"SUMLEV","STATE","COUNTY","STNAME","CTYNAME","YEAR","AGE","TOT_POP","TOT_MALE","TOT_FEMALE"
050,56,001,"Wyoming","Albany County",1,0,318,165,153
050,56,001,"Wyoming","Albany County",1,1,319,166,153
050,56,001,"Wyoming","Albany County",1,2,330,162,168
050,56,001,"Wyoming","Albany County",1,3,335,155,180
050,56,001,"Wyoming","Albany County",1,4,327,157,170
050,56,001,"Wyoming","Albany County",1,5,334,183,151
050,56,001,"Wyoming","Albany County",1,6,317,167,150
050,56,001,"Wyoming","Albany County",1,7,325,171,154
050,56,001,"Wyoming","Albany County",1,8,350,205,145
050,56,001,"Wyoming","Albany County",1,9,315,166,149
050,56,001,"Wyoming","Albany County",1,10,322,163,159
050,56,001,"Wyoming","Albany County",1,11,346,183,163
050,56,001,"Wyoming","Albany County",1,12,344,181,163
050,56,001,"Wyoming","Albany County",1,13,345,193,152
050,56,001,"Wyoming","Albany County",1,14,328,149,179
050,56,001,"Wyoming","Albany County",1,15,324,170,154
050,56,001,"Wyoming","Albany County",1,16,291,147,144
050,56,001,"Wyoming","Albany County",1,17,315,155,160
050,56,001,"Wyoming","Albany County",1,18,826,398,428
050,56,001,"Wyoming","Albany County",1,19,1652,860,792
050,56,001,"Wyoming","Albany County",1,20,1565,782,783
050,56,001,"Wyoming","Albany County",1,21,1854,961,893
050,56,001,"Wyoming","Albany County",1,22,1858,1009,849
050,56,001,"Wyoming","Albany County",1,23,1431,793,638
050,56,001,"Wyoming","Albany County",1,24,1135,587,548
050,56,001,"Wyoming","Albany County",1,25,881,506,375
050,56,001,"Wyoming","Albany County",1,26,715,397,318
050,56,001,"Wyoming","Albany County",1,27,594,329,265
050,56,001,"Wyoming","Albany County",1,28,612,351,261
050,56,001,"Wyoming","Albany County",1,29,562,325,237
050,56,001,"Wyoming","Albany County",1,30,550,316,234
050,56,001,"Wyoming","Albany County",1,31,472,277,195
050,56,001,"Wyoming","Albany County",1,32,432,241,191
050,56,001,"Wyoming","Albany County",1,33,418,224,194
050,56,001,"Wyoming","Albany County",1,34,454,246,208
050,56,001,"Wyoming","Albany County",1,35,411,223,188
050,56,001,"Wyoming","Albany County",1,36,434,230,204
050,56,001,"Wyoming","Albany County",1,37,463,233,230
050,56,001,"Wyoming","Albany County",1,38,447,239,208
050,56,001,"Wyoming","Albany County",1,39,394,215,179
050,56,001,"Wyoming","Albany County",1,40,398,205,193
050,56,001,"Wyoming","Albany County",1,41,373,198,175
050,56,001,"Wyoming","Albany County",1,42,392,226,166
050,56,001,"Wyoming","Albany County",1,43,359,204,155
050,56,001,"Wyoming","Albany County",1,44,337,171,166
050,56,001,"Wyoming","Albany County",1,45,330,180,150
050,56,001,"Wyoming","Albany County",1,46,326,179,147
050,56,001,"Wyoming","Albany County",1,47,302,154,148
050,56,001,"Wyoming","Albany County",1,48,303,152,151
050,56,001,"Wyoming","Albany County",1,49,299,159,140
050,56,001,"Wyoming","Albany County",1,50,309,165,144
050,56,001,"Wyoming","Albany County",1,51,319,164,155
050,56,001,"Wyoming","Albany County",1,52,309,153,156
050,56,001,"Wyoming","Albany County",1,53,273,143,130
050,56,001,"Wyoming","Albany County",1,54,284,148,136
050,56,001,"Wyoming","Albany County",1,55,319,169,150
050,56,001,"Wyoming","Albany County",1,56,291,143,148
050,56,001,"Wyoming","Albany County",1,57,311,147,164
050,56,001,"Wyoming","Albany County",1,58,342,173,169
050,56,001,"Wyoming","Albany County",1,59,353,175,178
050,56,001,"Wyoming","Albany County",1,60,369,190,179
050,56,001,"Wyoming","Albany County",1,61,365,191,174
050,56,001,"Wyoming","Albany County",1,62,372,184,188
050,56,001,"Wyoming","Albany County",1,63,381,182,199
050,56,001,"Wyoming","Albany County",1,64,377,189,188
050,56,001,"Wyoming","Albany County",1,65,370,188,182
050,56,001,"Wyoming","Albany County",1,66,384,196,188
050,56,001,"Wyoming","Albany County",1,67,361,178,183
050,56,001,"Wyoming","Albany County",1,68,327,165,162
050,56,001,"Wyoming","Albany County",1,69,310,163,147
050,56,001,"Wyoming","Albany County",1,70,284,147,137
050,56,001,"Wyoming","Albany County",1,71,270,140,130
050,56,001,"Wyoming","Albany County",1,72,258,130,128
050,56,001,"Wyoming","Albany County",1,73,257,127,130
050,56,001,"Wyoming","Albany County",1,74,181,85,96
050,56,001,"Wyoming","Albany County",1,75,186,91,95
050,56,001,"Wyoming","Albany County",1,76,153,68,85
050,56,001,"Wyoming","Albany County",1,77,153,69,84
050,56,001,"Wyoming","Albany County",1,78,129,62,67
050,56,001,"Wyoming","Albany County",1,79,117,58,59
050,56,001,"Wyoming","Albany County",1,80,125,62,63
050,56,001,"Wyoming","Albany County",1,81,110,54,56
050,56,001,"Wyoming","Albany County",1,82,86,39,47
050,56,001,"Wyoming","Albany County",1,83,83,40,43
050,56,001,"Wyoming","Albany County",1,84,83,31,52
050,56,001,"Wyoming","Albany County",1,85,404,141,263
050,56,001,"Wyoming","Albany County",2,0,323,158,165
050,56,001,"Wyoming","Albany County",2,1,317,165,152
050,56,001,"Wyoming","Albany County",2,2,328,163,165
050,56,001,"Wyoming","Albany County",2,3,335,155,180
050,56,001,"Wyoming","Albany County",2,4,331,157,174
050,56,001,"Wyoming","Albany County",2,5,330,177,153
050,56,001,"Wyoming","Albany County",2,6,321,172,149
050,56,001,"Wyoming","Albany County",2,7,327,172,155
050,56,001,"Wyoming","Albany County",2,8,342,196,146
050,56,001,"Wyoming","Albany County",2,9,319,173,146
050,56,001,"Wyoming","Albany County",2,10,318,162,156
050,56,001,"Wyoming","Albany County",2,11,339,177,162
050,56,001,"Wyoming","Albany County",2,12,345,183,162
050,56,001,"Wyoming","Albany County",2,13,340,186,154
050,56,001,"Wyoming","Albany County",2,14,332,159,173
050,56,001,"Wyoming","Albany County",2,15,325,164,161
050,56,001,"Wyoming","Albany County",2,16,302,153,149
050,56,001,"Wyoming","Albany County",2,17,315,155,160
050,56,001,"Wyoming","Albany County",2,18,836,401,435
050,56,001,"Wyoming","Albany County",2,19,1661,864,797
050,56,001,"Wyoming","Albany County",2,20,1597,796,801
050,56,001,"Wyoming","Albany County",2,21,1846,961,885
050,56,001,"Wyoming","Albany County",2,22,1848,1008,840
050,56,001,"Wyoming","Albany County",2,23,1410,776,634
050,56,001,"Wyoming","Albany County",2,24,1111,576,535
050,56,001,"Wyoming","Albany County",2,25,880,500,380
050,56,001,"Wyoming","Albany County",2,26,709,395,314
050,56,001,"Wyoming","Albany County",2,27,594,326,268
050,56,001,"Wyoming","Albany County",2,28,592,340,252
050,56,001,"Wyoming","Albany County",2,29,565,325,240
050,56,001,"Wyoming","Albany County",2,30,548,315,233
050,56,001,"Wyoming","Albany County",2,31,487,283,204
050,56,001,"Wyoming","Albany County",2,32,438,247,191
050,56,001,"Wyoming","Albany County",2,33,421,227,194
050,56,001,"Wyoming","Albany County",2,34,445,240,205
050,56,001,"Wyoming","Albany County",2,35,422,227,195
050,56,001,"Wyoming","Albany County",2,36,428,226,202
050,56,001,"Wyoming","Albany County",2,37,451,230,221
050,56,001,"Wyoming","Albany County",2,38,447,236,211
050,56,001,"Wyoming","Albany County",2,39,408,222,186
050,56,001,"Wyoming","Albany County",2,40,404,210,194
050,56,001,"Wyoming","Albany County",2,41,379,200,179
050,56,001,"Wyoming","Albany County",2,42,384,218,166
050,56,001,"Wyoming","Albany County",2,43,370,211,159
050,56,001,"Wyoming","Albany County",2,44,337,175,162
050,56,001,"Wyoming","Albany County",2,45,330,177,153
050,56,001,"Wyoming","Albany County",2,46,326,180,146
050,56,001,"Wyoming","Albany County",2,47,306,160,146
050,56,001,"Wyoming","Albany County",2,48,303,153,150
050,56,001,"Wyoming","Albany County",2,49,304,159,145
050,56,001,"Wyoming","Albany County",2,50,305,164,141
050,56,001,"Wyoming","Albany County",2,51,319,167,152
050,56,001,"Wyoming","Albany County",2,52,310,153,157
050,56,001,"Wyoming","Albany County",2,53,282,147,135
050,56,001,"Wyoming","Albany County",2,54,284,148,136
050,56,001,"Wyoming","Albany County",2,55,308,162,146
050,56,001,"Wyoming","Albany County",2,56,297,148,149
050,56,001,"Wyoming","Albany County",2,57,306,147,159
050,56,001,"Wyoming","Albany County",2,58,334,169,165
050,56,001,"Wyoming","Albany County",2,59,354,177,177
050,56,001,"Wyoming","Albany County",2,60,365,187,178
050,56,001,"Wyoming","Albany County",2,61,365,189,176
050,56,001,"Wyoming","Albany County",2,62,371,185,186
050,56,001,"Wyoming","Albany County",2,63,382,183,199
050,56,001,"Wyoming","Albany County",2,64,375,185,190
050,56,001,"Wyoming","Albany County",2,65,374,190,184
050,56,001,"Wyoming","Albany County",2,66,381,196,185
050,56,001,"Wyoming","Albany County",2,67,366,182,184
050,56,001,"Wyoming","Albany County",2,68,330,166,164
050,56,001,"Wyoming","Albany County",2,69,314,164,150
050,56,001,"Wyoming","Albany County",2,70,287,149,138
050,56,001,"Wyoming","Albany County",2,71,272,140,132
050,56,001,"Wyoming","Albany County",2,72,257,132,125
050,56,001,"Wyoming","Albany County",2,73,270,134,136
050,56,001,"Wyoming","Albany County",2,74,186,88,98
050,56,001,"Wyoming","Albany County",2,75,186,91,95
050,56,001,"Wyoming","Albany County",2,76,159,72,87
050,56,001,"Wyoming","Albany County",2,77,156,70,86
050,56,001,"Wyoming","Albany County",2,78,132,62,70
050,56,001,"Wyoming","Albany County",2,79,116,58,58
050,56,001,"Wyoming","Albany County",2,80,122,60,62
050,56,001,"Wyoming","Albany County",2,81,113,55,58
050,56,001,"Wyoming","Albany County",2,82,93,42,51
050,56,001,"Wyoming","Albany County",2,83,81,37,44
050,56,001,"Wyoming","Albany County",2,84,83,33,50
050,56,001,"Wyoming","Albany County",2,85,401,141,260
050,56,001,"Wyoming","Albany County",3,0,303,155,148
050,56,001,"Wyoming","Albany County",3,1,341,157,184
050,56,001,"Wyoming","Albany County",3,2,313,162,151
050,56,001,"Wyoming","Albany County",3,3,306,153,153
050,56,001,"Wyoming","Albany County",3,4,339,155,184
050,56,001,"Wyoming","Albany County",3,5,343,166,177
050,56,001,"Wyoming","Albany County",3,6,327,179,148
050,56,001,"Wyoming","Albany County",3,7,319,171,148
050,56,001,"Wyoming","Albany County",3,8,327,162,165
050,56,001,"Wyoming","Albany County",3,9,337,198,139
050,56,001,"Wyoming","Albany County",3,10,314,179,135
050,56,001,"Wyoming","Albany County",3,11,312,157,155
050,56,001,"Wyoming","Albany County",3,12,343,180,163
050,56,001,"Wyoming","Albany County",3,13,347,186,161
050,56,001,"Wyoming","Albany County",3,14,335,178,157
050,56,001,"Wyoming","Albany County",3,15,351,171,180
050,56,001,"Wyoming","Albany County",3,16,328,170,158
050,56,001,"Wyoming","Albany County",3,17,316,158,158
050,56,001,"Wyoming","Albany County",3,18,902,426,476
050,56,001,"Wyoming","Albany County",3,19,1769,911,858
050,56,001,"Wyoming","Albany County",3,20,1693,845,848
050,56,001,"Wyoming","Albany County",3,21,1927,1023,904
050,56,001,"Wyoming","Albany County",3,22,1849,1012,837
050,56,001,"Wyoming","Albany County",3,23,1365,748,617
050,56,001,"Wyoming","Albany County",3,24,1084,555,529
050,56,001,"Wyoming","Albany County",3,25,872,509,363
050,56,001,"Wyoming","Albany County",3,26,760,434,326
050,56,001,"Wyoming","Albany County",3,27,600,329,271
050,56,001,"Wyoming","Albany County",3,28,566,309,257
050,56,001,"Wyoming","Albany County",3,29,563,323,240
050,56,001,"Wyoming","Albany County",3,30,546,301,245
050,56,001,"Wyoming","Albany County",3,31,552,318,234
050,56,001,"Wyoming","Albany County",3,32,470,269,201
050,56,001,"Wyoming","Albany County",3,33,430,249,181
050,56,001,"Wyoming","Albany County",3,34,427,228,199
050,56,001,"Wyoming","Albany County",3,35,441,237,204
050,56,001,"Wyoming","Albany County",3,36,423,219,204
050,56,001,"Wyoming","Albany County",3,37,432,219,213
050,56,001,"Wyoming","Albany County",3,38,429,221,208
050,56,001,"Wyoming","Albany County",3,39,453,234,219
050,56,001,"Wyoming","Albany County",3,40,423,229,194
050,56,001,"Wyoming","Albany County",3,41,403,210,193
050,56,001,"Wyoming","Albany County",3,42,381,204,177
050,56,001,"Wyoming","Albany County",3,43,388,227,161
050,56,001,"Wyoming","Albany County",3,44,377,212,165
050,56,001,"Wyoming","Albany County",3,45,340,171,169
050,56,001,"Wyoming","Albany County",3,46,333,183,150
050,56,001,"Wyoming","Albany County",3,47,330,182,148
050,56,001,"Wyoming","Albany County",3,48,310,164,146
050,56,001,"Wyoming","Albany County",3,49,315,156,159
050,56,001,"Wyoming","Albany County",3,50,298,155,143
050,56,001,"Wyoming","Albany County",3,51,310,171,139
050,56,001,"Wyoming","Albany County",3,52,318,167,151
050,56,001,"Wyoming","Albany County",3,53,318,155,163
050,56,001,"Wyoming","Albany County",3,54,287,146,141
050,56,001,"Wyoming","Albany County",3,55,279,142,137
050,56,001,"Wyoming","Albany County",3,56,309,155,154
050,56,001,"Wyoming","Albany County",3,57,309,153,156
050,56,001,"Wyoming","Albany County",3,58,313,151,162
050,56,001,"Wyoming","Albany County",3,59,348,173,175
050,56,001,"Wyoming","Albany County",3,60,340,171,169
050,56,001,"Wyoming","Albany County",3,61,363,187,176
050,56,001,"Wyoming","Albany County",3,62,361,185,176
050,56,001,"Wyoming","Albany County",3,63,362,178,184
050,56,001,"Wyoming","Albany County",3,64,382,185,197
050,56,001,"Wyoming","Albany County",3,65,369,176,193
050,56,001,"Wyoming","Albany County",3,66,379,196,183
050,56,001,"Wyoming","Albany County",3,67,364,185,179
050,56,001,"Wyoming","Albany County",3,68,364,175,189
050,56,001,"Wyoming","Albany County",3,69,330,166,164
050,56,001,"Wyoming","Albany County",3,70,307,162,145
050,56,001,"Wyoming","Albany County",3,71,280,149,131
050,56,001,"Wyoming","Albany County",3,72,273,138,135
050,56,001,"Wyoming","Albany County",3,73,255,128,127
050,56,001,"Wyoming","Albany County",3,74,267,131,136
050,56,001,"Wyoming","Albany County",3,75,192,90,102
050,56,001,"Wyoming","Albany County",3,76,187,92,95
050,56,001,"Wyoming","Albany County",3,77,149,70,79
050,56,001,"Wyoming","Albany County",3,78,156,67,89
050,56,001,"Wyoming","Albany County",3,79,127,60,67
050,56,001,"Wyoming","Albany County",3,80,114,57,57
050,56,001,"Wyoming","Albany County",3,81,120,58,62
050,56,001,"Wyoming","Albany County",3,82,101,50,51
050,56,001,"Wyoming","Albany County",3,83,85,39,46
050,56,001,"Wyoming","Albany County",3,84,88,40,48
050,56,001,"Wyoming","Albany County",3,85,396,139,257
050,56,001,"Wyoming","Albany County",4,0,316,176,140
050,56,001,"Wyoming","Albany County",4,1,285,145,140
050,56,001,"Wyoming","Albany County",4,2,333,164,169
050,56,001,"Wyoming","Albany County",4,3,317,164,153
050,56,001,"Wyoming","Albany County",4,4,297,156,141
050,56,001,"Wyoming","Albany County",4,5,330,157,173
050,56,001,"Wyoming","Albany County",4,6,339,165,174
050,56,001,"Wyoming","Albany County",4,7,329,183,146
050,56,001,"Wyoming","Albany County",4,8,319,176,143
050,56,001,"Wyoming","Albany County",4,9,334,160,174
050,56,001,"Wyoming","Albany County",4,10,319,186,133
050,56,001,"Wyoming","Albany County",4,11,315,175,140
050,56,001,"Wyoming","Albany County",4,12,319,163,156
050,56,001,"Wyoming","Albany County",4,13,344,182,162
050,56,001,"Wyoming","Albany County",4,14,346,188,158
050,56,001,"Wyoming","Albany County",4,15,339,180,159
050,56,001,"Wyoming","Albany County",4,16,350,170,180
050,56,001,"Wyoming","Albany County",4,17,349,176,173
050,56,001,"Wyoming","Albany County",4,18,919,435,484
050,56,001,"Wyoming","Albany County",4,19,1831,940,891
050,56,001,"Wyoming","Albany County",4,20,1684,834,850
050,56,001,"Wyoming","Albany County",4,21,2009,1076,933
050,56,001,"Wyoming","Albany County",4,22,1986,1104,882
050,56,001,"Wyoming","Albany County",4,23,1357,759,598
050,56,001,"Wyoming","Albany County",4,24,1035,536,499
050,56,001,"Wyoming","Albany County",4,25,853,456,397
050,56,001,"Wyoming","Albany County",4,26,718,406,312
050,56,001,"Wyoming","Albany County",4,27,640,354,286
050,56,001,"Wyoming","Albany County",4,28,578,310,268
050,56,001,"Wyoming","Albany County",4,29,505,285,220
050,56,001,"Wyoming","Albany County",4,30,532,317,215
050,56,001,"Wyoming","Albany County",4,31,527,287,240
050,56,001,"Wyoming","Albany County",4,32,501,279,222
050,56,001,"Wyoming","Albany County",4,33,459,256,203
050,56,001,"Wyoming","Albany County",4,34,409,235,174
050,56,001,"Wyoming","Albany County",4,35,423,221,202
050,56,001,"Wyoming","Albany County",4,36,441,232,209
050,56,001,"Wyoming","Albany County",4,37,407,214,193
050,56,001,"Wyoming","Albany County",4,38,438,227,211
050,56,001,"Wyoming","Albany County",4,39,425,219,206
050,56,001,"Wyoming","Albany County",4,40,427,215,212
050,56,001,"Wyoming","Albany County",4,41,432,232,200
050,56,001,"Wyoming","Albany County",4,42,403,208,195
050,56,001,"Wyoming","Albany County",4,43,388,205,183
050,56,001,"Wyoming","Albany County",4,44,381,220,161
050,56,001,"Wyoming","Albany County",4,45,370,208,162
050,56,001,"Wyoming","Albany County",4,46,321,156,165
050,56,001,"Wyoming","Albany County",4,47,331,186,145
050,56,001,"Wyoming","Albany County",4,48,340,184,156
050,56,001,"Wyoming","Albany County",4,49,301,160,141
050,56,001,"Wyoming","Albany County",4,50,304,146,158
050,56,001,"Wyoming","Albany County",4,51,289,149,140
050,56,001,"Wyoming","Albany County",4,52,307,168,139
050,56,001,"Wyoming","Albany County",4,53,310,163,147
050,56,001,"Wyoming","Albany County",4,54,319,161,158
050,56,001,"Wyoming","Albany County",4,55,299,147,152
050,56,001,"Wyoming","Albany County",4,56,281,147,134
050,56,001,"Wyoming","Albany County",4,57,328,163,165
050,56,001,"Wyoming","Albany County",4,58,318,160,158
050,56,001,"Wyoming","Albany County",4,59,308,143,165
050,56,001,"Wyoming","Albany County",4,60,345,170,175
050,56,001,"Wyoming","Albany County",4,61,342,172,170
050,56,001,"Wyoming","Albany County",4,62,370,186,184
050,56,001,"Wyoming","Albany County",4,63,362,190,172
050,56,001,"Wyoming","Albany County",4,64,351,172,179
050,56,001,"Wyoming","Albany County",4,65,394,191,203
050,56,001,"Wyoming","Albany County",4,66,376,188,188
050,56,001,"Wyoming","Albany County",4,67,361,180,181
050,56,001,"Wyoming","Albany County",4,68,363,183,180
050,56,001,"Wyoming","Albany County",4,69,359,175,184
050,56,001,"Wyoming","Albany County",4,70,319,155,164
050,56,001,"Wyoming","Albany County",4,71,291,156,135
050,56,001,"Wyoming","Albany County",4,72,277,151,126
050,56,001,"Wyoming","Albany County",4,73,257,132,125
050,56,001,"Wyoming","Albany County",4,74,242,121,121
050,56,001,"Wyoming","Albany County",4,75,265,127,138
050,56,001,"Wyoming","Albany County",4,76,191,90,101
050,56,001,"Wyoming","Albany County",4,77,169,83,86
050,56,001,"Wyoming","Albany County",4,78,144,68,76
050,56,001,"Wyoming","Albany County",4,79,148,61,87
050,56,001,"Wyoming","Albany County",4,80,122,58,64
050,56,001,"Wyoming","Albany County",4,81,116,58,58
050,56,001,"Wyoming","Albany County",4,82,108,51,57
050,56,001,"Wyoming","Albany County",4,83,102,45,57
050,56,001,"Wyoming","Albany County",4,84,82,37,45
050,56,001,"Wyoming","Albany County",4,85,408,152,256
050,56,001,"Wyoming","Albany County",5,0,315,176,139
050,56,001,"Wyoming","Albany County",5,1,287,162,125
050,56,001,"Wyoming","Albany County",5,2,262,136,126
050,56,001,"Wyoming","Albany County",5,3,321,157,164
050,56,001,"Wyoming","Albany County",5,4,303,166,137
050,56,001,"Wyoming","Albany County",5,5,289,153,136
050,56,001,"Wyoming","Albany County",5,6,312,152,160
050,56,001,"Wyoming","Albany County",5,7,339,166,173
050,56,001,"Wyoming","Albany County",5,8,321,183,138
050,56,001,"Wyoming","Albany County",5,9,325,171,154
050,56,001,"Wyoming","Albany County",5,10,334,165,169
050,56,001,"Wyoming","Albany County",5,11,318,185,133
050,56,001,"Wyoming","Albany County",5,12,312,176,136
050,56,001,"Wyoming","Albany County",5,13,308,155,153
050,56,001,"Wyoming","Albany County",5,14,350,184,166
050,56,001,"Wyoming","Albany County",5,15,353,187,166
050,56,001,"Wyoming","Albany County",5,16,348,181,167
050,56,001,"Wyoming","Albany County",5,17,364,174,190
050,56,001,"Wyoming","Albany County",5,18,929,437,492
050,56,001,"Wyoming","Albany County",5,19,1821,939,882
050,56,001,"Wyoming","Albany County",5,20,1681,828,853
050,56,001,"Wyoming","Albany County",5,21,1949,1028,921
050,56,001,"Wyoming","Albany County",5,22,2024,1140,884
050,56,001,"Wyoming","Albany County",5,23,1508,853,655
050,56,001,"Wyoming","Albany County",5,24,1041,535,506
050,56,001,"Wyoming","Albany County",5,25,799,451,348
050,56,001,"Wyoming","Albany County",5,26,702,381,321
050,56,001,"Wyoming","Albany County",5,27,586,318,268
050,56,001,"Wyoming","Albany County",5,28,604,336,268
050,56,001,"Wyoming","Albany County",5,29,532,277,255
050,56,001,"Wyoming","Albany County",5,30,507,282,225
050,56,001,"Wyoming","Albany County",5,31,510,306,204
050,56,001,"Wyoming","Albany County",5,32,511,264,247
050,56,001,"Wyoming","Albany County",5,33,484,270,214
050,56,001,"Wyoming","Albany County",5,34,438,244,194
050,56,001,"Wyoming","Albany County",5,35,398,228,170
050,56,001,"Wyoming","Albany County",5,36,422,212,210
050,56,001,"Wyoming","Albany County",5,37,430,223,207
050,56,001,"Wyoming","Albany County",5,38,388,205,183
050,56,001,"Wyoming","Albany County",5,39,437,217,220
050,56,001,"Wyoming","Albany County",5,40,416,213,203
050,56,001,"Wyoming","Albany County",5,41,409,217,192
050,56,001,"Wyoming","Albany County",5,42,430,231,199
050,56,001,"Wyoming","Albany County",5,43,399,204,195
050,56,001,"Wyoming","Albany County",5,44,373,197,176
050,56,001,"Wyoming","Albany County",5,45,374,217,157
050,56,001,"Wyoming","Albany County",5,46,370,214,156
050,56,001,"Wyoming","Albany County",5,47,321,160,161
050,56,001,"Wyoming","Albany County",5,48,331,188,143
050,56,001,"Wyoming","Albany County",5,49,328,174,154
050,56,001,"Wyoming","Albany County",5,50,307,156,151
050,56,001,"Wyoming","Albany County",5,51,307,155,152
050,56,001,"Wyoming","Albany County",5,52,286,149,137
050,56,001,"Wyoming","Albany County",5,53,290,161,129
050,56,001,"Wyoming","Albany County",5,54,317,166,151
050,56,001,"Wyoming","Albany County",5,55,317,161,156
050,56,001,"Wyoming","Albany County",5,56,304,148,156
050,56,001,"Wyoming","Albany County",5,57,267,137,130
050,56,001,"Wyoming","Albany County",5,58,329,168,161
050,56,001,"Wyoming","Albany County",5,59,335,166,169
050,56,001,"Wyoming","Albany County",5,60,299,137,162
050,56,001,"Wyoming","Albany County",5,61,326,160,166
050,56,001,"Wyoming","Albany County",5,62,351,181,170
050,56,001,"Wyoming","Albany County",5,63,362,188,174
050,56,001,"Wyoming","Albany County",5,64,360,192,168
050,56,001,"Wyoming","Albany County",5,65,351,177,174
050,56,001,"Wyoming","Albany County",5,66,394,191,203
050,56,001,"Wyoming","Albany County",5,67,366,181,185
050,56,001,"Wyoming","Albany County",5,68,355,176,179
050,56,001,"Wyoming","Albany County",5,69,354,183,171
050,56,001,"Wyoming","Albany County",5,70,351,165,186
050,56,001,"Wyoming","Albany County",5,71,313,159,154
050,56,001,"Wyoming","Albany County",5,72,285,155,130
050,56,001,"Wyoming","Albany County",5,73,272,150,122
050,56,001,"Wyoming","Albany County",5,74,253,129,124
050,56,001,"Wyoming","Albany County",5,75,244,117,127
050,56,001,"Wyoming","Albany County",5,76,261,125,136
050,56,001,"Wyoming","Albany County",5,77,176,80,96
050,56,001,"Wyoming","Albany County",5,78,167,80,87
050,56,001,"Wyoming","Albany County",5,79,143,68,75
050,56,001,"Wyoming","Albany County",5,80,142,60,82
050,56,001,"Wyoming","Albany County",5,81,131,59,72
050,56,001,"Wyoming","Albany County",5,82,104,51,53
050,56,001,"Wyoming","Albany County",5,83,104,47,57
050,56,001,"Wyoming","Albany County",5,84,99,45,54
050,56,001,"Wyoming","Albany County",5,85,422,160,262
050,56,003,"Wyoming","Big Horn County",1,0,110,58,52
050,56,003,"Wyoming","Big Horn County",1,1,100,57,43
050,56,003,"Wyoming","Big Horn County",1,2,136,74,62
050,56,003,"Wyoming","Big Horn County",1,3,143,82,61
050,56,003,"Wyoming","Big Horn County",1,4,144,71,73
050,56,003,"Wyoming","Big Horn County",1,5,162,72,90
050,56,003,"Wyoming","Big Horn County",1,6,152,88,64
050,56,003,"Wyoming","Big Horn County",1,7,152,73,79
050,56,003,"Wyoming","Big Horn County",1,8,157,84,73
050,56,003,"Wyoming","Big Horn County",1,9,166,86,80
050,56,003,"Wyoming","Big Horn County",1,10,157,78,79
050,56,003,"Wyoming","Big Horn County",1,11,163,86,77
050,56,003,"Wyoming","Big Horn County",1,12,172,88,84
050,56,003,"Wyoming","Big Horn County",1,13,182,91,91
050,56,003,"Wyoming","Big Horn County",1,14,191,93,98
050,56,003,"Wyoming","Big Horn County",1,15,206,107,99
050,56,003,"Wyoming","Big Horn County",1,16,178,88,90
050,56,003,"Wyoming","Big Horn County",1,17,172,85,87
050,56,003,"Wyoming","Big Horn County",1,18,136,68,68
050,56,003,"Wyoming","Big Horn County",1,19,110,59,51
050,56,003,"Wyoming","Big Horn County",1,20,115,62,53
050,56,003,"Wyoming","Big Horn County",1,21,106,53,53
050,56,003,"Wyoming","Big Horn County",1,22,112,53,59
050,56,003,"Wyoming","Big Horn County",1,23,125,75,50
050,56,003,"Wyoming","Big Horn County",1,24,122,66,56
050,56,003,"Wyoming","Big Horn County",1,25,115,54,61
050,56,003,"Wyoming","Big Horn County",1,26,112,59,53
050,56,003,"Wyoming","Big Horn County",1,27,103,51,52
050,56,003,"Wyoming","Big Horn County",1,28,103,60,43
050,56,003,"Wyoming","Big Horn County",1,29,105,47,58
050,56,003,"Wyoming","Big Horn County",1,30,122,62,60
050,56,003,"Wyoming","Big Horn County",1,31,118,59,59
050,56,003,"Wyoming","Big Horn County",1,32,117,64,53
050,56,003,"Wyoming","Big Horn County",1,33,133,67,66
050,56,003,"Wyoming","Big Horn County",1,34,136,73,63
050,56,003,"Wyoming","Big Horn County",1,35,144,78,66
050,56,003,"Wyoming","Big Horn County",1,36,140,70,70
050,56,003,"Wyoming","Big Horn County",1,37,136,75,61
050,56,003,"Wyoming","Big Horn County",1,38,132,70,62
050,56,003,"Wyoming","Big Horn County",1,39,138,60,78
050,56,003,"Wyoming","Big Horn County",1,40,137,68,69
050,56,003,"Wyoming","Big Horn County",1,41,153,84,69
050,56,003,"Wyoming","Big Horn County",1,42,149,83,66
050,56,003,"Wyoming","Big Horn County",1,43,133,68,65
050,56,003,"Wyoming","Big Horn County",1,44,119,63,56
050,56,003,"Wyoming","Big Horn County",1,45,101,51,50
050,56,003,"Wyoming","Big Horn County",1,46,107,54,53
050,56,003,"Wyoming","Big Horn County",1,47,116,62,54
050,56,003,"Wyoming","Big Horn County",1,48,128,65,63
050,56,003,"Wyoming","Big Horn County",1,49,131,67,64
050,56,003,"Wyoming","Big Horn County",1,50,129,70,59
050,56,003,"Wyoming","Big Horn County",1,51,126,65,61
050,56,003,"Wyoming","Big Horn County",1,52,127,61,66
050,56,003,"Wyoming","Big Horn County",1,53,134,64,70
050,56,003,"Wyoming","Big Horn County",1,54,131,67,64
050,56,003,"Wyoming","Big Horn County",1,55,147,78,69
050,56,003,"Wyoming","Big Horn County",1,56,158,81,77
050,56,003,"Wyoming","Big Horn County",1,57,152,75,77
050,56,003,"Wyoming","Big Horn County",1,58,172,86,86
050,56,003,"Wyoming","Big Horn County",1,59,156,72,84
050,56,003,"Wyoming","Big Horn County",1,60,161,91,70
050,56,003,"Wyoming","Big Horn County",1,61,158,84,74
050,56,003,"Wyoming","Big Horn County",1,62,182,94,88
050,56,003,"Wyoming","Big Horn County",1,63,150,74,76
050,56,003,"Wyoming","Big Horn County",1,64,176,88,88
050,56,003,"Wyoming","Big Horn County",1,65,180,88,92
050,56,003,"Wyoming","Big Horn County",1,66,170,80,90
050,56,003,"Wyoming","Big Horn County",1,67,164,86,78
050,56,003,"Wyoming","Big Horn County",1,68,137,65,72
050,56,003,"Wyoming","Big Horn County",1,69,149,75,74
050,56,003,"Wyoming","Big Horn County",1,70,139,75,64
050,56,003,"Wyoming","Big Horn County",1,71,130,63,67
050,56,003,"Wyoming","Big Horn County",1,72,138,72,66
050,56,003,"Wyoming","Big Horn County",1,73,141,76,65
050,56,003,"Wyoming","Big Horn County",1,74,88,44,44
050,56,003,"Wyoming","Big Horn County",1,75,97,44,53
050,56,003,"Wyoming","Big Horn County",1,76,96,45,51
050,56,003,"Wyoming","Big Horn County",1,77,103,51,52
050,56,003,"Wyoming","Big Horn County",1,78,92,47,45
050,56,003,"Wyoming","Big Horn County",1,79,71,37,34
050,56,003,"Wyoming","Big Horn County",1,80,78,38,40
050,56,003,"Wyoming","Big Horn County",1,81,67,34,33
050,56,003,"Wyoming","Big Horn County",1,82,55,27,28
050,56,003,"Wyoming","Big Horn County",1,83,49,20,29
050,56,003,"Wyoming","Big Horn County",1,84,33,12,21
050,56,003,"Wyoming","Big Horn County",1,85,290,109,181
050,56,003,"Wyoming","Big Horn County",2,0,103,57,46
050,56,003,"Wyoming","Big Horn County",2,1,102,57,45
050,56,003,"Wyoming","Big Horn County",2,2,129,70,59
050,56,003,"Wyoming","Big Horn County",2,3,141,80,61
050,56,003,"Wyoming","Big Horn County",2,4,144,74,70
050,56,003,"Wyoming","Big Horn County",2,5,159,73,86
050,56,003,"Wyoming","Big Horn County",2,6,156,86,70
050,56,003,"Wyoming","Big Horn County",2,7,151,76,75
050,56,003,"Wyoming","Big Horn County",2,8,152,79,73
050,56,003,"Wyoming","Big Horn County",2,9,163,86,77
050,56,003,"Wyoming","Big Horn County",2,10,157,79,78
050,56,003,"Wyoming","Big Horn County",2,11,159,84,75
050,56,003,"Wyoming","Big Horn County",2,12,170,89,81
050,56,003,"Wyoming","Big Horn County",2,13,179,90,89
050,56,003,"Wyoming","Big Horn County",2,14,187,93,94
050,56,003,"Wyoming","Big Horn County",2,15,201,103,98
050,56,003,"Wyoming","Big Horn County",2,16,188,95,93
050,56,003,"Wyoming","Big Horn County",2,17,172,85,87
050,56,003,"Wyoming","Big Horn County",2,18,137,70,67
050,56,003,"Wyoming","Big Horn County",2,19,108,58,50
050,56,003,"Wyoming","Big Horn County",2,20,116,62,54
050,56,003,"Wyoming","Big Horn County",2,21,110,55,55
050,56,003,"Wyoming","Big Horn County",2,22,113,54,59
050,56,003,"Wyoming","Big Horn County",2,23,120,70,50
050,56,003,"Wyoming","Big Horn County",2,24,123,67,56
050,56,003,"Wyoming","Big Horn County",2,25,117,57,60
050,56,003,"Wyoming","Big Horn County",2,26,112,57,55
050,56,003,"Wyoming","Big Horn County",2,27,104,52,52
050,56,003,"Wyoming","Big Horn County",2,28,106,59,47
050,56,003,"Wyoming","Big Horn County",2,29,105,49,56
050,56,003,"Wyoming","Big Horn County",2,30,119,61,58
050,56,003,"Wyoming","Big Horn County",2,31,118,59,59
050,56,003,"Wyoming","Big Horn County",2,32,118,63,55
050,56,003,"Wyoming","Big Horn County",2,33,128,66,62
050,56,003,"Wyoming","Big Horn County",2,34,135,72,63
050,56,003,"Wyoming","Big Horn County",2,35,145,79,66
050,56,003,"Wyoming","Big Horn County",2,36,138,70,68
050,56,003,"Wyoming","Big Horn County",2,37,138,74,64
050,56,003,"Wyoming","Big Horn County",2,38,133,71,62
050,56,003,"Wyoming","Big Horn County",2,39,137,62,75
050,56,003,"Wyoming","Big Horn County",2,40,140,67,73
050,56,003,"Wyoming","Big Horn County",2,41,144,78,66
050,56,003,"Wyoming","Big Horn County",2,42,148,82,66
050,56,003,"Wyoming","Big Horn County",2,43,139,75,64
050,56,003,"Wyoming","Big Horn County",2,44,120,62,58
050,56,003,"Wyoming","Big Horn County",2,45,105,54,51
050,56,003,"Wyoming","Big Horn County",2,46,106,53,53
050,56,003,"Wyoming","Big Horn County",2,47,113,60,53
050,56,003,"Wyoming","Big Horn County",2,48,124,64,60
050,56,003,"Wyoming","Big Horn County",2,49,129,66,63
050,56,003,"Wyoming","Big Horn County",2,50,127,68,59
050,56,003,"Wyoming","Big Horn County",2,51,125,65,60
050,56,003,"Wyoming","Big Horn County",2,52,125,61,64
050,56,003,"Wyoming","Big Horn County",2,53,133,64,69
050,56,003,"Wyoming","Big Horn County",2,54,130,65,65
050,56,003,"Wyoming","Big Horn County",2,55,146,77,69
050,56,003,"Wyoming","Big Horn County",2,56,153,79,74
050,56,003,"Wyoming","Big Horn County",2,57,154,76,78
050,56,003,"Wyoming","Big Horn County",2,58,170,86,84
050,56,003,"Wyoming","Big Horn County",2,59,160,75,85
050,56,003,"Wyoming","Big Horn County",2,60,160,87,73
050,56,003,"Wyoming","Big Horn County",2,61,157,85,72
050,56,003,"Wyoming","Big Horn County",2,62,178,91,87
050,56,003,"Wyoming","Big Horn County",2,63,158,79,79
050,56,003,"Wyoming","Big Horn County",2,64,170,85,85
050,56,003,"Wyoming","Big Horn County",2,65,179,87,92
050,56,003,"Wyoming","Big Horn County",2,66,175,83,92
050,56,003,"Wyoming","Big Horn County",2,67,167,85,82
050,56,003,"Wyoming","Big Horn County",2,68,142,70,72
050,56,003,"Wyoming","Big Horn County",2,69,146,73,73
050,56,003,"Wyoming","Big Horn County",2,70,137,72,65
050,56,003,"Wyoming","Big Horn County",2,71,130,64,66
050,56,003,"Wyoming","Big Horn County",2,72,133,69,64
050,56,003,"Wyoming","Big Horn County",2,73,148,79,69
050,56,003,"Wyoming","Big Horn County",2,74,94,48,46
050,56,003,"Wyoming","Big Horn County",2,75,93,43,50
050,56,003,"Wyoming","Big Horn County",2,76,94,44,50
050,56,003,"Wyoming","Big Horn County",2,77,102,50,52
050,56,003,"Wyoming","Big Horn County",2,78,93,47,46
050,56,003,"Wyoming","Big Horn County",2,79,72,37,35
050,56,003,"Wyoming","Big Horn County",2,80,73,37,36
050,56,003,"Wyoming","Big Horn County",2,81,70,36,34
050,56,003,"Wyoming","Big Horn County",2,82,57,28,29
050,56,003,"Wyoming","Big Horn County",2,83,49,20,29
050,56,003,"Wyoming","Big Horn County",2,84,33,12,21
050,56,003,"Wyoming","Big Horn County",2,85,290,108,182
050,56,003,"Wyoming","Big Horn County",3,0,117,64,53
050,56,003,"Wyoming","Big Horn County",3,1,115,65,50
050,56,003,"Wyoming","Big Horn County",3,2,101,54,47
050,56,003,"Wyoming","Big Horn County",3,3,138,74,64
050,56,003,"Wyoming","Big Horn County",3,4,149,83,66
050,56,003,"Wyoming","Big Horn County",3,5,157,80,77
050,56,003,"Wyoming","Big Horn County",3,6,164,73,91
050,56,003,"Wyoming","Big Horn County",3,7,165,94,71
050,56,003,"Wyoming","Big Horn County",3,8,152,76,76
050,56,003,"Wyoming","Big Horn County",3,9,153,81,72
050,56,003,"Wyoming","Big Horn County",3,10,176,99,77
050,56,003,"Wyoming","Big Horn County",3,11,158,73,85
050,56,003,"Wyoming","Big Horn County",3,12,163,86,77
050,56,003,"Wyoming","Big Horn County",3,13,176,90,86
050,56,003,"Wyoming","Big Horn County",3,14,188,96,92
050,56,003,"Wyoming","Big Horn County",3,15,190,93,97
050,56,003,"Wyoming","Big Horn County",3,16,203,106,97
050,56,003,"Wyoming","Big Horn County",3,17,181,91,90
050,56,003,"Wyoming","Big Horn County",3,18,144,74,70
050,56,003,"Wyoming","Big Horn County",3,19,103,54,49
050,56,003,"Wyoming","Big Horn County",3,20,113,56,57
050,56,003,"Wyoming","Big Horn County",3,21,122,61,61
050,56,003,"Wyoming","Big Horn County",3,22,117,53,64
050,56,003,"Wyoming","Big Horn County",3,23,109,57,52
050,56,003,"Wyoming","Big Horn County",3,24,112,70,42
050,56,003,"Wyoming","Big Horn County",3,25,110,59,51
050,56,003,"Wyoming","Big Horn County",3,26,117,54,63
050,56,003,"Wyoming","Big Horn County",3,27,120,67,53
050,56,003,"Wyoming","Big Horn County",3,28,115,61,54
050,56,003,"Wyoming","Big Horn County",3,29,102,53,49
050,56,003,"Wyoming","Big Horn County",3,30,105,51,54
050,56,003,"Wyoming","Big Horn County",3,31,123,60,63
050,56,003,"Wyoming","Big Horn County",3,32,135,67,68
050,56,003,"Wyoming","Big Horn County",3,33,118,59,59
050,56,003,"Wyoming","Big Horn County",3,34,142,73,69
050,56,003,"Wyoming","Big Horn County",3,35,143,76,67
050,56,003,"Wyoming","Big Horn County",3,36,146,80,66
050,56,003,"Wyoming","Big Horn County",3,37,140,75,65
050,56,003,"Wyoming","Big Horn County",3,38,137,75,62
050,56,003,"Wyoming","Big Horn County",3,39,141,71,70
050,56,003,"Wyoming","Big Horn County",3,40,151,73,78
050,56,003,"Wyoming","Big Horn County",3,41,134,60,74
050,56,003,"Wyoming","Big Horn County",3,42,144,79,65
050,56,003,"Wyoming","Big Horn County",3,43,153,84,69
050,56,003,"Wyoming","Big Horn County",3,44,137,71,66
050,56,003,"Wyoming","Big Horn County",3,45,117,65,52
050,56,003,"Wyoming","Big Horn County",3,46,105,54,51
050,56,003,"Wyoming","Big Horn County",3,47,117,58,59
050,56,003,"Wyoming","Big Horn County",3,48,116,66,50
050,56,003,"Wyoming","Big Horn County",3,49,124,65,59
050,56,003,"Wyoming","Big Horn County",3,50,135,67,68
050,56,003,"Wyoming","Big Horn County",3,51,124,67,57
050,56,003,"Wyoming","Big Horn County",3,52,125,61,64
050,56,003,"Wyoming","Big Horn County",3,53,124,61,63
050,56,003,"Wyoming","Big Horn County",3,54,126,59,67
050,56,003,"Wyoming","Big Horn County",3,55,138,71,67
050,56,003,"Wyoming","Big Horn County",3,56,149,81,68
050,56,003,"Wyoming","Big Horn County",3,57,154,77,77
050,56,003,"Wyoming","Big Horn County",3,58,163,83,80
050,56,003,"Wyoming","Big Horn County",3,59,167,82,85
050,56,003,"Wyoming","Big Horn County",3,60,170,81,89
050,56,003,"Wyoming","Big Horn County",3,61,166,90,76
050,56,003,"Wyoming","Big Horn County",3,62,173,93,80
050,56,003,"Wyoming","Big Horn County",3,63,177,90,87
050,56,003,"Wyoming","Big Horn County",3,64,162,84,78
050,56,003,"Wyoming","Big Horn County",3,65,176,86,90
050,56,003,"Wyoming","Big Horn County",3,66,185,91,94
050,56,003,"Wyoming","Big Horn County",3,67,184,88,96
050,56,003,"Wyoming","Big Horn County",3,68,159,83,76
050,56,003,"Wyoming","Big Horn County",3,69,141,69,72
050,56,003,"Wyoming","Big Horn County",3,70,137,68,69
050,56,003,"Wyoming","Big Horn County",3,71,131,70,61
050,56,003,"Wyoming","Big Horn County",3,72,130,66,64
050,56,003,"Wyoming","Big Horn County",3,73,129,68,61
050,56,003,"Wyoming","Big Horn County",3,74,147,76,71
050,56,003,"Wyoming","Big Horn County",3,75,92,50,42
050,56,003,"Wyoming","Big Horn County",3,76,91,43,48
050,56,003,"Wyoming","Big Horn County",3,77,87,41,46
050,56,003,"Wyoming","Big Horn County",3,78,97,47,50
050,56,003,"Wyoming","Big Horn County",3,79,85,43,42
050,56,003,"Wyoming","Big Horn County",3,80,64,34,30
050,56,003,"Wyoming","Big Horn County",3,81,70,38,32
050,56,003,"Wyoming","Big Horn County",3,82,63,32,31
050,56,003,"Wyoming","Big Horn County",3,83,54,25,29
050,56,003,"Wyoming","Big Horn County",3,84,36,14,22
050,56,003,"Wyoming","Big Horn County",3,85,274,97,177
050,56,003,"Wyoming","Big Horn County",4,0,124,70,54
050,56,003,"Wyoming","Big Horn County",4,1,119,62,57
050,56,003,"Wyoming","Big Horn County",4,2,126,72,54
050,56,003,"Wyoming","Big Horn County",4,3,107,60,47
050,56,003,"Wyoming","Big Horn County",4,4,140,79,61
050,56,003,"Wyoming","Big Horn County",4,5,156,86,70
050,56,003,"Wyoming","Big Horn County",4,6,161,82,79
050,56,003,"Wyoming","Big Horn County",4,7,171,76,95
050,56,003,"Wyoming","Big Horn County",4,8,173,96,77
050,56,003,"Wyoming","Big Horn County",4,9,164,81,83
050,56,003,"Wyoming","Big Horn County",4,10,156,83,73
050,56,003,"Wyoming","Big Horn County",4,11,174,98,76
050,56,003,"Wyoming","Big Horn County",4,12,169,83,86
050,56,003,"Wyoming","Big Horn County",4,13,168,88,80
050,56,003,"Wyoming","Big Horn County",4,14,177,89,88
050,56,003,"Wyoming","Big Horn County",4,15,199,107,92
050,56,003,"Wyoming","Big Horn County",4,16,189,92,97
050,56,003,"Wyoming","Big Horn County",4,17,209,110,99
050,56,003,"Wyoming","Big Horn County",4,18,151,81,70
050,56,003,"Wyoming","Big Horn County",4,19,110,61,49
050,56,003,"Wyoming","Big Horn County",4,20,103,55,48
050,56,003,"Wyoming","Big Horn County",4,21,119,59,60
050,56,003,"Wyoming","Big Horn County",4,22,125,61,64
050,56,003,"Wyoming","Big Horn County",4,23,131,68,63
050,56,003,"Wyoming","Big Horn County",4,24,123,64,59
050,56,003,"Wyoming","Big Horn County",4,25,109,61,48
050,56,003,"Wyoming","Big Horn County",4,26,113,59,54
050,56,003,"Wyoming","Big Horn County",4,27,115,53,62
050,56,003,"Wyoming","Big Horn County",4,28,131,72,59
050,56,003,"Wyoming","Big Horn County",4,29,114,55,59
050,56,003,"Wyoming","Big Horn County",4,30,109,62,47
050,56,003,"Wyoming","Big Horn County",4,31,110,48,62
050,56,003,"Wyoming","Big Horn County",4,32,134,61,73
050,56,003,"Wyoming","Big Horn County",4,33,144,72,72
050,56,003,"Wyoming","Big Horn County",4,34,119,63,56
050,56,003,"Wyoming","Big Horn County",4,35,152,82,70
050,56,003,"Wyoming","Big Horn County",4,36,140,73,67
050,56,003,"Wyoming","Big Horn County",4,37,157,82,75
050,56,003,"Wyoming","Big Horn County",4,38,133,72,61
050,56,003,"Wyoming","Big Horn County",4,39,150,83,67
050,56,003,"Wyoming","Big Horn County",4,40,157,80,77
050,56,003,"Wyoming","Big Horn County",4,41,151,74,77
050,56,003,"Wyoming","Big Horn County",4,42,143,62,81
050,56,003,"Wyoming","Big Horn County",4,43,149,85,64
050,56,003,"Wyoming","Big Horn County",4,44,151,83,68
050,56,003,"Wyoming","Big Horn County",4,45,133,70,63
050,56,003,"Wyoming","Big Horn County",4,46,122,69,53
050,56,003,"Wyoming","Big Horn County",4,47,114,59,55
050,56,003,"Wyoming","Big Horn County",4,48,123,63,60
050,56,003,"Wyoming","Big Horn County",4,49,113,61,52
050,56,003,"Wyoming","Big Horn County",4,50,123,64,59
050,56,003,"Wyoming","Big Horn County",4,51,137,67,70
050,56,003,"Wyoming","Big Horn County",4,52,119,63,56
050,56,003,"Wyoming","Big Horn County",4,53,133,63,70
050,56,003,"Wyoming","Big Horn County",4,54,127,61,66
050,56,003,"Wyoming","Big Horn County",4,55,136,63,73
050,56,003,"Wyoming","Big Horn County",4,56,148,77,71
050,56,003,"Wyoming","Big Horn County",4,57,152,85,67
050,56,003,"Wyoming","Big Horn County",4,58,158,80,78
050,56,003,"Wyoming","Big Horn County",4,59,167,82,85
050,56,003,"Wyoming","Big Horn County",4,60,168,80,88
050,56,003,"Wyoming","Big Horn County",4,61,178,84,94
050,56,003,"Wyoming","Big Horn County",4,62,165,84,81
050,56,003,"Wyoming","Big Horn County",4,63,171,93,78
050,56,003,"Wyoming","Big Horn County",4,64,191,99,92
050,56,003,"Wyoming","Big Horn County",4,65,165,86,79
050,56,003,"Wyoming","Big Horn County",4,66,185,89,96
050,56,003,"Wyoming","Big Horn County",4,67,188,90,98
050,56,003,"Wyoming","Big Horn County",4,68,170,84,86
050,56,003,"Wyoming","Big Horn County",4,69,165,86,79
050,56,003,"Wyoming","Big Horn County",4,70,140,68,72
050,56,003,"Wyoming","Big Horn County",4,71,127,64,63
050,56,003,"Wyoming","Big Horn County",4,72,127,70,57
050,56,003,"Wyoming","Big Horn County",4,73,130,65,65
050,56,003,"Wyoming","Big Horn County",4,74,131,65,66
050,56,003,"Wyoming","Big Horn County",4,75,138,72,66
050,56,003,"Wyoming","Big Horn County",4,76,83,45,38
050,56,003,"Wyoming","Big Horn County",4,77,85,41,44
050,56,003,"Wyoming","Big Horn County",4,78,85,39,46
050,56,003,"Wyoming","Big Horn County",4,79,90,45,45
050,56,003,"Wyoming","Big Horn County",4,80,73,35,38
050,56,003,"Wyoming","Big Horn County",4,81,60,33,27
050,56,003,"Wyoming","Big Horn County",4,82,62,33,29
050,56,003,"Wyoming","Big Horn County",4,83,63,31,32
050,56,003,"Wyoming","Big Horn County",4,84,43,19,24
050,56,003,"Wyoming","Big Horn County",4,85,266,94,172
050,56,003,"Wyoming","Big Horn County",5,0,132,76,56
050,56,003,"Wyoming","Big Horn County",5,1,124,72,52
050,56,003,"Wyoming","Big Horn County",5,2,119,64,55
050,56,003,"Wyoming","Big Horn County",5,3,127,71,56
050,56,003,"Wyoming","Big Horn County",5,4,111,64,47
050,56,003,"Wyoming","Big Horn County",5,5,135,78,57
050,56,003,"Wyoming","Big Horn County",5,6,164,92,72
050,56,003,"Wyoming","Big Horn County",5,7,147,77,70
050,56,003,"Wyoming","Big Horn County",5,8,178,86,92
050,56,003,"Wyoming","Big Horn County",5,9,164,88,76
050,56,003,"Wyoming","Big Horn County",5,10,163,78,85
050,56,003,"Wyoming","Big Horn County",5,11,157,84,73
050,56,003,"Wyoming","Big Horn County",5,12,179,106,73
050,56,003,"Wyoming","Big Horn County",5,13,176,87,89
050,56,003,"Wyoming","Big Horn County",5,14,180,98,82
050,56,003,"Wyoming","Big Horn County",5,15,193,98,95
050,56,003,"Wyoming","Big Horn County",5,16,203,113,90
050,56,003,"Wyoming","Big Horn County",5,17,186,89,97
050,56,003,"Wyoming","Big Horn County",5,18,179,93,86
050,56,003,"Wyoming","Big Horn County",5,19,121,67,54
050,56,003,"Wyoming","Big Horn County",5,20,113,61,52
050,56,003,"Wyoming","Big Horn County",5,21,112,58,54
050,56,003,"Wyoming","Big Horn County",5,22,125,63,62
050,56,003,"Wyoming","Big Horn County",5,23,125,61,64
050,56,003,"Wyoming","Big Horn County",5,24,136,71,65
050,56,003,"Wyoming","Big Horn County",5,25,115,58,57
050,56,003,"Wyoming","Big Horn County",5,26,111,64,47
050,56,003,"Wyoming","Big Horn County",5,27,109,58,51
050,56,003,"Wyoming","Big Horn County",5,28,125,63,62
050,56,003,"Wyoming","Big Horn County",5,29,129,66,63
050,56,003,"Wyoming","Big Horn County",5,30,113,59,54
050,56,003,"Wyoming","Big Horn County",5,31,107,64,43
050,56,003,"Wyoming","Big Horn County",5,32,109,47,62
050,56,003,"Wyoming","Big Horn County",5,33,141,68,73
050,56,003,"Wyoming","Big Horn County",5,34,142,65,77
050,56,003,"Wyoming","Big Horn County",5,35,127,72,55
050,56,003,"Wyoming","Big Horn County",5,36,148,76,72
050,56,003,"Wyoming","Big Horn County",5,37,148,74,74
050,56,003,"Wyoming","Big Horn County",5,38,158,89,69
050,56,003,"Wyoming","Big Horn County",5,39,143,77,66
050,56,003,"Wyoming","Big Horn County",5,40,165,95,70
050,56,003,"Wyoming","Big Horn County",5,41,157,80,77
050,56,003,"Wyoming","Big Horn County",5,42,162,77,85
050,56,003,"Wyoming","Big Horn County",5,43,152,70,82
050,56,003,"Wyoming","Big Horn County",5,44,156,88,68
050,56,003,"Wyoming","Big Horn County",5,45,155,85,70
050,56,003,"Wyoming","Big Horn County",5,46,136,72,64
050,56,003,"Wyoming","Big Horn County",5,47,120,67,53
050,56,003,"Wyoming","Big Horn County",5,48,112,60,52
050,56,003,"Wyoming","Big Horn County",5,49,127,60,67
050,56,003,"Wyoming","Big Horn County",5,50,123,62,61
050,56,003,"Wyoming","Big Horn County",5,51,124,65,59
050,56,003,"Wyoming","Big Horn County",5,52,137,69,68
050,56,003,"Wyoming","Big Horn County",5,53,123,70,53
050,56,003,"Wyoming","Big Horn County",5,54,136,66,70
050,56,003,"Wyoming","Big Horn County",5,55,128,61,67
050,56,003,"Wyoming","Big Horn County",5,56,138,67,71
050,56,003,"Wyoming","Big Horn County",5,57,152,79,73
050,56,003,"Wyoming","Big Horn County",5,58,158,96,62
050,56,003,"Wyoming","Big Horn County",5,59,149,69,80
050,56,003,"Wyoming","Big Horn County",5,60,167,80,87
050,56,003,"Wyoming","Big Horn County",5,61,172,80,92
050,56,003,"Wyoming","Big Horn County",5,62,187,89,98
050,56,003,"Wyoming","Big Horn County",5,63,171,87,84
050,56,003,"Wyoming","Big Horn County",5,64,180,97,83
050,56,003,"Wyoming","Big Horn County",5,65,186,97,89
050,56,003,"Wyoming","Big Horn County",5,66,169,88,81
050,56,003,"Wyoming","Big Horn County",5,67,190,90,100
050,56,003,"Wyoming","Big Horn County",5,68,182,90,92
050,56,003,"Wyoming","Big Horn County",5,69,169,82,87
050,56,003,"Wyoming","Big Horn County",5,70,163,85,78
050,56,003,"Wyoming","Big Horn County",5,71,128,65,63
050,56,003,"Wyoming","Big Horn County",5,72,131,67,64
050,56,003,"Wyoming","Big Horn County",5,73,125,71,54
050,56,003,"Wyoming","Big Horn County",5,74,127,63,64
050,56,003,"Wyoming","Big Horn County",5,75,123,60,63
050,56,003,"Wyoming","Big Horn County",5,76,129,68,61
050,56,003,"Wyoming","Big Horn County",5,77,78,42,36
050,56,003,"Wyoming","Big Horn County",5,78,84,39,45
050,56,003,"Wyoming","Big Horn County",5,79,84,38,46
050,56,003,"Wyoming","Big Horn County",5,80,81,38,43
050,56,003,"Wyoming","Big Horn County",5,81,68,35,33
050,56,003,"Wyoming","Big Horn County",5,82,56,30,26
050,56,003,"Wyoming","Big Horn County",5,83,59,31,28
050,56,003,"Wyoming","Big Horn County",5,84,50,24,26
050,56,003,"Wyoming","Big Horn County",5,85,275,99,176
050,56,005,"Wyoming","Campbell County",1,0,576,291,285
050,56,005,"Wyoming","Campbell County",1,1,590,287,303
050,56,005,"Wyoming","Campbell County",1,2,650,319,331
050,56,005,"Wyoming","Campbell County",1,3,691,341,350
050,56,005,"Wyoming","Campbell County",1,4,769,385,384
050,56,005,"Wyoming","Campbell County",1,5,699,361,338
050,56,005,"Wyoming","Campbell County",1,6,666,325,341
050,56,005,"Wyoming","Campbell County",1,7,674,343,331
050,56,005,"Wyoming","Campbell County",1,8,714,362,352
050,56,005,"Wyoming","Campbell County",1,9,689,362,327
050,56,005,"Wyoming","Campbell County",1,10,779,389,390
050,56,005,"Wyoming","Campbell County",1,11,818,398,420
050,56,005,"Wyoming","Campbell County",1,12,830,408,422
050,56,005,"Wyoming","Campbell County",1,13,792,410,382
050,56,005,"Wyoming","Campbell County",1,14,729,366,363
050,56,005,"Wyoming","Campbell County",1,15,747,362,385
050,56,005,"Wyoming","Campbell County",1,16,713,372,341
050,56,005,"Wyoming","Campbell County",1,17,669,366,303
050,56,005,"Wyoming","Campbell County",1,18,569,310,259
050,56,005,"Wyoming","Campbell County",1,19,491,272,219
050,56,005,"Wyoming","Campbell County",1,20,515,289,226
050,56,005,"Wyoming","Campbell County",1,21,520,282,238
050,56,005,"Wyoming","Campbell County",1,22,541,291,250
050,56,005,"Wyoming","Campbell County",1,23,531,278,253
050,56,005,"Wyoming","Campbell County",1,24,544,282,262
050,56,005,"Wyoming","Campbell County",1,25,564,300,264
050,56,005,"Wyoming","Campbell County",1,26,586,312,274
050,56,005,"Wyoming","Campbell County",1,27,618,305,313
050,56,005,"Wyoming","Campbell County",1,28,681,346,335
050,56,005,"Wyoming","Campbell County",1,29,716,361,355
050,56,005,"Wyoming","Campbell County",1,30,707,338,369
050,56,005,"Wyoming","Campbell County",1,31,668,331,337
050,56,005,"Wyoming","Campbell County",1,32,692,360,332
050,56,005,"Wyoming","Campbell County",1,33,724,383,341
050,56,005,"Wyoming","Campbell County",1,34,777,436,341
050,56,005,"Wyoming","Campbell County",1,35,789,427,362
050,56,005,"Wyoming","Campbell County",1,36,759,410,349
050,56,005,"Wyoming","Campbell County",1,37,767,399,368
050,56,005,"Wyoming","Campbell County",1,38,728,395,333
050,56,005,"Wyoming","Campbell County",1,39,703,350,353
050,56,005,"Wyoming","Campbell County",1,40,680,356,324
050,56,005,"Wyoming","Campbell County",1,41,691,362,329
050,56,005,"Wyoming","Campbell County",1,42,641,344,297
050,56,005,"Wyoming","Campbell County",1,43,608,330,278
050,56,005,"Wyoming","Campbell County",1,44,582,297,285
050,56,005,"Wyoming","Campbell County",1,45,579,289,290
050,56,005,"Wyoming","Campbell County",1,46,560,296,264
050,56,005,"Wyoming","Campbell County",1,47,525,271,254
050,56,005,"Wyoming","Campbell County",1,48,530,278,252
050,56,005,"Wyoming","Campbell County",1,49,561,311,250
050,56,005,"Wyoming","Campbell County",1,50,525,285,240
050,56,005,"Wyoming","Campbell County",1,51,524,262,262
050,56,005,"Wyoming","Campbell County",1,52,477,243,234
050,56,005,"Wyoming","Campbell County",1,53,470,238,232
050,56,005,"Wyoming","Campbell County",1,54,516,271,245
050,56,005,"Wyoming","Campbell County",1,55,524,252,272
050,56,005,"Wyoming","Campbell County",1,56,584,296,288
050,56,005,"Wyoming","Campbell County",1,57,624,312,312
050,56,005,"Wyoming","Campbell County",1,58,644,317,327
050,56,005,"Wyoming","Campbell County",1,59,682,349,333
050,56,005,"Wyoming","Campbell County",1,60,693,368,325
050,56,005,"Wyoming","Campbell County",1,61,713,388,325
050,56,005,"Wyoming","Campbell County",1,62,665,362,303
050,56,005,"Wyoming","Campbell County",1,63,608,329,279
050,56,005,"Wyoming","Campbell County",1,64,574,303,271
050,56,005,"Wyoming","Campbell County",1,65,557,311,246
050,56,005,"Wyoming","Campbell County",1,66,502,266,236
050,56,005,"Wyoming","Campbell County",1,67,471,244,227
050,56,005,"Wyoming","Campbell County",1,68,416,213,203
050,56,005,"Wyoming","Campbell County",1,69,364,183,181
050,56,005,"Wyoming","Campbell County",1,70,358,178,180
050,56,005,"Wyoming","Campbell County",1,71,312,160,152
050,56,005,"Wyoming","Campbell County",1,72,306,146,160
050,56,005,"Wyoming","Campbell County",1,73,282,147,135
050,56,005,"Wyoming","Campbell County",1,74,169,88,81
050,56,005,"Wyoming","Campbell County",1,75,169,81,88
050,56,005,"Wyoming","Campbell County",1,76,170,76,94
050,56,005,"Wyoming","Campbell County",1,77,154,67,87
050,56,005,"Wyoming","Campbell County",1,78,127,61,66
050,56,005,"Wyoming","Campbell County",1,79,115,51,64
050,56,005,"Wyoming","Campbell County",1,80,101,45,56
050,56,005,"Wyoming","Campbell County",1,81,89,33,56
050,56,005,"Wyoming","Campbell County",1,82,76,31,45
050,56,005,"Wyoming","Campbell County",1,83,76,30,46
050,56,005,"Wyoming","Campbell County",1,84,68,29,39
050,56,005,"Wyoming","Campbell County",1,85,383,143,240
050,56,005,"Wyoming","Campbell County",2,0,583,291,292
050,56,005,"Wyoming","Campbell County",2,1,593,288,305
050,56,005,"Wyoming","Campbell County",2,2,633,308,325
050,56,005,"Wyoming","Campbell County",2,3,683,335,348
050,56,005,"Wyoming","Campbell County",2,4,751,377,374
050,56,005,"Wyoming","Campbell County",2,5,707,361,346
050,56,005,"Wyoming","Campbell County",2,6,672,332,340
050,56,005,"Wyoming","Campbell County",2,7,676,339,337
050,56,005,"Wyoming","Campbell County",2,8,701,356,345
050,56,005,"Wyoming","Campbell County",2,9,692,360,332
050,56,005,"Wyoming","Campbell County",2,10,757,382,375
050,56,005,"Wyoming","Campbell County",2,11,808,394,414
050,56,005,"Wyoming","Campbell County",2,12,828,405,423
050,56,005,"Wyoming","Campbell County",2,13,803,410,393
050,56,005,"Wyoming","Campbell County",2,14,750,377,373
050,56,005,"Wyoming","Campbell County",2,15,746,365,381
050,56,005,"Wyoming","Campbell County",2,16,727,372,355
050,56,005,"Wyoming","Campbell County",2,17,684,370,314
050,56,005,"Wyoming","Campbell County",2,18,574,313,261
050,56,005,"Wyoming","Campbell County",2,19,496,277,219
050,56,005,"Wyoming","Campbell County",2,20,521,291,230
050,56,005,"Wyoming","Campbell County",2,21,526,288,238
050,56,005,"Wyoming","Campbell County",2,22,551,294,257
050,56,005,"Wyoming","Campbell County",2,23,544,284,260
050,56,005,"Wyoming","Campbell County",2,24,550,285,265
050,56,005,"Wyoming","Campbell County",2,25,567,304,263
050,56,005,"Wyoming","Campbell County",2,26,587,314,273
050,56,005,"Wyoming","Campbell County",2,27,612,308,304
050,56,005,"Wyoming","Campbell County",2,28,671,340,331
050,56,005,"Wyoming","Campbell County",2,29,711,360,351
050,56,005,"Wyoming","Campbell County",2,30,713,344,369
050,56,005,"Wyoming","Campbell County",2,31,673,330,343
050,56,005,"Wyoming","Campbell County",2,32,688,355,333
050,56,005,"Wyoming","Campbell County",2,33,718,380,338
050,56,005,"Wyoming","Campbell County",2,34,766,423,343
050,56,005,"Wyoming","Campbell County",2,35,790,433,357
050,56,005,"Wyoming","Campbell County",2,36,756,410,346
050,56,005,"Wyoming","Campbell County",2,37,764,401,363
050,56,005,"Wyoming","Campbell County",2,38,739,396,343
050,56,005,"Wyoming","Campbell County",2,39,708,361,347
050,56,005,"Wyoming","Campbell County",2,40,686,355,331
050,56,005,"Wyoming","Campbell County",2,41,691,364,327
050,56,005,"Wyoming","Campbell County",2,42,648,344,304
050,56,005,"Wyoming","Campbell County",2,43,621,336,285
050,56,005,"Wyoming","Campbell County",2,44,581,303,278
050,56,005,"Wyoming","Campbell County",2,45,583,293,290
050,56,005,"Wyoming","Campbell County",2,46,564,292,272
050,56,005,"Wyoming","Campbell County",2,47,531,273,258
050,56,005,"Wyoming","Campbell County",2,48,531,276,255
050,56,005,"Wyoming","Campbell County",2,49,551,300,251
050,56,005,"Wyoming","Campbell County",2,50,536,292,244
050,56,005,"Wyoming","Campbell County",2,51,522,266,256
050,56,005,"Wyoming","Campbell County",2,52,485,247,238
050,56,005,"Wyoming","Campbell County",2,53,470,239,231
050,56,005,"Wyoming","Campbell County",2,54,501,260,241
050,56,005,"Wyoming","Campbell County",2,55,521,257,264
050,56,005,"Wyoming","Campbell County",2,56,568,284,284
050,56,005,"Wyoming","Campbell County",2,57,613,307,306
050,56,005,"Wyoming","Campbell County",2,58,632,312,320
050,56,005,"Wyoming","Campbell County",2,59,675,341,334
050,56,005,"Wyoming","Campbell County",2,60,681,356,325
050,56,005,"Wyoming","Campbell County",2,61,703,380,323
050,56,005,"Wyoming","Campbell County",2,62,670,363,307
050,56,005,"Wyoming","Campbell County",2,63,622,337,285
050,56,005,"Wyoming","Campbell County",2,64,574,307,267
050,56,005,"Wyoming","Campbell County",2,65,557,307,250
050,56,005,"Wyoming","Campbell County",2,66,518,277,241
050,56,005,"Wyoming","Campbell County",2,67,478,249,229
050,56,005,"Wyoming","Campbell County",2,68,423,217,206
050,56,005,"Wyoming","Campbell County",2,69,377,190,187
050,56,005,"Wyoming","Campbell County",2,70,359,177,182
050,56,005,"Wyoming","Campbell County",2,71,325,166,159
050,56,005,"Wyoming","Campbell County",2,72,299,146,153
050,56,005,"Wyoming","Campbell County",2,73,299,153,146
050,56,005,"Wyoming","Campbell County",2,74,183,95,88
050,56,005,"Wyoming","Campbell County",2,75,170,84,86
050,56,005,"Wyoming","Campbell County",2,76,168,75,93
050,56,005,"Wyoming","Campbell County",2,77,162,72,90
050,56,005,"Wyoming","Campbell County",2,78,128,61,67
050,56,005,"Wyoming","Campbell County",2,79,117,53,64
050,56,005,"Wyoming","Campbell County",2,80,103,42,61
050,56,005,"Wyoming","Campbell County",2,81,91,34,57
050,56,005,"Wyoming","Campbell County",2,82,78,32,46
050,56,005,"Wyoming","Campbell County",2,83,76,30,46
050,56,005,"Wyoming","Campbell County",2,84,69,29,40
050,56,005,"Wyoming","Campbell County",2,85,388,144,244
050,56,005,"Wyoming","Campbell County",3,0,619,319,300
050,56,005,"Wyoming","Campbell County",3,1,580,279,301
050,56,005,"Wyoming","Campbell County",3,2,581,286,295
050,56,005,"Wyoming","Campbell County",3,3,622,310,312
050,56,005,"Wyoming","Campbell County",3,4,679,333,346
050,56,005,"Wyoming","Campbell County",3,5,737,372,365
050,56,005,"Wyoming","Campbell County",3,6,710,357,353
050,56,005,"Wyoming","Campbell County",3,7,655,321,334
050,56,005,"Wyoming","Campbell County",3,8,661,338,323
050,56,005,"Wyoming","Campbell County",3,9,697,358,339
050,56,005,"Wyoming","Campbell County",3,10,701,352,349
050,56,005,"Wyoming","Campbell County",3,11,748,384,364
050,56,005,"Wyoming","Campbell County",3,12,798,381,417
050,56,005,"Wyoming","Campbell County",3,13,801,402,399
050,56,005,"Wyoming","Campbell County",3,14,781,393,388
050,56,005,"Wyoming","Campbell County",3,15,746,380,366
050,56,005,"Wyoming","Campbell County",3,16,721,342,379
050,56,005,"Wyoming","Campbell County",3,17,719,367,352
050,56,005,"Wyoming","Campbell County",3,18,595,328,267
050,56,005,"Wyoming","Campbell County",3,19,483,273,210
050,56,005,"Wyoming","Campbell County",3,20,475,272,203
050,56,005,"Wyoming","Campbell County",3,21,505,263,242
050,56,005,"Wyoming","Campbell County",3,22,539,298,241
050,56,005,"Wyoming","Campbell County",3,23,577,300,277
050,56,005,"Wyoming","Campbell County",3,24,516,250,266
050,56,005,"Wyoming","Campbell County",3,25,537,272,265
050,56,005,"Wyoming","Campbell County",3,26,554,299,255
050,56,005,"Wyoming","Campbell County",3,27,563,292,271
050,56,005,"Wyoming","Campbell County",3,28,589,292,297
050,56,005,"Wyoming","Campbell County",3,29,681,345,336
050,56,005,"Wyoming","Campbell County",3,30,698,337,361
050,56,005,"Wyoming","Campbell County",3,31,667,318,349
050,56,005,"Wyoming","Campbell County",3,32,662,329,333
050,56,005,"Wyoming","Campbell County",3,33,654,332,322
050,56,005,"Wyoming","Campbell County",3,34,710,377,333
050,56,005,"Wyoming","Campbell County",3,35,738,414,324
050,56,005,"Wyoming","Campbell County",3,36,779,426,353
050,56,005,"Wyoming","Campbell County",3,37,751,400,351
050,56,005,"Wyoming","Campbell County",3,38,751,398,353
050,56,005,"Wyoming","Campbell County",3,39,738,398,340
050,56,005,"Wyoming","Campbell County",3,40,666,335,331
050,56,005,"Wyoming","Campbell County",3,41,662,352,310
050,56,005,"Wyoming","Campbell County",3,42,665,350,315
050,56,005,"Wyoming","Campbell County",3,43,638,346,292
050,56,005,"Wyoming","Campbell County",3,44,608,327,281
050,56,005,"Wyoming","Campbell County",3,45,570,293,277
050,56,005,"Wyoming","Campbell County",3,46,567,283,284
050,56,005,"Wyoming","Campbell County",3,47,550,282,268
050,56,005,"Wyoming","Campbell County",3,48,513,266,247
050,56,005,"Wyoming","Campbell County",3,49,511,259,252
050,56,005,"Wyoming","Campbell County",3,50,526,290,236
050,56,005,"Wyoming","Campbell County",3,51,521,283,238
050,56,005,"Wyoming","Campbell County",3,52,510,262,248
050,56,005,"Wyoming","Campbell County",3,53,488,251,237
050,56,005,"Wyoming","Campbell County",3,54,469,237,232
050,56,005,"Wyoming","Campbell County",3,55,491,254,237
050,56,005,"Wyoming","Campbell County",3,56,512,252,260
050,56,005,"Wyoming","Campbell County",3,57,558,283,275
050,56,005,"Wyoming","Campbell County",3,58,588,293,295
050,56,005,"Wyoming","Campbell County",3,59,609,282,327
050,56,005,"Wyoming","Campbell County",3,60,684,339,345
050,56,005,"Wyoming","Campbell County",3,61,667,346,321
050,56,005,"Wyoming","Campbell County",3,62,690,372,318
050,56,005,"Wyoming","Campbell County",3,63,649,350,299
050,56,005,"Wyoming","Campbell County",3,64,607,328,279
050,56,005,"Wyoming","Campbell County",3,65,553,297,256
050,56,005,"Wyoming","Campbell County",3,66,541,291,250
050,56,005,"Wyoming","Campbell County",3,67,514,276,238
050,56,005,"Wyoming","Campbell County",3,68,463,241,222
050,56,005,"Wyoming","Campbell County",3,69,417,209,208
050,56,005,"Wyoming","Campbell County",3,70,367,183,184
050,56,005,"Wyoming","Campbell County",3,71,341,162,179
050,56,005,"Wyoming","Campbell County",3,72,312,163,149
050,56,005,"Wyoming","Campbell County",3,73,289,141,148
050,56,005,"Wyoming","Campbell County",3,74,298,151,147
050,56,005,"Wyoming","Campbell County",3,75,176,92,84
050,56,005,"Wyoming","Campbell County",3,76,161,77,84
050,56,005,"Wyoming","Campbell County",3,77,163,75,88
050,56,005,"Wyoming","Campbell County",3,78,151,65,86
050,56,005,"Wyoming","Campbell County",3,79,121,59,62
050,56,005,"Wyoming","Campbell County",3,80,125,60,65
050,56,005,"Wyoming","Campbell County",3,81,95,37,58
050,56,005,"Wyoming","Campbell County",3,82,79,28,51
050,56,005,"Wyoming","Campbell County",3,83,81,31,50
050,56,005,"Wyoming","Campbell County",3,84,66,24,42
050,56,005,"Wyoming","Campbell County",3,85,393,142,251
050,56,005,"Wyoming","Campbell County",4,0,574,297,277
050,56,005,"Wyoming","Campbell County",4,1,617,315,302
050,56,005,"Wyoming","Campbell County",4,2,588,296,292
050,56,005,"Wyoming","Campbell County",4,3,599,297,302
050,56,005,"Wyoming","Campbell County",4,4,622,304,318
050,56,005,"Wyoming","Campbell County",4,5,676,344,332
050,56,005,"Wyoming","Campbell County",4,6,725,372,353
050,56,005,"Wyoming","Campbell County",4,7,722,363,359
050,56,005,"Wyoming","Campbell County",4,8,660,333,327
050,56,005,"Wyoming","Campbell County",4,9,673,345,328
050,56,005,"Wyoming","Campbell County",4,10,704,354,350
050,56,005,"Wyoming","Campbell County",4,11,708,360,348
050,56,005,"Wyoming","Campbell County",4,12,767,392,375
050,56,005,"Wyoming","Campbell County",4,13,796,387,409
050,56,005,"Wyoming","Campbell County",4,14,808,407,401
050,56,005,"Wyoming","Campbell County",4,15,797,388,409
050,56,005,"Wyoming","Campbell County",4,16,751,385,366
050,56,005,"Wyoming","Campbell County",4,17,718,342,376
050,56,005,"Wyoming","Campbell County",4,18,627,323,304
050,56,005,"Wyoming","Campbell County",4,19,520,305,215
050,56,005,"Wyoming","Campbell County",4,20,474,273,201
050,56,005,"Wyoming","Campbell County",4,21,487,275,212
050,56,005,"Wyoming","Campbell County",4,22,522,286,236
050,56,005,"Wyoming","Campbell County",4,23,577,312,265
050,56,005,"Wyoming","Campbell County",4,24,584,300,284
050,56,005,"Wyoming","Campbell County",4,25,524,255,269
050,56,005,"Wyoming","Campbell County",4,26,570,294,276
050,56,005,"Wyoming","Campbell County",4,27,545,290,255
050,56,005,"Wyoming","Campbell County",4,28,587,315,272
050,56,005,"Wyoming","Campbell County",4,29,649,314,335
050,56,005,"Wyoming","Campbell County",4,30,707,353,354
050,56,005,"Wyoming","Campbell County",4,31,672,324,348
050,56,005,"Wyoming","Campbell County",4,32,701,338,363
050,56,005,"Wyoming","Campbell County",4,33,660,334,326
050,56,005,"Wyoming","Campbell County",4,34,668,343,325
050,56,005,"Wyoming","Campbell County",4,35,721,383,338
050,56,005,"Wyoming","Campbell County",4,36,736,412,324
050,56,005,"Wyoming","Campbell County",4,37,786,435,351
050,56,005,"Wyoming","Campbell County",4,38,751,404,347
050,56,005,"Wyoming","Campbell County",4,39,755,402,353
050,56,005,"Wyoming","Campbell County",4,40,738,395,343
050,56,005,"Wyoming","Campbell County",4,41,689,356,333
050,56,005,"Wyoming","Campbell County",4,42,645,331,314
050,56,005,"Wyoming","Campbell County",4,43,673,349,324
050,56,005,"Wyoming","Campbell County",4,44,622,337,285
050,56,005,"Wyoming","Campbell County",4,45,621,339,282
050,56,005,"Wyoming","Campbell County",4,46,577,295,282
050,56,005,"Wyoming","Campbell County",4,47,561,283,278
050,56,005,"Wyoming","Campbell County",4,48,538,272,266
050,56,005,"Wyoming","Campbell County",4,49,512,264,248
050,56,005,"Wyoming","Campbell County",4,50,496,258,238
050,56,005,"Wyoming","Campbell County",4,51,527,288,239
050,56,005,"Wyoming","Campbell County",4,52,540,290,250
050,56,005,"Wyoming","Campbell County",4,53,501,261,240
050,56,005,"Wyoming","Campbell County",4,54,478,253,225
050,56,005,"Wyoming","Campbell County",4,55,458,231,227
050,56,005,"Wyoming","Campbell County",4,56,476,237,239
050,56,005,"Wyoming","Campbell County",4,57,500,241,259
050,56,005,"Wyoming","Campbell County",4,58,566,285,281
050,56,005,"Wyoming","Campbell County",4,59,591,294,297
050,56,005,"Wyoming","Campbell County",4,60,616,285,331
050,56,005,"Wyoming","Campbell County",4,61,681,335,346
050,56,005,"Wyoming","Campbell County",4,62,661,339,322
050,56,005,"Wyoming","Campbell County",4,63,673,361,312
050,56,005,"Wyoming","Campbell County",4,64,640,352,288
050,56,005,"Wyoming","Campbell County",4,65,591,318,273
050,56,005,"Wyoming","Campbell County",4,66,554,299,255
050,56,005,"Wyoming","Campbell County",4,67,528,281,247
050,56,005,"Wyoming","Campbell County",4,68,500,268,232
050,56,005,"Wyoming","Campbell County",4,69,453,233,220
050,56,005,"Wyoming","Campbell County",4,70,422,213,209
050,56,005,"Wyoming","Campbell County",4,71,367,176,191
050,56,005,"Wyoming","Campbell County",4,72,328,159,169
050,56,005,"Wyoming","Campbell County",4,73,317,172,145
050,56,005,"Wyoming","Campbell County",4,74,282,137,145
050,56,005,"Wyoming","Campbell County",4,75,289,143,146
050,56,005,"Wyoming","Campbell County",4,76,179,90,89
050,56,005,"Wyoming","Campbell County",4,77,157,78,79
050,56,005,"Wyoming","Campbell County",4,78,157,70,87
050,56,005,"Wyoming","Campbell County",4,79,147,62,85
050,56,005,"Wyoming","Campbell County",4,80,127,59,68
050,56,005,"Wyoming","Campbell County",4,81,108,47,61
050,56,005,"Wyoming","Campbell County",4,82,90,32,58
050,56,005,"Wyoming","Campbell County",4,83,80,30,50
050,56,005,"Wyoming","Campbell County",4,84,71,20,51
050,56,005,"Wyoming","Campbell County",4,85,404,145,259
050,56,005,"Wyoming","Campbell County",5,0,562,290,272
050,56,005,"Wyoming","Campbell County",5,1,578,298,280
050,56,005,"Wyoming","Campbell County",5,2,637,325,312
050,56,005,"Wyoming","Campbell County",5,3,616,313,303
050,56,005,"Wyoming","Campbell County",5,4,625,307,318
050,56,005,"Wyoming","Campbell County",5,5,637,315,322
050,56,005,"Wyoming","Campbell County",5,6,678,343,335
050,56,005,"Wyoming","Campbell County",5,7,731,371,360
050,56,005,"Wyoming","Campbell County",5,8,732,365,367
050,56,005,"Wyoming","Campbell County",5,9,673,342,331
050,56,005,"Wyoming","Campbell County",5,10,672,348,324
050,56,005,"Wyoming","Campbell County",5,11,711,355,356
050,56,005,"Wyoming","Campbell County",5,12,703,352,351
050,56,005,"Wyoming","Campbell County",5,13,756,387,369
050,56,005,"Wyoming","Campbell County",5,14,810,388,422
050,56,005,"Wyoming","Campbell County",5,15,785,391,394
050,56,005,"Wyoming","Campbell County",5,16,820,400,420
050,56,005,"Wyoming","Campbell County",5,17,751,383,368
050,56,005,"Wyoming","Campbell County",5,18,609,286,323
050,56,005,"Wyoming","Campbell County",5,19,543,296,247
050,56,005,"Wyoming","Campbell County",5,20,522,293,229
050,56,005,"Wyoming","Campbell County",5,21,490,279,211
050,56,005,"Wyoming","Campbell County",5,22,518,284,234
050,56,005,"Wyoming","Campbell County",5,23,580,321,259
050,56,005,"Wyoming","Campbell County",5,24,559,294,265
050,56,005,"Wyoming","Campbell County",5,25,588,300,288
050,56,005,"Wyoming","Campbell County",5,26,532,263,269
050,56,005,"Wyoming","Campbell County",5,27,570,291,279
050,56,005,"Wyoming","Campbell County",5,28,550,287,263
050,56,005,"Wyoming","Campbell County",5,29,629,334,295
050,56,005,"Wyoming","Campbell County",5,30,669,314,355
050,56,005,"Wyoming","Campbell County",5,31,697,344,353
050,56,005,"Wyoming","Campbell County",5,32,696,343,353
050,56,005,"Wyoming","Campbell County",5,33,683,329,354
050,56,005,"Wyoming","Campbell County",5,34,688,355,333
050,56,005,"Wyoming","Campbell County",5,35,671,338,333
050,56,005,"Wyoming","Campbell County",5,36,723,382,341
050,56,005,"Wyoming","Campbell County",5,37,739,400,339
050,56,005,"Wyoming","Campbell County",5,38,786,437,349
050,56,005,"Wyoming","Campbell County",5,39,764,406,358
050,56,005,"Wyoming","Campbell County",5,40,732,390,342
050,56,005,"Wyoming","Campbell County",5,41,754,406,348
050,56,005,"Wyoming","Campbell County",5,42,674,344,330
050,56,005,"Wyoming","Campbell County",5,43,647,336,311
050,56,005,"Wyoming","Campbell County",5,44,662,345,317
050,56,005,"Wyoming","Campbell County",5,45,638,347,291
050,56,005,"Wyoming","Campbell County",5,46,623,343,280
050,56,005,"Wyoming","Campbell County",5,47,581,296,285
050,56,005,"Wyoming","Campbell County",5,48,563,286,277
050,56,005,"Wyoming","Campbell County",5,49,556,276,280
050,56,005,"Wyoming","Campbell County",5,50,508,263,245
050,56,005,"Wyoming","Campbell County",5,51,493,253,240
050,56,005,"Wyoming","Campbell County",5,52,531,288,243
050,56,005,"Wyoming","Campbell County",5,53,527,286,241
050,56,005,"Wyoming","Campbell County",5,54,497,259,238
050,56,005,"Wyoming","Campbell County",5,55,479,242,237
050,56,005,"Wyoming","Campbell County",5,56,466,235,231
050,56,005,"Wyoming","Campbell County",5,57,473,239,234
050,56,005,"Wyoming","Campbell County",5,58,505,250,255
050,56,005,"Wyoming","Campbell County",5,59,558,284,274
050,56,005,"Wyoming","Campbell County",5,60,603,307,296
050,56,005,"Wyoming","Campbell County",5,61,602,282,320
050,56,005,"Wyoming","Campbell County",5,62,667,325,342
050,56,005,"Wyoming","Campbell County",5,63,654,337,317
050,56,005,"Wyoming","Campbell County",5,64,662,349,313
050,56,005,"Wyoming","Campbell County",5,65,616,341,275
050,56,005,"Wyoming","Campbell County",5,66,573,308,265
050,56,005,"Wyoming","Campbell County",5,67,547,297,250
050,56,005,"Wyoming","Campbell County",5,68,531,282,249
050,56,005,"Wyoming","Campbell County",5,69,482,254,228
050,56,005,"Wyoming","Campbell County",5,70,450,229,221
050,56,005,"Wyoming","Campbell County",5,71,418,211,207
050,56,005,"Wyoming","Campbell County",5,72,349,167,182
050,56,005,"Wyoming","Campbell County",5,73,320,155,165
050,56,005,"Wyoming","Campbell County",5,74,312,169,143
050,56,005,"Wyoming","Campbell County",5,75,265,131,134
050,56,005,"Wyoming","Campbell County",5,76,288,140,148
050,56,005,"Wyoming","Campbell County",5,77,175,89,86
050,56,005,"Wyoming","Campbell County",5,78,151,72,79
050,56,005,"Wyoming","Campbell County",5,79,146,65,81
050,56,005,"Wyoming","Campbell County",5,80,152,62,90
050,56,005,"Wyoming","Campbell County",5,81,111,47,64
050,56,005,"Wyoming","Campbell County",5,82,99,42,57
050,56,005,"Wyoming","Campbell County",5,83,89,30,59
050,56,005,"Wyoming","Campbell County",5,84,72,24,48
050,56,005,"Wyoming","Campbell County",5,85,414,148,266
050,56,007,"Wyoming","Carbon County",1,0,167,86,81
050,56,007,"Wyoming","Carbon County",1,1,159,85,74
050,56,007,"Wyoming","Carbon County",1,2,167,94,73
050,56,007,"Wyoming","Carbon County",1,3,192,107,85
050,56,007,"Wyoming","Carbon County",1,4,207,110,97
050,56,007,"Wyoming","Carbon County",1,5,182,92,90
050,56,007,"Wyoming","Carbon County",1,6,181,86,95
050,56,007,"Wyoming","Carbon County",1,7,180,89,91
050,56,007,"Wyoming","Carbon County",1,8,182,95,87
050,56,007,"Wyoming","Carbon County",1,9,184,92,92
050,56,007,"Wyoming","Carbon County",1,10,189,98,91
050,56,007,"Wyoming","Carbon County",1,11,196,110,86
050,56,007,"Wyoming","Carbon County",1,12,201,106,95
050,56,007,"Wyoming","Carbon County",1,13,203,106,97
050,56,007,"Wyoming","Carbon County",1,14,186,95,91
050,56,007,"Wyoming","Carbon County",1,15,174,94,80
050,56,007,"Wyoming","Carbon County",1,16,194,102,92
050,56,007,"Wyoming","Carbon County",1,17,188,92,96
050,56,007,"Wyoming","Carbon County",1,18,164,92,72
050,56,007,"Wyoming","Carbon County",1,19,132,79,53
050,56,007,"Wyoming","Carbon County",1,20,144,86,58
050,56,007,"Wyoming","Carbon County",1,21,160,95,65
050,56,007,"Wyoming","Carbon County",1,22,147,88,59
050,56,007,"Wyoming","Carbon County",1,23,157,93,64
050,56,007,"Wyoming","Carbon County",1,24,161,85,76
050,56,007,"Wyoming","Carbon County",1,25,154,90,64
050,56,007,"Wyoming","Carbon County",1,26,189,99,90
050,56,007,"Wyoming","Carbon County",1,27,188,102,86
050,56,007,"Wyoming","Carbon County",1,28,192,106,86
050,56,007,"Wyoming","Carbon County",1,29,197,108,89
050,56,007,"Wyoming","Carbon County",1,30,233,138,95
050,56,007,"Wyoming","Carbon County",1,31,219,129,90
050,56,007,"Wyoming","Carbon County",1,32,178,99,79
050,56,007,"Wyoming","Carbon County",1,33,203,114,89
050,56,007,"Wyoming","Carbon County",1,34,206,106,100
050,56,007,"Wyoming","Carbon County",1,35,205,114,91
050,56,007,"Wyoming","Carbon County",1,36,220,129,91
050,56,007,"Wyoming","Carbon County",1,37,197,117,80
050,56,007,"Wyoming","Carbon County",1,38,199,112,87
050,56,007,"Wyoming","Carbon County",1,39,190,106,84
050,56,007,"Wyoming","Carbon County",1,40,191,101,90
050,56,007,"Wyoming","Carbon County",1,41,205,111,94
050,56,007,"Wyoming","Carbon County",1,42,177,103,74
050,56,007,"Wyoming","Carbon County",1,43,175,96,79
050,56,007,"Wyoming","Carbon County",1,44,183,110,73
050,56,007,"Wyoming","Carbon County",1,45,185,103,82
050,56,007,"Wyoming","Carbon County",1,46,172,93,79
050,56,007,"Wyoming","Carbon County",1,47,151,81,70
050,56,007,"Wyoming","Carbon County",1,48,152,87,65
050,56,007,"Wyoming","Carbon County",1,49,165,91,74
050,56,007,"Wyoming","Carbon County",1,50,165,89,76
050,56,007,"Wyoming","Carbon County",1,51,153,75,78
050,56,007,"Wyoming","Carbon County",1,52,149,86,63
050,56,007,"Wyoming","Carbon County",1,53,138,75,63
050,56,007,"Wyoming","Carbon County",1,54,174,96,78
050,56,007,"Wyoming","Carbon County",1,55,178,85,93
050,56,007,"Wyoming","Carbon County",1,56,186,86,100
050,56,007,"Wyoming","Carbon County",1,57,198,100,98
050,56,007,"Wyoming","Carbon County",1,58,207,109,98
050,56,007,"Wyoming","Carbon County",1,59,213,122,91
050,56,007,"Wyoming","Carbon County",1,60,204,117,87
050,56,007,"Wyoming","Carbon County",1,61,205,107,98
050,56,007,"Wyoming","Carbon County",1,62,231,125,106
050,56,007,"Wyoming","Carbon County",1,63,226,116,110
050,56,007,"Wyoming","Carbon County",1,64,206,116,90
050,56,007,"Wyoming","Carbon County",1,65,197,105,92
050,56,007,"Wyoming","Carbon County",1,66,193,107,86
050,56,007,"Wyoming","Carbon County",1,67,196,95,101
050,56,007,"Wyoming","Carbon County",1,68,156,78,78
050,56,007,"Wyoming","Carbon County",1,69,164,81,83
050,56,007,"Wyoming","Carbon County",1,70,167,92,75
050,56,007,"Wyoming","Carbon County",1,71,154,80,74
050,56,007,"Wyoming","Carbon County",1,72,150,83,67
050,56,007,"Wyoming","Carbon County",1,73,142,79,63
050,56,007,"Wyoming","Carbon County",1,74,95,49,46
050,56,007,"Wyoming","Carbon County",1,75,96,51,45
050,56,007,"Wyoming","Carbon County",1,76,116,67,49
050,56,007,"Wyoming","Carbon County",1,77,97,49,48
050,56,007,"Wyoming","Carbon County",1,78,77,33,44
050,56,007,"Wyoming","Carbon County",1,79,79,39,40
050,56,007,"Wyoming","Carbon County",1,80,70,33,37
050,56,007,"Wyoming","Carbon County",1,81,61,32,29
050,56,007,"Wyoming","Carbon County",1,82,48,21,27
050,56,007,"Wyoming","Carbon County",1,83,42,22,20
050,56,007,"Wyoming","Carbon County",1,84,45,20,25
050,56,007,"Wyoming","Carbon County",1,85,234,95,139
050,56,007,"Wyoming","Carbon County",2,0,163,88,75
050,56,007,"Wyoming","Carbon County",2,1,159,84,75
050,56,007,"Wyoming","Carbon County",2,2,165,91,74
050,56,007,"Wyoming","Carbon County",2,3,184,103,81
050,56,007,"Wyoming","Carbon County",2,4,204,110,94
050,56,007,"Wyoming","Carbon County",2,5,189,95,94
050,56,007,"Wyoming","Carbon County",2,6,180,86,94
050,56,007,"Wyoming","Carbon County",2,7,178,88,90
050,56,007,"Wyoming","Carbon County",2,8,180,93,87
050,56,007,"Wyoming","Carbon County",2,9,182,92,90
050,56,007,"Wyoming","Carbon County",2,10,185,96,89
050,56,007,"Wyoming","Carbon County",2,11,195,109,86
050,56,007,"Wyoming","Carbon County",2,12,202,110,92
050,56,007,"Wyoming","Carbon County",2,13,202,105,97
050,56,007,"Wyoming","Carbon County",2,14,187,96,91
050,56,007,"Wyoming","Carbon County",2,15,178,94,84
050,56,007,"Wyoming","Carbon County",2,16,188,98,90
050,56,007,"Wyoming","Carbon County",2,17,189,95,94
050,56,007,"Wyoming","Carbon County",2,18,163,90,73
050,56,007,"Wyoming","Carbon County",2,19,131,79,52
050,56,007,"Wyoming","Carbon County",2,20,144,87,57
050,56,007,"Wyoming","Carbon County",2,21,159,95,64
050,56,007,"Wyoming","Carbon County",2,22,151,90,61
050,56,007,"Wyoming","Carbon County",2,23,161,95,66
050,56,007,"Wyoming","Carbon County",2,24,160,87,73
050,56,007,"Wyoming","Carbon County",2,25,164,93,71
050,56,007,"Wyoming","Carbon County",2,26,180,95,85
050,56,007,"Wyoming","Carbon County",2,27,187,101,86
050,56,007,"Wyoming","Carbon County",2,28,194,107,87
050,56,007,"Wyoming","Carbon County",2,29,196,107,89
050,56,007,"Wyoming","Carbon County",2,30,226,133,93
050,56,007,"Wyoming","Carbon County",2,31,218,127,91
050,56,007,"Wyoming","Carbon County",2,32,187,106,81
050,56,007,"Wyoming","Carbon County",2,33,193,108,85
050,56,007,"Wyoming","Carbon County",2,34,206,109,97
050,56,007,"Wyoming","Carbon County",2,35,204,110,94
050,56,007,"Wyoming","Carbon County",2,36,215,125,90
050,56,007,"Wyoming","Carbon County",2,37,203,121,82
050,56,007,"Wyoming","Carbon County",2,38,197,113,84
050,56,007,"Wyoming","Carbon County",2,39,190,105,85
050,56,007,"Wyoming","Carbon County",2,40,191,101,90
050,56,007,"Wyoming","Carbon County",2,41,203,110,93
050,56,007,"Wyoming","Carbon County",2,42,185,105,80
050,56,007,"Wyoming","Carbon County",2,43,178,100,78
050,56,007,"Wyoming","Carbon County",2,44,178,105,73
050,56,007,"Wyoming","Carbon County",2,45,185,106,79
050,56,007,"Wyoming","Carbon County",2,46,174,95,79
050,56,007,"Wyoming","Carbon County",2,47,155,83,72
050,56,007,"Wyoming","Carbon County",2,48,153,87,66
050,56,007,"Wyoming","Carbon County",2,49,163,92,71
050,56,007,"Wyoming","Carbon County",2,50,165,88,77
050,56,007,"Wyoming","Carbon County",2,51,154,77,77
050,56,007,"Wyoming","Carbon County",2,52,149,84,65
050,56,007,"Wyoming","Carbon County",2,53,141,76,65
050,56,007,"Wyoming","Carbon County",2,54,168,92,76
050,56,007,"Wyoming","Carbon County",2,55,173,83,90
050,56,007,"Wyoming","Carbon County",2,56,186,87,99
050,56,007,"Wyoming","Carbon County",2,57,192,94,98
050,56,007,"Wyoming","Carbon County",2,58,203,105,98
050,56,007,"Wyoming","Carbon County",2,59,212,119,93
050,56,007,"Wyoming","Carbon County",2,60,206,117,89
050,56,007,"Wyoming","Carbon County",2,61,199,106,93
050,56,007,"Wyoming","Carbon County",2,62,223,121,102
050,56,007,"Wyoming","Carbon County",2,63,227,118,109
050,56,007,"Wyoming","Carbon County",2,64,209,115,94
050,56,007,"Wyoming","Carbon County",2,65,197,108,89
050,56,007,"Wyoming","Carbon County",2,66,193,107,86
050,56,007,"Wyoming","Carbon County",2,67,192,96,96
050,56,007,"Wyoming","Carbon County",2,68,162,80,82
050,56,007,"Wyoming","Carbon County",2,69,162,81,81
050,56,007,"Wyoming","Carbon County",2,70,166,89,77
050,56,007,"Wyoming","Carbon County",2,71,154,80,74
050,56,007,"Wyoming","Carbon County",2,72,150,82,68
050,56,007,"Wyoming","Carbon County",2,73,152,84,68
050,56,007,"Wyoming","Carbon County",2,74,100,53,47
050,56,007,"Wyoming","Carbon County",2,75,96,50,46
050,56,007,"Wyoming","Carbon County",2,76,108,62,46
050,56,007,"Wyoming","Carbon County",2,77,100,53,47
050,56,007,"Wyoming","Carbon County",2,78,82,37,45
050,56,007,"Wyoming","Carbon County",2,79,76,37,39
050,56,007,"Wyoming","Carbon County",2,80,73,35,38
050,56,007,"Wyoming","Carbon County",2,81,62,32,30
050,56,007,"Wyoming","Carbon County",2,82,49,23,26
050,56,007,"Wyoming","Carbon County",2,83,41,22,19
050,56,007,"Wyoming","Carbon County",2,84,44,20,24
050,56,007,"Wyoming","Carbon County",2,85,239,96,143
050,56,007,"Wyoming","Carbon County",3,0,161,89,72
050,56,007,"Wyoming","Carbon County",3,1,164,94,70
050,56,007,"Wyoming","Carbon County",3,2,164,87,77
050,56,007,"Wyoming","Carbon County",3,3,178,100,78
050,56,007,"Wyoming","Carbon County",3,4,184,106,78
050,56,007,"Wyoming","Carbon County",3,5,202,111,91
050,56,007,"Wyoming","Carbon County",3,6,194,105,89
050,56,007,"Wyoming","Carbon County",3,7,180,82,98
050,56,007,"Wyoming","Carbon County",3,8,186,94,92
050,56,007,"Wyoming","Carbon County",3,9,185,94,91
050,56,007,"Wyoming","Carbon County",3,10,184,96,88
050,56,007,"Wyoming","Carbon County",3,11,189,94,95
050,56,007,"Wyoming","Carbon County",3,12,204,115,89
050,56,007,"Wyoming","Carbon County",3,13,204,108,96
050,56,007,"Wyoming","Carbon County",3,14,200,101,99
050,56,007,"Wyoming","Carbon County",3,15,193,99,94
050,56,007,"Wyoming","Carbon County",3,16,183,92,91
050,56,007,"Wyoming","Carbon County",3,17,186,103,83
050,56,007,"Wyoming","Carbon County",3,18,164,89,75
050,56,007,"Wyoming","Carbon County",3,19,150,88,62
050,56,007,"Wyoming","Carbon County",3,20,144,89,55
050,56,007,"Wyoming","Carbon County",3,21,153,93,60
050,56,007,"Wyoming","Carbon County",3,22,172,101,71
050,56,007,"Wyoming","Carbon County",3,23,167,104,63
050,56,007,"Wyoming","Carbon County",3,24,156,89,67
050,56,007,"Wyoming","Carbon County",3,25,157,85,72
050,56,007,"Wyoming","Carbon County",3,26,167,94,73
050,56,007,"Wyoming","Carbon County",3,27,181,102,79
050,56,007,"Wyoming","Carbon County",3,28,210,117,93
050,56,007,"Wyoming","Carbon County",3,29,186,102,84
050,56,007,"Wyoming","Carbon County",3,30,204,112,92
050,56,007,"Wyoming","Carbon County",3,31,227,132,95
050,56,007,"Wyoming","Carbon County",3,32,234,135,99
050,56,007,"Wyoming","Carbon County",3,33,189,106,83
050,56,007,"Wyoming","Carbon County",3,34,210,125,85
050,56,007,"Wyoming","Carbon County",3,35,207,110,97
050,56,007,"Wyoming","Carbon County",3,36,218,120,98
050,56,007,"Wyoming","Carbon County",3,37,223,129,94
050,56,007,"Wyoming","Carbon County",3,38,213,124,89
050,56,007,"Wyoming","Carbon County",3,39,194,107,87
050,56,007,"Wyoming","Carbon County",3,40,176,99,77
050,56,007,"Wyoming","Carbon County",3,41,197,107,90
050,56,007,"Wyoming","Carbon County",3,42,211,113,98
050,56,007,"Wyoming","Carbon County",3,43,192,113,79
050,56,007,"Wyoming","Carbon County",3,44,173,96,77
050,56,007,"Wyoming","Carbon County",3,45,180,106,74
050,56,007,"Wyoming","Carbon County",3,46,186,109,77
050,56,007,"Wyoming","Carbon County",3,47,182,87,95
050,56,007,"Wyoming","Carbon County",3,48,157,85,72
050,56,007,"Wyoming","Carbon County",3,49,159,94,65
050,56,007,"Wyoming","Carbon County",3,50,167,95,72
050,56,007,"Wyoming","Carbon County",3,51,158,82,76
050,56,007,"Wyoming","Carbon County",3,52,169,91,78
050,56,007,"Wyoming","Carbon County",3,53,138,79,59
050,56,007,"Wyoming","Carbon County",3,54,144,81,63
050,56,007,"Wyoming","Carbon County",3,55,157,82,75
050,56,007,"Wyoming","Carbon County",3,56,177,87,90
050,56,007,"Wyoming","Carbon County",3,57,187,88,99
050,56,007,"Wyoming","Carbon County",3,58,186,95,91
050,56,007,"Wyoming","Carbon County",3,59,203,104,99
050,56,007,"Wyoming","Carbon County",3,60,217,127,90
050,56,007,"Wyoming","Carbon County",3,61,205,114,91
050,56,007,"Wyoming","Carbon County",3,62,209,116,93
050,56,007,"Wyoming","Carbon County",3,63,213,114,99
050,56,007,"Wyoming","Carbon County",3,64,222,117,105
050,56,007,"Wyoming","Carbon County",3,65,209,117,92
050,56,007,"Wyoming","Carbon County",3,66,196,107,89
050,56,007,"Wyoming","Carbon County",3,67,185,98,87
050,56,007,"Wyoming","Carbon County",3,68,189,93,96
050,56,007,"Wyoming","Carbon County",3,69,159,77,82
050,56,007,"Wyoming","Carbon County",3,70,153,78,75
050,56,007,"Wyoming","Carbon County",3,71,164,86,78
050,56,007,"Wyoming","Carbon County",3,72,152,79,73
050,56,007,"Wyoming","Carbon County",3,73,139,77,62
050,56,007,"Wyoming","Carbon County",3,74,152,81,71
050,56,007,"Wyoming","Carbon County",3,75,94,51,43
050,56,007,"Wyoming","Carbon County",3,76,92,50,42
050,56,007,"Wyoming","Carbon County",3,77,103,57,46
050,56,007,"Wyoming","Carbon County",3,78,96,54,42
050,56,007,"Wyoming","Carbon County",3,79,78,31,47
050,56,007,"Wyoming","Carbon County",3,80,70,33,37
050,56,007,"Wyoming","Carbon County",3,81,66,34,32
050,56,007,"Wyoming","Carbon County",3,82,62,31,31
050,56,007,"Wyoming","Carbon County",3,83,44,20,24
050,56,007,"Wyoming","Carbon County",3,84,38,20,18
050,56,007,"Wyoming","Carbon County",3,85,241,99,142
050,56,007,"Wyoming","Carbon County",4,0,155,81,74
050,56,007,"Wyoming","Carbon County",4,1,143,83,60
050,56,007,"Wyoming","Carbon County",4,2,153,87,66
050,56,007,"Wyoming","Carbon County",4,3,164,89,75
050,56,007,"Wyoming","Carbon County",4,4,181,104,77
050,56,007,"Wyoming","Carbon County",4,5,180,99,81
050,56,007,"Wyoming","Carbon County",4,6,202,111,91
050,56,007,"Wyoming","Carbon County",4,7,186,103,83
050,56,007,"Wyoming","Carbon County",4,8,173,78,95
050,56,007,"Wyoming","Carbon County",4,9,178,89,89
050,56,007,"Wyoming","Carbon County",4,10,183,99,84
050,56,007,"Wyoming","Carbon County",4,11,187,98,89
050,56,007,"Wyoming","Carbon County",4,12,185,94,91
050,56,007,"Wyoming","Carbon County",4,13,202,112,90
050,56,007,"Wyoming","Carbon County",4,14,207,110,97
050,56,007,"Wyoming","Carbon County",4,15,189,99,90
050,56,007,"Wyoming","Carbon County",4,16,211,107,104
050,56,007,"Wyoming","Carbon County",4,17,182,93,89
050,56,007,"Wyoming","Carbon County",4,18,164,97,67
050,56,007,"Wyoming","Carbon County",4,19,125,73,52
050,56,007,"Wyoming","Carbon County",4,20,154,91,63
050,56,007,"Wyoming","Carbon County",4,21,138,85,53
050,56,007,"Wyoming","Carbon County",4,22,161,93,68
050,56,007,"Wyoming","Carbon County",4,23,159,86,73
050,56,007,"Wyoming","Carbon County",4,24,156,89,67
050,56,007,"Wyoming","Carbon County",4,25,168,96,72
050,56,007,"Wyoming","Carbon County",4,26,157,84,73
050,56,007,"Wyoming","Carbon County",4,27,161,98,63
050,56,007,"Wyoming","Carbon County",4,28,189,102,87
050,56,007,"Wyoming","Carbon County",4,29,201,107,94
050,56,007,"Wyoming","Carbon County",4,30,191,106,85
050,56,007,"Wyoming","Carbon County",4,31,191,105,86
050,56,007,"Wyoming","Carbon County",4,32,250,144,106
050,56,007,"Wyoming","Carbon County",4,33,206,115,91
050,56,007,"Wyoming","Carbon County",4,34,195,109,86
050,56,007,"Wyoming","Carbon County",4,35,192,115,77
050,56,007,"Wyoming","Carbon County",4,36,201,107,94
050,56,007,"Wyoming","Carbon County",4,37,222,123,99
050,56,007,"Wyoming","Carbon County",4,38,221,129,92
050,56,007,"Wyoming","Carbon County",4,39,207,117,90
050,56,007,"Wyoming","Carbon County",4,40,185,99,86
050,56,007,"Wyoming","Carbon County",4,41,182,102,80
050,56,007,"Wyoming","Carbon County",4,42,188,104,84
050,56,007,"Wyoming","Carbon County",4,43,212,112,100
050,56,007,"Wyoming","Carbon County",4,44,190,110,80
050,56,007,"Wyoming","Carbon County",4,45,175,97,78
050,56,007,"Wyoming","Carbon County",4,46,186,107,79
050,56,007,"Wyoming","Carbon County",4,47,176,97,79
050,56,007,"Wyoming","Carbon County",4,48,175,84,91
050,56,007,"Wyoming","Carbon County",4,49,147,77,70
050,56,007,"Wyoming","Carbon County",4,50,169,102,67
050,56,007,"Wyoming","Carbon County",4,51,169,93,76
050,56,007,"Wyoming","Carbon County",4,52,166,82,84
050,56,007,"Wyoming","Carbon County",4,53,181,94,87
050,56,007,"Wyoming","Carbon County",4,54,143,78,65
050,56,007,"Wyoming","Carbon County",4,55,128,71,57
050,56,007,"Wyoming","Carbon County",4,56,156,86,70
050,56,007,"Wyoming","Carbon County",4,57,169,82,87
050,56,007,"Wyoming","Carbon County",4,58,182,86,96
050,56,007,"Wyoming","Carbon County",4,59,187,93,94
050,56,007,"Wyoming","Carbon County",4,60,205,109,96
050,56,007,"Wyoming","Carbon County",4,61,227,133,94
050,56,007,"Wyoming","Carbon County",4,62,204,114,90
050,56,007,"Wyoming","Carbon County",4,63,207,112,95
050,56,007,"Wyoming","Carbon County",4,64,200,112,88
050,56,007,"Wyoming","Carbon County",4,65,224,114,110
050,56,007,"Wyoming","Carbon County",4,66,201,115,86
050,56,007,"Wyoming","Carbon County",4,67,190,99,91
050,56,007,"Wyoming","Carbon County",4,68,183,96,87
050,56,007,"Wyoming","Carbon County",4,69,190,91,99
050,56,007,"Wyoming","Carbon County",4,70,151,72,79
050,56,007,"Wyoming","Carbon County",4,71,148,74,74
050,56,007,"Wyoming","Carbon County",4,72,166,85,81
050,56,007,"Wyoming","Carbon County",4,73,137,72,65
050,56,007,"Wyoming","Carbon County",4,74,125,70,55
050,56,007,"Wyoming","Carbon County",4,75,151,82,69
050,56,007,"Wyoming","Carbon County",4,76,92,51,41
050,56,007,"Wyoming","Carbon County",4,77,81,43,38
050,56,007,"Wyoming","Carbon County",4,78,97,56,41
050,56,007,"Wyoming","Carbon County",4,79,90,51,39
050,56,007,"Wyoming","Carbon County",4,80,73,29,44
050,56,007,"Wyoming","Carbon County",4,81,60,28,32
050,56,007,"Wyoming","Carbon County",4,82,59,29,30
050,56,007,"Wyoming","Carbon County",4,83,57,28,29
050,56,007,"Wyoming","Carbon County",4,84,46,21,25
050,56,007,"Wyoming","Carbon County",4,85,238,104,134
050,56,007,"Wyoming","Carbon County",5,0,142,76,66
050,56,007,"Wyoming","Carbon County",5,1,150,75,75
050,56,007,"Wyoming","Carbon County",5,2,154,84,70
050,56,007,"Wyoming","Carbon County",5,3,157,85,72
050,56,007,"Wyoming","Carbon County",5,4,144,76,68
050,56,007,"Wyoming","Carbon County",5,5,171,97,74
050,56,007,"Wyoming","Carbon County",5,6,177,94,83
050,56,007,"Wyoming","Carbon County",5,7,192,103,89
050,56,007,"Wyoming","Carbon County",5,8,187,102,85
050,56,007,"Wyoming","Carbon County",5,9,161,72,89
050,56,007,"Wyoming","Carbon County",5,10,181,92,89
050,56,007,"Wyoming","Carbon County",5,11,164,87,77
050,56,007,"Wyoming","Carbon County",5,12,177,93,84
050,56,007,"Wyoming","Carbon County",5,13,187,95,92
050,56,007,"Wyoming","Carbon County",5,14,192,105,87
050,56,007,"Wyoming","Carbon County",5,15,205,107,98
050,56,007,"Wyoming","Carbon County",5,16,188,94,94
050,56,007,"Wyoming","Carbon County",5,17,213,115,98
050,56,007,"Wyoming","Carbon County",5,18,162,86,76
050,56,007,"Wyoming","Carbon County",5,19,128,82,46
050,56,007,"Wyoming","Carbon County",5,20,130,78,52
050,56,007,"Wyoming","Carbon County",5,21,156,91,65
050,56,007,"Wyoming","Carbon County",5,22,153,94,59
050,56,007,"Wyoming","Carbon County",5,23,163,97,66
050,56,007,"Wyoming","Carbon County",5,24,167,87,80
050,56,007,"Wyoming","Carbon County",5,25,165,93,72
050,56,007,"Wyoming","Carbon County",5,26,170,97,73
050,56,007,"Wyoming","Carbon County",5,27,153,75,78
050,56,007,"Wyoming","Carbon County",5,28,164,94,70
050,56,007,"Wyoming","Carbon County",5,29,174,97,77
050,56,007,"Wyoming","Carbon County",5,30,194,100,94
050,56,007,"Wyoming","Carbon County",5,31,176,100,76
050,56,007,"Wyoming","Carbon County",5,32,189,102,87
050,56,007,"Wyoming","Carbon County",5,33,228,130,98
050,56,007,"Wyoming","Carbon County",5,34,200,112,88
050,56,007,"Wyoming","Carbon County",5,35,186,104,82
050,56,007,"Wyoming","Carbon County",5,36,195,116,79
050,56,007,"Wyoming","Carbon County",5,37,192,103,89
050,56,007,"Wyoming","Carbon County",5,38,214,117,97
050,56,007,"Wyoming","Carbon County",5,39,209,120,89
050,56,007,"Wyoming","Carbon County",5,40,205,116,89
050,56,007,"Wyoming","Carbon County",5,41,184,100,84
050,56,007,"Wyoming","Carbon County",5,42,191,107,84
050,56,007,"Wyoming","Carbon County",5,43,197,111,86
050,56,007,"Wyoming","Carbon County",5,44,210,114,96
050,56,007,"Wyoming","Carbon County",5,45,188,111,77
050,56,007,"Wyoming","Carbon County",5,46,176,97,79
050,56,007,"Wyoming","Carbon County",5,47,184,103,81
050,56,007,"Wyoming","Carbon County",5,48,166,93,73
050,56,007,"Wyoming","Carbon County",5,49,165,75,90
050,56,007,"Wyoming","Carbon County",5,50,151,76,75
050,56,007,"Wyoming","Carbon County",5,51,173,97,76
050,56,007,"Wyoming","Carbon County",5,52,173,97,76
050,56,007,"Wyoming","Carbon County",5,53,187,89,98
050,56,007,"Wyoming","Carbon County",5,54,173,93,80
050,56,007,"Wyoming","Carbon County",5,55,136,69,67
050,56,007,"Wyoming","Carbon County",5,56,134,77,57
050,56,007,"Wyoming","Carbon County",5,57,154,82,72
050,56,007,"Wyoming","Carbon County",5,58,161,76,85
050,56,007,"Wyoming","Carbon County",5,59,179,83,96
050,56,007,"Wyoming","Carbon County",5,60,191,97,94
050,56,007,"Wyoming","Carbon County",5,61,202,106,96
050,56,007,"Wyoming","Carbon County",5,62,218,131,87
050,56,007,"Wyoming","Carbon County",5,63,205,108,97
050,56,007,"Wyoming","Carbon County",5,64,200,109,91
050,56,007,"Wyoming","Carbon County",5,65,197,110,87
050,56,007,"Wyoming","Carbon County",5,66,222,112,110
050,56,007,"Wyoming","Carbon County",5,67,198,110,88
050,56,007,"Wyoming","Carbon County",5,68,180,96,84
050,56,007,"Wyoming","Carbon County",5,69,183,99,84
050,56,007,"Wyoming","Carbon County",5,70,180,86,94
050,56,007,"Wyoming","Carbon County",5,71,150,73,77
050,56,007,"Wyoming","Carbon County",5,72,145,72,73
050,56,007,"Wyoming","Carbon County",5,73,157,82,75
050,56,007,"Wyoming","Carbon County",5,74,138,69,69
050,56,007,"Wyoming","Carbon County",5,75,120,70,50
050,56,007,"Wyoming","Carbon County",5,76,142,80,62
050,56,007,"Wyoming","Carbon County",5,77,86,47,39
050,56,007,"Wyoming","Carbon County",5,78,74,41,33
050,56,007,"Wyoming","Carbon County",5,79,94,53,41
050,56,007,"Wyoming","Carbon County",5,80,86,49,37
050,56,007,"Wyoming","Carbon County",5,81,64,27,37
050,56,007,"Wyoming","Carbon County",5,82,55,24,31
050,56,007,"Wyoming","Carbon County",5,83,52,26,26
050,56,007,"Wyoming","Carbon County",5,84,55,26,29
050,56,007,"Wyoming","Carbon County",5,85,243,108,135
050,56,009,"Wyoming","Converse County",1,0,156,79,77
050,56,009,"Wyoming","Converse County",1,1,158,73,85
050,56,009,"Wyoming","Converse County",1,2,165,78,87
050,56,009,"Wyoming","Converse County",1,3,178,102,76
050,56,009,"Wyoming","Converse County",1,4,184,105,79
050,56,009,"Wyoming","Converse County",1,5,202,109,93
050,56,009,"Wyoming","Converse County",1,6,205,101,104
050,56,009,"Wyoming","Converse County",1,7,188,93,95
050,56,009,"Wyoming","Converse County",1,8,188,98,90
050,56,009,"Wyoming","Converse County",1,9,181,88,93
050,56,009,"Wyoming","Converse County",1,10,201,88,113
050,56,009,"Wyoming","Converse County",1,11,202,104,98
050,56,009,"Wyoming","Converse County",1,12,199,116,83
050,56,009,"Wyoming","Converse County",1,13,204,105,99
050,56,009,"Wyoming","Converse County",1,14,200,106,94
050,56,009,"Wyoming","Converse County",1,15,199,97,102
050,56,009,"Wyoming","Converse County",1,16,182,89,93
050,56,009,"Wyoming","Converse County",1,17,178,86,92
050,56,009,"Wyoming","Converse County",1,18,159,81,78
050,56,009,"Wyoming","Converse County",1,19,121,61,60
050,56,009,"Wyoming","Converse County",1,20,135,70,65
050,56,009,"Wyoming","Converse County",1,21,132,71,61
050,56,009,"Wyoming","Converse County",1,22,124,64,60
050,56,009,"Wyoming","Converse County",1,23,140,71,69
050,56,009,"Wyoming","Converse County",1,24,145,70,75
050,56,009,"Wyoming","Converse County",1,25,141,78,63
050,56,009,"Wyoming","Converse County",1,26,150,79,71
050,56,009,"Wyoming","Converse County",1,27,169,84,85
050,56,009,"Wyoming","Converse County",1,28,166,81,85
050,56,009,"Wyoming","Converse County",1,29,167,83,84
050,56,009,"Wyoming","Converse County",1,30,179,91,88
050,56,009,"Wyoming","Converse County",1,31,175,80,95
050,56,009,"Wyoming","Converse County",1,32,182,95,87
050,56,009,"Wyoming","Converse County",1,33,188,100,88
050,56,009,"Wyoming","Converse County",1,34,155,86,69
050,56,009,"Wyoming","Converse County",1,35,184,95,89
050,56,009,"Wyoming","Converse County",1,36,187,92,95
050,56,009,"Wyoming","Converse County",1,37,186,95,91
050,56,009,"Wyoming","Converse County",1,38,183,95,88
050,56,009,"Wyoming","Converse County",1,39,173,95,78
050,56,009,"Wyoming","Converse County",1,40,161,88,73
050,56,009,"Wyoming","Converse County",1,41,162,86,76
050,56,009,"Wyoming","Converse County",1,42,166,87,79
050,56,009,"Wyoming","Converse County",1,43,174,85,89
050,56,009,"Wyoming","Converse County",1,44,165,72,93
050,56,009,"Wyoming","Converse County",1,45,161,87,74
050,56,009,"Wyoming","Converse County",1,46,154,82,72
050,56,009,"Wyoming","Converse County",1,47,151,75,76
050,56,009,"Wyoming","Converse County",1,48,159,88,71
050,56,009,"Wyoming","Converse County",1,49,176,98,78
050,56,009,"Wyoming","Converse County",1,50,168,89,79
050,56,009,"Wyoming","Converse County",1,51,172,90,82
050,56,009,"Wyoming","Converse County",1,52,155,84,71
050,56,009,"Wyoming","Converse County",1,53,176,90,86
050,56,009,"Wyoming","Converse County",1,54,182,88,94
050,56,009,"Wyoming","Converse County",1,55,166,87,79
050,56,009,"Wyoming","Converse County",1,56,191,103,88
050,56,009,"Wyoming","Converse County",1,57,197,105,92
050,56,009,"Wyoming","Converse County",1,58,185,99,86
050,56,009,"Wyoming","Converse County",1,59,213,101,112
050,56,009,"Wyoming","Converse County",1,60,202,102,100
050,56,009,"Wyoming","Converse County",1,61,215,113,102
050,56,009,"Wyoming","Converse County",1,62,215,123,92
050,56,009,"Wyoming","Converse County",1,63,203,109,94
050,56,009,"Wyoming","Converse County",1,64,205,106,99
050,56,009,"Wyoming","Converse County",1,65,187,103,84
050,56,009,"Wyoming","Converse County",1,66,181,96,85
050,56,009,"Wyoming","Converse County",1,67,168,94,74
050,56,009,"Wyoming","Converse County",1,68,158,87,71
050,56,009,"Wyoming","Converse County",1,69,141,73,68
050,56,009,"Wyoming","Converse County",1,70,144,79,65
050,56,009,"Wyoming","Converse County",1,71,133,68,65
050,56,009,"Wyoming","Converse County",1,72,143,77,66
050,56,009,"Wyoming","Converse County",1,73,131,69,62
050,56,009,"Wyoming","Converse County",1,74,84,38,46
050,56,009,"Wyoming","Converse County",1,75,90,40,50
050,56,009,"Wyoming","Converse County",1,76,97,46,51
050,56,009,"Wyoming","Converse County",1,77,76,39,37
050,56,009,"Wyoming","Converse County",1,78,77,38,39
050,56,009,"Wyoming","Converse County",1,79,54,28,26
050,56,009,"Wyoming","Converse County",1,80,61,28,33
050,56,009,"Wyoming","Converse County",1,81,60,21,39
050,56,009,"Wyoming","Converse County",1,82,58,25,33
050,56,009,"Wyoming","Converse County",1,83,42,16,26
050,56,009,"Wyoming","Converse County",1,84,44,22,22
050,56,009,"Wyoming","Converse County",1,85,237,101,136
050,56,009,"Wyoming","Converse County",2,0,162,83,79
050,56,009,"Wyoming","Converse County",2,1,155,73,82
050,56,009,"Wyoming","Converse County",2,2,164,78,86
050,56,009,"Wyoming","Converse County",2,3,173,95,78
050,56,009,"Wyoming","Converse County",2,4,181,102,79
050,56,009,"Wyoming","Converse County",2,5,198,108,90
050,56,009,"Wyoming","Converse County",2,6,207,103,104
050,56,009,"Wyoming","Converse County",2,7,191,94,97
050,56,009,"Wyoming","Converse County",2,8,190,97,93
050,56,009,"Wyoming","Converse County",2,9,186,92,94
050,56,009,"Wyoming","Converse County",2,10,197,89,108
050,56,009,"Wyoming","Converse County",2,11,201,100,101
050,56,009,"Wyoming","Converse County",2,12,201,113,88
050,56,009,"Wyoming","Converse County",2,13,199,106,93
050,56,009,"Wyoming","Converse County",2,14,196,103,93
050,56,009,"Wyoming","Converse County",2,15,197,99,98
050,56,009,"Wyoming","Converse County",2,16,185,90,95
050,56,009,"Wyoming","Converse County",2,17,180,88,92
050,56,009,"Wyoming","Converse County",2,18,153,77,76
050,56,009,"Wyoming","Converse County",2,19,122,61,61
050,56,009,"Wyoming","Converse County",2,20,136,70,66
050,56,009,"Wyoming","Converse County",2,21,134,72,62
050,56,009,"Wyoming","Converse County",2,22,126,66,60
050,56,009,"Wyoming","Converse County",2,23,139,71,68
050,56,009,"Wyoming","Converse County",2,24,144,71,73
050,56,009,"Wyoming","Converse County",2,25,143,77,66
050,56,009,"Wyoming","Converse County",2,26,150,81,69
050,56,009,"Wyoming","Converse County",2,27,167,84,83
050,56,009,"Wyoming","Converse County",2,28,167,84,83
050,56,009,"Wyoming","Converse County",2,29,170,85,85
050,56,009,"Wyoming","Converse County",2,30,181,90,91
050,56,009,"Wyoming","Converse County",2,31,177,85,92
050,56,009,"Wyoming","Converse County",2,32,180,91,89
050,56,009,"Wyoming","Converse County",2,33,181,95,86
050,56,009,"Wyoming","Converse County",2,34,163,90,73
050,56,009,"Wyoming","Converse County",2,35,180,96,84
050,56,009,"Wyoming","Converse County",2,36,187,92,95
050,56,009,"Wyoming","Converse County",2,37,189,94,95
050,56,009,"Wyoming","Converse County",2,38,183,94,89
050,56,009,"Wyoming","Converse County",2,39,175,95,80
050,56,009,"Wyoming","Converse County",2,40,163,90,73
050,56,009,"Wyoming","Converse County",2,41,159,85,74
050,56,009,"Wyoming","Converse County",2,42,161,84,77
050,56,009,"Wyoming","Converse County",2,43,174,85,89
050,56,009,"Wyoming","Converse County",2,44,165,74,91
050,56,009,"Wyoming","Converse County",2,45,162,85,77
050,56,009,"Wyoming","Converse County",2,46,156,84,72
050,56,009,"Wyoming","Converse County",2,47,150,76,74
050,56,009,"Wyoming","Converse County",2,48,155,83,72
050,56,009,"Wyoming","Converse County",2,49,172,96,76
050,56,009,"Wyoming","Converse County",2,50,169,90,79
050,56,009,"Wyoming","Converse County",2,51,171,91,80
050,56,009,"Wyoming","Converse County",2,52,159,85,74
050,56,009,"Wyoming","Converse County",2,53,170,88,82
050,56,009,"Wyoming","Converse County",2,54,178,87,91
050,56,009,"Wyoming","Converse County",2,55,171,87,84
050,56,009,"Wyoming","Converse County",2,56,185,99,86
050,56,009,"Wyoming","Converse County",2,57,195,104,91
050,56,009,"Wyoming","Converse County",2,58,190,102,88
050,56,009,"Wyoming","Converse County",2,59,206,100,106
050,56,009,"Wyoming","Converse County",2,60,205,102,103
050,56,009,"Wyoming","Converse County",2,61,209,108,101
050,56,009,"Wyoming","Converse County",2,62,213,119,94
050,56,009,"Wyoming","Converse County",2,63,207,113,94
050,56,009,"Wyoming","Converse County",2,64,204,107,97
050,56,009,"Wyoming","Converse County",2,65,191,104,87
050,56,009,"Wyoming","Converse County",2,66,181,97,84
050,56,009,"Wyoming","Converse County",2,67,171,94,77
050,56,009,"Wyoming","Converse County",2,68,158,88,70
050,56,009,"Wyoming","Converse County",2,69,145,77,68
050,56,009,"Wyoming","Converse County",2,70,142,77,65
050,56,009,"Wyoming","Converse County",2,71,135,70,65
050,56,009,"Wyoming","Converse County",2,72,138,73,65
050,56,009,"Wyoming","Converse County",2,73,139,75,64
050,56,009,"Wyoming","Converse County",2,74,86,42,44
050,56,009,"Wyoming","Converse County",2,75,89,38,51
050,56,009,"Wyoming","Converse County",2,76,94,44,50
050,56,009,"Wyoming","Converse County",2,77,84,43,41
050,56,009,"Wyoming","Converse County",2,78,74,38,36
050,56,009,"Wyoming","Converse County",2,79,58,29,29
050,56,009,"Wyoming","Converse County",2,80,60,29,31
050,56,009,"Wyoming","Converse County",2,81,58,20,38
050,56,009,"Wyoming","Converse County",2,82,59,25,34
050,56,009,"Wyoming","Converse County",2,83,45,19,26
050,56,009,"Wyoming","Converse County",2,84,43,20,23
050,56,009,"Wyoming","Converse County",2,85,237,101,136
050,56,009,"Wyoming","Converse County",3,0,128,62,66
050,56,009,"Wyoming","Converse County",3,1,175,97,78
050,56,009,"Wyoming","Converse County",3,2,159,78,81
050,56,009,"Wyoming","Converse County",3,3,157,69,88
050,56,009,"Wyoming","Converse County",3,4,177,96,81
050,56,009,"Wyoming","Converse County",3,5,182,105,77
050,56,009,"Wyoming","Converse County",3,6,198,108,90
050,56,009,"Wyoming","Converse County",3,7,206,100,106
050,56,009,"Wyoming","Converse County",3,8,182,90,92
050,56,009,"Wyoming","Converse County",3,9,199,102,97
050,56,009,"Wyoming","Converse County",3,10,190,94,96
050,56,009,"Wyoming","Converse County",3,11,194,91,103
050,56,009,"Wyoming","Converse County",3,12,206,110,96
050,56,009,"Wyoming","Converse County",3,13,188,96,92
050,56,009,"Wyoming","Converse County",3,14,203,103,100
050,56,009,"Wyoming","Converse County",3,15,190,98,92
050,56,009,"Wyoming","Converse County",3,16,200,96,104
050,56,009,"Wyoming","Converse County",3,17,181,97,84
050,56,009,"Wyoming","Converse County",3,18,152,80,72
050,56,009,"Wyoming","Converse County",3,19,114,58,56
050,56,009,"Wyoming","Converse County",3,20,132,62,70
050,56,009,"Wyoming","Converse County",3,21,133,66,67
050,56,009,"Wyoming","Converse County",3,22,129,65,64
050,56,009,"Wyoming","Converse County",3,23,130,64,66
050,56,009,"Wyoming","Converse County",3,24,147,78,69
050,56,009,"Wyoming","Converse County",3,25,150,71,79
050,56,009,"Wyoming","Converse County",3,26,152,74,78
050,56,009,"Wyoming","Converse County",3,27,161,86,75
050,56,009,"Wyoming","Converse County",3,28,181,98,83
050,56,009,"Wyoming","Converse County",3,29,162,79,83
050,56,009,"Wyoming","Converse County",3,30,164,80,84
050,56,009,"Wyoming","Converse County",3,31,179,92,87
050,56,009,"Wyoming","Converse County",3,32,175,86,89
050,56,009,"Wyoming","Converse County",3,33,180,92,88
050,56,009,"Wyoming","Converse County",3,34,186,89,97
050,56,009,"Wyoming","Converse County",3,35,156,86,70
050,56,009,"Wyoming","Converse County",3,36,174,92,82
050,56,009,"Wyoming","Converse County",3,37,186,99,87
050,56,009,"Wyoming","Converse County",3,38,187,94,93
050,56,009,"Wyoming","Converse County",3,39,187,95,92
050,56,009,"Wyoming","Converse County",3,40,173,96,77
050,56,009,"Wyoming","Converse County",3,41,159,89,70
050,56,009,"Wyoming","Converse County",3,42,147,78,69
050,56,009,"Wyoming","Converse County",3,43,158,79,79
050,56,009,"Wyoming","Converse County",3,44,182,88,94
050,56,009,"Wyoming","Converse County",3,45,162,75,87
050,56,009,"Wyoming","Converse County",3,46,163,85,78
050,56,009,"Wyoming","Converse County",3,47,148,80,68
050,56,009,"Wyoming","Converse County",3,48,136,70,66
050,56,009,"Wyoming","Converse County",3,49,155,80,75
050,56,009,"Wyoming","Converse County",3,50,170,94,76
050,56,009,"Wyoming","Converse County",3,51,172,91,81
050,56,009,"Wyoming","Converse County",3,52,171,87,84
050,56,009,"Wyoming","Converse County",3,53,157,90,67
050,56,009,"Wyoming","Converse County",3,54,156,80,76
050,56,009,"Wyoming","Converse County",3,55,174,85,89
050,56,009,"Wyoming","Converse County",3,56,172,87,85
050,56,009,"Wyoming","Converse County",3,57,181,97,84
050,56,009,"Wyoming","Converse County",3,58,190,102,88
050,56,009,"Wyoming","Converse County",3,59,195,105,90
050,56,009,"Wyoming","Converse County",3,60,211,104,107
050,56,009,"Wyoming","Converse County",3,61,199,98,101
050,56,009,"Wyoming","Converse County",3,62,213,110,103
050,56,009,"Wyoming","Converse County",3,63,214,115,99
050,56,009,"Wyoming","Converse County",3,64,199,108,91
050,56,009,"Wyoming","Converse County",3,65,198,107,91
050,56,009,"Wyoming","Converse County",3,66,190,99,91
050,56,009,"Wyoming","Converse County",3,67,179,93,86
050,56,009,"Wyoming","Converse County",3,68,161,87,74
050,56,009,"Wyoming","Converse County",3,69,155,86,69
050,56,009,"Wyoming","Converse County",3,70,141,75,66
050,56,009,"Wyoming","Converse County",3,71,135,73,62
050,56,009,"Wyoming","Converse County",3,72,133,67,66
050,56,009,"Wyoming","Converse County",3,73,134,69,65
050,56,009,"Wyoming","Converse County",3,74,139,73,66
050,56,009,"Wyoming","Converse County",3,75,88,40,48
050,56,009,"Wyoming","Converse County",3,76,82,35,47
050,56,009,"Wyoming","Converse County",3,77,95,43,52
050,56,009,"Wyoming","Converse County",3,78,84,46,38
050,56,009,"Wyoming","Converse County",3,79,63,29,34
050,56,009,"Wyoming","Converse County",3,80,61,34,27
050,56,009,"Wyoming","Converse County",3,81,57,25,32
050,56,009,"Wyoming","Converse County",3,82,52,19,33
050,56,009,"Wyoming","Converse County",3,83,53,24,29
050,56,009,"Wyoming","Converse County",3,84,41,17,24
050,56,009,"Wyoming","Converse County",3,85,232,99,133
050,56,009,"Wyoming","Converse County",4,0,144,67,77
050,56,009,"Wyoming","Converse County",4,1,129,64,65
050,56,009,"Wyoming","Converse County",4,2,160,79,81
050,56,009,"Wyoming","Converse County",4,3,170,86,84
050,56,009,"Wyoming","Converse County",4,4,174,81,93
050,56,009,"Wyoming","Converse County",4,5,177,91,86
050,56,009,"Wyoming","Converse County",4,6,187,108,79
050,56,009,"Wyoming","Converse County",4,7,201,106,95
050,56,009,"Wyoming","Converse County",4,8,206,102,104
050,56,009,"Wyoming","Converse County",4,9,185,86,99
050,56,009,"Wyoming","Converse County",4,10,202,106,96
050,56,009,"Wyoming","Converse County",4,11,193,98,95
050,56,009,"Wyoming","Converse County",4,12,201,97,104
050,56,009,"Wyoming","Converse County",4,13,208,104,104
050,56,009,"Wyoming","Converse County",4,14,186,100,86
050,56,009,"Wyoming","Converse County",4,15,208,108,100
050,56,009,"Wyoming","Converse County",4,16,191,102,89
050,56,009,"Wyoming","Converse County",4,17,202,96,106
050,56,009,"Wyoming","Converse County",4,18,154,79,75
050,56,009,"Wyoming","Converse County",4,19,113,61,52
050,56,009,"Wyoming","Converse County",4,20,126,63,63
050,56,009,"Wyoming","Converse County",4,21,126,58,68
050,56,009,"Wyoming","Converse County",4,22,133,61,72
050,56,009,"Wyoming","Converse County",4,23,126,65,61
050,56,009,"Wyoming","Converse County",4,24,127,66,61
050,56,009,"Wyoming","Converse County",4,25,142,68,74
050,56,009,"Wyoming","Converse County",4,26,147,65,82
050,56,009,"Wyoming","Converse County",4,27,161,81,80
050,56,009,"Wyoming","Converse County",4,28,170,91,79
050,56,009,"Wyoming","Converse County",4,29,176,86,90
050,56,009,"Wyoming","Converse County",4,30,172,84,88
050,56,009,"Wyoming","Converse County",4,31,164,80,84
050,56,009,"Wyoming","Converse County",4,32,186,94,92
050,56,009,"Wyoming","Converse County",4,33,182,89,93
050,56,009,"Wyoming","Converse County",4,34,183,87,96
050,56,009,"Wyoming","Converse County",4,35,174,81,93
050,56,009,"Wyoming","Converse County",4,36,163,89,74
050,56,009,"Wyoming","Converse County",4,37,181,98,83
050,56,009,"Wyoming","Converse County",4,38,187,95,92
050,56,009,"Wyoming","Converse County",4,39,180,91,89
050,56,009,"Wyoming","Converse County",4,40,193,99,94
050,56,009,"Wyoming","Converse County",4,41,173,95,78
050,56,009,"Wyoming","Converse County",4,42,158,88,70
050,56,009,"Wyoming","Converse County",4,43,160,82,78
050,56,009,"Wyoming","Converse County",4,44,157,79,78
050,56,009,"Wyoming","Converse County",4,45,189,99,90
050,56,009,"Wyoming","Converse County",4,46,167,82,85
050,56,009,"Wyoming","Converse County",4,47,170,90,80
050,56,009,"Wyoming","Converse County",4,48,142,75,67
050,56,009,"Wyoming","Converse County",4,49,138,70,68
050,56,009,"Wyoming","Converse County",4,50,152,77,75
050,56,009,"Wyoming","Converse County",4,51,176,100,76
050,56,009,"Wyoming","Converse County",4,52,172,96,76
050,56,009,"Wyoming","Converse County",4,53,178,86,92
050,56,009,"Wyoming","Converse County",4,54,156,87,69
050,56,009,"Wyoming","Converse County",4,55,157,79,78
050,56,009,"Wyoming","Converse County",4,56,176,87,89
050,56,009,"Wyoming","Converse County",4,57,173,88,85
050,56,009,"Wyoming","Converse County",4,58,185,102,83
050,56,009,"Wyoming","Converse County",4,59,198,109,89
050,56,009,"Wyoming","Converse County",4,60,193,104,89
050,56,009,"Wyoming","Converse County",4,61,214,106,108
050,56,009,"Wyoming","Converse County",4,62,206,101,105
050,56,009,"Wyoming","Converse County",4,63,220,118,102
050,56,009,"Wyoming","Converse County",4,64,217,117,100
050,56,009,"Wyoming","Converse County",4,65,196,108,88
050,56,009,"Wyoming","Converse County",4,66,196,104,92
050,56,009,"Wyoming","Converse County",4,67,182,93,89
050,56,009,"Wyoming","Converse County",4,68,171,84,87
050,56,009,"Wyoming","Converse County",4,69,162,89,73
050,56,009,"Wyoming","Converse County",4,70,154,89,65
050,56,009,"Wyoming","Converse County",4,71,144,70,74
050,56,009,"Wyoming","Converse County",4,72,138,77,61
050,56,009,"Wyoming","Converse County",4,73,126,65,61
050,56,009,"Wyoming","Converse County",4,74,131,64,67
050,56,009,"Wyoming","Converse County",4,75,142,76,66
050,56,009,"Wyoming","Converse County",4,76,82,36,46
050,56,009,"Wyoming","Converse County",4,77,76,32,44
050,56,009,"Wyoming","Converse County",4,78,92,44,48
050,56,009,"Wyoming","Converse County",4,79,74,37,37
050,56,009,"Wyoming","Converse County",4,80,59,28,31
050,56,009,"Wyoming","Converse County",4,81,58,29,29
050,56,009,"Wyoming","Converse County",4,82,51,24,27
050,56,009,"Wyoming","Converse County",4,83,50,19,31
050,56,009,"Wyoming","Converse County",4,84,44,19,25
050,56,009,"Wyoming","Converse County",4,85,220,97,123
050,56,009,"Wyoming","Converse County",5,0,127,60,67
050,56,009,"Wyoming","Converse County",5,1,149,67,82
050,56,009,"Wyoming","Converse County",5,2,129,66,63
050,56,009,"Wyoming","Converse County",5,3,173,83,90
050,56,009,"Wyoming","Converse County",5,4,174,87,87
050,56,009,"Wyoming","Converse County",5,5,176,85,91
050,56,009,"Wyoming","Converse County",5,6,173,92,81
050,56,009,"Wyoming","Converse County",5,7,189,116,73
050,56,009,"Wyoming","Converse County",5,8,193,104,89
050,56,009,"Wyoming","Converse County",5,9,207,101,106
050,56,009,"Wyoming","Converse County",5,10,199,98,101
050,56,009,"Wyoming","Converse County",5,11,207,109,98
050,56,009,"Wyoming","Converse County",5,12,197,95,102
050,56,009,"Wyoming","Converse County",5,13,205,96,109
050,56,009,"Wyoming","Converse County",5,14,207,108,99
050,56,009,"Wyoming","Converse County",5,15,200,105,95
050,56,009,"Wyoming","Converse County",5,16,208,110,98
050,56,009,"Wyoming","Converse County",5,17,193,105,88
050,56,009,"Wyoming","Converse County",5,18,178,91,87
050,56,009,"Wyoming","Converse County",5,19,116,61,55
050,56,009,"Wyoming","Converse County",5,20,118,66,52
050,56,009,"Wyoming","Converse County",5,21,127,66,61
050,56,009,"Wyoming","Converse County",5,22,127,65,62
050,56,009,"Wyoming","Converse County",5,23,150,67,83
050,56,009,"Wyoming","Converse County",5,24,136,73,63
050,56,009,"Wyoming","Converse County",5,25,122,61,61
050,56,009,"Wyoming","Converse County",5,26,141,64,77
050,56,009,"Wyoming","Converse County",5,27,148,67,81
050,56,009,"Wyoming","Converse County",5,28,153,83,70
050,56,009,"Wyoming","Converse County",5,29,171,85,86
050,56,009,"Wyoming","Converse County",5,30,183,92,91
050,56,009,"Wyoming","Converse County",5,31,172,82,90
050,56,009,"Wyoming","Converse County",5,32,171,88,83
050,56,009,"Wyoming","Converse County",5,33,186,94,92
050,56,009,"Wyoming","Converse County",5,34,188,94,94
050,56,009,"Wyoming","Converse County",5,35,185,85,100
050,56,009,"Wyoming","Converse County",5,36,179,87,92
050,56,009,"Wyoming","Converse County",5,37,173,97,76
050,56,009,"Wyoming","Converse County",5,38,171,90,81
050,56,009,"Wyoming","Converse County",5,39,190,97,93
050,56,009,"Wyoming","Converse County",5,40,179,91,88
050,56,009,"Wyoming","Converse County",5,41,197,100,97
050,56,009,"Wyoming","Converse County",5,42,175,94,81
050,56,009,"Wyoming","Converse County",5,43,161,85,76
050,56,009,"Wyoming","Converse County",5,44,155,80,75
050,56,009,"Wyoming","Converse County",5,45,157,80,77
050,56,009,"Wyoming","Converse County",5,46,192,97,95
050,56,009,"Wyoming","Converse County",5,47,165,79,86
050,56,009,"Wyoming","Converse County",5,48,173,94,79
050,56,009,"Wyoming","Converse County",5,49,147,75,72
050,56,009,"Wyoming","Converse County",5,50,140,69,71
050,56,009,"Wyoming","Converse County",5,51,154,81,73
050,56,009,"Wyoming","Converse County",5,52,173,96,77
050,56,009,"Wyoming","Converse County",5,53,167,93,74
050,56,009,"Wyoming","Converse County",5,54,176,87,89
050,56,009,"Wyoming","Converse County",5,55,160,91,69
050,56,009,"Wyoming","Converse County",5,56,158,76,82
050,56,009,"Wyoming","Converse County",5,57,171,86,85
050,56,009,"Wyoming","Converse County",5,58,175,89,86
050,56,009,"Wyoming","Converse County",5,59,180,98,82
050,56,009,"Wyoming","Converse County",5,60,199,108,91
050,56,009,"Wyoming","Converse County",5,61,200,107,93
050,56,009,"Wyoming","Converse County",5,62,221,106,115
050,56,009,"Wyoming","Converse County",5,63,201,100,101
050,56,009,"Wyoming","Converse County",5,64,217,115,102
050,56,009,"Wyoming","Converse County",5,65,212,115,97
050,56,009,"Wyoming","Converse County",5,66,191,106,85
050,56,009,"Wyoming","Converse County",5,67,194,100,94
050,56,009,"Wyoming","Converse County",5,68,171,89,82
050,56,009,"Wyoming","Converse County",5,69,161,80,81
050,56,009,"Wyoming","Converse County",5,70,157,85,72
050,56,009,"Wyoming","Converse County",5,71,150,82,68
050,56,009,"Wyoming","Converse County",5,72,145,72,73
050,56,009,"Wyoming","Converse County",5,73,132,73,59
050,56,009,"Wyoming","Converse County",5,74,117,62,55
050,56,009,"Wyoming","Converse County",5,75,129,61,68
050,56,009,"Wyoming","Converse County",5,76,136,72,64
050,56,009,"Wyoming","Converse County",5,77,78,34,44
050,56,009,"Wyoming","Converse County",5,78,74,35,39
050,56,009,"Wyoming","Converse County",5,79,85,38,47
050,56,009,"Wyoming","Converse County",5,80,74,38,36
050,56,009,"Wyoming","Converse County",5,81,55,22,33
050,56,009,"Wyoming","Converse County",5,82,53,28,25
050,56,009,"Wyoming","Converse County",5,83,46,22,24
050,56,009,"Wyoming","Converse County",5,84,44,15,29
050,56,009,"Wyoming","Converse County",5,85,221,100,121
050,56,011,"Wyoming","Crook County",1,0,100,50,50
050,56,011,"Wyoming","Crook County",1,1,104,46,58
050,56,011,"Wyoming","Crook County",1,2,98,43,55
050,56,011,"Wyoming","Crook County",1,3,87,41,46
050,56,011,"Wyoming","Crook County",1,4,92,48,44
050,56,011,"Wyoming","Crook County",1,5,113,56,57
050,56,011,"Wyoming","Crook County",1,6,97,47,50
050,56,011,"Wyoming","Crook County",1,7,100,47,53
050,56,011,"Wyoming","Crook County",1,8,103,47,56
050,56,011,"Wyoming","Crook County",1,9,105,57,48
050,56,011,"Wyoming","Crook County",1,10,101,49,52
050,56,011,"Wyoming","Crook County",1,11,89,46,43
050,56,011,"Wyoming","Crook County",1,12,112,58,54
050,56,011,"Wyoming","Crook County",1,13,96,51,45
050,56,011,"Wyoming","Crook County",1,14,103,49,54
050,56,011,"Wyoming","Crook County",1,15,98,45,53
050,56,011,"Wyoming","Crook County",1,16,92,42,50
050,56,011,"Wyoming","Crook County",1,17,91,48,43
050,56,011,"Wyoming","Crook County",1,18,78,46,32
050,56,011,"Wyoming","Crook County",1,19,55,33,22
050,56,011,"Wyoming","Crook County",1,20,52,26,26
050,56,011,"Wyoming","Crook County",1,21,48,24,24
050,56,011,"Wyoming","Crook County",1,22,49,22,27
050,56,011,"Wyoming","Crook County",1,23,65,32,33
050,56,011,"Wyoming","Crook County",1,24,58,30,28
050,56,011,"Wyoming","Crook County",1,25,56,33,23
050,56,011,"Wyoming","Crook County",1,26,58,29,29
050,56,011,"Wyoming","Crook County",1,27,63,35,28
050,56,011,"Wyoming","Crook County",1,28,65,30,35
050,56,011,"Wyoming","Crook County",1,29,80,36,44
050,56,011,"Wyoming","Crook County",1,30,77,40,37
050,56,011,"Wyoming","Crook County",1,31,83,43,40
050,56,011,"Wyoming","Crook County",1,32,81,43,38
050,56,011,"Wyoming","Crook County",1,33,78,41,37
050,56,011,"Wyoming","Crook County",1,34,71,38,33
050,56,011,"Wyoming","Crook County",1,35,84,41,43
050,56,011,"Wyoming","Crook County",1,36,77,33,44
050,56,011,"Wyoming","Crook County",1,37,68,39,29
050,56,011,"Wyoming","Crook County",1,38,68,33,35
050,56,011,"Wyoming","Crook County",1,39,78,44,34
050,56,011,"Wyoming","Crook County",1,40,82,48,34
050,56,011,"Wyoming","Crook County",1,41,85,48,37
050,56,011,"Wyoming","Crook County",1,42,76,47,29
050,56,011,"Wyoming","Crook County",1,43,63,36,27
050,56,011,"Wyoming","Crook County",1,44,55,32,23
050,56,011,"Wyoming","Crook County",1,45,62,38,24
050,56,011,"Wyoming","Crook County",1,46,64,29,35
050,56,011,"Wyoming","Crook County",1,47,61,22,39
050,56,011,"Wyoming","Crook County",1,48,66,28,38
050,56,011,"Wyoming","Crook County",1,49,88,49,39
050,56,011,"Wyoming","Crook County",1,50,92,44,48
050,56,011,"Wyoming","Crook County",1,51,88,41,47
050,56,011,"Wyoming","Crook County",1,52,96,44,52
050,56,011,"Wyoming","Crook County",1,53,87,45,42
050,56,011,"Wyoming","Crook County",1,54,91,51,40
050,56,011,"Wyoming","Crook County",1,55,105,57,48
050,56,011,"Wyoming","Crook County",1,56,106,50,56
050,56,011,"Wyoming","Crook County",1,57,106,49,57
050,56,011,"Wyoming","Crook County",1,58,119,59,60
050,56,011,"Wyoming","Crook County",1,59,132,64,68
050,56,011,"Wyoming","Crook County",1,60,109,56,53
050,56,011,"Wyoming","Crook County",1,61,127,63,64
050,56,011,"Wyoming","Crook County",1,62,135,76,59
050,56,011,"Wyoming","Crook County",1,63,138,66,72
050,56,011,"Wyoming","Crook County",1,64,132,68,64
050,56,011,"Wyoming","Crook County",1,65,118,56,62
050,56,011,"Wyoming","Crook County",1,66,113,57,56
050,56,011,"Wyoming","Crook County",1,67,123,71,52
050,56,011,"Wyoming","Crook County",1,68,114,63,51
050,56,011,"Wyoming","Crook County",1,69,97,46,51
050,56,011,"Wyoming","Crook County",1,70,101,48,53
050,56,011,"Wyoming","Crook County",1,71,87,45,42
050,56,011,"Wyoming","Crook County",1,72,77,44,33
050,56,011,"Wyoming","Crook County",1,73,76,46,30
050,56,011,"Wyoming","Crook County",1,74,59,24,35
050,56,011,"Wyoming","Crook County",1,75,65,26,39
050,56,011,"Wyoming","Crook County",1,76,58,30,28
050,56,011,"Wyoming","Crook County",1,77,60,30,30
050,56,011,"Wyoming","Crook County",1,78,49,24,25
050,56,011,"Wyoming","Crook County",1,79,43,24,19
050,56,011,"Wyoming","Crook County",1,80,34,18,16
050,56,011,"Wyoming","Crook County",1,81,40,25,15
050,56,011,"Wyoming","Crook County",1,82,35,18,17
050,56,011,"Wyoming","Crook County",1,83,25,13,12
050,56,011,"Wyoming","Crook County",1,84,18,6,12
050,56,011,"Wyoming","Crook County",1,85,146,58,88
050,56,011,"Wyoming","Crook County",2,0,94,45,49
050,56,011,"Wyoming","Crook County",2,1,104,47,57
050,56,011,"Wyoming","Crook County",2,2,100,44,56
050,56,011,"Wyoming","Crook County",2,3,90,42,48
050,56,011,"Wyoming","Crook County",2,4,92,47,45
050,56,011,"Wyoming","Crook County",2,5,107,53,54
050,56,011,"Wyoming","Crook County",2,6,101,49,52
050,56,011,"Wyoming","Crook County",2,7,99,47,52
050,56,011,"Wyoming","Crook County",2,8,102,47,55
050,56,011,"Wyoming","Crook County",2,9,104,54,50
050,56,011,"Wyoming","Crook County",2,10,102,50,52
050,56,011,"Wyoming","Crook County",2,11,94,48,46
050,56,011,"Wyoming","Crook County",2,12,106,54,52
050,56,011,"Wyoming","Crook County",2,13,100,52,48
050,56,011,"Wyoming","Crook County",2,14,102,50,52
050,56,011,"Wyoming","Crook County",2,15,99,46,53
050,56,011,"Wyoming","Crook County",2,16,93,43,50
050,56,011,"Wyoming","Crook County",2,17,91,47,44
050,56,011,"Wyoming","Crook County",2,18,77,45,32
050,56,011,"Wyoming","Crook County",2,19,57,33,24
050,56,011,"Wyoming","Crook County",2,20,53,27,26
050,56,011,"Wyoming","Crook County",2,21,49,25,24
050,56,011,"Wyoming","Crook County",2,22,49,23,26
050,56,011,"Wyoming","Crook County",2,23,61,30,31
050,56,011,"Wyoming","Crook County",2,24,60,32,28
050,56,011,"Wyoming","Crook County",2,25,56,32,24
050,56,011,"Wyoming","Crook County",2,26,56,29,27
050,56,011,"Wyoming","Crook County",2,27,62,34,28
050,56,011,"Wyoming","Crook County",2,28,66,32,34
050,56,011,"Wyoming","Crook County",2,29,76,34,42
050,56,011,"Wyoming","Crook County",2,30,80,40,40
050,56,011,"Wyoming","Crook County",2,31,84,45,39
050,56,011,"Wyoming","Crook County",2,32,81,42,39
050,56,011,"Wyoming","Crook County",2,33,77,41,36
050,56,011,"Wyoming","Crook County",2,34,74,39,35
050,56,011,"Wyoming","Crook County",2,35,81,41,40
050,56,011,"Wyoming","Crook County",2,36,78,35,43
050,56,011,"Wyoming","Crook County",2,37,70,37,33
050,56,011,"Wyoming","Crook County",2,38,69,34,35
050,56,011,"Wyoming","Crook County",2,39,74,41,33
050,56,011,"Wyoming","Crook County",2,40,81,48,33
050,56,011,"Wyoming","Crook County",2,41,85,50,35
050,56,011,"Wyoming","Crook County",2,42,77,46,31
050,56,011,"Wyoming","Crook County",2,43,66,37,29
050,56,011,"Wyoming","Crook County",2,44,55,32,23
050,56,011,"Wyoming","Crook County",2,45,60,36,24
050,56,011,"Wyoming","Crook County",2,46,62,30,32
050,56,011,"Wyoming","Crook County",2,47,64,24,40
050,56,011,"Wyoming","Crook County",2,48,64,27,37
050,56,011,"Wyoming","Crook County",2,49,84,44,40
050,56,011,"Wyoming","Crook County",2,50,92,46,46
050,56,011,"Wyoming","Crook County",2,51,89,42,47
050,56,011,"Wyoming","Crook County",2,52,94,43,51
050,56,011,"Wyoming","Crook County",2,53,90,46,44
050,56,011,"Wyoming","Crook County",2,54,92,51,41
050,56,011,"Wyoming","Crook County",2,55,103,56,47
050,56,011,"Wyoming","Crook County",2,56,105,51,54
050,56,011,"Wyoming","Crook County",2,57,106,50,56
050,56,011,"Wyoming","Crook County",2,58,115,55,60
050,56,011,"Wyoming","Crook County",2,59,128,62,66
050,56,011,"Wyoming","Crook County",2,60,116,59,57
050,56,011,"Wyoming","Crook County",2,61,125,63,62
050,56,011,"Wyoming","Crook County",2,62,132,72,60
050,56,011,"Wyoming","Crook County",2,63,137,69,68
050,56,011,"Wyoming","Crook County",2,64,133,67,66
050,56,011,"Wyoming","Crook County",2,65,121,58,63
050,56,011,"Wyoming","Crook County",2,66,111,54,57
050,56,011,"Wyoming","Crook County",2,67,122,68,54
050,56,011,"Wyoming","Crook County",2,68,113,63,50
050,56,011,"Wyoming","Crook County",2,69,101,50,51
050,56,011,"Wyoming","Crook County",2,70,100,47,53
050,56,011,"Wyoming","Crook County",2,71,92,46,46
050,56,011,"Wyoming","Crook County",2,72,79,44,35
050,56,011,"Wyoming","Crook County",2,73,80,48,32
050,56,011,"Wyoming","Crook County",2,74,60,27,33
050,56,011,"Wyoming","Crook County",2,75,62,25,37
050,56,011,"Wyoming","Crook County",2,76,59,29,30
050,56,011,"Wyoming","Crook County",2,77,60,31,29
050,56,011,"Wyoming","Crook County",2,78,49,23,26
050,56,011,"Wyoming","Crook County",2,79,42,23,19
050,56,011,"Wyoming","Crook County",2,80,36,19,17
050,56,011,"Wyoming","Crook County",2,81,35,23,12
050,56,011,"Wyoming","Crook County",2,82,38,20,18
050,56,011,"Wyoming","Crook County",2,83,27,14,13
050,56,011,"Wyoming","Crook County",2,84,20,8,12
050,56,011,"Wyoming","Crook County",2,85,146,58,88
050,56,011,"Wyoming","Crook County",3,0,113,51,62
050,56,011,"Wyoming","Crook County",3,1,98,49,49
050,56,011,"Wyoming","Crook County",3,2,105,47,58
050,56,011,"Wyoming","Crook County",3,3,99,43,56
050,56,011,"Wyoming","Crook County",3,4,89,45,44
050,56,011,"Wyoming","Crook County",3,5,98,51,47
050,56,011,"Wyoming","Crook County",3,6,101,53,48
050,56,011,"Wyoming","Crook County",3,7,104,49,55
050,56,011,"Wyoming","Crook County",3,8,100,47,53
050,56,011,"Wyoming","Crook County",3,9,110,49,61
050,56,011,"Wyoming","Crook County",3,10,97,50,47
050,56,011,"Wyoming","Crook County",3,11,104,55,49
050,56,011,"Wyoming","Crook County",3,12,94,51,43
050,56,011,"Wyoming","Crook County",3,13,110,53,57
050,56,011,"Wyoming","Crook County",3,14,110,57,53
050,56,011,"Wyoming","Crook County",3,15,111,54,57
050,56,011,"Wyoming","Crook County",3,16,101,45,56
050,56,011,"Wyoming","Crook County",3,17,97,48,49
050,56,011,"Wyoming","Crook County",3,18,80,43,37
050,56,011,"Wyoming","Crook County",3,19,58,35,23
050,56,011,"Wyoming","Crook County",3,20,68,38,30
050,56,011,"Wyoming","Crook County",3,21,59,32,27
050,56,011,"Wyoming","Crook County",3,22,44,23,21
050,56,011,"Wyoming","Crook County",3,23,53,26,27
050,56,011,"Wyoming","Crook County",3,24,62,31,31
050,56,011,"Wyoming","Crook County",3,25,65,35,30
050,56,011,"Wyoming","Crook County",3,26,60,29,31
050,56,011,"Wyoming","Crook County",3,27,57,31,26
050,56,011,"Wyoming","Crook County",3,28,63,36,27
050,56,011,"Wyoming","Crook County",3,29,64,36,28
050,56,011,"Wyoming","Crook County",3,30,81,39,42
050,56,011,"Wyoming","Crook County",3,31,85,46,39
050,56,011,"Wyoming","Crook County",3,32,90,48,42
050,56,011,"Wyoming","Crook County",3,33,86,44,42
050,56,011,"Wyoming","Crook County",3,34,78,39,39
050,56,011,"Wyoming","Crook County",3,35,76,38,38
050,56,011,"Wyoming","Crook County",3,36,79,39,40
050,56,011,"Wyoming","Crook County",3,37,80,39,41
050,56,011,"Wyoming","Crook County",3,38,70,39,31
050,56,011,"Wyoming","Crook County",3,39,73,35,38
050,56,011,"Wyoming","Crook County",3,40,79,41,38
050,56,011,"Wyoming","Crook County",3,41,86,51,35
050,56,011,"Wyoming","Crook County",3,42,91,54,37
050,56,011,"Wyoming","Crook County",3,43,80,49,31
050,56,011,"Wyoming","Crook County",3,44,69,37,32
050,56,011,"Wyoming","Crook County",3,45,59,32,27
050,56,011,"Wyoming","Crook County",3,46,66,39,27
050,56,011,"Wyoming","Crook County",3,47,69,37,32
050,56,011,"Wyoming","Crook County",3,48,69,25,44
050,56,011,"Wyoming","Crook County",3,49,65,28,37
050,56,011,"Wyoming","Crook County",3,50,89,47,42
050,56,011,"Wyoming","Crook County",3,51,92,47,45
050,56,011,"Wyoming","Crook County",3,52,89,43,46
050,56,011,"Wyoming","Crook County",3,53,93,45,48
050,56,011,"Wyoming","Crook County",3,54,89,49,40
050,56,011,"Wyoming","Crook County",3,55,89,48,41
050,56,011,"Wyoming","Crook County",3,56,105,57,48
050,56,011,"Wyoming","Crook County",3,57,101,51,50
050,56,011,"Wyoming","Crook County",3,58,111,52,59
050,56,011,"Wyoming","Crook County",3,59,123,57,66
050,56,011,"Wyoming","Crook County",3,60,128,60,68
050,56,011,"Wyoming","Crook County",3,61,116,61,55
050,56,011,"Wyoming","Crook County",3,62,125,62,63
050,56,011,"Wyoming","Crook County",3,63,130,71,59
050,56,011,"Wyoming","Crook County",3,64,139,71,68
050,56,011,"Wyoming","Crook County",3,65,133,64,69
050,56,011,"Wyoming","Crook County",3,66,118,61,57
050,56,011,"Wyoming","Crook County",3,67,99,50,49
050,56,011,"Wyoming","Crook County",3,68,122,67,55
050,56,011,"Wyoming","Crook County",3,69,110,60,50
050,56,011,"Wyoming","Crook County",3,70,100,51,49
050,56,011,"Wyoming","Crook County",3,71,100,48,52
050,56,011,"Wyoming","Crook County",3,72,93,47,46
050,56,011,"Wyoming","Crook County",3,73,73,38,35
050,56,011,"Wyoming","Crook County",3,74,80,47,33
050,56,011,"Wyoming","Crook County",3,75,55,24,31
050,56,011,"Wyoming","Crook County",3,76,58,24,34
050,56,011,"Wyoming","Crook County",3,77,53,25,28
050,56,011,"Wyoming","Crook County",3,78,57,29,28
050,56,011,"Wyoming","Crook County",3,79,46,20,26
050,56,011,"Wyoming","Crook County",3,80,34,14,20
050,56,011,"Wyoming","Crook County",3,81,34,18,16
050,56,011,"Wyoming","Crook County",3,82,34,22,12
050,56,011,"Wyoming","Crook County",3,83,36,22,14
050,56,011,"Wyoming","Crook County",3,84,25,12,13
050,56,011,"Wyoming","Crook County",3,85,124,46,78
050,56,011,"Wyoming","Crook County",4,0,89,49,40
050,56,011,"Wyoming","Crook County",4,1,113,51,62
050,56,011,"Wyoming","Crook County",4,2,104,54,50
050,56,011,"Wyoming","Crook County",4,3,104,48,56
050,56,011,"Wyoming","Crook County",4,4,105,50,55
050,56,011,"Wyoming","Crook County",4,5,99,53,46
050,56,011,"Wyoming","Crook County",4,6,106,53,53
050,56,011,"Wyoming","Crook County",4,7,103,57,46
050,56,011,"Wyoming","Crook County",4,8,108,49,59
050,56,011,"Wyoming","Crook County",4,9,97,44,53
050,56,011,"Wyoming","Crook County",4,10,111,48,63
050,56,011,"Wyoming","Crook County",4,11,100,52,48
050,56,011,"Wyoming","Crook County",4,12,99,55,44
050,56,011,"Wyoming","Crook County",4,13,91,47,44
050,56,011,"Wyoming","Crook County",4,14,101,51,50
050,56,011,"Wyoming","Crook County",4,15,110,59,51
050,56,011,"Wyoming","Crook County",4,16,108,54,54
050,56,011,"Wyoming","Crook County",4,17,106,50,56
050,56,011,"Wyoming","Crook County",4,18,82,43,39
050,56,011,"Wyoming","Crook County",4,19,61,33,28
050,56,011,"Wyoming","Crook County",4,20,56,32,24
050,56,011,"Wyoming","Crook County",4,21,63,32,31
050,56,011,"Wyoming","Crook County",4,22,60,34,26
050,56,011,"Wyoming","Crook County",4,23,55,28,27
050,56,011,"Wyoming","Crook County",4,24,60,31,29
050,56,011,"Wyoming","Crook County",4,25,67,33,34
050,56,011,"Wyoming","Crook County",4,26,71,39,32
050,56,011,"Wyoming","Crook County",4,27,58,30,28
050,56,011,"Wyoming","Crook County",4,28,55,30,25
050,56,011,"Wyoming","Crook County",4,29,58,33,25
050,56,011,"Wyoming","Crook County",4,30,59,36,23
050,56,011,"Wyoming","Crook County",4,31,82,42,40
050,56,011,"Wyoming","Crook County",4,32,84,42,42
050,56,011,"Wyoming","Crook County",4,33,92,47,45
050,56,011,"Wyoming","Crook County",4,34,85,44,41
050,56,011,"Wyoming","Crook County",4,35,81,40,41
050,56,011,"Wyoming","Crook County",4,36,74,36,38
050,56,011,"Wyoming","Crook County",4,37,87,47,40
050,56,011,"Wyoming","Crook County",4,38,83,39,44
050,56,011,"Wyoming","Crook County",4,39,63,35,28
050,56,011,"Wyoming","Crook County",4,40,76,35,41
050,56,011,"Wyoming","Crook County",4,41,83,44,39
050,56,011,"Wyoming","Crook County",4,42,90,54,36
050,56,011,"Wyoming","Crook County",4,43,91,56,35
050,56,011,"Wyoming","Crook County",4,44,81,49,32
050,56,011,"Wyoming","Crook County",4,45,71,36,35
050,56,011,"Wyoming","Crook County",4,46,61,36,25
050,56,011,"Wyoming","Crook County",4,47,66,39,27
050,56,011,"Wyoming","Crook County",4,48,71,40,31
050,56,011,"Wyoming","Crook County",4,49,65,24,41
050,56,011,"Wyoming","Crook County",4,50,65,25,40
050,56,011,"Wyoming","Crook County",4,51,90,48,42
050,56,011,"Wyoming","Crook County",4,52,91,47,44
050,56,011,"Wyoming","Crook County",4,53,93,44,49
050,56,011,"Wyoming","Crook County",4,54,95,46,49
050,56,011,"Wyoming","Crook County",4,55,89,53,36
050,56,011,"Wyoming","Crook County",4,56,89,45,44
050,56,011,"Wyoming","Crook County",4,57,107,59,48
050,56,011,"Wyoming","Crook County",4,58,111,57,54
050,56,011,"Wyoming","Crook County",4,59,114,56,58
050,56,011,"Wyoming","Crook County",4,60,126,60,66
050,56,011,"Wyoming","Crook County",4,61,135,60,75
050,56,011,"Wyoming","Crook County",4,62,130,66,64
050,56,011,"Wyoming","Crook County",4,63,126,58,68
050,56,011,"Wyoming","Crook County",4,64,141,80,61
050,56,011,"Wyoming","Crook County",4,65,147,80,67
050,56,011,"Wyoming","Crook County",4,66,135,67,68
050,56,011,"Wyoming","Crook County",4,67,114,63,51
050,56,011,"Wyoming","Crook County",4,68,101,48,53
050,56,011,"Wyoming","Crook County",4,69,122,68,54
050,56,011,"Wyoming","Crook County",4,70,111,60,51
050,56,011,"Wyoming","Crook County",4,71,92,49,43
050,56,011,"Wyoming","Crook County",4,72,94,44,50
050,56,011,"Wyoming","Crook County",4,73,85,41,44
050,56,011,"Wyoming","Crook County",4,74,69,35,34
050,56,011,"Wyoming","Crook County",4,75,77,44,33
050,56,011,"Wyoming","Crook County",4,76,50,23,27
050,56,011,"Wyoming","Crook County",4,77,58,26,32
050,56,011,"Wyoming","Crook County",4,78,53,25,28
050,56,011,"Wyoming","Crook County",4,79,47,25,22
050,56,011,"Wyoming","Crook County",4,80,47,17,30
050,56,011,"Wyoming","Crook County",4,81,33,14,19
050,56,011,"Wyoming","Crook County",4,82,37,19,18
050,56,011,"Wyoming","Crook County",4,83,30,20,10
050,56,011,"Wyoming","Crook County",4,84,38,23,15
050,56,011,"Wyoming","Crook County",4,85,132,50,82
050,56,011,"Wyoming","Crook County",5,0,87,47,40
050,56,011,"Wyoming","Crook County",5,1,89,47,42
050,56,011,"Wyoming","Crook County",5,2,110,50,60
050,56,011,"Wyoming","Crook County",5,3,105,55,50
050,56,011,"Wyoming","Crook County",5,4,99,47,52
050,56,011,"Wyoming","Crook County",5,5,113,53,60
050,56,011,"Wyoming","Crook County",5,6,106,54,52
050,56,011,"Wyoming","Crook County",5,7,119,61,58
050,56,011,"Wyoming","Crook County",5,8,111,61,50
050,56,011,"Wyoming","Crook County",5,9,112,49,63
050,56,011,"Wyoming","Crook County",5,10,95,45,50
050,56,011,"Wyoming","Crook County",5,11,113,52,61
050,56,011,"Wyoming","Crook County",5,12,106,53,53
050,56,011,"Wyoming","Crook County",5,13,105,64,41
050,56,011,"Wyoming","Crook County",5,14,98,52,46
050,56,011,"Wyoming","Crook County",5,15,108,49,59
050,56,011,"Wyoming","Crook County",5,16,110,60,50
050,56,011,"Wyoming","Crook County",5,17,112,57,55
050,56,011,"Wyoming","Crook County",5,18,88,44,44
050,56,011,"Wyoming","Crook County",5,19,57,31,26
050,56,011,"Wyoming","Crook County",5,20,61,31,30
050,56,011,"Wyoming","Crook County",5,21,56,32,24
050,56,011,"Wyoming","Crook County",5,22,66,33,33
050,56,011,"Wyoming","Crook County",5,23,56,30,26
050,56,011,"Wyoming","Crook County",5,24,47,26,21
050,56,011,"Wyoming","Crook County",5,25,68,33,35
050,56,011,"Wyoming","Crook County",5,26,71,34,37
050,56,011,"Wyoming","Crook County",5,27,70,36,34
050,56,011,"Wyoming","Crook County",5,28,57,30,27
050,56,011,"Wyoming","Crook County",5,29,63,34,29
050,56,011,"Wyoming","Crook County",5,30,58,36,22
050,56,011,"Wyoming","Crook County",5,31,63,36,27
050,56,011,"Wyoming","Crook County",5,32,84,43,41
050,56,011,"Wyoming","Crook County",5,33,86,46,40
050,56,011,"Wyoming","Crook County",5,34,89,44,45
050,56,011,"Wyoming","Crook County",5,35,88,43,45
050,56,011,"Wyoming","Crook County",5,36,85,44,41
050,56,011,"Wyoming","Crook County",5,37,85,46,39
050,56,011,"Wyoming","Crook County",5,38,92,51,41
050,56,011,"Wyoming","Crook County",5,39,86,41,45
050,56,011,"Wyoming","Crook County",5,40,70,38,32
050,56,011,"Wyoming","Crook County",5,41,82,37,45
050,56,011,"Wyoming","Crook County",5,42,90,46,44
050,56,011,"Wyoming","Crook County",5,43,95,58,37
050,56,011,"Wyoming","Crook County",5,44,99,61,38
050,56,011,"Wyoming","Crook County",5,45,83,48,35
050,56,011,"Wyoming","Crook County",5,46,71,31,40
050,56,011,"Wyoming","Crook County",5,47,64,42,22
050,56,011,"Wyoming","Crook County",5,48,70,40,30
050,56,011,"Wyoming","Crook County",5,49,70,39,31
050,56,011,"Wyoming","Crook County",5,50,67,24,43
050,56,011,"Wyoming","Crook County",5,51,73,29,44
050,56,011,"Wyoming","Crook County",5,52,100,51,49
050,56,011,"Wyoming","Crook County",5,53,91,48,43
050,56,011,"Wyoming","Crook County",5,54,106,50,56
050,56,011,"Wyoming","Crook County",5,55,93,46,47
050,56,011,"Wyoming","Crook County",5,56,85,51,34
050,56,011,"Wyoming","Crook County",5,57,93,46,47
050,56,011,"Wyoming","Crook County",5,58,113,62,51
050,56,011,"Wyoming","Crook County",5,59,117,63,54
050,56,011,"Wyoming","Crook County",5,60,108,51,57
050,56,011,"Wyoming","Crook County",5,61,123,57,66
050,56,011,"Wyoming","Crook County",5,62,149,64,85
050,56,011,"Wyoming","Crook County",5,63,137,69,68
050,56,011,"Wyoming","Crook County",5,64,117,56,61
050,56,011,"Wyoming","Crook County",5,65,140,80,60
050,56,011,"Wyoming","Crook County",5,66,146,82,64
050,56,011,"Wyoming","Crook County",5,67,131,67,64
050,56,011,"Wyoming","Crook County",5,68,113,61,52
050,56,011,"Wyoming","Crook County",5,69,96,46,50
050,56,011,"Wyoming","Crook County",5,70,122,66,56
050,56,011,"Wyoming","Crook County",5,71,115,60,55
050,56,011,"Wyoming","Crook County",5,72,95,51,44
050,56,011,"Wyoming","Crook County",5,73,91,44,47
050,56,011,"Wyoming","Crook County",5,74,86,41,45
050,56,011,"Wyoming","Crook County",5,75,62,32,30
050,56,011,"Wyoming","Crook County",5,76,71,41,30
050,56,011,"Wyoming","Crook County",5,77,49,23,26
050,56,011,"Wyoming","Crook County",5,78,60,29,31
050,56,011,"Wyoming","Crook County",5,79,48,21,27
050,56,011,"Wyoming","Crook County",5,80,39,21,18
050,56,011,"Wyoming","Crook County",5,81,43,16,27
050,56,011,"Wyoming","Crook County",5,82,36,15,21
050,56,011,"Wyoming","Crook County",5,83,31,16,15
050,56,011,"Wyoming","Crook County",5,84,30,19,11
050,56,011,"Wyoming","Crook County",5,85,148,64,84
050,56,013,"Wyoming","Fremont County",1,0,487,251,236
050,56,013,"Wyoming","Fremont County",1,1,494,257,237
050,56,013,"Wyoming","Fremont County",1,2,469,262,207
050,56,013,"Wyoming","Fremont County",1,3,506,256,250
050,56,013,"Wyoming","Fremont County",1,4,522,269,253
050,56,013,"Wyoming","Fremont County",1,5,537,289,248
050,56,013,"Wyoming","Fremont County",1,6,526,288,238
050,56,013,"Wyoming","Fremont County",1,7,540,288,252
050,56,013,"Wyoming","Fremont County",1,8,532,270,262
050,56,013,"Wyoming","Fremont County",1,9,555,297,258
050,56,013,"Wyoming","Fremont County",1,10,592,290,302
050,56,013,"Wyoming","Fremont County",1,11,599,291,308
050,56,013,"Wyoming","Fremont County",1,12,630,315,315
050,56,013,"Wyoming","Fremont County",1,13,625,312,313
050,56,013,"Wyoming","Fremont County",1,14,584,318,266
050,56,013,"Wyoming","Fremont County",1,15,576,325,251
050,56,013,"Wyoming","Fremont County",1,16,544,277,267
050,56,013,"Wyoming","Fremont County",1,17,552,284,268
050,56,013,"Wyoming","Fremont County",1,18,514,263,251
050,56,013,"Wyoming","Fremont County",1,19,475,240,235
050,56,013,"Wyoming","Fremont County",1,20,464,240,224
050,56,013,"Wyoming","Fremont County",1,21,431,249,182
050,56,013,"Wyoming","Fremont County",1,22,434,241,193
050,56,013,"Wyoming","Fremont County",1,23,404,220,184
050,56,013,"Wyoming","Fremont County",1,24,380,199,181
050,56,013,"Wyoming","Fremont County",1,25,379,193,186
050,56,013,"Wyoming","Fremont County",1,26,408,202,206
050,56,013,"Wyoming","Fremont County",1,27,418,214,204
050,56,013,"Wyoming","Fremont County",1,28,427,204,223
050,56,013,"Wyoming","Fremont County",1,29,457,242,215
050,56,013,"Wyoming","Fremont County",1,30,431,215,216
050,56,013,"Wyoming","Fremont County",1,31,441,214,227
050,56,013,"Wyoming","Fremont County",1,32,449,221,228
050,56,013,"Wyoming","Fremont County",1,33,483,243,240
050,56,013,"Wyoming","Fremont County",1,34,478,253,225
050,56,013,"Wyoming","Fremont County",1,35,488,242,246
050,56,013,"Wyoming","Fremont County",1,36,485,244,241
050,56,013,"Wyoming","Fremont County",1,37,498,245,253
050,56,013,"Wyoming","Fremont County",1,38,519,250,269
050,56,013,"Wyoming","Fremont County",1,39,470,236,234
050,56,013,"Wyoming","Fremont County",1,40,502,265,237
050,56,013,"Wyoming","Fremont County",1,41,471,257,214
050,56,013,"Wyoming","Fremont County",1,42,440,229,211
050,56,013,"Wyoming","Fremont County",1,43,387,199,188
050,56,013,"Wyoming","Fremont County",1,44,388,194,194
050,56,013,"Wyoming","Fremont County",1,45,400,208,192
050,56,013,"Wyoming","Fremont County",1,46,382,194,188
050,56,013,"Wyoming","Fremont County",1,47,393,190,203
050,56,013,"Wyoming","Fremont County",1,48,428,218,210
050,56,013,"Wyoming","Fremont County",1,49,451,240,211
050,56,013,"Wyoming","Fremont County",1,50,470,258,212
050,56,013,"Wyoming","Fremont County",1,51,413,213,200
050,56,013,"Wyoming","Fremont County",1,52,406,189,217
050,56,013,"Wyoming","Fremont County",1,53,445,230,215
050,56,013,"Wyoming","Fremont County",1,54,452,227,225
050,56,013,"Wyoming","Fremont County",1,55,469,248,221
050,56,013,"Wyoming","Fremont County",1,56,485,250,235
050,56,013,"Wyoming","Fremont County",1,57,521,264,257
050,56,013,"Wyoming","Fremont County",1,58,536,272,264
050,56,013,"Wyoming","Fremont County",1,59,573,272,301
050,56,013,"Wyoming","Fremont County",1,60,567,284,283
050,56,013,"Wyoming","Fremont County",1,61,574,292,282
050,56,013,"Wyoming","Fremont County",1,62,567,288,279
050,56,013,"Wyoming","Fremont County",1,63,561,277,284
050,56,013,"Wyoming","Fremont County",1,64,576,282,294
050,56,013,"Wyoming","Fremont County",1,65,560,272,288
050,56,013,"Wyoming","Fremont County",1,66,547,278,269
050,56,013,"Wyoming","Fremont County",1,67,537,269,268
050,56,013,"Wyoming","Fremont County",1,68,534,253,281
050,56,013,"Wyoming","Fremont County",1,69,476,224,252
050,56,013,"Wyoming","Fremont County",1,70,444,216,228
050,56,013,"Wyoming","Fremont County",1,71,433,215,218
050,56,013,"Wyoming","Fremont County",1,72,435,212,223
050,56,013,"Wyoming","Fremont County",1,73,419,214,205
050,56,013,"Wyoming","Fremont County",1,74,302,140,162
050,56,013,"Wyoming","Fremont County",1,75,287,149,138
050,56,013,"Wyoming","Fremont County",1,76,300,160,140
050,56,013,"Wyoming","Fremont County",1,77,282,143,139
050,56,013,"Wyoming","Fremont County",1,78,233,109,124
050,56,013,"Wyoming","Fremont County",1,79,200,90,110
050,56,013,"Wyoming","Fremont County",1,80,184,88,96
050,56,013,"Wyoming","Fremont County",1,81,198,89,109
050,56,013,"Wyoming","Fremont County",1,82,163,82,81
050,56,013,"Wyoming","Fremont County",1,83,151,72,79
050,56,013,"Wyoming","Fremont County",1,84,125,53,72
050,56,013,"Wyoming","Fremont County",1,85,765,280,485
050,56,013,"Wyoming","Fremont County",2,0,471,241,230
050,56,013,"Wyoming","Fremont County",2,1,491,255,236
050,56,013,"Wyoming","Fremont County",2,2,474,260,214
050,56,013,"Wyoming","Fremont County",2,3,493,255,238
050,56,013,"Wyoming","Fremont County",2,4,520,267,253
050,56,013,"Wyoming","Fremont County",2,5,532,284,248
050,56,013,"Wyoming","Fremont County",2,6,527,286,241
050,56,013,"Wyoming","Fremont County",2,7,535,285,250
050,56,013,"Wyoming","Fremont County",2,8,531,272,259
050,56,013,"Wyoming","Fremont County",2,9,549,290,259
050,56,013,"Wyoming","Fremont County",2,10,578,286,292
050,56,013,"Wyoming","Fremont County",2,11,591,287,304
050,56,013,"Wyoming","Fremont County",2,12,625,310,315
050,56,013,"Wyoming","Fremont County",2,13,625,313,312
050,56,013,"Wyoming","Fremont County",2,14,593,317,276
050,56,013,"Wyoming","Fremont County",2,15,581,323,258
050,56,013,"Wyoming","Fremont County",2,16,555,292,263
050,56,013,"Wyoming","Fremont County",2,17,550,282,268
050,56,013,"Wyoming","Fremont County",2,18,515,265,250
050,56,013,"Wyoming","Fremont County",2,19,476,240,236
050,56,013,"Wyoming","Fremont County",2,20,468,240,228
050,56,013,"Wyoming","Fremont County",2,21,431,247,184
050,56,013,"Wyoming","Fremont County",2,22,436,246,190
050,56,013,"Wyoming","Fremont County",2,23,401,217,184
050,56,013,"Wyoming","Fremont County",2,24,390,205,185
050,56,013,"Wyoming","Fremont County",2,25,377,192,185
050,56,013,"Wyoming","Fremont County",2,26,405,204,201
050,56,013,"Wyoming","Fremont County",2,27,412,209,203
050,56,013,"Wyoming","Fremont County",2,28,423,205,218
050,56,013,"Wyoming","Fremont County",2,29,452,236,216
050,56,013,"Wyoming","Fremont County",2,30,435,218,217
050,56,013,"Wyoming","Fremont County",2,31,439,215,224
050,56,013,"Wyoming","Fremont County",2,32,443,216,227
050,56,013,"Wyoming","Fremont County",2,33,475,239,236
050,56,013,"Wyoming","Fremont County",2,34,472,246,226
050,56,013,"Wyoming","Fremont County",2,35,484,245,239
050,56,013,"Wyoming","Fremont County",2,36,483,241,242
050,56,013,"Wyoming","Fremont County",2,37,496,246,250
050,56,013,"Wyoming","Fremont County",2,38,516,249,267
050,56,013,"Wyoming","Fremont County",2,39,481,239,242
050,56,013,"Wyoming","Fremont County",2,40,500,261,239
050,56,013,"Wyoming","Fremont County",2,41,479,263,216
050,56,013,"Wyoming","Fremont County",2,42,438,225,213
050,56,013,"Wyoming","Fremont County",2,43,400,209,191
050,56,013,"Wyoming","Fremont County",2,44,386,195,191
050,56,013,"Wyoming","Fremont County",2,45,391,198,193
050,56,013,"Wyoming","Fremont County",2,46,383,197,186
050,56,013,"Wyoming","Fremont County",2,47,394,192,202
050,56,013,"Wyoming","Fremont County",2,48,421,214,207
050,56,013,"Wyoming","Fremont County",2,49,449,238,211
050,56,013,"Wyoming","Fremont County",2,50,463,253,210
050,56,013,"Wyoming","Fremont County",2,51,425,222,203
050,56,013,"Wyoming","Fremont County",2,52,410,194,216
050,56,013,"Wyoming","Fremont County",2,53,442,226,216
050,56,013,"Wyoming","Fremont County",2,54,450,227,223
050,56,013,"Wyoming","Fremont County",2,55,467,243,224
050,56,013,"Wyoming","Fremont County",2,56,486,253,233
050,56,013,"Wyoming","Fremont County",2,57,513,261,252
050,56,013,"Wyoming","Fremont County",2,58,531,268,263
050,56,013,"Wyoming","Fremont County",2,59,568,274,294
050,56,013,"Wyoming","Fremont County",2,60,566,280,286
050,56,013,"Wyoming","Fremont County",2,61,575,295,280
050,56,013,"Wyoming","Fremont County",2,62,567,287,280
050,56,013,"Wyoming","Fremont County",2,63,563,280,283
050,56,013,"Wyoming","Fremont County",2,64,568,279,289
050,56,013,"Wyoming","Fremont County",2,65,567,275,292
050,56,013,"Wyoming","Fremont County",2,66,554,279,275
050,56,013,"Wyoming","Fremont County",2,67,534,269,265
050,56,013,"Wyoming","Fremont County",2,68,529,252,277
050,56,013,"Wyoming","Fremont County",2,69,491,233,258
050,56,013,"Wyoming","Fremont County",2,70,448,216,232
050,56,013,"Wyoming","Fremont County",2,71,436,215,221
050,56,013,"Wyoming","Fremont County",2,72,423,205,218
050,56,013,"Wyoming","Fremont County",2,73,437,220,217
050,56,013,"Wyoming","Fremont County",2,74,309,146,163
050,56,013,"Wyoming","Fremont County",2,75,290,147,143
050,56,013,"Wyoming","Fremont County",2,76,294,154,140
050,56,013,"Wyoming","Fremont County",2,77,291,149,142
050,56,013,"Wyoming","Fremont County",2,78,241,116,125
050,56,013,"Wyoming","Fremont County",2,79,205,93,112
050,56,013,"Wyoming","Fremont County",2,80,187,89,98
050,56,013,"Wyoming","Fremont County",2,81,190,86,104
050,56,013,"Wyoming","Fremont County",2,82,167,83,84
050,56,013,"Wyoming","Fremont County",2,83,151,71,80
050,56,013,"Wyoming","Fremont County",2,84,124,54,70
050,56,013,"Wyoming","Fremont County",2,85,768,283,485
050,56,013,"Wyoming","Fremont County",3,0,445,216,229
050,56,013,"Wyoming","Fremont County",3,1,473,248,225
050,56,013,"Wyoming","Fremont County",3,2,496,260,236
050,56,013,"Wyoming","Fremont County",3,3,476,261,215
050,56,013,"Wyoming","Fremont County",3,4,502,257,245
050,56,013,"Wyoming","Fremont County",3,5,530,269,261
050,56,013,"Wyoming","Fremont County",3,6,530,290,240
050,56,013,"Wyoming","Fremont County",3,7,543,291,252
050,56,013,"Wyoming","Fremont County",3,8,537,289,248
050,56,013,"Wyoming","Fremont County",3,9,544,281,263
050,56,013,"Wyoming","Fremont County",3,10,533,281,252
050,56,013,"Wyoming","Fremont County",3,11,586,294,292
050,56,013,"Wyoming","Fremont County",3,12,604,298,306
050,56,013,"Wyoming","Fremont County",3,13,618,307,311
050,56,013,"Wyoming","Fremont County",3,14,635,318,317
050,56,013,"Wyoming","Fremont County",3,15,586,310,276
050,56,013,"Wyoming","Fremont County",3,16,577,322,255
050,56,013,"Wyoming","Fremont County",3,17,556,296,260
050,56,013,"Wyoming","Fremont County",3,18,534,268,266
050,56,013,"Wyoming","Fremont County",3,19,482,247,235
050,56,013,"Wyoming","Fremont County",3,20,481,248,233
050,56,013,"Wyoming","Fremont County",3,21,459,251,208
050,56,013,"Wyoming","Fremont County",3,22,419,239,180
050,56,013,"Wyoming","Fremont County",3,23,403,222,181
050,56,013,"Wyoming","Fremont County",3,24,416,223,193
050,56,013,"Wyoming","Fremont County",3,25,407,210,197
050,56,013,"Wyoming","Fremont County",3,26,383,188,195
050,56,013,"Wyoming","Fremont County",3,27,383,198,185
050,56,013,"Wyoming","Fremont County",3,28,419,207,212
050,56,013,"Wyoming","Fremont County",3,29,449,228,221
050,56,013,"Wyoming","Fremont County",3,30,438,220,218
050,56,013,"Wyoming","Fremont County",3,31,464,241,223
050,56,013,"Wyoming","Fremont County",3,32,458,223,235
050,56,013,"Wyoming","Fremont County",3,33,466,248,218
050,56,013,"Wyoming","Fremont County",3,34,472,227,245
050,56,013,"Wyoming","Fremont County",3,35,485,249,236
050,56,013,"Wyoming","Fremont County",3,36,510,254,256
050,56,013,"Wyoming","Fremont County",3,37,478,239,239
050,56,013,"Wyoming","Fremont County",3,38,520,259,261
050,56,013,"Wyoming","Fremont County",3,39,512,241,271
050,56,013,"Wyoming","Fremont County",3,40,493,243,250
050,56,013,"Wyoming","Fremont County",3,41,528,286,242
050,56,013,"Wyoming","Fremont County",3,42,461,229,232
050,56,013,"Wyoming","Fremont County",3,43,437,231,206
050,56,013,"Wyoming","Fremont County",3,44,419,222,197
050,56,013,"Wyoming","Fremont County",3,45,370,186,184
050,56,013,"Wyoming","Fremont County",3,46,390,203,187
050,56,013,"Wyoming","Fremont County",3,47,387,193,194
050,56,013,"Wyoming","Fremont County",3,48,407,207,200
050,56,013,"Wyoming","Fremont County",3,49,426,227,199
050,56,013,"Wyoming","Fremont County",3,50,458,244,214
050,56,013,"Wyoming","Fremont County",3,51,451,237,214
050,56,013,"Wyoming","Fremont County",3,52,440,224,216
050,56,013,"Wyoming","Fremont County",3,53,435,219,216
050,56,013,"Wyoming","Fremont County",3,54,426,209,217
050,56,013,"Wyoming","Fremont County",3,55,438,227,211
050,56,013,"Wyoming","Fremont County",3,56,469,252,217
050,56,013,"Wyoming","Fremont County",3,57,476,248,228
050,56,013,"Wyoming","Fremont County",3,58,496,247,249
050,56,013,"Wyoming","Fremont County",3,59,536,270,266
050,56,013,"Wyoming","Fremont County",3,60,570,273,297
050,56,013,"Wyoming","Fremont County",3,61,576,291,285
050,56,013,"Wyoming","Fremont County",3,62,563,276,287
050,56,013,"Wyoming","Fremont County",3,63,573,284,289
050,56,013,"Wyoming","Fremont County",3,64,574,291,283
050,56,013,"Wyoming","Fremont County",3,65,558,279,279
050,56,013,"Wyoming","Fremont County",3,66,558,274,284
050,56,013,"Wyoming","Fremont County",3,67,533,269,264
050,56,013,"Wyoming","Fremont County",3,68,524,265,259
050,56,013,"Wyoming","Fremont County",3,69,522,245,277
050,56,013,"Wyoming","Fremont County",3,70,480,228,252
050,56,013,"Wyoming","Fremont County",3,71,433,212,221
050,56,013,"Wyoming","Fremont County",3,72,426,207,219
050,56,013,"Wyoming","Fremont County",3,73,416,198,218
050,56,013,"Wyoming","Fremont County",3,74,428,216,212
050,56,013,"Wyoming","Fremont County",3,75,277,133,144
050,56,013,"Wyoming","Fremont County",3,76,288,149,139
050,56,013,"Wyoming","Fremont County",3,77,276,141,135
050,56,013,"Wyoming","Fremont County",3,78,283,147,136
050,56,013,"Wyoming","Fremont County",3,79,230,111,119
050,56,013,"Wyoming","Fremont County",3,80,189,90,99
050,56,013,"Wyoming","Fremont County",3,81,173,75,98
050,56,013,"Wyoming","Fremont County",3,82,174,80,94
050,56,013,"Wyoming","Fremont County",3,83,152,65,87
050,56,013,"Wyoming","Fremont County",3,84,133,59,74
050,56,013,"Wyoming","Fremont County",3,85,755,285,470
050,56,013,"Wyoming","Fremont County",4,0,464,239,225
050,56,013,"Wyoming","Fremont County",4,1,436,214,222
050,56,013,"Wyoming","Fremont County",4,2,472,248,224
050,56,013,"Wyoming","Fremont County",4,3,494,256,238
050,56,013,"Wyoming","Fremont County",4,4,482,267,215
050,56,013,"Wyoming","Fremont County",4,5,483,245,238
050,56,013,"Wyoming","Fremont County",4,6,528,265,263
050,56,013,"Wyoming","Fremont County",4,7,532,285,247
050,56,013,"Wyoming","Fremont County",4,8,534,292,242
050,56,013,"Wyoming","Fremont County",4,9,538,292,246
050,56,013,"Wyoming","Fremont County",4,10,534,278,256
050,56,013,"Wyoming","Fremont County",4,11,542,281,261
050,56,013,"Wyoming","Fremont County",4,12,583,294,289
050,56,013,"Wyoming","Fremont County",4,13,590,288,302
050,56,013,"Wyoming","Fremont County",4,14,622,305,317
050,56,013,"Wyoming","Fremont County",4,15,648,323,325
050,56,013,"Wyoming","Fremont County",4,16,595,315,280
050,56,013,"Wyoming","Fremont County",4,17,584,322,262
050,56,013,"Wyoming","Fremont County",4,18,539,284,255
050,56,013,"Wyoming","Fremont County",4,19,500,249,251
050,56,013,"Wyoming","Fremont County",4,20,486,238,248
050,56,013,"Wyoming","Fremont County",4,21,447,249,198
050,56,013,"Wyoming","Fremont County",4,22,451,259,192
050,56,013,"Wyoming","Fremont County",4,23,403,229,174
050,56,013,"Wyoming","Fremont County",4,24,431,240,191
050,56,013,"Wyoming","Fremont County",4,25,392,210,182
050,56,013,"Wyoming","Fremont County",4,26,418,215,203
050,56,013,"Wyoming","Fremont County",4,27,364,177,187
050,56,013,"Wyoming","Fremont County",4,28,405,199,206
050,56,013,"Wyoming","Fremont County",4,29,444,229,215
050,56,013,"Wyoming","Fremont County",4,30,433,219,214
050,56,013,"Wyoming","Fremont County",4,31,463,245,218
050,56,013,"Wyoming","Fremont County",4,32,462,242,220
050,56,013,"Wyoming","Fremont County",4,33,476,246,230
050,56,013,"Wyoming","Fremont County",4,34,455,237,218
050,56,013,"Wyoming","Fremont County",4,35,462,223,239
050,56,013,"Wyoming","Fremont County",4,36,501,251,250
050,56,013,"Wyoming","Fremont County",4,37,522,265,257
050,56,013,"Wyoming","Fremont County",4,38,502,255,247
050,56,013,"Wyoming","Fremont County",4,39,521,263,258
050,56,013,"Wyoming","Fremont County",4,40,540,257,283
050,56,013,"Wyoming","Fremont County",4,41,529,279,250
050,56,013,"Wyoming","Fremont County",4,42,511,255,256
050,56,013,"Wyoming","Fremont County",4,43,456,235,221
050,56,013,"Wyoming","Fremont County",4,44,442,233,209
050,56,013,"Wyoming","Fremont County",4,45,420,213,207
050,56,013,"Wyoming","Fremont County",4,46,371,191,180
050,56,013,"Wyoming","Fremont County",4,47,411,213,198
050,56,013,"Wyoming","Fremont County",4,48,400,202,198
050,56,013,"Wyoming","Fremont County",4,49,432,228,204
050,56,013,"Wyoming","Fremont County",4,50,423,233,190
050,56,013,"Wyoming","Fremont County",4,51,443,223,220
050,56,013,"Wyoming","Fremont County",4,52,466,232,234
050,56,013,"Wyoming","Fremont County",4,53,460,248,212
050,56,013,"Wyoming","Fremont County",4,54,416,213,203
050,56,013,"Wyoming","Fremont County",4,55,431,212,219
050,56,013,"Wyoming","Fremont County",4,56,453,236,217
050,56,013,"Wyoming","Fremont County",4,57,460,246,214
050,56,013,"Wyoming","Fremont County",4,58,473,243,230
050,56,013,"Wyoming","Fremont County",4,59,505,249,256
050,56,013,"Wyoming","Fremont County",4,60,531,254,277
050,56,013,"Wyoming","Fremont County",4,61,592,296,296
050,56,013,"Wyoming","Fremont County",4,62,572,287,285
050,56,013,"Wyoming","Fremont County",4,63,565,283,282
050,56,013,"Wyoming","Fremont County",4,64,563,283,280
050,56,013,"Wyoming","Fremont County",4,65,572,289,283
050,56,013,"Wyoming","Fremont County",4,66,544,276,268
050,56,013,"Wyoming","Fremont County",4,67,547,266,281
050,56,013,"Wyoming","Fremont County",4,68,521,262,259
050,56,013,"Wyoming","Fremont County",4,69,503,245,258
050,56,013,"Wyoming","Fremont County",4,70,510,237,273
050,56,013,"Wyoming","Fremont County",4,71,461,224,237
050,56,013,"Wyoming","Fremont County",4,72,417,206,211
050,56,013,"Wyoming","Fremont County",4,73,417,202,215
050,56,013,"Wyoming","Fremont County",4,74,405,195,210
050,56,013,"Wyoming","Fremont County",4,75,411,213,198
050,56,013,"Wyoming","Fremont County",4,76,275,136,139
050,56,013,"Wyoming","Fremont County",4,77,270,139,131
050,56,013,"Wyoming","Fremont County",4,78,274,136,138
050,56,013,"Wyoming","Fremont County",4,79,264,139,125
050,56,013,"Wyoming","Fremont County",4,80,206,104,102
050,56,013,"Wyoming","Fremont County",4,81,176,80,96
050,56,013,"Wyoming","Fremont County",4,82,147,69,78
050,56,013,"Wyoming","Fremont County",4,83,160,68,92
050,56,013,"Wyoming","Fremont County",4,84,138,61,77
050,56,013,"Wyoming","Fremont County",4,85,745,286,459
050,56,013,"Wyoming","Fremont County",5,0,443,231,212
050,56,013,"Wyoming","Fremont County",5,1,455,231,224
050,56,013,"Wyoming","Fremont County",5,2,444,219,225
050,56,013,"Wyoming","Fremont County",5,3,458,246,212
050,56,013,"Wyoming","Fremont County",5,4,507,271,236
050,56,013,"Wyoming","Fremont County",5,5,470,255,215
050,56,013,"Wyoming","Fremont County",5,6,496,252,244
050,56,013,"Wyoming","Fremont County",5,7,543,276,267
050,56,013,"Wyoming","Fremont County",5,8,527,282,245
050,56,013,"Wyoming","Fremont County",5,9,548,309,239
050,56,013,"Wyoming","Fremont County",5,10,540,289,251
050,56,013,"Wyoming","Fremont County",5,11,551,292,259
050,56,013,"Wyoming","Fremont County",5,12,574,297,277
050,56,013,"Wyoming","Fremont County",5,13,596,296,300
050,56,013,"Wyoming","Fremont County",5,14,607,298,309
050,56,013,"Wyoming","Fremont County",5,15,647,321,326
050,56,013,"Wyoming","Fremont County",5,16,653,323,330
050,56,013,"Wyoming","Fremont County",5,17,606,321,285
050,56,013,"Wyoming","Fremont County",5,18,558,312,246
050,56,013,"Wyoming","Fremont County",5,19,501,265,236
050,56,013,"Wyoming","Fremont County",5,20,509,250,259
050,56,013,"Wyoming","Fremont County",5,21,451,242,209
050,56,013,"Wyoming","Fremont County",5,22,453,257,196
050,56,013,"Wyoming","Fremont County",5,23,423,235,188
050,56,013,"Wyoming","Fremont County",5,24,432,234,198
050,56,013,"Wyoming","Fremont County",5,25,419,230,189
050,56,013,"Wyoming","Fremont County",5,26,416,224,192
050,56,013,"Wyoming","Fremont County",5,27,391,202,189
050,56,013,"Wyoming","Fremont County",5,28,389,185,204
050,56,013,"Wyoming","Fremont County",5,29,426,211,215
050,56,013,"Wyoming","Fremont County",5,30,447,225,222
050,56,013,"Wyoming","Fremont County",5,31,453,230,223
050,56,013,"Wyoming","Fremont County",5,32,464,245,219
050,56,013,"Wyoming","Fremont County",5,33,483,261,222
050,56,013,"Wyoming","Fremont County",5,34,446,220,226
050,56,013,"Wyoming","Fremont County",5,35,454,232,222
050,56,013,"Wyoming","Fremont County",5,36,476,236,240
050,56,013,"Wyoming","Fremont County",5,37,505,267,238
050,56,013,"Wyoming","Fremont County",5,38,532,269,263
050,56,013,"Wyoming","Fremont County",5,39,508,263,245
050,56,013,"Wyoming","Fremont County",5,40,532,269,263
050,56,013,"Wyoming","Fremont County",5,41,566,286,280
050,56,013,"Wyoming","Fremont County",5,42,504,234,270
050,56,013,"Wyoming","Fremont County",5,43,496,251,245
050,56,013,"Wyoming","Fremont County",5,44,467,244,223
050,56,013,"Wyoming","Fremont County",5,45,430,220,210
050,56,013,"Wyoming","Fremont County",5,46,432,227,205
050,56,013,"Wyoming","Fremont County",5,47,373,187,186
050,56,013,"Wyoming","Fremont County",5,48,417,221,196
050,56,013,"Wyoming","Fremont County",5,49,415,218,197
050,56,013,"Wyoming","Fremont County",5,50,428,229,199
050,56,013,"Wyoming","Fremont County",5,51,412,217,195
050,56,013,"Wyoming","Fremont County",5,52,440,206,234
050,56,013,"Wyoming","Fremont County",5,53,479,254,225
050,56,013,"Wyoming","Fremont County",5,54,450,237,213
050,56,013,"Wyoming","Fremont County",5,55,409,213,196
050,56,013,"Wyoming","Fremont County",5,56,444,218,226
050,56,013,"Wyoming","Fremont County",5,57,449,230,219
050,56,013,"Wyoming","Fremont County",5,58,454,233,221
050,56,013,"Wyoming","Fremont County",5,59,474,242,232
050,56,013,"Wyoming","Fremont County",5,60,497,237,260
050,56,013,"Wyoming","Fremont County",5,61,554,275,279
050,56,013,"Wyoming","Fremont County",5,62,589,284,305
050,56,013,"Wyoming","Fremont County",5,63,578,284,294
050,56,013,"Wyoming","Fremont County",5,64,561,288,273
050,56,013,"Wyoming","Fremont County",5,65,556,284,272
050,56,013,"Wyoming","Fremont County",5,66,560,283,277
050,56,013,"Wyoming","Fremont County",5,67,533,268,265
050,56,013,"Wyoming","Fremont County",5,68,541,264,277
050,56,013,"Wyoming","Fremont County",5,69,512,262,250
050,56,013,"Wyoming","Fremont County",5,70,503,247,256
050,56,013,"Wyoming","Fremont County",5,71,487,231,256
050,56,013,"Wyoming","Fremont County",5,72,447,212,235
050,56,013,"Wyoming","Fremont County",5,73,415,200,215
050,56,013,"Wyoming","Fremont County",5,74,399,193,206
050,56,013,"Wyoming","Fremont County",5,75,388,192,196
050,56,013,"Wyoming","Fremont County",5,76,400,206,194
050,56,013,"Wyoming","Fremont County",5,77,261,130,131
050,56,013,"Wyoming","Fremont County",5,78,263,133,130
050,56,013,"Wyoming","Fremont County",5,79,257,124,133
050,56,013,"Wyoming","Fremont County",5,80,245,135,110
050,56,013,"Wyoming","Fremont County",5,81,193,93,100
050,56,013,"Wyoming","Fremont County",5,82,153,76,77
050,56,013,"Wyoming","Fremont County",5,83,138,62,76
050,56,013,"Wyoming","Fremont County",5,84,145,66,79
050,56,013,"Wyoming","Fremont County",5,85,768,301,467
050,56,015,"Wyoming","Goshen County",1,0,106,53,53
050,56,015,"Wyoming","Goshen County",1,1,117,66,51
050,56,015,"Wyoming","Goshen County",1,2,125,78,47
050,56,015,"Wyoming","Goshen County",1,3,139,72,67
050,56,015,"Wyoming","Goshen County",1,4,132,61,71
050,56,015,"Wyoming","Goshen County",1,5,141,79,62
050,56,015,"Wyoming","Goshen County",1,6,141,73,68
050,56,015,"Wyoming","Goshen County",1,7,127,69,58
050,56,015,"Wyoming","Goshen County",1,8,127,64,63
050,56,015,"Wyoming","Goshen County",1,9,132,65,67
050,56,015,"Wyoming","Goshen County",1,10,141,69,72
050,56,015,"Wyoming","Goshen County",1,11,156,82,74
050,56,015,"Wyoming","Goshen County",1,12,159,82,77
050,56,015,"Wyoming","Goshen County",1,13,156,82,74
050,56,015,"Wyoming","Goshen County",1,14,140,71,69
050,56,015,"Wyoming","Goshen County",1,15,141,73,68
050,56,015,"Wyoming","Goshen County",1,16,147,74,73
050,56,015,"Wyoming","Goshen County",1,17,149,73,76
050,56,015,"Wyoming","Goshen County",1,18,154,79,75
050,56,015,"Wyoming","Goshen County",1,19,216,106,110
050,56,015,"Wyoming","Goshen County",1,20,181,98,83
050,56,015,"Wyoming","Goshen County",1,21,147,83,64
050,56,015,"Wyoming","Goshen County",1,22,154,94,60
050,56,015,"Wyoming","Goshen County",1,23,149,77,72
050,56,015,"Wyoming","Goshen County",1,24,127,73,54
050,56,015,"Wyoming","Goshen County",1,25,125,75,50
050,56,015,"Wyoming","Goshen County",1,26,121,71,50
050,56,015,"Wyoming","Goshen County",1,27,129,71,58
050,56,015,"Wyoming","Goshen County",1,28,147,74,73
050,56,015,"Wyoming","Goshen County",1,29,142,76,66
050,56,015,"Wyoming","Goshen County",1,30,154,87,67
050,56,015,"Wyoming","Goshen County",1,31,147,84,63
050,56,015,"Wyoming","Goshen County",1,32,143,82,61
050,56,015,"Wyoming","Goshen County",1,33,145,86,59
050,56,015,"Wyoming","Goshen County",1,34,141,78,63
050,56,015,"Wyoming","Goshen County",1,35,143,72,71
050,56,015,"Wyoming","Goshen County",1,36,144,82,62
050,56,015,"Wyoming","Goshen County",1,37,162,88,74
050,56,015,"Wyoming","Goshen County",1,38,153,83,70
050,56,015,"Wyoming","Goshen County",1,39,142,79,63
050,56,015,"Wyoming","Goshen County",1,40,157,84,73
050,56,015,"Wyoming","Goshen County",1,41,137,74,63
050,56,015,"Wyoming","Goshen County",1,42,124,69,55
050,56,015,"Wyoming","Goshen County",1,43,140,79,61
050,56,015,"Wyoming","Goshen County",1,44,141,94,47
050,56,015,"Wyoming","Goshen County",1,45,120,74,46
050,56,015,"Wyoming","Goshen County",1,46,131,66,65
050,56,015,"Wyoming","Goshen County",1,47,147,83,64
050,56,015,"Wyoming","Goshen County",1,48,159,87,72
050,56,015,"Wyoming","Goshen County",1,49,157,96,61
050,56,015,"Wyoming","Goshen County",1,50,137,84,53
050,56,015,"Wyoming","Goshen County",1,51,135,80,55
050,56,015,"Wyoming","Goshen County",1,52,145,84,61
050,56,015,"Wyoming","Goshen County",1,53,139,78,61
050,56,015,"Wyoming","Goshen County",1,54,144,82,62
050,56,015,"Wyoming","Goshen County",1,55,143,79,64
050,56,015,"Wyoming","Goshen County",1,56,164,88,76
050,56,015,"Wyoming","Goshen County",1,57,165,86,79
050,56,015,"Wyoming","Goshen County",1,58,170,90,80
050,56,015,"Wyoming","Goshen County",1,59,189,104,85
050,56,015,"Wyoming","Goshen County",1,60,196,96,100
050,56,015,"Wyoming","Goshen County",1,61,191,85,106
050,56,015,"Wyoming","Goshen County",1,62,189,94,95
050,56,015,"Wyoming","Goshen County",1,63,194,100,94
050,56,015,"Wyoming","Goshen County",1,64,203,105,98
050,56,015,"Wyoming","Goshen County",1,65,195,103,92
050,56,015,"Wyoming","Goshen County",1,66,169,86,83
050,56,015,"Wyoming","Goshen County",1,67,164,90,74
050,56,015,"Wyoming","Goshen County",1,68,162,87,75
050,56,015,"Wyoming","Goshen County",1,69,149,80,69
050,56,015,"Wyoming","Goshen County",1,70,148,75,73
050,56,015,"Wyoming","Goshen County",1,71,149,77,72
050,56,015,"Wyoming","Goshen County",1,72,141,70,71
050,56,015,"Wyoming","Goshen County",1,73,162,83,79
050,56,015,"Wyoming","Goshen County",1,74,113,55,58
050,56,015,"Wyoming","Goshen County",1,75,111,48,63
050,56,015,"Wyoming","Goshen County",1,76,111,53,58
050,56,015,"Wyoming","Goshen County",1,77,126,54,72
050,56,015,"Wyoming","Goshen County",1,78,97,43,54
050,56,015,"Wyoming","Goshen County",1,79,88,45,43
050,56,015,"Wyoming","Goshen County",1,80,82,40,42
050,56,015,"Wyoming","Goshen County",1,81,91,46,45
050,56,015,"Wyoming","Goshen County",1,82,81,37,44
050,56,015,"Wyoming","Goshen County",1,83,67,24,43
050,56,015,"Wyoming","Goshen County",1,84,52,22,30
050,56,015,"Wyoming","Goshen County",1,85,387,135,252
050,56,015,"Wyoming","Goshen County",2,0,122,60,62
050,56,015,"Wyoming","Goshen County",2,1,112,61,51
050,56,015,"Wyoming","Goshen County",2,2,123,74,49
050,56,015,"Wyoming","Goshen County",2,3,135,73,62
050,56,015,"Wyoming","Goshen County",2,4,134,64,70
050,56,015,"Wyoming","Goshen County",2,5,141,76,65
050,56,015,"Wyoming","Goshen County",2,6,144,77,67
050,56,015,"Wyoming","Goshen County",2,7,128,69,59
050,56,015,"Wyoming","Goshen County",2,8,126,65,61
050,56,015,"Wyoming","Goshen County",2,9,132,66,66
050,56,015,"Wyoming","Goshen County",2,10,140,68,72
050,56,015,"Wyoming","Goshen County",2,11,152,78,74
050,56,015,"Wyoming","Goshen County",2,12,159,82,77
050,56,015,"Wyoming","Goshen County",2,13,157,81,76
050,56,015,"Wyoming","Goshen County",2,14,146,75,71
050,56,015,"Wyoming","Goshen County",2,15,140,72,68
050,56,015,"Wyoming","Goshen County",2,16,144,73,71
050,56,015,"Wyoming","Goshen County",2,17,148,74,74
050,56,015,"Wyoming","Goshen County",2,18,155,79,76
050,56,015,"Wyoming","Goshen County",2,19,214,106,108
050,56,015,"Wyoming","Goshen County",2,20,182,99,83
050,56,015,"Wyoming","Goshen County",2,21,151,85,66
050,56,015,"Wyoming","Goshen County",2,22,149,89,60
050,56,015,"Wyoming","Goshen County",2,23,150,80,70
050,56,015,"Wyoming","Goshen County",2,24,130,73,57
050,56,015,"Wyoming","Goshen County",2,25,127,77,50
050,56,015,"Wyoming","Goshen County",2,26,122,72,50
050,56,015,"Wyoming","Goshen County",2,27,132,74,58
050,56,015,"Wyoming","Goshen County",2,28,140,70,70
050,56,015,"Wyoming","Goshen County",2,29,144,77,67
050,56,015,"Wyoming","Goshen County",2,30,153,86,67
050,56,015,"Wyoming","Goshen County",2,31,145,83,62
050,56,015,"Wyoming","Goshen County",2,32,146,84,62
050,56,015,"Wyoming","Goshen County",2,33,146,87,59
050,56,015,"Wyoming","Goshen County",2,34,138,76,62
050,56,015,"Wyoming","Goshen County",2,35,145,74,71
050,56,015,"Wyoming","Goshen County",2,36,144,80,64
050,56,015,"Wyoming","Goshen County",2,37,157,86,71
050,56,015,"Wyoming","Goshen County",2,38,153,83,70
050,56,015,"Wyoming","Goshen County",2,39,149,82,67
050,56,015,"Wyoming","Goshen County",2,40,156,85,71
050,56,015,"Wyoming","Goshen County",2,41,138,75,63
050,56,015,"Wyoming","Goshen County",2,42,124,68,56
050,56,015,"Wyoming","Goshen County",2,43,139,78,61
050,56,015,"Wyoming","Goshen County",2,44,139,92,47
050,56,015,"Wyoming","Goshen County",2,45,126,79,47
050,56,015,"Wyoming","Goshen County",2,46,126,65,61
050,56,015,"Wyoming","Goshen County",2,47,143,78,65
050,56,015,"Wyoming","Goshen County",2,48,157,86,71
050,56,015,"Wyoming","Goshen County",2,49,159,95,64
050,56,015,"Wyoming","Goshen County",2,50,143,86,57
050,56,015,"Wyoming","Goshen County",2,51,137,83,54
050,56,015,"Wyoming","Goshen County",2,52,144,83,61
050,56,015,"Wyoming","Goshen County",2,53,139,78,61
050,56,015,"Wyoming","Goshen County",2,54,145,83,62
050,56,015,"Wyoming","Goshen County",2,55,140,76,64
050,56,015,"Wyoming","Goshen County",2,56,159,86,73
050,56,015,"Wyoming","Goshen County",2,57,164,85,79
050,56,015,"Wyoming","Goshen County",2,58,169,90,79
050,56,015,"Wyoming","Goshen County",2,59,186,101,85
050,56,015,"Wyoming","Goshen County",2,60,195,99,96
050,56,015,"Wyoming","Goshen County",2,61,188,86,102
050,56,015,"Wyoming","Goshen County",2,62,187,91,96
050,56,015,"Wyoming","Goshen County",2,63,193,98,95
050,56,015,"Wyoming","Goshen County",2,64,200,103,97
050,56,015,"Wyoming","Goshen County",2,65,197,102,95
050,56,015,"Wyoming","Goshen County",2,66,177,92,85
050,56,015,"Wyoming","Goshen County",2,67,164,89,75
050,56,015,"Wyoming","Goshen County",2,68,163,88,75
050,56,015,"Wyoming","Goshen County",2,69,153,83,70
050,56,015,"Wyoming","Goshen County",2,70,147,75,72
050,56,015,"Wyoming","Goshen County",2,71,149,77,72
050,56,015,"Wyoming","Goshen County",2,72,137,68,69
050,56,015,"Wyoming","Goshen County",2,73,167,86,81
050,56,015,"Wyoming","Goshen County",2,74,116,57,59
050,56,015,"Wyoming","Goshen County",2,75,110,48,62
050,56,015,"Wyoming","Goshen County",2,76,110,52,58
050,56,015,"Wyoming","Goshen County",2,77,123,53,70
050,56,015,"Wyoming","Goshen County",2,78,101,44,57
050,56,015,"Wyoming","Goshen County",2,79,85,42,43
050,56,015,"Wyoming","Goshen County",2,80,85,43,42
050,56,015,"Wyoming","Goshen County",2,81,90,45,45
050,56,015,"Wyoming","Goshen County",2,82,83,39,44
050,56,015,"Wyoming","Goshen County",2,83,67,27,40
050,56,015,"Wyoming","Goshen County",2,84,55,22,33
050,56,015,"Wyoming","Goshen County",2,85,385,135,250
050,56,015,"Wyoming","Goshen County",3,0,121,55,66
050,56,015,"Wyoming","Goshen County",3,1,126,58,68
050,56,015,"Wyoming","Goshen County",3,2,111,59,52
050,56,015,"Wyoming","Goshen County",3,3,123,73,50
050,56,015,"Wyoming","Goshen County",3,4,145,81,64
050,56,015,"Wyoming","Goshen County",3,5,134,61,73
050,56,015,"Wyoming","Goshen County",3,6,136,78,58
050,56,015,"Wyoming","Goshen County",3,7,137,75,62
050,56,015,"Wyoming","Goshen County",3,8,131,67,64
050,56,015,"Wyoming","Goshen County",3,9,128,68,60
050,56,015,"Wyoming","Goshen County",3,10,128,68,60
050,56,015,"Wyoming","Goshen County",3,11,138,64,74
050,56,015,"Wyoming","Goshen County",3,12,154,79,75
050,56,015,"Wyoming","Goshen County",3,13,154,73,81
050,56,015,"Wyoming","Goshen County",3,14,161,81,80
050,56,015,"Wyoming","Goshen County",3,15,141,72,69
050,56,015,"Wyoming","Goshen County",3,16,145,72,73
050,56,015,"Wyoming","Goshen County",3,17,134,69,65
050,56,015,"Wyoming","Goshen County",3,18,157,78,79
050,56,015,"Wyoming","Goshen County",3,19,208,105,103
050,56,015,"Wyoming","Goshen County",3,20,189,102,87
050,56,015,"Wyoming","Goshen County",3,21,169,88,81
050,56,015,"Wyoming","Goshen County",3,22,143,84,59
050,56,015,"Wyoming","Goshen County",3,23,141,76,65
050,56,015,"Wyoming","Goshen County",3,24,156,86,70
050,56,015,"Wyoming","Goshen County",3,25,129,77,52
050,56,015,"Wyoming","Goshen County",3,26,119,69,50
050,56,015,"Wyoming","Goshen County",3,27,139,87,52
050,56,015,"Wyoming","Goshen County",3,28,128,63,65
050,56,015,"Wyoming","Goshen County",3,29,150,79,71
050,56,015,"Wyoming","Goshen County",3,30,148,83,65
050,56,015,"Wyoming","Goshen County",3,31,158,87,71
050,56,015,"Wyoming","Goshen County",3,32,148,91,57
050,56,015,"Wyoming","Goshen County",3,33,156,92,64
050,56,015,"Wyoming","Goshen County",3,34,129,73,56
050,56,015,"Wyoming","Goshen County",3,35,139,82,57
050,56,015,"Wyoming","Goshen County",3,36,158,83,75
050,56,015,"Wyoming","Goshen County",3,37,145,83,62
050,56,015,"Wyoming","Goshen County",3,38,149,79,70
050,56,015,"Wyoming","Goshen County",3,39,152,86,66
050,56,015,"Wyoming","Goshen County",3,40,169,102,67
050,56,015,"Wyoming","Goshen County",3,41,157,91,66
050,56,015,"Wyoming","Goshen County",3,42,122,60,62
050,56,015,"Wyoming","Goshen County",3,43,135,74,61
050,56,015,"Wyoming","Goshen County",3,44,148,90,58
050,56,015,"Wyoming","Goshen County",3,45,133,93,40
050,56,015,"Wyoming","Goshen County",3,46,117,71,46
050,56,015,"Wyoming","Goshen County",3,47,123,68,55
050,56,015,"Wyoming","Goshen County",3,48,141,78,63
050,56,015,"Wyoming","Goshen County",3,49,161,89,72
050,56,015,"Wyoming","Goshen County",3,50,152,91,61
050,56,015,"Wyoming","Goshen County",3,51,137,80,57
050,56,015,"Wyoming","Goshen County",3,52,136,81,55
050,56,015,"Wyoming","Goshen County",3,53,148,88,60
050,56,015,"Wyoming","Goshen County",3,54,151,85,66
050,56,015,"Wyoming","Goshen County",3,55,130,72,58
050,56,015,"Wyoming","Goshen County",3,56,144,79,65
050,56,015,"Wyoming","Goshen County",3,57,162,87,75
050,56,015,"Wyoming","Goshen County",3,58,168,89,79
050,56,015,"Wyoming","Goshen County",3,59,180,102,78
050,56,015,"Wyoming","Goshen County",3,60,181,99,82
050,56,015,"Wyoming","Goshen County",3,61,199,100,99
050,56,015,"Wyoming","Goshen County",3,62,187,83,104
050,56,015,"Wyoming","Goshen County",3,63,188,96,92
050,56,015,"Wyoming","Goshen County",3,64,192,97,95
050,56,015,"Wyoming","Goshen County",3,65,203,104,99
050,56,015,"Wyoming","Goshen County",3,66,201,103,98
050,56,015,"Wyoming","Goshen County",3,67,177,92,85
050,56,015,"Wyoming","Goshen County",3,68,165,89,76
050,56,015,"Wyoming","Goshen County",3,69,176,95,81
050,56,015,"Wyoming","Goshen County",3,70,138,73,65
050,56,015,"Wyoming","Goshen County",3,71,147,74,73
050,56,015,"Wyoming","Goshen County",3,72,145,76,69
050,56,015,"Wyoming","Goshen County",3,73,140,74,66
050,56,015,"Wyoming","Goshen County",3,74,158,78,80
050,56,015,"Wyoming","Goshen County",3,75,112,53,59
050,56,015,"Wyoming","Goshen County",3,76,104,46,58
050,56,015,"Wyoming","Goshen County",3,77,107,49,58
050,56,015,"Wyoming","Goshen County",3,78,111,45,66
050,56,015,"Wyoming","Goshen County",3,79,90,38,52
050,56,015,"Wyoming","Goshen County",3,80,85,43,42
050,56,015,"Wyoming","Goshen County",3,81,86,42,44
050,56,015,"Wyoming","Goshen County",3,82,76,39,37
050,56,015,"Wyoming","Goshen County",3,83,81,38,43
050,56,015,"Wyoming","Goshen County",3,84,60,25,35
050,56,015,"Wyoming","Goshen County",3,85,388,140,248
050,56,015,"Wyoming","Goshen County",4,0,119,63,56
050,56,015,"Wyoming","Goshen County",4,1,116,51,65
050,56,015,"Wyoming","Goshen County",4,2,122,58,64
050,56,015,"Wyoming","Goshen County",4,3,115,58,57
050,56,015,"Wyoming","Goshen County",4,4,125,73,52
050,56,015,"Wyoming","Goshen County",4,5,154,85,69
050,56,015,"Wyoming","Goshen County",4,6,133,64,69
050,56,015,"Wyoming","Goshen County",4,7,146,78,68
050,56,015,"Wyoming","Goshen County",4,8,143,78,65
050,56,015,"Wyoming","Goshen County",4,9,138,72,66
050,56,015,"Wyoming","Goshen County",4,10,130,65,65
050,56,015,"Wyoming","Goshen County",4,11,137,77,60
050,56,015,"Wyoming","Goshen County",4,12,146,69,77
050,56,015,"Wyoming","Goshen County",4,13,158,83,75
050,56,015,"Wyoming","Goshen County",4,14,159,78,81
050,56,015,"Wyoming","Goshen County",4,15,156,77,79
050,56,015,"Wyoming","Goshen County",4,16,139,70,69
050,56,015,"Wyoming","Goshen County",4,17,142,73,69
050,56,015,"Wyoming","Goshen County",4,18,155,81,74
050,56,015,"Wyoming","Goshen County",4,19,210,100,110
050,56,015,"Wyoming","Goshen County",4,20,181,107,74
050,56,015,"Wyoming","Goshen County",4,21,177,99,78
050,56,015,"Wyoming","Goshen County",4,22,141,82,59
050,56,015,"Wyoming","Goshen County",4,23,156,81,75
050,56,015,"Wyoming","Goshen County",4,24,131,70,61
050,56,015,"Wyoming","Goshen County",4,25,151,83,68
050,56,015,"Wyoming","Goshen County",4,26,126,78,48
050,56,015,"Wyoming","Goshen County",4,27,113,71,42
050,56,015,"Wyoming","Goshen County",4,28,117,61,56
050,56,015,"Wyoming","Goshen County",4,29,134,67,67
050,56,015,"Wyoming","Goshen County",4,30,148,80,68
050,56,015,"Wyoming","Goshen County",4,31,146,79,67
050,56,015,"Wyoming","Goshen County",4,32,162,91,71
050,56,015,"Wyoming","Goshen County",4,33,159,105,54
050,56,015,"Wyoming","Goshen County",4,34,139,75,64
050,56,015,"Wyoming","Goshen County",4,35,125,73,52
050,56,015,"Wyoming","Goshen County",4,36,144,90,54
050,56,015,"Wyoming","Goshen County",4,37,155,74,81
050,56,015,"Wyoming","Goshen County",4,38,147,83,64
050,56,015,"Wyoming","Goshen County",4,39,166,89,77
050,56,015,"Wyoming","Goshen County",4,40,166,99,67
050,56,015,"Wyoming","Goshen County",4,41,173,103,70
050,56,015,"Wyoming","Goshen County",4,42,147,79,68
050,56,015,"Wyoming","Goshen County",4,43,137,64,73
050,56,015,"Wyoming","Goshen County",4,44,135,80,55
050,56,015,"Wyoming","Goshen County",4,45,144,86,58
050,56,015,"Wyoming","Goshen County",4,46,121,80,41
050,56,015,"Wyoming","Goshen County",4,47,123,76,47
050,56,015,"Wyoming","Goshen County",4,48,128,72,56
050,56,015,"Wyoming","Goshen County",4,49,141,76,65
050,56,015,"Wyoming","Goshen County",4,50,162,93,69
050,56,015,"Wyoming","Goshen County",4,51,150,89,61
050,56,015,"Wyoming","Goshen County",4,52,146,85,61
050,56,015,"Wyoming","Goshen County",4,53,131,79,52
050,56,015,"Wyoming","Goshen County",4,54,151,91,60
050,56,015,"Wyoming","Goshen County",4,55,139,74,65
050,56,015,"Wyoming","Goshen County",4,56,131,75,56
050,56,015,"Wyoming","Goshen County",4,57,139,73,66
050,56,015,"Wyoming","Goshen County",4,58,168,90,78
050,56,015,"Wyoming","Goshen County",4,59,170,93,77
050,56,015,"Wyoming","Goshen County",4,60,180,101,79
050,56,015,"Wyoming","Goshen County",4,61,186,100,86
050,56,015,"Wyoming","Goshen County",4,62,202,99,103
050,56,015,"Wyoming","Goshen County",4,63,197,93,104
050,56,015,"Wyoming","Goshen County",4,64,188,97,91
050,56,015,"Wyoming","Goshen County",4,65,195,97,98
050,56,015,"Wyoming","Goshen County",4,66,197,102,95
050,56,015,"Wyoming","Goshen County",4,67,196,99,97
050,56,015,"Wyoming","Goshen County",4,68,180,96,84
050,56,015,"Wyoming","Goshen County",4,69,170,87,83
050,56,015,"Wyoming","Goshen County",4,70,167,89,78
050,56,015,"Wyoming","Goshen County",4,71,138,74,64
050,56,015,"Wyoming","Goshen County",4,72,143,69,74
050,56,015,"Wyoming","Goshen County",4,73,153,82,71
050,56,015,"Wyoming","Goshen County",4,74,130,64,66
050,56,015,"Wyoming","Goshen County",4,75,152,76,76
050,56,015,"Wyoming","Goshen County",4,76,107,53,54
050,56,015,"Wyoming","Goshen County",4,77,105,46,59
050,56,015,"Wyoming","Goshen County",4,78,97,43,54
050,56,015,"Wyoming","Goshen County",4,79,105,42,63
050,56,015,"Wyoming","Goshen County",4,80,86,36,50
050,56,015,"Wyoming","Goshen County",4,81,91,44,47
050,56,015,"Wyoming","Goshen County",4,82,77,38,39
050,56,015,"Wyoming","Goshen County",4,83,76,40,36
050,56,015,"Wyoming","Goshen County",4,84,69,30,39
050,56,015,"Wyoming","Goshen County",4,85,386,145,241
050,56,015,"Wyoming","Goshen County",5,0,108,56,52
050,56,015,"Wyoming","Goshen County",5,1,130,71,59
050,56,015,"Wyoming","Goshen County",5,2,114,55,59
050,56,015,"Wyoming","Goshen County",5,3,127,62,65
050,56,015,"Wyoming","Goshen County",5,4,113,57,56
050,56,015,"Wyoming","Goshen County",5,5,134,73,61
050,56,015,"Wyoming","Goshen County",5,6,153,84,69
050,56,015,"Wyoming","Goshen County",5,7,140,68,72
050,56,015,"Wyoming","Goshen County",5,8,145,78,67
050,56,015,"Wyoming","Goshen County",5,9,150,83,67
050,56,015,"Wyoming","Goshen County",5,10,137,72,65
050,56,015,"Wyoming","Goshen County",5,11,130,68,62
050,56,015,"Wyoming","Goshen County",5,12,138,78,60
050,56,015,"Wyoming","Goshen County",5,13,143,69,74
050,56,015,"Wyoming","Goshen County",5,14,165,84,81
050,56,015,"Wyoming","Goshen County",5,15,157,74,83
050,56,015,"Wyoming","Goshen County",5,16,159,77,82
050,56,015,"Wyoming","Goshen County",5,17,128,67,61
050,56,015,"Wyoming","Goshen County",5,18,166,84,82
050,56,015,"Wyoming","Goshen County",5,19,209,106,103
050,56,015,"Wyoming","Goshen County",5,20,177,102,75
050,56,015,"Wyoming","Goshen County",5,21,173,105,68
050,56,015,"Wyoming","Goshen County",5,22,153,92,61
050,56,015,"Wyoming","Goshen County",5,23,145,76,69
050,56,015,"Wyoming","Goshen County",5,24,144,77,67
050,56,015,"Wyoming","Goshen County",5,25,127,75,52
050,56,015,"Wyoming","Goshen County",5,26,145,73,72
050,56,015,"Wyoming","Goshen County",5,27,135,83,52
050,56,015,"Wyoming","Goshen County",5,28,104,64,40
050,56,015,"Wyoming","Goshen County",5,29,126,66,60
050,56,015,"Wyoming","Goshen County",5,30,135,71,64
050,56,015,"Wyoming","Goshen County",5,31,151,83,68
050,56,015,"Wyoming","Goshen County",5,32,151,80,71
050,56,015,"Wyoming","Goshen County",5,33,168,99,69
050,56,015,"Wyoming","Goshen County",5,34,138,83,55
050,56,015,"Wyoming","Goshen County",5,35,130,69,61
050,56,015,"Wyoming","Goshen County",5,36,130,76,54
050,56,015,"Wyoming","Goshen County",5,37,140,89,51
050,56,015,"Wyoming","Goshen County",5,38,164,73,91
050,56,015,"Wyoming","Goshen County",5,39,150,85,65
050,56,015,"Wyoming","Goshen County",5,40,181,101,80
050,56,015,"Wyoming","Goshen County",5,41,153,83,70
050,56,015,"Wyoming","Goshen County",5,42,159,91,68
050,56,015,"Wyoming","Goshen County",5,43,154,84,70
050,56,015,"Wyoming","Goshen County",5,44,148,75,73
050,56,015,"Wyoming","Goshen County",5,45,136,81,55
050,56,015,"Wyoming","Goshen County",5,46,138,77,61
050,56,015,"Wyoming","Goshen County",5,47,123,78,45
050,56,015,"Wyoming","Goshen County",5,48,122,79,43
050,56,015,"Wyoming","Goshen County",5,49,130,74,56
050,56,015,"Wyoming","Goshen County",5,50,144,79,65
050,56,015,"Wyoming","Goshen County",5,51,155,86,69
050,56,015,"Wyoming","Goshen County",5,52,149,88,61
050,56,015,"Wyoming","Goshen County",5,53,144,81,63
050,56,015,"Wyoming","Goshen County",5,54,136,82,54
050,56,015,"Wyoming","Goshen County",5,55,145,82,63
050,56,015,"Wyoming","Goshen County",5,56,142,76,66
050,56,015,"Wyoming","Goshen County",5,57,120,66,54
050,56,015,"Wyoming","Goshen County",5,58,143,77,66
050,56,015,"Wyoming","Goshen County",5,59,179,96,83
050,56,015,"Wyoming","Goshen County",5,60,168,94,74
050,56,015,"Wyoming","Goshen County",5,61,175,96,79
050,56,015,"Wyoming","Goshen County",5,62,175,90,85
050,56,015,"Wyoming","Goshen County",5,63,212,103,109
050,56,015,"Wyoming","Goshen County",5,64,196,94,102
050,56,015,"Wyoming","Goshen County",5,65,188,98,90
050,56,015,"Wyoming","Goshen County",5,66,193,96,97
050,56,015,"Wyoming","Goshen County",5,67,190,99,91
050,56,015,"Wyoming","Goshen County",5,68,196,99,97
050,56,015,"Wyoming","Goshen County",5,69,182,95,87
050,56,015,"Wyoming","Goshen County",5,70,168,84,84
050,56,015,"Wyoming","Goshen County",5,71,166,91,75
050,56,015,"Wyoming","Goshen County",5,72,133,69,64
050,56,015,"Wyoming","Goshen County",5,73,147,73,74
050,56,015,"Wyoming","Goshen County",5,74,145,74,71
050,56,015,"Wyoming","Goshen County",5,75,124,61,63
050,56,015,"Wyoming","Goshen County",5,76,151,77,74
050,56,015,"Wyoming","Goshen County",5,77,106,52,54
050,56,015,"Wyoming","Goshen County",5,78,98,41,57
050,56,015,"Wyoming","Goshen County",5,79,90,41,49
050,56,015,"Wyoming","Goshen County",5,80,102,40,62
050,56,015,"Wyoming","Goshen County",5,81,86,33,53
050,56,015,"Wyoming","Goshen County",5,82,80,39,41
050,56,015,"Wyoming","Goshen County",5,83,73,37,36
050,56,015,"Wyoming","Goshen County",5,84,71,40,31
050,56,015,"Wyoming","Goshen County",5,85,394,154,240
050,56,017,"Wyoming","Hot Springs County",1,0,47,24,23
050,56,017,"Wyoming","Hot Springs County",1,1,41,21,20
050,56,017,"Wyoming","Hot Springs County",1,2,44,24,20
050,56,017,"Wyoming","Hot Springs County",1,3,49,29,20
050,56,017,"Wyoming","Hot Springs County",1,4,52,23,29
050,56,017,"Wyoming","Hot Springs County",1,5,54,30,24
050,56,017,"Wyoming","Hot Springs County",1,6,52,29,23
050,56,017,"Wyoming","Hot Springs County",1,7,58,28,30
050,56,017,"Wyoming","Hot Springs County",1,8,62,31,31
050,56,017,"Wyoming","Hot Springs County",1,9,50,30,20
050,56,017,"Wyoming","Hot Springs County",1,10,50,32,18
050,56,017,"Wyoming","Hot Springs County",1,11,50,29,21
050,56,017,"Wyoming","Hot Springs County",1,12,65,32,33
050,56,017,"Wyoming","Hot Springs County",1,13,74,35,39
050,56,017,"Wyoming","Hot Springs County",1,14,63,30,33
050,56,017,"Wyoming","Hot Springs County",1,15,65,31,34
050,56,017,"Wyoming","Hot Springs County",1,16,59,33,26
050,56,017,"Wyoming","Hot Springs County",1,17,56,25,31
050,56,017,"Wyoming","Hot Springs County",1,18,46,27,19
050,56,017,"Wyoming","Hot Springs County",1,19,31,19,12
050,56,017,"Wyoming","Hot Springs County",1,20,38,20,18
050,56,017,"Wyoming","Hot Springs County",1,21,41,21,20
050,56,017,"Wyoming","Hot Springs County",1,22,38,17,21
050,56,017,"Wyoming","Hot Springs County",1,23,36,16,20
050,56,017,"Wyoming","Hot Springs County",1,24,37,17,20
050,56,017,"Wyoming","Hot Springs County",1,25,34,16,18
050,56,017,"Wyoming","Hot Springs County",1,26,38,21,17
050,56,017,"Wyoming","Hot Springs County",1,27,39,25,14
050,56,017,"Wyoming","Hot Springs County",1,28,42,19,23
050,56,017,"Wyoming","Hot Springs County",1,29,37,21,16
050,56,017,"Wyoming","Hot Springs County",1,30,37,16,21
050,56,017,"Wyoming","Hot Springs County",1,31,45,18,27
050,56,017,"Wyoming","Hot Springs County",1,32,50,28,22
050,56,017,"Wyoming","Hot Springs County",1,33,51,25,26
050,56,017,"Wyoming","Hot Springs County",1,34,49,26,23
050,56,017,"Wyoming","Hot Springs County",1,35,42,22,20
050,56,017,"Wyoming","Hot Springs County",1,36,47,23,24
050,56,017,"Wyoming","Hot Springs County",1,37,42,17,25
050,56,017,"Wyoming","Hot Springs County",1,38,50,28,22
050,56,017,"Wyoming","Hot Springs County",1,39,48,31,17
050,56,017,"Wyoming","Hot Springs County",1,40,50,25,25
050,56,017,"Wyoming","Hot Springs County",1,41,52,30,22
050,56,017,"Wyoming","Hot Springs County",1,42,51,23,28
050,56,017,"Wyoming","Hot Springs County",1,43,38,17,21
050,56,017,"Wyoming","Hot Springs County",1,44,40,20,20
050,56,017,"Wyoming","Hot Springs County",1,45,46,31,15
050,56,017,"Wyoming","Hot Springs County",1,46,47,24,23
050,56,017,"Wyoming","Hot Springs County",1,47,55,26,29
050,56,017,"Wyoming","Hot Springs County",1,48,52,21,31
050,56,017,"Wyoming","Hot Springs County",1,49,54,24,30
050,56,017,"Wyoming","Hot Springs County",1,50,51,30,21
050,56,017,"Wyoming","Hot Springs County",1,51,43,24,19
050,56,017,"Wyoming","Hot Springs County",1,52,45,25,20
050,56,017,"Wyoming","Hot Springs County",1,53,43,22,21
050,56,017,"Wyoming","Hot Springs County",1,54,52,30,22
050,56,017,"Wyoming","Hot Springs County",1,55,52,28,24
050,56,017,"Wyoming","Hot Springs County",1,56,64,30,34
050,56,017,"Wyoming","Hot Springs County",1,57,72,37,35
050,56,017,"Wyoming","Hot Springs County",1,58,69,39,30
050,56,017,"Wyoming","Hot Springs County",1,59,75,40,35
050,56,017,"Wyoming","Hot Springs County",1,60,65,30,35
050,56,017,"Wyoming","Hot Springs County",1,61,70,33,37
050,56,017,"Wyoming","Hot Springs County",1,62,78,34,44
050,56,017,"Wyoming","Hot Springs County",1,63,89,43,46
050,56,017,"Wyoming","Hot Springs County",1,64,73,31,42
050,56,017,"Wyoming","Hot Springs County",1,65,82,42,40
050,56,017,"Wyoming","Hot Springs County",1,66,94,46,48
050,56,017,"Wyoming","Hot Springs County",1,67,73,33,40
050,56,017,"Wyoming","Hot Springs County",1,68,84,38,46
050,56,017,"Wyoming","Hot Springs County",1,69,76,35,41
050,56,017,"Wyoming","Hot Springs County",1,70,67,30,37
050,56,017,"Wyoming","Hot Springs County",1,71,66,41,25
050,56,017,"Wyoming","Hot Springs County",1,72,74,35,39
050,56,017,"Wyoming","Hot Springs County",1,73,84,41,43
050,56,017,"Wyoming","Hot Springs County",1,74,46,23,23
050,56,017,"Wyoming","Hot Springs County",1,75,43,20,23
050,56,017,"Wyoming","Hot Springs County",1,76,46,23,23
050,56,017,"Wyoming","Hot Springs County",1,77,47,23,24
050,56,017,"Wyoming","Hot Springs County",1,78,44,23,21
050,56,017,"Wyoming","Hot Springs County",1,79,36,16,20
050,56,017,"Wyoming","Hot Springs County",1,80,39,16,23
050,56,017,"Wyoming","Hot Springs County",1,81,34,17,17
050,56,017,"Wyoming","Hot Springs County",1,82,31,18,13
050,56,017,"Wyoming","Hot Springs County",1,83,34,16,18
050,56,017,"Wyoming","Hot Springs County",1,84,33,18,15
050,56,017,"Wyoming","Hot Springs County",1,85,151,59,92
050,56,017,"Wyoming","Hot Springs County",2,0,46,22,24
050,56,017,"Wyoming","Hot Springs County",2,1,41,21,20
050,56,017,"Wyoming","Hot Springs County",2,2,45,25,20
050,56,017,"Wyoming","Hot Springs County",2,3,47,27,20
050,56,017,"Wyoming","Hot Springs County",2,4,54,26,28
050,56,017,"Wyoming","Hot Springs County",2,5,53,27,26
050,56,017,"Wyoming","Hot Springs County",2,6,54,30,24
050,56,017,"Wyoming","Hot Springs County",2,7,56,28,28
050,56,017,"Wyoming","Hot Springs County",2,8,60,30,30
050,56,017,"Wyoming","Hot Springs County",2,9,53,30,23
050,56,017,"Wyoming","Hot Springs County",2,10,50,31,19
050,56,017,"Wyoming","Hot Springs County",2,11,50,30,20
050,56,017,"Wyoming","Hot Springs County",2,12,63,31,32
050,56,017,"Wyoming","Hot Springs County",2,13,75,36,39
050,56,017,"Wyoming","Hot Springs County",2,14,66,31,35
050,56,017,"Wyoming","Hot Springs County",2,15,65,31,34
050,56,017,"Wyoming","Hot Springs County",2,16,62,33,29
050,56,017,"Wyoming","Hot Springs County",2,17,58,28,30
050,56,017,"Wyoming","Hot Springs County",2,18,44,24,20
050,56,017,"Wyoming","Hot Springs County",2,19,32,19,13
050,56,017,"Wyoming","Hot Springs County",2,20,37,20,17
050,56,017,"Wyoming","Hot Springs County",2,21,41,21,20
050,56,017,"Wyoming","Hot Springs County",2,22,37,17,20
050,56,017,"Wyoming","Hot Springs County",2,23,36,16,20
050,56,017,"Wyoming","Hot Springs County",2,24,37,17,20
050,56,017,"Wyoming","Hot Springs County",2,25,35,16,19
050,56,017,"Wyoming","Hot Springs County",2,26,38,21,17
050,56,017,"Wyoming","Hot Springs County",2,27,39,24,15
050,56,017,"Wyoming","Hot Springs County",2,28,42,21,21
050,56,017,"Wyoming","Hot Springs County",2,29,39,21,18
050,56,017,"Wyoming","Hot Springs County",2,30,36,16,20
050,56,017,"Wyoming","Hot Springs County",2,31,42,17,25
050,56,017,"Wyoming","Hot Springs County",2,32,49,25,24
050,56,017,"Wyoming","Hot Springs County",2,33,50,25,25
050,56,017,"Wyoming","Hot Springs County",2,34,49,26,23
050,56,017,"Wyoming","Hot Springs County",2,35,42,22,20
050,56,017,"Wyoming","Hot Springs County",2,36,44,21,23
050,56,017,"Wyoming","Hot Springs County",2,37,43,18,25
050,56,017,"Wyoming","Hot Springs County",2,38,50,26,24
050,56,017,"Wyoming","Hot Springs County",2,39,47,29,18
050,56,017,"Wyoming","Hot Springs County",2,40,49,26,23
050,56,017,"Wyoming","Hot Springs County",2,41,52,29,23
050,56,017,"Wyoming","Hot Springs County",2,42,51,25,26
050,56,017,"Wyoming","Hot Springs County",2,43,43,20,23
050,56,017,"Wyoming","Hot Springs County",2,44,40,20,20
050,56,017,"Wyoming","Hot Springs County",2,45,47,30,17
050,56,017,"Wyoming","Hot Springs County",2,46,47,25,22
050,56,017,"Wyoming","Hot Springs County",2,47,52,25,27
050,56,017,"Wyoming","Hot Springs County",2,48,55,23,32
050,56,017,"Wyoming","Hot Springs County",2,49,55,24,31
050,56,017,"Wyoming","Hot Springs County",2,50,53,29,24
050,56,017,"Wyoming","Hot Springs County",2,51,45,25,20
050,56,017,"Wyoming","Hot Springs County",2,52,44,25,19
050,56,017,"Wyoming","Hot Springs County",2,53,42,22,20
050,56,017,"Wyoming","Hot Springs County",2,54,49,28,21
050,56,017,"Wyoming","Hot Springs County",2,55,53,29,24
050,56,017,"Wyoming","Hot Springs County",2,56,62,29,33
050,56,017,"Wyoming","Hot Springs County",2,57,71,36,35
050,56,017,"Wyoming","Hot Springs County",2,58,68,38,30
050,56,017,"Wyoming","Hot Springs County",2,59,73,39,34
050,56,017,"Wyoming","Hot Springs County",2,60,66,32,34
050,56,017,"Wyoming","Hot Springs County",2,61,69,32,37
050,56,017,"Wyoming","Hot Springs County",2,62,76,34,42
050,56,017,"Wyoming","Hot Springs County",2,63,87,41,46
050,56,017,"Wyoming","Hot Springs County",2,64,75,34,41
050,56,017,"Wyoming","Hot Springs County",2,65,82,39,43
050,56,017,"Wyoming","Hot Springs County",2,66,90,44,46
050,56,017,"Wyoming","Hot Springs County",2,67,76,36,40
050,56,017,"Wyoming","Hot Springs County",2,68,81,36,45
050,56,017,"Wyoming","Hot Springs County",2,69,78,36,42
050,56,017,"Wyoming","Hot Springs County",2,70,70,32,38
050,56,017,"Wyoming","Hot Springs County",2,71,68,40,28
050,56,017,"Wyoming","Hot Springs County",2,72,71,35,36
050,56,017,"Wyoming","Hot Springs County",2,73,88,43,45
050,56,017,"Wyoming","Hot Springs County",2,74,51,25,26
050,56,017,"Wyoming","Hot Springs County",2,75,43,20,23
050,56,017,"Wyoming","Hot Springs County",2,76,45,22,23
050,56,017,"Wyoming","Hot Springs County",2,77,47,23,24
050,56,017,"Wyoming","Hot Springs County",2,78,44,22,22
050,56,017,"Wyoming","Hot Springs County",2,79,37,17,20
050,56,017,"Wyoming","Hot Springs County",2,80,38,16,22
050,56,017,"Wyoming","Hot Springs County",2,81,34,17,17
050,56,017,"Wyoming","Hot Springs County",2,82,31,17,14
050,56,017,"Wyoming","Hot Springs County",2,83,34,17,17
050,56,017,"Wyoming","Hot Springs County",2,84,33,17,16
050,56,017,"Wyoming","Hot Springs County",2,85,149,60,89
050,56,017,"Wyoming","Hot Springs County",3,0,42,27,15
050,56,017,"Wyoming","Hot Springs County",3,1,49,25,24
050,56,017,"Wyoming","Hot Springs County",3,2,38,20,18
050,56,017,"Wyoming","Hot Springs County",3,3,43,24,19
050,56,017,"Wyoming","Hot Springs County",3,4,42,23,19
050,56,017,"Wyoming","Hot Springs County",3,5,51,26,25
050,56,017,"Wyoming","Hot Springs County",3,6,47,23,24
050,56,017,"Wyoming","Hot Springs County",3,7,55,29,26
050,56,017,"Wyoming","Hot Springs County",3,8,55,32,23
050,56,017,"Wyoming","Hot Springs County",3,9,59,30,29
050,56,017,"Wyoming","Hot Springs County",3,10,59,36,23
050,56,017,"Wyoming","Hot Springs County",3,11,50,30,20
050,56,017,"Wyoming","Hot Springs County",3,12,48,30,18
050,56,017,"Wyoming","Hot Springs County",3,13,63,29,34
050,56,017,"Wyoming","Hot Springs County",3,14,83,41,42
050,56,017,"Wyoming","Hot Springs County",3,15,66,30,36
050,56,017,"Wyoming","Hot Springs County",3,16,63,30,33
050,56,017,"Wyoming","Hot Springs County",3,17,59,32,27
050,56,017,"Wyoming","Hot Springs County",3,18,46,26,20
050,56,017,"Wyoming","Hot Springs County",3,19,29,16,13
050,56,017,"Wyoming","Hot Springs County",3,20,28,17,11
050,56,017,"Wyoming","Hot Springs County",3,21,40,20,20
050,56,017,"Wyoming","Hot Springs County",3,22,35,20,15
050,56,017,"Wyoming","Hot Springs County",3,23,42,20,22
050,56,017,"Wyoming","Hot Springs County",3,24,39,17,22
050,56,017,"Wyoming","Hot Springs County",3,25,41,19,22
050,56,017,"Wyoming","Hot Springs County",3,26,41,21,20
050,56,017,"Wyoming","Hot Springs County",3,27,44,23,21
050,56,017,"Wyoming","Hot Springs County",3,28,37,22,15
050,56,017,"Wyoming","Hot Springs County",3,29,43,22,21
050,56,017,"Wyoming","Hot Springs County",3,30,38,23,15
050,56,017,"Wyoming","Hot Springs County",3,31,38,14,24
050,56,017,"Wyoming","Hot Springs County",3,32,46,21,25
050,56,017,"Wyoming","Hot Springs County",3,33,48,25,23
050,56,017,"Wyoming","Hot Springs County",3,34,43,21,22
050,56,017,"Wyoming","Hot Springs County",3,35,50,26,24
050,56,017,"Wyoming","Hot Springs County",3,36,43,21,22
050,56,017,"Wyoming","Hot Springs County",3,37,44,22,22
050,56,017,"Wyoming","Hot Springs County",3,38,38,17,21
050,56,017,"Wyoming","Hot Springs County",3,39,49,26,23
050,56,017,"Wyoming","Hot Springs County",3,40,46,27,19
050,56,017,"Wyoming","Hot Springs County",3,41,48,26,22
050,56,017,"Wyoming","Hot Springs County",3,42,49,26,23
050,56,017,"Wyoming","Hot Springs County",3,43,53,25,28
050,56,017,"Wyoming","Hot Springs County",3,44,44,20,24
050,56,017,"Wyoming","Hot Springs County",3,45,33,16,17
050,56,017,"Wyoming","Hot Springs County",3,46,48,32,16
050,56,017,"Wyoming","Hot Springs County",3,47,48,27,21
050,56,017,"Wyoming","Hot Springs County",3,48,55,25,30
050,56,017,"Wyoming","Hot Springs County",3,49,54,22,32
050,56,017,"Wyoming","Hot Springs County",3,50,53,24,29
050,56,017,"Wyoming","Hot Springs County",3,51,50,26,24
050,56,017,"Wyoming","Hot Springs County",3,52,47,27,20
050,56,017,"Wyoming","Hot Springs County",3,53,42,22,20
050,56,017,"Wyoming","Hot Springs County",3,54,42,21,21
050,56,017,"Wyoming","Hot Springs County",3,55,50,30,20
050,56,017,"Wyoming","Hot Springs County",3,56,55,28,27
050,56,017,"Wyoming","Hot Springs County",3,57,61,30,31
050,56,017,"Wyoming","Hot Springs County",3,58,75,38,37
050,56,017,"Wyoming","Hot Springs County",3,59,68,40,28
050,56,017,"Wyoming","Hot Springs County",3,60,73,39,34
050,56,017,"Wyoming","Hot Springs County",3,61,66,35,31
050,56,017,"Wyoming","Hot Springs County",3,62,71,35,36
050,56,017,"Wyoming","Hot Springs County",3,63,79,36,43
050,56,017,"Wyoming","Hot Springs County",3,64,94,44,50
050,56,017,"Wyoming","Hot Springs County",3,65,78,36,42
050,56,017,"Wyoming","Hot Springs County",3,66,88,45,43
050,56,017,"Wyoming","Hot Springs County",3,67,91,46,45
050,56,017,"Wyoming","Hot Springs County",3,68,79,33,46
050,56,017,"Wyoming","Hot Springs County",3,69,81,37,44
050,56,017,"Wyoming","Hot Springs County",3,70,78,35,43
050,56,017,"Wyoming","Hot Springs County",3,71,71,32,39
050,56,017,"Wyoming","Hot Springs County",3,72,65,37,28
050,56,017,"Wyoming","Hot Springs County",3,73,71,36,35
050,56,017,"Wyoming","Hot Springs County",3,74,81,38,43
050,56,017,"Wyoming","Hot Springs County",3,75,46,23,23
050,56,017,"Wyoming","Hot Springs County",3,76,38,16,22
050,56,017,"Wyoming","Hot Springs County",3,77,45,24,21
050,56,017,"Wyoming","Hot Springs County",3,78,46,19,27
050,56,017,"Wyoming","Hot Springs County",3,79,40,20,20
050,56,017,"Wyoming","Hot Springs County",3,80,35,16,19
050,56,017,"Wyoming","Hot Springs County",3,81,34,16,18
050,56,017,"Wyoming","Hot Springs County",3,82,25,14,11
050,56,017,"Wyoming","Hot Springs County",3,83,31,17,14
050,56,017,"Wyoming","Hot Springs County",3,84,31,15,16
050,56,017,"Wyoming","Hot Springs County",3,85,163,67,96
050,56,017,"Wyoming","Hot Springs County",4,0,34,22,12
050,56,017,"Wyoming","Hot Springs County",4,1,43,27,16
050,56,017,"Wyoming","Hot Springs County",4,2,47,24,23
050,56,017,"Wyoming","Hot Springs County",4,3,42,25,17
050,56,017,"Wyoming","Hot Springs County",4,4,47,24,23
050,56,017,"Wyoming","Hot Springs County",4,5,45,25,20
050,56,017,"Wyoming","Hot Springs County",4,6,52,25,27
050,56,017,"Wyoming","Hot Springs County",4,7,46,24,22
050,56,017,"Wyoming","Hot Springs County",4,8,57,29,28
050,56,017,"Wyoming","Hot Springs County",4,9,54,31,23
050,56,017,"Wyoming","Hot Springs County",4,10,62,32,30
050,56,017,"Wyoming","Hot Springs County",4,11,61,35,26
050,56,017,"Wyoming","Hot Springs County",4,12,45,24,21
050,56,017,"Wyoming","Hot Springs County",4,13,45,27,18
050,56,017,"Wyoming","Hot Springs County",4,14,67,31,36
050,56,017,"Wyoming","Hot Springs County",4,15,81,41,40
050,56,017,"Wyoming","Hot Springs County",4,16,60,29,31
050,56,017,"Wyoming","Hot Springs County",4,17,61,29,32
050,56,017,"Wyoming","Hot Springs County",4,18,48,29,19
050,56,017,"Wyoming","Hot Springs County",4,19,38,20,18
050,56,017,"Wyoming","Hot Springs County",4,20,26,14,12
050,56,017,"Wyoming","Hot Springs County",4,21,35,20,15
050,56,017,"Wyoming","Hot Springs County",4,22,36,17,19
050,56,017,"Wyoming","Hot Springs County",4,23,43,21,22
050,56,017,"Wyoming","Hot Springs County",4,24,44,23,21
050,56,017,"Wyoming","Hot Springs County",4,25,44,22,22
050,56,017,"Wyoming","Hot Springs County",4,26,46,20,26
050,56,017,"Wyoming","Hot Springs County",4,27,34,15,19
050,56,017,"Wyoming","Hot Springs County",4,28,44,22,22
050,56,017,"Wyoming","Hot Springs County",4,29,37,22,15
050,56,017,"Wyoming","Hot Springs County",4,30,48,22,26
050,56,017,"Wyoming","Hot Springs County",4,31,45,27,18
050,56,017,"Wyoming","Hot Springs County",4,32,42,19,23
050,56,017,"Wyoming","Hot Springs County",4,33,45,22,23
050,56,017,"Wyoming","Hot Springs County",4,34,47,25,22
050,56,017,"Wyoming","Hot Springs County",4,35,43,20,23
050,56,017,"Wyoming","Hot Springs County",4,36,53,26,27
050,56,017,"Wyoming","Hot Springs County",4,37,42,18,24
050,56,017,"Wyoming","Hot Springs County",4,38,49,26,23
050,56,017,"Wyoming","Hot Springs County",4,39,45,23,22
050,56,017,"Wyoming","Hot Springs County",4,40,42,21,21
050,56,017,"Wyoming","Hot Springs County",4,41,47,28,19
050,56,017,"Wyoming","Hot Springs County",4,42,44,22,22
050,56,017,"Wyoming","Hot Springs County",4,43,43,23,20
050,56,017,"Wyoming","Hot Springs County",4,44,55,25,30
050,56,017,"Wyoming","Hot Springs County",4,45,42,18,24
050,56,017,"Wyoming","Hot Springs County",4,46,39,19,20
050,56,017,"Wyoming","Hot Springs County",4,47,50,34,16
050,56,017,"Wyoming","Hot Springs County",4,48,43,23,20
050,56,017,"Wyoming","Hot Springs County",4,49,66,32,34
050,56,017,"Wyoming","Hot Springs County",4,50,54,26,28
050,56,017,"Wyoming","Hot Springs County",4,51,51,22,29
050,56,017,"Wyoming","Hot Springs County",4,52,47,21,26
050,56,017,"Wyoming","Hot Springs County",4,53,52,28,24
050,56,017,"Wyoming","Hot Springs County",4,54,44,23,21
050,56,017,"Wyoming","Hot Springs County",4,55,47,23,24
050,56,017,"Wyoming","Hot Springs County",4,56,54,32,22
050,56,017,"Wyoming","Hot Springs County",4,57,53,24,29
050,56,017,"Wyoming","Hot Springs County",4,58,67,33,34
050,56,017,"Wyoming","Hot Springs County",4,59,77,35,42
050,56,017,"Wyoming","Hot Springs County",4,60,72,42,30
050,56,017,"Wyoming","Hot Springs County",4,61,80,44,36
050,56,017,"Wyoming","Hot Springs County",4,62,65,35,30
050,56,017,"Wyoming","Hot Springs County",4,63,78,39,39
050,56,017,"Wyoming","Hot Springs County",4,64,82,38,44
050,56,017,"Wyoming","Hot Springs County",4,65,92,45,47
050,56,017,"Wyoming","Hot Springs County",4,66,79,37,42
050,56,017,"Wyoming","Hot Springs County",4,67,85,42,43
050,56,017,"Wyoming","Hot Springs County",4,68,90,46,44
050,56,017,"Wyoming","Hot Springs County",4,69,71,32,39
050,56,017,"Wyoming","Hot Springs County",4,70,81,36,45
050,56,017,"Wyoming","Hot Springs County",4,71,72,33,39
050,56,017,"Wyoming","Hot Springs County",4,72,69,29,40
050,56,017,"Wyoming","Hot Springs County",4,73,63,35,28
050,56,017,"Wyoming","Hot Springs County",4,74,64,32,32
050,56,017,"Wyoming","Hot Springs County",4,75,75,33,42
050,56,017,"Wyoming","Hot Springs County",4,76,45,23,22
050,56,017,"Wyoming","Hot Springs County",4,77,38,18,20
050,56,017,"Wyoming","Hot Springs County",4,78,46,22,24
050,56,017,"Wyoming","Hot Springs County",4,79,42,16,26
050,56,017,"Wyoming","Hot Springs County",4,80,40,17,23
050,56,017,"Wyoming","Hot Springs County",4,81,31,17,14
050,56,017,"Wyoming","Hot Springs County",4,82,32,14,18
050,56,017,"Wyoming","Hot Springs County",4,83,24,13,11
050,56,017,"Wyoming","Hot Springs County",4,84,29,15,14
050,56,017,"Wyoming","Hot Springs County",4,85,178,75,103
050,56,017,"Wyoming","Hot Springs County",5,0,34,21,13
050,56,017,"Wyoming","Hot Springs County",5,1,30,18,12
050,56,017,"Wyoming","Hot Springs County",5,2,45,29,16
050,56,017,"Wyoming","Hot Springs County",5,3,48,24,24
050,56,017,"Wyoming","Hot Springs County",5,4,43,25,18
050,56,017,"Wyoming","Hot Springs County",5,5,50,27,23
050,56,017,"Wyoming","Hot Springs County",5,6,48,27,21
050,56,017,"Wyoming","Hot Springs County",5,7,51,27,24
050,56,017,"Wyoming","Hot Springs County",5,8,53,28,25
050,56,017,"Wyoming","Hot Springs County",5,9,61,33,28
050,56,017,"Wyoming","Hot Springs County",5,10,55,33,22
050,56,017,"Wyoming","Hot Springs County",5,11,66,35,31
050,56,017,"Wyoming","Hot Springs County",5,12,61,34,27
050,56,017,"Wyoming","Hot Springs County",5,13,53,31,22
050,56,017,"Wyoming","Hot Springs County",5,14,51,30,21
050,56,017,"Wyoming","Hot Springs County",5,15,69,33,36
050,56,017,"Wyoming","Hot Springs County",5,16,80,43,37
050,56,017,"Wyoming","Hot Springs County",5,17,60,29,31
050,56,017,"Wyoming","Hot Springs County",5,18,50,27,23
050,56,017,"Wyoming","Hot Springs County",5,19,35,20,15
050,56,017,"Wyoming","Hot Springs County",5,20,40,21,19
050,56,017,"Wyoming","Hot Springs County",5,21,32,17,15
050,56,017,"Wyoming","Hot Springs County",5,22,29,14,15
050,56,017,"Wyoming","Hot Springs County",5,23,40,19,21
050,56,017,"Wyoming","Hot Springs County",5,24,37,18,19
050,56,017,"Wyoming","Hot Springs County",5,25,37,20,17
050,56,017,"Wyoming","Hot Springs County",5,26,45,21,24
050,56,017,"Wyoming","Hot Springs County",5,27,46,19,27
050,56,017,"Wyoming","Hot Springs County",5,28,36,18,18
050,56,017,"Wyoming","Hot Springs County",5,29,44,23,21
050,56,017,"Wyoming","Hot Springs County",5,30,42,24,18
050,56,017,"Wyoming","Hot Springs County",5,31,51,21,30
050,56,017,"Wyoming","Hot Springs County",5,32,46,27,19
050,56,017,"Wyoming","Hot Springs County",5,33,42,20,22
050,56,017,"Wyoming","Hot Springs County",5,34,43,21,22
050,56,017,"Wyoming","Hot Springs County",5,35,60,31,29
050,56,017,"Wyoming","Hot Springs County",5,36,50,23,27
050,56,017,"Wyoming","Hot Springs County",5,37,50,24,26
050,56,017,"Wyoming","Hot Springs County",5,38,38,18,20
050,56,017,"Wyoming","Hot Springs County",5,39,55,31,24
050,56,017,"Wyoming","Hot Springs County",5,40,50,27,23
050,56,017,"Wyoming","Hot Springs County",5,41,43,23,20
050,56,017,"Wyoming","Hot Springs County",5,42,43,24,19
050,56,017,"Wyoming","Hot Springs County",5,43,41,19,22
050,56,017,"Wyoming","Hot Springs County",5,44,44,25,19
050,56,017,"Wyoming","Hot Springs County",5,45,50,24,26
050,56,017,"Wyoming","Hot Springs County",5,46,44,20,24
050,56,017,"Wyoming","Hot Springs County",5,47,40,19,21
050,56,017,"Wyoming","Hot Springs County",5,48,51,34,17
050,56,017,"Wyoming","Hot Springs County",5,49,40,19,21
050,56,017,"Wyoming","Hot Springs County",5,50,60,29,31
050,56,017,"Wyoming","Hot Springs County",5,51,47,24,23
050,56,017,"Wyoming","Hot Springs County",5,52,53,21,32
050,56,017,"Wyoming","Hot Springs County",5,53,50,24,26
050,56,017,"Wyoming","Hot Springs County",5,54,50,30,20
050,56,017,"Wyoming","Hot Springs County",5,55,49,25,24
050,56,017,"Wyoming","Hot Springs County",5,56,44,22,22
050,56,017,"Wyoming","Hot Springs County",5,57,54,32,22
050,56,017,"Wyoming","Hot Springs County",5,58,55,25,30
050,56,017,"Wyoming","Hot Springs County",5,59,68,32,36
050,56,017,"Wyoming","Hot Springs County",5,60,89,41,48
050,56,017,"Wyoming","Hot Springs County",5,61,72,45,27
050,56,017,"Wyoming","Hot Springs County",5,62,74,43,31
050,56,017,"Wyoming","Hot Springs County",5,63,72,36,36
050,56,017,"Wyoming","Hot Springs County",5,64,79,41,38
050,56,017,"Wyoming","Hot Springs County",5,65,78,34,44
050,56,017,"Wyoming","Hot Springs County",5,66,96,44,52
050,56,017,"Wyoming","Hot Springs County",5,67,75,35,40
050,56,017,"Wyoming","Hot Springs County",5,68,88,43,45
050,56,017,"Wyoming","Hot Springs County",5,69,90,48,42
050,56,017,"Wyoming","Hot Springs County",5,70,78,37,41
050,56,017,"Wyoming","Hot Springs County",5,71,80,38,42
050,56,017,"Wyoming","Hot Springs County",5,72,71,29,42
050,56,017,"Wyoming","Hot Springs County",5,73,65,28,37
050,56,017,"Wyoming","Hot Springs County",5,74,58,33,25
050,56,017,"Wyoming","Hot Springs County",5,75,61,29,32
050,56,017,"Wyoming","Hot Springs County",5,76,72,32,40
050,56,017,"Wyoming","Hot Springs County",5,77,44,25,19
050,56,017,"Wyoming","Hot Springs County",5,78,41,17,24
050,56,017,"Wyoming","Hot Springs County",5,79,44,20,24
050,56,017,"Wyoming","Hot Springs County",5,80,38,14,24
050,56,017,"Wyoming","Hot Springs County",5,81,35,18,17
050,56,017,"Wyoming","Hot Springs County",5,82,31,14,17
050,56,017,"Wyoming","Hot Springs County",5,83,33,14,19
050,56,017,"Wyoming","Hot Springs County",5,84,21,9,12
050,56,017,"Wyoming","Hot Springs County",5,85,194,82,112
050,56,019,"Wyoming","Johnson County",1,0,67,34,33
050,56,019,"Wyoming","Johnson County",1,1,71,34,37
050,56,019,"Wyoming","Johnson County",1,2,68,30,38
050,56,019,"Wyoming","Johnson County",1,3,81,36,45
050,56,019,"Wyoming","Johnson County",1,4,86,39,47
050,56,019,"Wyoming","Johnson County",1,5,91,48,43
050,56,019,"Wyoming","Johnson County",1,6,89,49,40
050,56,019,"Wyoming","Johnson County",1,7,95,57,38
050,56,019,"Wyoming","Johnson County",1,8,101,56,45
050,56,019,"Wyoming","Johnson County",1,9,108,56,52
050,56,019,"Wyoming","Johnson County",1,10,107,57,50
050,56,019,"Wyoming","Johnson County",1,11,127,76,51
050,56,019,"Wyoming","Johnson County",1,12,125,69,56
050,56,019,"Wyoming","Johnson County",1,13,123,71,52
050,56,019,"Wyoming","Johnson County",1,14,123,66,57
050,56,019,"Wyoming","Johnson County",1,15,125,57,68
050,56,019,"Wyoming","Johnson County",1,16,105,55,50
050,56,019,"Wyoming","Johnson County",1,17,96,58,38
050,56,019,"Wyoming","Johnson County",1,18,88,47,41
050,56,019,"Wyoming","Johnson County",1,19,57,30,27
050,56,019,"Wyoming","Johnson County",1,20,57,29,28
050,56,019,"Wyoming","Johnson County",1,21,66,36,30
050,56,019,"Wyoming","Johnson County",1,22,69,34,35
050,56,019,"Wyoming","Johnson County",1,23,69,37,32
050,56,019,"Wyoming","Johnson County",1,24,66,31,35
050,56,019,"Wyoming","Johnson County",1,25,82,43,39
050,56,019,"Wyoming","Johnson County",1,26,72,38,34
050,56,019,"Wyoming","Johnson County",1,27,68,38,30
050,56,019,"Wyoming","Johnson County",1,28,70,33,37
050,56,019,"Wyoming","Johnson County",1,29,64,30,34
050,56,019,"Wyoming","Johnson County",1,30,81,42,39
050,56,019,"Wyoming","Johnson County",1,31,83,39,44
050,56,019,"Wyoming","Johnson County",1,32,76,36,40
050,56,019,"Wyoming","Johnson County",1,33,86,43,43
050,56,019,"Wyoming","Johnson County",1,34,98,44,54
050,56,019,"Wyoming","Johnson County",1,35,97,42,55
050,56,019,"Wyoming","Johnson County",1,36,102,47,55
050,56,019,"Wyoming","Johnson County",1,37,108,56,52
050,56,019,"Wyoming","Johnson County",1,38,105,57,48
050,56,019,"Wyoming","Johnson County",1,39,105,57,48
050,56,019,"Wyoming","Johnson County",1,40,97,49,48
050,56,019,"Wyoming","Johnson County",1,41,99,46,53
050,56,019,"Wyoming","Johnson County",1,42,90,43,47
050,56,019,"Wyoming","Johnson County",1,43,97,50,47
050,56,019,"Wyoming","Johnson County",1,44,86,47,39
050,56,019,"Wyoming","Johnson County",1,45,99,52,47
050,56,019,"Wyoming","Johnson County",1,46,85,42,43
050,56,019,"Wyoming","Johnson County",1,47,94,46,48
050,56,019,"Wyoming","Johnson County",1,48,101,54,47
050,56,019,"Wyoming","Johnson County",1,49,113,56,57
050,56,019,"Wyoming","Johnson County",1,50,97,50,47
050,56,019,"Wyoming","Johnson County",1,51,99,46,53
050,56,019,"Wyoming","Johnson County",1,52,95,43,52
050,56,019,"Wyoming","Johnson County",1,53,94,46,48
050,56,019,"Wyoming","Johnson County",1,54,92,40,52
050,56,019,"Wyoming","Johnson County",1,55,103,49,54
050,56,019,"Wyoming","Johnson County",1,56,122,60,62
050,56,019,"Wyoming","Johnson County",1,57,107,55,52
050,56,019,"Wyoming","Johnson County",1,58,119,56,63
050,56,019,"Wyoming","Johnson County",1,59,128,63,65
050,56,019,"Wyoming","Johnson County",1,60,136,67,69
050,56,019,"Wyoming","Johnson County",1,61,119,66,53
050,56,019,"Wyoming","Johnson County",1,62,130,64,66
050,56,019,"Wyoming","Johnson County",1,63,146,75,71
050,56,019,"Wyoming","Johnson County",1,64,159,76,83
050,56,019,"Wyoming","Johnson County",1,65,159,75,84
050,56,019,"Wyoming","Johnson County",1,66,155,75,80
050,56,019,"Wyoming","Johnson County",1,67,133,72,61
050,56,019,"Wyoming","Johnson County",1,68,143,69,74
050,56,019,"Wyoming","Johnson County",1,69,122,63,59
050,56,019,"Wyoming","Johnson County",1,70,135,72,63
050,56,019,"Wyoming","Johnson County",1,71,134,75,59
050,56,019,"Wyoming","Johnson County",1,72,136,74,62
050,56,019,"Wyoming","Johnson County",1,73,133,73,60
050,56,019,"Wyoming","Johnson County",1,74,82,45,37
050,56,019,"Wyoming","Johnson County",1,75,71,37,34
050,56,019,"Wyoming","Johnson County",1,76,80,39,41
050,56,019,"Wyoming","Johnson County",1,77,80,41,39
050,56,019,"Wyoming","Johnson County",1,78,65,33,32
050,56,019,"Wyoming","Johnson County",1,79,70,46,24
050,56,019,"Wyoming","Johnson County",1,80,55,26,29
050,56,019,"Wyoming","Johnson County",1,81,51,18,33
050,56,019,"Wyoming","Johnson County",1,82,56,25,31
050,56,019,"Wyoming","Johnson County",1,83,52,31,21
050,56,019,"Wyoming","Johnson County",1,84,44,24,20
050,56,019,"Wyoming","Johnson County",1,85,230,105,125
050,56,019,"Wyoming","Johnson County",2,0,72,32,40
050,56,019,"Wyoming","Johnson County",2,1,71,34,37
050,56,019,"Wyoming","Johnson County",2,2,69,30,39
050,56,019,"Wyoming","Johnson County",2,3,78,35,43
050,56,019,"Wyoming","Johnson County",2,4,87,39,48
050,56,019,"Wyoming","Johnson County",2,5,90,46,44
050,56,019,"Wyoming","Johnson County",2,6,89,48,41
050,56,019,"Wyoming","Johnson County",2,7,92,54,38
050,56,019,"Wyoming","Johnson County",2,8,99,56,43
050,56,019,"Wyoming","Johnson County",2,9,107,56,51
050,56,019,"Wyoming","Johnson County",2,10,108,57,51
050,56,019,"Wyoming","Johnson County",2,11,119,70,49
050,56,019,"Wyoming","Johnson County",2,12,126,70,56
050,56,019,"Wyoming","Johnson County",2,13,122,69,53
050,56,019,"Wyoming","Johnson County",2,14,124,68,56
050,56,019,"Wyoming","Johnson County",2,15,125,59,66
050,56,019,"Wyoming","Johnson County",2,16,108,54,54
050,56,019,"Wyoming","Johnson County",2,17,100,58,42
050,56,019,"Wyoming","Johnson County",2,18,85,48,37
050,56,019,"Wyoming","Johnson County",2,19,61,33,28
050,56,019,"Wyoming","Johnson County",2,20,61,31,30
050,56,019,"Wyoming","Johnson County",2,21,64,35,29
050,56,019,"Wyoming","Johnson County",2,22,68,34,34
050,56,019,"Wyoming","Johnson County",2,23,69,36,33
050,56,019,"Wyoming","Johnson County",2,24,68,33,35
050,56,019,"Wyoming","Johnson County",2,25,80,41,39
050,56,019,"Wyoming","Johnson County",2,26,75,40,35
050,56,019,"Wyoming","Johnson County",2,27,69,38,31
050,56,019,"Wyoming","Johnson County",2,28,68,33,35
050,56,019,"Wyoming","Johnson County",2,29,66,32,34
050,56,019,"Wyoming","Johnson County",2,30,80,41,39
050,56,019,"Wyoming","Johnson County",2,31,82,41,41
050,56,019,"Wyoming","Johnson County",2,32,77,37,40
050,56,019,"Wyoming","Johnson County",2,33,83,42,41
050,56,019,"Wyoming","Johnson County",2,34,96,44,52
050,56,019,"Wyoming","Johnson County",2,35,96,42,54
050,56,019,"Wyoming","Johnson County",2,36,98,45,53
050,56,019,"Wyoming","Johnson County",2,37,107,54,53
050,56,019,"Wyoming","Johnson County",2,38,104,56,48
050,56,019,"Wyoming","Johnson County",2,39,105,57,48
050,56,019,"Wyoming","Johnson County",2,40,99,50,49
050,56,019,"Wyoming","Johnson County",2,41,98,46,52
050,56,019,"Wyoming","Johnson County",2,42,93,45,48
050,56,019,"Wyoming","Johnson County",2,43,97,49,48
050,56,019,"Wyoming","Johnson County",2,44,87,47,40
050,56,019,"Wyoming","Johnson County",2,45,97,52,45
050,56,019,"Wyoming","Johnson County",2,46,88,44,44
050,56,019,"Wyoming","Johnson County",2,47,92,45,47
050,56,019,"Wyoming","Johnson County",2,48,97,51,46
050,56,019,"Wyoming","Johnson County",2,49,111,55,56
050,56,019,"Wyoming","Johnson County",2,50,103,52,51
050,56,019,"Wyoming","Johnson County",2,51,97,46,51
050,56,019,"Wyoming","Johnson County",2,52,95,44,51
050,56,019,"Wyoming","Johnson County",2,53,94,45,49
050,56,019,"Wyoming","Johnson County",2,54,94,43,51
050,56,019,"Wyoming","Johnson County",2,55,102,46,56
050,56,019,"Wyoming","Johnson County",2,56,118,58,60
050,56,019,"Wyoming","Johnson County",2,57,112,57,55
050,56,019,"Wyoming","Johnson County",2,58,116,56,60
050,56,019,"Wyoming","Johnson County",2,59,130,64,66
050,56,019,"Wyoming","Johnson County",2,60,134,66,68
050,56,019,"Wyoming","Johnson County",2,61,122,65,57
050,56,019,"Wyoming","Johnson County",2,62,127,64,63
050,56,019,"Wyoming","Johnson County",2,63,143,73,70
050,56,019,"Wyoming","Johnson County",2,64,156,76,80
050,56,019,"Wyoming","Johnson County",2,65,158,74,84
050,56,019,"Wyoming","Johnson County",2,66,158,77,81
050,56,019,"Wyoming","Johnson County",2,67,138,72,66
050,56,019,"Wyoming","Johnson County",2,68,140,69,71
050,56,019,"Wyoming","Johnson County",2,69,127,65,62
050,56,019,"Wyoming","Johnson County",2,70,129,67,62
050,56,019,"Wyoming","Johnson County",2,71,135,74,61
050,56,019,"Wyoming","Johnson County",2,72,134,73,61
050,56,019,"Wyoming","Johnson County",2,73,141,77,64
050,56,019,"Wyoming","Johnson County",2,74,89,49,40
050,56,019,"Wyoming","Johnson County",2,75,74,39,35
050,56,019,"Wyoming","Johnson County",2,76,78,39,39
050,56,019,"Wyoming","Johnson County",2,77,82,41,41
050,56,019,"Wyoming","Johnson County",2,78,68,35,33
050,56,019,"Wyoming","Johnson County",2,79,69,43,26
050,56,019,"Wyoming","Johnson County",2,80,57,30,27
050,56,019,"Wyoming","Johnson County",2,81,50,19,31
050,56,019,"Wyoming","Johnson County",2,82,57,24,33
050,56,019,"Wyoming","Johnson County",2,83,50,27,23
050,56,019,"Wyoming","Johnson County",2,84,47,27,20
050,56,019,"Wyoming","Johnson County",2,85,236,110,126
050,56,019,"Wyoming","Johnson County",3,0,80,32,48
050,56,019,"Wyoming","Johnson County",3,1,77,37,40
050,56,019,"Wyoming","Johnson County",3,2,79,39,40
050,56,019,"Wyoming","Johnson County",3,3,74,32,42
050,56,019,"Wyoming","Johnson County",3,4,78,37,41
050,56,019,"Wyoming","Johnson County",3,5,95,40,55
050,56,019,"Wyoming","Johnson County",3,6,91,47,44
050,56,019,"Wyoming","Johnson County",3,7,94,46,48
050,56,019,"Wyoming","Johnson County",3,8,92,56,36
050,56,019,"Wyoming","Johnson County",3,9,98,51,47
050,56,019,"Wyoming","Johnson County",3,10,112,57,55
050,56,019,"Wyoming","Johnson County",3,11,108,57,51
050,56,019,"Wyoming","Johnson County",3,12,119,67,52
050,56,019,"Wyoming","Johnson County",3,13,122,66,56
050,56,019,"Wyoming","Johnson County",3,14,123,69,54
050,56,019,"Wyoming","Johnson County",3,15,133,75,58
050,56,019,"Wyoming","Johnson County",3,16,124,57,67
050,56,019,"Wyoming","Johnson County",3,17,107,53,54
050,56,019,"Wyoming","Johnson County",3,18,87,51,36
050,56,019,"Wyoming","Johnson County",3,19,61,33,28
050,56,019,"Wyoming","Johnson County",3,20,64,36,28
050,56,019,"Wyoming","Johnson County",3,21,69,33,36
050,56,019,"Wyoming","Johnson County",3,22,70,38,32
050,56,019,"Wyoming","Johnson County",3,23,70,33,37
050,56,019,"Wyoming","Johnson County",3,24,76,37,39
050,56,019,"Wyoming","Johnson County",3,25,73,35,38
050,56,019,"Wyoming","Johnson County",3,26,85,42,43
050,56,019,"Wyoming","Johnson County",3,27,76,42,34
050,56,019,"Wyoming","Johnson County",3,28,71,39,32
050,56,019,"Wyoming","Johnson County",3,29,71,36,35
050,56,019,"Wyoming","Johnson County",3,30,74,39,35
050,56,019,"Wyoming","Johnson County",3,31,82,46,36
050,56,019,"Wyoming","Johnson County",3,32,81,40,41
050,56,019,"Wyoming","Johnson County",3,33,83,41,42
050,56,019,"Wyoming","Johnson County",3,34,88,38,50
050,56,019,"Wyoming","Johnson County",3,35,98,40,58
050,56,019,"Wyoming","Johnson County",3,36,99,41,58
050,56,019,"Wyoming","Johnson County",3,37,94,47,47
050,56,019,"Wyoming","Johnson County",3,38,114,54,60
050,56,019,"Wyoming","Johnson County",3,39,114,62,52
050,56,019,"Wyoming","Johnson County",3,40,109,62,47
050,56,019,"Wyoming","Johnson County",3,41,107,52,55
050,56,019,"Wyoming","Johnson County",3,42,99,49,50
050,56,019,"Wyoming","Johnson County",3,43,97,47,50
050,56,019,"Wyoming","Johnson County",3,44,94,48,46
050,56,019,"Wyoming","Johnson County",3,45,88,49,39
050,56,019,"Wyoming","Johnson County",3,46,101,55,46
050,56,019,"Wyoming","Johnson County",3,47,96,49,47
050,56,019,"Wyoming","Johnson County",3,48,94,44,50
050,56,019,"Wyoming","Johnson County",3,49,98,53,45
050,56,019,"Wyoming","Johnson County",3,50,108,58,50
050,56,019,"Wyoming","Johnson County",3,51,98,47,51
050,56,019,"Wyoming","Johnson County",3,52,101,44,57
050,56,019,"Wyoming","Johnson County",3,53,103,45,58
050,56,019,"Wyoming","Johnson County",3,54,93,42,51
050,56,019,"Wyoming","Johnson County",3,55,99,45,54
050,56,019,"Wyoming","Johnson County",3,56,103,46,57
050,56,019,"Wyoming","Johnson County",3,57,121,60,61
050,56,019,"Wyoming","Johnson County",3,58,116,59,57
050,56,019,"Wyoming","Johnson County",3,59,124,64,60
050,56,019,"Wyoming","Johnson County",3,60,131,62,69
050,56,019,"Wyoming","Johnson County",3,61,137,64,73
050,56,019,"Wyoming","Johnson County",3,62,123,63,60
050,56,019,"Wyoming","Johnson County",3,63,130,66,64
050,56,019,"Wyoming","Johnson County",3,64,147,71,76
050,56,019,"Wyoming","Johnson County",3,65,149,75,74
050,56,019,"Wyoming","Johnson County",3,66,162,75,87
050,56,019,"Wyoming","Johnson County",3,67,156,74,82
050,56,019,"Wyoming","Johnson County",3,68,153,81,72
050,56,019,"Wyoming","Johnson County",3,69,145,74,71
050,56,019,"Wyoming","Johnson County",3,70,128,66,62
050,56,019,"Wyoming","Johnson County",3,71,129,66,63
050,56,019,"Wyoming","Johnson County",3,72,134,73,61
050,56,019,"Wyoming","Johnson County",3,73,128,70,58
050,56,019,"Wyoming","Johnson County",3,74,133,73,60
050,56,019,"Wyoming","Johnson County",3,75,84,47,37
050,56,019,"Wyoming","Johnson County",3,76,68,36,32
050,56,019,"Wyoming","Johnson County",3,77,79,39,40
050,56,019,"Wyoming","Johnson County",3,78,77,37,40
050,56,019,"Wyoming","Johnson County",3,79,68,35,33
050,56,019,"Wyoming","Johnson County",3,80,61,36,25
050,56,019,"Wyoming","Johnson County",3,81,52,28,24
050,56,019,"Wyoming","Johnson County",3,82,51,19,32
050,56,019,"Wyoming","Johnson County",3,83,52,21,31
050,56,019,"Wyoming","Johnson County",3,84,49,26,23
050,56,019,"Wyoming","Johnson County",3,85,243,120,123
050,56,019,"Wyoming","Johnson County",4,0,78,39,39
050,56,019,"Wyoming","Johnson County",4,1,75,34,41
050,56,019,"Wyoming","Johnson County",4,2,78,38,40
050,56,019,"Wyoming","Johnson County",4,3,76,37,39
050,56,019,"Wyoming","Johnson County",4,4,77,32,45
050,56,019,"Wyoming","Johnson County",4,5,75,40,35
050,56,019,"Wyoming","Johnson County",4,6,101,45,56
050,56,019,"Wyoming","Johnson County",4,7,94,47,47
050,56,019,"Wyoming","Johnson County",4,8,96,48,48
050,56,019,"Wyoming","Johnson County",4,9,99,61,38
050,56,019,"Wyoming","Johnson County",4,10,102,55,47
050,56,019,"Wyoming","Johnson County",4,11,106,55,51
050,56,019,"Wyoming","Johnson County",4,12,100,53,47
050,56,019,"Wyoming","Johnson County",4,13,120,69,51
050,56,019,"Wyoming","Johnson County",4,14,124,64,60
050,56,019,"Wyoming","Johnson County",4,15,131,75,56
050,56,019,"Wyoming","Johnson County",4,16,123,66,57
050,56,019,"Wyoming","Johnson County",4,17,115,54,61
050,56,019,"Wyoming","Johnson County",4,18,98,50,48
050,56,019,"Wyoming","Johnson County",4,19,72,45,27
050,56,019,"Wyoming","Johnson County",4,20,62,30,32
050,56,019,"Wyoming","Johnson County",4,21,70,39,31
050,56,019,"Wyoming","Johnson County",4,22,67,35,32
050,56,019,"Wyoming","Johnson County",4,23,63,34,29
050,56,019,"Wyoming","Johnson County",4,24,66,36,30
050,56,019,"Wyoming","Johnson County",4,25,78,40,38
050,56,019,"Wyoming","Johnson County",4,26,78,39,39
050,56,019,"Wyoming","Johnson County",4,27,79,40,39
050,56,019,"Wyoming","Johnson County",4,28,77,44,33
050,56,019,"Wyoming","Johnson County",4,29,72,34,38
050,56,019,"Wyoming","Johnson County",4,30,72,33,39
050,56,019,"Wyoming","Johnson County",4,31,75,39,36
050,56,019,"Wyoming","Johnson County",4,32,84,47,37
050,56,019,"Wyoming","Johnson County",4,33,82,46,36
050,56,019,"Wyoming","Johnson County",4,34,89,44,45
050,56,019,"Wyoming","Johnson County",4,35,91,41,50
050,56,019,"Wyoming","Johnson County",4,36,106,46,60
050,56,019,"Wyoming","Johnson County",4,37,112,51,61
050,56,019,"Wyoming","Johnson County",4,38,96,50,46
050,56,019,"Wyoming","Johnson County",4,39,111,55,56
050,56,019,"Wyoming","Johnson County",4,40,129,65,64
050,56,019,"Wyoming","Johnson County",4,41,117,63,54
050,56,019,"Wyoming","Johnson County",4,42,111,57,54
050,56,019,"Wyoming","Johnson County",4,43,102,54,48
050,56,019,"Wyoming","Johnson County",4,44,97,46,51
050,56,019,"Wyoming","Johnson County",4,45,97,46,51
050,56,019,"Wyoming","Johnson County",4,46,93,52,41
050,56,019,"Wyoming","Johnson County",4,47,91,49,42
050,56,019,"Wyoming","Johnson County",4,48,97,53,44
050,56,019,"Wyoming","Johnson County",4,49,101,48,53
050,56,019,"Wyoming","Johnson County",4,50,101,54,47
050,56,019,"Wyoming","Johnson County",4,51,113,62,51
050,56,019,"Wyoming","Johnson County",4,52,104,51,53
050,56,019,"Wyoming","Johnson County",4,53,105,49,56
050,56,019,"Wyoming","Johnson County",4,54,108,48,60
050,56,019,"Wyoming","Johnson County",4,55,97,42,55
050,56,019,"Wyoming","Johnson County",4,56,97,45,52
050,56,019,"Wyoming","Johnson County",4,57,108,48,60
050,56,019,"Wyoming","Johnson County",4,58,127,61,66
050,56,019,"Wyoming","Johnson County",4,59,120,64,56
050,56,019,"Wyoming","Johnson County",4,60,122,62,60
050,56,019,"Wyoming","Johnson County",4,61,148,70,78
050,56,019,"Wyoming","Johnson County",4,62,141,66,75
050,56,019,"Wyoming","Johnson County",4,63,127,67,60
050,56,019,"Wyoming","Johnson County",4,64,133,67,66
050,56,019,"Wyoming","Johnson County",4,65,147,72,75
050,56,019,"Wyoming","Johnson County",4,66,152,75,77
050,56,019,"Wyoming","Johnson County",4,67,166,75,91
050,56,019,"Wyoming","Johnson County",4,68,159,77,82
050,56,019,"Wyoming","Johnson County",4,69,155,82,73
050,56,019,"Wyoming","Johnson County",4,70,140,69,71
050,56,019,"Wyoming","Johnson County",4,71,125,64,61
050,56,019,"Wyoming","Johnson County",4,72,125,68,57
050,56,019,"Wyoming","Johnson County",4,73,126,68,58
050,56,019,"Wyoming","Johnson County",4,74,122,67,55
050,56,019,"Wyoming","Johnson County",4,75,127,72,55
050,56,019,"Wyoming","Johnson County",4,76,75,41,34
050,56,019,"Wyoming","Johnson County",4,77,64,31,33
050,56,019,"Wyoming","Johnson County",4,78,75,38,37
050,56,019,"Wyoming","Johnson County",4,79,75,37,38
050,56,019,"Wyoming","Johnson County",4,80,60,30,30
050,56,019,"Wyoming","Johnson County",4,81,59,35,24
050,56,019,"Wyoming","Johnson County",4,82,52,29,23
050,56,019,"Wyoming","Johnson County",4,83,41,12,29
050,56,019,"Wyoming","Johnson County",4,84,55,23,32
050,56,019,"Wyoming","Johnson County",4,85,263,137,126
050,56,019,"Wyoming","Johnson County",5,0,76,36,40
050,56,019,"Wyoming","Johnson County",5,1,80,39,41
050,56,019,"Wyoming","Johnson County",5,2,76,38,38
050,56,019,"Wyoming","Johnson County",5,3,75,36,39
050,56,019,"Wyoming","Johnson County",5,4,74,38,36
050,56,019,"Wyoming","Johnson County",5,5,79,34,45
050,56,019,"Wyoming","Johnson County",5,6,77,40,37
050,56,019,"Wyoming","Johnson County",5,7,100,46,54
050,56,019,"Wyoming","Johnson County",5,8,91,46,45
050,56,019,"Wyoming","Johnson County",5,9,96,49,47
050,56,019,"Wyoming","Johnson County",5,10,99,60,39
050,56,019,"Wyoming","Johnson County",5,11,102,55,47
050,56,019,"Wyoming","Johnson County",5,12,115,59,56
050,56,019,"Wyoming","Johnson County",5,13,102,55,47
050,56,019,"Wyoming","Johnson County",5,14,117,66,51
050,56,019,"Wyoming","Johnson County",5,15,124,65,59
050,56,019,"Wyoming","Johnson County",5,16,132,71,61
050,56,019,"Wyoming","Johnson County",5,17,122,68,54
050,56,019,"Wyoming","Johnson County",5,18,95,45,50
050,56,019,"Wyoming","Johnson County",5,19,79,42,37
050,56,019,"Wyoming","Johnson County",5,20,72,43,29
050,56,019,"Wyoming","Johnson County",5,21,61,34,27
050,56,019,"Wyoming","Johnson County",5,22,71,39,32
050,56,019,"Wyoming","Johnson County",5,23,77,36,41
050,56,019,"Wyoming","Johnson County",5,24,61,30,31
050,56,019,"Wyoming","Johnson County",5,25,62,33,29
050,56,019,"Wyoming","Johnson County",5,26,82,42,40
050,56,019,"Wyoming","Johnson County",5,27,77,36,41
050,56,019,"Wyoming","Johnson County",5,28,77,37,40
050,56,019,"Wyoming","Johnson County",5,29,81,45,36
050,56,019,"Wyoming","Johnson County",5,30,77,39,38
050,56,019,"Wyoming","Johnson County",5,31,70,33,37
050,56,019,"Wyoming","Johnson County",5,32,73,38,35
050,56,019,"Wyoming","Johnson County",5,33,94,54,40
050,56,019,"Wyoming","Johnson County",5,34,82,42,40
050,56,019,"Wyoming","Johnson County",5,35,94,50,44
050,56,019,"Wyoming","Johnson County",5,36,96,45,51
050,56,019,"Wyoming","Johnson County",5,37,106,47,59
050,56,019,"Wyoming","Johnson County",5,38,107,51,56
050,56,019,"Wyoming","Johnson County",5,39,99,48,51
050,56,019,"Wyoming","Johnson County",5,40,113,58,55
050,56,019,"Wyoming","Johnson County",5,41,137,68,69
050,56,019,"Wyoming","Johnson County",5,42,113,60,53
050,56,019,"Wyoming","Johnson County",5,43,114,56,58
050,56,019,"Wyoming","Johnson County",5,44,107,56,51
050,56,019,"Wyoming","Johnson County",5,45,101,50,51
050,56,019,"Wyoming","Johnson County",5,46,98,46,52
050,56,019,"Wyoming","Johnson County",5,47,85,49,36
050,56,019,"Wyoming","Johnson County",5,48,99,53,46
050,56,019,"Wyoming","Johnson County",5,49,96,51,45
050,56,019,"Wyoming","Johnson County",5,50,98,48,50
050,56,019,"Wyoming","Johnson County",5,51,101,55,46
050,56,019,"Wyoming","Johnson County",5,52,110,57,53
050,56,019,"Wyoming","Johnson County",5,53,110,57,53
050,56,019,"Wyoming","Johnson County",5,54,100,47,53
050,56,019,"Wyoming","Johnson County",5,55,101,45,56
050,56,019,"Wyoming","Johnson County",5,56,97,40,57
050,56,019,"Wyoming","Johnson County",5,57,99,46,53
050,56,019,"Wyoming","Johnson County",5,58,109,51,58
050,56,019,"Wyoming","Johnson County",5,59,130,61,69
050,56,019,"Wyoming","Johnson County",5,60,127,67,60
050,56,019,"Wyoming","Johnson County",5,61,130,68,62
050,56,019,"Wyoming","Johnson County",5,62,148,70,78
050,56,019,"Wyoming","Johnson County",5,63,144,67,77
050,56,019,"Wyoming","Johnson County",5,64,125,65,60
050,56,019,"Wyoming","Johnson County",5,65,137,67,70
050,56,019,"Wyoming","Johnson County",5,66,153,75,78
050,56,019,"Wyoming","Johnson County",5,67,157,79,78
050,56,019,"Wyoming","Johnson County",5,68,164,71,93
050,56,019,"Wyoming","Johnson County",5,69,159,78,81
050,56,019,"Wyoming","Johnson County",5,70,154,80,74
050,56,019,"Wyoming","Johnson County",5,71,138,66,72
050,56,019,"Wyoming","Johnson County",5,72,119,62,57
050,56,019,"Wyoming","Johnson County",5,73,121,66,55
050,56,019,"Wyoming","Johnson County",5,74,126,68,58
050,56,019,"Wyoming","Johnson County",5,75,117,64,53
050,56,019,"Wyoming","Johnson County",5,76,125,69,56
050,56,019,"Wyoming","Johnson County",5,77,77,40,37
050,56,019,"Wyoming","Johnson County",5,78,59,28,31
050,56,019,"Wyoming","Johnson County",5,79,72,38,34
050,56,019,"Wyoming","Johnson County",5,80,72,34,38
050,56,019,"Wyoming","Johnson County",5,81,58,31,27
050,56,019,"Wyoming","Johnson County",5,82,57,32,25
050,56,019,"Wyoming","Johnson County",5,83,46,26,20
050,56,019,"Wyoming","Johnson County",5,84,42,12,30
050,56,019,"Wyoming","Johnson County",5,85,284,149,135
050,56,021,"Wyoming","Laramie County",1,0,1185,610,575
050,56,021,"Wyoming","Laramie County",1,1,1191,633,558
050,56,021,"Wyoming","Laramie County",1,2,1226,607,619
050,56,021,"Wyoming","Laramie County",1,3,1231,629,602
050,56,021,"Wyoming","Laramie County",1,4,1275,685,590
050,56,021,"Wyoming","Laramie County",1,5,1234,629,605
050,56,021,"Wyoming","Laramie County",1,6,1245,653,592
050,56,021,"Wyoming","Laramie County",1,7,1328,703,625
050,56,021,"Wyoming","Laramie County",1,8,1280,686,594
050,56,021,"Wyoming","Laramie County",1,9,1325,665,660
050,56,021,"Wyoming","Laramie County",1,10,1413,727,686
050,56,021,"Wyoming","Laramie County",1,11,1396,714,682
050,56,021,"Wyoming","Laramie County",1,12,1399,714,685
050,56,021,"Wyoming","Laramie County",1,13,1404,701,703
050,56,021,"Wyoming","Laramie County",1,14,1369,708,661
050,56,021,"Wyoming","Laramie County",1,15,1331,668,663
050,56,021,"Wyoming","Laramie County",1,16,1293,665,628
050,56,021,"Wyoming","Laramie County",1,17,1250,643,607
050,56,021,"Wyoming","Laramie County",1,18,1061,560,501
050,56,021,"Wyoming","Laramie County",1,19,1020,565,455
050,56,021,"Wyoming","Laramie County",1,20,1233,711,522
050,56,021,"Wyoming","Laramie County",1,21,1278,715,563
050,56,021,"Wyoming","Laramie County",1,22,1263,690,573
050,56,021,"Wyoming","Laramie County",1,23,1282,686,596
050,56,021,"Wyoming","Laramie County",1,24,1384,763,621
050,56,021,"Wyoming","Laramie County",1,25,1326,704,622
050,56,021,"Wyoming","Laramie County",1,26,1393,749,644
050,56,021,"Wyoming","Laramie County",1,27,1477,751,726
050,56,021,"Wyoming","Laramie County",1,28,1497,751,746
050,56,021,"Wyoming","Laramie County",1,29,1533,790,743
050,56,021,"Wyoming","Laramie County",1,30,1533,793,740
050,56,021,"Wyoming","Laramie County",1,31,1433,772,661
050,56,021,"Wyoming","Laramie County",1,32,1429,762,667
050,56,021,"Wyoming","Laramie County",1,33,1443,736,707
050,56,021,"Wyoming","Laramie County",1,34,1480,758,722
050,56,021,"Wyoming","Laramie County",1,35,1438,745,693
050,56,021,"Wyoming","Laramie County",1,36,1461,753,708
050,56,021,"Wyoming","Laramie County",1,37,1464,775,689
050,56,021,"Wyoming","Laramie County",1,38,1386,740,646
050,56,021,"Wyoming","Laramie County",1,39,1397,747,650
050,56,021,"Wyoming","Laramie County",1,40,1293,679,614
050,56,021,"Wyoming","Laramie County",1,41,1211,623,588
050,56,021,"Wyoming","Laramie County",1,42,1172,619,553
050,56,021,"Wyoming","Laramie County",1,43,1119,588,531
050,56,021,"Wyoming","Laramie County",1,44,1095,561,534
050,56,021,"Wyoming","Laramie County",1,45,1106,589,517
050,56,021,"Wyoming","Laramie County",1,46,1080,571,509
050,56,021,"Wyoming","Laramie County",1,47,1105,562,543
050,56,021,"Wyoming","Laramie County",1,48,1138,555,583
050,56,021,"Wyoming","Laramie County",1,49,1214,613,601
050,56,021,"Wyoming","Laramie County",1,50,1206,621,585
050,56,021,"Wyoming","Laramie County",1,51,1112,569,543
050,56,021,"Wyoming","Laramie County",1,52,1087,569,518
050,56,021,"Wyoming","Laramie County",1,53,1122,593,529
050,56,021,"Wyoming","Laramie County",1,54,1138,612,526
050,56,021,"Wyoming","Laramie County",1,55,1265,651,614
050,56,021,"Wyoming","Laramie County",1,56,1334,658,676
050,56,021,"Wyoming","Laramie County",1,57,1326,654,672
050,56,021,"Wyoming","Laramie County",1,58,1380,704,676
050,56,021,"Wyoming","Laramie County",1,59,1397,714,683
050,56,021,"Wyoming","Laramie County",1,60,1394,694,700
050,56,021,"Wyoming","Laramie County",1,61,1315,654,661
050,56,021,"Wyoming","Laramie County",1,62,1263,621,642
050,56,021,"Wyoming","Laramie County",1,63,1265,597,668
050,56,021,"Wyoming","Laramie County",1,64,1252,598,654
050,56,021,"Wyoming","Laramie County",1,65,1239,595,644
050,56,021,"Wyoming","Laramie County",1,66,1145,551,594
050,56,021,"Wyoming","Laramie County",1,67,1132,574,558
050,56,021,"Wyoming","Laramie County",1,68,1085,551,534
050,56,021,"Wyoming","Laramie County",1,69,1006,485,521
050,56,021,"Wyoming","Laramie County",1,70,1008,487,521
050,56,021,"Wyoming","Laramie County",1,71,995,480,515
050,56,021,"Wyoming","Laramie County",1,72,984,476,508
050,56,021,"Wyoming","Laramie County",1,73,934,457,477
050,56,021,"Wyoming","Laramie County",1,74,650,316,334
050,56,021,"Wyoming","Laramie County",1,75,661,321,340
050,56,021,"Wyoming","Laramie County",1,76,616,308,308
050,56,021,"Wyoming","Laramie County",1,77,589,283,306
050,56,021,"Wyoming","Laramie County",1,78,512,242,270
050,56,021,"Wyoming","Laramie County",1,79,464,213,251
050,56,021,"Wyoming","Laramie County",1,80,418,194,224
050,56,021,"Wyoming","Laramie County",1,81,395,185,210
050,56,021,"Wyoming","Laramie County",1,82,334,141,193
050,56,021,"Wyoming","Laramie County",1,83,313,135,178
050,56,021,"Wyoming","Laramie County",1,84,288,137,151
050,56,021,"Wyoming","Laramie County",1,85,1769,673,1096
050,56,021,"Wyoming","Laramie County",2,0,1169,603,566
050,56,021,"Wyoming","Laramie County",2,1,1184,623,561
050,56,021,"Wyoming","Laramie County",2,2,1215,612,603
050,56,021,"Wyoming","Laramie County",2,3,1230,626,604
050,56,021,"Wyoming","Laramie County",2,4,1266,671,595
050,56,021,"Wyoming","Laramie County",2,5,1244,646,598
050,56,021,"Wyoming","Laramie County",2,6,1244,650,594
050,56,021,"Wyoming","Laramie County",2,7,1307,692,615
050,56,021,"Wyoming","Laramie County",2,8,1299,698,601
050,56,021,"Wyoming","Laramie County",2,9,1320,673,647
050,56,021,"Wyoming","Laramie County",2,10,1390,711,679
050,56,021,"Wyoming","Laramie County",2,11,1396,715,681
050,56,021,"Wyoming","Laramie County",2,12,1412,721,691
050,56,021,"Wyoming","Laramie County",2,13,1405,704,701
050,56,021,"Wyoming","Laramie County",2,14,1375,705,670
050,56,021,"Wyoming","Laramie County",2,15,1334,675,659
050,56,021,"Wyoming","Laramie County",2,16,1299,664,635
050,56,021,"Wyoming","Laramie County",2,17,1260,649,611
050,56,021,"Wyoming","Laramie County",2,18,1080,569,511
050,56,021,"Wyoming","Laramie County",2,19,1038,577,461
050,56,021,"Wyoming","Laramie County",2,20,1237,712,525
050,56,021,"Wyoming","Laramie County",2,21,1270,713,557
050,56,021,"Wyoming","Laramie County",2,22,1277,697,580
050,56,021,"Wyoming","Laramie County",2,23,1277,688,589
050,56,021,"Wyoming","Laramie County",2,24,1359,740,619
050,56,021,"Wyoming","Laramie County",2,25,1331,711,620
050,56,021,"Wyoming","Laramie County",2,26,1386,745,641
050,56,021,"Wyoming","Laramie County",2,27,1454,747,707
050,56,021,"Wyoming","Laramie County",2,28,1502,762,740
050,56,021,"Wyoming","Laramie County",2,29,1531,779,752
050,56,021,"Wyoming","Laramie County",2,30,1535,795,740
050,56,021,"Wyoming","Laramie County",2,31,1459,779,680
050,56,021,"Wyoming","Laramie County",2,32,1427,766,661
050,56,021,"Wyoming","Laramie County",2,33,1443,742,701
050,56,021,"Wyoming","Laramie County",2,34,1472,751,721
050,56,021,"Wyoming","Laramie County",2,35,1462,750,712
050,56,021,"Wyoming","Laramie County",2,36,1447,747,700
050,56,021,"Wyoming","Laramie County",2,37,1461,768,693
050,56,021,"Wyoming","Laramie County",2,38,1407,748,659
050,56,021,"Wyoming","Laramie County",2,39,1381,736,645
050,56,021,"Wyoming","Laramie County",2,40,1313,686,627
050,56,021,"Wyoming","Laramie County",2,41,1233,637,596
050,56,021,"Wyoming","Laramie County",2,42,1172,615,557
050,56,021,"Wyoming","Laramie County",2,43,1138,598,540
050,56,021,"Wyoming","Laramie County",2,44,1089,558,531
050,56,021,"Wyoming","Laramie County",2,45,1114,589,525
050,56,021,"Wyoming","Laramie County",2,46,1085,573,512
050,56,021,"Wyoming","Laramie County",2,47,1093,560,533
050,56,021,"Wyoming","Laramie County",2,48,1132,555,577
050,56,021,"Wyoming","Laramie County",2,49,1203,606,597
050,56,021,"Wyoming","Laramie County",2,50,1220,626,594
050,56,021,"Wyoming","Laramie County",2,51,1138,582,556
050,56,021,"Wyoming","Laramie County",2,52,1090,567,523
050,56,021,"Wyoming","Laramie County",2,53,1117,591,526
050,56,021,"Wyoming","Laramie County",2,54,1131,607,524
050,56,021,"Wyoming","Laramie County",2,55,1237,643,594
050,56,021,"Wyoming","Laramie County",2,56,1323,662,661
050,56,021,"Wyoming","Laramie County",2,57,1334,658,676
050,56,021,"Wyoming","Laramie County",2,58,1366,694,672
050,56,021,"Wyoming","Laramie County",2,59,1401,715,686
050,56,021,"Wyoming","Laramie County",2,60,1395,696,699
050,56,021,"Wyoming","Laramie County",2,61,1332,662,670
050,56,021,"Wyoming","Laramie County",2,62,1282,635,647
050,56,021,"Wyoming","Laramie County",2,63,1273,603,670
050,56,021,"Wyoming","Laramie County",2,64,1256,599,657
050,56,021,"Wyoming","Laramie County",2,65,1235,591,644
050,56,021,"Wyoming","Laramie County",2,66,1167,557,610
050,56,021,"Wyoming","Laramie County",2,67,1130,569,561
050,56,021,"Wyoming","Laramie County",2,68,1087,556,531
050,56,021,"Wyoming","Laramie County",2,69,1035,506,529
050,56,021,"Wyoming","Laramie County",2,70,1007,487,520
050,56,021,"Wyoming","Laramie County",2,71,999,481,518
050,56,021,"Wyoming","Laramie County",2,72,964,466,498
050,56,021,"Wyoming","Laramie County",2,73,983,482,501
050,56,021,"Wyoming","Laramie County",2,74,674,327,347
050,56,021,"Wyoming","Laramie County",2,75,656,320,336
050,56,021,"Wyoming","Laramie County",2,76,614,306,308
050,56,021,"Wyoming","Laramie County",2,77,601,294,307
050,56,021,"Wyoming","Laramie County",2,78,516,243,273
050,56,021,"Wyoming","Laramie County",2,79,478,218,260
050,56,021,"Wyoming","Laramie County",2,80,421,197,224
050,56,021,"Wyoming","Laramie County",2,81,391,175,216
050,56,021,"Wyoming","Laramie County",2,82,346,150,196
050,56,021,"Wyoming","Laramie County",2,83,311,134,177
050,56,021,"Wyoming","Laramie County",2,84,286,132,154
050,56,021,"Wyoming","Laramie County",2,85,1777,673,1104
050,56,021,"Wyoming","Laramie County",3,0,1097,560,537
050,56,021,"Wyoming","Laramie County",3,1,1124,585,539
050,56,021,"Wyoming","Laramie County",3,2,1182,606,576
050,56,021,"Wyoming","Laramie County",3,3,1193,593,600
050,56,021,"Wyoming","Laramie County",3,4,1220,601,619
050,56,021,"Wyoming","Laramie County",3,5,1270,653,617
050,56,021,"Wyoming","Laramie County",3,6,1217,629,588
050,56,021,"Wyoming","Laramie County",3,7,1234,644,590
050,56,021,"Wyoming","Laramie County",3,8,1311,682,629
050,56,021,"Wyoming","Laramie County",3,9,1251,661,590
050,56,021,"Wyoming","Laramie County",3,10,1334,664,670
050,56,021,"Wyoming","Laramie County",3,11,1380,710,670
050,56,021,"Wyoming","Laramie County",3,12,1405,720,685
050,56,021,"Wyoming","Laramie County",3,13,1425,719,706
050,56,021,"Wyoming","Laramie County",3,14,1370,681,689
050,56,021,"Wyoming","Laramie County",3,15,1373,703,670
050,56,021,"Wyoming","Laramie County",3,16,1339,666,673
050,56,021,"Wyoming","Laramie County",3,17,1331,684,647
050,56,021,"Wyoming","Laramie County",3,18,1104,584,520
050,56,021,"Wyoming","Laramie County",3,19,1066,586,480
050,56,021,"Wyoming","Laramie County",3,20,1253,698,555
050,56,021,"Wyoming","Laramie County",3,21,1273,719,554
050,56,021,"Wyoming","Laramie County",3,22,1366,729,637
050,56,021,"Wyoming","Laramie County",3,23,1296,693,603
050,56,021,"Wyoming","Laramie County",3,24,1344,718,626
050,56,021,"Wyoming","Laramie County",3,25,1348,710,638
050,56,021,"Wyoming","Laramie County",3,26,1337,706,631
050,56,021,"Wyoming","Laramie County",3,27,1398,751,647
050,56,021,"Wyoming","Laramie County",3,28,1400,716,684
050,56,021,"Wyoming","Laramie County",3,29,1510,758,752
050,56,021,"Wyoming","Laramie County",3,30,1544,795,749
050,56,021,"Wyoming","Laramie County",3,31,1514,770,744
050,56,021,"Wyoming","Laramie County",3,32,1444,754,690
050,56,021,"Wyoming","Laramie County",3,33,1403,743,660
050,56,021,"Wyoming","Laramie County",3,34,1424,736,688
050,56,021,"Wyoming","Laramie County",3,35,1496,762,734
050,56,021,"Wyoming","Laramie County",3,36,1466,746,720
050,56,021,"Wyoming","Laramie County",3,37,1441,740,701
050,56,021,"Wyoming","Laramie County",3,38,1441,751,690
050,56,021,"Wyoming","Laramie County",3,39,1389,726,663
050,56,021,"Wyoming","Laramie County",3,40,1351,717,634
050,56,021,"Wyoming","Laramie County",3,41,1324,697,627
050,56,021,"Wyoming","Laramie County",3,42,1266,654,612
050,56,021,"Wyoming","Laramie County",3,43,1145,597,548
050,56,021,"Wyoming","Laramie County",3,44,1113,575,538
050,56,021,"Wyoming","Laramie County",3,45,1082,559,523
050,56,021,"Wyoming","Laramie County",3,46,1115,588,527
050,56,021,"Wyoming","Laramie County",3,47,1078,572,506
050,56,021,"Wyoming","Laramie County",3,48,1095,557,538
050,56,021,"Wyoming","Laramie County",3,49,1121,545,576
050,56,021,"Wyoming","Laramie County",3,50,1218,619,599
050,56,021,"Wyoming","Laramie County",3,51,1194,613,581
050,56,021,"Wyoming","Laramie County",3,52,1151,589,562
050,56,021,"Wyoming","Laramie County",3,53,1086,551,535
050,56,021,"Wyoming","Laramie County",3,54,1124,594,530
050,56,021,"Wyoming","Laramie County",3,55,1136,598,538
050,56,021,"Wyoming","Laramie County",3,56,1230,644,586
050,56,021,"Wyoming","Laramie County",3,57,1308,653,655
050,56,021,"Wyoming","Laramie County",3,58,1313,644,669
050,56,021,"Wyoming","Laramie County",3,59,1366,703,663
050,56,021,"Wyoming","Laramie County",3,60,1364,689,675
050,56,021,"Wyoming","Laramie County",3,61,1364,670,694
050,56,021,"Wyoming","Laramie County",3,62,1297,636,661
050,56,021,"Wyoming","Laramie County",3,63,1275,631,644
050,56,021,"Wyoming","Laramie County",3,64,1261,599,662
050,56,021,"Wyoming","Laramie County",3,65,1238,585,653
050,56,021,"Wyoming","Laramie County",3,66,1230,580,650
050,56,021,"Wyoming","Laramie County",3,67,1140,551,589
050,56,021,"Wyoming","Laramie County",3,68,1114,561,553
050,56,021,"Wyoming","Laramie County",3,69,1062,544,518
050,56,021,"Wyoming","Laramie County",3,70,1010,489,521
050,56,021,"Wyoming","Laramie County",3,71,988,473,515
050,56,021,"Wyoming","Laramie County",3,72,976,471,505
050,56,021,"Wyoming","Laramie County",3,73,920,448,472
050,56,021,"Wyoming","Laramie County",3,74,962,465,497
050,56,021,"Wyoming","Laramie County",3,75,639,304,335
050,56,021,"Wyoming","Laramie County",3,76,635,319,316
050,56,021,"Wyoming","Laramie County",3,77,580,282,298
050,56,021,"Wyoming","Laramie County",3,78,561,265,296
050,56,021,"Wyoming","Laramie County",3,79,491,228,263
050,56,021,"Wyoming","Laramie County",3,80,443,205,238
050,56,021,"Wyoming","Laramie County",3,81,394,180,214
050,56,021,"Wyoming","Laramie County",3,82,360,163,197
050,56,021,"Wyoming","Laramie County",3,83,330,137,193
050,56,021,"Wyoming","Laramie County",3,84,276,120,156
050,56,021,"Wyoming","Laramie County",3,85,1788,691,1097
050,56,021,"Wyoming","Laramie County",4,0,1109,600,509
050,56,021,"Wyoming","Laramie County",4,1,1085,555,530
050,56,021,"Wyoming","Laramie County",4,2,1130,587,543
050,56,021,"Wyoming","Laramie County",4,3,1179,590,589
050,56,021,"Wyoming","Laramie County",4,4,1179,579,600
050,56,021,"Wyoming","Laramie County",4,5,1235,630,605
050,56,021,"Wyoming","Laramie County",4,6,1254,644,610
050,56,021,"Wyoming","Laramie County",4,7,1195,609,586
050,56,021,"Wyoming","Laramie County",4,8,1238,656,582
050,56,021,"Wyoming","Laramie County",4,9,1305,668,637
050,56,021,"Wyoming","Laramie County",4,10,1246,659,587
050,56,021,"Wyoming","Laramie County",4,11,1312,654,658
050,56,021,"Wyoming","Laramie County",4,12,1348,683,665
050,56,021,"Wyoming","Laramie County",4,13,1376,713,663
050,56,021,"Wyoming","Laramie County",4,14,1420,724,696
050,56,021,"Wyoming","Laramie County",4,15,1333,667,666
050,56,021,"Wyoming","Laramie County",4,16,1368,711,657
050,56,021,"Wyoming","Laramie County",4,17,1331,657,674
050,56,021,"Wyoming","Laramie County",4,18,1162,620,542
050,56,021,"Wyoming","Laramie County",4,19,1070,605,465
050,56,021,"Wyoming","Laramie County",4,20,1220,700,520
050,56,021,"Wyoming","Laramie County",4,21,1305,710,595
050,56,021,"Wyoming","Laramie County",4,22,1297,698,599
050,56,021,"Wyoming","Laramie County",4,23,1416,766,650
050,56,021,"Wyoming","Laramie County",4,24,1345,706,639
050,56,021,"Wyoming","Laramie County",4,25,1353,732,621
050,56,021,"Wyoming","Laramie County",4,26,1399,744,655
050,56,021,"Wyoming","Laramie County",4,27,1354,715,639
050,56,021,"Wyoming","Laramie County",4,28,1397,739,658
050,56,021,"Wyoming","Laramie County",4,29,1447,745,702
050,56,021,"Wyoming","Laramie County",4,30,1518,777,741
050,56,021,"Wyoming","Laramie County",4,31,1538,786,752
050,56,021,"Wyoming","Laramie County",4,32,1503,775,728
050,56,021,"Wyoming","Laramie County",4,33,1433,761,672
050,56,021,"Wyoming","Laramie County",4,34,1397,752,645
050,56,021,"Wyoming","Laramie County",4,35,1431,755,676
050,56,021,"Wyoming","Laramie County",4,36,1490,747,743
050,56,021,"Wyoming","Laramie County",4,37,1470,743,727
050,56,021,"Wyoming","Laramie County",4,38,1408,740,668
050,56,021,"Wyoming","Laramie County",4,39,1421,730,691
050,56,021,"Wyoming","Laramie County",4,40,1373,706,667
050,56,021,"Wyoming","Laramie County",4,41,1346,734,612
050,56,021,"Wyoming","Laramie County",4,42,1314,679,635
050,56,021,"Wyoming","Laramie County",4,43,1239,638,601
050,56,021,"Wyoming","Laramie County",4,44,1149,592,557
050,56,021,"Wyoming","Laramie County",4,45,1103,564,539
050,56,021,"Wyoming","Laramie County",4,46,1079,554,525
050,56,021,"Wyoming","Laramie County",4,47,1128,603,525
050,56,021,"Wyoming","Laramie County",4,48,1054,556,498
050,56,021,"Wyoming","Laramie County",4,49,1090,557,533
050,56,021,"Wyoming","Laramie County",4,50,1135,548,587
050,56,021,"Wyoming","Laramie County",4,51,1234,631,603
050,56,021,"Wyoming","Laramie County",4,52,1187,622,565
050,56,021,"Wyoming","Laramie County",4,53,1155,588,567
050,56,021,"Wyoming","Laramie County",4,54,1097,554,543
050,56,021,"Wyoming","Laramie County",4,55,1098,590,508
050,56,021,"Wyoming","Laramie County",4,56,1144,601,543
050,56,021,"Wyoming","Laramie County",4,57,1228,637,591
050,56,021,"Wyoming","Laramie County",4,58,1278,633,645
050,56,021,"Wyoming","Laramie County",4,59,1289,638,651
050,56,021,"Wyoming","Laramie County",4,60,1341,681,660
050,56,021,"Wyoming","Laramie County",4,61,1338,669,669
050,56,021,"Wyoming","Laramie County",4,62,1343,649,694
050,56,021,"Wyoming","Laramie County",4,63,1268,621,647
050,56,021,"Wyoming","Laramie County",4,64,1249,622,627
050,56,021,"Wyoming","Laramie County",4,65,1236,591,645
050,56,021,"Wyoming","Laramie County",4,66,1218,558,660
050,56,021,"Wyoming","Laramie County",4,67,1210,575,635
050,56,021,"Wyoming","Laramie County",4,68,1113,540,573
050,56,021,"Wyoming","Laramie County",4,69,1096,547,549
050,56,021,"Wyoming","Laramie County",4,70,1041,527,514
050,56,021,"Wyoming","Laramie County",4,71,982,477,505
050,56,021,"Wyoming","Laramie County",4,72,975,457,518
050,56,021,"Wyoming","Laramie County",4,73,917,440,477
050,56,021,"Wyoming","Laramie County",4,74,897,436,461
050,56,021,"Wyoming","Laramie County",4,75,920,450,470
050,56,021,"Wyoming","Laramie County",4,76,608,298,310
050,56,021,"Wyoming","Laramie County",4,77,596,296,300
050,56,021,"Wyoming","Laramie County",4,78,544,259,285
050,56,021,"Wyoming","Laramie County",4,79,532,247,285
050,56,021,"Wyoming","Laramie County",4,80,456,213,243
050,56,021,"Wyoming","Laramie County",4,81,409,184,225
050,56,021,"Wyoming","Laramie County",4,82,366,166,200
050,56,021,"Wyoming","Laramie County",4,83,333,149,184
050,56,021,"Wyoming","Laramie County",4,84,302,120,182
050,56,021,"Wyoming","Laramie County",4,85,1754,673,1081
050,56,021,"Wyoming","Laramie County",5,0,1104,593,511
050,56,021,"Wyoming","Laramie County",5,1,1128,624,504
050,56,021,"Wyoming","Laramie County",5,2,1074,530,544
050,56,021,"Wyoming","Laramie County",5,3,1115,579,536
050,56,021,"Wyoming","Laramie County",5,4,1204,598,606
050,56,021,"Wyoming","Laramie County",5,5,1177,589,588
050,56,021,"Wyoming","Laramie County",5,6,1203,619,584
050,56,021,"Wyoming","Laramie County",5,7,1256,640,616
050,56,021,"Wyoming","Laramie County",5,8,1194,597,597
050,56,021,"Wyoming","Laramie County",5,9,1240,645,595
050,56,021,"Wyoming","Laramie County",5,10,1287,645,642
050,56,021,"Wyoming","Laramie County",5,11,1224,645,579
050,56,021,"Wyoming","Laramie County",5,12,1305,657,648
050,56,021,"Wyoming","Laramie County",5,13,1297,667,630
050,56,021,"Wyoming","Laramie County",5,14,1363,708,655
050,56,021,"Wyoming","Laramie County",5,15,1429,717,712
050,56,021,"Wyoming","Laramie County",5,16,1326,646,680
050,56,021,"Wyoming","Laramie County",5,17,1352,706,646
050,56,021,"Wyoming","Laramie County",5,18,1166,601,565
050,56,021,"Wyoming","Laramie County",5,19,1124,626,498
050,56,021,"Wyoming","Laramie County",5,20,1242,748,494
050,56,021,"Wyoming","Laramie County",5,21,1249,707,542
050,56,021,"Wyoming","Laramie County",5,22,1336,703,633
050,56,021,"Wyoming","Laramie County",5,23,1369,740,629
050,56,021,"Wyoming","Laramie County",5,24,1404,748,656
050,56,021,"Wyoming","Laramie County",5,25,1348,691,657
050,56,021,"Wyoming","Laramie County",5,26,1419,761,658
050,56,021,"Wyoming","Laramie County",5,27,1388,732,656
050,56,021,"Wyoming","Laramie County",5,28,1341,704,637
050,56,021,"Wyoming","Laramie County",5,29,1417,754,663
050,56,021,"Wyoming","Laramie County",5,30,1447,757,690
050,56,021,"Wyoming","Laramie County",5,31,1516,775,741
050,56,021,"Wyoming","Laramie County",5,32,1538,781,757
050,56,021,"Wyoming","Laramie County",5,33,1487,757,730
050,56,021,"Wyoming","Laramie County",5,34,1438,783,655
050,56,021,"Wyoming","Laramie County",5,35,1380,736,644
050,56,021,"Wyoming","Laramie County",5,36,1415,737,678
050,56,021,"Wyoming","Laramie County",5,37,1452,740,712
050,56,021,"Wyoming","Laramie County",5,38,1444,734,710
050,56,021,"Wyoming","Laramie County",5,39,1396,730,666
050,56,021,"Wyoming","Laramie County",5,40,1397,711,686
050,56,021,"Wyoming","Laramie County",5,41,1376,713,663
050,56,021,"Wyoming","Laramie County",5,42,1345,731,614
050,56,021,"Wyoming","Laramie County",5,43,1340,699,641
050,56,021,"Wyoming","Laramie County",5,44,1239,642,597
050,56,021,"Wyoming","Laramie County",5,45,1165,591,574
050,56,021,"Wyoming","Laramie County",5,46,1105,565,540
050,56,021,"Wyoming","Laramie County",5,47,1067,542,525
050,56,021,"Wyoming","Laramie County",5,48,1114,586,528
050,56,021,"Wyoming","Laramie County",5,49,1042,547,495
050,56,021,"Wyoming","Laramie County",5,50,1079,548,531
050,56,021,"Wyoming","Laramie County",5,51,1120,536,584
050,56,021,"Wyoming","Laramie County",5,52,1225,634,591
050,56,021,"Wyoming","Laramie County",5,53,1206,624,582
050,56,021,"Wyoming","Laramie County",5,54,1140,583,557
050,56,021,"Wyoming","Laramie County",5,55,1101,551,550
050,56,021,"Wyoming","Laramie County",5,56,1122,598,524
050,56,021,"Wyoming","Laramie County",5,57,1155,598,557
050,56,021,"Wyoming","Laramie County",5,58,1248,648,600
050,56,021,"Wyoming","Laramie County",5,59,1279,636,643
050,56,021,"Wyoming","Laramie County",5,60,1282,629,653
050,56,021,"Wyoming","Laramie County",5,61,1336,682,654
050,56,021,"Wyoming","Laramie County",5,62,1329,670,659
050,56,021,"Wyoming","Laramie County",5,63,1329,639,690
050,56,021,"Wyoming","Laramie County",5,64,1255,612,643
050,56,021,"Wyoming","Laramie County",5,65,1265,632,633
050,56,021,"Wyoming","Laramie County",5,66,1237,598,639
050,56,021,"Wyoming","Laramie County",5,67,1212,562,650
050,56,021,"Wyoming","Laramie County",5,68,1190,565,625
050,56,021,"Wyoming","Laramie County",5,69,1100,529,571
050,56,021,"Wyoming","Laramie County",5,70,1060,526,534
050,56,021,"Wyoming","Laramie County",5,71,1021,511,510
050,56,021,"Wyoming","Laramie County",5,72,965,469,496
050,56,021,"Wyoming","Laramie County",5,73,926,424,502
050,56,021,"Wyoming","Laramie County",5,74,886,424,462
050,56,021,"Wyoming","Laramie County",5,75,860,407,453
050,56,021,"Wyoming","Laramie County",5,76,883,438,445
050,56,021,"Wyoming","Laramie County",5,77,576,275,301
050,56,021,"Wyoming","Laramie County",5,78,570,281,289
050,56,021,"Wyoming","Laramie County",5,79,519,244,275
050,56,021,"Wyoming","Laramie County",5,80,502,234,268
050,56,021,"Wyoming","Laramie County",5,81,429,198,231
050,56,021,"Wyoming","Laramie County",5,82,382,172,210
050,56,021,"Wyoming","Laramie County",5,83,335,148,187
050,56,021,"Wyoming","Laramie County",5,84,300,132,168
050,56,021,"Wyoming","Laramie County",5,85,1776,682,1094
050,56,023,"Wyoming","Lincoln County",1,0,224,113,111
050,56,023,"Wyoming","Lincoln County",1,1,213,106,107
050,56,023,"Wyoming","Lincoln County",1,2,229,110,119
050,56,023,"Wyoming","Lincoln County",1,3,274,133,141
050,56,023,"Wyoming","Lincoln County",1,4,282,150,132
050,56,023,"Wyoming","Lincoln County",1,5,266,125,141
050,56,023,"Wyoming","Lincoln County",1,6,288,150,138
050,56,023,"Wyoming","Lincoln County",1,7,269,149,120
050,56,023,"Wyoming","Lincoln County",1,8,287,147,140
050,56,023,"Wyoming","Lincoln County",1,9,277,164,113
050,56,023,"Wyoming","Lincoln County",1,10,298,155,143
050,56,023,"Wyoming","Lincoln County",1,11,341,172,169
050,56,023,"Wyoming","Lincoln County",1,12,332,163,169
050,56,023,"Wyoming","Lincoln County",1,13,328,172,156
050,56,023,"Wyoming","Lincoln County",1,14,329,172,157
050,56,023,"Wyoming","Lincoln County",1,15,315,155,160
050,56,023,"Wyoming","Lincoln County",1,16,322,166,156
050,56,023,"Wyoming","Lincoln County",1,17,304,157,147
050,56,023,"Wyoming","Lincoln County",1,18,242,143,99
050,56,023,"Wyoming","Lincoln County",1,19,179,100,79
050,56,023,"Wyoming","Lincoln County",1,20,172,94,78
050,56,023,"Wyoming","Lincoln County",1,21,164,95,69
050,56,023,"Wyoming","Lincoln County",1,22,178,93,85
050,56,023,"Wyoming","Lincoln County",1,23,170,87,83
050,56,023,"Wyoming","Lincoln County",1,24,163,91,72
050,56,023,"Wyoming","Lincoln County",1,25,169,76,93
050,56,023,"Wyoming","Lincoln County",1,26,176,86,90
050,56,023,"Wyoming","Lincoln County",1,27,177,88,89
050,56,023,"Wyoming","Lincoln County",1,28,180,89,91
050,56,023,"Wyoming","Lincoln County",1,29,170,87,83
050,56,023,"Wyoming","Lincoln County",1,30,178,83,95
050,56,023,"Wyoming","Lincoln County",1,31,189,86,103
050,56,023,"Wyoming","Lincoln County",1,32,198,105,93
050,56,023,"Wyoming","Lincoln County",1,33,217,111,106
050,56,023,"Wyoming","Lincoln County",1,34,218,104,114
050,56,023,"Wyoming","Lincoln County",1,35,234,115,119
050,56,023,"Wyoming","Lincoln County",1,36,251,133,118
050,56,023,"Wyoming","Lincoln County",1,37,238,127,111
050,56,023,"Wyoming","Lincoln County",1,38,237,127,110
050,56,023,"Wyoming","Lincoln County",1,39,257,126,131
050,56,023,"Wyoming","Lincoln County",1,40,277,141,136
050,56,023,"Wyoming","Lincoln County",1,41,268,133,135
050,56,023,"Wyoming","Lincoln County",1,42,293,141,152
050,56,023,"Wyoming","Lincoln County",1,43,267,151,116
050,56,023,"Wyoming","Lincoln County",1,44,250,138,112
050,56,023,"Wyoming","Lincoln County",1,45,251,130,121
050,56,023,"Wyoming","Lincoln County",1,46,215,109,106
050,56,023,"Wyoming","Lincoln County",1,47,218,111,107
050,56,023,"Wyoming","Lincoln County",1,48,252,131,121
050,56,023,"Wyoming","Lincoln County",1,49,252,137,115
050,56,023,"Wyoming","Lincoln County",1,50,225,118,107
050,56,023,"Wyoming","Lincoln County",1,51,199,98,101
050,56,023,"Wyoming","Lincoln County",1,52,200,99,101
050,56,023,"Wyoming","Lincoln County",1,53,209,109,100
050,56,023,"Wyoming","Lincoln County",1,54,209,98,111
050,56,023,"Wyoming","Lincoln County",1,55,226,120,106
050,56,023,"Wyoming","Lincoln County",1,56,252,135,117
050,56,023,"Wyoming","Lincoln County",1,57,264,142,122
050,56,023,"Wyoming","Lincoln County",1,58,281,148,133
050,56,023,"Wyoming","Lincoln County",1,59,285,147,138
050,56,023,"Wyoming","Lincoln County",1,60,286,136,150
050,56,023,"Wyoming","Lincoln County",1,61,291,141,150
050,56,023,"Wyoming","Lincoln County",1,62,320,154,166
050,56,023,"Wyoming","Lincoln County",1,63,320,162,158
050,56,023,"Wyoming","Lincoln County",1,64,331,180,151
050,56,023,"Wyoming","Lincoln County",1,65,324,178,146
050,56,023,"Wyoming","Lincoln County",1,66,291,150,141
050,56,023,"Wyoming","Lincoln County",1,67,284,147,137
050,56,023,"Wyoming","Lincoln County",1,68,269,139,130
050,56,023,"Wyoming","Lincoln County",1,69,217,107,110
050,56,023,"Wyoming","Lincoln County",1,70,216,112,104
050,56,023,"Wyoming","Lincoln County",1,71,220,114,106
050,56,023,"Wyoming","Lincoln County",1,72,236,120,116
050,56,023,"Wyoming","Lincoln County",1,73,224,115,109
050,56,023,"Wyoming","Lincoln County",1,74,132,70,62
050,56,023,"Wyoming","Lincoln County",1,75,138,73,65
050,56,023,"Wyoming","Lincoln County",1,76,137,68,69
050,56,023,"Wyoming","Lincoln County",1,77,121,69,52
050,56,023,"Wyoming","Lincoln County",1,78,97,44,53
050,56,023,"Wyoming","Lincoln County",1,79,94,45,49
050,56,023,"Wyoming","Lincoln County",1,80,93,50,43
050,56,023,"Wyoming","Lincoln County",1,81,71,32,39
050,56,023,"Wyoming","Lincoln County",1,82,56,26,30
050,56,023,"Wyoming","Lincoln County",1,83,59,28,31
050,56,023,"Wyoming","Lincoln County",1,84,64,28,36
050,56,023,"Wyoming","Lincoln County",1,85,263,116,147
050,56,023,"Wyoming","Lincoln County",2,0,229,112,117
050,56,023,"Wyoming","Lincoln County",2,1,212,107,105
050,56,023,"Wyoming","Lincoln County",2,2,224,110,114
050,56,023,"Wyoming","Lincoln County",2,3,263,128,135
050,56,023,"Wyoming","Lincoln County",2,4,282,146,136
050,56,023,"Wyoming","Lincoln County",2,5,272,132,140
050,56,023,"Wyoming","Lincoln County",2,6,283,144,139
050,56,023,"Wyoming","Lincoln County",2,7,275,150,125
050,56,023,"Wyoming","Lincoln County",2,8,283,149,134
050,56,023,"Wyoming","Lincoln County",2,9,279,160,119
050,56,023,"Wyoming","Lincoln County",2,10,297,158,139
050,56,023,"Wyoming","Lincoln County",2,11,330,168,162
050,56,023,"Wyoming","Lincoln County",2,12,340,168,172
050,56,023,"Wyoming","Lincoln County",2,13,331,171,160
050,56,023,"Wyoming","Lincoln County",2,14,329,172,157
050,56,023,"Wyoming","Lincoln County",2,15,321,160,161
050,56,023,"Wyoming","Lincoln County",2,16,323,165,158
050,56,023,"Wyoming","Lincoln County",2,17,308,160,148
050,56,023,"Wyoming","Lincoln County",2,18,243,141,102
050,56,023,"Wyoming","Lincoln County",2,19,180,102,78
050,56,023,"Wyoming","Lincoln County",2,20,178,98,80
050,56,023,"Wyoming","Lincoln County",2,21,169,95,74
050,56,023,"Wyoming","Lincoln County",2,22,176,94,82
050,56,023,"Wyoming","Lincoln County",2,23,171,88,83
050,56,023,"Wyoming","Lincoln County",2,24,163,89,74
050,56,023,"Wyoming","Lincoln County",2,25,168,81,87
050,56,023,"Wyoming","Lincoln County",2,26,176,84,92
050,56,023,"Wyoming","Lincoln County",2,27,179,89,90
050,56,023,"Wyoming","Lincoln County",2,28,180,89,91
050,56,023,"Wyoming","Lincoln County",2,29,175,90,85
050,56,023,"Wyoming","Lincoln County",2,30,179,85,94
050,56,023,"Wyoming","Lincoln County",2,31,188,87,101
050,56,023,"Wyoming","Lincoln County",2,32,199,101,98
050,56,023,"Wyoming","Lincoln County",2,33,214,109,105
050,56,023,"Wyoming","Lincoln County",2,34,217,107,110
050,56,023,"Wyoming","Lincoln County",2,35,232,114,118
050,56,023,"Wyoming","Lincoln County",2,36,245,128,117
050,56,023,"Wyoming","Lincoln County",2,37,239,127,112
050,56,023,"Wyoming","Lincoln County",2,38,238,127,111
050,56,023,"Wyoming","Lincoln County",2,39,251,125,126
050,56,023,"Wyoming","Lincoln County",2,40,274,138,136
050,56,023,"Wyoming","Lincoln County",2,41,274,137,137
050,56,023,"Wyoming","Lincoln County",2,42,289,142,147
050,56,023,"Wyoming","Lincoln County",2,43,277,151,126
050,56,023,"Wyoming","Lincoln County",2,44,255,142,113
050,56,023,"Wyoming","Lincoln County",2,45,255,135,120
050,56,023,"Wyoming","Lincoln County",2,46,225,115,110
050,56,023,"Wyoming","Lincoln County",2,47,218,112,106
050,56,023,"Wyoming","Lincoln County",2,48,243,126,117
050,56,023,"Wyoming","Lincoln County",2,49,254,137,117
050,56,023,"Wyoming","Lincoln County",2,50,233,125,108
050,56,023,"Wyoming","Lincoln County",2,51,206,103,103
050,56,023,"Wyoming","Lincoln County",2,52,199,99,100
050,56,023,"Wyoming","Lincoln County",2,53,209,107,102
050,56,023,"Wyoming","Lincoln County",2,54,207,100,107
050,56,023,"Wyoming","Lincoln County",2,55,221,113,108
050,56,023,"Wyoming","Lincoln County",2,56,247,133,114
050,56,023,"Wyoming","Lincoln County",2,57,266,142,124
050,56,023,"Wyoming","Lincoln County",2,58,277,146,131
050,56,023,"Wyoming","Lincoln County",2,59,287,147,140
050,56,023,"Wyoming","Lincoln County",2,60,286,139,147
050,56,023,"Wyoming","Lincoln County",2,61,291,141,150
050,56,023,"Wyoming","Lincoln County",2,62,314,151,163
050,56,023,"Wyoming","Lincoln County",2,63,323,161,162
050,56,023,"Wyoming","Lincoln County",2,64,330,178,152
050,56,023,"Wyoming","Lincoln County",2,65,326,179,147
050,56,023,"Wyoming","Lincoln County",2,66,302,158,144
050,56,023,"Wyoming","Lincoln County",2,67,285,148,137
050,56,023,"Wyoming","Lincoln County",2,68,271,140,131
050,56,023,"Wyoming","Lincoln County",2,69,232,115,117
050,56,023,"Wyoming","Lincoln County",2,70,215,109,106
050,56,023,"Wyoming","Lincoln County",2,71,221,114,107
050,56,023,"Wyoming","Lincoln County",2,72,230,118,112
050,56,023,"Wyoming","Lincoln County",2,73,240,122,118
050,56,023,"Wyoming","Lincoln County",2,74,142,74,68
050,56,023,"Wyoming","Lincoln County",2,75,136,73,63
050,56,023,"Wyoming","Lincoln County",2,76,136,68,68
050,56,023,"Wyoming","Lincoln County",2,77,128,71,57
050,56,023,"Wyoming","Lincoln County",2,78,99,48,51
050,56,023,"Wyoming","Lincoln County",2,79,93,43,50
050,56,023,"Wyoming","Lincoln County",2,80,90,45,45
050,56,023,"Wyoming","Lincoln County",2,81,74,37,37
050,56,023,"Wyoming","Lincoln County",2,82,57,27,30
050,56,023,"Wyoming","Lincoln County",2,83,58,26,32
050,56,023,"Wyoming","Lincoln County",2,84,62,27,35
050,56,023,"Wyoming","Lincoln County",2,85,260,115,145
050,56,023,"Wyoming","Lincoln County",3,0,225,124,101
050,56,023,"Wyoming","Lincoln County",3,1,237,120,117
050,56,023,"Wyoming","Lincoln County",3,2,212,114,98
050,56,023,"Wyoming","Lincoln County",3,3,245,123,122
050,56,023,"Wyoming","Lincoln County",3,4,264,138,126
050,56,023,"Wyoming","Lincoln County",3,5,287,150,137
050,56,023,"Wyoming","Lincoln County",3,6,272,131,141
050,56,023,"Wyoming","Lincoln County",3,7,291,157,134
050,56,023,"Wyoming","Lincoln County",3,8,281,152,129
050,56,023,"Wyoming","Lincoln County",3,9,289,150,139
050,56,023,"Wyoming","Lincoln County",3,10,289,166,123
050,56,023,"Wyoming","Lincoln County",3,11,293,148,145
050,56,023,"Wyoming","Lincoln County",3,12,328,167,161
050,56,023,"Wyoming","Lincoln County",3,13,344,168,176
050,56,023,"Wyoming","Lincoln County",3,14,332,169,163
050,56,023,"Wyoming","Lincoln County",3,15,337,181,156
050,56,023,"Wyoming","Lincoln County",3,16,318,155,163
050,56,023,"Wyoming","Lincoln County",3,17,312,161,151
050,56,023,"Wyoming","Lincoln County",3,18,269,141,128
050,56,023,"Wyoming","Lincoln County",3,19,190,113,77
050,56,023,"Wyoming","Lincoln County",3,20,196,110,86
050,56,023,"Wyoming","Lincoln County",3,21,172,96,76
050,56,023,"Wyoming","Lincoln County",3,22,165,92,73
050,56,023,"Wyoming","Lincoln County",3,23,207,111,96
050,56,023,"Wyoming","Lincoln County",3,24,183,87,96
050,56,023,"Wyoming","Lincoln County",3,25,173,101,72
050,56,023,"Wyoming","Lincoln County",3,26,175,83,92
050,56,023,"Wyoming","Lincoln County",3,27,193,90,103
050,56,023,"Wyoming","Lincoln County",3,28,200,102,98
050,56,023,"Wyoming","Lincoln County",3,29,183,95,88
050,56,023,"Wyoming","Lincoln County",3,30,180,98,82
050,56,023,"Wyoming","Lincoln County",3,31,186,89,97
050,56,023,"Wyoming","Lincoln County",3,32,202,90,112
050,56,023,"Wyoming","Lincoln County",3,33,219,110,109
050,56,023,"Wyoming","Lincoln County",3,34,224,122,102
050,56,023,"Wyoming","Lincoln County",3,35,222,112,110
050,56,023,"Wyoming","Lincoln County",3,36,238,113,125
050,56,023,"Wyoming","Lincoln County",3,37,250,127,123
050,56,023,"Wyoming","Lincoln County",3,38,236,129,107
050,56,023,"Wyoming","Lincoln County",3,39,252,126,126
050,56,023,"Wyoming","Lincoln County",3,40,262,133,129
050,56,023,"Wyoming","Lincoln County",3,41,282,143,139
050,56,023,"Wyoming","Lincoln County",3,42,285,142,143
050,56,023,"Wyoming","Lincoln County",3,43,314,154,160
050,56,023,"Wyoming","Lincoln County",3,44,285,156,129
050,56,023,"Wyoming","Lincoln County",3,45,255,145,110
050,56,023,"Wyoming","Lincoln County",3,46,253,134,119
050,56,023,"Wyoming","Lincoln County",3,47,226,115,111
050,56,023,"Wyoming","Lincoln County",3,48,223,121,102
050,56,023,"Wyoming","Lincoln County",3,49,241,128,113
050,56,023,"Wyoming","Lincoln County",3,50,267,144,123
050,56,023,"Wyoming","Lincoln County",3,51,240,125,115
050,56,023,"Wyoming","Lincoln County",3,52,213,106,107
050,56,023,"Wyoming","Lincoln County",3,53,218,109,109
050,56,023,"Wyoming","Lincoln County",3,54,231,116,115
050,56,023,"Wyoming","Lincoln County",3,55,224,107,117
050,56,023,"Wyoming","Lincoln County",3,56,240,124,116
050,56,023,"Wyoming","Lincoln County",3,57,258,133,125
050,56,023,"Wyoming","Lincoln County",3,58,277,147,130
050,56,023,"Wyoming","Lincoln County",3,59,292,155,137
050,56,023,"Wyoming","Lincoln County",3,60,300,153,147
050,56,023,"Wyoming","Lincoln County",3,61,305,152,153
050,56,023,"Wyoming","Lincoln County",3,62,288,137,151
050,56,023,"Wyoming","Lincoln County",3,63,314,153,161
050,56,023,"Wyoming","Lincoln County",3,64,325,162,163
050,56,023,"Wyoming","Lincoln County",3,65,330,178,152
050,56,023,"Wyoming","Lincoln County",3,66,324,178,146
050,56,023,"Wyoming","Lincoln County",3,67,302,160,142
050,56,023,"Wyoming","Lincoln County",3,68,283,150,133
050,56,023,"Wyoming","Lincoln County",3,69,277,142,135
050,56,023,"Wyoming","Lincoln County",3,70,229,116,113
050,56,023,"Wyoming","Lincoln County",3,71,210,108,102
050,56,023,"Wyoming","Lincoln County",3,72,226,115,111
050,56,023,"Wyoming","Lincoln County",3,73,228,118,110
050,56,023,"Wyoming","Lincoln County",3,74,233,118,115
050,56,023,"Wyoming","Lincoln County",3,75,137,71,66
050,56,023,"Wyoming","Lincoln County",3,76,127,67,60
050,56,023,"Wyoming","Lincoln County",3,77,126,59,67
050,56,023,"Wyoming","Lincoln County",3,78,121,68,53
050,56,023,"Wyoming","Lincoln County",3,79,102,51,51
050,56,023,"Wyoming","Lincoln County",3,80,92,39,53
050,56,023,"Wyoming","Lincoln County",3,81,83,43,40
050,56,023,"Wyoming","Lincoln County",3,82,68,30,38
050,56,023,"Wyoming","Lincoln County",3,83,52,26,26
050,56,023,"Wyoming","Lincoln County",3,84,56,26,30
050,56,023,"Wyoming","Lincoln County",3,85,278,121,157
050,56,023,"Wyoming","Lincoln County",4,0,223,114,109
050,56,023,"Wyoming","Lincoln County",4,1,215,114,101
050,56,023,"Wyoming","Lincoln County",4,2,246,130,116
050,56,023,"Wyoming","Lincoln County",4,3,228,119,109
050,56,023,"Wyoming","Lincoln County",4,4,242,117,125
050,56,023,"Wyoming","Lincoln County",4,5,277,139,138
050,56,023,"Wyoming","Lincoln County",4,6,304,156,148
050,56,023,"Wyoming","Lincoln County",4,7,276,134,142
050,56,023,"Wyoming","Lincoln County",4,8,301,166,135
050,56,023,"Wyoming","Lincoln County",4,9,287,153,134
050,56,023,"Wyoming","Lincoln County",4,10,306,166,140
050,56,023,"Wyoming","Lincoln County",4,11,294,164,130
050,56,023,"Wyoming","Lincoln County",4,12,315,160,155
050,56,023,"Wyoming","Lincoln County",4,13,350,182,168
050,56,023,"Wyoming","Lincoln County",4,14,350,168,182
050,56,023,"Wyoming","Lincoln County",4,15,350,181,169
050,56,023,"Wyoming","Lincoln County",4,16,341,179,162
050,56,023,"Wyoming","Lincoln County",4,17,330,166,164
050,56,023,"Wyoming","Lincoln County",4,18,265,144,121
050,56,023,"Wyoming","Lincoln County",4,19,198,106,92
050,56,023,"Wyoming","Lincoln County",4,20,192,115,77
050,56,023,"Wyoming","Lincoln County",4,21,193,106,87
050,56,023,"Wyoming","Lincoln County",4,22,184,97,87
050,56,023,"Wyoming","Lincoln County",4,23,169,98,71
050,56,023,"Wyoming","Lincoln County",4,24,214,115,99
050,56,023,"Wyoming","Lincoln County",4,25,193,98,95
050,56,023,"Wyoming","Lincoln County",4,26,189,107,82
050,56,023,"Wyoming","Lincoln County",4,27,168,79,89
050,56,023,"Wyoming","Lincoln County",4,28,212,104,108
050,56,023,"Wyoming","Lincoln County",4,29,190,95,95
050,56,023,"Wyoming","Lincoln County",4,30,192,100,92
050,56,023,"Wyoming","Lincoln County",4,31,189,99,90
050,56,023,"Wyoming","Lincoln County",4,32,199,99,100
050,56,023,"Wyoming","Lincoln County",4,33,219,96,123
050,56,023,"Wyoming","Lincoln County",4,34,231,121,110
050,56,023,"Wyoming","Lincoln County",4,35,236,126,110
050,56,023,"Wyoming","Lincoln County",4,36,236,116,120
050,56,023,"Wyoming","Lincoln County",4,37,258,127,131
050,56,023,"Wyoming","Lincoln County",4,38,261,137,124
050,56,023,"Wyoming","Lincoln County",4,39,267,143,124
050,56,023,"Wyoming","Lincoln County",4,40,262,139,123
050,56,023,"Wyoming","Lincoln County",4,41,256,128,128
050,56,023,"Wyoming","Lincoln County",4,42,289,143,146
050,56,023,"Wyoming","Lincoln County",4,43,294,150,144
050,56,023,"Wyoming","Lincoln County",4,44,312,148,164
050,56,023,"Wyoming","Lincoln County",4,45,287,156,131
050,56,023,"Wyoming","Lincoln County",4,46,274,153,121
050,56,023,"Wyoming","Lincoln County",4,47,250,133,117
050,56,023,"Wyoming","Lincoln County",4,48,239,118,121
050,56,023,"Wyoming","Lincoln County",4,49,229,126,103
050,56,023,"Wyoming","Lincoln County",4,50,253,138,115
050,56,023,"Wyoming","Lincoln County",4,51,280,149,131
050,56,023,"Wyoming","Lincoln County",4,52,247,125,122
050,56,023,"Wyoming","Lincoln County",4,53,223,114,109
050,56,023,"Wyoming","Lincoln County",4,54,227,117,110
050,56,023,"Wyoming","Lincoln County",4,55,233,115,118
050,56,023,"Wyoming","Lincoln County",4,56,217,103,114
050,56,023,"Wyoming","Lincoln County",4,57,252,126,126
050,56,023,"Wyoming","Lincoln County",4,58,268,136,132
050,56,023,"Wyoming","Lincoln County",4,59,278,150,128
050,56,023,"Wyoming","Lincoln County",4,60,299,156,143
050,56,023,"Wyoming","Lincoln County",4,61,299,153,146
050,56,023,"Wyoming","Lincoln County",4,62,300,153,147
050,56,023,"Wyoming","Lincoln County",4,63,302,148,154
050,56,023,"Wyoming","Lincoln County",4,64,314,156,158
050,56,023,"Wyoming","Lincoln County",4,65,345,176,169
050,56,023,"Wyoming","Lincoln County",4,66,332,180,152
050,56,023,"Wyoming","Lincoln County",4,67,338,181,157
050,56,023,"Wyoming","Lincoln County",4,68,298,158,140
050,56,023,"Wyoming","Lincoln County",4,69,284,144,140
050,56,023,"Wyoming","Lincoln County",4,70,271,141,130
050,56,023,"Wyoming","Lincoln County",4,71,230,115,115
050,56,023,"Wyoming","Lincoln County",4,72,211,111,100
050,56,023,"Wyoming","Lincoln County",4,73,221,114,107
050,56,023,"Wyoming","Lincoln County",4,74,207,106,101
050,56,023,"Wyoming","Lincoln County",4,75,233,124,109
050,56,023,"Wyoming","Lincoln County",4,76,131,69,62
050,56,023,"Wyoming","Lincoln County",4,77,119,59,60
050,56,023,"Wyoming","Lincoln County",4,78,114,54,60
050,56,023,"Wyoming","Lincoln County",4,79,116,68,48
050,56,023,"Wyoming","Lincoln County",4,80,94,48,46
050,56,023,"Wyoming","Lincoln County",4,81,79,34,45
050,56,023,"Wyoming","Lincoln County",4,82,71,33,38
050,56,023,"Wyoming","Lincoln County",4,83,65,30,35
050,56,023,"Wyoming","Lincoln County",4,84,50,25,25
050,56,023,"Wyoming","Lincoln County",4,85,288,130,158
050,56,023,"Wyoming","Lincoln County",5,0,208,108,100
050,56,023,"Wyoming","Lincoln County",5,1,235,118,117
050,56,023,"Wyoming","Lincoln County",5,2,216,110,106
050,56,023,"Wyoming","Lincoln County",5,3,253,130,123
050,56,023,"Wyoming","Lincoln County",5,4,231,117,114
050,56,023,"Wyoming","Lincoln County",5,5,240,119,121
050,56,023,"Wyoming","Lincoln County",5,6,279,147,132
050,56,023,"Wyoming","Lincoln County",5,7,314,160,154
050,56,023,"Wyoming","Lincoln County",5,8,270,134,136
050,56,023,"Wyoming","Lincoln County",5,9,304,163,141
050,56,023,"Wyoming","Lincoln County",5,10,298,160,138
050,56,023,"Wyoming","Lincoln County",5,11,304,168,136
050,56,023,"Wyoming","Lincoln County",5,12,297,170,127
050,56,023,"Wyoming","Lincoln County",5,13,324,165,159
050,56,023,"Wyoming","Lincoln County",5,14,345,181,164
050,56,023,"Wyoming","Lincoln County",5,15,353,173,180
050,56,023,"Wyoming","Lincoln County",5,16,350,181,169
050,56,023,"Wyoming","Lincoln County",5,17,350,190,160
050,56,023,"Wyoming","Lincoln County",5,18,271,138,133
050,56,023,"Wyoming","Lincoln County",5,19,208,114,94
050,56,023,"Wyoming","Lincoln County",5,20,213,108,105
050,56,023,"Wyoming","Lincoln County",5,21,193,113,80
050,56,023,"Wyoming","Lincoln County",5,22,192,98,94
050,56,023,"Wyoming","Lincoln County",5,23,170,90,80
050,56,023,"Wyoming","Lincoln County",5,24,184,103,81
050,56,023,"Wyoming","Lincoln County",5,25,220,121,99
050,56,023,"Wyoming","Lincoln County",5,26,207,104,103
050,56,023,"Wyoming","Lincoln County",5,27,205,111,94
050,56,023,"Wyoming","Lincoln County",5,28,173,79,94
050,56,023,"Wyoming","Lincoln County",5,29,220,111,109
050,56,023,"Wyoming","Lincoln County",5,30,193,98,95
050,56,023,"Wyoming","Lincoln County",5,31,201,106,95
050,56,023,"Wyoming","Lincoln County",5,32,195,93,102
050,56,023,"Wyoming","Lincoln County",5,33,204,102,102
050,56,023,"Wyoming","Lincoln County",5,34,223,99,124
050,56,023,"Wyoming","Lincoln County",5,35,230,122,108
050,56,023,"Wyoming","Lincoln County",5,36,248,129,119
050,56,023,"Wyoming","Lincoln County",5,37,238,112,126
050,56,023,"Wyoming","Lincoln County",5,38,253,122,131
050,56,023,"Wyoming","Lincoln County",5,39,280,154,126
050,56,023,"Wyoming","Lincoln County",5,40,254,136,118
050,56,023,"Wyoming","Lincoln County",5,41,257,137,120
050,56,023,"Wyoming","Lincoln County",5,42,259,130,129
050,56,023,"Wyoming","Lincoln County",5,43,289,141,148
050,56,023,"Wyoming","Lincoln County",5,44,296,150,146
050,56,023,"Wyoming","Lincoln County",5,45,302,146,156
050,56,023,"Wyoming","Lincoln County",5,46,285,157,128
050,56,023,"Wyoming","Lincoln County",5,47,281,157,124
050,56,023,"Wyoming","Lincoln County",5,48,266,145,121
050,56,023,"Wyoming","Lincoln County",5,49,241,118,123
050,56,023,"Wyoming","Lincoln County",5,50,237,130,107
050,56,023,"Wyoming","Lincoln County",5,51,256,138,118
050,56,023,"Wyoming","Lincoln County",5,52,282,150,132
050,56,023,"Wyoming","Lincoln County",5,53,263,133,130
050,56,023,"Wyoming","Lincoln County",5,54,225,115,110
050,56,023,"Wyoming","Lincoln County",5,55,229,116,113
050,56,023,"Wyoming","Lincoln County",5,56,236,117,119
050,56,023,"Wyoming","Lincoln County",5,57,225,103,122
050,56,023,"Wyoming","Lincoln County",5,58,259,126,133
050,56,023,"Wyoming","Lincoln County",5,59,273,140,133
050,56,023,"Wyoming","Lincoln County",5,60,279,148,131
050,56,023,"Wyoming","Lincoln County",5,61,305,157,148
050,56,023,"Wyoming","Lincoln County",5,62,306,153,153
050,56,023,"Wyoming","Lincoln County",5,63,308,156,152
050,56,023,"Wyoming","Lincoln County",5,64,318,163,155
050,56,023,"Wyoming","Lincoln County",5,65,316,153,163
050,56,023,"Wyoming","Lincoln County",5,66,346,180,166
050,56,023,"Wyoming","Lincoln County",5,67,326,175,151
050,56,023,"Wyoming","Lincoln County",5,68,325,170,155
050,56,023,"Wyoming","Lincoln County",5,69,305,155,150
050,56,023,"Wyoming","Lincoln County",5,70,271,140,131
050,56,023,"Wyoming","Lincoln County",5,71,264,136,128
050,56,023,"Wyoming","Lincoln County",5,72,225,116,109
050,56,023,"Wyoming","Lincoln County",5,73,210,109,101
050,56,023,"Wyoming","Lincoln County",5,74,209,107,102
050,56,023,"Wyoming","Lincoln County",5,75,202,103,99
050,56,023,"Wyoming","Lincoln County",5,76,222,117,105
050,56,023,"Wyoming","Lincoln County",5,77,122,64,58
050,56,023,"Wyoming","Lincoln County",5,78,109,53,56
050,56,023,"Wyoming","Lincoln County",5,79,113,56,57
050,56,023,"Wyoming","Lincoln County",5,80,112,67,45
050,56,023,"Wyoming","Lincoln County",5,81,88,48,40
050,56,023,"Wyoming","Lincoln County",5,82,73,30,43
050,56,023,"Wyoming","Lincoln County",5,83,66,31,35
050,56,023,"Wyoming","Lincoln County",5,84,64,32,32
050,56,023,"Wyoming","Lincoln County",5,85,289,138,151
050,56,025,"Wyoming","Natrona County",1,0,910,465,445
050,56,025,"Wyoming","Natrona County",1,1,943,481,462
050,56,025,"Wyoming","Natrona County",1,2,1002,511,491
050,56,025,"Wyoming","Natrona County",1,3,1037,545,492
050,56,025,"Wyoming","Natrona County",1,4,1104,576,528
050,56,025,"Wyoming","Natrona County",1,5,1056,571,485
050,56,025,"Wyoming","Natrona County",1,6,1097,555,542
050,56,025,"Wyoming","Natrona County",1,7,1083,561,522
050,56,025,"Wyoming","Natrona County",1,8,1065,546,519
050,56,025,"Wyoming","Natrona County",1,9,1097,538,559
050,56,025,"Wyoming","Natrona County",1,10,1127,572,555
050,56,025,"Wyoming","Natrona County",1,11,1122,595,527
050,56,025,"Wyoming","Natrona County",1,12,1201,635,566
050,56,025,"Wyoming","Natrona County",1,13,1197,637,560
050,56,025,"Wyoming","Natrona County",1,14,1135,582,553
050,56,025,"Wyoming","Natrona County",1,15,1108,557,551
050,56,025,"Wyoming","Natrona County",1,16,1089,569,520
050,56,025,"Wyoming","Natrona County",1,17,1057,546,511
050,56,025,"Wyoming","Natrona County",1,18,914,488,426
050,56,025,"Wyoming","Natrona County",1,19,849,441,408
050,56,025,"Wyoming","Natrona County",1,20,828,427,401
050,56,025,"Wyoming","Natrona County",1,21,810,431,379
050,56,025,"Wyoming","Natrona County",1,22,847,436,411
050,56,025,"Wyoming","Natrona County",1,23,909,465,444
050,56,025,"Wyoming","Natrona County",1,24,958,504,454
050,56,025,"Wyoming","Natrona County",1,25,961,487,474
050,56,025,"Wyoming","Natrona County",1,26,1015,509,506
050,56,025,"Wyoming","Natrona County",1,27,1069,542,527
050,56,025,"Wyoming","Natrona County",1,28,1164,566,598
050,56,025,"Wyoming","Natrona County",1,29,1187,586,601
050,56,025,"Wyoming","Natrona County",1,30,1215,632,583
050,56,025,"Wyoming","Natrona County",1,31,1170,602,568
050,56,025,"Wyoming","Natrona County",1,32,1100,574,526
050,56,025,"Wyoming","Natrona County",1,33,1134,604,530
050,56,025,"Wyoming","Natrona County",1,34,1168,617,551
050,56,025,"Wyoming","Natrona County",1,35,1181,630,551
050,56,025,"Wyoming","Natrona County",1,36,1189,617,572
050,56,025,"Wyoming","Natrona County",1,37,1204,603,601
050,56,025,"Wyoming","Natrona County",1,38,1148,572,576
050,56,025,"Wyoming","Natrona County",1,39,1167,622,545
050,56,025,"Wyoming","Natrona County",1,40,1158,587,571
050,56,025,"Wyoming","Natrona County",1,41,1088,562,526
050,56,025,"Wyoming","Natrona County",1,42,1015,520,495
050,56,025,"Wyoming","Natrona County",1,43,1011,502,509
050,56,025,"Wyoming","Natrona County",1,44,924,472,452
050,56,025,"Wyoming","Natrona County",1,45,917,473,444
050,56,025,"Wyoming","Natrona County",1,46,864,439,425
050,56,025,"Wyoming","Natrona County",1,47,870,454,416
050,56,025,"Wyoming","Natrona County",1,48,897,472,425
050,56,025,"Wyoming","Natrona County",1,49,968,501,467
050,56,025,"Wyoming","Natrona County",1,50,885,469,416
050,56,025,"Wyoming","Natrona County",1,51,885,436,449
050,56,025,"Wyoming","Natrona County",1,52,885,449,436
050,56,025,"Wyoming","Natrona County",1,53,858,438,420
050,56,025,"Wyoming","Natrona County",1,54,838,424,414
050,56,025,"Wyoming","Natrona County",1,55,904,454,450
050,56,025,"Wyoming","Natrona County",1,56,966,497,469
050,56,025,"Wyoming","Natrona County",1,57,1054,525,529
050,56,025,"Wyoming","Natrona County",1,58,1094,549,545
050,56,025,"Wyoming","Natrona County",1,59,1118,551,567
050,56,025,"Wyoming","Natrona County",1,60,1111,571,540
050,56,025,"Wyoming","Natrona County",1,61,1121,582,539
050,56,025,"Wyoming","Natrona County",1,62,1098,575,523
050,56,025,"Wyoming","Natrona County",1,63,1111,539,572
050,56,025,"Wyoming","Natrona County",1,64,1086,541,545
050,56,025,"Wyoming","Natrona County",1,65,995,500,495
050,56,025,"Wyoming","Natrona County",1,66,986,505,481
050,56,025,"Wyoming","Natrona County",1,67,953,490,463
050,56,025,"Wyoming","Natrona County",1,68,899,456,443
050,56,025,"Wyoming","Natrona County",1,69,817,412,405
050,56,025,"Wyoming","Natrona County",1,70,727,362,365
050,56,025,"Wyoming","Natrona County",1,71,692,333,359
050,56,025,"Wyoming","Natrona County",1,72,717,350,367
050,56,025,"Wyoming","Natrona County",1,73,723,375,348
050,56,025,"Wyoming","Natrona County",1,74,473,244,229
050,56,025,"Wyoming","Natrona County",1,75,462,220,242
050,56,025,"Wyoming","Natrona County",1,76,449,193,256
050,56,025,"Wyoming","Natrona County",1,77,397,172,225
050,56,025,"Wyoming","Natrona County",1,78,333,156,177
050,56,025,"Wyoming","Natrona County",1,79,298,126,172
050,56,025,"Wyoming","Natrona County",1,80,304,128,176
050,56,025,"Wyoming","Natrona County",1,81,271,124,147
050,56,025,"Wyoming","Natrona County",1,82,268,114,154
050,56,025,"Wyoming","Natrona County",1,83,255,109,146
050,56,025,"Wyoming","Natrona County",1,84,213,89,124
050,56,025,"Wyoming","Natrona County",1,85,1391,479,912
050,56,025,"Wyoming","Natrona County",2,0,922,471,451
050,56,025,"Wyoming","Natrona County",2,1,941,482,459
050,56,025,"Wyoming","Natrona County",2,2,994,510,484
050,56,025,"Wyoming","Natrona County",2,3,1026,535,491
050,56,025,"Wyoming","Natrona County",2,4,1094,572,522
050,56,025,"Wyoming","Natrona County",2,5,1075,574,501
050,56,025,"Wyoming","Natrona County",2,6,1095,565,530
050,56,025,"Wyoming","Natrona County",2,7,1092,560,532
050,56,025,"Wyoming","Natrona County",2,8,1066,545,521
050,56,025,"Wyoming","Natrona County",2,9,1094,544,550
050,56,025,"Wyoming","Natrona County",2,10,1126,569,557
050,56,025,"Wyoming","Natrona County",2,11,1132,594,538
050,56,025,"Wyoming","Natrona County",2,12,1199,635,564
050,56,025,"Wyoming","Natrona County",2,13,1201,638,563
050,56,025,"Wyoming","Natrona County",2,14,1157,599,558
050,56,025,"Wyoming","Natrona County",2,15,1118,567,551
050,56,025,"Wyoming","Natrona County",2,16,1098,567,531
050,56,025,"Wyoming","Natrona County",2,17,1069,555,514
050,56,025,"Wyoming","Natrona County",2,18,925,491,434
050,56,025,"Wyoming","Natrona County",2,19,859,444,415
050,56,025,"Wyoming","Natrona County",2,20,835,432,403
050,56,025,"Wyoming","Natrona County",2,21,817,433,384
050,56,025,"Wyoming","Natrona County",2,22,860,442,418
050,56,025,"Wyoming","Natrona County",2,23,913,468,445
050,56,025,"Wyoming","Natrona County",2,24,954,498,456
050,56,025,"Wyoming","Natrona County",2,25,972,494,478
050,56,025,"Wyoming","Natrona County",2,26,1014,509,505
050,56,025,"Wyoming","Natrona County",2,27,1065,537,528
050,56,025,"Wyoming","Natrona County",2,28,1148,568,580
050,56,025,"Wyoming","Natrona County",2,29,1186,589,597
050,56,025,"Wyoming","Natrona County",2,30,1223,627,596
050,56,025,"Wyoming","Natrona County",2,31,1181,613,568
050,56,025,"Wyoming","Natrona County",2,32,1117,581,536
050,56,025,"Wyoming","Natrona County",2,33,1129,599,530
050,56,025,"Wyoming","Natrona County",2,34,1161,614,547
050,56,025,"Wyoming","Natrona County",2,35,1184,631,553
050,56,025,"Wyoming","Natrona County",2,36,1188,621,567
050,56,025,"Wyoming","Natrona County",2,37,1207,610,597
050,56,025,"Wyoming","Natrona County",2,38,1169,584,585
050,56,025,"Wyoming","Natrona County",2,39,1159,607,552
050,56,025,"Wyoming","Natrona County",2,40,1170,604,566
050,56,025,"Wyoming","Natrona County",2,41,1113,570,543
050,56,025,"Wyoming","Natrona County",2,42,1040,532,508
050,56,025,"Wyoming","Natrona County",2,43,1022,515,507
050,56,025,"Wyoming","Natrona County",2,44,939,477,462
050,56,025,"Wyoming","Natrona County",2,45,924,472,452
050,56,025,"Wyoming","Natrona County",2,46,881,450,431
050,56,025,"Wyoming","Natrona County",2,47,864,448,416
050,56,025,"Wyoming","Natrona County",2,48,897,469,428
050,56,025,"Wyoming","Natrona County",2,49,956,499,457
050,56,025,"Wyoming","Natrona County",2,50,911,482,429
050,56,025,"Wyoming","Natrona County",2,51,884,446,438
050,56,025,"Wyoming","Natrona County",2,52,878,443,435
050,56,025,"Wyoming","Natrona County",2,53,867,440,427
050,56,025,"Wyoming","Natrona County",2,54,839,427,412
050,56,025,"Wyoming","Natrona County",2,55,884,445,439
050,56,025,"Wyoming","Natrona County",2,56,955,489,466
050,56,025,"Wyoming","Natrona County",2,57,1035,515,520
050,56,025,"Wyoming","Natrona County",2,58,1086,544,542
050,56,025,"Wyoming","Natrona County",2,59,1114,552,562
050,56,025,"Wyoming","Natrona County",2,60,1108,562,546
050,56,025,"Wyoming","Natrona County",2,61,1118,579,539
050,56,025,"Wyoming","Natrona County",2,62,1099,573,526
050,56,025,"Wyoming","Natrona County",2,63,1111,550,561
050,56,025,"Wyoming","Natrona County",2,64,1073,531,542
050,56,025,"Wyoming","Natrona County",2,65,1014,507,507
050,56,025,"Wyoming","Natrona County",2,66,984,500,484
050,56,025,"Wyoming","Natrona County",2,67,959,495,464
050,56,025,"Wyoming","Natrona County",2,68,910,463,447
050,56,025,"Wyoming","Natrona County",2,69,838,425,413
050,56,025,"Wyoming","Natrona County",2,70,742,371,371
050,56,025,"Wyoming","Natrona County",2,71,697,338,359
050,56,025,"Wyoming","Natrona County",2,72,691,334,357
050,56,025,"Wyoming","Natrona County",2,73,753,388,365
050,56,025,"Wyoming","Natrona County",2,74,501,258,243
050,56,025,"Wyoming","Natrona County",2,75,464,225,239
050,56,025,"Wyoming","Natrona County",2,76,450,199,251
050,56,025,"Wyoming","Natrona County",2,77,417,180,237
050,56,025,"Wyoming","Natrona County",2,78,340,157,183
050,56,025,"Wyoming","Natrona County",2,79,300,130,170
050,56,025,"Wyoming","Natrona County",2,80,298,126,172
050,56,025,"Wyoming","Natrona County",2,81,275,122,153
050,56,025,"Wyoming","Natrona County",2,82,272,117,155
050,56,025,"Wyoming","Natrona County",2,83,253,107,146
050,56,025,"Wyoming","Natrona County",2,84,223,91,132
050,56,025,"Wyoming","Natrona County",2,85,1385,485,900
050,56,025,"Wyoming","Natrona County",3,0,857,458,399
050,56,025,"Wyoming","Natrona County",3,1,913,452,461
050,56,025,"Wyoming","Natrona County",3,2,933,479,454
050,56,025,"Wyoming","Natrona County",3,3,986,506,480
050,56,025,"Wyoming","Natrona County",3,4,1017,529,488
050,56,025,"Wyoming","Natrona County",3,5,1048,545,503
050,56,025,"Wyoming","Natrona County",3,6,1076,580,496
050,56,025,"Wyoming","Natrona County",3,7,1068,556,512
050,56,025,"Wyoming","Natrona County",3,8,1077,548,529
050,56,025,"Wyoming","Natrona County",3,9,1081,570,511
050,56,025,"Wyoming","Natrona County",3,10,1073,525,548
050,56,025,"Wyoming","Natrona County",3,11,1133,582,551
050,56,025,"Wyoming","Natrona County",3,12,1136,587,549
050,56,025,"Wyoming","Natrona County",3,13,1187,626,561
050,56,025,"Wyoming","Natrona County",3,14,1187,625,562
050,56,025,"Wyoming","Natrona County",3,15,1151,600,551
050,56,025,"Wyoming","Natrona County",3,16,1119,573,546
050,56,025,"Wyoming","Natrona County",3,17,1102,559,543
050,56,025,"Wyoming","Natrona County",3,18,968,512,456
050,56,025,"Wyoming","Natrona County",3,19,874,449,425
050,56,025,"Wyoming","Natrona County",3,20,849,424,425
050,56,025,"Wyoming","Natrona County",3,21,804,423,381
050,56,025,"Wyoming","Natrona County",3,22,858,455,403
050,56,025,"Wyoming","Natrona County",3,23,881,439,442
050,56,025,"Wyoming","Natrona County",3,24,924,475,449
050,56,025,"Wyoming","Natrona County",3,25,936,489,447
050,56,025,"Wyoming","Natrona County",3,26,1002,511,491
050,56,025,"Wyoming","Natrona County",3,27,992,489,503
050,56,025,"Wyoming","Natrona County",3,28,1040,521,519
050,56,025,"Wyoming","Natrona County",3,29,1115,555,560
050,56,025,"Wyoming","Natrona County",3,30,1160,562,598
050,56,025,"Wyoming","Natrona County",3,31,1220,624,596
050,56,025,"Wyoming","Natrona County",3,32,1159,593,566
050,56,025,"Wyoming","Natrona County",3,33,1113,588,525
050,56,025,"Wyoming","Natrona County",3,34,1100,577,523
050,56,025,"Wyoming","Natrona County",3,35,1163,629,534
050,56,025,"Wyoming","Natrona County",3,36,1180,632,548
050,56,025,"Wyoming","Natrona County",3,37,1187,607,580
050,56,025,"Wyoming","Natrona County",3,38,1198,619,579
050,56,025,"Wyoming","Natrona County",3,39,1153,572,581
050,56,025,"Wyoming","Natrona County",3,40,1142,588,554
050,56,025,"Wyoming","Natrona County",3,41,1176,598,578
050,56,025,"Wyoming","Natrona County",3,42,1082,550,532
050,56,025,"Wyoming","Natrona County",3,43,1005,509,496
050,56,025,"Wyoming","Natrona County",3,44,995,499,496
050,56,025,"Wyoming","Natrona County",3,45,911,464,447
050,56,025,"Wyoming","Natrona County",3,46,923,471,452
050,56,025,"Wyoming","Natrona County",3,47,871,442,429
050,56,025,"Wyoming","Natrona County",3,48,840,434,406
050,56,025,"Wyoming","Natrona County",3,49,876,457,419
050,56,025,"Wyoming","Natrona County",3,50,938,496,442
050,56,025,"Wyoming","Natrona County",3,51,902,474,428
050,56,025,"Wyoming","Natrona County",3,52,885,453,432
050,56,025,"Wyoming","Natrona County",3,53,856,428,428
050,56,025,"Wyoming","Natrona County",3,54,862,442,420
050,56,025,"Wyoming","Natrona County",3,55,813,405,408
050,56,025,"Wyoming","Natrona County",3,56,893,448,445
050,56,025,"Wyoming","Natrona County",3,57,943,475,468
050,56,025,"Wyoming","Natrona County",3,58,1020,494,526
050,56,025,"Wyoming","Natrona County",3,59,1075,535,540
050,56,025,"Wyoming","Natrona County",3,60,1101,545,556
050,56,025,"Wyoming","Natrona County",3,61,1111,569,542
050,56,025,"Wyoming","Natrona County",3,62,1077,561,516
050,56,025,"Wyoming","Natrona County",3,63,1089,562,527
050,56,025,"Wyoming","Natrona County",3,64,1080,527,553
050,56,025,"Wyoming","Natrona County",3,65,1050,514,536
050,56,025,"Wyoming","Natrona County",3,66,987,498,489
050,56,025,"Wyoming","Natrona County",3,67,959,491,468
050,56,025,"Wyoming","Natrona County",3,68,939,479,460
050,56,025,"Wyoming","Natrona County",3,69,897,449,448
050,56,025,"Wyoming","Natrona County",3,70,809,405,404
050,56,025,"Wyoming","Natrona County",3,71,725,368,357
050,56,025,"Wyoming","Natrona County",3,72,675,330,345
050,56,025,"Wyoming","Natrona County",3,73,678,326,352
050,56,025,"Wyoming","Natrona County",3,74,720,365,355
050,56,025,"Wyoming","Natrona County",3,75,471,239,232
050,56,025,"Wyoming","Natrona County",3,76,455,218,237
050,56,025,"Wyoming","Natrona County",3,77,430,183,247
050,56,025,"Wyoming","Natrona County",3,78,390,173,217
050,56,025,"Wyoming","Natrona County",3,79,316,147,169
050,56,025,"Wyoming","Natrona County",3,80,275,122,153
050,56,025,"Wyoming","Natrona County",3,81,276,116,160
050,56,025,"Wyoming","Natrona County",3,82,263,107,156
050,56,025,"Wyoming","Natrona County",3,83,244,106,138
050,56,025,"Wyoming","Natrona County",3,84,242,92,150
050,56,025,"Wyoming","Natrona County",3,85,1348,472,876
050,56,025,"Wyoming","Natrona County",4,0,837,437,400
050,56,025,"Wyoming","Natrona County",4,1,855,442,413
050,56,025,"Wyoming","Natrona County",4,2,918,461,457
050,56,025,"Wyoming","Natrona County",4,3,916,480,436
050,56,025,"Wyoming","Natrona County",4,4,966,490,476
050,56,025,"Wyoming","Natrona County",4,5,1000,524,476
050,56,025,"Wyoming","Natrona County",4,6,1040,539,501
050,56,025,"Wyoming","Natrona County",4,7,1067,576,491
050,56,025,"Wyoming","Natrona County",4,8,1088,576,512
050,56,025,"Wyoming","Natrona County",4,9,1056,539,517
050,56,025,"Wyoming","Natrona County",4,10,1055,560,495
050,56,025,"Wyoming","Natrona County",4,11,1058,507,551
050,56,025,"Wyoming","Natrona County",4,12,1124,571,553
050,56,025,"Wyoming","Natrona County",4,13,1143,583,560
050,56,025,"Wyoming","Natrona County",4,14,1192,629,563
050,56,025,"Wyoming","Natrona County",4,15,1205,637,568
050,56,025,"Wyoming","Natrona County",4,16,1136,591,545
050,56,025,"Wyoming","Natrona County",4,17,1130,581,549
050,56,025,"Wyoming","Natrona County",4,18,991,510,481
050,56,025,"Wyoming","Natrona County",4,19,888,447,441
050,56,025,"Wyoming","Natrona County",4,20,844,440,404
050,56,025,"Wyoming","Natrona County",4,21,844,429,415
050,56,025,"Wyoming","Natrona County",4,22,835,428,407
050,56,025,"Wyoming","Natrona County",4,23,900,474,426
050,56,025,"Wyoming","Natrona County",4,24,911,464,447
050,56,025,"Wyoming","Natrona County",4,25,953,484,469
050,56,025,"Wyoming","Natrona County",4,26,941,484,457
050,56,025,"Wyoming","Natrona County",4,27,1030,515,515
050,56,025,"Wyoming","Natrona County",4,28,984,489,495
050,56,025,"Wyoming","Natrona County",4,29,1020,508,512
050,56,025,"Wyoming","Natrona County",4,30,1126,561,565
050,56,025,"Wyoming","Natrona County",4,31,1172,574,598
050,56,025,"Wyoming","Natrona County",4,32,1218,623,595
050,56,025,"Wyoming","Natrona County",4,33,1165,594,571
050,56,025,"Wyoming","Natrona County",4,34,1088,575,513
050,56,025,"Wyoming","Natrona County",4,35,1117,583,534
050,56,025,"Wyoming","Natrona County",4,36,1148,624,524
050,56,025,"Wyoming","Natrona County",4,37,1168,617,551
050,56,025,"Wyoming","Natrona County",4,38,1185,605,580
050,56,025,"Wyoming","Natrona County",4,39,1191,606,585
050,56,025,"Wyoming","Natrona County",4,40,1140,546,594
050,56,025,"Wyoming","Natrona County",4,41,1124,572,552
050,56,025,"Wyoming","Natrona County",4,42,1155,581,574
050,56,025,"Wyoming","Natrona County",4,43,1085,560,525
050,56,025,"Wyoming","Natrona County",4,44,1016,511,505
050,56,025,"Wyoming","Natrona County",4,45,982,502,480
050,56,025,"Wyoming","Natrona County",4,46,912,458,454
050,56,025,"Wyoming","Natrona County",4,47,923,474,449
050,56,025,"Wyoming","Natrona County",4,48,844,424,420
050,56,025,"Wyoming","Natrona County",4,49,835,431,404
050,56,025,"Wyoming","Natrona County",4,50,889,459,430
050,56,025,"Wyoming","Natrona County",4,51,931,481,450
050,56,025,"Wyoming","Natrona County",4,52,921,473,448
050,56,025,"Wyoming","Natrona County",4,53,888,456,432
050,56,025,"Wyoming","Natrona County",4,54,854,442,412
050,56,025,"Wyoming","Natrona County",4,55,836,431,405
050,56,025,"Wyoming","Natrona County",4,56,805,396,409
050,56,025,"Wyoming","Natrona County",4,57,872,436,436
050,56,025,"Wyoming","Natrona County",4,58,943,472,471
050,56,025,"Wyoming","Natrona County",4,59,1022,498,524
050,56,025,"Wyoming","Natrona County",4,60,1048,518,530
050,56,025,"Wyoming","Natrona County",4,61,1109,556,553
050,56,025,"Wyoming","Natrona County",4,62,1075,550,525
050,56,025,"Wyoming","Natrona County",4,63,1057,555,502
050,56,025,"Wyoming","Natrona County",4,64,1072,550,522
050,56,025,"Wyoming","Natrona County",4,65,1061,518,543
050,56,025,"Wyoming","Natrona County",4,66,1035,503,532
050,56,025,"Wyoming","Natrona County",4,67,982,497,485
050,56,025,"Wyoming","Natrona County",4,68,967,498,469
050,56,025,"Wyoming","Natrona County",4,69,926,475,451
050,56,025,"Wyoming","Natrona County",4,70,876,432,444
050,56,025,"Wyoming","Natrona County",4,71,798,392,406
050,56,025,"Wyoming","Natrona County",4,72,715,362,353
050,56,025,"Wyoming","Natrona County",4,73,659,320,339
050,56,025,"Wyoming","Natrona County",4,74,654,318,336
050,56,025,"Wyoming","Natrona County",4,75,697,347,350
050,56,025,"Wyoming","Natrona County",4,76,460,233,227
050,56,025,"Wyoming","Natrona County",4,77,439,208,231
050,56,025,"Wyoming","Natrona County",4,78,409,177,232
050,56,025,"Wyoming","Natrona County",4,79,366,165,201
050,56,025,"Wyoming","Natrona County",4,80,306,147,159
050,56,025,"Wyoming","Natrona County",4,81,265,122,143
050,56,025,"Wyoming","Natrona County",4,82,269,107,162
050,56,025,"Wyoming","Natrona County",4,83,232,98,134
050,56,025,"Wyoming","Natrona County",4,84,230,96,134
050,56,025,"Wyoming","Natrona County",4,85,1334,473,861
050,56,025,"Wyoming","Natrona County",5,0,824,428,396
050,56,025,"Wyoming","Natrona County",5,1,858,474,384
050,56,025,"Wyoming","Natrona County",5,2,869,447,422
050,56,025,"Wyoming","Natrona County",5,3,936,469,467
050,56,025,"Wyoming","Natrona County",5,4,924,479,445
050,56,025,"Wyoming","Natrona County",5,5,982,497,485
050,56,025,"Wyoming","Natrona County",5,6,1012,531,481
050,56,025,"Wyoming","Natrona County",5,7,1047,544,503
050,56,025,"Wyoming","Natrona County",5,8,1071,581,490
050,56,025,"Wyoming","Natrona County",5,9,1092,566,526
050,56,025,"Wyoming","Natrona County",5,10,1044,530,514
050,56,025,"Wyoming","Natrona County",5,11,1062,569,493
050,56,025,"Wyoming","Natrona County",5,12,1051,501,550
050,56,025,"Wyoming","Natrona County",5,13,1137,584,553
050,56,025,"Wyoming","Natrona County",5,14,1136,579,557
050,56,025,"Wyoming","Natrona County",5,15,1176,611,565
050,56,025,"Wyoming","Natrona County",5,16,1200,632,568
050,56,025,"Wyoming","Natrona County",5,17,1141,594,547
050,56,025,"Wyoming","Natrona County",5,18,992,514,478
050,56,025,"Wyoming","Natrona County",5,19,894,442,452
050,56,025,"Wyoming","Natrona County",5,20,902,463,439
050,56,025,"Wyoming","Natrona County",5,21,830,438,392
050,56,025,"Wyoming","Natrona County",5,22,891,439,452
050,56,025,"Wyoming","Natrona County",5,23,879,444,435
050,56,025,"Wyoming","Natrona County",5,24,920,469,451
050,56,025,"Wyoming","Natrona County",5,25,926,475,451
050,56,025,"Wyoming","Natrona County",5,26,959,476,483
050,56,025,"Wyoming","Natrona County",5,27,974,490,484
050,56,025,"Wyoming","Natrona County",5,28,1055,529,526
050,56,025,"Wyoming","Natrona County",5,29,1016,514,502
050,56,025,"Wyoming","Natrona County",5,30,1067,546,521
050,56,025,"Wyoming","Natrona County",5,31,1104,552,552
050,56,025,"Wyoming","Natrona County",5,32,1149,567,582
050,56,025,"Wyoming","Natrona County",5,33,1226,626,600
050,56,025,"Wyoming","Natrona County",5,34,1174,597,577
050,56,025,"Wyoming","Natrona County",5,35,1112,576,536
050,56,025,"Wyoming","Natrona County",5,36,1130,581,549
050,56,025,"Wyoming","Natrona County",5,37,1174,626,548
050,56,025,"Wyoming","Natrona County",5,38,1155,612,543
050,56,025,"Wyoming","Natrona County",5,39,1184,610,574
050,56,025,"Wyoming","Natrona County",5,40,1213,620,593
050,56,025,"Wyoming","Natrona County",5,41,1168,572,596
050,56,025,"Wyoming","Natrona County",5,42,1134,573,561
050,56,025,"Wyoming","Natrona County",5,43,1172,589,583
050,56,025,"Wyoming","Natrona County",5,44,1095,565,530
050,56,025,"Wyoming","Natrona County",5,45,1013,505,508
050,56,025,"Wyoming","Natrona County",5,46,990,507,483
050,56,025,"Wyoming","Natrona County",5,47,915,461,454
050,56,025,"Wyoming","Natrona County",5,48,910,464,446
050,56,025,"Wyoming","Natrona County",5,49,840,420,420
050,56,025,"Wyoming","Natrona County",5,50,813,424,389
050,56,025,"Wyoming","Natrona County",5,51,877,452,425
050,56,025,"Wyoming","Natrona County",5,52,939,483,456
050,56,025,"Wyoming","Natrona County",5,53,931,479,452
050,56,025,"Wyoming","Natrona County",5,54,898,468,430
050,56,025,"Wyoming","Natrona County",5,55,845,427,418
050,56,025,"Wyoming","Natrona County",5,56,834,427,407
050,56,025,"Wyoming","Natrona County",5,57,795,387,408
050,56,025,"Wyoming","Natrona County",5,58,868,427,441
050,56,025,"Wyoming","Natrona County",5,59,944,473,471
050,56,025,"Wyoming","Natrona County",5,60,1026,491,535
050,56,025,"Wyoming","Natrona County",5,61,1046,516,530
050,56,025,"Wyoming","Natrona County",5,62,1073,533,540
050,56,025,"Wyoming","Natrona County",5,63,1073,549,524
050,56,025,"Wyoming","Natrona County",5,64,1045,554,491
050,56,025,"Wyoming","Natrona County",5,65,1041,533,508
050,56,025,"Wyoming","Natrona County",5,66,1062,511,551
050,56,025,"Wyoming","Natrona County",5,67,1018,499,519
050,56,025,"Wyoming","Natrona County",5,68,976,495,481
050,56,025,"Wyoming","Natrona County",5,69,954,483,471
050,56,025,"Wyoming","Natrona County",5,70,895,462,433
050,56,025,"Wyoming","Natrona County",5,71,856,415,441
050,56,025,"Wyoming","Natrona County",5,72,792,386,406
050,56,025,"Wyoming","Natrona County",5,73,703,350,353
050,56,025,"Wyoming","Natrona County",5,74,641,316,325
050,56,025,"Wyoming","Natrona County",5,75,633,308,325
050,56,025,"Wyoming","Natrona County",5,76,685,337,348
050,56,025,"Wyoming","Natrona County",5,77,442,217,225
050,56,025,"Wyoming","Natrona County",5,78,426,206,220
050,56,025,"Wyoming","Natrona County",5,79,388,170,218
050,56,025,"Wyoming","Natrona County",5,80,352,160,192
050,56,025,"Wyoming","Natrona County",5,81,286,139,147
050,56,025,"Wyoming","Natrona County",5,82,261,118,143
050,56,025,"Wyoming","Natrona County",5,83,248,103,145
050,56,025,"Wyoming","Natrona County",5,84,218,88,130
050,56,025,"Wyoming","Natrona County",5,85,1332,479,853
050,56,027,"Wyoming","Niobrara County",1,0,28,13,15
050,56,027,"Wyoming","Niobrara County",1,1,30,16,14
050,56,027,"Wyoming","Niobrara County",1,2,26,8,18
050,56,027,"Wyoming","Niobrara County",1,3,27,10,17
050,56,027,"Wyoming","Niobrara County",1,4,29,16,13
050,56,027,"Wyoming","Niobrara County",1,5,28,13,15
050,56,027,"Wyoming","Niobrara County",1,6,25,12,13
050,56,027,"Wyoming","Niobrara County",1,7,27,13,14
050,56,027,"Wyoming","Niobrara County",1,8,23,12,11
050,56,027,"Wyoming","Niobrara County",1,9,24,11,13
050,56,027,"Wyoming","Niobrara County",1,10,18,14,4
050,56,027,"Wyoming","Niobrara County",1,11,19,12,7
050,56,027,"Wyoming","Niobrara County",1,12,25,18,7
050,56,027,"Wyoming","Niobrara County",1,13,25,16,9
050,56,027,"Wyoming","Niobrara County",1,14,17,11,6
050,56,027,"Wyoming","Niobrara County",1,15,17,9,8
050,56,027,"Wyoming","Niobrara County",1,16,22,14,8
050,56,027,"Wyoming","Niobrara County",1,17,29,17,12
050,56,027,"Wyoming","Niobrara County",1,18,20,12,8
050,56,027,"Wyoming","Niobrara County",1,19,23,10,13
050,56,027,"Wyoming","Niobrara County",1,20,18,7,11
050,56,027,"Wyoming","Niobrara County",1,21,28,13,15
050,56,027,"Wyoming","Niobrara County",1,22,32,9,23
050,56,027,"Wyoming","Niobrara County",1,23,40,5,35
050,56,027,"Wyoming","Niobrara County",1,24,26,13,13
050,56,027,"Wyoming","Niobrara County",1,25,25,9,16
050,56,027,"Wyoming","Niobrara County",1,26,28,6,22
050,56,027,"Wyoming","Niobrara County",1,27,31,11,20
050,56,027,"Wyoming","Niobrara County",1,28,35,10,25
050,56,027,"Wyoming","Niobrara County",1,29,31,15,16
050,56,027,"Wyoming","Niobrara County",1,30,38,14,24
050,56,027,"Wyoming","Niobrara County",1,31,29,8,21
050,56,027,"Wyoming","Niobrara County",1,32,36,10,26
050,56,027,"Wyoming","Niobrara County",1,33,32,13,19
050,56,027,"Wyoming","Niobrara County",1,34,39,12,27
050,56,027,"Wyoming","Niobrara County",1,35,29,8,21
050,56,027,"Wyoming","Niobrara County",1,36,31,11,20
050,56,027,"Wyoming","Niobrara County",1,37,25,10,15
050,56,027,"Wyoming","Niobrara County",1,38,38,17,21
050,56,027,"Wyoming","Niobrara County",1,39,38,16,22
050,56,027,"Wyoming","Niobrara County",1,40,44,21,23
050,56,027,"Wyoming","Niobrara County",1,41,30,14,16
050,56,027,"Wyoming","Niobrara County",1,42,24,12,12
050,56,027,"Wyoming","Niobrara County",1,43,20,9,11
050,56,027,"Wyoming","Niobrara County",1,44,26,6,20
050,56,027,"Wyoming","Niobrara County",1,45,36,13,23
050,56,027,"Wyoming","Niobrara County",1,46,22,9,13
050,56,027,"Wyoming","Niobrara County",1,47,36,13,23
050,56,027,"Wyoming","Niobrara County",1,48,41,16,25
050,56,027,"Wyoming","Niobrara County",1,49,26,11,15
050,56,027,"Wyoming","Niobrara County",1,50,23,12,11
050,56,027,"Wyoming","Niobrara County",1,51,27,12,15
050,56,027,"Wyoming","Niobrara County",1,52,23,9,14
050,56,027,"Wyoming","Niobrara County",1,53,24,11,13
050,56,027,"Wyoming","Niobrara County",1,54,23,12,11
050,56,027,"Wyoming","Niobrara County",1,55,25,9,16
050,56,027,"Wyoming","Niobrara County",1,56,26,9,17
050,56,027,"Wyoming","Niobrara County",1,57,24,11,13
050,56,027,"Wyoming","Niobrara County",1,58,38,17,21
050,56,027,"Wyoming","Niobrara County",1,59,38,20,18
050,56,027,"Wyoming","Niobrara County",1,60,29,16,13
050,56,027,"Wyoming","Niobrara County",1,61,26,12,14
050,56,027,"Wyoming","Niobrara County",1,62,47,21,26
050,56,027,"Wyoming","Niobrara County",1,63,46,25,21
050,56,027,"Wyoming","Niobrara County",1,64,49,23,26
050,56,027,"Wyoming","Niobrara County",1,65,41,22,19
050,56,027,"Wyoming","Niobrara County",1,66,37,15,22
050,56,027,"Wyoming","Niobrara County",1,67,39,17,22
050,56,027,"Wyoming","Niobrara County",1,68,33,20,13
050,56,027,"Wyoming","Niobrara County",1,69,33,17,16
050,56,027,"Wyoming","Niobrara County",1,70,36,20,16
050,56,027,"Wyoming","Niobrara County",1,71,27,13,14
050,56,027,"Wyoming","Niobrara County",1,72,22,13,9
050,56,027,"Wyoming","Niobrara County",1,73,22,13,9
050,56,027,"Wyoming","Niobrara County",1,74,20,12,8
050,56,027,"Wyoming","Niobrara County",1,75,21,13,8
050,56,027,"Wyoming","Niobrara County",1,76,24,12,12
050,56,027,"Wyoming","Niobrara County",1,77,24,8,16
050,56,027,"Wyoming","Niobrara County",1,78,21,9,12
050,56,027,"Wyoming","Niobrara County",1,79,17,7,10
050,56,027,"Wyoming","Niobrara County",1,80,17,9,8
050,56,027,"Wyoming","Niobrara County",1,81,15,9,6
050,56,027,"Wyoming","Niobrara County",1,82,19,12,7
050,56,027,"Wyoming","Niobrara County",1,83,26,13,13
050,56,027,"Wyoming","Niobrara County",1,84,21,8,13
050,56,027,"Wyoming","Niobrara County",1,85,72,38,34
050,56,027,"Wyoming","Niobrara County",2,0,31,16,15
050,56,027,"Wyoming","Niobrara County",2,1,28,14,14
050,56,027,"Wyoming","Niobrara County",2,2,27,10,17
050,56,027,"Wyoming","Niobrara County",2,3,27,9,18
050,56,027,"Wyoming","Niobrara County",2,4,29,14,15
050,56,027,"Wyoming","Niobrara County",2,5,28,14,14
050,56,027,"Wyoming","Niobrara County",2,6,25,12,13
050,56,027,"Wyoming","Niobrara County",2,7,25,12,13
050,56,027,"Wyoming","Niobrara County",2,8,23,12,11
050,56,027,"Wyoming","Niobrara County",2,9,23,11,12
050,56,027,"Wyoming","Niobrara County",2,10,19,13,6
050,56,027,"Wyoming","Niobrara County",2,11,20,13,7
050,56,027,"Wyoming","Niobrara County",2,12,24,17,7
050,56,027,"Wyoming","Niobrara County",2,13,24,16,8
050,56,027,"Wyoming","Niobrara County",2,14,19,13,6
050,56,027,"Wyoming","Niobrara County",2,15,17,9,8
050,56,027,"Wyoming","Niobrara County",2,16,22,14,8
050,56,027,"Wyoming","Niobrara County",2,17,26,15,11
050,56,027,"Wyoming","Niobrara County",2,18,21,12,9
050,56,027,"Wyoming","Niobrara County",2,19,21,9,12
050,56,027,"Wyoming","Niobrara County",2,20,19,8,11
050,56,027,"Wyoming","Niobrara County",2,21,27,11,16
050,56,027,"Wyoming","Niobrara County",2,22,32,10,22
050,56,027,"Wyoming","Niobrara County",2,23,40,7,33
050,56,027,"Wyoming","Niobrara County",2,24,28,12,16
050,56,027,"Wyoming","Niobrara County",2,25,23,8,15
050,56,027,"Wyoming","Niobrara County",2,26,29,7,22
050,56,027,"Wyoming","Niobrara County",2,27,29,11,18
050,56,027,"Wyoming","Niobrara County",2,28,34,10,24
050,56,027,"Wyoming","Niobrara County",2,29,31,14,17
050,56,027,"Wyoming","Niobrara County",2,30,37,13,24
050,56,027,"Wyoming","Niobrara County",2,31,30,9,21
050,56,027,"Wyoming","Niobrara County",2,32,35,10,25
050,56,027,"Wyoming","Niobrara County",2,33,33,13,20
050,56,027,"Wyoming","Niobrara County",2,34,38,11,27
050,56,027,"Wyoming","Niobrara County",2,35,29,9,20
050,56,027,"Wyoming","Niobrara County",2,36,31,10,21
050,56,027,"Wyoming","Niobrara County",2,37,26,10,16
050,56,027,"Wyoming","Niobrara County",2,38,35,15,20
050,56,027,"Wyoming","Niobrara County",2,39,38,17,21
050,56,027,"Wyoming","Niobrara County",2,40,43,21,22
050,56,027,"Wyoming","Niobrara County",2,41,33,16,17
050,56,027,"Wyoming","Niobrara County",2,42,22,11,11
050,56,027,"Wyoming","Niobrara County",2,43,21,9,12
050,56,027,"Wyoming","Niobrara County",2,44,26,7,19
050,56,027,"Wyoming","Niobrara County",2,45,33,11,22
050,56,027,"Wyoming","Niobrara County",2,46,24,10,14
050,56,027,"Wyoming","Niobrara County",2,47,34,12,22
050,56,027,"Wyoming","Niobrara County",2,48,40,15,25
050,56,027,"Wyoming","Niobrara County",2,49,28,13,15
050,56,027,"Wyoming","Niobrara County",2,50,23,12,11
050,56,027,"Wyoming","Niobrara County",2,51,27,12,15
050,56,027,"Wyoming","Niobrara County",2,52,23,9,14
050,56,027,"Wyoming","Niobrara County",2,53,23,10,13
050,56,027,"Wyoming","Niobrara County",2,54,23,12,11
050,56,027,"Wyoming","Niobrara County",2,55,24,9,15
050,56,027,"Wyoming","Niobrara County",2,56,25,9,16
050,56,027,"Wyoming","Niobrara County",2,57,23,10,13
050,56,027,"Wyoming","Niobrara County",2,58,36,16,20
050,56,027,"Wyoming","Niobrara County",2,59,36,19,17
050,56,027,"Wyoming","Niobrara County",2,60,31,17,14
050,56,027,"Wyoming","Niobrara County",2,61,27,13,14
050,56,027,"Wyoming","Niobrara County",2,62,42,19,23
050,56,027,"Wyoming","Niobrara County",2,63,47,24,23
050,56,027,"Wyoming","Niobrara County",2,64,48,23,25
050,56,027,"Wyoming","Niobrara County",2,65,42,22,20
050,56,027,"Wyoming","Niobrara County",2,66,38,17,21
050,56,027,"Wyoming","Niobrara County",2,67,38,16,22
050,56,027,"Wyoming","Niobrara County",2,68,34,19,15
050,56,027,"Wyoming","Niobrara County",2,69,33,18,15
050,56,027,"Wyoming","Niobrara County",2,70,34,19,15
050,56,027,"Wyoming","Niobrara County",2,71,29,15,14
050,56,027,"Wyoming","Niobrara County",2,72,23,13,10
050,56,027,"Wyoming","Niobrara County",2,73,24,14,10
050,56,027,"Wyoming","Niobrara County",2,74,19,12,7
050,56,027,"Wyoming","Niobrara County",2,75,20,12,8
050,56,027,"Wyoming","Niobrara County",2,76,23,12,11
050,56,027,"Wyoming","Niobrara County",2,77,25,10,15
050,56,027,"Wyoming","Niobrara County",2,78,20,9,11
050,56,027,"Wyoming","Niobrara County",2,79,17,7,10
050,56,027,"Wyoming","Niobrara County",2,80,18,9,9
050,56,027,"Wyoming","Niobrara County",2,81,15,9,6
050,56,027,"Wyoming","Niobrara County",2,82,17,10,7
050,56,027,"Wyoming","Niobrara County",2,83,23,12,11
050,56,027,"Wyoming","Niobrara County",2,84,21,9,12
050,56,027,"Wyoming","Niobrara County",2,85,76,39,37
050,56,027,"Wyoming","Niobrara County",3,0,25,14,11
050,56,027,"Wyoming","Niobrara County",3,1,35,18,17
050,56,027,"Wyoming","Niobrara County",3,2,19,10,9
050,56,027,"Wyoming","Niobrara County",3,3,25,10,15
050,56,027,"Wyoming","Niobrara County",3,4,24,7,17
050,56,027,"Wyoming","Niobrara County",3,5,25,12,13
050,56,027,"Wyoming","Niobrara County",3,6,27,14,13
050,56,027,"Wyoming","Niobrara County",3,7,22,9,13
050,56,027,"Wyoming","Niobrara County",3,8,27,13,14
050,56,027,"Wyoming","Niobrara County",3,9,20,11,9
050,56,027,"Wyoming","Niobrara County",3,10,23,11,12
050,56,027,"Wyoming","Niobrara County",3,11,21,14,7
050,56,027,"Wyoming","Niobrara County",3,12,19,11,8
050,56,027,"Wyoming","Niobrara County",3,13,17,14,3
050,56,027,"Wyoming","Niobrara County",3,14,22,14,8
050,56,027,"Wyoming","Niobrara County",3,15,24,15,9
050,56,027,"Wyoming","Niobrara County",3,16,15,7,8
050,56,027,"Wyoming","Niobrara County",3,17,21,15,6
050,56,027,"Wyoming","Niobrara County",3,18,19,10,9
050,56,027,"Wyoming","Niobrara County",3,19,20,10,10
050,56,027,"Wyoming","Niobrara County",3,20,22,11,11
050,56,027,"Wyoming","Niobrara County",3,21,20,4,16
050,56,027,"Wyoming","Niobrara County",3,22,26,9,17
050,56,027,"Wyoming","Niobrara County",3,23,43,13,30
050,56,027,"Wyoming","Niobrara County",3,24,33,11,22
050,56,027,"Wyoming","Niobrara County",3,25,31,10,21
050,56,027,"Wyoming","Niobrara County",3,26,25,7,18
050,56,027,"Wyoming","Niobrara County",3,27,26,6,20
050,56,027,"Wyoming","Niobrara County",3,28,37,13,24
050,56,027,"Wyoming","Niobrara County",3,29,33,12,21
050,56,027,"Wyoming","Niobrara County",3,30,35,10,25
050,56,027,"Wyoming","Niobrara County",3,31,34,11,23
050,56,027,"Wyoming","Niobrara County",3,32,27,6,21
050,56,027,"Wyoming","Niobrara County",3,33,30,9,21
050,56,027,"Wyoming","Niobrara County",3,34,39,14,25
050,56,027,"Wyoming","Niobrara County",3,35,27,9,18
050,56,027,"Wyoming","Niobrara County",3,36,32,10,22
050,56,027,"Wyoming","Niobrara County",3,37,28,10,18
050,56,027,"Wyoming","Niobrara County",3,38,28,10,18
050,56,027,"Wyoming","Niobrara County",3,39,29,12,17
050,56,027,"Wyoming","Niobrara County",3,40,40,19,21
050,56,027,"Wyoming","Niobrara County",3,41,41,22,19
050,56,027,"Wyoming","Niobrara County",3,42,25,14,11
050,56,027,"Wyoming","Niobrara County",3,43,20,8,12
050,56,027,"Wyoming","Niobrara County",3,44,26,9,17
050,56,027,"Wyoming","Niobrara County",3,45,22,6,16
050,56,027,"Wyoming","Niobrara County",3,46,30,11,19
050,56,027,"Wyoming","Niobrara County",3,47,31,10,21
050,56,027,"Wyoming","Niobrara County",3,48,35,11,24
050,56,027,"Wyoming","Niobrara County",3,49,34,14,20
050,56,027,"Wyoming","Niobrara County",3,50,29,13,16
050,56,027,"Wyoming","Niobrara County",3,51,24,10,14
050,56,027,"Wyoming","Niobrara County",3,52,27,11,16
050,56,027,"Wyoming","Niobrara County",3,53,22,9,13
050,56,027,"Wyoming","Niobrara County",3,54,22,13,9
050,56,027,"Wyoming","Niobrara County",3,55,24,12,12
050,56,027,"Wyoming","Niobrara County",3,56,26,11,15
050,56,027,"Wyoming","Niobrara County",3,57,24,9,15
050,56,027,"Wyoming","Niobrara County",3,58,28,9,19
050,56,027,"Wyoming","Niobrara County",3,59,30,14,16
050,56,027,"Wyoming","Niobrara County",3,60,40,17,23
050,56,027,"Wyoming","Niobrara County",3,61,36,22,14
050,56,027,"Wyoming","Niobrara County",3,62,27,12,15
050,56,027,"Wyoming","Niobrara County",3,63,39,19,20
050,56,027,"Wyoming","Niobrara County",3,64,48,23,25
050,56,027,"Wyoming","Niobrara County",3,65,49,23,26
050,56,027,"Wyoming","Niobrara County",3,66,41,21,20
050,56,027,"Wyoming","Niobrara County",3,67,37,14,23
050,56,027,"Wyoming","Niobrara County",3,68,36,15,21
050,56,027,"Wyoming","Niobrara County",3,69,35,20,15
050,56,027,"Wyoming","Niobrara County",3,70,32,17,15
050,56,027,"Wyoming","Niobrara County",3,71,32,18,14
050,56,027,"Wyoming","Niobrara County",3,72,30,15,15
050,56,027,"Wyoming","Niobrara County",3,73,22,12,10
050,56,027,"Wyoming","Niobrara County",3,74,22,12,10
050,56,027,"Wyoming","Niobrara County",3,75,20,13,7
050,56,027,"Wyoming","Niobrara County",3,76,22,13,9
050,56,027,"Wyoming","Niobrara County",3,77,24,12,12
050,56,027,"Wyoming","Niobrara County",3,78,24,9,15
050,56,027,"Wyoming","Niobrara County",3,79,17,8,9
050,56,027,"Wyoming","Niobrara County",3,80,15,7,8
050,56,027,"Wyoming","Niobrara County",3,81,17,8,9
050,56,027,"Wyoming","Niobrara County",3,82,13,8,5
050,56,027,"Wyoming","Niobrara County",3,83,16,10,6
050,56,027,"Wyoming","Niobrara County",3,84,21,12,9
050,56,027,"Wyoming","Niobrara County",3,85,86,41,45
050,56,027,"Wyoming","Niobrara County",4,0,22,12,10
050,56,027,"Wyoming","Niobrara County",4,1,27,17,10
050,56,027,"Wyoming","Niobrara County",4,2,33,16,17
050,56,027,"Wyoming","Niobrara County",4,3,20,10,10
050,56,027,"Wyoming","Niobrara County",4,4,24,10,14
050,56,027,"Wyoming","Niobrara County",4,5,26,8,18
050,56,027,"Wyoming","Niobrara County",4,6,26,12,14
050,56,027,"Wyoming","Niobrara County",4,7,25,13,12
050,56,027,"Wyoming","Niobrara County",4,8,21,8,13
050,56,027,"Wyoming","Niobrara County",4,9,26,12,14
050,56,027,"Wyoming","Niobrara County",4,10,20,12,8
050,56,027,"Wyoming","Niobrara County",4,11,25,11,14
050,56,027,"Wyoming","Niobrara County",4,12,17,11,6
050,56,027,"Wyoming","Niobrara County",4,13,26,16,10
050,56,027,"Wyoming","Niobrara County",4,14,21,18,3
050,56,027,"Wyoming","Niobrara County",4,15,20,12,8
050,56,027,"Wyoming","Niobrara County",4,16,20,14,6
050,56,027,"Wyoming","Niobrara County",4,17,17,8,9
050,56,027,"Wyoming","Niobrara County",4,18,20,14,6
050,56,027,"Wyoming","Niobrara County",4,19,19,9,10
050,56,027,"Wyoming","Niobrara County",4,20,16,9,7
050,56,027,"Wyoming","Niobrara County",4,21,28,11,17
050,56,027,"Wyoming","Niobrara County",4,22,19,4,15
050,56,027,"Wyoming","Niobrara County",4,23,32,11,21
050,56,027,"Wyoming","Niobrara County",4,24,33,15,18
050,56,027,"Wyoming","Niobrara County",4,25,25,8,17
050,56,027,"Wyoming","Niobrara County",4,26,31,10,21
050,56,027,"Wyoming","Niobrara County",4,27,17,6,11
050,56,027,"Wyoming","Niobrara County",4,28,25,7,18
050,56,027,"Wyoming","Niobrara County",4,29,32,15,17
050,56,027,"Wyoming","Niobrara County",4,30,38,11,27
050,56,027,"Wyoming","Niobrara County",4,31,30,11,19
050,56,027,"Wyoming","Niobrara County",4,32,31,9,22
050,56,027,"Wyoming","Niobrara County",4,33,20,5,15
050,56,027,"Wyoming","Niobrara County",4,34,27,9,18
050,56,027,"Wyoming","Niobrara County",4,35,32,15,17
050,56,027,"Wyoming","Niobrara County",4,36,28,7,21
050,56,027,"Wyoming","Niobrara County",4,37,36,13,23
050,56,027,"Wyoming","Niobrara County",4,38,34,13,21
050,56,027,"Wyoming","Niobrara County",4,39,24,9,15
050,56,027,"Wyoming","Niobrara County",4,40,28,12,16
050,56,027,"Wyoming","Niobrara County",4,41,39,22,17
050,56,027,"Wyoming","Niobrara County",4,42,30,21,9
050,56,027,"Wyoming","Niobrara County",4,43,27,14,13
050,56,027,"Wyoming","Niobrara County",4,44,24,9,15
050,56,027,"Wyoming","Niobrara County",4,45,23,8,15
050,56,027,"Wyoming","Niobrara County",4,46,16,6,10
050,56,027,"Wyoming","Niobrara County",4,47,35,11,24
050,56,027,"Wyoming","Niobrara County",4,48,32,10,22
050,56,027,"Wyoming","Niobrara County",4,49,32,12,20
050,56,027,"Wyoming","Niobrara County",4,50,33,14,19
050,56,027,"Wyoming","Niobrara County",4,51,29,10,19
050,56,027,"Wyoming","Niobrara County",4,52,24,11,13
050,56,027,"Wyoming","Niobrara County",4,53,26,12,14
050,56,027,"Wyoming","Niobrara County",4,54,19,12,7
050,56,027,"Wyoming","Niobrara County",4,55,25,14,11
050,56,027,"Wyoming","Niobrara County",4,56,23,10,13
050,56,027,"Wyoming","Niobrara County",4,57,27,13,14
050,56,027,"Wyoming","Niobrara County",4,58,26,8,18
050,56,027,"Wyoming","Niobrara County",4,59,28,10,18
050,56,027,"Wyoming","Niobrara County",4,60,25,13,12
050,56,027,"Wyoming","Niobrara County",4,61,37,17,20
050,56,027,"Wyoming","Niobrara County",4,62,38,20,18
050,56,027,"Wyoming","Niobrara County",4,63,26,13,13
050,56,027,"Wyoming","Niobrara County",4,64,34,16,18
050,56,027,"Wyoming","Niobrara County",4,65,43,20,23
050,56,027,"Wyoming","Niobrara County",4,66,50,27,23
050,56,027,"Wyoming","Niobrara County",4,67,44,21,23
050,56,027,"Wyoming","Niobrara County",4,68,38,15,23
050,56,027,"Wyoming","Niobrara County",4,69,36,15,21
050,56,027,"Wyoming","Niobrara County",4,70,35,20,15
050,56,027,"Wyoming","Niobrara County",4,71,32,18,14
050,56,027,"Wyoming","Niobrara County",4,72,33,18,15
050,56,027,"Wyoming","Niobrara County",4,73,31,15,16
050,56,027,"Wyoming","Niobrara County",4,74,21,11,10
050,56,027,"Wyoming","Niobrara County",4,75,20,10,10
050,56,027,"Wyoming","Niobrara County",4,76,17,11,6
050,56,027,"Wyoming","Niobrara County",4,77,20,10,10
050,56,027,"Wyoming","Niobrara County",4,78,22,10,12
050,56,027,"Wyoming","Niobrara County",4,79,24,9,15
050,56,027,"Wyoming","Niobrara County",4,80,17,7,10
050,56,027,"Wyoming","Niobrara County",4,81,15,6,9
050,56,027,"Wyoming","Niobrara County",4,82,15,8,7
050,56,027,"Wyoming","Niobrara County",4,83,10,6,4
050,56,027,"Wyoming","Niobrara County",4,84,14,10,4
050,56,027,"Wyoming","Niobrara County",4,85,92,44,48
050,56,027,"Wyoming","Niobrara County",5,0,21,12,9
050,56,027,"Wyoming","Niobrara County",5,1,29,17,12
050,56,027,"Wyoming","Niobrara County",5,2,21,14,7
050,56,027,"Wyoming","Niobrara County",5,3,28,12,16
050,56,027,"Wyoming","Niobrara County",5,4,20,9,11
050,56,027,"Wyoming","Niobrara County",5,5,26,12,14
050,56,027,"Wyoming","Niobrara County",5,6,26,9,17
050,56,027,"Wyoming","Niobrara County",5,7,29,15,14
050,56,027,"Wyoming","Niobrara County",5,8,27,14,13
050,56,027,"Wyoming","Niobrara County",5,9,21,9,12
050,56,027,"Wyoming","Niobrara County",5,10,27,12,15
050,56,027,"Wyoming","Niobrara County",5,11,19,11,8
050,56,027,"Wyoming","Niobrara County",5,12,24,11,13
050,56,027,"Wyoming","Niobrara County",5,13,19,12,7
050,56,027,"Wyoming","Niobrara County",5,14,24,14,10
050,56,027,"Wyoming","Niobrara County",5,15,22,18,4
050,56,027,"Wyoming","Niobrara County",5,16,21,14,7
050,56,027,"Wyoming","Niobrara County",5,17,23,11,12
050,56,027,"Wyoming","Niobrara County",5,18,14,8,6
050,56,027,"Wyoming","Niobrara County",5,19,20,12,8
050,56,027,"Wyoming","Niobrara County",5,20,15,8,7
050,56,027,"Wyoming","Niobrara County",5,21,22,9,13
050,56,027,"Wyoming","Niobrara County",5,22,27,7,20
050,56,027,"Wyoming","Niobrara County",5,23,28,7,21
050,56,027,"Wyoming","Niobrara County",5,24,23,11,12
050,56,027,"Wyoming","Niobrara County",5,25,34,11,23
050,56,027,"Wyoming","Niobrara County",5,26,29,8,21
050,56,027,"Wyoming","Niobrara County",5,27,27,13,14
050,56,027,"Wyoming","Niobrara County",5,28,23,8,15
050,56,027,"Wyoming","Niobrara County",5,29,26,12,14
050,56,027,"Wyoming","Niobrara County",5,30,39,12,27
050,56,027,"Wyoming","Niobrara County",5,31,33,11,22
050,56,027,"Wyoming","Niobrara County",5,32,29,11,18
050,56,027,"Wyoming","Niobrara County",5,33,25,9,16
050,56,027,"Wyoming","Niobrara County",5,34,25,6,19
050,56,027,"Wyoming","Niobrara County",5,35,23,9,14
050,56,027,"Wyoming","Niobrara County",5,36,35,15,20
050,56,027,"Wyoming","Niobrara County",5,37,21,4,17
050,56,027,"Wyoming","Niobrara County",5,38,39,12,27
050,56,027,"Wyoming","Niobrara County",5,39,31,12,19
050,56,027,"Wyoming","Niobrara County",5,40,27,13,14
050,56,027,"Wyoming","Niobrara County",5,41,28,13,15
050,56,027,"Wyoming","Niobrara County",5,42,31,19,12
050,56,027,"Wyoming","Niobrara County",5,43,31,21,10
050,56,027,"Wyoming","Niobrara County",5,44,30,15,15
050,56,027,"Wyoming","Niobrara County",5,45,24,8,16
050,56,027,"Wyoming","Niobrara County",5,46,19,8,11
050,56,027,"Wyoming","Niobrara County",5,47,19,7,12
050,56,027,"Wyoming","Niobrara County",5,48,37,10,27
050,56,027,"Wyoming","Niobrara County",5,49,32,14,18
050,56,027,"Wyoming","Niobrara County",5,50,31,12,19
050,56,027,"Wyoming","Niobrara County",5,51,36,14,22
050,56,027,"Wyoming","Niobrara County",5,52,29,10,19
050,56,027,"Wyoming","Niobrara County",5,53,23,13,10
050,56,027,"Wyoming","Niobrara County",5,54,20,10,10
050,56,027,"Wyoming","Niobrara County",5,55,20,13,7
050,56,027,"Wyoming","Niobrara County",5,56,23,12,11
050,56,027,"Wyoming","Niobrara County",5,57,22,10,12
050,56,027,"Wyoming","Niobrara County",5,58,28,11,17
050,56,027,"Wyoming","Niobrara County",5,59,25,9,16
050,56,027,"Wyoming","Niobrara County",5,60,26,9,17
050,56,027,"Wyoming","Niobrara County",5,61,27,14,13
050,56,027,"Wyoming","Niobrara County",5,62,38,18,20
050,56,027,"Wyoming","Niobrara County",5,63,37,20,17
050,56,027,"Wyoming","Niobrara County",5,64,26,13,13
050,56,027,"Wyoming","Niobrara County",5,65,34,15,19
050,56,027,"Wyoming","Niobrara County",5,66,43,20,23
050,56,027,"Wyoming","Niobrara County",5,67,58,31,27
050,56,027,"Wyoming","Niobrara County",5,68,43,21,22
050,56,027,"Wyoming","Niobrara County",5,69,39,16,23
050,56,027,"Wyoming","Niobrara County",5,70,38,17,21
050,56,027,"Wyoming","Niobrara County",5,71,38,22,16
050,56,027,"Wyoming","Niobrara County",5,72,35,20,15
050,56,027,"Wyoming","Niobrara County",5,73,32,18,14
050,56,027,"Wyoming","Niobrara County",5,74,33,16,17
050,56,027,"Wyoming","Niobrara County",5,75,19,10,9
050,56,027,"Wyoming","Niobrara County",5,76,18,9,9
050,56,027,"Wyoming","Niobrara County",5,77,18,11,7
050,56,027,"Wyoming","Niobrara County",5,78,18,8,10
050,56,027,"Wyoming","Niobrara County",5,79,22,9,13
050,56,027,"Wyoming","Niobrara County",5,80,20,7,13
050,56,027,"Wyoming","Niobrara County",5,81,11,4,7
050,56,027,"Wyoming","Niobrara County",5,82,15,6,9
050,56,027,"Wyoming","Niobrara County",5,83,13,7,6
050,56,027,"Wyoming","Niobrara County",5,84,11,6,5
050,56,027,"Wyoming","Niobrara County",5,85,92,45,47
050,56,029,"Wyoming","Park County",1,0,268,136,132
050,56,029,"Wyoming","Park County",1,1,280,138,142
050,56,029,"Wyoming","Park County",1,2,306,160,146
050,56,029,"Wyoming","Park County",1,3,312,169,143
050,56,029,"Wyoming","Park County",1,4,316,165,151
050,56,029,"Wyoming","Park County",1,5,357,183,174
050,56,029,"Wyoming","Park County",1,6,345,156,189
050,56,029,"Wyoming","Park County",1,7,331,184,147
050,56,029,"Wyoming","Park County",1,8,351,187,164
050,56,029,"Wyoming","Park County",1,9,336,166,170
050,56,029,"Wyoming","Park County",1,10,356,173,183
050,56,029,"Wyoming","Park County",1,11,384,194,190
050,56,029,"Wyoming","Park County",1,12,360,181,179
050,56,029,"Wyoming","Park County",1,13,376,196,180
050,56,029,"Wyoming","Park County",1,14,366,199,167
050,56,029,"Wyoming","Park County",1,15,363,184,179
050,56,029,"Wyoming","Park County",1,16,342,187,155
050,56,029,"Wyoming","Park County",1,17,356,187,169
050,56,029,"Wyoming","Park County",1,18,347,185,162
050,56,029,"Wyoming","Park County",1,19,385,201,184
050,56,029,"Wyoming","Park County",1,20,325,167,158
050,56,029,"Wyoming","Park County",1,21,294,158,136
050,56,029,"Wyoming","Park County",1,22,287,148,139
050,56,029,"Wyoming","Park County",1,23,259,126,133
050,56,029,"Wyoming","Park County",1,24,282,136,146
050,56,029,"Wyoming","Park County",1,25,269,136,133
050,56,029,"Wyoming","Park County",1,26,291,130,161
050,56,029,"Wyoming","Park County",1,27,304,143,161
050,56,029,"Wyoming","Park County",1,28,306,152,154
050,56,029,"Wyoming","Park County",1,29,319,163,156
050,56,029,"Wyoming","Park County",1,30,319,160,159
050,56,029,"Wyoming","Park County",1,31,335,177,158
050,56,029,"Wyoming","Park County",1,32,332,168,164
050,56,029,"Wyoming","Park County",1,33,327,167,160
050,56,029,"Wyoming","Park County",1,34,366,180,186
050,56,029,"Wyoming","Park County",1,35,354,172,182
050,56,029,"Wyoming","Park County",1,36,350,186,164
050,56,029,"Wyoming","Park County",1,37,370,199,171
050,56,029,"Wyoming","Park County",1,38,354,171,183
050,56,029,"Wyoming","Park County",1,39,345,160,185
050,56,029,"Wyoming","Park County",1,40,370,187,183
050,56,029,"Wyoming","Park County",1,41,344,183,161
050,56,029,"Wyoming","Park County",1,42,304,145,159
050,56,029,"Wyoming","Park County",1,43,293,150,143
050,56,029,"Wyoming","Park County",1,44,314,166,148
050,56,029,"Wyoming","Park County",1,45,302,153,149
050,56,029,"Wyoming","Park County",1,46,308,159,149
050,56,029,"Wyoming","Park County",1,47,303,157,146
050,56,029,"Wyoming","Park County",1,48,303,151,152
050,56,029,"Wyoming","Park County",1,49,300,149,151
050,56,029,"Wyoming","Park County",1,50,327,164,163
050,56,029,"Wyoming","Park County",1,51,316,147,169
050,56,029,"Wyoming","Park County",1,52,318,161,157
050,56,029,"Wyoming","Park County",1,53,339,179,160
050,56,029,"Wyoming","Park County",1,54,323,163,160
050,56,029,"Wyoming","Park County",1,55,343,165,178
050,56,029,"Wyoming","Park County",1,56,416,191,225
050,56,029,"Wyoming","Park County",1,57,416,200,216
050,56,029,"Wyoming","Park County",1,58,419,193,226
050,56,029,"Wyoming","Park County",1,59,453,225,228
050,56,029,"Wyoming","Park County",1,60,477,233,244
050,56,029,"Wyoming","Park County",1,61,487,228,259
050,56,029,"Wyoming","Park County",1,62,495,243,252
050,56,029,"Wyoming","Park County",1,63,475,237,238
050,56,029,"Wyoming","Park County",1,64,473,229,244
050,56,029,"Wyoming","Park County",1,65,504,244,260
050,56,029,"Wyoming","Park County",1,66,512,261,251
050,56,029,"Wyoming","Park County",1,67,476,232,244
050,56,029,"Wyoming","Park County",1,68,452,240,212
050,56,029,"Wyoming","Park County",1,69,454,231,223
050,56,029,"Wyoming","Park County",1,70,424,208,216
050,56,029,"Wyoming","Park County",1,71,404,215,189
050,56,029,"Wyoming","Park County",1,72,408,206,202
050,56,029,"Wyoming","Park County",1,73,409,213,196
050,56,029,"Wyoming","Park County",1,74,293,147,146
050,56,029,"Wyoming","Park County",1,75,302,143,159
050,56,029,"Wyoming","Park County",1,76,280,144,136
050,56,029,"Wyoming","Park County",1,77,295,165,130
050,56,029,"Wyoming","Park County",1,78,252,123,129
050,56,029,"Wyoming","Park County",1,79,196,88,108
050,56,029,"Wyoming","Park County",1,80,171,82,89
050,56,029,"Wyoming","Park County",1,81,160,88,72
050,56,029,"Wyoming","Park County",1,82,167,86,81
050,56,029,"Wyoming","Park County",1,83,141,67,74
050,56,029,"Wyoming","Park County",1,84,121,52,69
050,56,029,"Wyoming","Park County",1,85,763,268,495
050,56,029,"Wyoming","Park County",2,0,263,132,131
050,56,029,"Wyoming","Park County",2,1,278,138,140
050,56,029,"Wyoming","Park County",2,2,300,156,144
050,56,029,"Wyoming","Park County",2,3,315,169,146
050,56,029,"Wyoming","Park County",2,4,319,170,149
050,56,029,"Wyoming","Park County",2,5,349,177,172
050,56,029,"Wyoming","Park County",2,6,352,164,188
050,56,029,"Wyoming","Park County",2,7,334,176,158
050,56,029,"Wyoming","Park County",2,8,346,187,159
050,56,029,"Wyoming","Park County",2,9,341,172,169
050,56,029,"Wyoming","Park County",2,10,350,170,180
050,56,029,"Wyoming","Park County",2,11,371,185,186
050,56,029,"Wyoming","Park County",2,12,365,184,181
050,56,029,"Wyoming","Park County",2,13,372,193,179
050,56,029,"Wyoming","Park County",2,14,368,196,172
050,56,029,"Wyoming","Park County",2,15,364,187,177
050,56,029,"Wyoming","Park County",2,16,348,187,161
050,56,029,"Wyoming","Park County",2,17,356,190,166
050,56,029,"Wyoming","Park County",2,18,353,187,166
050,56,029,"Wyoming","Park County",2,19,384,202,182
050,56,029,"Wyoming","Park County",2,20,328,168,160
050,56,029,"Wyoming","Park County",2,21,290,155,135
050,56,029,"Wyoming","Park County",2,22,285,147,138
050,56,029,"Wyoming","Park County",2,23,271,134,137
050,56,029,"Wyoming","Park County",2,24,274,132,142
050,56,029,"Wyoming","Park County",2,25,273,136,137
050,56,029,"Wyoming","Park County",2,26,288,132,156
050,56,029,"Wyoming","Park County",2,27,302,140,162
050,56,029,"Wyoming","Park County",2,28,309,152,157
050,56,029,"Wyoming","Park County",2,29,314,158,156
050,56,029,"Wyoming","Park County",2,30,323,163,160
050,56,029,"Wyoming","Park County",2,31,333,175,158
050,56,029,"Wyoming","Park County",2,32,331,169,162
050,56,029,"Wyoming","Park County",2,33,331,170,161
050,56,029,"Wyoming","Park County",2,34,357,177,180
050,56,029,"Wyoming","Park County",2,35,359,176,183
050,56,029,"Wyoming","Park County",2,36,349,181,168
050,56,029,"Wyoming","Park County",2,37,365,195,170
050,56,029,"Wyoming","Park County",2,38,359,176,183
050,56,029,"Wyoming","Park County",2,39,351,164,187
050,56,029,"Wyoming","Park County",2,40,368,183,185
050,56,029,"Wyoming","Park County",2,41,351,184,167
050,56,029,"Wyoming","Park County",2,42,311,154,157
050,56,029,"Wyoming","Park County",2,43,299,150,149
050,56,029,"Wyoming","Park County",2,44,304,159,145
050,56,029,"Wyoming","Park County",2,45,305,156,149
050,56,029,"Wyoming","Park County",2,46,306,159,147
050,56,029,"Wyoming","Park County",2,47,305,159,146
050,56,029,"Wyoming","Park County",2,48,301,151,150
050,56,029,"Wyoming","Park County",2,49,305,152,153
050,56,029,"Wyoming","Park County",2,50,320,160,160
050,56,029,"Wyoming","Park County",2,51,320,151,169
050,56,029,"Wyoming","Park County",2,52,313,153,160
050,56,029,"Wyoming","Park County",2,53,337,176,161
050,56,029,"Wyoming","Park County",2,54,328,167,161
050,56,029,"Wyoming","Park County",2,55,338,163,175
050,56,029,"Wyoming","Park County",2,56,399,186,213
050,56,029,"Wyoming","Park County",2,57,418,199,219
050,56,029,"Wyoming","Park County",2,58,419,196,223
050,56,029,"Wyoming","Park County",2,59,447,218,229
050,56,029,"Wyoming","Park County",2,60,472,233,239
050,56,029,"Wyoming","Park County",2,61,488,233,255
050,56,029,"Wyoming","Park County",2,62,495,241,254
050,56,029,"Wyoming","Park County",2,63,485,241,244
050,56,029,"Wyoming","Park County",2,64,478,232,246
050,56,029,"Wyoming","Park County",2,65,494,240,254
050,56,029,"Wyoming","Park County",2,66,512,258,254
050,56,029,"Wyoming","Park County",2,67,480,237,243
050,56,029,"Wyoming","Park County",2,68,454,236,218
050,56,029,"Wyoming","Park County",2,69,457,234,223
050,56,029,"Wyoming","Park County",2,70,428,212,216
050,56,029,"Wyoming","Park County",2,71,410,215,195
050,56,029,"Wyoming","Park County",2,72,397,202,195
050,56,029,"Wyoming","Park County",2,73,430,222,208
050,56,029,"Wyoming","Park County",2,74,298,152,146
050,56,029,"Wyoming","Park County",2,75,302,145,157
050,56,029,"Wyoming","Park County",2,76,282,143,139
050,56,029,"Wyoming","Park County",2,77,294,159,135
050,56,029,"Wyoming","Park County",2,78,257,131,126
050,56,029,"Wyoming","Park County",2,79,206,96,110
050,56,029,"Wyoming","Park County",2,80,176,82,94
050,56,029,"Wyoming","Park County",2,81,161,87,74
050,56,029,"Wyoming","Park County",2,82,166,87,79
050,56,029,"Wyoming","Park County",2,83,143,70,73
050,56,029,"Wyoming","Park County",2,84,126,57,69
050,56,029,"Wyoming","Park County",2,85,764,266,498
050,56,029,"Wyoming","Park County",3,0,294,151,143
050,56,029,"Wyoming","Park County",3,1,259,128,131
050,56,029,"Wyoming","Park County",3,2,294,142,152
050,56,029,"Wyoming","Park County",3,3,307,152,155
050,56,029,"Wyoming","Park County",3,4,318,176,142
050,56,029,"Wyoming","Park County",3,5,327,174,153
050,56,029,"Wyoming","Park County",3,6,376,185,191
050,56,029,"Wyoming","Park County",3,7,356,166,190
050,56,029,"Wyoming","Park County",3,8,341,178,163
050,56,029,"Wyoming","Park County",3,9,350,193,157
050,56,029,"Wyoming","Park County",3,10,345,176,169
050,56,029,"Wyoming","Park County",3,11,356,168,188
050,56,029,"Wyoming","Park County",3,12,386,190,196
050,56,029,"Wyoming","Park County",3,13,379,197,182
050,56,029,"Wyoming","Park County",3,14,379,193,186
050,56,029,"Wyoming","Park County",3,15,377,199,178
050,56,029,"Wyoming","Park County",3,16,385,194,191
050,56,029,"Wyoming","Park County",3,17,366,191,175
050,56,029,"Wyoming","Park County",3,18,377,198,179
050,56,029,"Wyoming","Park County",3,19,388,212,176
050,56,029,"Wyoming","Park County",3,20,334,174,160
050,56,029,"Wyoming","Park County",3,21,284,152,132
050,56,029,"Wyoming","Park County",3,22,285,150,135
050,56,029,"Wyoming","Park County",3,23,315,160,155
050,56,029,"Wyoming","Park County",3,24,290,140,150
050,56,029,"Wyoming","Park County",3,25,284,144,140
050,56,029,"Wyoming","Park County",3,26,280,142,138
050,56,029,"Wyoming","Park County",3,27,302,130,172
050,56,029,"Wyoming","Park County",3,28,295,127,168
050,56,029,"Wyoming","Park County",3,29,305,148,157
050,56,029,"Wyoming","Park County",3,30,310,161,149
050,56,029,"Wyoming","Park County",3,31,336,173,163
050,56,029,"Wyoming","Park County",3,32,336,172,164
050,56,029,"Wyoming","Park County",3,33,346,179,167
050,56,029,"Wyoming","Park County",3,34,335,166,169
050,56,029,"Wyoming","Park County",3,35,352,171,181
050,56,029,"Wyoming","Park County",3,36,366,180,186
050,56,029,"Wyoming","Park County",3,37,344,170,174
050,56,029,"Wyoming","Park County",3,38,368,198,170
050,56,029,"Wyoming","Park County",3,39,365,186,179
050,56,029,"Wyoming","Park County",3,40,358,171,187
050,56,029,"Wyoming","Park County",3,41,367,177,190
050,56,029,"Wyoming","Park County",3,42,353,189,164
050,56,029,"Wyoming","Park County",3,43,317,158,159
050,56,029,"Wyoming","Park County",3,44,308,165,143
050,56,029,"Wyoming","Park County",3,45,306,157,149
050,56,029,"Wyoming","Park County",3,46,310,156,154
050,56,029,"Wyoming","Park County",3,47,312,156,156
050,56,029,"Wyoming","Park County",3,48,301,157,144
050,56,029,"Wyoming","Park County",3,49,308,157,151
050,56,029,"Wyoming","Park County",3,50,321,167,154
050,56,029,"Wyoming","Park County",3,51,327,165,162
050,56,029,"Wyoming","Park County",3,52,319,148,171
050,56,029,"Wyoming","Park County",3,53,321,162,159
050,56,029,"Wyoming","Park County",3,54,344,178,166
050,56,029,"Wyoming","Park County",3,55,335,168,167
050,56,029,"Wyoming","Park County",3,56,356,180,176
050,56,029,"Wyoming","Park County",3,57,407,183,224
050,56,029,"Wyoming","Park County",3,58,430,206,224
050,56,029,"Wyoming","Park County",3,59,427,198,229
050,56,029,"Wyoming","Park County",3,60,465,228,237
050,56,029,"Wyoming","Park County",3,61,491,242,249
050,56,029,"Wyoming","Park County",3,62,503,238,265
050,56,029,"Wyoming","Park County",3,63,492,236,256
050,56,029,"Wyoming","Park County",3,64,507,259,248
050,56,029,"Wyoming","Park County",3,65,491,238,253
050,56,029,"Wyoming","Park County",3,66,493,233,260
050,56,029,"Wyoming","Park County",3,67,510,258,252
050,56,029,"Wyoming","Park County",3,68,481,237,244
050,56,029,"Wyoming","Park County",3,69,458,242,216
050,56,029,"Wyoming","Park County",3,70,452,231,221
050,56,029,"Wyoming","Park County",3,71,423,211,212
050,56,029,"Wyoming","Park County",3,72,399,210,189
050,56,029,"Wyoming","Park County",3,73,389,197,192
050,56,029,"Wyoming","Park County",3,74,401,207,194
050,56,029,"Wyoming","Park County",3,75,288,145,143
050,56,029,"Wyoming","Park County",3,76,288,137,151
050,56,029,"Wyoming","Park County",3,77,269,134,135
050,56,029,"Wyoming","Park County",3,78,286,156,130
050,56,029,"Wyoming","Park County",3,79,237,119,118
050,56,029,"Wyoming","Park County",3,80,199,89,110
050,56,029,"Wyoming","Park County",3,81,168,82,86
050,56,029,"Wyoming","Park County",3,82,150,79,71
050,56,029,"Wyoming","Park County",3,83,147,77,70
050,56,029,"Wyoming","Park County",3,84,146,65,81
050,56,029,"Wyoming","Park County",3,85,789,296,493
050,56,029,"Wyoming","Park County",4,0,272,152,120
050,56,029,"Wyoming","Park County",4,1,312,165,147
050,56,029,"Wyoming","Park County",4,2,263,131,132
050,56,029,"Wyoming","Park County",4,3,298,148,150
050,56,029,"Wyoming","Park County",4,4,312,145,167
050,56,029,"Wyoming","Park County",4,5,328,179,149
050,56,029,"Wyoming","Park County",4,6,349,175,174
050,56,029,"Wyoming","Park County",4,7,380,190,190
050,56,029,"Wyoming","Park County",4,8,367,173,194
050,56,029,"Wyoming","Park County",4,9,352,179,173
050,56,029,"Wyoming","Park County",4,10,364,202,162
050,56,029,"Wyoming","Park County",4,11,336,174,162
050,56,029,"Wyoming","Park County",4,12,362,172,190
050,56,029,"Wyoming","Park County",4,13,404,200,204
050,56,029,"Wyoming","Park County",4,14,390,197,193
050,56,029,"Wyoming","Park County",4,15,391,198,193
050,56,029,"Wyoming","Park County",4,16,384,207,177
050,56,029,"Wyoming","Park County",4,17,394,201,193
050,56,029,"Wyoming","Park County",4,18,377,199,178
050,56,029,"Wyoming","Park County",4,19,389,209,180
050,56,029,"Wyoming","Park County",4,20,334,179,155
050,56,029,"Wyoming","Park County",4,21,292,150,142
050,56,029,"Wyoming","Park County",4,22,267,141,126
050,56,029,"Wyoming","Park County",4,23,291,149,142
050,56,029,"Wyoming","Park County",4,24,318,155,163
050,56,029,"Wyoming","Park County",4,25,293,145,148
050,56,029,"Wyoming","Park County",4,26,301,146,155
050,56,029,"Wyoming","Park County",4,27,291,147,144
050,56,029,"Wyoming","Park County",4,28,320,140,180
050,56,029,"Wyoming","Park County",4,29,292,131,161
050,56,029,"Wyoming","Park County",4,30,309,155,154
050,56,029,"Wyoming","Park County",4,31,322,169,153
050,56,029,"Wyoming","Park County",4,32,344,177,167
050,56,029,"Wyoming","Park County",4,33,339,176,163
050,56,029,"Wyoming","Park County",4,34,364,194,170
050,56,029,"Wyoming","Park County",4,35,350,170,180
050,56,029,"Wyoming","Park County",4,36,358,175,183
050,56,029,"Wyoming","Park County",4,37,384,190,194
050,56,029,"Wyoming","Park County",4,38,368,187,181
050,56,029,"Wyoming","Park County",4,39,377,206,171
050,56,029,"Wyoming","Park County",4,40,372,186,186
050,56,029,"Wyoming","Park County",4,41,385,178,207
050,56,029,"Wyoming","Park County",4,42,371,180,191
050,56,029,"Wyoming","Park County",4,43,340,178,162
050,56,029,"Wyoming","Park County",4,44,316,161,155
050,56,029,"Wyoming","Park County",4,45,323,173,150
050,56,029,"Wyoming","Park County",4,46,321,171,150
050,56,029,"Wyoming","Park County",4,47,309,150,159
050,56,029,"Wyoming","Park County",4,48,318,157,161
050,56,029,"Wyoming","Park County",4,49,312,164,148
050,56,029,"Wyoming","Park County",4,50,322,171,151
050,56,029,"Wyoming","Park County",4,51,326,170,156
050,56,029,"Wyoming","Park County",4,52,349,175,174
050,56,029,"Wyoming","Park County",4,53,341,168,173
050,56,029,"Wyoming","Park County",4,54,326,166,160
050,56,029,"Wyoming","Park County",4,55,347,181,166
050,56,029,"Wyoming","Park County",4,56,337,164,173
050,56,029,"Wyoming","Park County",4,57,359,172,187
050,56,029,"Wyoming","Park County",4,58,418,188,230
050,56,029,"Wyoming","Park County",4,59,428,204,224
050,56,029,"Wyoming","Park County",4,60,427,198,229
050,56,029,"Wyoming","Park County",4,61,462,235,227
050,56,029,"Wyoming","Park County",4,62,496,245,251
050,56,029,"Wyoming","Park County",4,63,501,241,260
050,56,029,"Wyoming","Park County",4,64,502,241,261
050,56,029,"Wyoming","Park County",4,65,514,264,250
050,56,029,"Wyoming","Park County",4,66,491,234,257
050,56,029,"Wyoming","Park County",4,67,493,236,257
050,56,029,"Wyoming","Park County",4,68,509,260,249
050,56,029,"Wyoming","Park County",4,69,474,234,240
050,56,029,"Wyoming","Park County",4,70,446,236,210
050,56,029,"Wyoming","Park County",4,71,442,224,218
050,56,029,"Wyoming","Park County",4,72,410,208,202
050,56,029,"Wyoming","Park County",4,73,396,203,193
050,56,029,"Wyoming","Park County",4,74,375,190,185
050,56,029,"Wyoming","Park County",4,75,398,202,196
050,56,029,"Wyoming","Park County",4,76,280,140,140
050,56,029,"Wyoming","Park County",4,77,280,129,151
050,56,029,"Wyoming","Park County",4,78,260,129,131
050,56,029,"Wyoming","Park County",4,79,260,140,120
050,56,029,"Wyoming","Park County",4,80,217,106,111
050,56,029,"Wyoming","Park County",4,81,187,80,107
050,56,029,"Wyoming","Park County",4,82,161,74,87
050,56,029,"Wyoming","Park County",4,83,134,68,66
050,56,029,"Wyoming","Park County",4,84,144,72,72
050,56,029,"Wyoming","Park County",4,85,788,308,480
050,56,029,"Wyoming","Park County",5,0,265,145,120
050,56,029,"Wyoming","Park County",5,1,276,146,130
050,56,029,"Wyoming","Park County",5,2,308,161,147
050,56,029,"Wyoming","Park County",5,3,269,141,128
050,56,029,"Wyoming","Park County",5,4,298,156,142
050,56,029,"Wyoming","Park County",5,5,316,151,165
050,56,029,"Wyoming","Park County",5,6,340,183,157
050,56,029,"Wyoming","Park County",5,7,356,188,168
050,56,029,"Wyoming","Park County",5,8,390,193,197
050,56,029,"Wyoming","Park County",5,9,374,175,199
050,56,029,"Wyoming","Park County",5,10,359,184,175
050,56,029,"Wyoming","Park County",5,11,376,209,167
050,56,029,"Wyoming","Park County",5,12,352,178,174
050,56,029,"Wyoming","Park County",5,13,365,176,189
050,56,029,"Wyoming","Park County",5,14,408,197,211
050,56,029,"Wyoming","Park County",5,15,392,193,199
050,56,029,"Wyoming","Park County",5,16,392,198,194
050,56,029,"Wyoming","Park County",5,17,405,212,193
050,56,029,"Wyoming","Park County",5,18,391,195,196
050,56,029,"Wyoming","Park County",5,19,384,209,175
050,56,029,"Wyoming","Park County",5,20,337,175,162
050,56,029,"Wyoming","Park County",5,21,297,162,135
050,56,029,"Wyoming","Park County",5,22,294,136,158
050,56,029,"Wyoming","Park County",5,23,275,149,126
050,56,029,"Wyoming","Park County",5,24,282,147,135
050,56,029,"Wyoming","Park County",5,25,318,164,154
050,56,029,"Wyoming","Park County",5,26,293,144,149
050,56,029,"Wyoming","Park County",5,27,309,151,158
050,56,029,"Wyoming","Park County",5,28,294,149,145
050,56,029,"Wyoming","Park County",5,29,333,150,183
050,56,029,"Wyoming","Park County",5,30,314,142,172
050,56,029,"Wyoming","Park County",5,31,326,166,160
050,56,029,"Wyoming","Park County",5,32,340,173,167
050,56,029,"Wyoming","Park County",5,33,347,181,166
050,56,029,"Wyoming","Park County",5,34,345,184,161
050,56,029,"Wyoming","Park County",5,35,363,200,163
050,56,029,"Wyoming","Park County",5,36,354,168,186
050,56,029,"Wyoming","Park County",5,37,363,185,178
050,56,029,"Wyoming","Park County",5,38,410,201,209
050,56,029,"Wyoming","Park County",5,39,370,186,184
050,56,029,"Wyoming","Park County",5,40,388,213,175
050,56,029,"Wyoming","Park County",5,41,377,193,184
050,56,029,"Wyoming","Park County",5,42,382,173,209
050,56,029,"Wyoming","Park County",5,43,370,181,189
050,56,029,"Wyoming","Park County",5,44,340,178,162
050,56,029,"Wyoming","Park County",5,45,314,163,151
050,56,029,"Wyoming","Park County",5,46,342,180,162
050,56,029,"Wyoming","Park County",5,47,314,165,149
050,56,029,"Wyoming","Park County",5,48,310,157,153
050,56,029,"Wyoming","Park County",5,49,316,154,162
050,56,029,"Wyoming","Park County",5,50,305,168,137
050,56,029,"Wyoming","Park County",5,51,330,180,150
050,56,029,"Wyoming","Park County",5,52,322,161,161
050,56,029,"Wyoming","Park County",5,53,356,183,173
050,56,029,"Wyoming","Park County",5,54,346,173,173
050,56,029,"Wyoming","Park County",5,55,316,151,165
050,56,029,"Wyoming","Park County",5,56,347,181,166
050,56,029,"Wyoming","Park County",5,57,333,159,174
050,56,029,"Wyoming","Park County",5,58,376,177,199
050,56,029,"Wyoming","Park County",5,59,424,192,232
050,56,029,"Wyoming","Park County",5,60,429,204,225
050,56,029,"Wyoming","Park County",5,61,439,201,238
050,56,029,"Wyoming","Park County",5,62,485,247,238
050,56,029,"Wyoming","Park County",5,63,498,246,252
050,56,029,"Wyoming","Park County",5,64,514,246,268
050,56,029,"Wyoming","Park County",5,65,512,243,269
050,56,029,"Wyoming","Park County",5,66,510,259,251
050,56,029,"Wyoming","Park County",5,67,489,233,256
050,56,029,"Wyoming","Park County",5,68,494,234,260
050,56,029,"Wyoming","Park County",5,69,496,256,240
050,56,029,"Wyoming","Park County",5,70,463,230,233
050,56,029,"Wyoming","Park County",5,71,438,229,209
050,56,029,"Wyoming","Park County",5,72,434,220,214
050,56,029,"Wyoming","Park County",5,73,407,203,204
050,56,029,"Wyoming","Park County",5,74,373,193,180
050,56,029,"Wyoming","Park County",5,75,360,176,184
050,56,029,"Wyoming","Park County",5,76,390,202,188
050,56,029,"Wyoming","Park County",5,77,268,129,139
050,56,029,"Wyoming","Park County",5,78,271,125,146
050,56,029,"Wyoming","Park County",5,79,238,115,123
050,56,029,"Wyoming","Park County",5,80,249,130,119
050,56,029,"Wyoming","Park County",5,81,209,101,108
050,56,029,"Wyoming","Park County",5,82,178,76,102
050,56,029,"Wyoming","Park County",5,83,144,66,78
050,56,029,"Wyoming","Park County",5,84,131,65,66
050,56,029,"Wyoming","Park County",5,85,828,341,487
050,56,031,"Wyoming","Platte County",1,0,78,41,37
050,56,031,"Wyoming","Platte County",1,1,88,47,41
050,56,031,"Wyoming","Platte County",1,2,86,39,47
050,56,031,"Wyoming","Platte County",1,3,99,42,57
050,56,031,"Wyoming","Platte County",1,4,101,47,54
050,56,031,"Wyoming","Platte County",1,5,93,51,42
050,56,031,"Wyoming","Platte County",1,6,90,46,44
050,56,031,"Wyoming","Platte County",1,7,106,63,43
050,56,031,"Wyoming","Platte County",1,8,117,60,57
050,56,031,"Wyoming","Platte County",1,9,101,53,48
050,56,031,"Wyoming","Platte County",1,10,99,44,55
050,56,031,"Wyoming","Platte County",1,11,103,52,51
050,56,031,"Wyoming","Platte County",1,12,107,55,52
050,56,031,"Wyoming","Platte County",1,13,117,61,56
050,56,031,"Wyoming","Platte County",1,14,108,54,54
050,56,031,"Wyoming","Platte County",1,15,101,51,50
050,56,031,"Wyoming","Platte County",1,16,94,47,47
050,56,031,"Wyoming","Platte County",1,17,101,49,52
050,56,031,"Wyoming","Platte County",1,18,89,43,46
050,56,031,"Wyoming","Platte County",1,19,64,34,30
050,56,031,"Wyoming","Platte County",1,20,69,37,32
050,56,031,"Wyoming","Platte County",1,21,72,42,30
050,56,031,"Wyoming","Platte County",1,22,76,42,34
050,56,031,"Wyoming","Platte County",1,23,68,32,36
050,56,031,"Wyoming","Platte County",1,24,72,32,40
050,56,031,"Wyoming","Platte County",1,25,68,36,32
050,56,031,"Wyoming","Platte County",1,26,79,45,34
050,56,031,"Wyoming","Platte County",1,27,83,42,41
050,56,031,"Wyoming","Platte County",1,28,98,52,46
050,56,031,"Wyoming","Platte County",1,29,92,47,45
050,56,031,"Wyoming","Platte County",1,30,76,37,39
050,56,031,"Wyoming","Platte County",1,31,75,45,30
050,56,031,"Wyoming","Platte County",1,32,81,42,39
050,56,031,"Wyoming","Platte County",1,33,90,52,38
050,56,031,"Wyoming","Platte County",1,34,96,49,47
050,56,031,"Wyoming","Platte County",1,35,104,43,61
050,56,031,"Wyoming","Platte County",1,36,109,54,55
050,56,031,"Wyoming","Platte County",1,37,106,52,54
050,56,031,"Wyoming","Platte County",1,38,89,48,41
050,56,031,"Wyoming","Platte County",1,39,86,44,42
050,56,031,"Wyoming","Platte County",1,40,87,55,32
050,56,031,"Wyoming","Platte County",1,41,89,49,40
050,56,031,"Wyoming","Platte County",1,42,79,39,40
050,56,031,"Wyoming","Platte County",1,43,85,36,49
050,56,031,"Wyoming","Platte County",1,44,91,41,50
050,56,031,"Wyoming","Platte County",1,45,96,52,44
050,56,031,"Wyoming","Platte County",1,46,89,51,38
050,56,031,"Wyoming","Platte County",1,47,79,38,41
050,56,031,"Wyoming","Platte County",1,48,91,42,49
050,56,031,"Wyoming","Platte County",1,49,105,48,57
050,56,031,"Wyoming","Platte County",1,50,97,46,51
050,56,031,"Wyoming","Platte County",1,51,94,48,46
050,56,031,"Wyoming","Platte County",1,52,106,54,52
050,56,031,"Wyoming","Platte County",1,53,106,55,51
050,56,031,"Wyoming","Platte County",1,54,122,63,59
050,56,031,"Wyoming","Platte County",1,55,116,61,55
050,56,031,"Wyoming","Platte County",1,56,114,62,52
050,56,031,"Wyoming","Platte County",1,57,131,65,66
050,56,031,"Wyoming","Platte County",1,58,126,62,64
050,56,031,"Wyoming","Platte County",1,59,136,62,74
050,56,031,"Wyoming","Platte County",1,60,147,68,79
050,56,031,"Wyoming","Platte County",1,61,147,73,74
050,56,031,"Wyoming","Platte County",1,62,136,76,60
050,56,031,"Wyoming","Platte County",1,63,131,73,58
050,56,031,"Wyoming","Platte County",1,64,137,74,63
050,56,031,"Wyoming","Platte County",1,65,135,63,72
050,56,031,"Wyoming","Platte County",1,66,133,69,64
050,56,031,"Wyoming","Platte County",1,67,119,64,55
050,56,031,"Wyoming","Platte County",1,68,127,62,65
050,56,031,"Wyoming","Platte County",1,69,144,70,74
050,56,031,"Wyoming","Platte County",1,70,121,70,51
050,56,031,"Wyoming","Platte County",1,71,134,73,61
050,56,031,"Wyoming","Platte County",1,72,135,62,73
050,56,031,"Wyoming","Platte County",1,73,126,64,62
050,56,031,"Wyoming","Platte County",1,74,88,39,49
050,56,031,"Wyoming","Platte County",1,75,108,54,54
050,56,031,"Wyoming","Platte County",1,76,96,52,44
050,56,031,"Wyoming","Platte County",1,77,91,50,41
050,56,031,"Wyoming","Platte County",1,78,75,37,38
050,56,031,"Wyoming","Platte County",1,79,70,34,36
050,56,031,"Wyoming","Platte County",1,80,62,30,32
050,56,031,"Wyoming","Platte County",1,81,62,31,31
050,56,031,"Wyoming","Platte County",1,82,60,25,35
050,56,031,"Wyoming","Platte County",1,83,49,25,24
050,56,031,"Wyoming","Platte County",1,84,42,15,27
050,56,031,"Wyoming","Platte County",1,85,256,107,149
050,56,031,"Wyoming","Platte County",2,0,85,45,40
050,56,031,"Wyoming","Platte County",2,1,85,45,40
050,56,031,"Wyoming","Platte County",2,2,90,42,48
050,56,031,"Wyoming","Platte County",2,3,96,41,55
050,56,031,"Wyoming","Platte County",2,4,103,48,55
050,56,031,"Wyoming","Platte County",2,5,96,49,47
050,56,031,"Wyoming","Platte County",2,6,95,49,46
050,56,031,"Wyoming","Platte County",2,7,101,58,43
050,56,031,"Wyoming","Platte County",2,8,114,61,53
050,56,031,"Wyoming","Platte County",2,9,105,54,51
050,56,031,"Wyoming","Platte County",2,10,100,47,53
050,56,031,"Wyoming","Platte County",2,11,103,51,52
050,56,031,"Wyoming","Platte County",2,12,110,57,53
050,56,031,"Wyoming","Platte County",2,13,117,61,56
050,56,031,"Wyoming","Platte County",2,14,111,56,55
050,56,031,"Wyoming","Platte County",2,15,103,52,51
050,56,031,"Wyoming","Platte County",2,16,98,50,48
050,56,031,"Wyoming","Platte County",2,17,100,49,51
050,56,031,"Wyoming","Platte County",2,18,86,42,44
050,56,031,"Wyoming","Platte County",2,19,65,33,32
050,56,031,"Wyoming","Platte County",2,20,70,38,32
050,56,031,"Wyoming","Platte County",2,21,71,40,31
050,56,031,"Wyoming","Platte County",2,22,74,42,32
050,56,031,"Wyoming","Platte County",2,23,71,34,37
050,56,031,"Wyoming","Platte County",2,24,71,32,39
050,56,031,"Wyoming","Platte County",2,25,70,36,34
050,56,031,"Wyoming","Platte County",2,26,78,44,34
050,56,031,"Wyoming","Platte County",2,27,83,43,40
050,56,031,"Wyoming","Platte County",2,28,94,49,45
050,56,031,"Wyoming","Platte County",2,29,92,46,46
050,56,031,"Wyoming","Platte County",2,30,81,40,41
050,56,031,"Wyoming","Platte County",2,31,78,45,33
050,56,031,"Wyoming","Platte County",2,32,81,43,38
050,56,031,"Wyoming","Platte County",2,33,89,50,39
050,56,031,"Wyoming","Platte County",2,34,98,51,47
050,56,031,"Wyoming","Platte County",2,35,102,44,58
050,56,031,"Wyoming","Platte County",2,36,107,50,57
050,56,031,"Wyoming","Platte County",2,37,108,53,55
050,56,031,"Wyoming","Platte County",2,38,96,51,45
050,56,031,"Wyoming","Platte County",2,39,87,47,40
050,56,031,"Wyoming","Platte County",2,40,88,52,36
050,56,031,"Wyoming","Platte County",2,41,88,51,37
050,56,031,"Wyoming","Platte County",2,42,81,41,40
050,56,031,"Wyoming","Platte County",2,43,86,38,48
050,56,031,"Wyoming","Platte County",2,44,88,39,49
050,56,031,"Wyoming","Platte County",2,45,95,50,45
050,56,031,"Wyoming","Platte County",2,46,92,52,40
050,56,031,"Wyoming","Platte County",2,47,82,42,40
050,56,031,"Wyoming","Platte County",2,48,87,41,46
050,56,031,"Wyoming","Platte County",2,49,103,47,56
050,56,031,"Wyoming","Platte County",2,50,98,46,52
050,56,031,"Wyoming","Platte County",2,51,94,47,47
050,56,031,"Wyoming","Platte County",2,52,103,53,50
050,56,031,"Wyoming","Platte County",2,53,106,54,52
050,56,031,"Wyoming","Platte County",2,54,118,61,57
050,56,031,"Wyoming","Platte County",2,55,119,62,57
050,56,031,"Wyoming","Platte County",2,56,117,63,54
050,56,031,"Wyoming","Platte County",2,57,124,63,61
050,56,031,"Wyoming","Platte County",2,58,127,63,64
050,56,031,"Wyoming","Platte County",2,59,133,62,71
050,56,031,"Wyoming","Platte County",2,60,144,66,78
050,56,031,"Wyoming","Platte County",2,61,145,71,74
050,56,031,"Wyoming","Platte County",2,62,136,75,61
050,56,031,"Wyoming","Platte County",2,63,135,76,59
050,56,031,"Wyoming","Platte County",2,64,136,74,62
050,56,031,"Wyoming","Platte County",2,65,137,66,71
050,56,031,"Wyoming","Platte County",2,66,131,66,65
050,56,031,"Wyoming","Platte County",2,67,122,65,57
050,56,031,"Wyoming","Platte County",2,68,124,61,63
050,56,031,"Wyoming","Platte County",2,69,141,69,72
050,56,031,"Wyoming","Platte County",2,70,126,69,57
050,56,031,"Wyoming","Platte County",2,71,131,72,59
050,56,031,"Wyoming","Platte County",2,72,133,64,69
050,56,031,"Wyoming","Platte County",2,73,133,66,67
050,56,031,"Wyoming","Platte County",2,74,90,42,48
050,56,031,"Wyoming","Platte County",2,75,101,49,52
050,56,031,"Wyoming","Platte County",2,76,97,53,44
050,56,031,"Wyoming","Platte County",2,77,94,52,42
050,56,031,"Wyoming","Platte County",2,78,79,40,39
050,56,031,"Wyoming","Platte County",2,79,70,35,35
050,56,031,"Wyoming","Platte County",2,80,63,30,33
050,56,031,"Wyoming","Platte County",2,81,61,30,31
050,56,031,"Wyoming","Platte County",2,82,60,26,34
050,56,031,"Wyoming","Platte County",2,83,49,23,26
050,56,031,"Wyoming","Platte County",2,84,43,17,26
050,56,031,"Wyoming","Platte County",2,85,257,105,152
050,56,031,"Wyoming","Platte County",3,0,78,45,33
050,56,031,"Wyoming","Platte County",3,1,90,47,43
050,56,031,"Wyoming","Platte County",3,2,85,42,43
050,56,031,"Wyoming","Platte County",3,3,94,45,49
050,56,031,"Wyoming","Platte County",3,4,97,44,53
050,56,031,"Wyoming","Platte County",3,5,98,48,50
050,56,031,"Wyoming","Platte County",3,6,104,53,51
050,56,031,"Wyoming","Platte County",3,7,89,46,43
050,56,031,"Wyoming","Platte County",3,8,107,60,47
050,56,031,"Wyoming","Platte County",3,9,114,59,55
050,56,031,"Wyoming","Platte County",3,10,108,58,50
050,56,031,"Wyoming","Platte County",3,11,95,50,45
050,56,031,"Wyoming","Platte County",3,12,106,50,56
050,56,031,"Wyoming","Platte County",3,13,113,56,57
050,56,031,"Wyoming","Platte County",3,14,110,58,52
050,56,031,"Wyoming","Platte County",3,15,103,50,53
050,56,031,"Wyoming","Platte County",3,16,110,55,55
050,56,031,"Wyoming","Platte County",3,17,97,50,47
050,56,031,"Wyoming","Platte County",3,18,83,43,40
050,56,031,"Wyoming","Platte County",3,19,69,34,35
050,56,031,"Wyoming","Platte County",3,20,65,31,34
050,56,031,"Wyoming","Platte County",3,21,73,40,33
050,56,031,"Wyoming","Platte County",3,22,81,47,34
050,56,031,"Wyoming","Platte County",3,23,74,41,33
050,56,031,"Wyoming","Platte County",3,24,74,36,38
050,56,031,"Wyoming","Platte County",3,25,70,30,40
050,56,031,"Wyoming","Platte County",3,26,79,42,37
050,56,031,"Wyoming","Platte County",3,27,88,49,39
050,56,031,"Wyoming","Platte County",3,28,89,45,44
050,56,031,"Wyoming","Platte County",3,29,93,51,42
050,56,031,"Wyoming","Platte County",3,30,97,50,47
050,56,031,"Wyoming","Platte County",3,31,82,44,38
050,56,031,"Wyoming","Platte County",3,32,85,50,35
050,56,031,"Wyoming","Platte County",3,33,77,43,34
050,56,031,"Wyoming","Platte County",3,34,92,50,42
050,56,031,"Wyoming","Platte County",3,35,97,51,46
050,56,031,"Wyoming","Platte County",3,36,100,43,57
050,56,031,"Wyoming","Platte County",3,37,104,49,55
050,56,031,"Wyoming","Platte County",3,38,104,49,55
050,56,031,"Wyoming","Platte County",3,39,98,51,47
050,56,031,"Wyoming","Platte County",3,40,81,42,39
050,56,031,"Wyoming","Platte County",3,41,86,49,37
050,56,031,"Wyoming","Platte County",3,42,88,55,33
050,56,031,"Wyoming","Platte County",3,43,85,45,40
050,56,031,"Wyoming","Platte County",3,44,88,40,48
050,56,031,"Wyoming","Platte County",3,45,95,45,50
050,56,031,"Wyoming","Platte County",3,46,89,47,42
050,56,031,"Wyoming","Platte County",3,47,88,47,41
050,56,031,"Wyoming","Platte County",3,48,85,45,40
050,56,031,"Wyoming","Platte County",3,49,90,42,48
050,56,031,"Wyoming","Platte County",3,50,100,45,55
050,56,031,"Wyoming","Platte County",3,51,95,49,46
050,56,031,"Wyoming","Platte County",3,52,94,44,50
050,56,031,"Wyoming","Platte County",3,53,109,58,51
050,56,031,"Wyoming","Platte County",3,54,108,55,53
050,56,031,"Wyoming","Platte County",3,55,116,59,57
050,56,031,"Wyoming","Platte County",3,56,117,58,59
050,56,031,"Wyoming","Platte County",3,57,117,62,55
050,56,031,"Wyoming","Platte County",3,58,132,70,62
050,56,031,"Wyoming","Platte County",3,59,131,66,65
050,56,031,"Wyoming","Platte County",3,60,135,59,76
050,56,031,"Wyoming","Platte County",3,61,147,71,76
050,56,031,"Wyoming","Platte County",3,62,139,71,68
050,56,031,"Wyoming","Platte County",3,63,140,75,65
050,56,031,"Wyoming","Platte County",3,64,143,81,62
050,56,031,"Wyoming","Platte County",3,65,137,75,62
050,56,031,"Wyoming","Platte County",3,66,136,61,75
050,56,031,"Wyoming","Platte County",3,67,132,68,64
050,56,031,"Wyoming","Platte County",3,68,125,67,58
050,56,031,"Wyoming","Platte County",3,69,122,62,60
050,56,031,"Wyoming","Platte County",3,70,144,71,73
050,56,031,"Wyoming","Platte County",3,71,126,68,58
050,56,031,"Wyoming","Platte County",3,72,129,72,57
050,56,031,"Wyoming","Platte County",3,73,134,65,69
050,56,031,"Wyoming","Platte County",3,74,128,63,65
050,56,031,"Wyoming","Platte County",3,75,86,40,46
050,56,031,"Wyoming","Platte County",3,76,99,49,50
050,56,031,"Wyoming","Platte County",3,77,95,52,43
050,56,031,"Wyoming","Platte County",3,78,90,51,39
050,56,031,"Wyoming","Platte County",3,79,75,37,38
050,56,031,"Wyoming","Platte County",3,80,69,35,34
050,56,031,"Wyoming","Platte County",3,81,57,26,31
050,56,031,"Wyoming","Platte County",3,82,58,30,28
050,56,031,"Wyoming","Platte County",3,83,54,21,33
050,56,031,"Wyoming","Platte County",3,84,50,23,27
050,56,031,"Wyoming","Platte County",3,85,261,106,155
050,56,031,"Wyoming","Platte County",4,0,74,43,31
050,56,031,"Wyoming","Platte County",4,1,83,47,36
050,56,031,"Wyoming","Platte County",4,2,96,50,46
050,56,031,"Wyoming","Platte County",4,3,85,45,40
050,56,031,"Wyoming","Platte County",4,4,105,53,52
050,56,031,"Wyoming","Platte County",4,5,94,43,51
050,56,031,"Wyoming","Platte County",4,6,101,49,52
050,56,031,"Wyoming","Platte County",4,7,100,51,49
050,56,031,"Wyoming","Platte County",4,8,96,45,51
050,56,031,"Wyoming","Platte County",4,9,108,61,47
050,56,031,"Wyoming","Platte County",4,10,111,57,54
050,56,031,"Wyoming","Platte County",4,11,111,61,50
050,56,031,"Wyoming","Platte County",4,12,90,45,45
050,56,031,"Wyoming","Platte County",4,13,104,53,51
050,56,031,"Wyoming","Platte County",4,14,116,60,56
050,56,031,"Wyoming","Platte County",4,15,114,60,54
050,56,031,"Wyoming","Platte County",4,16,107,55,52
050,56,031,"Wyoming","Platte County",4,17,97,50,47
050,56,031,"Wyoming","Platte County",4,18,84,45,39
050,56,031,"Wyoming","Platte County",4,19,64,34,30
050,56,031,"Wyoming","Platte County",4,20,75,38,37
050,56,031,"Wyoming","Platte County",4,21,68,34,34
050,56,031,"Wyoming","Platte County",4,22,68,35,33
050,56,031,"Wyoming","Platte County",4,23,85,44,41
050,56,031,"Wyoming","Platte County",4,24,71,38,33
050,56,031,"Wyoming","Platte County",4,25,71,34,37
050,56,031,"Wyoming","Platte County",4,26,76,32,44
050,56,031,"Wyoming","Platte County",4,27,84,46,38
050,56,031,"Wyoming","Platte County",4,28,91,56,35
050,56,031,"Wyoming","Platte County",4,29,84,43,41
050,56,031,"Wyoming","Platte County",4,30,101,53,48
050,56,031,"Wyoming","Platte County",4,31,97,49,48
050,56,031,"Wyoming","Platte County",4,32,89,47,42
050,56,031,"Wyoming","Platte County",4,33,83,49,34
050,56,031,"Wyoming","Platte County",4,34,68,36,32
050,56,031,"Wyoming","Platte County",4,35,94,47,47
050,56,031,"Wyoming","Platte County",4,36,96,52,44
050,56,031,"Wyoming","Platte County",4,37,104,46,58
050,56,031,"Wyoming","Platte County",4,38,100,48,52
050,56,031,"Wyoming","Platte County",4,39,108,53,55
050,56,031,"Wyoming","Platte County",4,40,97,49,48
050,56,031,"Wyoming","Platte County",4,41,77,40,37
050,56,031,"Wyoming","Platte County",4,42,83,47,36
050,56,031,"Wyoming","Platte County",4,43,86,54,32
050,56,031,"Wyoming","Platte County",4,44,84,45,39
050,56,031,"Wyoming","Platte County",4,45,90,41,49
050,56,031,"Wyoming","Platte County",4,46,95,46,49
050,56,031,"Wyoming","Platte County",4,47,85,43,42
050,56,031,"Wyoming","Platte County",4,48,87,45,42
050,56,031,"Wyoming","Platte County",4,49,89,47,42
050,56,031,"Wyoming","Platte County",4,50,93,42,51
050,56,031,"Wyoming","Platte County",4,51,107,50,57
050,56,031,"Wyoming","Platte County",4,52,100,50,50
050,56,031,"Wyoming","Platte County",4,53,90,42,48
050,56,031,"Wyoming","Platte County",4,54,108,57,51
050,56,031,"Wyoming","Platte County",4,55,109,54,55
050,56,031,"Wyoming","Platte County",4,56,125,63,62
050,56,031,"Wyoming","Platte County",4,57,116,59,57
050,56,031,"Wyoming","Platte County",4,58,120,63,57
050,56,031,"Wyoming","Platte County",4,59,137,72,65
050,56,031,"Wyoming","Platte County",4,60,133,61,72
050,56,031,"Wyoming","Platte County",4,61,135,60,75
050,56,031,"Wyoming","Platte County",4,62,142,71,71
050,56,031,"Wyoming","Platte County",4,63,145,76,69
050,56,031,"Wyoming","Platte County",4,64,139,76,63
050,56,031,"Wyoming","Platte County",4,65,143,78,65
050,56,031,"Wyoming","Platte County",4,66,131,69,62
050,56,031,"Wyoming","Platte County",4,67,138,66,72
050,56,031,"Wyoming","Platte County",4,68,131,65,66
050,56,031,"Wyoming","Platte County",4,69,129,68,61
050,56,031,"Wyoming","Platte County",4,70,119,61,58
050,56,031,"Wyoming","Platte County",4,71,139,69,70
050,56,031,"Wyoming","Platte County",4,72,125,66,59
050,56,031,"Wyoming","Platte County",4,73,126,71,55
050,56,031,"Wyoming","Platte County",4,74,130,63,67
050,56,031,"Wyoming","Platte County",4,75,121,61,60
050,56,031,"Wyoming","Platte County",4,76,87,40,47
050,56,031,"Wyoming","Platte County",4,77,92,46,46
050,56,031,"Wyoming","Platte County",4,78,93,50,43
050,56,031,"Wyoming","Platte County",4,79,87,49,38
050,56,031,"Wyoming","Platte County",4,80,64,30,34
050,56,031,"Wyoming","Platte County",4,81,63,34,29
050,56,031,"Wyoming","Platte County",4,82,51,23,28
050,56,031,"Wyoming","Platte County",4,83,45,23,22
050,56,031,"Wyoming","Platte County",4,84,51,20,31
050,56,031,"Wyoming","Platte County",4,85,262,106,156
050,56,031,"Wyoming","Platte County",5,0,69,41,28
050,56,031,"Wyoming","Platte County",5,1,84,44,40
050,56,031,"Wyoming","Platte County",5,2,73,44,29
050,56,031,"Wyoming","Platte County",5,3,99,50,49
050,56,031,"Wyoming","Platte County",5,4,87,42,45
050,56,031,"Wyoming","Platte County",5,5,107,53,54
050,56,031,"Wyoming","Platte County",5,6,91,42,49
050,56,031,"Wyoming","Platte County",5,7,89,47,42
050,56,031,"Wyoming","Platte County",5,8,104,51,53
050,56,031,"Wyoming","Platte County",5,9,92,41,51
050,56,031,"Wyoming","Platte County",5,10,105,56,49
050,56,031,"Wyoming","Platte County",5,11,106,56,50
050,56,031,"Wyoming","Platte County",5,12,106,57,49
050,56,031,"Wyoming","Platte County",5,13,88,45,43
050,56,031,"Wyoming","Platte County",5,14,96,50,46
050,56,031,"Wyoming","Platte County",5,15,110,54,56
050,56,031,"Wyoming","Platte County",5,16,109,56,53
050,56,031,"Wyoming","Platte County",5,17,102,50,52
050,56,031,"Wyoming","Platte County",5,18,72,40,32
050,56,031,"Wyoming","Platte County",5,19,63,34,29
050,56,031,"Wyoming","Platte County",5,20,63,34,29
050,56,031,"Wyoming","Platte County",5,21,74,37,37
050,56,031,"Wyoming","Platte County",5,22,76,40,36
050,56,031,"Wyoming","Platte County",5,23,66,32,34
050,56,031,"Wyoming","Platte County",5,24,83,47,36
050,56,031,"Wyoming","Platte County",5,25,78,42,36
050,56,031,"Wyoming","Platte County",5,26,62,32,30
050,56,031,"Wyoming","Platte County",5,27,81,36,45
050,56,031,"Wyoming","Platte County",5,28,93,51,42
050,56,031,"Wyoming","Platte County",5,29,95,55,40
050,56,031,"Wyoming","Platte County",5,30,78,41,37
050,56,031,"Wyoming","Platte County",5,31,110,57,53
050,56,031,"Wyoming","Platte County",5,32,110,53,57
050,56,031,"Wyoming","Platte County",5,33,85,41,44
050,56,031,"Wyoming","Platte County",5,34,84,48,36
050,56,031,"Wyoming","Platte County",5,35,70,38,32
050,56,031,"Wyoming","Platte County",5,36,102,54,48
050,56,031,"Wyoming","Platte County",5,37,93,48,45
050,56,031,"Wyoming","Platte County",5,38,97,42,55
050,56,031,"Wyoming","Platte County",5,39,103,53,50
050,56,031,"Wyoming","Platte County",5,40,97,46,51
050,56,031,"Wyoming","Platte County",5,41,99,49,50
050,56,031,"Wyoming","Platte County",5,42,73,34,39
050,56,031,"Wyoming","Platte County",5,43,92,53,39
050,56,031,"Wyoming","Platte County",5,44,87,55,32
050,56,031,"Wyoming","Platte County",5,45,85,45,40
050,56,031,"Wyoming","Platte County",5,46,91,43,48
050,56,031,"Wyoming","Platte County",5,47,96,46,50
050,56,031,"Wyoming","Platte County",5,48,77,36,41
050,56,031,"Wyoming","Platte County",5,49,84,45,39
050,56,031,"Wyoming","Platte County",5,50,90,45,45
050,56,031,"Wyoming","Platte County",5,51,94,43,51
050,56,031,"Wyoming","Platte County",5,52,107,49,58
050,56,031,"Wyoming","Platte County",5,53,94,48,46
050,56,031,"Wyoming","Platte County",5,54,87,44,43
050,56,031,"Wyoming","Platte County",5,55,104,54,50
050,56,031,"Wyoming","Platte County",5,56,110,54,56
050,56,031,"Wyoming","Platte County",5,57,130,69,61
050,56,031,"Wyoming","Platte County",5,58,118,59,59
050,56,031,"Wyoming","Platte County",5,59,128,63,65
050,56,031,"Wyoming","Platte County",5,60,136,68,68
050,56,031,"Wyoming","Platte County",5,61,126,58,68
050,56,031,"Wyoming","Platte County",5,62,134,58,76
050,56,031,"Wyoming","Platte County",5,63,138,73,65
050,56,031,"Wyoming","Platte County",5,64,151,77,74
050,56,031,"Wyoming","Platte County",5,65,139,72,67
050,56,031,"Wyoming","Platte County",5,66,138,74,64
050,56,031,"Wyoming","Platte County",5,67,139,73,66
050,56,031,"Wyoming","Platte County",5,68,138,66,72
050,56,031,"Wyoming","Platte County",5,69,134,68,66
050,56,031,"Wyoming","Platte County",5,70,128,66,62
050,56,031,"Wyoming","Platte County",5,71,115,60,55
050,56,031,"Wyoming","Platte County",5,72,134,68,66
050,56,031,"Wyoming","Platte County",5,73,121,63,58
050,56,031,"Wyoming","Platte County",5,74,122,67,55
050,56,031,"Wyoming","Platte County",5,75,124,62,62
050,56,031,"Wyoming","Platte County",5,76,123,62,61
050,56,031,"Wyoming","Platte County",5,77,81,37,44
050,56,031,"Wyoming","Platte County",5,78,83,44,39
050,56,031,"Wyoming","Platte County",5,79,87,46,41
050,56,031,"Wyoming","Platte County",5,80,81,45,36
050,56,031,"Wyoming","Platte County",5,81,59,26,33
050,56,031,"Wyoming","Platte County",5,82,57,32,25
050,56,031,"Wyoming","Platte County",5,83,41,17,24
050,56,031,"Wyoming","Platte County",5,84,43,21,22
050,56,031,"Wyoming","Platte County",5,85,276,113,163
050,56,033,"Wyoming","Sheridan County",1,0,294,152,142
050,56,033,"Wyoming","Sheridan County",1,1,304,153,151
050,56,033,"Wyoming","Sheridan County",1,2,294,139,155
050,56,033,"Wyoming","Sheridan County",1,3,310,164,146
050,56,033,"Wyoming","Sheridan County",1,4,343,187,156
050,56,033,"Wyoming","Sheridan County",1,5,343,179,164
050,56,033,"Wyoming","Sheridan County",1,6,357,179,178
050,56,033,"Wyoming","Sheridan County",1,7,340,173,167
050,56,033,"Wyoming","Sheridan County",1,8,364,205,159
050,56,033,"Wyoming","Sheridan County",1,9,378,203,175
050,56,033,"Wyoming","Sheridan County",1,10,415,207,208
050,56,033,"Wyoming","Sheridan County",1,11,398,190,208
050,56,033,"Wyoming","Sheridan County",1,12,443,230,213
050,56,033,"Wyoming","Sheridan County",1,13,426,221,205
050,56,033,"Wyoming","Sheridan County",1,14,413,213,200
050,56,033,"Wyoming","Sheridan County",1,15,378,199,179
050,56,033,"Wyoming","Sheridan County",1,16,407,220,187
050,56,033,"Wyoming","Sheridan County",1,17,382,197,185
050,56,033,"Wyoming","Sheridan County",1,18,347,168,179
050,56,033,"Wyoming","Sheridan County",1,19,368,184,184
050,56,033,"Wyoming","Sheridan County",1,20,361,189,172
050,56,033,"Wyoming","Sheridan County",1,21,277,141,136
050,56,033,"Wyoming","Sheridan County",1,22,312,161,151
050,56,033,"Wyoming","Sheridan County",1,23,332,165,167
050,56,033,"Wyoming","Sheridan County",1,24,316,154,162
050,56,033,"Wyoming","Sheridan County",1,25,307,158,149
050,56,033,"Wyoming","Sheridan County",1,26,319,167,152
050,56,033,"Wyoming","Sheridan County",1,27,362,176,186
050,56,033,"Wyoming","Sheridan County",1,28,362,195,167
050,56,033,"Wyoming","Sheridan County",1,29,324,161,163
050,56,033,"Wyoming","Sheridan County",1,30,363,185,178
050,56,033,"Wyoming","Sheridan County",1,31,353,181,172
050,56,033,"Wyoming","Sheridan County",1,32,378,198,180
050,56,033,"Wyoming","Sheridan County",1,33,351,181,170
050,56,033,"Wyoming","Sheridan County",1,34,383,177,206
050,56,033,"Wyoming","Sheridan County",1,35,401,193,208
050,56,033,"Wyoming","Sheridan County",1,36,384,193,191
050,56,033,"Wyoming","Sheridan County",1,37,396,207,189
050,56,033,"Wyoming","Sheridan County",1,38,374,191,183
050,56,033,"Wyoming","Sheridan County",1,39,377,193,184
050,56,033,"Wyoming","Sheridan County",1,40,413,209,204
050,56,033,"Wyoming","Sheridan County",1,41,387,199,188
050,56,033,"Wyoming","Sheridan County",1,42,375,187,188
050,56,033,"Wyoming","Sheridan County",1,43,376,191,185
050,56,033,"Wyoming","Sheridan County",1,44,361,196,165
050,56,033,"Wyoming","Sheridan County",1,45,351,180,171
050,56,033,"Wyoming","Sheridan County",1,46,321,166,155
050,56,033,"Wyoming","Sheridan County",1,47,333,172,161
050,56,033,"Wyoming","Sheridan County",1,48,358,190,168
050,56,033,"Wyoming","Sheridan County",1,49,400,215,185
050,56,033,"Wyoming","Sheridan County",1,50,386,196,190
050,56,033,"Wyoming","Sheridan County",1,51,355,191,164
050,56,033,"Wyoming","Sheridan County",1,52,328,163,165
050,56,033,"Wyoming","Sheridan County",1,53,338,158,180
050,56,033,"Wyoming","Sheridan County",1,54,365,180,185
050,56,033,"Wyoming","Sheridan County",1,55,384,183,201
050,56,033,"Wyoming","Sheridan County",1,56,391,196,195
050,56,033,"Wyoming","Sheridan County",1,57,415,218,197
050,56,033,"Wyoming","Sheridan County",1,58,431,209,222
050,56,033,"Wyoming","Sheridan County",1,59,445,212,233
050,56,033,"Wyoming","Sheridan County",1,60,449,205,244
050,56,033,"Wyoming","Sheridan County",1,61,459,222,237
050,56,033,"Wyoming","Sheridan County",1,62,468,233,235
050,56,033,"Wyoming","Sheridan County",1,63,521,253,268
050,56,033,"Wyoming","Sheridan County",1,64,500,237,263
050,56,033,"Wyoming","Sheridan County",1,65,505,244,261
050,56,033,"Wyoming","Sheridan County",1,66,497,247,250
050,56,033,"Wyoming","Sheridan County",1,67,480,247,233
050,56,033,"Wyoming","Sheridan County",1,68,464,239,225
050,56,033,"Wyoming","Sheridan County",1,69,430,220,210
050,56,033,"Wyoming","Sheridan County",1,70,421,226,195
050,56,033,"Wyoming","Sheridan County",1,71,385,205,180
050,56,033,"Wyoming","Sheridan County",1,72,361,184,177
050,56,033,"Wyoming","Sheridan County",1,73,347,186,161
050,56,033,"Wyoming","Sheridan County",1,74,255,128,127
050,56,033,"Wyoming","Sheridan County",1,75,261,121,140
050,56,033,"Wyoming","Sheridan County",1,76,260,118,142
050,56,033,"Wyoming","Sheridan County",1,77,251,130,121
050,56,033,"Wyoming","Sheridan County",1,78,218,110,108
050,56,033,"Wyoming","Sheridan County",1,79,185,83,102
050,56,033,"Wyoming","Sheridan County",1,80,181,83,98
050,56,033,"Wyoming","Sheridan County",1,81,160,74,86
050,56,033,"Wyoming","Sheridan County",1,82,139,64,75
050,56,033,"Wyoming","Sheridan County",1,83,119,60,59
050,56,033,"Wyoming","Sheridan County",1,84,96,44,52
050,56,033,"Wyoming","Sheridan County",1,85,656,250,406
050,56,033,"Wyoming","Sheridan County",2,0,298,146,152
050,56,033,"Wyoming","Sheridan County",2,1,303,153,150
050,56,033,"Wyoming","Sheridan County",2,2,298,144,154
050,56,033,"Wyoming","Sheridan County",2,3,307,159,148
050,56,033,"Wyoming","Sheridan County",2,4,336,181,155
050,56,033,"Wyoming","Sheridan County",2,5,345,182,163
050,56,033,"Wyoming","Sheridan County",2,6,352,179,173
050,56,033,"Wyoming","Sheridan County",2,7,346,177,169
050,56,033,"Wyoming","Sheridan County",2,8,359,196,163
050,56,033,"Wyoming","Sheridan County",2,9,375,204,171
050,56,033,"Wyoming","Sheridan County",2,10,406,207,199
050,56,033,"Wyoming","Sheridan County",2,11,403,197,206
050,56,033,"Wyoming","Sheridan County",2,12,431,220,211
050,56,033,"Wyoming","Sheridan County",2,13,432,225,207
050,56,033,"Wyoming","Sheridan County",2,14,416,215,201
050,56,033,"Wyoming","Sheridan County",2,15,388,204,184
050,56,033,"Wyoming","Sheridan County",2,16,402,215,187
050,56,033,"Wyoming","Sheridan County",2,17,388,202,186
050,56,033,"Wyoming","Sheridan County",2,18,344,168,176
050,56,033,"Wyoming","Sheridan County",2,19,370,186,184
050,56,033,"Wyoming","Sheridan County",2,20,359,186,173
050,56,033,"Wyoming","Sheridan County",2,21,288,147,141
050,56,033,"Wyoming","Sheridan County",2,22,308,159,149
050,56,033,"Wyoming","Sheridan County",2,23,332,167,165
050,56,033,"Wyoming","Sheridan County",2,24,321,159,162
050,56,033,"Wyoming","Sheridan County",2,25,312,159,153
050,56,033,"Wyoming","Sheridan County",2,26,321,166,155
050,56,033,"Wyoming","Sheridan County",2,27,351,173,178
050,56,033,"Wyoming","Sheridan County",2,28,362,190,172
050,56,033,"Wyoming","Sheridan County",2,29,336,170,166
050,56,033,"Wyoming","Sheridan County",2,30,358,182,176
050,56,033,"Wyoming","Sheridan County",2,31,360,183,177
050,56,033,"Wyoming","Sheridan County",2,32,373,194,179
050,56,033,"Wyoming","Sheridan County",2,33,358,185,173
050,56,033,"Wyoming","Sheridan County",2,34,373,178,195
050,56,033,"Wyoming","Sheridan County",2,35,401,193,208
050,56,033,"Wyoming","Sheridan County",2,36,387,191,196
050,56,033,"Wyoming","Sheridan County",2,37,395,205,190
050,56,033,"Wyoming","Sheridan County",2,38,381,197,184
050,56,033,"Wyoming","Sheridan County",2,39,378,194,184
050,56,033,"Wyoming","Sheridan County",2,40,407,208,199
050,56,033,"Wyoming","Sheridan County",2,41,396,202,194
050,56,033,"Wyoming","Sheridan County",2,42,379,190,189
050,56,033,"Wyoming","Sheridan County",2,43,378,191,187
050,56,033,"Wyoming","Sheridan County",2,44,361,193,168
050,56,033,"Wyoming","Sheridan County",2,45,355,186,169
050,56,033,"Wyoming","Sheridan County",2,46,329,170,159
050,56,033,"Wyoming","Sheridan County",2,47,331,172,159
050,56,033,"Wyoming","Sheridan County",2,48,354,188,166
050,56,033,"Wyoming","Sheridan County",2,49,393,211,182
050,56,033,"Wyoming","Sheridan County",2,50,390,201,189
050,56,033,"Wyoming","Sheridan County",2,51,361,189,172
050,56,033,"Wyoming","Sheridan County",2,52,336,170,166
050,56,033,"Wyoming","Sheridan County",2,53,338,160,178
050,56,033,"Wyoming","Sheridan County",2,54,359,176,183
050,56,033,"Wyoming","Sheridan County",2,55,375,180,195
050,56,033,"Wyoming","Sheridan County",2,56,391,194,197
050,56,033,"Wyoming","Sheridan County",2,57,411,214,197
050,56,033,"Wyoming","Sheridan County",2,58,429,212,217
050,56,033,"Wyoming","Sheridan County",2,59,445,212,233
050,56,033,"Wyoming","Sheridan County",2,60,450,207,243
050,56,033,"Wyoming","Sheridan County",2,61,458,220,238
050,56,033,"Wyoming","Sheridan County",2,62,469,231,238
050,56,033,"Wyoming","Sheridan County",2,63,517,253,264
050,56,033,"Wyoming","Sheridan County",2,64,501,238,263
050,56,033,"Wyoming","Sheridan County",2,65,502,240,262
050,56,033,"Wyoming","Sheridan County",2,66,501,247,254
050,56,033,"Wyoming","Sheridan County",2,67,482,245,237
050,56,033,"Wyoming","Sheridan County",2,68,466,239,227
050,56,033,"Wyoming","Sheridan County",2,69,440,226,214
050,56,033,"Wyoming","Sheridan County",2,70,418,221,197
050,56,033,"Wyoming","Sheridan County",2,71,395,211,184
050,56,033,"Wyoming","Sheridan County",2,72,359,185,174
050,56,033,"Wyoming","Sheridan County",2,73,364,192,172
050,56,033,"Wyoming","Sheridan County",2,74,259,133,126
050,56,033,"Wyoming","Sheridan County",2,75,260,122,138
050,56,033,"Wyoming","Sheridan County",2,76,258,118,140
050,56,033,"Wyoming","Sheridan County",2,77,257,129,128
050,56,033,"Wyoming","Sheridan County",2,78,221,112,109
050,56,033,"Wyoming","Sheridan County",2,79,190,88,102
050,56,033,"Wyoming","Sheridan County",2,80,184,84,100
050,56,033,"Wyoming","Sheridan County",2,81,159,75,84
050,56,033,"Wyoming","Sheridan County",2,82,144,67,77
050,56,033,"Wyoming","Sheridan County",2,83,122,60,62
050,56,033,"Wyoming","Sheridan County",2,84,100,48,52
050,56,033,"Wyoming","Sheridan County",2,85,653,247,406
050,56,033,"Wyoming","Sheridan County",3,0,314,167,147
050,56,033,"Wyoming","Sheridan County",3,1,301,144,157
050,56,033,"Wyoming","Sheridan County",3,2,326,166,160
050,56,033,"Wyoming","Sheridan County",3,3,293,142,151
050,56,033,"Wyoming","Sheridan County",3,4,328,172,156
050,56,033,"Wyoming","Sheridan County",3,5,332,174,158
050,56,033,"Wyoming","Sheridan County",3,6,353,185,168
050,56,033,"Wyoming","Sheridan County",3,7,364,191,173
050,56,033,"Wyoming","Sheridan County",3,8,358,181,177
050,56,033,"Wyoming","Sheridan County",3,9,377,197,180
050,56,033,"Wyoming","Sheridan County",3,10,389,211,178
050,56,033,"Wyoming","Sheridan County",3,11,417,214,203
050,56,033,"Wyoming","Sheridan County",3,12,406,195,211
050,56,033,"Wyoming","Sheridan County",3,13,439,222,217
050,56,033,"Wyoming","Sheridan County",3,14,465,240,225
050,56,033,"Wyoming","Sheridan County",3,15,420,216,204
050,56,033,"Wyoming","Sheridan County",3,16,423,217,206
050,56,033,"Wyoming","Sheridan County",3,17,403,211,192
050,56,033,"Wyoming","Sheridan County",3,18,349,179,170
050,56,033,"Wyoming","Sheridan County",3,19,364,181,183
050,56,033,"Wyoming","Sheridan County",3,20,337,176,161
050,56,033,"Wyoming","Sheridan County",3,21,315,152,163
050,56,033,"Wyoming","Sheridan County",3,22,298,150,148
050,56,033,"Wyoming","Sheridan County",3,23,299,149,150
050,56,033,"Wyoming","Sheridan County",3,24,336,168,168
050,56,033,"Wyoming","Sheridan County",3,25,327,172,155
050,56,033,"Wyoming","Sheridan County",3,26,317,159,158
050,56,033,"Wyoming","Sheridan County",3,27,332,174,158
050,56,033,"Wyoming","Sheridan County",3,28,365,189,176
050,56,033,"Wyoming","Sheridan County",3,29,351,181,170
050,56,033,"Wyoming","Sheridan County",3,30,348,176,172
050,56,033,"Wyoming","Sheridan County",3,31,364,179,185
050,56,033,"Wyoming","Sheridan County",3,32,389,207,182
050,56,033,"Wyoming","Sheridan County",3,33,387,196,191
050,56,033,"Wyoming","Sheridan County",3,34,377,195,182
050,56,033,"Wyoming","Sheridan County",3,35,391,184,207
050,56,033,"Wyoming","Sheridan County",3,36,423,207,216
050,56,033,"Wyoming","Sheridan County",3,37,415,198,217
050,56,033,"Wyoming","Sheridan County",3,38,416,216,200
050,56,033,"Wyoming","Sheridan County",3,39,400,209,191
050,56,033,"Wyoming","Sheridan County",3,40,388,200,188
050,56,033,"Wyoming","Sheridan County",3,41,426,217,209
050,56,033,"Wyoming","Sheridan County",3,42,399,206,193
050,56,033,"Wyoming","Sheridan County",3,43,383,192,191
050,56,033,"Wyoming","Sheridan County",3,44,392,200,192
050,56,033,"Wyoming","Sheridan County",3,45,365,198,167
050,56,033,"Wyoming","Sheridan County",3,46,363,187,176
050,56,033,"Wyoming","Sheridan County",3,47,341,178,163
050,56,033,"Wyoming","Sheridan County",3,48,352,185,167
050,56,033,"Wyoming","Sheridan County",3,49,377,194,183
050,56,033,"Wyoming","Sheridan County",3,50,421,230,191
050,56,033,"Wyoming","Sheridan County",3,51,413,216,197
050,56,033,"Wyoming","Sheridan County",3,52,365,193,172
050,56,033,"Wyoming","Sheridan County",3,53,347,172,175
050,56,033,"Wyoming","Sheridan County",3,54,338,163,175
050,56,033,"Wyoming","Sheridan County",3,55,353,174,179
050,56,033,"Wyoming","Sheridan County",3,56,373,178,195
050,56,033,"Wyoming","Sheridan County",3,57,405,204,201
050,56,033,"Wyoming","Sheridan County",3,58,427,219,208
050,56,033,"Wyoming","Sheridan County",3,59,438,214,224
050,56,033,"Wyoming","Sheridan County",3,60,454,216,238
050,56,033,"Wyoming","Sheridan County",3,61,459,217,242
050,56,033,"Wyoming","Sheridan County",3,62,470,230,240
050,56,033,"Wyoming","Sheridan County",3,63,477,239,238
050,56,033,"Wyoming","Sheridan County",3,64,518,255,263
050,56,033,"Wyoming","Sheridan County",3,65,504,231,273
050,56,033,"Wyoming","Sheridan County",3,66,484,227,257
050,56,033,"Wyoming","Sheridan County",3,67,500,248,252
050,56,033,"Wyoming","Sheridan County",3,68,484,245,239
050,56,033,"Wyoming","Sheridan County",3,69,468,239,229
050,56,033,"Wyoming","Sheridan County",3,70,432,223,209
050,56,033,"Wyoming","Sheridan County",3,71,411,215,196
050,56,033,"Wyoming","Sheridan County",3,72,381,205,176
050,56,033,"Wyoming","Sheridan County",3,73,356,187,169
050,56,033,"Wyoming","Sheridan County",3,74,362,192,170
050,56,033,"Wyoming","Sheridan County",3,75,248,124,124
050,56,033,"Wyoming","Sheridan County",3,76,255,120,135
050,56,033,"Wyoming","Sheridan County",3,77,248,112,136
050,56,033,"Wyoming","Sheridan County",3,78,250,125,125
050,56,033,"Wyoming","Sheridan County",3,79,206,100,106
050,56,033,"Wyoming","Sheridan County",3,80,186,85,101
050,56,033,"Wyoming","Sheridan County",3,81,169,79,90
050,56,033,"Wyoming","Sheridan County",3,82,159,76,83
050,56,033,"Wyoming","Sheridan County",3,83,129,63,66
050,56,033,"Wyoming","Sheridan County",3,84,119,61,58
050,56,033,"Wyoming","Sheridan County",3,85,650,255,395
050,56,033,"Wyoming","Sheridan County",4,0,298,166,132
050,56,033,"Wyoming","Sheridan County",4,1,336,166,170
050,56,033,"Wyoming","Sheridan County",4,2,308,143,165
050,56,033,"Wyoming","Sheridan County",4,3,316,158,158
050,56,033,"Wyoming","Sheridan County",4,4,298,143,155
050,56,033,"Wyoming","Sheridan County",4,5,336,167,169
050,56,033,"Wyoming","Sheridan County",4,6,351,186,165
050,56,033,"Wyoming","Sheridan County",4,7,354,176,178
050,56,033,"Wyoming","Sheridan County",4,8,365,185,180
050,56,033,"Wyoming","Sheridan County",4,9,355,178,177
050,56,033,"Wyoming","Sheridan County",4,10,372,202,170
050,56,033,"Wyoming","Sheridan County",4,11,390,208,182
050,56,033,"Wyoming","Sheridan County",4,12,424,213,211
050,56,033,"Wyoming","Sheridan County",4,13,424,203,221
050,56,033,"Wyoming","Sheridan County",4,14,453,235,218
050,56,033,"Wyoming","Sheridan County",4,15,464,235,229
050,56,033,"Wyoming","Sheridan County",4,16,434,222,212
050,56,033,"Wyoming","Sheridan County",4,17,411,212,199
050,56,033,"Wyoming","Sheridan County",4,18,368,193,175
050,56,033,"Wyoming","Sheridan County",4,19,366,194,172
050,56,033,"Wyoming","Sheridan County",4,20,338,178,160
050,56,033,"Wyoming","Sheridan County",4,21,307,159,148
050,56,033,"Wyoming","Sheridan County",4,22,323,147,176
050,56,033,"Wyoming","Sheridan County",4,23,303,165,138
050,56,033,"Wyoming","Sheridan County",4,24,291,153,138
050,56,033,"Wyoming","Sheridan County",4,25,339,173,166
050,56,033,"Wyoming","Sheridan County",4,26,325,173,152
050,56,033,"Wyoming","Sheridan County",4,27,339,171,168
050,56,033,"Wyoming","Sheridan County",4,28,330,183,147
050,56,033,"Wyoming","Sheridan County",4,29,376,197,179
050,56,033,"Wyoming","Sheridan County",4,30,359,188,171
050,56,033,"Wyoming","Sheridan County",4,31,367,186,181
050,56,033,"Wyoming","Sheridan County",4,32,370,184,186
050,56,033,"Wyoming","Sheridan County",4,33,383,198,185
050,56,033,"Wyoming","Sheridan County",4,34,389,193,196
050,56,033,"Wyoming","Sheridan County",4,35,385,201,184
050,56,033,"Wyoming","Sheridan County",4,36,392,180,212
050,56,033,"Wyoming","Sheridan County",4,37,431,216,215
050,56,033,"Wyoming","Sheridan County",4,38,410,194,216
050,56,033,"Wyoming","Sheridan County",4,39,431,231,200
050,56,033,"Wyoming","Sheridan County",4,40,397,214,183
050,56,033,"Wyoming","Sheridan County",4,41,399,205,194
050,56,033,"Wyoming","Sheridan County",4,42,443,222,221
050,56,033,"Wyoming","Sheridan County",4,43,385,194,191
050,56,033,"Wyoming","Sheridan County",4,44,389,194,195
050,56,033,"Wyoming","Sheridan County",4,45,399,204,195
050,56,033,"Wyoming","Sheridan County",4,46,378,206,172
050,56,033,"Wyoming","Sheridan County",4,47,372,194,178
050,56,033,"Wyoming","Sheridan County",4,48,336,170,166
050,56,033,"Wyoming","Sheridan County",4,49,358,185,173
050,56,033,"Wyoming","Sheridan County",4,50,388,204,184
050,56,033,"Wyoming","Sheridan County",4,51,411,221,190
050,56,033,"Wyoming","Sheridan County",4,52,421,219,202
050,56,033,"Wyoming","Sheridan County",4,53,363,188,175
050,56,033,"Wyoming","Sheridan County",4,54,346,175,171
050,56,033,"Wyoming","Sheridan County",4,55,345,168,177
050,56,033,"Wyoming","Sheridan County",4,56,365,178,187
050,56,033,"Wyoming","Sheridan County",4,57,384,178,206
050,56,033,"Wyoming","Sheridan County",4,58,418,209,209
050,56,033,"Wyoming","Sheridan County",4,59,440,221,219
050,56,033,"Wyoming","Sheridan County",4,60,446,214,232
050,56,033,"Wyoming","Sheridan County",4,61,456,218,238
050,56,033,"Wyoming","Sheridan County",4,62,471,228,243
050,56,033,"Wyoming","Sheridan County",4,63,489,241,248
050,56,033,"Wyoming","Sheridan County",4,64,493,247,246
050,56,033,"Wyoming","Sheridan County",4,65,524,261,263
050,56,033,"Wyoming","Sheridan County",4,66,513,232,281
050,56,033,"Wyoming","Sheridan County",4,67,478,218,260
050,56,033,"Wyoming","Sheridan County",4,68,500,255,245
050,56,033,"Wyoming","Sheridan County",4,69,489,245,244
050,56,033,"Wyoming","Sheridan County",4,70,471,237,234
050,56,033,"Wyoming","Sheridan County",4,71,432,218,214
050,56,033,"Wyoming","Sheridan County",4,72,402,209,193
050,56,033,"Wyoming","Sheridan County",4,73,378,207,171
050,56,033,"Wyoming","Sheridan County",4,74,355,187,168
050,56,033,"Wyoming","Sheridan County",4,75,349,183,166
050,56,033,"Wyoming","Sheridan County",4,76,241,122,119
050,56,033,"Wyoming","Sheridan County",4,77,250,115,135
050,56,033,"Wyoming","Sheridan County",4,78,246,111,135
050,56,033,"Wyoming","Sheridan County",4,79,236,120,116
050,56,033,"Wyoming","Sheridan County",4,80,207,98,109
050,56,033,"Wyoming","Sheridan County",4,81,176,81,95
050,56,033,"Wyoming","Sheridan County",4,82,173,82,91
050,56,033,"Wyoming","Sheridan County",4,83,156,75,81
050,56,033,"Wyoming","Sheridan County",4,84,119,58,61
050,56,033,"Wyoming","Sheridan County",4,85,637,257,380
050,56,033,"Wyoming","Sheridan County",5,0,294,161,133
050,56,033,"Wyoming","Sheridan County",5,1,299,161,138
050,56,033,"Wyoming","Sheridan County",5,2,361,182,179
050,56,033,"Wyoming","Sheridan County",5,3,326,154,172
050,56,033,"Wyoming","Sheridan County",5,4,319,159,160
050,56,033,"Wyoming","Sheridan County",5,5,317,154,163
050,56,033,"Wyoming","Sheridan County",5,6,348,167,181
050,56,033,"Wyoming","Sheridan County",5,7,363,193,170
050,56,033,"Wyoming","Sheridan County",5,8,353,175,178
050,56,033,"Wyoming","Sheridan County",5,9,370,188,182
050,56,033,"Wyoming","Sheridan County",5,10,367,181,186
050,56,033,"Wyoming","Sheridan County",5,11,379,194,185
050,56,033,"Wyoming","Sheridan County",5,12,396,210,186
050,56,033,"Wyoming","Sheridan County",5,13,440,223,217
050,56,033,"Wyoming","Sheridan County",5,14,429,202,227
050,56,033,"Wyoming","Sheridan County",5,15,450,239,211
050,56,033,"Wyoming","Sheridan County",5,16,465,243,222
050,56,033,"Wyoming","Sheridan County",5,17,434,216,218
050,56,033,"Wyoming","Sheridan County",5,18,373,193,180
050,56,033,"Wyoming","Sheridan County",5,19,377,202,175
050,56,033,"Wyoming","Sheridan County",5,20,348,191,157
050,56,033,"Wyoming","Sheridan County",5,21,305,152,153
050,56,033,"Wyoming","Sheridan County",5,22,330,169,161
050,56,033,"Wyoming","Sheridan County",5,23,321,149,172
050,56,033,"Wyoming","Sheridan County",5,24,307,167,140
050,56,033,"Wyoming","Sheridan County",5,25,316,166,150
050,56,033,"Wyoming","Sheridan County",5,26,351,172,179
050,56,033,"Wyoming","Sheridan County",5,27,342,167,175
050,56,033,"Wyoming","Sheridan County",5,28,353,180,173
050,56,033,"Wyoming","Sheridan County",5,29,349,185,164
050,56,033,"Wyoming","Sheridan County",5,30,356,178,178
050,56,033,"Wyoming","Sheridan County",5,31,366,198,168
050,56,033,"Wyoming","Sheridan County",5,32,379,196,183
050,56,033,"Wyoming","Sheridan County",5,33,390,192,198
050,56,033,"Wyoming","Sheridan County",5,34,394,200,194
050,56,033,"Wyoming","Sheridan County",5,35,410,206,204
050,56,033,"Wyoming","Sheridan County",5,36,390,206,184
050,56,033,"Wyoming","Sheridan County",5,37,397,192,205
050,56,033,"Wyoming","Sheridan County",5,38,441,222,219
050,56,033,"Wyoming","Sheridan County",5,39,424,204,220
050,56,033,"Wyoming","Sheridan County",5,40,428,229,199
050,56,033,"Wyoming","Sheridan County",5,41,408,216,192
050,56,033,"Wyoming","Sheridan County",5,42,406,213,193
050,56,033,"Wyoming","Sheridan County",5,43,457,226,231
050,56,033,"Wyoming","Sheridan County",5,44,385,194,191
050,56,033,"Wyoming","Sheridan County",5,45,393,198,195
050,56,033,"Wyoming","Sheridan County",5,46,401,204,197
050,56,033,"Wyoming","Sheridan County",5,47,397,206,191
050,56,033,"Wyoming","Sheridan County",5,48,377,198,179
050,56,033,"Wyoming","Sheridan County",5,49,352,173,179
050,56,033,"Wyoming","Sheridan County",5,50,372,192,180
050,56,033,"Wyoming","Sheridan County",5,51,405,213,192
050,56,033,"Wyoming","Sheridan County",5,52,425,218,207
050,56,033,"Wyoming","Sheridan County",5,53,430,217,213
050,56,033,"Wyoming","Sheridan County",5,54,354,182,172
050,56,033,"Wyoming","Sheridan County",5,55,354,177,177
050,56,033,"Wyoming","Sheridan County",5,56,359,175,184
050,56,033,"Wyoming","Sheridan County",5,57,369,179,190
050,56,033,"Wyoming","Sheridan County",5,58,382,177,205
050,56,033,"Wyoming","Sheridan County",5,59,428,215,213
050,56,033,"Wyoming","Sheridan County",5,60,445,218,227
050,56,033,"Wyoming","Sheridan County",5,61,445,216,229
050,56,033,"Wyoming","Sheridan County",5,62,469,225,244
050,56,033,"Wyoming","Sheridan County",5,63,471,231,240
050,56,033,"Wyoming","Sheridan County",5,64,503,251,252
050,56,033,"Wyoming","Sheridan County",5,65,499,252,247
050,56,033,"Wyoming","Sheridan County",5,66,524,258,266
050,56,033,"Wyoming","Sheridan County",5,67,506,232,274
050,56,033,"Wyoming","Sheridan County",5,68,478,225,253
050,56,033,"Wyoming","Sheridan County",5,69,503,252,251
050,56,033,"Wyoming","Sheridan County",5,70,483,240,243
050,56,033,"Wyoming","Sheridan County",5,71,458,230,228
050,56,033,"Wyoming","Sheridan County",5,72,413,204,209
050,56,033,"Wyoming","Sheridan County",5,73,398,213,185
050,56,033,"Wyoming","Sheridan County",5,74,373,207,166
050,56,033,"Wyoming","Sheridan County",5,75,347,181,166
050,56,033,"Wyoming","Sheridan County",5,76,345,180,165
050,56,033,"Wyoming","Sheridan County",5,77,224,113,111
050,56,033,"Wyoming","Sheridan County",5,78,249,117,132
050,56,033,"Wyoming","Sheridan County",5,79,231,102,129
050,56,033,"Wyoming","Sheridan County",5,80,231,116,115
050,56,033,"Wyoming","Sheridan County",5,81,189,91,98
050,56,033,"Wyoming","Sheridan County",5,82,168,78,90
050,56,033,"Wyoming","Sheridan County",5,83,160,75,85
050,56,033,"Wyoming","Sheridan County",5,84,146,70,76
050,56,033,"Wyoming","Sheridan County",5,85,650,266,384
050,56,035,"Wyoming","Sublette County",1,0,70,36,34
050,56,035,"Wyoming","Sublette County",1,1,70,35,35
050,56,035,"Wyoming","Sublette County",1,2,94,51,43
050,56,035,"Wyoming","Sublette County",1,3,96,57,39
050,56,035,"Wyoming","Sublette County",1,4,107,63,44
050,56,035,"Wyoming","Sublette County",1,5,119,61,58
050,56,035,"Wyoming","Sublette County",1,6,101,50,51
050,56,035,"Wyoming","Sublette County",1,7,111,54,57
050,56,035,"Wyoming","Sublette County",1,8,103,55,48
050,56,035,"Wyoming","Sublette County",1,9,116,63,53
050,56,035,"Wyoming","Sublette County",1,10,119,63,56
050,56,035,"Wyoming","Sublette County",1,11,140,83,57
050,56,035,"Wyoming","Sublette County",1,12,146,78,68
050,56,035,"Wyoming","Sublette County",1,13,129,67,62
050,56,035,"Wyoming","Sublette County",1,14,114,64,50
050,56,035,"Wyoming","Sublette County",1,15,121,64,57
050,56,035,"Wyoming","Sublette County",1,16,120,69,51
050,56,035,"Wyoming","Sublette County",1,17,108,61,47
050,56,035,"Wyoming","Sublette County",1,18,92,51,41
050,56,035,"Wyoming","Sublette County",1,19,66,37,29
050,56,035,"Wyoming","Sublette County",1,20,71,37,34
050,56,035,"Wyoming","Sublette County",1,21,76,39,37
050,56,035,"Wyoming","Sublette County",1,22,69,33,36
050,56,035,"Wyoming","Sublette County",1,23,77,40,37
050,56,035,"Wyoming","Sublette County",1,24,57,23,34
050,56,035,"Wyoming","Sublette County",1,25,72,36,36
050,56,035,"Wyoming","Sublette County",1,26,72,36,36
050,56,035,"Wyoming","Sublette County",1,27,75,38,37
050,56,035,"Wyoming","Sublette County",1,28,84,44,40
050,56,035,"Wyoming","Sublette County",1,29,83,37,46
050,56,035,"Wyoming","Sublette County",1,30,77,37,40
050,56,035,"Wyoming","Sublette County",1,31,112,60,52
050,56,035,"Wyoming","Sublette County",1,32,95,53,42
050,56,035,"Wyoming","Sublette County",1,33,102,51,51
050,56,035,"Wyoming","Sublette County",1,34,116,52,64
050,56,035,"Wyoming","Sublette County",1,35,120,65,55
050,56,035,"Wyoming","Sublette County",1,36,99,55,44
050,56,035,"Wyoming","Sublette County",1,37,103,57,46
050,56,035,"Wyoming","Sublette County",1,38,117,65,52
050,56,035,"Wyoming","Sublette County",1,39,116,54,62
050,56,035,"Wyoming","Sublette County",1,40,137,67,70
050,56,035,"Wyoming","Sublette County",1,41,130,71,59
050,56,035,"Wyoming","Sublette County",1,42,123,67,56
050,56,035,"Wyoming","Sublette County",1,43,120,64,56
050,56,035,"Wyoming","Sublette County",1,44,118,65,53
050,56,035,"Wyoming","Sublette County",1,45,116,62,54
050,56,035,"Wyoming","Sublette County",1,46,110,61,49
050,56,035,"Wyoming","Sublette County",1,47,101,59,42
050,56,035,"Wyoming","Sublette County",1,48,115,66,49
050,56,035,"Wyoming","Sublette County",1,49,118,59,59
050,56,035,"Wyoming","Sublette County",1,50,110,58,52
050,56,035,"Wyoming","Sublette County",1,51,87,54,33
050,56,035,"Wyoming","Sublette County",1,52,84,48,36
050,56,035,"Wyoming","Sublette County",1,53,89,49,40
050,56,035,"Wyoming","Sublette County",1,54,105,51,54
050,56,035,"Wyoming","Sublette County",1,55,106,61,45
050,56,035,"Wyoming","Sublette County",1,56,130,72,58
050,56,035,"Wyoming","Sublette County",1,57,117,57,60
050,56,035,"Wyoming","Sublette County",1,58,127,65,62
050,56,035,"Wyoming","Sublette County",1,59,134,75,59
050,56,035,"Wyoming","Sublette County",1,60,128,73,55
050,56,035,"Wyoming","Sublette County",1,61,121,58,63
050,56,035,"Wyoming","Sublette County",1,62,131,65,66
050,56,035,"Wyoming","Sublette County",1,63,131,73,58
050,56,035,"Wyoming","Sublette County",1,64,122,60,62
050,56,035,"Wyoming","Sublette County",1,65,141,72,69
050,56,035,"Wyoming","Sublette County",1,66,137,75,62
050,56,035,"Wyoming","Sublette County",1,67,126,72,54
050,56,035,"Wyoming","Sublette County",1,68,123,68,55
050,56,035,"Wyoming","Sublette County",1,69,113,60,53
050,56,035,"Wyoming","Sublette County",1,70,113,63,50
050,56,035,"Wyoming","Sublette County",1,71,103,60,43
050,56,035,"Wyoming","Sublette County",1,72,100,52,48
050,56,035,"Wyoming","Sublette County",1,73,115,60,55
050,56,035,"Wyoming","Sublette County",1,74,92,46,46
050,56,035,"Wyoming","Sublette County",1,75,79,36,43
050,56,035,"Wyoming","Sublette County",1,76,82,45,37
050,56,035,"Wyoming","Sublette County",1,77,80,44,36
050,56,035,"Wyoming","Sublette County",1,78,69,31,38
050,56,035,"Wyoming","Sublette County",1,79,65,31,34
050,56,035,"Wyoming","Sublette County",1,80,48,24,24
050,56,035,"Wyoming","Sublette County",1,81,40,20,20
050,56,035,"Wyoming","Sublette County",1,82,29,19,10
050,56,035,"Wyoming","Sublette County",1,83,37,21,16
050,56,035,"Wyoming","Sublette County",1,84,31,15,16
050,56,035,"Wyoming","Sublette County",1,85,158,83,75
050,56,035,"Wyoming","Sublette County",2,0,82,40,42
050,56,035,"Wyoming","Sublette County",2,1,70,35,35
050,56,035,"Wyoming","Sublette County",2,2,90,48,42
050,56,035,"Wyoming","Sublette County",2,3,96,56,40
050,56,035,"Wyoming","Sublette County",2,4,104,62,42
050,56,035,"Wyoming","Sublette County",2,5,117,62,55
050,56,035,"Wyoming","Sublette County",2,6,105,53,52
050,56,035,"Wyoming","Sublette County",2,7,108,53,55
050,56,035,"Wyoming","Sublette County",2,8,103,54,49
050,56,035,"Wyoming","Sublette County",2,9,112,61,51
050,56,035,"Wyoming","Sublette County",2,10,117,63,54
050,56,035,"Wyoming","Sublette County",2,11,134,78,56
050,56,035,"Wyoming","Sublette County",2,12,146,79,67
050,56,035,"Wyoming","Sublette County",2,13,134,70,64
050,56,035,"Wyoming","Sublette County",2,14,119,65,54
050,56,035,"Wyoming","Sublette County",2,15,119,64,55
050,56,035,"Wyoming","Sublette County",2,16,117,66,51
050,56,035,"Wyoming","Sublette County",2,17,110,62,48
050,56,035,"Wyoming","Sublette County",2,18,90,51,39
050,56,035,"Wyoming","Sublette County",2,19,67,38,29
050,56,035,"Wyoming","Sublette County",2,20,71,37,34
050,56,035,"Wyoming","Sublette County",2,21,75,39,36
050,56,035,"Wyoming","Sublette County",2,22,74,36,38
050,56,035,"Wyoming","Sublette County",2,23,74,37,37
050,56,035,"Wyoming","Sublette County",2,24,64,28,36
050,56,035,"Wyoming","Sublette County",2,25,70,34,36
050,56,035,"Wyoming","Sublette County",2,26,75,37,38
050,56,035,"Wyoming","Sublette County",2,27,75,38,37
050,56,035,"Wyoming","Sublette County",2,28,81,41,40
050,56,035,"Wyoming","Sublette County",2,29,82,37,45
050,56,035,"Wyoming","Sublette County",2,30,80,39,41
050,56,035,"Wyoming","Sublette County",2,31,101,54,47
050,56,035,"Wyoming","Sublette County",2,32,96,53,43
050,56,035,"Wyoming","Sublette County",2,33,99,50,49
050,56,035,"Wyoming","Sublette County",2,34,112,52,60
050,56,035,"Wyoming","Sublette County",2,35,120,62,58
050,56,035,"Wyoming","Sublette County",2,36,106,59,47
050,56,035,"Wyoming","Sublette County",2,37,106,60,46
050,56,035,"Wyoming","Sublette County",2,38,117,65,52
050,56,035,"Wyoming","Sublette County",2,39,117,57,60
050,56,035,"Wyoming","Sublette County",2,40,133,64,69
050,56,035,"Wyoming","Sublette County",2,41,131,70,61
050,56,035,"Wyoming","Sublette County",2,42,125,69,56
050,56,035,"Wyoming","Sublette County",2,43,120,64,56
050,56,035,"Wyoming","Sublette County",2,44,116,65,51
050,56,035,"Wyoming","Sublette County",2,45,117,63,54
050,56,035,"Wyoming","Sublette County",2,46,111,61,50
050,56,035,"Wyoming","Sublette County",2,47,102,58,44
050,56,035,"Wyoming","Sublette County",2,48,113,66,47
050,56,035,"Wyoming","Sublette County",2,49,116,59,57
050,56,035,"Wyoming","Sublette County",2,50,114,59,55
050,56,035,"Wyoming","Sublette County",2,51,90,53,37
050,56,035,"Wyoming","Sublette County",2,52,82,49,33
050,56,035,"Wyoming","Sublette County",2,53,88,48,40
050,56,035,"Wyoming","Sublette County",2,54,102,51,51
050,56,035,"Wyoming","Sublette County",2,55,107,59,48
050,56,035,"Wyoming","Sublette County",2,56,124,69,55
050,56,035,"Wyoming","Sublette County",2,57,120,61,59
050,56,035,"Wyoming","Sublette County",2,58,124,63,61
050,56,035,"Wyoming","Sublette County",2,59,133,73,60
050,56,035,"Wyoming","Sublette County",2,60,129,74,55
050,56,035,"Wyoming","Sublette County",2,61,121,61,60
050,56,035,"Wyoming","Sublette County",2,62,126,63,63
050,56,035,"Wyoming","Sublette County",2,63,133,73,60
050,56,035,"Wyoming","Sublette County",2,64,123,62,61
050,56,035,"Wyoming","Sublette County",2,65,138,70,68
050,56,035,"Wyoming","Sublette County",2,66,136,73,63
050,56,035,"Wyoming","Sublette County",2,67,127,71,56
050,56,035,"Wyoming","Sublette County",2,68,123,68,55
050,56,035,"Wyoming","Sublette County",2,69,117,62,55
050,56,035,"Wyoming","Sublette County",2,70,113,63,50
050,56,035,"Wyoming","Sublette County",2,71,106,61,45
050,56,035,"Wyoming","Sublette County",2,72,100,54,46
050,56,035,"Wyoming","Sublette County",2,73,117,61,56
050,56,035,"Wyoming","Sublette County",2,74,90,45,45
050,56,035,"Wyoming","Sublette County",2,75,80,38,42
050,56,035,"Wyoming","Sublette County",2,76,80,42,38
050,56,035,"Wyoming","Sublette County",2,77,83,46,37
050,56,035,"Wyoming","Sublette County",2,78,71,34,37
050,56,035,"Wyoming","Sublette County",2,79,66,31,35
050,56,035,"Wyoming","Sublette County",2,80,51,25,26
050,56,035,"Wyoming","Sublette County",2,81,41,20,21
050,56,035,"Wyoming","Sublette County",2,82,32,19,13
050,56,035,"Wyoming","Sublette County",2,83,35,21,14
050,56,035,"Wyoming","Sublette County",2,84,32,16,16
050,56,035,"Wyoming","Sublette County",2,85,163,84,79
050,56,035,"Wyoming","Sublette County",3,0,89,42,47
050,56,035,"Wyoming","Sublette County",3,1,64,35,29
050,56,035,"Wyoming","Sublette County",3,2,67,38,29
050,56,035,"Wyoming","Sublette County",3,3,79,44,35
050,56,035,"Wyoming","Sublette County",3,4,89,48,41
050,56,035,"Wyoming","Sublette County",3,5,105,66,39
050,56,035,"Wyoming","Sublette County",3,6,108,58,50
050,56,035,"Wyoming","Sublette County",3,7,106,58,48
050,56,035,"Wyoming","Sublette County",3,8,109,52,57
050,56,035,"Wyoming","Sublette County",3,9,104,49,55
050,56,035,"Wyoming","Sublette County",3,10,119,67,52
050,56,035,"Wyoming","Sublette County",3,11,112,59,53
050,56,035,"Wyoming","Sublette County",3,12,133,77,56
050,56,035,"Wyoming","Sublette County",3,13,146,75,71
050,56,035,"Wyoming","Sublette County",3,14,130,71,59
050,56,035,"Wyoming","Sublette County",3,15,122,67,55
050,56,035,"Wyoming","Sublette County",3,16,120,64,56
050,56,035,"Wyoming","Sublette County",3,17,116,64,52
050,56,035,"Wyoming","Sublette County",3,18,100,59,41
050,56,035,"Wyoming","Sublette County",3,19,68,36,32
050,56,035,"Wyoming","Sublette County",3,20,56,31,25
050,56,035,"Wyoming","Sublette County",3,21,64,33,31
050,56,035,"Wyoming","Sublette County",3,22,71,40,31
050,56,035,"Wyoming","Sublette County",3,23,71,36,35
050,56,035,"Wyoming","Sublette County",3,24,75,37,38
050,56,035,"Wyoming","Sublette County",3,25,69,31,38
050,56,035,"Wyoming","Sublette County",3,26,69,36,33
050,56,035,"Wyoming","Sublette County",3,27,74,37,37
050,56,035,"Wyoming","Sublette County",3,28,77,40,37
050,56,035,"Wyoming","Sublette County",3,29,85,43,42
050,56,035,"Wyoming","Sublette County",3,30,88,40,48
050,56,035,"Wyoming","Sublette County",3,31,98,51,47
050,56,035,"Wyoming","Sublette County",3,32,103,53,50
050,56,035,"Wyoming","Sublette County",3,33,101,55,46
050,56,035,"Wyoming","Sublette County",3,34,106,51,55
050,56,035,"Wyoming","Sublette County",3,35,108,51,57
050,56,035,"Wyoming","Sublette County",3,36,119,60,59
050,56,035,"Wyoming","Sublette County",3,37,112,65,47
050,56,035,"Wyoming","Sublette County",3,38,103,57,46
050,56,035,"Wyoming","Sublette County",3,39,116,65,51
050,56,035,"Wyoming","Sublette County",3,40,118,57,61
050,56,035,"Wyoming","Sublette County",3,41,133,63,70
050,56,035,"Wyoming","Sublette County",3,42,124,69,55
050,56,035,"Wyoming","Sublette County",3,43,129,70,59
050,56,035,"Wyoming","Sublette County",3,44,109,53,56
050,56,035,"Wyoming","Sublette County",3,45,121,70,51
050,56,035,"Wyoming","Sublette County",3,46,113,60,53
050,56,035,"Wyoming","Sublette County",3,47,106,60,46
050,56,035,"Wyoming","Sublette County",3,48,101,56,45
050,56,035,"Wyoming","Sublette County",3,49,119,69,50
050,56,035,"Wyoming","Sublette County",3,50,117,62,55
050,56,035,"Wyoming","Sublette County",3,51,110,58,52
050,56,035,"Wyoming","Sublette County",3,52,77,40,37
050,56,035,"Wyoming","Sublette County",3,53,85,51,34
050,56,035,"Wyoming","Sublette County",3,54,93,53,40
050,56,035,"Wyoming","Sublette County",3,55,96,48,48
050,56,035,"Wyoming","Sublette County",3,56,111,58,53
050,56,035,"Wyoming","Sublette County",3,57,122,66,56
050,56,035,"Wyoming","Sublette County",3,58,109,51,58
050,56,035,"Wyoming","Sublette County",3,59,121,61,60
050,56,035,"Wyoming","Sublette County",3,60,134,74,60
050,56,035,"Wyoming","Sublette County",3,61,134,77,57
050,56,035,"Wyoming","Sublette County",3,62,123,65,58
050,56,035,"Wyoming","Sublette County",3,63,137,65,72
050,56,035,"Wyoming","Sublette County",3,64,142,81,61
050,56,035,"Wyoming","Sublette County",3,65,128,63,65
050,56,035,"Wyoming","Sublette County",3,66,141,72,69
050,56,035,"Wyoming","Sublette County",3,67,139,80,59
050,56,035,"Wyoming","Sublette County",3,68,129,72,57
050,56,035,"Wyoming","Sublette County",3,69,119,62,57
050,56,035,"Wyoming","Sublette County",3,70,119,63,56
050,56,035,"Wyoming","Sublette County",3,71,117,65,52
050,56,035,"Wyoming","Sublette County",3,72,105,61,44
050,56,035,"Wyoming","Sublette County",3,73,95,51,44
050,56,035,"Wyoming","Sublette County",3,74,122,64,58
050,56,035,"Wyoming","Sublette County",3,75,88,45,43
050,56,035,"Wyoming","Sublette County",3,76,77,39,38
050,56,035,"Wyoming","Sublette County",3,77,77,39,38
050,56,035,"Wyoming","Sublette County",3,78,80,43,37
050,56,035,"Wyoming","Sublette County",3,79,62,31,31
050,56,035,"Wyoming","Sublette County",3,80,63,30,33
050,56,035,"Wyoming","Sublette County",3,81,50,24,26
050,56,035,"Wyoming","Sublette County",3,82,39,18,21
050,56,035,"Wyoming","Sublette County",3,83,27,17,10
050,56,035,"Wyoming","Sublette County",3,84,34,20,14
050,56,035,"Wyoming","Sublette County",3,85,176,88,88
050,56,035,"Wyoming","Sublette County",4,0,82,37,45
050,56,035,"Wyoming","Sublette County",4,1,90,43,47
050,56,035,"Wyoming","Sublette County",4,2,64,36,28
050,56,035,"Wyoming","Sublette County",4,3,74,42,32
050,56,035,"Wyoming","Sublette County",4,4,83,44,39
050,56,035,"Wyoming","Sublette County",4,5,90,52,38
050,56,035,"Wyoming","Sublette County",4,6,101,64,37
050,56,035,"Wyoming","Sublette County",4,7,116,61,55
050,56,035,"Wyoming","Sublette County",4,8,109,61,48
050,56,035,"Wyoming","Sublette County",4,9,110,54,56
050,56,035,"Wyoming","Sublette County",4,10,102,51,51
050,56,035,"Wyoming","Sublette County",4,11,113,66,47
050,56,035,"Wyoming","Sublette County",4,12,114,58,56
050,56,035,"Wyoming","Sublette County",4,13,127,71,56
050,56,035,"Wyoming","Sublette County",4,14,144,75,69
050,56,035,"Wyoming","Sublette County",4,15,125,69,56
050,56,035,"Wyoming","Sublette County",4,16,126,71,55
050,56,035,"Wyoming","Sublette County",4,17,111,57,54
050,56,035,"Wyoming","Sublette County",4,18,96,52,44
050,56,035,"Wyoming","Sublette County",4,19,68,42,26
050,56,035,"Wyoming","Sublette County",4,20,63,36,27
050,56,035,"Wyoming","Sublette County",4,21,62,34,28
050,56,035,"Wyoming","Sublette County",4,22,60,30,30
050,56,035,"Wyoming","Sublette County",4,23,69,37,32
050,56,035,"Wyoming","Sublette County",4,24,71,38,33
050,56,035,"Wyoming","Sublette County",4,25,74,38,36
050,56,035,"Wyoming","Sublette County",4,26,59,29,30
050,56,035,"Wyoming","Sublette County",4,27,75,41,34
050,56,035,"Wyoming","Sublette County",4,28,85,40,45
050,56,035,"Wyoming","Sublette County",4,29,87,42,45
050,56,035,"Wyoming","Sublette County",4,30,88,43,45
050,56,035,"Wyoming","Sublette County",4,31,96,44,52
050,56,035,"Wyoming","Sublette County",4,32,98,50,48
050,56,035,"Wyoming","Sublette County",4,33,97,51,46
050,56,035,"Wyoming","Sublette County",4,34,106,59,47
050,56,035,"Wyoming","Sublette County",4,35,113,52,61
050,56,035,"Wyoming","Sublette County",4,36,121,57,64
050,56,035,"Wyoming","Sublette County",4,37,129,68,61
050,56,035,"Wyoming","Sublette County",4,38,103,59,44
050,56,035,"Wyoming","Sublette County",4,39,108,57,51
050,56,035,"Wyoming","Sublette County",4,40,118,68,50
050,56,035,"Wyoming","Sublette County",4,41,122,59,63
050,56,035,"Wyoming","Sublette County",4,42,119,57,62
050,56,035,"Wyoming","Sublette County",4,43,123,66,57
050,56,035,"Wyoming","Sublette County",4,44,129,68,61
050,56,035,"Wyoming","Sublette County",4,45,112,54,58
050,56,035,"Wyoming","Sublette County",4,46,130,76,54
050,56,035,"Wyoming","Sublette County",4,47,111,57,54
050,56,035,"Wyoming","Sublette County",4,48,104,59,45
050,56,035,"Wyoming","Sublette County",4,49,95,50,45
050,56,035,"Wyoming","Sublette County",4,50,117,67,50
050,56,035,"Wyoming","Sublette County",4,51,119,65,54
050,56,035,"Wyoming","Sublette County",4,52,103,54,49
050,56,035,"Wyoming","Sublette County",4,53,79,40,39
050,56,035,"Wyoming","Sublette County",4,54,88,53,35
050,56,035,"Wyoming","Sublette County",4,55,94,54,40
050,56,035,"Wyoming","Sublette County",4,56,99,49,50
050,56,035,"Wyoming","Sublette County",4,57,114,59,55
050,56,035,"Wyoming","Sublette County",4,58,116,64,52
050,56,035,"Wyoming","Sublette County",4,59,107,54,53
050,56,035,"Wyoming","Sublette County",4,60,121,63,58
050,56,035,"Wyoming","Sublette County",4,61,129,70,59
050,56,035,"Wyoming","Sublette County",4,62,134,76,58
050,56,035,"Wyoming","Sublette County",4,63,125,64,61
050,56,035,"Wyoming","Sublette County",4,64,146,71,75
050,56,035,"Wyoming","Sublette County",4,65,139,78,61
050,56,035,"Wyoming","Sublette County",4,66,131,64,67
050,56,035,"Wyoming","Sublette County",4,67,143,74,69
050,56,035,"Wyoming","Sublette County",4,68,139,77,62
050,56,035,"Wyoming","Sublette County",4,69,136,76,60
050,56,035,"Wyoming","Sublette County",4,70,121,64,57
050,56,035,"Wyoming","Sublette County",4,71,116,63,53
050,56,035,"Wyoming","Sublette County",4,72,112,61,51
050,56,035,"Wyoming","Sublette County",4,73,97,57,40
050,56,035,"Wyoming","Sublette County",4,74,93,51,42
050,56,035,"Wyoming","Sublette County",4,75,120,61,59
050,56,035,"Wyoming","Sublette County",4,76,87,45,42
050,56,035,"Wyoming","Sublette County",4,77,77,39,38
050,56,035,"Wyoming","Sublette County",4,78,71,35,36
050,56,035,"Wyoming","Sublette County",4,79,80,41,39
050,56,035,"Wyoming","Sublette County",4,80,64,32,32
050,56,035,"Wyoming","Sublette County",4,81,57,27,30
050,56,035,"Wyoming","Sublette County",4,82,50,25,25
050,56,035,"Wyoming","Sublette County",4,83,35,17,18
050,56,035,"Wyoming","Sublette County",4,84,27,17,10
050,56,035,"Wyoming","Sublette County",4,85,194,98,96
050,56,035,"Wyoming","Sublette County",5,0,75,35,40
050,56,035,"Wyoming","Sublette County",5,1,85,43,42
050,56,035,"Wyoming","Sublette County",5,2,90,45,45
050,56,035,"Wyoming","Sublette County",5,3,61,36,25
050,56,035,"Wyoming","Sublette County",5,4,81,45,36
050,56,035,"Wyoming","Sublette County",5,5,87,46,41
050,56,035,"Wyoming","Sublette County",5,6,93,52,41
050,56,035,"Wyoming","Sublette County",5,7,110,67,43
050,56,035,"Wyoming","Sublette County",5,8,116,62,54
050,56,035,"Wyoming","Sublette County",5,9,113,57,56
050,56,035,"Wyoming","Sublette County",5,10,115,57,58
050,56,035,"Wyoming","Sublette County",5,11,100,50,50
050,56,035,"Wyoming","Sublette County",5,12,117,65,52
050,56,035,"Wyoming","Sublette County",5,13,115,58,57
050,56,035,"Wyoming","Sublette County",5,14,137,79,58
050,56,035,"Wyoming","Sublette County",5,15,157,79,78
050,56,035,"Wyoming","Sublette County",5,16,127,71,56
050,56,035,"Wyoming","Sublette County",5,17,130,71,59
050,56,035,"Wyoming","Sublette County",5,18,99,52,47
050,56,035,"Wyoming","Sublette County",5,19,71,37,34
050,56,035,"Wyoming","Sublette County",5,20,73,43,30
050,56,035,"Wyoming","Sublette County",5,21,74,43,31
050,56,035,"Wyoming","Sublette County",5,22,58,34,24
050,56,035,"Wyoming","Sublette County",5,23,65,32,33
050,56,035,"Wyoming","Sublette County",5,24,66,39,27
050,56,035,"Wyoming","Sublette County",5,25,72,38,34
050,56,035,"Wyoming","Sublette County",5,26,80,40,40
050,56,035,"Wyoming","Sublette County",5,27,64,32,32
050,56,035,"Wyoming","Sublette County",5,28,73,37,36
050,56,035,"Wyoming","Sublette County",5,29,92,43,49
050,56,035,"Wyoming","Sublette County",5,30,82,42,40
050,56,035,"Wyoming","Sublette County",5,31,103,51,52
050,56,035,"Wyoming","Sublette County",5,32,98,43,55
050,56,035,"Wyoming","Sublette County",5,33,110,56,54
050,56,035,"Wyoming","Sublette County",5,34,102,56,46
050,56,035,"Wyoming","Sublette County",5,35,112,60,52
050,56,035,"Wyoming","Sublette County",5,36,112,52,60
050,56,035,"Wyoming","Sublette County",5,37,130,61,69
050,56,035,"Wyoming","Sublette County",5,38,136,72,64
050,56,035,"Wyoming","Sublette County",5,39,105,60,45
050,56,035,"Wyoming","Sublette County",5,40,113,60,53
050,56,035,"Wyoming","Sublette County",5,41,127,73,54
050,56,035,"Wyoming","Sublette County",5,42,133,67,66
050,56,035,"Wyoming","Sublette County",5,43,114,52,62
050,56,035,"Wyoming","Sublette County",5,44,130,71,59
050,56,035,"Wyoming","Sublette County",5,45,137,72,65
050,56,035,"Wyoming","Sublette County",5,46,115,51,64
050,56,035,"Wyoming","Sublette County",5,47,131,78,53
050,56,035,"Wyoming","Sublette County",5,48,112,57,55
050,56,035,"Wyoming","Sublette County",5,49,105,58,47
050,56,035,"Wyoming","Sublette County",5,50,100,56,44
050,56,035,"Wyoming","Sublette County",5,51,121,68,53
050,56,035,"Wyoming","Sublette County",5,52,118,63,55
050,56,035,"Wyoming","Sublette County",5,53,106,57,49
050,56,035,"Wyoming","Sublette County",5,54,80,41,39
050,56,035,"Wyoming","Sublette County",5,55,83,51,32
050,56,035,"Wyoming","Sublette County",5,56,98,54,44
050,56,035,"Wyoming","Sublette County",5,57,102,46,56
050,56,035,"Wyoming","Sublette County",5,58,110,56,54
050,56,035,"Wyoming","Sublette County",5,59,113,62,51
050,56,035,"Wyoming","Sublette County",5,60,109,57,52
050,56,035,"Wyoming","Sublette County",5,61,120,61,59
050,56,035,"Wyoming","Sublette County",5,62,134,70,64
050,56,035,"Wyoming","Sublette County",5,63,142,79,63
050,56,035,"Wyoming","Sublette County",5,64,134,68,66
050,56,035,"Wyoming","Sublette County",5,65,156,81,75
050,56,035,"Wyoming","Sublette County",5,66,143,83,60
050,56,035,"Wyoming","Sublette County",5,67,130,64,66
050,56,035,"Wyoming","Sublette County",5,68,144,75,69
050,56,035,"Wyoming","Sublette County",5,69,137,74,63
050,56,035,"Wyoming","Sublette County",5,70,131,74,57
050,56,035,"Wyoming","Sublette County",5,71,125,68,57
050,56,035,"Wyoming","Sublette County",5,72,117,61,56
050,56,035,"Wyoming","Sublette County",5,73,109,59,50
050,56,035,"Wyoming","Sublette County",5,74,94,56,38
050,56,035,"Wyoming","Sublette County",5,75,92,48,44
050,56,035,"Wyoming","Sublette County",5,76,117,57,60
050,56,035,"Wyoming","Sublette County",5,77,87,45,42
050,56,035,"Wyoming","Sublette County",5,78,72,35,37
050,56,035,"Wyoming","Sublette County",5,79,70,34,36
050,56,035,"Wyoming","Sublette County",5,80,76,40,36
050,56,035,"Wyoming","Sublette County",5,81,62,32,30
050,56,035,"Wyoming","Sublette County",5,82,55,29,26
050,56,035,"Wyoming","Sublette County",5,83,46,22,24
050,56,035,"Wyoming","Sublette County",5,84,35,17,18
050,56,035,"Wyoming","Sublette County",5,85,198,97,101
050,56,037,"Wyoming","Sweetwater County",1,0,466,240,226
050,56,037,"Wyoming","Sweetwater County",1,1,471,255,216
050,56,037,"Wyoming","Sweetwater County",1,2,529,281,248
050,56,037,"Wyoming","Sweetwater County",1,3,567,299,268
050,56,037,"Wyoming","Sweetwater County",1,4,584,313,271
050,56,037,"Wyoming","Sweetwater County",1,5,616,321,295
050,56,037,"Wyoming","Sweetwater County",1,6,581,295,286
050,56,037,"Wyoming","Sweetwater County",1,7,584,294,290
050,56,037,"Wyoming","Sweetwater County",1,8,559,301,258
050,56,037,"Wyoming","Sweetwater County",1,9,607,307,300
050,56,037,"Wyoming","Sweetwater County",1,10,680,355,325
050,56,037,"Wyoming","Sweetwater County",1,11,703,378,325
050,56,037,"Wyoming","Sweetwater County",1,12,707,362,345
050,56,037,"Wyoming","Sweetwater County",1,13,700,357,343
050,56,037,"Wyoming","Sweetwater County",1,14,695,345,350
050,56,037,"Wyoming","Sweetwater County",1,15,639,325,314
050,56,037,"Wyoming","Sweetwater County",1,16,617,321,296
050,56,037,"Wyoming","Sweetwater County",1,17,627,331,296
050,56,037,"Wyoming","Sweetwater County",1,18,565,286,279
050,56,037,"Wyoming","Sweetwater County",1,19,511,260,251
050,56,037,"Wyoming","Sweetwater County",1,20,522,263,259
050,56,037,"Wyoming","Sweetwater County",1,21,487,264,223
050,56,037,"Wyoming","Sweetwater County",1,22,458,239,219
050,56,037,"Wyoming","Sweetwater County",1,23,486,260,226
050,56,037,"Wyoming","Sweetwater County",1,24,508,265,243
050,56,037,"Wyoming","Sweetwater County",1,25,481,228,253
050,56,037,"Wyoming","Sweetwater County",1,26,482,248,234
050,56,037,"Wyoming","Sweetwater County",1,27,511,268,243
050,56,037,"Wyoming","Sweetwater County",1,28,551,266,285
050,56,037,"Wyoming","Sweetwater County",1,29,574,294,280
050,56,037,"Wyoming","Sweetwater County",1,30,558,306,252
050,56,037,"Wyoming","Sweetwater County",1,31,580,327,253
050,56,037,"Wyoming","Sweetwater County",1,32,605,329,276
050,56,037,"Wyoming","Sweetwater County",1,33,632,320,312
050,56,037,"Wyoming","Sweetwater County",1,34,642,330,312
050,56,037,"Wyoming","Sweetwater County",1,35,606,297,309
050,56,037,"Wyoming","Sweetwater County",1,36,650,338,312
050,56,037,"Wyoming","Sweetwater County",1,37,666,339,327
050,56,037,"Wyoming","Sweetwater County",1,38,655,358,297
050,56,037,"Wyoming","Sweetwater County",1,39,691,378,313
050,56,037,"Wyoming","Sweetwater County",1,40,690,342,348
050,56,037,"Wyoming","Sweetwater County",1,41,609,310,299
050,56,037,"Wyoming","Sweetwater County",1,42,609,327,282
050,56,037,"Wyoming","Sweetwater County",1,43,577,304,273
050,56,037,"Wyoming","Sweetwater County",1,44,536,288,248
050,56,037,"Wyoming","Sweetwater County",1,45,523,264,259
050,56,037,"Wyoming","Sweetwater County",1,46,517,268,249
050,56,037,"Wyoming","Sweetwater County",1,47,466,252,214
050,56,037,"Wyoming","Sweetwater County",1,48,468,260,208
050,56,037,"Wyoming","Sweetwater County",1,49,547,287,260
050,56,037,"Wyoming","Sweetwater County",1,50,519,284,235
050,56,037,"Wyoming","Sweetwater County",1,51,450,236,214
050,56,037,"Wyoming","Sweetwater County",1,52,405,214,191
050,56,037,"Wyoming","Sweetwater County",1,53,434,232,202
050,56,037,"Wyoming","Sweetwater County",1,54,454,239,215
050,56,037,"Wyoming","Sweetwater County",1,55,503,263,240
050,56,037,"Wyoming","Sweetwater County",1,56,509,264,245
050,56,037,"Wyoming","Sweetwater County",1,57,543,288,255
050,56,037,"Wyoming","Sweetwater County",1,58,532,287,245
050,56,037,"Wyoming","Sweetwater County",1,59,551,284,267
050,56,037,"Wyoming","Sweetwater County",1,60,562,293,269
050,56,037,"Wyoming","Sweetwater County",1,61,578,292,286
050,56,037,"Wyoming","Sweetwater County",1,62,595,314,281
050,56,037,"Wyoming","Sweetwater County",1,63,568,314,254
050,56,037,"Wyoming","Sweetwater County",1,64,526,292,234
050,56,037,"Wyoming","Sweetwater County",1,65,504,266,238
050,56,037,"Wyoming","Sweetwater County",1,66,484,264,220
050,56,037,"Wyoming","Sweetwater County",1,67,469,247,222
050,56,037,"Wyoming","Sweetwater County",1,68,426,218,208
050,56,037,"Wyoming","Sweetwater County",1,69,352,178,174
050,56,037,"Wyoming","Sweetwater County",1,70,355,187,168
050,56,037,"Wyoming","Sweetwater County",1,71,341,182,159
050,56,037,"Wyoming","Sweetwater County",1,72,316,167,149
050,56,037,"Wyoming","Sweetwater County",1,73,296,152,144
050,56,037,"Wyoming","Sweetwater County",1,74,210,100,110
050,56,037,"Wyoming","Sweetwater County",1,75,213,99,114
050,56,037,"Wyoming","Sweetwater County",1,76,190,87,103
050,56,037,"Wyoming","Sweetwater County",1,77,183,99,84
050,56,037,"Wyoming","Sweetwater County",1,78,170,88,82
050,56,037,"Wyoming","Sweetwater County",1,79,157,75,82
050,56,037,"Wyoming","Sweetwater County",1,80,124,59,65
050,56,037,"Wyoming","Sweetwater County",1,81,116,61,55
050,56,037,"Wyoming","Sweetwater County",1,82,108,49,59
050,56,037,"Wyoming","Sweetwater County",1,83,97,45,52
050,56,037,"Wyoming","Sweetwater County",1,84,89,40,49
050,56,037,"Wyoming","Sweetwater County",1,85,447,149,298
050,56,037,"Wyoming","Sweetwater County",2,0,457,231,226
050,56,037,"Wyoming","Sweetwater County",2,1,468,250,218
050,56,037,"Wyoming","Sweetwater County",2,2,517,276,241
050,56,037,"Wyoming","Sweetwater County",2,3,555,294,261
050,56,037,"Wyoming","Sweetwater County",2,4,585,313,272
050,56,037,"Wyoming","Sweetwater County",2,5,608,318,290
050,56,037,"Wyoming","Sweetwater County",2,6,593,304,289
050,56,037,"Wyoming","Sweetwater County",2,7,584,295,289
050,56,037,"Wyoming","Sweetwater County",2,8,566,299,267
050,56,037,"Wyoming","Sweetwater County",2,9,597,306,291
050,56,037,"Wyoming","Sweetwater County",2,10,664,344,320
050,56,037,"Wyoming","Sweetwater County",2,11,691,370,321
050,56,037,"Wyoming","Sweetwater County",2,12,707,365,342
050,56,037,"Wyoming","Sweetwater County",2,13,698,356,342
050,56,037,"Wyoming","Sweetwater County",2,14,693,345,348
050,56,037,"Wyoming","Sweetwater County",2,15,655,329,326
050,56,037,"Wyoming","Sweetwater County",2,16,623,324,299
050,56,037,"Wyoming","Sweetwater County",2,17,622,326,296
050,56,037,"Wyoming","Sweetwater County",2,18,568,293,275
050,56,037,"Wyoming","Sweetwater County",2,19,515,260,255
050,56,037,"Wyoming","Sweetwater County",2,20,522,263,259
050,56,037,"Wyoming","Sweetwater County",2,21,488,262,226
050,56,037,"Wyoming","Sweetwater County",2,22,466,246,220
050,56,037,"Wyoming","Sweetwater County",2,23,486,258,228
050,56,037,"Wyoming","Sweetwater County",2,24,505,264,241
050,56,037,"Wyoming","Sweetwater County",2,25,487,236,251
050,56,037,"Wyoming","Sweetwater County",2,26,482,242,240
050,56,037,"Wyoming","Sweetwater County",2,27,508,264,244
050,56,037,"Wyoming","Sweetwater County",2,28,544,268,276
050,56,037,"Wyoming","Sweetwater County",2,29,568,288,280
050,56,037,"Wyoming","Sweetwater County",2,30,563,304,259
050,56,037,"Wyoming","Sweetwater County",2,31,571,320,251
050,56,037,"Wyoming","Sweetwater County",2,32,596,326,270
050,56,037,"Wyoming","Sweetwater County",2,33,622,322,300
050,56,037,"Wyoming","Sweetwater County",2,34,640,325,315
050,56,037,"Wyoming","Sweetwater County",2,35,615,307,308
050,56,037,"Wyoming","Sweetwater County",2,36,636,329,307
050,56,037,"Wyoming","Sweetwater County",2,37,657,335,322
050,56,037,"Wyoming","Sweetwater County",2,38,662,357,305
050,56,037,"Wyoming","Sweetwater County",2,39,671,364,307
050,56,037,"Wyoming","Sweetwater County",2,40,691,353,338
050,56,037,"Wyoming","Sweetwater County",2,41,623,316,307
050,56,037,"Wyoming","Sweetwater County",2,42,603,318,285
050,56,037,"Wyoming","Sweetwater County",2,43,583,309,274
050,56,037,"Wyoming","Sweetwater County",2,44,545,292,253
050,56,037,"Wyoming","Sweetwater County",2,45,527,270,257
050,56,037,"Wyoming","Sweetwater County",2,46,509,262,247
050,56,037,"Wyoming","Sweetwater County",2,47,476,255,221
050,56,037,"Wyoming","Sweetwater County",2,48,470,262,208
050,56,037,"Wyoming","Sweetwater County",2,49,529,283,246
050,56,037,"Wyoming","Sweetwater County",2,50,523,284,239
050,56,037,"Wyoming","Sweetwater County",2,51,462,246,216
050,56,037,"Wyoming","Sweetwater County",2,52,414,217,197
050,56,037,"Wyoming","Sweetwater County",2,53,429,230,199
050,56,037,"Wyoming","Sweetwater County",2,54,440,232,208
050,56,037,"Wyoming","Sweetwater County",2,55,486,253,233
050,56,037,"Wyoming","Sweetwater County",2,56,508,264,244
050,56,037,"Wyoming","Sweetwater County",2,57,532,281,251
050,56,037,"Wyoming","Sweetwater County",2,58,532,284,248
050,56,037,"Wyoming","Sweetwater County",2,59,544,283,261
050,56,037,"Wyoming","Sweetwater County",2,60,554,287,267
050,56,037,"Wyoming","Sweetwater County",2,61,574,293,281
050,56,037,"Wyoming","Sweetwater County",2,62,585,305,280
050,56,037,"Wyoming","Sweetwater County",2,63,571,315,256
050,56,037,"Wyoming","Sweetwater County",2,64,528,293,235
050,56,037,"Wyoming","Sweetwater County",2,65,503,270,233
050,56,037,"Wyoming","Sweetwater County",2,66,488,266,222
050,56,037,"Wyoming","Sweetwater County",2,67,467,248,219
050,56,037,"Wyoming","Sweetwater County",2,68,433,224,209
050,56,037,"Wyoming","Sweetwater County",2,69,371,189,182
050,56,037,"Wyoming","Sweetwater County",2,70,351,182,169
050,56,037,"Wyoming","Sweetwater County",2,71,342,182,160
050,56,037,"Wyoming","Sweetwater County",2,72,318,168,150
050,56,037,"Wyoming","Sweetwater County",2,73,310,158,152
050,56,037,"Wyoming","Sweetwater County",2,74,216,106,110
050,56,037,"Wyoming","Sweetwater County",2,75,209,98,111
050,56,037,"Wyoming","Sweetwater County",2,76,191,89,102
050,56,037,"Wyoming","Sweetwater County",2,77,191,100,91
050,56,037,"Wyoming","Sweetwater County",2,78,166,89,77
050,56,037,"Wyoming","Sweetwater County",2,79,157,76,81
050,56,037,"Wyoming","Sweetwater County",2,80,132,62,70
050,56,037,"Wyoming","Sweetwater County",2,81,113,57,56
050,56,037,"Wyoming","Sweetwater County",2,82,110,52,58
050,56,037,"Wyoming","Sweetwater County",2,83,94,43,51
050,56,037,"Wyoming","Sweetwater County",2,84,91,42,49
050,56,037,"Wyoming","Sweetwater County",2,85,451,150,301
050,56,037,"Wyoming","Sweetwater County",3,0,451,241,210
050,56,037,"Wyoming","Sweetwater County",3,1,446,217,229
050,56,037,"Wyoming","Sweetwater County",3,2,466,253,213
050,56,037,"Wyoming","Sweetwater County",3,3,485,257,228
050,56,037,"Wyoming","Sweetwater County",3,4,550,293,257
050,56,037,"Wyoming","Sweetwater County",3,5,562,304,258
050,56,037,"Wyoming","Sweetwater County",3,6,603,318,285
050,56,037,"Wyoming","Sweetwater County",3,7,591,307,284
050,56,037,"Wyoming","Sweetwater County",3,8,585,295,290
050,56,037,"Wyoming","Sweetwater County",3,9,551,287,264
050,56,037,"Wyoming","Sweetwater County",3,10,594,299,295
050,56,037,"Wyoming","Sweetwater County",3,11,650,335,315
050,56,037,"Wyoming","Sweetwater County",3,12,669,355,314
050,56,037,"Wyoming","Sweetwater County",3,13,684,359,325
050,56,037,"Wyoming","Sweetwater County",3,14,688,358,330
050,56,037,"Wyoming","Sweetwater County",3,15,691,342,349
050,56,037,"Wyoming","Sweetwater County",3,16,635,325,310
050,56,037,"Wyoming","Sweetwater County",3,17,613,319,294
050,56,037,"Wyoming","Sweetwater County",3,18,554,294,260
050,56,037,"Wyoming","Sweetwater County",3,19,508,256,252
050,56,037,"Wyoming","Sweetwater County",3,20,512,257,255
050,56,037,"Wyoming","Sweetwater County",3,21,473,242,231
050,56,037,"Wyoming","Sweetwater County",3,22,471,252,219
050,56,037,"Wyoming","Sweetwater County",3,23,483,253,230
050,56,037,"Wyoming","Sweetwater County",3,24,472,248,224
050,56,037,"Wyoming","Sweetwater County",3,25,478,247,231
050,56,037,"Wyoming","Sweetwater County",3,26,480,225,255
050,56,037,"Wyoming","Sweetwater County",3,27,477,240,237
050,56,037,"Wyoming","Sweetwater County",3,28,490,260,230
050,56,037,"Wyoming","Sweetwater County",3,29,558,276,282
050,56,037,"Wyoming","Sweetwater County",3,30,548,264,284
050,56,037,"Wyoming","Sweetwater County",3,31,577,310,267
050,56,037,"Wyoming","Sweetwater County",3,32,556,306,250
050,56,037,"Wyoming","Sweetwater County",3,33,590,329,261
050,56,037,"Wyoming","Sweetwater County",3,34,616,316,300
050,56,037,"Wyoming","Sweetwater County",3,35,613,307,306
050,56,037,"Wyoming","Sweetwater County",3,36,602,297,305
050,56,037,"Wyoming","Sweetwater County",3,37,627,315,312
050,56,037,"Wyoming","Sweetwater County",3,38,662,343,319
050,56,037,"Wyoming","Sweetwater County",3,39,639,343,296
050,56,037,"Wyoming","Sweetwater County",3,40,655,350,305
050,56,037,"Wyoming","Sweetwater County",3,41,671,347,324
050,56,037,"Wyoming","Sweetwater County",3,42,613,301,312
050,56,037,"Wyoming","Sweetwater County",3,43,595,310,285
050,56,037,"Wyoming","Sweetwater County",3,44,578,302,276
050,56,037,"Wyoming","Sweetwater County",3,45,536,286,250
050,56,037,"Wyoming","Sweetwater County",3,46,521,269,252
050,56,037,"Wyoming","Sweetwater County",3,47,505,261,244
050,56,037,"Wyoming","Sweetwater County",3,48,490,266,224
050,56,037,"Wyoming","Sweetwater County",3,49,470,263,207
050,56,037,"Wyoming","Sweetwater County",3,50,519,281,238
050,56,037,"Wyoming","Sweetwater County",3,51,525,284,241
050,56,037,"Wyoming","Sweetwater County",3,52,457,244,213
050,56,037,"Wyoming","Sweetwater County",3,53,421,218,203
050,56,037,"Wyoming","Sweetwater County",3,54,429,228,201
050,56,037,"Wyoming","Sweetwater County",3,55,428,218,210
050,56,037,"Wyoming","Sweetwater County",3,56,471,239,232
050,56,037,"Wyoming","Sweetwater County",3,57,499,266,233
050,56,037,"Wyoming","Sweetwater County",3,58,515,274,241
050,56,037,"Wyoming","Sweetwater County",3,59,513,270,243
050,56,037,"Wyoming","Sweetwater County",3,60,528,284,244
050,56,037,"Wyoming","Sweetwater County",3,61,538,276,262
050,56,037,"Wyoming","Sweetwater County",3,62,561,282,279
050,56,037,"Wyoming","Sweetwater County",3,63,555,289,266
050,56,037,"Wyoming","Sweetwater County",3,64,551,303,248
050,56,037,"Wyoming","Sweetwater County",3,65,511,286,225
050,56,037,"Wyoming","Sweetwater County",3,66,501,267,234
050,56,037,"Wyoming","Sweetwater County",3,67,470,253,217
050,56,037,"Wyoming","Sweetwater County",3,68,454,237,217
050,56,037,"Wyoming","Sweetwater County",3,69,411,216,195
050,56,037,"Wyoming","Sweetwater County",3,70,365,183,182
050,56,037,"Wyoming","Sweetwater County",3,71,340,177,163
050,56,037,"Wyoming","Sweetwater County",3,72,329,171,158
050,56,037,"Wyoming","Sweetwater County",3,73,319,169,150
050,56,037,"Wyoming","Sweetwater County",3,74,306,155,151
050,56,037,"Wyoming","Sweetwater County",3,75,206,102,104
050,56,037,"Wyoming","Sweetwater County",3,76,205,99,106
050,56,037,"Wyoming","Sweetwater County",3,77,188,87,101
050,56,037,"Wyoming","Sweetwater County",3,78,176,89,87
050,56,037,"Wyoming","Sweetwater County",3,79,168,93,75
050,56,037,"Wyoming","Sweetwater County",3,80,146,71,75
050,56,037,"Wyoming","Sweetwater County",3,81,122,55,67
050,56,037,"Wyoming","Sweetwater County",3,82,111,52,59
050,56,037,"Wyoming","Sweetwater County",3,83,96,51,45
050,56,037,"Wyoming","Sweetwater County",3,84,92,44,48
050,56,037,"Wyoming","Sweetwater County",3,85,466,164,302
050,56,037,"Wyoming","Sweetwater County",4,0,439,237,202
050,56,037,"Wyoming","Sweetwater County",4,1,470,248,222
050,56,037,"Wyoming","Sweetwater County",4,2,448,217,231
050,56,037,"Wyoming","Sweetwater County",4,3,474,252,222
050,56,037,"Wyoming","Sweetwater County",4,4,490,257,233
050,56,037,"Wyoming","Sweetwater County",4,5,539,277,262
050,56,037,"Wyoming","Sweetwater County",4,6,561,304,257
050,56,037,"Wyoming","Sweetwater County",4,7,593,321,272
050,56,037,"Wyoming","Sweetwater County",4,8,570,298,272
050,56,037,"Wyoming","Sweetwater County",4,9,589,297,292
050,56,037,"Wyoming","Sweetwater County",4,10,564,285,279
050,56,037,"Wyoming","Sweetwater County",4,11,583,311,272
050,56,037,"Wyoming","Sweetwater County",4,12,644,338,306
050,56,037,"Wyoming","Sweetwater County",4,13,674,362,312
050,56,037,"Wyoming","Sweetwater County",4,14,689,354,335
050,56,037,"Wyoming","Sweetwater County",4,15,672,343,329
050,56,037,"Wyoming","Sweetwater County",4,16,682,340,342
050,56,037,"Wyoming","Sweetwater County",4,17,635,323,312
050,56,037,"Wyoming","Sweetwater County",4,18,564,303,261
050,56,037,"Wyoming","Sweetwater County",4,19,494,265,229
050,56,037,"Wyoming","Sweetwater County",4,20,506,250,256
050,56,037,"Wyoming","Sweetwater County",4,21,477,244,233
050,56,037,"Wyoming","Sweetwater County",4,22,459,240,219
050,56,037,"Wyoming","Sweetwater County",4,23,457,249,208
050,56,037,"Wyoming","Sweetwater County",4,24,473,231,242
050,56,037,"Wyoming","Sweetwater County",4,25,461,247,214
050,56,037,"Wyoming","Sweetwater County",4,26,470,239,231
050,56,037,"Wyoming","Sweetwater County",4,27,499,223,276
050,56,037,"Wyoming","Sweetwater County",4,28,479,235,244
050,56,037,"Wyoming","Sweetwater County",4,29,487,262,225
050,56,037,"Wyoming","Sweetwater County",4,30,561,282,279
050,56,037,"Wyoming","Sweetwater County",4,31,572,280,292
050,56,037,"Wyoming","Sweetwater County",4,32,567,302,265
050,56,037,"Wyoming","Sweetwater County",4,33,575,326,249
050,56,037,"Wyoming","Sweetwater County",4,34,598,338,260
050,56,037,"Wyoming","Sweetwater County",4,35,602,313,289
050,56,037,"Wyoming","Sweetwater County",4,36,614,308,306
050,56,037,"Wyoming","Sweetwater County",4,37,614,296,318
050,56,037,"Wyoming","Sweetwater County",4,38,637,335,302
050,56,037,"Wyoming","Sweetwater County",4,39,646,329,317
050,56,037,"Wyoming","Sweetwater County",4,40,638,345,293
050,56,037,"Wyoming","Sweetwater County",4,41,658,353,305
050,56,037,"Wyoming","Sweetwater County",4,42,678,345,333
050,56,037,"Wyoming","Sweetwater County",4,43,605,302,303
050,56,037,"Wyoming","Sweetwater County",4,44,581,301,280
050,56,037,"Wyoming","Sweetwater County",4,45,586,309,277
050,56,037,"Wyoming","Sweetwater County",4,46,527,281,246
050,56,037,"Wyoming","Sweetwater County",4,47,517,271,246
050,56,037,"Wyoming","Sweetwater County",4,48,497,252,245
050,56,037,"Wyoming","Sweetwater County",4,49,481,260,221
050,56,037,"Wyoming","Sweetwater County",4,50,468,264,204
050,56,037,"Wyoming","Sweetwater County",4,51,514,278,236
050,56,037,"Wyoming","Sweetwater County",4,52,496,266,230
050,56,037,"Wyoming","Sweetwater County",4,53,458,246,212
050,56,037,"Wyoming","Sweetwater County",4,54,418,215,203
050,56,037,"Wyoming","Sweetwater County",4,55,422,227,195
050,56,037,"Wyoming","Sweetwater County",4,56,409,200,209
050,56,037,"Wyoming","Sweetwater County",4,57,455,230,225
050,56,037,"Wyoming","Sweetwater County",4,58,482,252,230
050,56,037,"Wyoming","Sweetwater County",4,59,516,276,240
050,56,037,"Wyoming","Sweetwater County",4,60,487,264,223
050,56,037,"Wyoming","Sweetwater County",4,61,527,282,245
050,56,037,"Wyoming","Sweetwater County",4,62,527,267,260
050,56,037,"Wyoming","Sweetwater County",4,63,547,273,274
050,56,037,"Wyoming","Sweetwater County",4,64,534,274,260
050,56,037,"Wyoming","Sweetwater County",4,65,538,299,239
050,56,037,"Wyoming","Sweetwater County",4,66,506,286,220
050,56,037,"Wyoming","Sweetwater County",4,67,475,254,221
050,56,037,"Wyoming","Sweetwater County",4,68,455,243,212
050,56,037,"Wyoming","Sweetwater County",4,69,430,224,206
050,56,037,"Wyoming","Sweetwater County",4,70,406,209,197
050,56,037,"Wyoming","Sweetwater County",4,71,352,176,176
050,56,037,"Wyoming","Sweetwater County",4,72,334,170,164
050,56,037,"Wyoming","Sweetwater County",4,73,325,174,151
050,56,037,"Wyoming","Sweetwater County",4,74,306,163,143
050,56,037,"Wyoming","Sweetwater County",4,75,287,143,144
050,56,037,"Wyoming","Sweetwater County",4,76,194,97,97
050,56,037,"Wyoming","Sweetwater County",4,77,201,97,104
050,56,037,"Wyoming","Sweetwater County",4,78,179,82,97
050,56,037,"Wyoming","Sweetwater County",4,79,173,87,86
050,56,037,"Wyoming","Sweetwater County",4,80,155,86,69
050,56,037,"Wyoming","Sweetwater County",4,81,129,59,70
050,56,037,"Wyoming","Sweetwater County",4,82,119,45,74
050,56,037,"Wyoming","Sweetwater County",4,83,89,47,42
050,56,037,"Wyoming","Sweetwater County",4,84,82,43,39
050,56,037,"Wyoming","Sweetwater County",4,85,483,179,304
050,56,037,"Wyoming","Sweetwater County",5,0,426,233,193
050,56,037,"Wyoming","Sweetwater County",5,1,461,256,205
050,56,037,"Wyoming","Sweetwater County",5,2,474,256,218
050,56,037,"Wyoming","Sweetwater County",5,3,447,215,232
050,56,037,"Wyoming","Sweetwater County",5,4,477,253,224
050,56,037,"Wyoming","Sweetwater County",5,5,494,260,234
050,56,037,"Wyoming","Sweetwater County",5,6,535,273,262
050,56,037,"Wyoming","Sweetwater County",5,7,563,301,262
050,56,037,"Wyoming","Sweetwater County",5,8,588,317,271
050,56,037,"Wyoming","Sweetwater County",5,9,581,308,273
050,56,037,"Wyoming","Sweetwater County",5,10,591,302,289
050,56,037,"Wyoming","Sweetwater County",5,11,534,271,263
050,56,037,"Wyoming","Sweetwater County",5,12,569,299,270
050,56,037,"Wyoming","Sweetwater County",5,13,635,334,301
050,56,037,"Wyoming","Sweetwater County",5,14,679,356,323
050,56,037,"Wyoming","Sweetwater County",5,15,682,356,326
050,56,037,"Wyoming","Sweetwater County",5,16,681,351,330
050,56,037,"Wyoming","Sweetwater County",5,17,670,335,335
050,56,037,"Wyoming","Sweetwater County",5,18,581,307,274
050,56,037,"Wyoming","Sweetwater County",5,19,492,268,224
050,56,037,"Wyoming","Sweetwater County",5,20,507,268,239
050,56,037,"Wyoming","Sweetwater County",5,21,494,250,244
050,56,037,"Wyoming","Sweetwater County",5,22,473,249,224
050,56,037,"Wyoming","Sweetwater County",5,23,460,228,232
050,56,037,"Wyoming","Sweetwater County",5,24,473,257,216
050,56,037,"Wyoming","Sweetwater County",5,25,483,238,245
050,56,037,"Wyoming","Sweetwater County",5,26,461,238,223
050,56,037,"Wyoming","Sweetwater County",5,27,503,254,249
050,56,037,"Wyoming","Sweetwater County",5,28,494,228,266
050,56,037,"Wyoming","Sweetwater County",5,29,491,247,244
050,56,037,"Wyoming","Sweetwater County",5,30,471,252,219
050,56,037,"Wyoming","Sweetwater County",5,31,577,294,283
050,56,037,"Wyoming","Sweetwater County",5,32,557,274,283
050,56,037,"Wyoming","Sweetwater County",5,33,555,296,259
050,56,037,"Wyoming","Sweetwater County",5,34,565,319,246
050,56,037,"Wyoming","Sweetwater County",5,35,594,325,269
050,56,037,"Wyoming","Sweetwater County",5,36,586,313,273
050,56,037,"Wyoming","Sweetwater County",5,37,609,306,303
050,56,037,"Wyoming","Sweetwater County",5,38,634,311,323
050,56,037,"Wyoming","Sweetwater County",5,39,617,320,297
050,56,037,"Wyoming","Sweetwater County",5,40,641,328,313
050,56,037,"Wyoming","Sweetwater County",5,41,630,336,294
050,56,037,"Wyoming","Sweetwater County",5,42,669,356,313
050,56,037,"Wyoming","Sweetwater County",5,43,669,343,326
050,56,037,"Wyoming","Sweetwater County",5,44,587,296,291
050,56,037,"Wyoming","Sweetwater County",5,45,567,291,276
050,56,037,"Wyoming","Sweetwater County",5,46,572,305,267
050,56,037,"Wyoming","Sweetwater County",5,47,524,276,248
050,56,037,"Wyoming","Sweetwater County",5,48,521,276,245
050,56,037,"Wyoming","Sweetwater County",5,49,497,249,248
050,56,037,"Wyoming","Sweetwater County",5,50,475,256,219
050,56,037,"Wyoming","Sweetwater County",5,51,471,267,204
050,56,037,"Wyoming","Sweetwater County",5,52,505,275,230
050,56,037,"Wyoming","Sweetwater County",5,53,505,274,231
050,56,037,"Wyoming","Sweetwater County",5,54,460,247,213
050,56,037,"Wyoming","Sweetwater County",5,55,405,212,193
050,56,037,"Wyoming","Sweetwater County",5,56,425,223,202
050,56,037,"Wyoming","Sweetwater County",5,57,388,193,195
050,56,037,"Wyoming","Sweetwater County",5,58,456,233,223
050,56,037,"Wyoming","Sweetwater County",5,59,477,250,227
050,56,037,"Wyoming","Sweetwater County",5,60,508,273,235
050,56,037,"Wyoming","Sweetwater County",5,61,484,265,219
050,56,037,"Wyoming","Sweetwater County",5,62,526,278,248
050,56,037,"Wyoming","Sweetwater County",5,63,514,267,247
050,56,037,"Wyoming","Sweetwater County",5,64,546,268,278
050,56,037,"Wyoming","Sweetwater County",5,65,513,263,250
050,56,037,"Wyoming","Sweetwater County",5,66,528,294,234
050,56,037,"Wyoming","Sweetwater County",5,67,494,276,218
050,56,037,"Wyoming","Sweetwater County",5,68,464,250,214
050,56,037,"Wyoming","Sweetwater County",5,69,432,233,199
050,56,037,"Wyoming","Sweetwater County",5,70,416,211,205
050,56,037,"Wyoming","Sweetwater County",5,71,387,192,195
050,56,037,"Wyoming","Sweetwater County",5,72,339,167,172
050,56,037,"Wyoming","Sweetwater County",5,73,320,164,156
050,56,037,"Wyoming","Sweetwater County",5,74,324,175,149
050,56,037,"Wyoming","Sweetwater County",5,75,293,150,143
050,56,037,"Wyoming","Sweetwater County",5,76,275,140,135
050,56,037,"Wyoming","Sweetwater County",5,77,195,94,101
050,56,037,"Wyoming","Sweetwater County",5,78,187,88,99
050,56,037,"Wyoming","Sweetwater County",5,79,185,83,102
050,56,037,"Wyoming","Sweetwater County",5,80,163,81,82
050,56,037,"Wyoming","Sweetwater County",5,81,140,77,63
050,56,037,"Wyoming","Sweetwater County",5,82,124,50,74
050,56,037,"Wyoming","Sweetwater County",5,83,102,42,60
050,56,037,"Wyoming","Sweetwater County",5,84,82,43,39
050,56,037,"Wyoming","Sweetwater County",5,85,500,190,310
050,56,039,"Wyoming","Teton County",1,0,219,114,105
050,56,039,"Wyoming","Teton County",1,1,217,113,104
050,56,039,"Wyoming","Teton County",1,2,236,120,116
050,56,039,"Wyoming","Teton County",1,3,205,107,98
050,56,039,"Wyoming","Teton County",1,4,217,106,111
050,56,039,"Wyoming","Teton County",1,5,217,121,96
050,56,039,"Wyoming","Teton County",1,6,208,102,106
050,56,039,"Wyoming","Teton County",1,7,211,96,115
050,56,039,"Wyoming","Teton County",1,8,232,114,118
050,56,039,"Wyoming","Teton County",1,9,243,115,128
050,56,039,"Wyoming","Teton County",1,10,264,132,132
050,56,039,"Wyoming","Teton County",1,11,265,139,126
050,56,039,"Wyoming","Teton County",1,12,251,122,129
050,56,039,"Wyoming","Teton County",1,13,261,146,115
050,56,039,"Wyoming","Teton County",1,14,239,131,108
050,56,039,"Wyoming","Teton County",1,15,223,122,101
050,56,039,"Wyoming","Teton County",1,16,227,120,107
050,56,039,"Wyoming","Teton County",1,17,219,112,107
050,56,039,"Wyoming","Teton County",1,18,182,89,93
050,56,039,"Wyoming","Teton County",1,19,163,90,73
050,56,039,"Wyoming","Teton County",1,20,177,92,85
050,56,039,"Wyoming","Teton County",1,21,199,103,96
050,56,039,"Wyoming","Teton County",1,22,216,97,119
050,56,039,"Wyoming","Teton County",1,23,283,128,155
050,56,039,"Wyoming","Teton County",1,24,271,130,141
050,56,039,"Wyoming","Teton County",1,25,308,141,167
050,56,039,"Wyoming","Teton County",1,26,370,189,181
050,56,039,"Wyoming","Teton County",1,27,359,171,188
050,56,039,"Wyoming","Teton County",1,28,392,216,176
050,56,039,"Wyoming","Teton County",1,29,449,268,181
050,56,039,"Wyoming","Teton County",1,30,404,228,176
050,56,039,"Wyoming","Teton County",1,31,356,189,167
050,56,039,"Wyoming","Teton County",1,32,374,190,184
050,56,039,"Wyoming","Teton County",1,33,420,221,199
050,56,039,"Wyoming","Teton County",1,34,401,208,193
050,56,039,"Wyoming","Teton County",1,35,402,205,197
050,56,039,"Wyoming","Teton County",1,36,398,228,170
050,56,039,"Wyoming","Teton County",1,37,418,234,184
050,56,039,"Wyoming","Teton County",1,38,408,213,195
050,56,039,"Wyoming","Teton County",1,39,374,197,177
050,56,039,"Wyoming","Teton County",1,40,408,215,193
050,56,039,"Wyoming","Teton County",1,41,372,205,167
050,56,039,"Wyoming","Teton County",1,42,369,182,187
050,56,039,"Wyoming","Teton County",1,43,339,182,157
050,56,039,"Wyoming","Teton County",1,44,342,188,154
050,56,039,"Wyoming","Teton County",1,45,332,198,134
050,56,039,"Wyoming","Teton County",1,46,349,209,140
050,56,039,"Wyoming","Teton County",1,47,344,187,157
050,56,039,"Wyoming","Teton County",1,48,337,184,153
050,56,039,"Wyoming","Teton County",1,49,370,208,162
050,56,039,"Wyoming","Teton County",1,50,350,190,160
050,56,039,"Wyoming","Teton County",1,51,297,168,129
050,56,039,"Wyoming","Teton County",1,52,276,147,129
050,56,039,"Wyoming","Teton County",1,53,280,140,140
050,56,039,"Wyoming","Teton County",1,54,276,144,132
050,56,039,"Wyoming","Teton County",1,55,296,143,153
050,56,039,"Wyoming","Teton County",1,56,298,138,160
050,56,039,"Wyoming","Teton County",1,57,274,144,130
050,56,039,"Wyoming","Teton County",1,58,267,143,124
050,56,039,"Wyoming","Teton County",1,59,312,151,161
050,56,039,"Wyoming","Teton County",1,60,345,170,175
050,56,039,"Wyoming","Teton County",1,61,311,154,157
050,56,039,"Wyoming","Teton County",1,62,297,156,141
050,56,039,"Wyoming","Teton County",1,63,313,157,156
050,56,039,"Wyoming","Teton County",1,64,320,163,157
050,56,039,"Wyoming","Teton County",1,65,302,160,142
050,56,039,"Wyoming","Teton County",1,66,270,151,119
050,56,039,"Wyoming","Teton County",1,67,288,163,125
050,56,039,"Wyoming","Teton County",1,68,248,136,112
050,56,039,"Wyoming","Teton County",1,69,246,126,120
050,56,039,"Wyoming","Teton County",1,70,251,140,111
050,56,039,"Wyoming","Teton County",1,71,240,136,104
050,56,039,"Wyoming","Teton County",1,72,228,123,105
050,56,039,"Wyoming","Teton County",1,73,238,123,115
050,56,039,"Wyoming","Teton County",1,74,146,70,76
050,56,039,"Wyoming","Teton County",1,75,148,76,72
050,56,039,"Wyoming","Teton County",1,76,162,83,79
050,56,039,"Wyoming","Teton County",1,77,150,70,80
050,56,039,"Wyoming","Teton County",1,78,114,56,58
050,56,039,"Wyoming","Teton County",1,79,96,49,47
050,56,039,"Wyoming","Teton County",1,80,83,40,43
050,56,039,"Wyoming","Teton County",1,81,71,36,35
050,56,039,"Wyoming","Teton County",1,82,57,28,29
050,56,039,"Wyoming","Teton County",1,83,53,24,29
050,56,039,"Wyoming","Teton County",1,84,59,24,35
050,56,039,"Wyoming","Teton County",1,85,321,132,189
050,56,039,"Wyoming","Teton County",2,0,227,115,112
050,56,039,"Wyoming","Teton County",2,1,215,113,102
050,56,039,"Wyoming","Teton County",2,2,229,117,112
050,56,039,"Wyoming","Teton County",2,3,211,109,102
050,56,039,"Wyoming","Teton County",2,4,214,105,109
050,56,039,"Wyoming","Teton County",2,5,216,117,99
050,56,039,"Wyoming","Teton County",2,6,209,106,103
050,56,039,"Wyoming","Teton County",2,7,211,98,113
050,56,039,"Wyoming","Teton County",2,8,227,110,117
050,56,039,"Wyoming","Teton County",2,9,240,115,125
050,56,039,"Wyoming","Teton County",2,10,259,128,131
050,56,039,"Wyoming","Teton County",2,11,264,137,127
050,56,039,"Wyoming","Teton County",2,12,253,125,128
050,56,039,"Wyoming","Teton County",2,13,259,141,118
050,56,039,"Wyoming","Teton County",2,14,241,133,108
050,56,039,"Wyoming","Teton County",2,15,227,124,103
050,56,039,"Wyoming","Teton County",2,16,225,121,104
050,56,039,"Wyoming","Teton County",2,17,220,113,107
050,56,039,"Wyoming","Teton County",2,18,184,91,93
050,56,039,"Wyoming","Teton County",2,19,166,89,77
050,56,039,"Wyoming","Teton County",2,20,182,96,86
050,56,039,"Wyoming","Teton County",2,21,201,103,98
050,56,039,"Wyoming","Teton County",2,22,224,104,120
050,56,039,"Wyoming","Teton County",2,23,281,130,151
050,56,039,"Wyoming","Teton County",2,24,278,132,146
050,56,039,"Wyoming","Teton County",2,25,311,147,164
050,56,039,"Wyoming","Teton County",2,26,360,180,180
050,56,039,"Wyoming","Teton County",2,27,364,176,188
050,56,039,"Wyoming","Teton County",2,28,390,210,180
050,56,039,"Wyoming","Teton County",2,29,436,255,181
050,56,039,"Wyoming","Teton County",2,30,414,237,177
050,56,039,"Wyoming","Teton County",2,31,366,197,169
050,56,039,"Wyoming","Teton County",2,32,364,185,179
050,56,039,"Wyoming","Teton County",2,33,407,213,194
050,56,039,"Wyoming","Teton County",2,34,404,209,195
050,56,039,"Wyoming","Teton County",2,35,402,207,195
050,56,039,"Wyoming","Teton County",2,36,392,220,172
050,56,039,"Wyoming","Teton County",2,37,415,233,182
050,56,039,"Wyoming","Teton County",2,38,412,220,192
050,56,039,"Wyoming","Teton County",2,39,382,200,182
050,56,039,"Wyoming","Teton County",2,40,401,212,189
050,56,039,"Wyoming","Teton County",2,41,380,205,175
050,56,039,"Wyoming","Teton County",2,42,365,184,181
050,56,039,"Wyoming","Teton County",2,43,349,184,165
050,56,039,"Wyoming","Teton County",2,44,338,186,152
050,56,039,"Wyoming","Teton County",2,45,336,198,138
050,56,039,"Wyoming","Teton County",2,46,343,205,138
050,56,039,"Wyoming","Teton County",2,47,345,192,153
050,56,039,"Wyoming","Teton County",2,48,337,185,152
050,56,039,"Wyoming","Teton County",2,49,363,201,162
050,56,039,"Wyoming","Teton County",2,50,354,194,160
050,56,039,"Wyoming","Teton County",2,51,307,170,137
050,56,039,"Wyoming","Teton County",2,52,284,154,130
050,56,039,"Wyoming","Teton County",2,53,279,143,136
050,56,039,"Wyoming","Teton County",2,54,280,145,135
050,56,039,"Wyoming","Teton County",2,55,290,143,147
050,56,039,"Wyoming","Teton County",2,56,296,139,157
050,56,039,"Wyoming","Teton County",2,57,280,142,138
050,56,039,"Wyoming","Teton County",2,58,271,144,127
050,56,039,"Wyoming","Teton County",2,59,300,149,151
050,56,039,"Wyoming","Teton County",2,60,337,166,171
050,56,039,"Wyoming","Teton County",2,61,316,158,158
050,56,039,"Wyoming","Teton County",2,62,297,154,143
050,56,039,"Wyoming","Teton County",2,63,314,161,153
050,56,039,"Wyoming","Teton County",2,64,316,161,155
050,56,039,"Wyoming","Teton County",2,65,305,160,145
050,56,039,"Wyoming","Teton County",2,66,276,153,123
050,56,039,"Wyoming","Teton County",2,67,282,158,124
050,56,039,"Wyoming","Teton County",2,68,254,141,113
050,56,039,"Wyoming","Teton County",2,69,246,127,119
050,56,039,"Wyoming","Teton County",2,70,248,136,112
050,56,039,"Wyoming","Teton County",2,71,242,136,106
050,56,039,"Wyoming","Teton County",2,72,225,125,100
050,56,039,"Wyoming","Teton County",2,73,247,127,120
050,56,039,"Wyoming","Teton County",2,74,156,77,79
050,56,039,"Wyoming","Teton County",2,75,149,75,74
050,56,039,"Wyoming","Teton County",2,76,156,79,77
050,56,039,"Wyoming","Teton County",2,77,155,74,81
050,56,039,"Wyoming","Teton County",2,78,121,59,62
050,56,039,"Wyoming","Teton County",2,79,98,49,49
050,56,039,"Wyoming","Teton County",2,80,85,42,43
050,56,039,"Wyoming","Teton County",2,81,72,35,37
050,56,039,"Wyoming","Teton County",2,82,59,30,29
050,56,039,"Wyoming","Teton County",2,83,54,25,29
050,56,039,"Wyoming","Teton County",2,84,60,24,36
050,56,039,"Wyoming","Teton County",2,85,329,135,194
050,56,039,"Wyoming","Teton County",3,0,205,113,92
050,56,039,"Wyoming","Teton County",3,1,227,107,120
050,56,039,"Wyoming","Teton County",3,2,219,112,107
050,56,039,"Wyoming","Teton County",3,3,223,112,111
050,56,039,"Wyoming","Teton County",3,4,208,108,100
050,56,039,"Wyoming","Teton County",3,5,207,99,108
050,56,039,"Wyoming","Teton County",3,6,210,113,97
050,56,039,"Wyoming","Teton County",3,7,211,105,106
050,56,039,"Wyoming","Teton County",3,8,209,100,109
050,56,039,"Wyoming","Teton County",3,9,216,109,107
050,56,039,"Wyoming","Teton County",3,10,227,108,119
050,56,039,"Wyoming","Teton County",3,11,273,139,134
050,56,039,"Wyoming","Teton County",3,12,253,126,127
050,56,039,"Wyoming","Teton County",3,13,251,125,126
050,56,039,"Wyoming","Teton County",3,14,256,136,120
050,56,039,"Wyoming","Teton County",3,15,236,128,108
050,56,039,"Wyoming","Teton County",3,16,234,129,105
050,56,039,"Wyoming","Teton County",3,17,234,126,108
050,56,039,"Wyoming","Teton County",3,18,189,100,89
050,56,039,"Wyoming","Teton County",3,19,152,75,77
050,56,039,"Wyoming","Teton County",3,20,161,92,69
050,56,039,"Wyoming","Teton County",3,21,201,110,91
050,56,039,"Wyoming","Teton County",3,22,210,104,106
050,56,039,"Wyoming","Teton County",3,23,288,141,147
050,56,039,"Wyoming","Teton County",3,24,335,168,167
050,56,039,"Wyoming","Teton County",3,25,338,167,171
050,56,039,"Wyoming","Teton County",3,26,350,179,171
050,56,039,"Wyoming","Teton County",3,27,392,193,199
050,56,039,"Wyoming","Teton County",3,28,360,177,183
050,56,039,"Wyoming","Teton County",3,29,381,211,170
050,56,039,"Wyoming","Teton County",3,30,420,247,173
050,56,039,"Wyoming","Teton County",3,31,433,236,197
050,56,039,"Wyoming","Teton County",3,32,386,205,181
050,56,039,"Wyoming","Teton County",3,33,370,192,178
050,56,039,"Wyoming","Teton County",3,34,407,211,196
050,56,039,"Wyoming","Teton County",3,35,423,226,197
050,56,039,"Wyoming","Teton County",3,36,399,212,187
050,56,039,"Wyoming","Teton County",3,37,387,228,159
050,56,039,"Wyoming","Teton County",3,38,415,225,190
050,56,039,"Wyoming","Teton County",3,39,421,224,197
050,56,039,"Wyoming","Teton County",3,40,368,194,174
050,56,039,"Wyoming","Teton County",3,41,404,214,190
050,56,039,"Wyoming","Teton County",3,42,366,192,174
050,56,039,"Wyoming","Teton County",3,43,362,176,186
050,56,039,"Wyoming","Teton County",3,44,343,186,157
050,56,039,"Wyoming","Teton County",3,45,345,196,149
050,56,039,"Wyoming","Teton County",3,46,325,184,141
050,56,039,"Wyoming","Teton County",3,47,341,202,139
050,56,039,"Wyoming","Teton County",3,48,347,195,152
050,56,039,"Wyoming","Teton County",3,49,327,175,152
050,56,039,"Wyoming","Teton County",3,50,366,197,169
050,56,039,"Wyoming","Teton County",3,51,351,188,163
050,56,039,"Wyoming","Teton County",3,52,313,172,141
050,56,039,"Wyoming","Teton County",3,53,285,156,129
050,56,039,"Wyoming","Teton County",3,54,273,138,135
050,56,039,"Wyoming","Teton County",3,55,269,141,128
050,56,039,"Wyoming","Teton County",3,56,283,146,137
050,56,039,"Wyoming","Teton County",3,57,289,131,158
050,56,039,"Wyoming","Teton County",3,58,280,149,131
050,56,039,"Wyoming","Teton County",3,59,266,137,129
050,56,039,"Wyoming","Teton County",3,60,293,149,144
050,56,039,"Wyoming","Teton County",3,61,335,158,177
050,56,039,"Wyoming","Teton County",3,62,316,160,156
050,56,039,"Wyoming","Teton County",3,63,300,155,145
050,56,039,"Wyoming","Teton County",3,64,317,166,151
050,56,039,"Wyoming","Teton County",3,65,311,154,157
050,56,039,"Wyoming","Teton County",3,66,298,157,141
050,56,039,"Wyoming","Teton County",3,67,272,152,120
050,56,039,"Wyoming","Teton County",3,68,281,159,122
050,56,039,"Wyoming","Teton County",3,69,246,136,110
050,56,039,"Wyoming","Teton County",3,70,245,129,116
050,56,039,"Wyoming","Teton County",3,71,256,135,121
050,56,039,"Wyoming","Teton County",3,72,237,136,101
050,56,039,"Wyoming","Teton County",3,73,219,122,97
050,56,039,"Wyoming","Teton County",3,74,234,121,113
050,56,039,"Wyoming","Teton County",3,75,146,69,77
050,56,039,"Wyoming","Teton County",3,76,140,71,69
050,56,039,"Wyoming","Teton County",3,77,161,83,78
050,56,039,"Wyoming","Teton County",3,78,148,71,77
050,56,039,"Wyoming","Teton County",3,79,121,59,62
050,56,039,"Wyoming","Teton County",3,80,102,48,54
050,56,039,"Wyoming","Teton County",3,81,80,38,42
050,56,039,"Wyoming","Teton County",3,82,62,30,32
050,56,039,"Wyoming","Teton County",3,83,53,27,26
050,56,039,"Wyoming","Teton County",3,84,66,27,39
050,56,039,"Wyoming","Teton County",3,85,346,149,197
050,56,039,"Wyoming","Teton County",4,0,192,98,94
050,56,039,"Wyoming","Teton County",4,1,200,112,88
050,56,039,"Wyoming","Teton County",4,2,208,97,111
050,56,039,"Wyoming","Teton County",4,3,221,114,107
050,56,039,"Wyoming","Teton County",4,4,216,113,103
050,56,039,"Wyoming","Teton County",4,5,208,102,106
050,56,039,"Wyoming","Teton County",4,6,207,102,105
050,56,039,"Wyoming","Teton County",4,7,211,110,101
050,56,039,"Wyoming","Teton County",4,8,201,101,100
050,56,039,"Wyoming","Teton County",4,9,207,98,109
050,56,039,"Wyoming","Teton County",4,10,212,103,109
050,56,039,"Wyoming","Teton County",4,11,217,105,112
050,56,039,"Wyoming","Teton County",4,12,266,136,130
050,56,039,"Wyoming","Teton County",4,13,246,126,120
050,56,039,"Wyoming","Teton County",4,14,241,120,121
050,56,039,"Wyoming","Teton County",4,15,246,129,117
050,56,039,"Wyoming","Teton County",4,16,238,130,108
050,56,039,"Wyoming","Teton County",4,17,234,128,106
050,56,039,"Wyoming","Teton County",4,18,203,104,99
050,56,039,"Wyoming","Teton County",4,19,155,82,73
050,56,039,"Wyoming","Teton County",4,20,155,78,77
050,56,039,"Wyoming","Teton County",4,21,179,98,81
050,56,039,"Wyoming","Teton County",4,22,217,109,108
050,56,039,"Wyoming","Teton County",4,23,261,124,137
050,56,039,"Wyoming","Teton County",4,24,313,155,158
050,56,039,"Wyoming","Teton County",4,25,363,181,182
050,56,039,"Wyoming","Teton County",4,26,378,203,175
050,56,039,"Wyoming","Teton County",4,27,359,187,172
050,56,039,"Wyoming","Teton County",4,28,392,200,192
050,56,039,"Wyoming","Teton County",4,29,391,206,185
050,56,039,"Wyoming","Teton County",4,30,361,199,162
050,56,039,"Wyoming","Teton County",4,31,410,237,173
050,56,039,"Wyoming","Teton County",4,32,415,224,191
050,56,039,"Wyoming","Teton County",4,33,374,204,170
050,56,039,"Wyoming","Teton County",4,34,347,178,169
050,56,039,"Wyoming","Teton County",4,35,383,200,183
050,56,039,"Wyoming","Teton County",4,36,389,208,181
050,56,039,"Wyoming","Teton County",4,37,375,203,172
050,56,039,"Wyoming","Teton County",4,38,384,220,164
050,56,039,"Wyoming","Teton County",4,39,395,217,178
050,56,039,"Wyoming","Teton County",4,40,415,213,202
050,56,039,"Wyoming","Teton County",4,41,375,202,173
050,56,039,"Wyoming","Teton County",4,42,371,187,184
050,56,039,"Wyoming","Teton County",4,43,355,187,168
050,56,039,"Wyoming","Teton County",4,44,352,173,179
050,56,039,"Wyoming","Teton County",4,45,341,184,157
050,56,039,"Wyoming","Teton County",4,46,341,190,151
050,56,039,"Wyoming","Teton County",4,47,335,187,148
050,56,039,"Wyoming","Teton County",4,48,340,203,137
050,56,039,"Wyoming","Teton County",4,49,339,192,147
050,56,039,"Wyoming","Teton County",4,50,316,166,150
050,56,039,"Wyoming","Teton County",4,51,349,186,163
050,56,039,"Wyoming","Teton County",4,52,355,184,171
050,56,039,"Wyoming","Teton County",4,53,301,168,133
050,56,039,"Wyoming","Teton County",4,54,284,156,128
050,56,039,"Wyoming","Teton County",4,55,258,129,129
050,56,039,"Wyoming","Teton County",4,56,274,142,132
050,56,039,"Wyoming","Teton County",4,57,272,137,135
050,56,039,"Wyoming","Teton County",4,58,289,132,157
050,56,039,"Wyoming","Teton County",4,59,267,141,126
050,56,039,"Wyoming","Teton County",4,60,266,141,125
050,56,039,"Wyoming","Teton County",4,61,281,141,140
050,56,039,"Wyoming","Teton County",4,62,324,158,166
050,56,039,"Wyoming","Teton County",4,63,299,141,158
050,56,039,"Wyoming","Teton County",4,64,301,158,143
050,56,039,"Wyoming","Teton County",4,65,311,164,147
050,56,039,"Wyoming","Teton County",4,66,301,147,154
050,56,039,"Wyoming","Teton County",4,67,287,148,139
050,56,039,"Wyoming","Teton County",4,68,278,157,121
050,56,039,"Wyoming","Teton County",4,69,267,146,121
050,56,039,"Wyoming","Teton County",4,70,232,130,102
050,56,039,"Wyoming","Teton County",4,71,237,124,113
050,56,039,"Wyoming","Teton County",4,72,231,123,108
050,56,039,"Wyoming","Teton County",4,73,233,136,97
050,56,039,"Wyoming","Teton County",4,74,209,115,94
050,56,039,"Wyoming","Teton County",4,75,227,115,112
050,56,039,"Wyoming","Teton County",4,76,144,68,76
050,56,039,"Wyoming","Teton County",4,77,128,65,63
050,56,039,"Wyoming","Teton County",4,78,154,81,73
050,56,039,"Wyoming","Teton County",4,79,142,67,75
050,56,039,"Wyoming","Teton County",4,80,122,58,64
050,56,039,"Wyoming","Teton County",4,81,93,39,54
050,56,039,"Wyoming","Teton County",4,82,70,32,38
050,56,039,"Wyoming","Teton County",4,83,57,30,27
050,56,039,"Wyoming","Teton County",4,84,60,26,34
050,56,039,"Wyoming","Teton County",4,85,344,153,191
050,56,039,"Wyoming","Teton County",5,0,189,97,92
050,56,039,"Wyoming","Teton County",5,1,185,93,92
050,56,039,"Wyoming","Teton County",5,2,188,104,84
050,56,039,"Wyoming","Teton County",5,3,203,98,105
050,56,039,"Wyoming","Teton County",5,4,222,111,111
050,56,039,"Wyoming","Teton County",5,5,214,112,102
050,56,039,"Wyoming","Teton County",5,6,211,100,111
050,56,039,"Wyoming","Teton County",5,7,201,98,103
050,56,039,"Wyoming","Teton County",5,8,211,113,98
050,56,039,"Wyoming","Teton County",5,9,201,102,99
050,56,039,"Wyoming","Teton County",5,10,201,91,110
050,56,039,"Wyoming","Teton County",5,11,217,108,109
050,56,039,"Wyoming","Teton County",5,12,215,98,117
050,56,039,"Wyoming","Teton County",5,13,258,131,127
050,56,039,"Wyoming","Teton County",5,14,250,132,118
050,56,039,"Wyoming","Teton County",5,15,241,122,119
050,56,039,"Wyoming","Teton County",5,16,246,130,116
050,56,039,"Wyoming","Teton County",5,17,239,126,113
050,56,039,"Wyoming","Teton County",5,18,209,116,93
050,56,039,"Wyoming","Teton County",5,19,170,89,81
050,56,039,"Wyoming","Teton County",5,20,150,79,71
050,56,039,"Wyoming","Teton County",5,21,187,90,97
050,56,039,"Wyoming","Teton County",5,22,220,116,104
050,56,039,"Wyoming","Teton County",5,23,274,138,136
050,56,039,"Wyoming","Teton County",5,24,282,145,137
050,56,039,"Wyoming","Teton County",5,25,333,170,163
050,56,039,"Wyoming","Teton County",5,26,423,234,189
050,56,039,"Wyoming","Teton County",5,27,357,194,163
050,56,039,"Wyoming","Teton County",5,28,358,188,170
050,56,039,"Wyoming","Teton County",5,29,396,199,197
050,56,039,"Wyoming","Teton County",5,30,387,193,194
050,56,039,"Wyoming","Teton County",5,31,359,216,143
050,56,039,"Wyoming","Teton County",5,32,373,213,160
050,56,039,"Wyoming","Teton County",5,33,390,212,178
050,56,039,"Wyoming","Teton County",5,34,355,194,161
050,56,039,"Wyoming","Teton County",5,35,342,184,158
050,56,039,"Wyoming","Teton County",5,36,358,193,165
050,56,039,"Wyoming","Teton County",5,37,356,194,162
050,56,039,"Wyoming","Teton County",5,38,363,195,168
050,56,039,"Wyoming","Teton County",5,39,369,203,166
050,56,039,"Wyoming","Teton County",5,40,391,224,167
050,56,039,"Wyoming","Teton County",5,41,404,202,202
050,56,039,"Wyoming","Teton County",5,42,369,199,170
050,56,039,"Wyoming","Teton County",5,43,367,195,172
050,56,039,"Wyoming","Teton County",5,44,347,185,162
050,56,039,"Wyoming","Teton County",5,45,357,183,174
050,56,039,"Wyoming","Teton County",5,46,329,174,155
050,56,039,"Wyoming","Teton County",5,47,353,189,164
050,56,039,"Wyoming","Teton County",5,48,342,198,144
050,56,039,"Wyoming","Teton County",5,49,339,196,143
050,56,039,"Wyoming","Teton County",5,50,346,196,150
050,56,039,"Wyoming","Teton County",5,51,312,158,154
050,56,039,"Wyoming","Teton County",5,52,349,185,164
050,56,039,"Wyoming","Teton County",5,53,352,181,171
050,56,039,"Wyoming","Teton County",5,54,305,170,135
050,56,039,"Wyoming","Teton County",5,55,281,159,122
050,56,039,"Wyoming","Teton County",5,56,273,135,138
050,56,039,"Wyoming","Teton County",5,57,247,129,118
050,56,039,"Wyoming","Teton County",5,58,269,137,132
050,56,039,"Wyoming","Teton County",5,59,288,134,154
050,56,039,"Wyoming","Teton County",5,60,263,140,123
050,56,039,"Wyoming","Teton County",5,61,266,146,120
050,56,039,"Wyoming","Teton County",5,62,282,149,133
050,56,039,"Wyoming","Teton County",5,63,311,156,155
050,56,039,"Wyoming","Teton County",5,64,283,134,149
050,56,039,"Wyoming","Teton County",5,65,287,151,136
050,56,039,"Wyoming","Teton County",5,66,305,160,145
050,56,039,"Wyoming","Teton County",5,67,304,147,157
050,56,039,"Wyoming","Teton County",5,68,288,150,138
050,56,039,"Wyoming","Teton County",5,69,260,144,116
050,56,039,"Wyoming","Teton County",5,70,260,144,116
050,56,039,"Wyoming","Teton County",5,71,238,131,107
050,56,039,"Wyoming","Teton County",5,72,224,119,105
050,56,039,"Wyoming","Teton County",5,73,231,123,108
050,56,039,"Wyoming","Teton County",5,74,227,129,98
050,56,039,"Wyoming","Teton County",5,75,200,104,96
050,56,039,"Wyoming","Teton County",5,76,223,114,109
050,56,039,"Wyoming","Teton County",5,77,141,67,74
050,56,039,"Wyoming","Teton County",5,78,123,61,62
050,56,039,"Wyoming","Teton County",5,79,154,81,73
050,56,039,"Wyoming","Teton County",5,80,143,65,78
050,56,039,"Wyoming","Teton County",5,81,120,57,63
050,56,039,"Wyoming","Teton County",5,82,83,34,49
050,56,039,"Wyoming","Teton County",5,83,68,31,37
050,56,039,"Wyoming","Teton County",5,84,65,29,36
050,56,039,"Wyoming","Teton County",5,85,360,169,191
050,56,041,"Wyoming","Uinta County",1,0,230,116,114
050,56,041,"Wyoming","Uinta County",1,1,234,113,121
050,56,041,"Wyoming","Uinta County",1,2,263,138,125
050,56,041,"Wyoming","Uinta County",1,3,273,140,133
050,56,041,"Wyoming","Uinta County",1,4,314,166,148
050,56,041,"Wyoming","Uinta County",1,5,301,149,152
050,56,041,"Wyoming","Uinta County",1,6,356,183,173
050,56,041,"Wyoming","Uinta County",1,7,327,172,155
050,56,041,"Wyoming","Uinta County",1,8,306,157,149
050,56,041,"Wyoming","Uinta County",1,9,335,186,149
050,56,041,"Wyoming","Uinta County",1,10,341,174,167
050,56,041,"Wyoming","Uinta County",1,11,356,181,175
050,56,041,"Wyoming","Uinta County",1,12,361,188,173
050,56,041,"Wyoming","Uinta County",1,13,369,195,174
050,56,041,"Wyoming","Uinta County",1,14,360,186,174
050,56,041,"Wyoming","Uinta County",1,15,346,160,186
050,56,041,"Wyoming","Uinta County",1,16,364,178,186
050,56,041,"Wyoming","Uinta County",1,17,340,185,155
050,56,041,"Wyoming","Uinta County",1,18,285,155,130
050,56,041,"Wyoming","Uinta County",1,19,195,106,89
050,56,041,"Wyoming","Uinta County",1,20,209,110,99
050,56,041,"Wyoming","Uinta County",1,21,225,120,105
050,56,041,"Wyoming","Uinta County",1,22,206,108,98
050,56,041,"Wyoming","Uinta County",1,23,201,100,101
050,56,041,"Wyoming","Uinta County",1,24,187,94,93
050,56,041,"Wyoming","Uinta County",1,25,199,97,102
050,56,041,"Wyoming","Uinta County",1,26,224,107,117
050,56,041,"Wyoming","Uinta County",1,27,226,103,123
050,56,041,"Wyoming","Uinta County",1,28,236,115,121
050,56,041,"Wyoming","Uinta County",1,29,245,131,114
050,56,041,"Wyoming","Uinta County",1,30,216,102,114
050,56,041,"Wyoming","Uinta County",1,31,241,114,127
050,56,041,"Wyoming","Uinta County",1,32,253,116,137
050,56,041,"Wyoming","Uinta County",1,33,243,121,122
050,56,041,"Wyoming","Uinta County",1,34,247,131,116
050,56,041,"Wyoming","Uinta County",1,35,256,131,125
050,56,041,"Wyoming","Uinta County",1,36,274,139,135
050,56,041,"Wyoming","Uinta County",1,37,291,148,143
050,56,041,"Wyoming","Uinta County",1,38,311,154,157
050,56,041,"Wyoming","Uinta County",1,39,302,149,153
050,56,041,"Wyoming","Uinta County",1,40,275,136,139
050,56,041,"Wyoming","Uinta County",1,41,275,138,137
050,56,041,"Wyoming","Uinta County",1,42,265,132,133
050,56,041,"Wyoming","Uinta County",1,43,247,118,129
050,56,041,"Wyoming","Uinta County",1,44,257,139,118
050,56,041,"Wyoming","Uinta County",1,45,253,135,118
050,56,041,"Wyoming","Uinta County",1,46,245,133,112
050,56,041,"Wyoming","Uinta County",1,47,227,117,110
050,56,041,"Wyoming","Uinta County",1,48,235,124,111
050,56,041,"Wyoming","Uinta County",1,49,246,123,123
050,56,041,"Wyoming","Uinta County",1,50,224,112,112
050,56,041,"Wyoming","Uinta County",1,51,205,110,95
050,56,041,"Wyoming","Uinta County",1,52,194,107,87
050,56,041,"Wyoming","Uinta County",1,53,214,109,105
050,56,041,"Wyoming","Uinta County",1,54,216,113,103
050,56,041,"Wyoming","Uinta County",1,55,213,107,106
050,56,041,"Wyoming","Uinta County",1,56,230,114,116
050,56,041,"Wyoming","Uinta County",1,57,231,106,125
050,56,041,"Wyoming","Uinta County",1,58,293,143,150
050,56,041,"Wyoming","Uinta County",1,59,287,151,136
050,56,041,"Wyoming","Uinta County",1,60,282,149,133
050,56,041,"Wyoming","Uinta County",1,61,283,148,135
050,56,041,"Wyoming","Uinta County",1,62,293,152,141
050,56,041,"Wyoming","Uinta County",1,63,302,158,144
050,56,041,"Wyoming","Uinta County",1,64,285,141,144
050,56,041,"Wyoming","Uinta County",1,65,276,133,143
050,56,041,"Wyoming","Uinta County",1,66,286,150,136
050,56,041,"Wyoming","Uinta County",1,67,250,139,111
050,56,041,"Wyoming","Uinta County",1,68,233,132,101
050,56,041,"Wyoming","Uinta County",1,69,216,116,100
050,56,041,"Wyoming","Uinta County",1,70,185,89,96
050,56,041,"Wyoming","Uinta County",1,71,177,88,89
050,56,041,"Wyoming","Uinta County",1,72,183,88,95
050,56,041,"Wyoming","Uinta County",1,73,165,80,85
050,56,041,"Wyoming","Uinta County",1,74,120,63,57
050,56,041,"Wyoming","Uinta County",1,75,117,65,52
050,56,041,"Wyoming","Uinta County",1,76,111,65,46
050,56,041,"Wyoming","Uinta County",1,77,119,61,58
050,56,041,"Wyoming","Uinta County",1,78,99,44,55
050,56,041,"Wyoming","Uinta County",1,79,69,35,34
050,56,041,"Wyoming","Uinta County",1,80,59,30,29
050,56,041,"Wyoming","Uinta County",1,81,53,24,29
050,56,041,"Wyoming","Uinta County",1,82,55,23,32
050,56,041,"Wyoming","Uinta County",1,83,45,19,26
050,56,041,"Wyoming","Uinta County",1,84,42,21,21
050,56,041,"Wyoming","Uinta County",1,85,260,97,163
050,56,041,"Wyoming","Uinta County",2,0,231,110,121
050,56,041,"Wyoming","Uinta County",2,1,233,114,119
050,56,041,"Wyoming","Uinta County",2,2,258,133,125
050,56,041,"Wyoming","Uinta County",2,3,269,139,130
050,56,041,"Wyoming","Uinta County",2,4,303,160,143
050,56,041,"Wyoming","Uinta County",2,5,305,155,150
050,56,041,"Wyoming","Uinta County",2,6,346,178,168
050,56,041,"Wyoming","Uinta County",2,7,333,175,158
050,56,041,"Wyoming","Uinta County",2,8,310,161,149
050,56,041,"Wyoming","Uinta County",2,9,332,180,152
050,56,041,"Wyoming","Uinta County",2,10,340,177,163
050,56,041,"Wyoming","Uinta County",2,11,349,176,173
050,56,041,"Wyoming","Uinta County",2,12,359,186,173
050,56,041,"Wyoming","Uinta County",2,13,363,192,171
050,56,041,"Wyoming","Uinta County",2,14,361,187,174
050,56,041,"Wyoming","Uinta County",2,15,351,167,184
050,56,041,"Wyoming","Uinta County",2,16,360,175,185
050,56,041,"Wyoming","Uinta County",2,17,346,184,162
050,56,041,"Wyoming","Uinta County",2,18,282,154,128
050,56,041,"Wyoming","Uinta County",2,19,200,108,92
050,56,041,"Wyoming","Uinta County",2,20,213,112,101
050,56,041,"Wyoming","Uinta County",2,21,222,117,105
050,56,041,"Wyoming","Uinta County",2,22,212,111,101
050,56,041,"Wyoming","Uinta County",2,23,204,103,101
050,56,041,"Wyoming","Uinta County",2,24,196,98,98
050,56,041,"Wyoming","Uinta County",2,25,199,98,101
050,56,041,"Wyoming","Uinta County",2,26,221,106,115
050,56,041,"Wyoming","Uinta County",2,27,226,104,122
050,56,041,"Wyoming","Uinta County",2,28,237,116,121
050,56,041,"Wyoming","Uinta County",2,29,240,125,115
050,56,041,"Wyoming","Uinta County",2,30,223,108,115
050,56,041,"Wyoming","Uinta County",2,31,234,111,123
050,56,041,"Wyoming","Uinta County",2,32,251,116,135
050,56,041,"Wyoming","Uinta County",2,33,247,121,126
050,56,041,"Wyoming","Uinta County",2,34,249,131,118
050,56,041,"Wyoming","Uinta County",2,35,255,130,125
050,56,041,"Wyoming","Uinta County",2,36,267,135,132
050,56,041,"Wyoming","Uinta County",2,37,288,146,142
050,56,041,"Wyoming","Uinta County",2,38,306,153,153
050,56,041,"Wyoming","Uinta County",2,39,303,151,152
050,56,041,"Wyoming","Uinta County",2,40,284,141,143
050,56,041,"Wyoming","Uinta County",2,41,276,138,138
050,56,041,"Wyoming","Uinta County",2,42,268,134,134
050,56,041,"Wyoming","Uinta County",2,43,252,122,130
050,56,041,"Wyoming","Uinta County",2,44,253,133,120
050,56,041,"Wyoming","Uinta County",2,45,254,136,118
050,56,041,"Wyoming","Uinta County",2,46,245,133,112
050,56,041,"Wyoming","Uinta County",2,47,232,121,111
050,56,041,"Wyoming","Uinta County",2,48,232,122,110
050,56,041,"Wyoming","Uinta County",2,49,245,123,122
050,56,041,"Wyoming","Uinta County",2,50,227,113,114
050,56,041,"Wyoming","Uinta County",2,51,210,111,99
050,56,041,"Wyoming","Uinta County",2,52,197,106,91
050,56,041,"Wyoming","Uinta County",2,53,211,110,101
050,56,041,"Wyoming","Uinta County",2,54,211,109,102
050,56,041,"Wyoming","Uinta County",2,55,214,110,104
050,56,041,"Wyoming","Uinta County",2,56,229,114,115
050,56,041,"Wyoming","Uinta County",2,57,233,109,124
050,56,041,"Wyoming","Uinta County",2,58,279,134,145
050,56,041,"Wyoming","Uinta County",2,59,287,148,139
050,56,041,"Wyoming","Uinta County",2,60,283,148,135
050,56,041,"Wyoming","Uinta County",2,61,281,146,135
050,56,041,"Wyoming","Uinta County",2,62,289,149,140
050,56,041,"Wyoming","Uinta County",2,63,301,156,145
050,56,041,"Wyoming","Uinta County",2,64,288,145,143
050,56,041,"Wyoming","Uinta County",2,65,277,134,143
050,56,041,"Wyoming","Uinta County",2,66,283,146,137
050,56,041,"Wyoming","Uinta County",2,67,257,140,117
050,56,041,"Wyoming","Uinta County",2,68,234,132,102
050,56,041,"Wyoming","Uinta County",2,69,222,120,102
050,56,041,"Wyoming","Uinta County",2,70,190,94,96
050,56,041,"Wyoming","Uinta County",2,71,178,88,90
050,56,041,"Wyoming","Uinta County",2,72,179,87,92
050,56,041,"Wyoming","Uinta County",2,73,178,86,92
050,56,041,"Wyoming","Uinta County",2,74,120,62,58
050,56,041,"Wyoming","Uinta County",2,75,116,63,53
050,56,041,"Wyoming","Uinta County",2,76,107,63,44
050,56,041,"Wyoming","Uinta County",2,77,117,63,54
050,56,041,"Wyoming","Uinta County",2,78,100,45,55
050,56,041,"Wyoming","Uinta County",2,79,76,37,39
050,56,041,"Wyoming","Uinta County",2,80,58,28,30
050,56,041,"Wyoming","Uinta County",2,81,53,25,28
050,56,041,"Wyoming","Uinta County",2,82,57,24,33
050,56,041,"Wyoming","Uinta County",2,83,45,19,26
050,56,041,"Wyoming","Uinta County",2,84,42,21,21
050,56,041,"Wyoming","Uinta County",2,85,263,98,165
050,56,041,"Wyoming","Uinta County",3,0,231,110,121
050,56,041,"Wyoming","Uinta County",3,1,250,121,129
050,56,041,"Wyoming","Uinta County",3,2,243,117,126
050,56,041,"Wyoming","Uinta County",3,3,271,135,136
050,56,041,"Wyoming","Uinta County",3,4,284,152,132
050,56,041,"Wyoming","Uinta County",3,5,314,164,150
050,56,041,"Wyoming","Uinta County",3,6,309,157,152
050,56,041,"Wyoming","Uinta County",3,7,347,177,170
050,56,041,"Wyoming","Uinta County",3,8,343,182,161
050,56,041,"Wyoming","Uinta County",3,9,311,166,145
050,56,041,"Wyoming","Uinta County",3,10,329,175,154
050,56,041,"Wyoming","Uinta County",3,11,338,179,159
050,56,041,"Wyoming","Uinta County",3,12,360,180,180
050,56,041,"Wyoming","Uinta County",3,13,376,203,173
050,56,041,"Wyoming","Uinta County",3,14,358,181,177
050,56,041,"Wyoming","Uinta County",3,15,369,191,178
050,56,041,"Wyoming","Uinta County",3,16,350,167,183
050,56,041,"Wyoming","Uinta County",3,17,366,176,190
050,56,041,"Wyoming","Uinta County",3,18,298,169,129
050,56,041,"Wyoming","Uinta County",3,19,210,119,91
050,56,041,"Wyoming","Uinta County",3,20,203,111,92
050,56,041,"Wyoming","Uinta County",3,21,218,108,110
050,56,041,"Wyoming","Uinta County",3,22,212,113,99
050,56,041,"Wyoming","Uinta County",3,23,209,112,97
050,56,041,"Wyoming","Uinta County",3,24,212,112,100
050,56,041,"Wyoming","Uinta County",3,25,212,104,108
050,56,041,"Wyoming","Uinta County",3,26,209,102,107
050,56,041,"Wyoming","Uinta County",3,27,233,111,122
050,56,041,"Wyoming","Uinta County",3,28,232,112,120
050,56,041,"Wyoming","Uinta County",3,29,242,116,126
050,56,041,"Wyoming","Uinta County",3,30,246,130,116
050,56,041,"Wyoming","Uinta County",3,31,245,122,123
050,56,041,"Wyoming","Uinta County",3,32,237,108,129
050,56,041,"Wyoming","Uinta County",3,33,261,129,132
050,56,041,"Wyoming","Uinta County",3,34,260,126,134
050,56,041,"Wyoming","Uinta County",3,35,246,127,119
050,56,041,"Wyoming","Uinta County",3,36,253,134,119
050,56,041,"Wyoming","Uinta County",3,37,277,140,137
050,56,041,"Wyoming","Uinta County",3,38,295,149,146
050,56,041,"Wyoming","Uinta County",3,39,313,156,157
050,56,041,"Wyoming","Uinta County",3,40,286,139,147
050,56,041,"Wyoming","Uinta County",3,41,291,141,150
050,56,041,"Wyoming","Uinta County",3,42,292,149,143
050,56,041,"Wyoming","Uinta County",3,43,277,138,139
050,56,041,"Wyoming","Uinta County",3,44,261,129,132
050,56,041,"Wyoming","Uinta County",3,45,256,137,119
050,56,041,"Wyoming","Uinta County",3,46,254,139,115
050,56,041,"Wyoming","Uinta County",3,47,254,139,115
050,56,041,"Wyoming","Uinta County",3,48,232,122,110
050,56,041,"Wyoming","Uinta County",3,49,233,125,108
050,56,041,"Wyoming","Uinta County",3,50,243,122,121
050,56,041,"Wyoming","Uinta County",3,51,228,113,115
050,56,041,"Wyoming","Uinta County",3,52,204,108,96
050,56,041,"Wyoming","Uinta County",3,53,198,106,92
050,56,041,"Wyoming","Uinta County",3,54,203,103,100
050,56,041,"Wyoming","Uinta County",3,55,205,108,97
050,56,041,"Wyoming","Uinta County",3,56,207,104,103
050,56,041,"Wyoming","Uinta County",3,57,225,110,115
050,56,041,"Wyoming","Uinta County",3,58,227,104,123
050,56,041,"Wyoming","Uinta County",3,59,266,128,138
050,56,041,"Wyoming","Uinta County",3,60,282,142,140
050,56,041,"Wyoming","Uinta County",3,61,283,148,135
050,56,041,"Wyoming","Uinta County",3,62,273,142,131
050,56,041,"Wyoming","Uinta County",3,63,292,151,141
050,56,041,"Wyoming","Uinta County",3,64,299,159,140
050,56,041,"Wyoming","Uinta County",3,65,274,139,135
050,56,041,"Wyoming","Uinta County",3,66,277,138,139
050,56,041,"Wyoming","Uinta County",3,67,279,144,135
050,56,041,"Wyoming","Uinta County",3,68,252,138,114
050,56,041,"Wyoming","Uinta County",3,69,240,132,108
050,56,041,"Wyoming","Uinta County",3,70,213,111,102
050,56,041,"Wyoming","Uinta County",3,71,183,93,90
050,56,041,"Wyoming","Uinta County",3,72,171,82,89
050,56,041,"Wyoming","Uinta County",3,73,180,88,92
050,56,041,"Wyoming","Uinta County",3,74,170,84,86
050,56,041,"Wyoming","Uinta County",3,75,112,57,55
050,56,041,"Wyoming","Uinta County",3,76,111,62,49
050,56,041,"Wyoming","Uinta County",3,77,101,61,40
050,56,041,"Wyoming","Uinta County",3,78,111,59,52
050,56,041,"Wyoming","Uinta County",3,79,95,44,51
050,56,041,"Wyoming","Uinta County",3,80,76,34,42
050,56,041,"Wyoming","Uinta County",3,81,56,27,29
050,56,041,"Wyoming","Uinta County",3,82,52,24,28
050,56,041,"Wyoming","Uinta County",3,83,57,21,36
050,56,041,"Wyoming","Uinta County",3,84,44,19,25
050,56,041,"Wyoming","Uinta County",3,85,284,107,177
050,56,041,"Wyoming","Uinta County",4,0,228,116,112
050,56,041,"Wyoming","Uinta County",4,1,236,109,127
050,56,041,"Wyoming","Uinta County",4,2,257,127,130
050,56,041,"Wyoming","Uinta County",4,3,231,111,120
050,56,041,"Wyoming","Uinta County",4,4,286,150,136
050,56,041,"Wyoming","Uinta County",4,5,284,148,136
050,56,041,"Wyoming","Uinta County",4,6,315,163,152
050,56,041,"Wyoming","Uinta County",4,7,306,156,150
050,56,041,"Wyoming","Uinta County",4,8,344,172,172
050,56,041,"Wyoming","Uinta County",4,9,351,187,164
050,56,041,"Wyoming","Uinta County",4,10,295,156,139
050,56,041,"Wyoming","Uinta County",4,11,341,183,158
050,56,041,"Wyoming","Uinta County",4,12,343,179,164
050,56,041,"Wyoming","Uinta County",4,13,359,184,175
050,56,041,"Wyoming","Uinta County",4,14,364,195,169
050,56,041,"Wyoming","Uinta County",4,15,357,185,172
050,56,041,"Wyoming","Uinta County",4,16,357,183,174
050,56,041,"Wyoming","Uinta County",4,17,358,170,188
050,56,041,"Wyoming","Uinta County",4,18,306,153,153
050,56,041,"Wyoming","Uinta County",4,19,213,127,86
050,56,041,"Wyoming","Uinta County",4,20,216,120,96
050,56,041,"Wyoming","Uinta County",4,21,216,109,107
050,56,041,"Wyoming","Uinta County",4,22,212,107,105
050,56,041,"Wyoming","Uinta County",4,23,217,119,98
050,56,041,"Wyoming","Uinta County",4,24,225,120,105
050,56,041,"Wyoming","Uinta County",4,25,195,106,89
050,56,041,"Wyoming","Uinta County",4,26,215,108,107
050,56,041,"Wyoming","Uinta County",4,27,223,106,117
050,56,041,"Wyoming","Uinta County",4,28,238,116,122
050,56,041,"Wyoming","Uinta County",4,29,236,108,128
050,56,041,"Wyoming","Uinta County",4,30,248,125,123
050,56,041,"Wyoming","Uinta County",4,31,252,131,121
050,56,041,"Wyoming","Uinta County",4,32,242,122,120
050,56,041,"Wyoming","Uinta County",4,33,242,112,130
050,56,041,"Wyoming","Uinta County",4,34,272,132,140
050,56,041,"Wyoming","Uinta County",4,35,260,126,134
050,56,041,"Wyoming","Uinta County",4,36,242,123,119
050,56,041,"Wyoming","Uinta County",4,37,251,127,124
050,56,041,"Wyoming","Uinta County",4,38,293,153,140
050,56,041,"Wyoming","Uinta County",4,39,297,153,144
050,56,041,"Wyoming","Uinta County",4,40,309,160,149
050,56,041,"Wyoming","Uinta County",4,41,291,141,150
050,56,041,"Wyoming","Uinta County",4,42,303,147,156
050,56,041,"Wyoming","Uinta County",4,43,288,147,141
050,56,041,"Wyoming","Uinta County",4,44,275,140,135
050,56,041,"Wyoming","Uinta County",4,45,273,134,139
050,56,041,"Wyoming","Uinta County",4,46,247,132,115
050,56,041,"Wyoming","Uinta County",4,47,252,144,108
050,56,041,"Wyoming","Uinta County",4,48,256,143,113
050,56,041,"Wyoming","Uinta County",4,49,236,126,110
050,56,041,"Wyoming","Uinta County",4,50,228,123,105
050,56,041,"Wyoming","Uinta County",4,51,239,121,118
050,56,041,"Wyoming","Uinta County",4,52,223,111,112
050,56,041,"Wyoming","Uinta County",4,53,210,111,99
050,56,041,"Wyoming","Uinta County",4,54,192,97,95
050,56,041,"Wyoming","Uinta County",4,55,210,105,105
050,56,041,"Wyoming","Uinta County",4,56,210,105,105
050,56,041,"Wyoming","Uinta County",4,57,196,98,98
050,56,041,"Wyoming","Uinta County",4,58,235,114,121
050,56,041,"Wyoming","Uinta County",4,59,226,106,120
050,56,041,"Wyoming","Uinta County",4,60,268,125,143
050,56,041,"Wyoming","Uinta County",4,61,272,133,139
050,56,041,"Wyoming","Uinta County",4,62,282,145,137
050,56,041,"Wyoming","Uinta County",4,63,273,140,133
050,56,041,"Wyoming","Uinta County",4,64,298,151,147
050,56,041,"Wyoming","Uinta County",4,65,290,156,134
050,56,041,"Wyoming","Uinta County",4,66,274,143,131
050,56,041,"Wyoming","Uinta County",4,67,274,137,137
050,56,041,"Wyoming","Uinta County",4,68,273,138,135
050,56,041,"Wyoming","Uinta County",4,69,254,141,113
050,56,041,"Wyoming","Uinta County",4,70,233,129,104
050,56,041,"Wyoming","Uinta County",4,71,211,109,102
050,56,041,"Wyoming","Uinta County",4,72,176,89,87
050,56,041,"Wyoming","Uinta County",4,73,172,80,92
050,56,041,"Wyoming","Uinta County",4,74,173,86,87
050,56,041,"Wyoming","Uinta County",4,75,160,74,86
050,56,041,"Wyoming","Uinta County",4,76,104,50,54
050,56,041,"Wyoming","Uinta County",4,77,106,56,50
050,56,041,"Wyoming","Uinta County",4,78,102,58,44
050,56,041,"Wyoming","Uinta County",4,79,106,57,49
050,56,041,"Wyoming","Uinta County",4,80,95,44,51
050,56,041,"Wyoming","Uinta County",4,81,71,34,37
050,56,041,"Wyoming","Uinta County",4,82,55,24,31
050,56,041,"Wyoming","Uinta County",4,83,49,20,29
050,56,041,"Wyoming","Uinta County",4,84,54,21,33
050,56,041,"Wyoming","Uinta County",4,85,280,109,171
050,56,041,"Wyoming","Uinta County",5,0,227,115,112
050,56,041,"Wyoming","Uinta County",5,1,228,108,120
050,56,041,"Wyoming","Uinta County",5,2,245,113,132
050,56,041,"Wyoming","Uinta County",5,3,250,118,132
050,56,041,"Wyoming","Uinta County",5,4,233,115,118
050,56,041,"Wyoming","Uinta County",5,5,277,144,133
050,56,041,"Wyoming","Uinta County",5,6,286,155,131
050,56,041,"Wyoming","Uinta County",5,7,313,163,150
050,56,041,"Wyoming","Uinta County",5,8,307,155,152
050,56,041,"Wyoming","Uinta County",5,9,337,167,170
050,56,041,"Wyoming","Uinta County",5,10,355,192,163
050,56,041,"Wyoming","Uinta County",5,11,302,156,146
050,56,041,"Wyoming","Uinta County",5,12,340,186,154
050,56,041,"Wyoming","Uinta County",5,13,339,176,163
050,56,041,"Wyoming","Uinta County",5,14,358,181,177
050,56,041,"Wyoming","Uinta County",5,15,361,194,167
050,56,041,"Wyoming","Uinta County",5,16,344,180,164
050,56,041,"Wyoming","Uinta County",5,17,365,182,183
050,56,041,"Wyoming","Uinta County",5,18,303,150,153
050,56,041,"Wyoming","Uinta County",5,19,226,117,109
050,56,041,"Wyoming","Uinta County",5,20,219,127,92
050,56,041,"Wyoming","Uinta County",5,21,231,131,100
050,56,041,"Wyoming","Uinta County",5,22,210,103,107
050,56,041,"Wyoming","Uinta County",5,23,230,110,120
050,56,041,"Wyoming","Uinta County",5,24,215,115,100
050,56,041,"Wyoming","Uinta County",5,25,225,124,101
050,56,041,"Wyoming","Uinta County",5,26,207,112,95
050,56,041,"Wyoming","Uinta County",5,27,215,113,102
050,56,041,"Wyoming","Uinta County",5,28,222,107,115
050,56,041,"Wyoming","Uinta County",5,29,239,111,128
050,56,041,"Wyoming","Uinta County",5,30,250,107,143
050,56,041,"Wyoming","Uinta County",5,31,244,128,116
050,56,041,"Wyoming","Uinta County",5,32,254,136,118
050,56,041,"Wyoming","Uinta County",5,33,243,126,117
050,56,041,"Wyoming","Uinta County",5,34,238,112,126
050,56,041,"Wyoming","Uinta County",5,35,270,131,139
050,56,041,"Wyoming","Uinta County",5,36,260,126,134
050,56,041,"Wyoming","Uinta County",5,37,257,131,126
050,56,041,"Wyoming","Uinta County",5,38,242,115,127
050,56,041,"Wyoming","Uinta County",5,39,286,155,131
050,56,041,"Wyoming","Uinta County",5,40,289,148,141
050,56,041,"Wyoming","Uinta County",5,41,317,166,151
050,56,041,"Wyoming","Uinta County",5,42,303,150,153
050,56,041,"Wyoming","Uinta County",5,43,300,144,156
050,56,041,"Wyoming","Uinta County",5,44,288,144,144
050,56,041,"Wyoming","Uinta County",5,45,283,141,142
050,56,041,"Wyoming","Uinta County",5,46,261,124,137
050,56,041,"Wyoming","Uinta County",5,47,251,138,113
050,56,041,"Wyoming","Uinta County",5,48,256,146,110
050,56,041,"Wyoming","Uinta County",5,49,261,149,112
050,56,041,"Wyoming","Uinta County",5,50,225,122,103
050,56,041,"Wyoming","Uinta County",5,51,234,124,110
050,56,041,"Wyoming","Uinta County",5,52,237,122,115
050,56,041,"Wyoming","Uinta County",5,53,230,118,112
050,56,041,"Wyoming","Uinta County",5,54,208,109,99
050,56,041,"Wyoming","Uinta County",5,55,187,92,95
050,56,041,"Wyoming","Uinta County",5,56,209,102,107
050,56,041,"Wyoming","Uinta County",5,57,201,101,100
050,56,041,"Wyoming","Uinta County",5,58,205,104,101
050,56,041,"Wyoming","Uinta County",5,59,227,107,120
050,56,041,"Wyoming","Uinta County",5,60,223,103,120
050,56,041,"Wyoming","Uinta County",5,61,267,124,143
050,56,041,"Wyoming","Uinta County",5,62,267,124,143
050,56,041,"Wyoming","Uinta County",5,63,277,141,136
050,56,041,"Wyoming","Uinta County",5,64,270,138,132
050,56,041,"Wyoming","Uinta County",5,65,295,150,145
050,56,041,"Wyoming","Uinta County",5,66,292,161,131
050,56,041,"Wyoming","Uinta County",5,67,277,147,130
050,56,041,"Wyoming","Uinta County",5,68,267,129,138
050,56,041,"Wyoming","Uinta County",5,69,273,138,135
050,56,041,"Wyoming","Uinta County",5,70,250,138,112
050,56,041,"Wyoming","Uinta County",5,71,233,126,107
050,56,041,"Wyoming","Uinta County",5,72,209,107,102
050,56,041,"Wyoming","Uinta County",5,73,180,91,89
050,56,041,"Wyoming","Uinta County",5,74,165,79,86
050,56,041,"Wyoming","Uinta County",5,75,167,81,86
050,56,041,"Wyoming","Uinta County",5,76,154,71,83
050,56,041,"Wyoming","Uinta County",5,77,96,45,51
050,56,041,"Wyoming","Uinta County",5,78,106,51,55
050,56,041,"Wyoming","Uinta County",5,79,97,57,40
050,56,041,"Wyoming","Uinta County",5,80,106,56,50
050,56,041,"Wyoming","Uinta County",5,81,84,37,47
050,56,041,"Wyoming","Uinta County",5,82,69,30,39
050,56,041,"Wyoming","Uinta County",5,83,56,24,32
050,56,041,"Wyoming","Uinta County",5,84,45,19,26
050,56,041,"Wyoming","Uinta County",5,85,295,114,181
050,56,043,"Wyoming","Washakie County",1,0,69,36,33
050,56,043,"Wyoming","Washakie County",1,1,88,49,39
050,56,043,"Wyoming","Washakie County",1,2,81,41,40
050,56,043,"Wyoming","Washakie County",1,3,62,32,30
050,56,043,"Wyoming","Washakie County",1,4,80,48,32
050,56,043,"Wyoming","Washakie County",1,5,83,49,34
050,56,043,"Wyoming","Washakie County",1,6,87,40,47
050,56,043,"Wyoming","Washakie County",1,7,85,47,38
050,56,043,"Wyoming","Washakie County",1,8,84,44,40
050,56,043,"Wyoming","Washakie County",1,9,88,43,45
050,56,043,"Wyoming","Washakie County",1,10,98,48,50
050,56,043,"Wyoming","Washakie County",1,11,102,51,51
050,56,043,"Wyoming","Washakie County",1,12,104,49,55
050,56,043,"Wyoming","Washakie County",1,13,124,60,64
050,56,043,"Wyoming","Washakie County",1,14,118,59,59
050,56,043,"Wyoming","Washakie County",1,15,120,74,46
050,56,043,"Wyoming","Washakie County",1,16,126,72,54
050,56,043,"Wyoming","Washakie County",1,17,136,74,62
050,56,043,"Wyoming","Washakie County",1,18,96,51,45
050,56,043,"Wyoming","Washakie County",1,19,70,39,31
050,56,043,"Wyoming","Washakie County",1,20,64,37,27
050,56,043,"Wyoming","Washakie County",1,21,75,45,30
050,56,043,"Wyoming","Washakie County",1,22,64,30,34
050,56,043,"Wyoming","Washakie County",1,23,65,30,35
050,56,043,"Wyoming","Washakie County",1,24,67,34,33
050,56,043,"Wyoming","Washakie County",1,25,69,40,29
050,56,043,"Wyoming","Washakie County",1,26,64,35,29
050,56,043,"Wyoming","Washakie County",1,27,67,26,41
050,56,043,"Wyoming","Washakie County",1,28,73,35,38
050,56,043,"Wyoming","Washakie County",1,29,72,37,35
050,56,043,"Wyoming","Washakie County",1,30,84,44,40
050,56,043,"Wyoming","Washakie County",1,31,77,44,33
050,56,043,"Wyoming","Washakie County",1,32,71,41,30
050,56,043,"Wyoming","Washakie County",1,33,78,44,34
050,56,043,"Wyoming","Washakie County",1,34,91,48,43
050,56,043,"Wyoming","Washakie County",1,35,91,52,39
050,56,043,"Wyoming","Washakie County",1,36,94,47,47
050,56,043,"Wyoming","Washakie County",1,37,86,39,47
050,56,043,"Wyoming","Washakie County",1,38,93,45,48
050,56,043,"Wyoming","Washakie County",1,39,115,59,56
050,56,043,"Wyoming","Washakie County",1,40,111,53,58
050,56,043,"Wyoming","Washakie County",1,41,86,51,35
050,56,043,"Wyoming","Washakie County",1,42,95,56,39
050,56,043,"Wyoming","Washakie County",1,43,95,46,49
050,56,043,"Wyoming","Washakie County",1,44,86,41,45
050,56,043,"Wyoming","Washakie County",1,45,75,33,42
050,56,043,"Wyoming","Washakie County",1,46,81,46,35
050,56,043,"Wyoming","Washakie County",1,47,92,50,42
050,56,043,"Wyoming","Washakie County",1,48,99,51,48
050,56,043,"Wyoming","Washakie County",1,49,81,46,35
050,56,043,"Wyoming","Washakie County",1,50,91,45,46
050,56,043,"Wyoming","Washakie County",1,51,87,47,40
050,56,043,"Wyoming","Washakie County",1,52,90,52,38
050,56,043,"Wyoming","Washakie County",1,53,99,56,43
050,56,043,"Wyoming","Washakie County",1,54,97,51,46
050,56,043,"Wyoming","Washakie County",1,55,100,52,48
050,56,043,"Wyoming","Washakie County",1,56,112,52,60
050,56,043,"Wyoming","Washakie County",1,57,109,56,53
050,56,043,"Wyoming","Washakie County",1,58,100,49,51
050,56,043,"Wyoming","Washakie County",1,59,110,54,56
050,56,043,"Wyoming","Washakie County",1,60,117,54,63
050,56,043,"Wyoming","Washakie County",1,61,126,64,62
050,56,043,"Wyoming","Washakie County",1,62,117,56,61
050,56,043,"Wyoming","Washakie County",1,63,118,61,57
050,56,043,"Wyoming","Washakie County",1,64,117,62,55
050,56,043,"Wyoming","Washakie County",1,65,109,56,53
050,56,043,"Wyoming","Washakie County",1,66,118,66,52
050,56,043,"Wyoming","Washakie County",1,67,121,66,55
050,56,043,"Wyoming","Washakie County",1,68,93,45,48
050,56,043,"Wyoming","Washakie County",1,69,96,47,49
050,56,043,"Wyoming","Washakie County",1,70,93,46,47
050,56,043,"Wyoming","Washakie County",1,71,88,46,42
050,56,043,"Wyoming","Washakie County",1,72,86,41,45
050,56,043,"Wyoming","Washakie County",1,73,84,42,42
050,56,043,"Wyoming","Washakie County",1,74,73,34,39
050,56,043,"Wyoming","Washakie County",1,75,72,33,39
050,56,043,"Wyoming","Washakie County",1,76,78,41,37
050,56,043,"Wyoming","Washakie County",1,77,66,37,29
050,56,043,"Wyoming","Washakie County",1,78,61,34,27
050,56,043,"Wyoming","Washakie County",1,79,55,29,26
050,56,043,"Wyoming","Washakie County",1,80,54,26,28
050,56,043,"Wyoming","Washakie County",1,81,54,26,28
050,56,043,"Wyoming","Washakie County",1,82,43,22,21
050,56,043,"Wyoming","Washakie County",1,83,34,16,18
050,56,043,"Wyoming","Washakie County",1,84,33,12,21
050,56,043,"Wyoming","Washakie County",1,85,216,79,137
050,56,043,"Wyoming","Washakie County",2,0,75,41,34
050,56,043,"Wyoming","Washakie County",2,1,83,46,37
050,56,043,"Wyoming","Washakie County",2,2,80,41,39
050,56,043,"Wyoming","Washakie County",2,3,68,35,33
050,56,043,"Wyoming","Washakie County",2,4,76,45,31
050,56,043,"Wyoming","Washakie County",2,5,82,48,34
050,56,043,"Wyoming","Washakie County",2,6,83,41,42
050,56,043,"Wyoming","Washakie County",2,7,85,45,40
050,56,043,"Wyoming","Washakie County",2,8,83,43,40
050,56,043,"Wyoming","Washakie County",2,9,88,43,45
050,56,043,"Wyoming","Washakie County",2,10,95,47,48
050,56,043,"Wyoming","Washakie County",2,11,99,50,49
050,56,043,"Wyoming","Washakie County",2,12,103,49,54
050,56,043,"Wyoming","Washakie County",2,13,117,56,61
050,56,043,"Wyoming","Washakie County",2,14,120,59,61
050,56,043,"Wyoming","Washakie County",2,15,120,71,49
050,56,043,"Wyoming","Washakie County",2,16,125,74,51
050,56,043,"Wyoming","Washakie County",2,17,134,74,60
050,56,043,"Wyoming","Washakie County",2,18,96,51,45
050,56,043,"Wyoming","Washakie County",2,19,70,37,33
050,56,043,"Wyoming","Washakie County",2,20,66,38,28
050,56,043,"Wyoming","Washakie County",2,21,73,42,31
050,56,043,"Wyoming","Washakie County",2,22,66,33,33
050,56,043,"Wyoming","Washakie County",2,23,66,31,35
050,56,043,"Wyoming","Washakie County",2,24,67,35,32
050,56,043,"Wyoming","Washakie County",2,25,72,40,32
050,56,043,"Wyoming","Washakie County",2,26,65,36,29
050,56,043,"Wyoming","Washakie County",2,27,66,28,38
050,56,043,"Wyoming","Washakie County",2,28,73,34,39
050,56,043,"Wyoming","Washakie County",2,29,73,37,36
050,56,043,"Wyoming","Washakie County",2,30,83,43,40
050,56,043,"Wyoming","Washakie County",2,31,79,45,34
050,56,043,"Wyoming","Washakie County",2,32,74,42,32
050,56,043,"Wyoming","Washakie County",2,33,76,43,33
050,56,043,"Wyoming","Washakie County",2,34,89,48,41
050,56,043,"Wyoming","Washakie County",2,35,92,51,41
050,56,043,"Wyoming","Washakie County",2,36,92,48,44
050,56,043,"Wyoming","Washakie County",2,37,87,40,47
050,56,043,"Wyoming","Washakie County",2,38,92,44,48
050,56,043,"Wyoming","Washakie County",2,39,109,55,54
050,56,043,"Wyoming","Washakie County",2,40,110,54,56
050,56,043,"Wyoming","Washakie County",2,41,91,52,39
050,56,043,"Wyoming","Washakie County",2,42,92,54,38
050,56,043,"Wyoming","Washakie County",2,43,94,48,46
050,56,043,"Wyoming","Washakie County",2,44,84,40,44
050,56,043,"Wyoming","Washakie County",2,45,77,35,42
050,56,043,"Wyoming","Washakie County",2,46,78,42,36
050,56,043,"Wyoming","Washakie County",2,47,88,48,40
050,56,043,"Wyoming","Washakie County",2,48,98,50,48
050,56,043,"Wyoming","Washakie County",2,49,85,47,38
050,56,043,"Wyoming","Washakie County",2,50,90,46,44
050,56,043,"Wyoming","Washakie County",2,51,88,47,41
050,56,043,"Wyoming","Washakie County",2,52,89,51,38
050,56,043,"Wyoming","Washakie County",2,53,96,55,41
050,56,043,"Wyoming","Washakie County",2,54,97,52,45
050,56,043,"Wyoming","Washakie County",2,55,99,52,47
050,56,043,"Wyoming","Washakie County",2,56,110,52,58
050,56,043,"Wyoming","Washakie County",2,57,110,55,55
050,56,043,"Wyoming","Washakie County",2,58,104,51,53
050,56,043,"Wyoming","Washakie County",2,59,108,53,55
050,56,043,"Wyoming","Washakie County",2,60,116,54,62
050,56,043,"Wyoming","Washakie County",2,61,123,61,62
050,56,043,"Wyoming","Washakie County",2,62,120,58,62
050,56,043,"Wyoming","Washakie County",2,63,120,61,59
050,56,043,"Wyoming","Washakie County",2,64,116,60,56
050,56,043,"Wyoming","Washakie County",2,65,109,56,53
050,56,043,"Wyoming","Washakie County",2,66,117,64,53
050,56,043,"Wyoming","Washakie County",2,67,120,66,54
050,56,043,"Wyoming","Washakie County",2,68,97,48,49
050,56,043,"Wyoming","Washakie County",2,69,95,47,48
050,56,043,"Wyoming","Washakie County",2,70,93,46,47
050,56,043,"Wyoming","Washakie County",2,71,90,46,44
050,56,043,"Wyoming","Washakie County",2,72,84,42,42
050,56,043,"Wyoming","Washakie County",2,73,90,45,45
050,56,043,"Wyoming","Washakie County",2,74,72,34,38
050,56,043,"Wyoming","Washakie County",2,75,71,33,38
050,56,043,"Wyoming","Washakie County",2,76,75,38,37
050,56,043,"Wyoming","Washakie County",2,77,71,39,32
050,56,043,"Wyoming","Washakie County",2,78,60,33,27
050,56,043,"Wyoming","Washakie County",2,79,54,29,25
050,56,043,"Wyoming","Washakie County",2,80,56,27,29
050,56,043,"Wyoming","Washakie County",2,81,54,26,28
050,56,043,"Wyoming","Washakie County",2,82,45,23,22
050,56,043,"Wyoming","Washakie County",2,83,36,18,18
050,56,043,"Wyoming","Washakie County",2,84,33,12,21
050,56,043,"Wyoming","Washakie County",2,85,210,78,132
050,56,043,"Wyoming","Washakie County",3,0,68,37,31
050,56,043,"Wyoming","Washakie County",3,1,65,37,28
050,56,043,"Wyoming","Washakie County",3,2,79,43,36
050,56,043,"Wyoming","Washakie County",3,3,78,41,37
050,56,043,"Wyoming","Washakie County",3,4,76,41,35
050,56,043,"Wyoming","Washakie County",3,5,74,43,31
050,56,043,"Wyoming","Washakie County",3,6,84,48,36
050,56,043,"Wyoming","Washakie County",3,7,75,37,38
050,56,043,"Wyoming","Washakie County",3,8,84,41,43
050,56,043,"Wyoming","Washakie County",3,9,80,42,38
050,56,043,"Wyoming","Washakie County",3,10,83,41,42
050,56,043,"Wyoming","Washakie County",3,11,96,46,50
050,56,043,"Wyoming","Washakie County",3,12,93,49,44
050,56,043,"Wyoming","Washakie County",3,13,102,51,51
050,56,043,"Wyoming","Washakie County",3,14,117,59,58
050,56,043,"Wyoming","Washakie County",3,15,124,64,60
050,56,043,"Wyoming","Washakie County",3,16,127,81,46
050,56,043,"Wyoming","Washakie County",3,17,131,78,53
050,56,043,"Wyoming","Washakie County",3,18,100,48,52
050,56,043,"Wyoming","Washakie County",3,19,77,40,37
050,56,043,"Wyoming","Washakie County",3,20,82,41,41
050,56,043,"Wyoming","Washakie County",3,21,72,42,30
050,56,043,"Wyoming","Washakie County",3,22,73,42,31
050,56,043,"Wyoming","Washakie County",3,23,60,33,27
050,56,043,"Wyoming","Washakie County",3,24,69,30,39
050,56,043,"Wyoming","Washakie County",3,25,67,39,28
050,56,043,"Wyoming","Washakie County",3,26,67,35,32
050,56,043,"Wyoming","Washakie County",3,27,69,36,33
050,56,043,"Wyoming","Washakie County",3,28,66,29,37
050,56,043,"Wyoming","Washakie County",3,29,72,38,34
050,56,043,"Wyoming","Washakie County",3,30,80,39,41
050,56,043,"Wyoming","Washakie County",3,31,86,41,45
050,56,043,"Wyoming","Washakie County",3,32,79,44,35
050,56,043,"Wyoming","Washakie County",3,33,83,47,36
050,56,043,"Wyoming","Washakie County",3,34,83,46,37
050,56,043,"Wyoming","Washakie County",3,35,88,51,37
050,56,043,"Wyoming","Washakie County",3,36,96,51,45
050,56,043,"Wyoming","Washakie County",3,37,91,46,45
050,56,043,"Wyoming","Washakie County",3,38,86,40,46
050,56,043,"Wyoming","Washakie County",3,39,97,49,48
050,56,043,"Wyoming","Washakie County",3,40,111,58,53
050,56,043,"Wyoming","Washakie County",3,41,116,61,55
050,56,043,"Wyoming","Washakie County",3,42,93,51,42
050,56,043,"Wyoming","Washakie County",3,43,89,52,37
050,56,043,"Wyoming","Washakie County",3,44,91,47,44
050,56,043,"Wyoming","Washakie County",3,45,90,43,47
050,56,043,"Wyoming","Washakie County",3,46,77,32,45
050,56,043,"Wyoming","Washakie County",3,47,83,46,37
050,56,043,"Wyoming","Washakie County",3,48,90,50,40
050,56,043,"Wyoming","Washakie County",3,49,101,48,53
050,56,043,"Wyoming","Washakie County",3,50,91,51,40
050,56,043,"Wyoming","Washakie County",3,51,97,50,47
050,56,043,"Wyoming","Washakie County",3,52,91,49,42
050,56,043,"Wyoming","Washakie County",3,53,94,56,38
050,56,043,"Wyoming","Washakie County",3,54,92,50,42
050,56,043,"Wyoming","Washakie County",3,55,99,56,43
050,56,043,"Wyoming","Washakie County",3,56,105,52,53
050,56,043,"Wyoming","Washakie County",3,57,110,52,58
050,56,043,"Wyoming","Washakie County",3,58,114,57,57
050,56,043,"Wyoming","Washakie County",3,59,101,51,50
050,56,043,"Wyoming","Washakie County",3,60,103,51,52
050,56,043,"Wyoming","Washakie County",3,61,120,55,65
050,56,043,"Wyoming","Washakie County",3,62,123,60,63
050,56,043,"Wyoming","Washakie County",3,63,121,58,63
050,56,043,"Wyoming","Washakie County",3,64,127,62,65
050,56,043,"Wyoming","Washakie County",3,65,121,62,59
050,56,043,"Wyoming","Washakie County",3,66,112,58,54
050,56,043,"Wyoming","Washakie County",3,67,116,63,53
050,56,043,"Wyoming","Washakie County",3,68,122,66,56
050,56,043,"Wyoming","Washakie County",3,69,97,49,48
050,56,043,"Wyoming","Washakie County",3,70,100,48,52
050,56,043,"Wyoming","Washakie County",3,71,92,44,48
050,56,043,"Wyoming","Washakie County",3,72,89,45,44
050,56,043,"Wyoming","Washakie County",3,73,85,42,43
050,56,043,"Wyoming","Washakie County",3,74,88,43,45
050,56,043,"Wyoming","Washakie County",3,75,70,32,38
050,56,043,"Wyoming","Washakie County",3,76,70,30,40
050,56,043,"Wyoming","Washakie County",3,77,71,36,35
050,56,043,"Wyoming","Washakie County",3,78,70,38,32
050,56,043,"Wyoming","Washakie County",3,79,57,31,26
050,56,043,"Wyoming","Washakie County",3,80,58,32,26
050,56,043,"Wyoming","Washakie County",3,81,58,30,28
050,56,043,"Wyoming","Washakie County",3,82,43,19,24
050,56,043,"Wyoming","Washakie County",3,83,44,24,20
050,56,043,"Wyoming","Washakie County",3,84,32,13,19
050,56,043,"Wyoming","Washakie County",3,85,216,81,135
050,56,043,"Wyoming","Washakie County",4,0,70,44,26
050,56,043,"Wyoming","Washakie County",4,1,65,38,27
050,56,043,"Wyoming","Washakie County",4,2,68,37,31
050,56,043,"Wyoming","Washakie County",4,3,74,42,32
050,56,043,"Wyoming","Washakie County",4,4,91,47,44
050,56,043,"Wyoming","Washakie County",4,5,75,44,31
050,56,043,"Wyoming","Washakie County",4,6,81,49,32
050,56,043,"Wyoming","Washakie County",4,7,86,49,37
050,56,043,"Wyoming","Washakie County",4,8,79,39,40
050,56,043,"Wyoming","Washakie County",4,9,90,42,48
050,56,043,"Wyoming","Washakie County",4,10,82,44,38
050,56,043,"Wyoming","Washakie County",4,11,93,48,45
050,56,043,"Wyoming","Washakie County",4,12,96,43,53
050,56,043,"Wyoming","Washakie County",4,13,93,49,44
050,56,043,"Wyoming","Washakie County",4,14,101,50,51
050,56,043,"Wyoming","Washakie County",4,15,116,62,54
050,56,043,"Wyoming","Washakie County",4,16,128,71,57
050,56,043,"Wyoming","Washakie County",4,17,122,81,41
050,56,043,"Wyoming","Washakie County",4,18,99,52,47
050,56,043,"Wyoming","Washakie County",4,19,75,37,38
050,56,043,"Wyoming","Washakie County",4,20,70,36,34
050,56,043,"Wyoming","Washakie County",4,21,79,41,38
050,56,043,"Wyoming","Washakie County",4,22,69,38,31
050,56,043,"Wyoming","Washakie County",4,23,75,43,32
050,56,043,"Wyoming","Washakie County",4,24,66,40,26
050,56,043,"Wyoming","Washakie County",4,25,68,30,38
050,56,043,"Wyoming","Washakie County",4,26,62,35,27
050,56,043,"Wyoming","Washakie County",4,27,65,33,32
050,56,043,"Wyoming","Washakie County",4,28,73,36,37
050,56,043,"Wyoming","Washakie County",4,29,66,30,36
050,56,043,"Wyoming","Washakie County",4,30,75,39,36
050,56,043,"Wyoming","Washakie County",4,31,77,37,40
050,56,043,"Wyoming","Washakie County",4,32,84,44,40
050,56,043,"Wyoming","Washakie County",4,33,87,49,38
050,56,043,"Wyoming","Washakie County",4,34,106,58,48
050,56,043,"Wyoming","Washakie County",4,35,84,46,38
050,56,043,"Wyoming","Washakie County",4,36,97,59,38
050,56,043,"Wyoming","Washakie County",4,37,98,55,43
050,56,043,"Wyoming","Washakie County",4,38,91,47,44
050,56,043,"Wyoming","Washakie County",4,39,83,38,45
050,56,043,"Wyoming","Washakie County",4,40,96,49,47
050,56,043,"Wyoming","Washakie County",4,41,109,56,53
050,56,043,"Wyoming","Washakie County",4,42,117,64,53
050,56,043,"Wyoming","Washakie County",4,43,93,51,42
050,56,043,"Wyoming","Washakie County",4,44,94,52,42
050,56,043,"Wyoming","Washakie County",4,45,90,45,45
050,56,043,"Wyoming","Washakie County",4,46,86,43,43
050,56,043,"Wyoming","Washakie County",4,47,75,29,46
050,56,043,"Wyoming","Washakie County",4,48,88,48,40
050,56,043,"Wyoming","Washakie County",4,49,94,51,43
050,56,043,"Wyoming","Washakie County",4,50,102,51,51
050,56,043,"Wyoming","Washakie County",4,51,83,47,36
050,56,043,"Wyoming","Washakie County",4,52,102,52,50
050,56,043,"Wyoming","Washakie County",4,53,85,47,38
050,56,043,"Wyoming","Washakie County",4,54,93,55,38
050,56,043,"Wyoming","Washakie County",4,55,91,50,41
050,56,043,"Wyoming","Washakie County",4,56,97,54,43
050,56,043,"Wyoming","Washakie County",4,57,109,54,55
050,56,043,"Wyoming","Washakie County",4,58,111,52,59
050,56,043,"Wyoming","Washakie County",4,59,119,58,61
050,56,043,"Wyoming","Washakie County",4,60,103,53,50
050,56,043,"Wyoming","Washakie County",4,61,103,50,53
050,56,043,"Wyoming","Washakie County",4,62,121,54,67
050,56,043,"Wyoming","Washakie County",4,63,129,67,62
050,56,043,"Wyoming","Washakie County",4,64,122,57,65
050,56,043,"Wyoming","Washakie County",4,65,125,61,64
050,56,043,"Wyoming","Washakie County",4,66,124,63,61
050,56,043,"Wyoming","Washakie County",4,67,106,56,50
050,56,043,"Wyoming","Washakie County",4,68,115,62,53
050,56,043,"Wyoming","Washakie County",4,69,119,64,55
050,56,043,"Wyoming","Washakie County",4,70,102,49,53
050,56,043,"Wyoming","Washakie County",4,71,98,47,51
050,56,043,"Wyoming","Washakie County",4,72,85,40,45
050,56,043,"Wyoming","Washakie County",4,73,84,41,43
050,56,043,"Wyoming","Washakie County",4,74,81,42,39
050,56,043,"Wyoming","Washakie County",4,75,84,41,43
050,56,043,"Wyoming","Washakie County",4,76,61,24,37
050,56,043,"Wyoming","Washakie County",4,77,68,30,38
050,56,043,"Wyoming","Washakie County",4,78,68,33,35
050,56,043,"Wyoming","Washakie County",4,79,66,34,32
050,56,043,"Wyoming","Washakie County",4,80,53,29,24
050,56,043,"Wyoming","Washakie County",4,81,63,35,28
050,56,043,"Wyoming","Washakie County",4,82,44,24,20
050,56,043,"Wyoming","Washakie County",4,83,44,21,23
050,56,043,"Wyoming","Washakie County",4,84,40,21,19
050,56,043,"Wyoming","Washakie County",4,85,223,85,138
050,56,043,"Wyoming","Washakie County",5,0,69,42,27
050,56,043,"Wyoming","Washakie County",5,1,68,47,21
050,56,043,"Wyoming","Washakie County",5,2,66,39,27
050,56,043,"Wyoming","Washakie County",5,3,66,34,32
050,56,043,"Wyoming","Washakie County",5,4,72,42,30
050,56,043,"Wyoming","Washakie County",5,5,89,44,45
050,56,043,"Wyoming","Washakie County",5,6,77,41,36
050,56,043,"Wyoming","Washakie County",5,7,87,50,37
050,56,043,"Wyoming","Washakie County",5,8,83,48,35
050,56,043,"Wyoming","Washakie County",5,9,79,36,43
050,56,043,"Wyoming","Washakie County",5,10,89,42,47
050,56,043,"Wyoming","Washakie County",5,11,84,45,39
050,56,043,"Wyoming","Washakie County",5,12,97,45,52
050,56,043,"Wyoming","Washakie County",5,13,93,44,49
050,56,043,"Wyoming","Washakie County",5,14,95,50,45
050,56,043,"Wyoming","Washakie County",5,15,106,56,50
050,56,043,"Wyoming","Washakie County",5,16,126,72,54
050,56,043,"Wyoming","Washakie County",5,17,124,73,51
050,56,043,"Wyoming","Washakie County",5,18,95,62,33
050,56,043,"Wyoming","Washakie County",5,19,73,38,35
050,56,043,"Wyoming","Washakie County",5,20,75,32,43
050,56,043,"Wyoming","Washakie County",5,21,79,42,37
050,56,043,"Wyoming","Washakie County",5,22,75,40,35
050,56,043,"Wyoming","Washakie County",5,23,71,37,34
050,56,043,"Wyoming","Washakie County",5,24,65,38,27
050,56,043,"Wyoming","Washakie County",5,25,68,42,26
050,56,043,"Wyoming","Washakie County",5,26,73,35,38
050,56,043,"Wyoming","Washakie County",5,27,57,31,26
050,56,043,"Wyoming","Washakie County",5,28,65,31,34
050,56,043,"Wyoming","Washakie County",5,29,76,41,35
050,56,043,"Wyoming","Washakie County",5,30,74,32,42
050,56,043,"Wyoming","Washakie County",5,31,80,42,38
050,56,043,"Wyoming","Washakie County",5,32,81,40,41
050,56,043,"Wyoming","Washakie County",5,33,87,43,44
050,56,043,"Wyoming","Washakie County",5,34,88,47,41
050,56,043,"Wyoming","Washakie County",5,35,102,55,47
050,56,043,"Wyoming","Washakie County",5,36,83,40,43
050,56,043,"Wyoming","Washakie County",5,37,97,60,37
050,56,043,"Wyoming","Washakie County",5,38,95,53,42
050,56,043,"Wyoming","Washakie County",5,39,88,49,39
050,56,043,"Wyoming","Washakie County",5,40,86,37,49
050,56,043,"Wyoming","Washakie County",5,41,100,54,46
050,56,043,"Wyoming","Washakie County",5,42,109,57,52
050,56,043,"Wyoming","Washakie County",5,43,121,65,56
050,56,043,"Wyoming","Washakie County",5,44,96,53,43
050,56,043,"Wyoming","Washakie County",5,45,100,54,46
050,56,043,"Wyoming","Washakie County",5,46,95,47,48
050,56,043,"Wyoming","Washakie County",5,47,85,43,42
050,56,043,"Wyoming","Washakie County",5,48,81,33,48
050,56,043,"Wyoming","Washakie County",5,49,85,45,40
050,56,043,"Wyoming","Washakie County",5,50,100,51,49
050,56,043,"Wyoming","Washakie County",5,51,97,49,48
050,56,043,"Wyoming","Washakie County",5,52,83,50,33
050,56,043,"Wyoming","Washakie County",5,53,101,52,49
050,56,043,"Wyoming","Washakie County",5,54,85,42,43
050,56,043,"Wyoming","Washakie County",5,55,89,52,37
050,56,043,"Wyoming","Washakie County",5,56,89,49,40
050,56,043,"Wyoming","Washakie County",5,57,93,50,43
050,56,043,"Wyoming","Washakie County",5,58,106,52,54
050,56,043,"Wyoming","Washakie County",5,59,114,53,61
050,56,043,"Wyoming","Washakie County",5,60,125,62,63
050,56,043,"Wyoming","Washakie County",5,61,106,56,50
050,56,043,"Wyoming","Washakie County",5,62,99,46,53
050,56,043,"Wyoming","Washakie County",5,63,121,55,66
050,56,043,"Wyoming","Washakie County",5,64,135,70,65
050,56,043,"Wyoming","Washakie County",5,65,119,58,61
050,56,043,"Wyoming","Washakie County",5,66,117,56,61
050,56,043,"Wyoming","Washakie County",5,67,117,57,60
050,56,043,"Wyoming","Washakie County",5,68,108,57,51
050,56,043,"Wyoming","Washakie County",5,69,117,62,55
050,56,043,"Wyoming","Washakie County",5,70,120,64,56
050,56,043,"Wyoming","Washakie County",5,71,100,49,51
050,56,043,"Wyoming","Washakie County",5,72,96,46,50
050,56,043,"Wyoming","Washakie County",5,73,82,37,45
050,56,043,"Wyoming","Washakie County",5,74,84,41,43
050,56,043,"Wyoming","Washakie County",5,75,74,39,35
050,56,043,"Wyoming","Washakie County",5,76,74,33,41
050,56,043,"Wyoming","Washakie County",5,77,60,24,36
050,56,043,"Wyoming","Washakie County",5,78,65,28,37
050,56,043,"Wyoming","Washakie County",5,79,65,31,34
050,56,043,"Wyoming","Washakie County",5,80,65,33,32
050,56,043,"Wyoming","Washakie County",5,81,56,34,22
050,56,043,"Wyoming","Washakie County",5,82,51,29,22
050,56,043,"Wyoming","Washakie County",5,83,43,25,18
050,56,043,"Wyoming","Washakie County",5,84,40,18,22
050,56,043,"Wyoming","Washakie County",5,85,239,99,140
050,56,045,"Wyoming","Weston County",1,0,50,25,25
050,56,045,"Wyoming","Weston County",1,1,55,24,31
050,56,045,"Wyoming","Weston County",1,2,72,36,36
050,56,045,"Wyoming","Weston County",1,3,60,34,26
050,56,045,"Wyoming","Weston County",1,4,71,29,42
050,56,045,"Wyoming","Weston County",1,5,67,29,38
050,56,045,"Wyoming","Weston County",1,6,76,40,36
050,56,045,"Wyoming","Weston County",1,7,83,39,44
050,56,045,"Wyoming","Weston County",1,8,83,43,40
050,56,045,"Wyoming","Weston County",1,9,86,38,48
050,56,045,"Wyoming","Weston County",1,10,86,40,46
050,56,045,"Wyoming","Weston County",1,11,71,30,41
050,56,045,"Wyoming","Weston County",1,12,69,39,30
050,56,045,"Wyoming","Weston County",1,13,73,40,33
050,56,045,"Wyoming","Weston County",1,14,91,48,43
050,56,045,"Wyoming","Weston County",1,15,83,37,46
050,56,045,"Wyoming","Weston County",1,16,91,48,43
050,56,045,"Wyoming","Weston County",1,17,82,43,39
050,56,045,"Wyoming","Weston County",1,18,66,39,27
050,56,045,"Wyoming","Weston County",1,19,63,43,20
050,56,045,"Wyoming","Weston County",1,20,65,44,21
050,56,045,"Wyoming","Weston County",1,21,57,40,17
050,56,045,"Wyoming","Weston County",1,22,66,37,29
050,56,045,"Wyoming","Weston County",1,23,67,47,20
050,56,045,"Wyoming","Weston County",1,24,58,42,16
050,56,045,"Wyoming","Weston County",1,25,72,40,32
050,56,045,"Wyoming","Weston County",1,26,74,48,26
050,56,045,"Wyoming","Weston County",1,27,66,37,29
050,56,045,"Wyoming","Weston County",1,28,89,59,30
050,56,045,"Wyoming","Weston County",1,29,68,41,27
050,56,045,"Wyoming","Weston County",1,30,63,33,30
050,56,045,"Wyoming","Weston County",1,31,83,50,33
050,56,045,"Wyoming","Weston County",1,32,96,58,38
050,56,045,"Wyoming","Weston County",1,33,73,43,30
050,56,045,"Wyoming","Weston County",1,34,87,49,38
050,56,045,"Wyoming","Weston County",1,35,95,50,45
050,56,045,"Wyoming","Weston County",1,36,103,57,46
050,56,045,"Wyoming","Weston County",1,37,111,57,54
050,56,045,"Wyoming","Weston County",1,38,111,52,59
050,56,045,"Wyoming","Weston County",1,39,108,64,44
050,56,045,"Wyoming","Weston County",1,40,101,60,41
050,56,045,"Wyoming","Weston County",1,41,96,58,38
050,56,045,"Wyoming","Weston County",1,42,86,61,25
050,56,045,"Wyoming","Weston County",1,43,73,37,36
050,56,045,"Wyoming","Weston County",1,44,68,37,31
050,56,045,"Wyoming","Weston County",1,45,76,46,30
050,56,045,"Wyoming","Weston County",1,46,70,34,36
050,56,045,"Wyoming","Weston County",1,47,64,37,27
050,56,045,"Wyoming","Weston County",1,48,79,54,25
050,56,045,"Wyoming","Weston County",1,49,82,56,26
050,56,045,"Wyoming","Weston County",1,50,77,43,34
050,56,045,"Wyoming","Weston County",1,51,67,38,29
050,56,045,"Wyoming","Weston County",1,52,92,48,44
050,56,045,"Wyoming","Weston County",1,53,82,44,38
050,56,045,"Wyoming","Weston County",1,54,84,47,37
050,56,045,"Wyoming","Weston County",1,55,93,51,42
050,56,045,"Wyoming","Weston County",1,56,112,65,47
050,56,045,"Wyoming","Weston County",1,57,113,59,54
050,56,045,"Wyoming","Weston County",1,58,121,71,50
050,56,045,"Wyoming","Weston County",1,59,111,61,50
050,56,045,"Wyoming","Weston County",1,60,109,60,49
050,56,045,"Wyoming","Weston County",1,61,94,49,45
050,56,045,"Wyoming","Weston County",1,62,117,60,57
050,56,045,"Wyoming","Weston County",1,63,113,61,52
050,56,045,"Wyoming","Weston County",1,64,122,58,64
050,56,045,"Wyoming","Weston County",1,65,126,68,58
050,56,045,"Wyoming","Weston County",1,66,119,65,54
050,56,045,"Wyoming","Weston County",1,67,111,63,48
050,56,045,"Wyoming","Weston County",1,68,97,58,39
050,56,045,"Wyoming","Weston County",1,69,79,43,36
050,56,045,"Wyoming","Weston County",1,70,74,43,31
050,56,045,"Wyoming","Weston County",1,71,78,41,37
050,56,045,"Wyoming","Weston County",1,72,67,31,36
050,56,045,"Wyoming","Weston County",1,73,78,44,34
050,56,045,"Wyoming","Weston County",1,74,53,27,26
050,56,045,"Wyoming","Weston County",1,75,48,24,24
050,56,045,"Wyoming","Weston County",1,76,49,26,23
050,56,045,"Wyoming","Weston County",1,77,50,24,26
050,56,045,"Wyoming","Weston County",1,78,36,15,21
050,56,045,"Wyoming","Weston County",1,79,31,15,16
050,56,045,"Wyoming","Weston County",1,80,34,17,17
050,56,045,"Wyoming","Weston County",1,81,36,14,22
050,56,045,"Wyoming","Weston County",1,82,32,9,23
050,56,045,"Wyoming","Weston County",1,83,31,10,21
050,56,045,"Wyoming","Weston County",1,84,37,19,18
050,56,045,"Wyoming","Weston County",1,85,180,70,110
050,56,045,"Wyoming","Weston County",2,0,57,31,26
050,56,045,"Wyoming","Weston County",2,1,54,24,30
050,56,045,"Wyoming","Weston County",2,2,66,33,33
050,56,045,"Wyoming","Weston County",2,3,62,34,28
050,56,045,"Wyoming","Weston County",2,4,70,30,40
050,56,045,"Wyoming","Weston County",2,5,68,29,39
050,56,045,"Wyoming","Weston County",2,6,73,37,36
050,56,045,"Wyoming","Weston County",2,7,81,40,41
050,56,045,"Wyoming","Weston County",2,8,83,42,41
050,56,045,"Wyoming","Weston County",2,9,85,39,46
050,56,045,"Wyoming","Weston County",2,10,85,38,47
050,56,045,"Wyoming","Weston County",2,11,73,32,41
050,56,045,"Wyoming","Weston County",2,12,69,37,32
050,56,045,"Wyoming","Weston County",2,13,73,41,32
050,56,045,"Wyoming","Weston County",2,14,86,45,41
050,56,045,"Wyoming","Weston County",2,15,84,40,44
050,56,045,"Wyoming","Weston County",2,16,90,47,43
050,56,045,"Wyoming","Weston County",2,17,82,43,39
050,56,045,"Wyoming","Weston County",2,18,68,40,28
050,56,045,"Wyoming","Weston County",2,19,64,44,20
050,56,045,"Wyoming","Weston County",2,20,66,45,21
050,56,045,"Wyoming","Weston County",2,21,56,38,18
050,56,045,"Wyoming","Weston County",2,22,65,39,26
050,56,045,"Wyoming","Weston County",2,23,69,48,21
050,56,045,"Wyoming","Weston County",2,24,56,39,17
050,56,045,"Wyoming","Weston County",2,25,69,41,28
050,56,045,"Wyoming","Weston County",2,26,73,45,28
050,56,045,"Wyoming","Weston County",2,27,67,40,27
050,56,045,"Wyoming","Weston County",2,28,84,55,29
050,56,045,"Wyoming","Weston County",2,29,72,44,28
050,56,045,"Wyoming","Weston County",2,30,63,34,29
050,56,045,"Wyoming","Weston County",2,31,80,48,32
050,56,045,"Wyoming","Weston County",2,32,95,58,37
050,56,045,"Wyoming","Weston County",2,33,75,44,31
050,56,045,"Wyoming","Weston County",2,34,81,46,35
050,56,045,"Wyoming","Weston County",2,35,94,51,43
050,56,045,"Wyoming","Weston County",2,36,102,57,45
050,56,045,"Wyoming","Weston County",2,37,109,58,51
050,56,045,"Wyoming","Weston County",2,38,110,51,59
050,56,045,"Wyoming","Weston County",2,39,114,66,48
050,56,045,"Wyoming","Weston County",2,40,102,59,43
050,56,045,"Wyoming","Weston County",2,41,97,58,39
050,56,045,"Wyoming","Weston County",2,42,90,62,28
050,56,045,"Wyoming","Weston County",2,43,74,41,33
050,56,045,"Wyoming","Weston County",2,44,70,37,33
050,56,045,"Wyoming","Weston County",2,45,74,44,30
050,56,045,"Wyoming","Weston County",2,46,69,35,34
050,56,045,"Wyoming","Weston County",2,47,64,36,28
050,56,045,"Wyoming","Weston County",2,48,76,51,25
050,56,045,"Wyoming","Weston County",2,49,81,55,26
050,56,045,"Wyoming","Weston County",2,50,75,44,31
050,56,045,"Wyoming","Weston County",2,51,68,39,29
050,56,045,"Wyoming","Weston County",2,52,85,45,40
050,56,045,"Wyoming","Weston County",2,53,84,44,40
050,56,045,"Wyoming","Weston County",2,54,82,45,37
050,56,045,"Wyoming","Weston County",2,55,93,51,42
050,56,045,"Wyoming","Weston County",2,56,107,62,45
050,56,045,"Wyoming","Weston County",2,57,110,58,52
050,56,045,"Wyoming","Weston County",2,58,120,69,51
050,56,045,"Wyoming","Weston County",2,59,114,63,51
050,56,045,"Wyoming","Weston County",2,60,111,61,50
050,56,045,"Wyoming","Weston County",2,61,96,50,46
050,56,045,"Wyoming","Weston County",2,62,110,56,54
050,56,045,"Wyoming","Weston County",2,63,116,61,55
050,56,045,"Wyoming","Weston County",2,64,116,59,57
050,56,045,"Wyoming","Weston County",2,65,124,66,58
050,56,045,"Wyoming","Weston County",2,66,118,65,53
050,56,045,"Wyoming","Weston County",2,67,111,62,49
050,56,045,"Wyoming","Weston County",2,68,101,59,42
050,56,045,"Wyoming","Weston County",2,69,84,47,37
050,56,045,"Wyoming","Weston County",2,70,77,44,33
050,56,045,"Wyoming","Weston County",2,71,74,40,34
050,56,045,"Wyoming","Weston County",2,72,69,33,36
050,56,045,"Wyoming","Weston County",2,73,79,43,36
050,56,045,"Wyoming","Weston County",2,74,57,30,27
050,56,045,"Wyoming","Weston County",2,75,49,25,24
050,56,045,"Wyoming","Weston County",2,76,48,25,23
050,56,045,"Wyoming","Weston County",2,77,51,25,26
050,56,045,"Wyoming","Weston County",2,78,38,17,21
050,56,045,"Wyoming","Weston County",2,79,32,15,17
050,56,045,"Wyoming","Weston County",2,80,32,16,16
050,56,045,"Wyoming","Weston County",2,81,36,15,21
050,56,045,"Wyoming","Weston County",2,82,32,11,21
050,56,045,"Wyoming","Weston County",2,83,31,9,22
050,56,045,"Wyoming","Weston County",2,84,34,17,17
050,56,045,"Wyoming","Weston County",2,85,182,70,112
050,56,045,"Wyoming","Weston County",3,0,49,24,25
050,56,045,"Wyoming","Weston County",3,1,68,38,30
050,56,045,"Wyoming","Weston County",3,2,49,24,25
050,56,045,"Wyoming","Weston County",3,3,61,31,30
050,56,045,"Wyoming","Weston County",3,4,68,38,30
050,56,045,"Wyoming","Weston County",3,5,69,31,38
050,56,045,"Wyoming","Weston County",3,6,65,30,35
050,56,045,"Wyoming","Weston County",3,7,78,43,35
050,56,045,"Wyoming","Weston County",3,8,89,44,45
050,56,045,"Wyoming","Weston County",3,9,76,38,38
050,56,045,"Wyoming","Weston County",3,10,80,37,43
050,56,045,"Wyoming","Weston County",3,11,91,40,51
050,56,045,"Wyoming","Weston County",3,12,77,33,44
050,56,045,"Wyoming","Weston County",3,13,69,40,29
050,56,045,"Wyoming","Weston County",3,14,79,45,34
050,56,045,"Wyoming","Weston County",3,15,82,41,41
050,56,045,"Wyoming","Weston County",3,16,84,41,43
050,56,045,"Wyoming","Weston County",3,17,80,40,40
050,56,045,"Wyoming","Weston County",3,18,80,48,32
050,56,045,"Wyoming","Weston County",3,19,63,40,23
050,56,045,"Wyoming","Weston County",3,20,68,45,23
050,56,045,"Wyoming","Weston County",3,21,56,37,19
050,56,045,"Wyoming","Weston County",3,22,58,37,21
050,56,045,"Wyoming","Weston County",3,23,77,53,24
050,56,045,"Wyoming","Weston County",3,24,57,36,21
050,56,045,"Wyoming","Weston County",3,25,57,40,17
050,56,045,"Wyoming","Weston County",3,26,66,41,25
050,56,045,"Wyoming","Weston County",3,27,66,40,26
050,56,045,"Wyoming","Weston County",3,28,62,40,22
050,56,045,"Wyoming","Weston County",3,29,73,44,29
050,56,045,"Wyoming","Weston County",3,30,67,40,27
050,56,045,"Wyoming","Weston County",3,31,70,44,26
050,56,045,"Wyoming","Weston County",3,32,91,58,33
050,56,045,"Wyoming","Weston County",3,33,79,44,35
050,56,045,"Wyoming","Weston County",3,34,72,39,33
050,56,045,"Wyoming","Weston County",3,35,76,46,30
050,56,045,"Wyoming","Weston County",3,36,100,59,41
050,56,045,"Wyoming","Weston County",3,37,101,57,44
050,56,045,"Wyoming","Weston County",3,38,96,43,53
050,56,045,"Wyoming","Weston County",3,39,127,67,60
050,56,045,"Wyoming","Weston County",3,40,108,59,49
050,56,045,"Wyoming","Weston County",3,41,100,58,42
050,56,045,"Wyoming","Weston County",3,42,106,67,39
050,56,045,"Wyoming","Weston County",3,43,83,54,29
050,56,045,"Wyoming","Weston County",3,44,76,42,34
050,56,045,"Wyoming","Weston County",3,45,73,38,35
050,56,045,"Wyoming","Weston County",3,46,66,39,27
050,56,045,"Wyoming","Weston County",3,47,71,36,35
050,56,045,"Wyoming","Weston County",3,48,68,41,27
050,56,045,"Wyoming","Weston County",3,49,80,53,27
050,56,045,"Wyoming","Weston County",3,50,81,51,30
050,56,045,"Wyoming","Weston County",3,51,73,42,31
050,56,045,"Wyoming","Weston County",3,52,70,40,30
050,56,045,"Wyoming","Weston County",3,53,82,44,38
050,56,045,"Wyoming","Weston County",3,54,77,40,37
050,56,045,"Wyoming","Weston County",3,55,81,46,35
050,56,045,"Wyoming","Weston County",3,56,98,55,43
050,56,045,"Wyoming","Weston County",3,57,104,58,46
050,56,045,"Wyoming","Weston County",3,58,116,64,52
050,56,045,"Wyoming","Weston County",3,59,119,67,52
050,56,045,"Wyoming","Weston County",3,60,120,65,55
050,56,045,"Wyoming","Weston County",3,61,107,56,51
050,56,045,"Wyoming","Weston County",3,62,102,56,46
050,56,045,"Wyoming","Weston County",3,63,115,58,57
050,56,045,"Wyoming","Weston County",3,64,119,64,55
050,56,045,"Wyoming","Weston County",3,65,117,61,56
050,56,045,"Wyoming","Weston County",3,66,118,63,55
050,56,045,"Wyoming","Weston County",3,67,112,61,51
050,56,045,"Wyoming","Weston County",3,68,110,63,47
050,56,045,"Wyoming","Weston County",3,69,97,55,42
050,56,045,"Wyoming","Weston County",3,70,85,49,36
050,56,045,"Wyoming","Weston County",3,71,71,42,29
050,56,045,"Wyoming","Weston County",3,72,74,42,32
050,56,045,"Wyoming","Weston County",3,73,67,31,36
050,56,045,"Wyoming","Weston County",3,74,80,44,36
050,56,045,"Wyoming","Weston County",3,75,50,24,26
050,56,045,"Wyoming","Weston County",3,76,45,24,21
050,56,045,"Wyoming","Weston County",3,77,52,23,29
050,56,045,"Wyoming","Weston County",3,78,44,24,20
050,56,045,"Wyoming","Weston County",3,79,31,14,17
050,56,045,"Wyoming","Weston County",3,80,26,12,14
050,56,045,"Wyoming","Weston County",3,81,29,14,15
050,56,045,"Wyoming","Weston County",3,82,34,16,18
050,56,045,"Wyoming","Weston County",3,83,28,10,18
050,56,045,"Wyoming","Weston County",3,84,27,10,17
050,56,045,"Wyoming","Weston County",3,85,178,69,109
050,56,045,"Wyoming","Weston County",4,0,53,23,30
050,56,045,"Wyoming","Weston County",4,1,47,24,23
050,56,045,"Wyoming","Weston County",4,2,73,39,34
050,56,045,"Wyoming","Weston County",4,3,49,21,28
050,56,045,"Wyoming","Weston County",4,4,63,35,28
050,56,045,"Wyoming","Weston County",4,5,63,34,29
050,56,045,"Wyoming","Weston County",4,6,68,29,39
050,56,045,"Wyoming","Weston County",4,7,69,33,36
050,56,045,"Wyoming","Weston County",4,8,72,39,33
050,56,045,"Wyoming","Weston County",4,9,87,43,44
050,56,045,"Wyoming","Weston County",4,10,78,40,38
050,56,045,"Wyoming","Weston County",4,11,84,40,44
050,56,045,"Wyoming","Weston County",4,12,89,42,47
050,56,045,"Wyoming","Weston County",4,13,79,33,46
050,56,045,"Wyoming","Weston County",4,14,68,41,27
050,56,045,"Wyoming","Weston County",4,15,76,42,34
050,56,045,"Wyoming","Weston County",4,16,91,47,44
050,56,045,"Wyoming","Weston County",4,17,87,41,46
050,56,045,"Wyoming","Weston County",4,18,72,43,29
050,56,045,"Wyoming","Weston County",4,19,75,49,26
050,56,045,"Wyoming","Weston County",4,20,69,46,23
050,56,045,"Wyoming","Weston County",4,21,61,34,27
050,56,045,"Wyoming","Weston County",4,22,66,43,23
050,56,045,"Wyoming","Weston County",4,23,85,62,23
050,56,045,"Wyoming","Weston County",4,24,70,46,24
050,56,045,"Wyoming","Weston County",4,25,62,39,23
050,56,045,"Wyoming","Weston County",4,26,55,39,16
050,56,045,"Wyoming","Weston County",4,27,64,42,22
050,56,045,"Wyoming","Weston County",4,28,70,45,25
050,56,045,"Wyoming","Weston County",4,29,54,31,23
050,56,045,"Wyoming","Weston County",4,30,71,42,29
050,56,045,"Wyoming","Weston County",4,31,80,54,26
050,56,045,"Wyoming","Weston County",4,32,81,54,27
050,56,045,"Wyoming","Weston County",4,33,85,51,34
050,56,045,"Wyoming","Weston County",4,34,75,43,32
050,56,045,"Wyoming","Weston County",4,35,69,39,30
050,56,045,"Wyoming","Weston County",4,36,90,57,33
050,56,045,"Wyoming","Weston County",4,37,101,59,42
050,56,045,"Wyoming","Weston County",4,38,86,47,39
050,56,045,"Wyoming","Weston County",4,39,113,60,53
050,56,045,"Wyoming","Weston County",4,40,121,60,61
050,56,045,"Wyoming","Weston County",4,41,109,57,52
050,56,045,"Wyoming","Weston County",4,42,112,66,46
050,56,045,"Wyoming","Weston County",4,43,102,61,41
050,56,045,"Wyoming","Weston County",4,44,86,55,31
050,56,045,"Wyoming","Weston County",4,45,75,42,33
050,56,045,"Wyoming","Weston County",4,46,74,39,35
050,56,045,"Wyoming","Weston County",4,47,70,39,31
050,56,045,"Wyoming","Weston County",4,48,78,43,35
050,56,045,"Wyoming","Weston County",4,49,71,45,26
050,56,045,"Wyoming","Weston County",4,50,75,49,26
050,56,045,"Wyoming","Weston County",4,51,86,56,30
050,56,045,"Wyoming","Weston County",4,52,75,39,36
050,56,045,"Wyoming","Weston County",4,53,73,42,31
050,56,045,"Wyoming","Weston County",4,54,86,46,40
050,56,045,"Wyoming","Weston County",4,55,85,46,39
050,56,045,"Wyoming","Weston County",4,56,87,45,42
050,56,045,"Wyoming","Weston County",4,57,101,52,49
050,56,045,"Wyoming","Weston County",4,58,108,62,46
050,56,045,"Wyoming","Weston County",4,59,109,58,51
050,56,045,"Wyoming","Weston County",4,60,122,71,51
050,56,045,"Wyoming","Weston County",4,61,126,69,57
050,56,045,"Wyoming","Weston County",4,62,110,55,55
050,56,045,"Wyoming","Weston County",4,63,101,55,46
050,56,045,"Wyoming","Weston County",4,64,116,58,58
050,56,045,"Wyoming","Weston County",4,65,132,70,62
050,56,045,"Wyoming","Weston County",4,66,114,58,56
050,56,045,"Wyoming","Weston County",4,67,119,67,52
050,56,045,"Wyoming","Weston County",4,68,112,60,52
050,56,045,"Wyoming","Weston County",4,69,105,61,44
050,56,045,"Wyoming","Weston County",4,70,101,56,45
050,56,045,"Wyoming","Weston County",4,71,87,51,36
050,56,045,"Wyoming","Weston County",4,72,79,46,33
050,56,045,"Wyoming","Weston County",4,73,72,41,31
050,56,045,"Wyoming","Weston County",4,74,67,30,37
050,56,045,"Wyoming","Weston County",4,75,74,40,34
050,56,045,"Wyoming","Weston County",4,76,48,23,25
050,56,045,"Wyoming","Weston County",4,77,46,22,24
050,56,045,"Wyoming","Weston County",4,78,47,23,24
050,56,045,"Wyoming","Weston County",4,79,34,19,15
050,56,045,"Wyoming","Weston County",4,80,26,12,14
050,56,045,"Wyoming","Weston County",4,81,26,11,15
050,56,045,"Wyoming","Weston County",4,82,28,16,12
050,56,045,"Wyoming","Weston County",4,83,31,15,16
050,56,045,"Wyoming","Weston County",4,84,26,10,16
050,56,045,"Wyoming","Weston County",4,85,176,64,112
050,56,045,"Wyoming","Weston County",5,0,50,22,28
050,56,045,"Wyoming","Weston County",5,1,63,31,32
050,56,045,"Wyoming","Weston County",5,2,51,25,26
050,56,045,"Wyoming","Weston County",5,3,72,37,35
050,56,045,"Wyoming","Weston County",5,4,48,19,29
050,56,045,"Wyoming","Weston County",5,5,61,31,30
050,56,045,"Wyoming","Weston County",5,6,66,36,30
050,56,045,"Wyoming","Weston County",5,7,67,30,37
050,56,045,"Wyoming","Weston County",5,8,68,31,37
050,56,045,"Wyoming","Weston County",5,9,76,46,30
050,56,045,"Wyoming","Weston County",5,10,89,46,43
050,56,045,"Wyoming","Weston County",5,11,78,40,38
050,56,045,"Wyoming","Weston County",5,12,82,38,44
050,56,045,"Wyoming","Weston County",5,13,86,43,43
050,56,045,"Wyoming","Weston County",5,14,72,34,38
050,56,045,"Wyoming","Weston County",5,15,74,43,31
050,56,045,"Wyoming","Weston County",5,16,76,40,36
050,56,045,"Wyoming","Weston County",5,17,86,44,42
050,56,045,"Wyoming","Weston County",5,18,73,38,35
050,56,045,"Wyoming","Weston County",5,19,70,47,23
050,56,045,"Wyoming","Weston County",5,20,79,54,25
050,56,045,"Wyoming","Weston County",5,21,58,34,24
050,56,045,"Wyoming","Weston County",5,22,58,30,28
050,56,045,"Wyoming","Weston County",5,23,88,60,28
050,56,045,"Wyoming","Weston County",5,24,72,48,24
050,56,045,"Wyoming","Weston County",5,25,68,43,25
050,56,045,"Wyoming","Weston County",5,26,65,38,27
050,56,045,"Wyoming","Weston County",5,27,57,36,21
050,56,045,"Wyoming","Weston County",5,28,66,44,22
050,56,045,"Wyoming","Weston County",5,29,66,41,25
050,56,045,"Wyoming","Weston County",5,30,54,32,22
050,56,045,"Wyoming","Weston County",5,31,80,49,31
050,56,045,"Wyoming","Weston County",5,32,94,62,32
050,56,045,"Wyoming","Weston County",5,33,66,40,26
050,56,045,"Wyoming","Weston County",5,34,82,44,38
050,56,045,"Wyoming","Weston County",5,35,78,45,33
050,56,045,"Wyoming","Weston County",5,36,75,44,31
050,56,045,"Wyoming","Weston County",5,37,90,57,33
050,56,045,"Wyoming","Weston County",5,38,89,48,41
050,56,045,"Wyoming","Weston County",5,39,100,61,39
050,56,045,"Wyoming","Weston County",5,40,108,55,53
050,56,045,"Wyoming","Weston County",5,41,111,58,53
050,56,045,"Wyoming","Weston County",5,42,112,62,50
050,56,045,"Wyoming","Weston County",5,43,98,52,46
050,56,045,"Wyoming","Weston County",5,44,103,62,41
050,56,045,"Wyoming","Weston County",5,45,85,58,27
050,56,045,"Wyoming","Weston County",5,46,73,40,33
050,56,045,"Wyoming","Weston County",5,47,75,38,37
050,56,045,"Wyoming","Weston County",5,48,81,46,35
050,56,045,"Wyoming","Weston County",5,49,78,44,34
050,56,045,"Wyoming","Weston County",5,50,68,43,25
050,56,045,"Wyoming","Weston County",5,51,71,45,26
050,56,045,"Wyoming","Weston County",5,52,85,57,28
050,56,045,"Wyoming","Weston County",5,53,72,37,35
050,56,045,"Wyoming","Weston County",5,54,73,40,33
050,56,045,"Wyoming","Weston County",5,55,87,46,41
050,56,045,"Wyoming","Weston County",5,56,87,49,38
050,56,045,"Wyoming","Weston County",5,57,85,39,46
050,56,045,"Wyoming","Weston County",5,58,110,57,53
050,56,045,"Wyoming","Weston County",5,59,111,61,50
050,56,045,"Wyoming","Weston County",5,60,107,58,49
050,56,045,"Wyoming","Weston County",5,61,116,69,47
050,56,045,"Wyoming","Weston County",5,62,125,67,58
050,56,045,"Wyoming","Weston County",5,63,110,56,54
050,56,045,"Wyoming","Weston County",5,64,99,53,46
050,56,045,"Wyoming","Weston County",5,65,115,59,56
050,56,045,"Wyoming","Weston County",5,66,126,61,65
050,56,045,"Wyoming","Weston County",5,67,111,55,56
050,56,045,"Wyoming","Weston County",5,68,114,65,49
050,56,045,"Wyoming","Weston County",5,69,108,59,49
050,56,045,"Wyoming","Weston County",5,70,106,61,45
050,56,045,"Wyoming","Weston County",5,71,93,52,41
050,56,045,"Wyoming","Weston County",5,72,88,53,35
050,56,045,"Wyoming","Weston County",5,73,78,45,33
050,56,045,"Wyoming","Weston County",5,74,72,41,31
050,56,045,"Wyoming","Weston County",5,75,62,28,34
050,56,045,"Wyoming","Weston County",5,76,75,41,34
050,56,045,"Wyoming","Weston County",5,77,53,24,29
050,56,045,"Wyoming","Weston County",5,78,41,22,19
050,56,045,"Wyoming","Weston County",5,79,40,20,20
050,56,045,"Wyoming","Weston County",5,80,31,16,15
050,56,045,"Wyoming","Weston County",5,81,22,10,12
050,56,045,"Wyoming","Weston County",5,82,23,12,11
050,56,045,"Wyoming","Weston County",5,83,25,15,10
050,56,045,"Wyoming","Weston County",5,84,29,15,14
050,56,045,"Wyoming","Weston County",5,85,173,60,113

