"SUMLEV","STATE","COUNTY","STNAME","CTYNAME","YEAR","AGE","TOT_POP","TOT_MALE","TOT_FEMALE"
050,44,001,"Rhode Island","Bristol County",1,0,315,160,155
050,44,001,"Rhode Island","Bristol County",1,1,338,174,164
050,44,001,"Rhode Island","Bristol County",1,2,421,213,208
050,44,001,"Rhode Island","Bristol County",1,3,420,206,214
050,44,001,"Rhode Island","Bristol County",1,4,445,214,231
050,44,001,"Rhode Island","Bristol County",1,5,508,248,260
050,44,001,"Rhode Island","Bristol County",1,6,453,237,216
050,44,001,"Rhode Island","Bristol County",1,7,466,236,230
050,44,001,"Rhode Island","Bristol County",1,8,499,246,253
050,44,001,"Rhode Island","Bristol County",1,9,566,294,272
050,44,001,"Rhode Island","Bristol County",1,10,588,305,283
050,44,001,"Rhode Island","Bristol County",1,11,565,288,277
050,44,001,"Rhode Island","Bristol County",1,12,606,333,273
050,44,001,"Rhode Island","Bristol County",1,13,632,316,316
050,44,001,"Rhode Island","Bristol County",1,14,649,345,304
050,44,001,"Rhode Island","Bristol County",1,15,608,320,288
050,44,001,"Rhode Island","Bristol County",1,16,642,311,331
050,44,001,"Rhode Island","Bristol County",1,17,661,322,339
050,44,001,"Rhode Island","Bristol County",1,18,1055,517,538
050,44,001,"Rhode Island","Bristol County",1,19,1163,568,595
050,44,001,"Rhode Island","Bristol County",1,20,981,491,490
050,44,001,"Rhode Island","Bristol County",1,21,977,477,500
050,44,001,"Rhode Island","Bristol County",1,22,727,363,364
050,44,001,"Rhode Island","Bristol County",1,23,546,276,270
050,44,001,"Rhode Island","Bristol County",1,24,530,247,283
050,44,001,"Rhode Island","Bristol County",1,25,475,243,232
050,44,001,"Rhode Island","Bristol County",1,26,465,242,223
050,44,001,"Rhode Island","Bristol County",1,27,478,259,219
050,44,001,"Rhode Island","Bristol County",1,28,499,269,230
050,44,001,"Rhode Island","Bristol County",1,29,538,282,256
050,44,001,"Rhode Island","Bristol County",1,30,512,266,246
050,44,001,"Rhode Island","Bristol County",1,31,506,255,251
050,44,001,"Rhode Island","Bristol County",1,32,493,247,246
050,44,001,"Rhode Island","Bristol County",1,33,521,259,262
050,44,001,"Rhode Island","Bristol County",1,34,538,261,277
050,44,001,"Rhode Island","Bristol County",1,35,551,269,282
050,44,001,"Rhode Island","Bristol County",1,36,571,289,282
050,44,001,"Rhode Island","Bristol County",1,37,606,293,313
050,44,001,"Rhode Island","Bristol County",1,38,601,275,326
050,44,001,"Rhode Island","Bristol County",1,39,598,294,304
050,44,001,"Rhode Island","Bristol County",1,40,579,277,302
050,44,001,"Rhode Island","Bristol County",1,41,568,272,296
050,44,001,"Rhode Island","Bristol County",1,42,534,268,266
050,44,001,"Rhode Island","Bristol County",1,43,549,273,276
050,44,001,"Rhode Island","Bristol County",1,44,545,246,299
050,44,001,"Rhode Island","Bristol County",1,45,543,253,290
050,44,001,"Rhode Island","Bristol County",1,46,613,304,309
050,44,001,"Rhode Island","Bristol County",1,47,653,338,315
050,44,001,"Rhode Island","Bristol County",1,48,657,320,337
050,44,001,"Rhode Island","Bristol County",1,49,724,356,368
050,44,001,"Rhode Island","Bristol County",1,50,721,334,387
050,44,001,"Rhode Island","Bristol County",1,51,691,323,368
050,44,001,"Rhode Island","Bristol County",1,52,693,334,359
050,44,001,"Rhode Island","Bristol County",1,53,720,381,339
050,44,001,"Rhode Island","Bristol County",1,54,707,349,358
050,44,001,"Rhode Island","Bristol County",1,55,801,383,418
050,44,001,"Rhode Island","Bristol County",1,56,786,364,422
050,44,001,"Rhode Island","Bristol County",1,57,783,367,416
050,44,001,"Rhode Island","Bristol County",1,58,817,395,422
050,44,001,"Rhode Island","Bristol County",1,59,843,388,455
050,44,001,"Rhode Island","Bristol County",1,60,803,393,410
050,44,001,"Rhode Island","Bristol County",1,61,780,386,394
050,44,001,"Rhode Island","Bristol County",1,62,781,379,402
050,44,001,"Rhode Island","Bristol County",1,63,791,383,408
050,44,001,"Rhode Island","Bristol County",1,64,750,371,379
050,44,001,"Rhode Island","Bristol County",1,65,718,351,367
050,44,001,"Rhode Island","Bristol County",1,66,674,321,353
050,44,001,"Rhode Island","Bristol County",1,67,628,302,326
050,44,001,"Rhode Island","Bristol County",1,68,611,287,324
050,44,001,"Rhode Island","Bristol County",1,69,543,258,285
050,44,001,"Rhode Island","Bristol County",1,70,525,258,267
050,44,001,"Rhode Island","Bristol County",1,71,521,227,294
050,44,001,"Rhode Island","Bristol County",1,72,531,241,290
050,44,001,"Rhode Island","Bristol County",1,73,552,268,284
050,44,001,"Rhode Island","Bristol County",1,74,386,173,213
050,44,001,"Rhode Island","Bristol County",1,75,351,142,209
050,44,001,"Rhode Island","Bristol County",1,76,370,161,209
050,44,001,"Rhode Island","Bristol County",1,77,403,198,205
050,44,001,"Rhode Island","Bristol County",1,78,310,144,166
050,44,001,"Rhode Island","Bristol County",1,79,268,123,145
050,44,001,"Rhode Island","Bristol County",1,80,251,113,138
050,44,001,"Rhode Island","Bristol County",1,81,245,113,132
050,44,001,"Rhode Island","Bristol County",1,82,239,106,133
050,44,001,"Rhode Island","Bristol County",1,83,233,97,136
050,44,001,"Rhode Island","Bristol County",1,84,209,89,120
050,44,001,"Rhode Island","Bristol County",1,85,1476,543,933
050,44,001,"Rhode Island","Bristol County",2,0,334,159,175
050,44,001,"Rhode Island","Bristol County",2,1,339,174,165
050,44,001,"Rhode Island","Bristol County",2,2,407,206,201
050,44,001,"Rhode Island","Bristol County",2,3,420,207,213
050,44,001,"Rhode Island","Bristol County",2,4,446,215,231
050,44,001,"Rhode Island","Bristol County",2,5,495,240,255
050,44,001,"Rhode Island","Bristol County",2,6,470,242,228
050,44,001,"Rhode Island","Bristol County",2,7,466,239,227
050,44,001,"Rhode Island","Bristol County",2,8,492,242,250
050,44,001,"Rhode Island","Bristol County",2,9,549,282,267
050,44,001,"Rhode Island","Bristol County",2,10,584,304,280
050,44,001,"Rhode Island","Bristol County",2,11,570,293,277
050,44,001,"Rhode Island","Bristol County",2,12,600,325,275
050,44,001,"Rhode Island","Bristol County",2,13,626,321,305
050,44,001,"Rhode Island","Bristol County",2,14,644,338,306
050,44,001,"Rhode Island","Bristol County",2,15,621,328,293
050,44,001,"Rhode Island","Bristol County",2,16,636,316,320
050,44,001,"Rhode Island","Bristol County",2,17,659,321,338
050,44,001,"Rhode Island","Bristol County",2,18,1050,511,539
050,44,001,"Rhode Island","Bristol County",2,19,1168,572,596
050,44,001,"Rhode Island","Bristol County",2,20,986,493,493
050,44,001,"Rhode Island","Bristol County",2,21,977,480,497
050,44,001,"Rhode Island","Bristol County",2,22,720,359,361
050,44,001,"Rhode Island","Bristol County",2,23,553,276,277
050,44,001,"Rhode Island","Bristol County",2,24,527,252,275
050,44,001,"Rhode Island","Bristol County",2,25,480,241,239
050,44,001,"Rhode Island","Bristol County",2,26,468,244,224
050,44,001,"Rhode Island","Bristol County",2,27,479,259,220
050,44,001,"Rhode Island","Bristol County",2,28,497,269,228
050,44,001,"Rhode Island","Bristol County",2,29,529,278,251
050,44,001,"Rhode Island","Bristol County",2,30,513,265,248
050,44,001,"Rhode Island","Bristol County",2,31,504,256,248
050,44,001,"Rhode Island","Bristol County",2,32,502,249,253
050,44,001,"Rhode Island","Bristol County",2,33,524,260,264
050,44,001,"Rhode Island","Bristol County",2,34,540,265,275
050,44,001,"Rhode Island","Bristol County",2,35,555,272,283
050,44,001,"Rhode Island","Bristol County",2,36,564,282,282
050,44,001,"Rhode Island","Bristol County",2,37,602,291,311
050,44,001,"Rhode Island","Bristol County",2,38,609,285,324
050,44,001,"Rhode Island","Bristol County",2,39,605,294,311
050,44,001,"Rhode Island","Bristol County",2,40,590,284,306
050,44,001,"Rhode Island","Bristol County",2,41,566,272,294
050,44,001,"Rhode Island","Bristol County",2,42,541,268,273
050,44,001,"Rhode Island","Bristol County",2,43,551,275,276
050,44,001,"Rhode Island","Bristol County",2,44,542,251,291
050,44,001,"Rhode Island","Bristol County",2,45,551,255,296
050,44,001,"Rhode Island","Bristol County",2,46,597,294,303
050,44,001,"Rhode Island","Bristol County",2,47,641,327,314
050,44,001,"Rhode Island","Bristol County",2,48,658,324,334
050,44,001,"Rhode Island","Bristol County",2,49,713,350,363
050,44,001,"Rhode Island","Bristol County",2,50,718,337,381
050,44,001,"Rhode Island","Bristol County",2,51,693,325,368
050,44,001,"Rhode Island","Bristol County",2,52,687,328,359
050,44,001,"Rhode Island","Bristol County",2,53,711,369,342
050,44,001,"Rhode Island","Bristol County",2,54,707,353,354
050,44,001,"Rhode Island","Bristol County",2,55,779,376,403
050,44,001,"Rhode Island","Bristol County",2,56,791,368,423
050,44,001,"Rhode Island","Bristol County",2,57,784,366,418
050,44,001,"Rhode Island","Bristol County",2,58,806,387,419
050,44,001,"Rhode Island","Bristol County",2,59,841,391,450
050,44,001,"Rhode Island","Bristol County",2,60,811,389,422
050,44,001,"Rhode Island","Bristol County",2,61,780,383,397
050,44,001,"Rhode Island","Bristol County",2,62,781,381,400
050,44,001,"Rhode Island","Bristol County",2,63,792,383,409
050,44,001,"Rhode Island","Bristol County",2,64,754,372,382
050,44,001,"Rhode Island","Bristol County",2,65,722,355,367
050,44,001,"Rhode Island","Bristol County",2,66,682,325,357
050,44,001,"Rhode Island","Bristol County",2,67,636,305,331
050,44,001,"Rhode Island","Bristol County",2,68,612,287,325
050,44,001,"Rhode Island","Bristol County",2,69,562,267,295
050,44,001,"Rhode Island","Bristol County",2,70,528,258,270
050,44,001,"Rhode Island","Bristol County",2,71,518,230,288
050,44,001,"Rhode Island","Bristol County",2,72,518,233,285
050,44,001,"Rhode Island","Bristol County",2,73,569,272,297
050,44,001,"Rhode Island","Bristol County",2,74,393,179,214
050,44,001,"Rhode Island","Bristol County",2,75,356,147,209
050,44,001,"Rhode Island","Bristol County",2,76,361,156,205
050,44,001,"Rhode Island","Bristol County",2,77,404,194,210
050,44,001,"Rhode Island","Bristol County",2,78,319,151,168
050,44,001,"Rhode Island","Bristol County",2,79,277,128,149
050,44,001,"Rhode Island","Bristol County",2,80,252,115,137
050,44,001,"Rhode Island","Bristol County",2,81,244,113,131
050,44,001,"Rhode Island","Bristol County",2,82,237,106,131
050,44,001,"Rhode Island","Bristol County",2,83,228,97,131
050,44,001,"Rhode Island","Bristol County",2,84,215,93,122
050,44,001,"Rhode Island","Bristol County",2,85,1456,532,924
050,44,001,"Rhode Island","Bristol County",3,0,320,162,158
050,44,001,"Rhode Island","Bristol County",3,1,368,174,194
050,44,001,"Rhode Island","Bristol County",3,2,365,179,186
050,44,001,"Rhode Island","Bristol County",3,3,431,221,210
050,44,001,"Rhode Island","Bristol County",3,4,435,216,219
050,44,001,"Rhode Island","Bristol County",3,5,446,211,235
050,44,001,"Rhode Island","Bristol County",3,6,504,241,263
050,44,001,"Rhode Island","Bristol County",3,7,485,249,236
050,44,001,"Rhode Island","Bristol County",3,8,482,246,236
050,44,001,"Rhode Island","Bristol County",3,9,490,244,246
050,44,001,"Rhode Island","Bristol County",3,10,553,281,272
050,44,001,"Rhode Island","Bristol County",3,11,591,302,289
050,44,001,"Rhode Island","Bristol County",3,12,571,295,276
050,44,001,"Rhode Island","Bristol County",3,13,605,331,274
050,44,001,"Rhode Island","Bristol County",3,14,641,325,316
050,44,001,"Rhode Island","Bristol County",3,15,637,335,302
050,44,001,"Rhode Island","Bristol County",3,16,625,326,299
050,44,001,"Rhode Island","Bristol County",3,17,638,320,318
050,44,001,"Rhode Island","Bristol County",3,18,1040,495,545
050,44,001,"Rhode Island","Bristol County",3,19,1148,565,583
050,44,001,"Rhode Island","Bristol County",3,20,954,473,481
050,44,001,"Rhode Island","Bristol County",3,21,961,476,485
050,44,001,"Rhode Island","Bristol County",3,22,710,364,346
050,44,001,"Rhode Island","Bristol County",3,23,552,278,274
050,44,001,"Rhode Island","Bristol County",3,24,519,254,265
050,44,001,"Rhode Island","Bristol County",3,25,492,243,249
050,44,001,"Rhode Island","Bristol County",3,26,476,232,244
050,44,001,"Rhode Island","Bristol County",3,27,467,260,207
050,44,001,"Rhode Island","Bristol County",3,28,468,253,215
050,44,001,"Rhode Island","Bristol County",3,29,508,278,230
050,44,001,"Rhode Island","Bristol County",3,30,546,281,265
050,44,001,"Rhode Island","Bristol County",3,31,532,266,266
050,44,001,"Rhode Island","Bristol County",3,32,547,277,270
050,44,001,"Rhode Island","Bristol County",3,33,547,274,273
050,44,001,"Rhode Island","Bristol County",3,34,568,282,286
050,44,001,"Rhode Island","Bristol County",3,35,562,277,285
050,44,001,"Rhode Island","Bristol County",3,36,593,292,301
050,44,001,"Rhode Island","Bristol County",3,37,590,284,306
050,44,001,"Rhode Island","Bristol County",3,38,621,305,316
050,44,001,"Rhode Island","Bristol County",3,39,600,279,321
050,44,001,"Rhode Island","Bristol County",3,40,622,305,317
050,44,001,"Rhode Island","Bristol County",3,41,614,305,309
050,44,001,"Rhode Island","Bristol County",3,42,584,284,300
050,44,001,"Rhode Island","Bristol County",3,43,533,264,269
050,44,001,"Rhode Island","Bristol County",3,44,561,270,291
050,44,001,"Rhode Island","Bristol County",3,45,544,254,290
050,44,001,"Rhode Island","Bristol County",3,46,565,262,303
050,44,001,"Rhode Island","Bristol County",3,47,594,288,306
050,44,001,"Rhode Island","Bristol County",3,48,641,325,316
050,44,001,"Rhode Island","Bristol County",3,49,663,326,337
050,44,001,"Rhode Island","Bristol County",3,50,719,345,374
050,44,001,"Rhode Island","Bristol County",3,51,729,350,379
050,44,001,"Rhode Island","Bristol County",3,52,683,319,364
050,44,001,"Rhode Island","Bristol County",3,53,688,334,354
050,44,001,"Rhode Island","Bristol County",3,54,704,361,343
050,44,001,"Rhode Island","Bristol County",3,55,715,361,354
050,44,001,"Rhode Island","Bristol County",3,56,753,358,395
050,44,001,"Rhode Island","Bristol County",3,57,790,366,424
050,44,001,"Rhode Island","Bristol County",3,58,787,365,422
050,44,001,"Rhode Island","Bristol County",3,59,807,391,416
050,44,001,"Rhode Island","Bristol County",3,60,835,389,446
050,44,001,"Rhode Island","Bristol County",3,61,809,383,426
050,44,001,"Rhode Island","Bristol County",3,62,751,364,387
050,44,001,"Rhode Island","Bristol County",3,63,768,373,395
050,44,001,"Rhode Island","Bristol County",3,64,795,383,412
050,44,001,"Rhode Island","Bristol County",3,65,753,367,386
050,44,001,"Rhode Island","Bristol County",3,66,714,348,366
050,44,001,"Rhode Island","Bristol County",3,67,672,315,357
050,44,001,"Rhode Island","Bristol County",3,68,622,289,333
050,44,001,"Rhode Island","Bristol County",3,69,602,285,317
050,44,001,"Rhode Island","Bristol County",3,70,546,260,286
050,44,001,"Rhode Island","Bristol County",3,71,517,250,267
050,44,001,"Rhode Island","Bristol County",3,72,521,227,294
050,44,001,"Rhode Island","Bristol County",3,73,492,226,266
050,44,001,"Rhode Island","Bristol County",3,74,551,258,293
050,44,001,"Rhode Island","Bristol County",3,75,372,171,201
050,44,001,"Rhode Island","Bristol County",3,76,344,146,198
050,44,001,"Rhode Island","Bristol County",3,77,355,146,209
050,44,001,"Rhode Island","Bristol County",3,78,378,179,199
050,44,001,"Rhode Island","Bristol County",3,79,322,154,168
050,44,001,"Rhode Island","Bristol County",3,80,259,120,139
050,44,001,"Rhode Island","Bristol County",3,81,243,108,135
050,44,001,"Rhode Island","Bristol County",3,82,228,112,116
050,44,001,"Rhode Island","Bristol County",3,83,223,94,129
050,44,001,"Rhode Island","Bristol County",3,84,210,93,117
050,44,001,"Rhode Island","Bristol County",3,85,1408,525,883
050,44,001,"Rhode Island","Bristol County",4,0,356,180,176
050,44,001,"Rhode Island","Bristol County",4,1,315,159,156
050,44,001,"Rhode Island","Bristol County",4,2,374,177,197
050,44,001,"Rhode Island","Bristol County",4,3,381,189,192
050,44,001,"Rhode Island","Bristol County",4,4,427,221,206
050,44,001,"Rhode Island","Bristol County",4,5,454,233,221
050,44,001,"Rhode Island","Bristol County",4,6,466,216,250
050,44,001,"Rhode Island","Bristol County",4,7,503,244,259
050,44,001,"Rhode Island","Bristol County",4,8,478,246,232
050,44,001,"Rhode Island","Bristol County",4,9,501,254,247
050,44,001,"Rhode Island","Bristol County",4,10,496,245,251
050,44,001,"Rhode Island","Bristol County",4,11,563,290,273
050,44,001,"Rhode Island","Bristol County",4,12,591,304,287
050,44,001,"Rhode Island","Bristol County",4,13,570,301,269
050,44,001,"Rhode Island","Bristol County",4,14,608,332,276
050,44,001,"Rhode Island","Bristol County",4,15,633,322,311
050,44,001,"Rhode Island","Bristol County",4,16,628,325,303
050,44,001,"Rhode Island","Bristol County",4,17,619,330,289
050,44,001,"Rhode Island","Bristol County",4,18,977,473,504
050,44,001,"Rhode Island","Bristol County",4,19,1087,533,554
050,44,001,"Rhode Island","Bristol County",4,20,921,460,461
050,44,001,"Rhode Island","Bristol County",4,21,919,451,468
050,44,001,"Rhode Island","Bristol County",4,22,687,349,338
050,44,001,"Rhode Island","Bristol County",4,23,537,279,258
050,44,001,"Rhode Island","Bristol County",4,24,518,266,252
050,44,001,"Rhode Island","Bristol County",4,25,487,250,237
050,44,001,"Rhode Island","Bristol County",4,26,475,234,241
050,44,001,"Rhode Island","Bristol County",4,27,460,225,235
050,44,001,"Rhode Island","Bristol County",4,28,457,239,218
050,44,001,"Rhode Island","Bristol County",4,29,445,241,204
050,44,001,"Rhode Island","Bristol County",4,30,523,284,239
050,44,001,"Rhode Island","Bristol County",4,31,550,274,276
050,44,001,"Rhode Island","Bristol County",4,32,549,277,272
050,44,001,"Rhode Island","Bristol County",4,33,562,292,270
050,44,001,"Rhode Island","Bristol County",4,34,559,270,289
050,44,001,"Rhode Island","Bristol County",4,35,575,292,283
050,44,001,"Rhode Island","Bristol County",4,36,560,277,283
050,44,001,"Rhode Island","Bristol County",4,37,609,290,319
050,44,001,"Rhode Island","Bristol County",4,38,567,282,285
050,44,001,"Rhode Island","Bristol County",4,39,623,312,311
050,44,001,"Rhode Island","Bristol County",4,40,610,284,326
050,44,001,"Rhode Island","Bristol County",4,41,626,299,327
050,44,001,"Rhode Island","Bristol County",4,42,624,314,310
050,44,001,"Rhode Island","Bristol County",4,43,589,285,304
050,44,001,"Rhode Island","Bristol County",4,44,552,265,287
050,44,001,"Rhode Island","Bristol County",4,45,585,284,301
050,44,001,"Rhode Island","Bristol County",4,46,534,246,288
050,44,001,"Rhode Island","Bristol County",4,47,546,263,283
050,44,001,"Rhode Island","Bristol County",4,48,583,286,297
050,44,001,"Rhode Island","Bristol County",4,49,643,331,312
050,44,001,"Rhode Island","Bristol County",4,50,652,321,331
050,44,001,"Rhode Island","Bristol County",4,51,704,338,366
050,44,001,"Rhode Island","Bristol County",4,52,724,347,377
050,44,001,"Rhode Island","Bristol County",4,53,689,324,365
050,44,001,"Rhode Island","Bristol County",4,54,673,324,349
050,44,001,"Rhode Island","Bristol County",4,55,699,357,342
050,44,001,"Rhode Island","Bristol County",4,56,702,351,351
050,44,001,"Rhode Island","Bristol County",4,57,739,347,392
050,44,001,"Rhode Island","Bristol County",4,58,796,364,432
050,44,001,"Rhode Island","Bristol County",4,59,793,362,431
050,44,001,"Rhode Island","Bristol County",4,60,824,400,424
050,44,001,"Rhode Island","Bristol County",4,61,837,393,444
050,44,001,"Rhode Island","Bristol County",4,62,800,376,424
050,44,001,"Rhode Island","Bristol County",4,63,749,367,382
050,44,001,"Rhode Island","Bristol County",4,64,786,379,407
050,44,001,"Rhode Island","Bristol County",4,65,769,364,405
050,44,001,"Rhode Island","Bristol County",4,66,735,361,374
050,44,001,"Rhode Island","Bristol County",4,67,687,334,353
050,44,001,"Rhode Island","Bristol County",4,68,661,307,354
050,44,001,"Rhode Island","Bristol County",4,69,599,283,316
050,44,001,"Rhode Island","Bristol County",4,70,588,272,316
050,44,001,"Rhode Island","Bristol County",4,71,536,249,287
050,44,001,"Rhode Island","Bristol County",4,72,521,246,275
050,44,001,"Rhode Island","Bristol County",4,73,511,225,286
050,44,001,"Rhode Island","Bristol County",4,74,483,215,268
050,44,001,"Rhode Island","Bristol County",4,75,540,255,285
050,44,001,"Rhode Island","Bristol County",4,76,360,166,194
050,44,001,"Rhode Island","Bristol County",4,77,340,137,203
050,44,001,"Rhode Island","Bristol County",4,78,342,135,207
050,44,001,"Rhode Island","Bristol County",4,79,380,184,196
050,44,001,"Rhode Island","Bristol County",4,80,291,138,153
050,44,001,"Rhode Island","Bristol County",4,81,252,116,136
050,44,001,"Rhode Island","Bristol County",4,82,227,105,122
050,44,001,"Rhode Island","Bristol County",4,83,211,97,114
050,44,001,"Rhode Island","Bristol County",4,84,213,94,119
050,44,001,"Rhode Island","Bristol County",4,85,1392,532,860
050,44,001,"Rhode Island","Bristol County",5,0,340,171,169
050,44,001,"Rhode Island","Bristol County",5,1,367,193,174
050,44,001,"Rhode Island","Bristol County",5,2,320,155,165
050,44,001,"Rhode Island","Bristol County",5,3,395,195,200
050,44,001,"Rhode Island","Bristol County",5,4,403,198,205
050,44,001,"Rhode Island","Bristol County",5,5,438,220,218
050,44,001,"Rhode Island","Bristol County",5,6,459,232,227
050,44,001,"Rhode Island","Bristol County",5,7,481,225,256
050,44,001,"Rhode Island","Bristol County",5,8,512,247,265
050,44,001,"Rhode Island","Bristol County",5,9,483,251,232
050,44,001,"Rhode Island","Bristol County",5,10,508,257,251
050,44,001,"Rhode Island","Bristol County",5,11,504,252,252
050,44,001,"Rhode Island","Bristol County",5,12,566,288,278
050,44,001,"Rhode Island","Bristol County",5,13,590,307,283
050,44,001,"Rhode Island","Bristol County",5,14,573,304,269
050,44,001,"Rhode Island","Bristol County",5,15,606,331,275
050,44,001,"Rhode Island","Bristol County",5,16,619,313,306
050,44,001,"Rhode Island","Bristol County",5,17,629,322,307
050,44,001,"Rhode Island","Bristol County",5,18,954,476,478
050,44,001,"Rhode Island","Bristol County",5,19,1074,523,551
050,44,001,"Rhode Island","Bristol County",5,20,935,463,472
050,44,001,"Rhode Island","Bristol County",5,21,918,450,468
050,44,001,"Rhode Island","Bristol County",5,22,675,337,338
050,44,001,"Rhode Island","Bristol County",5,23,530,275,255
050,44,001,"Rhode Island","Bristol County",5,24,518,269,249
050,44,001,"Rhode Island","Bristol County",5,25,482,235,247
050,44,001,"Rhode Island","Bristol County",5,26,461,237,224
050,44,001,"Rhode Island","Bristol County",5,27,479,240,239
050,44,001,"Rhode Island","Bristol County",5,28,454,217,237
050,44,001,"Rhode Island","Bristol County",5,29,452,231,221
050,44,001,"Rhode Island","Bristol County",5,30,445,241,204
050,44,001,"Rhode Island","Bristol County",5,31,520,271,249
050,44,001,"Rhode Island","Bristol County",5,32,561,283,278
050,44,001,"Rhode Island","Bristol County",5,33,556,276,280
050,44,001,"Rhode Island","Bristol County",5,34,590,300,290
050,44,001,"Rhode Island","Bristol County",5,35,572,275,297
050,44,001,"Rhode Island","Bristol County",5,36,585,295,290
050,44,001,"Rhode Island","Bristol County",5,37,573,281,292
050,44,001,"Rhode Island","Bristol County",5,38,636,312,324
050,44,001,"Rhode Island","Bristol County",5,39,597,294,303
050,44,001,"Rhode Island","Bristol County",5,40,652,327,325
050,44,001,"Rhode Island","Bristol County",5,41,609,292,317
050,44,001,"Rhode Island","Bristol County",5,42,646,312,334
050,44,001,"Rhode Island","Bristol County",5,43,636,327,309
050,44,001,"Rhode Island","Bristol County",5,44,583,280,303
050,44,001,"Rhode Island","Bristol County",5,45,560,271,289
050,44,001,"Rhode Island","Bristol County",5,46,605,290,315
050,44,001,"Rhode Island","Bristol County",5,47,551,259,292
050,44,001,"Rhode Island","Bristol County",5,48,537,255,282
050,44,001,"Rhode Island","Bristol County",5,49,589,292,297
050,44,001,"Rhode Island","Bristol County",5,50,640,322,318
050,44,001,"Rhode Island","Bristol County",5,51,658,323,335
050,44,001,"Rhode Island","Bristol County",5,52,706,335,371
050,44,001,"Rhode Island","Bristol County",5,53,708,347,361
050,44,001,"Rhode Island","Bristol County",5,54,672,314,358
050,44,001,"Rhode Island","Bristol County",5,55,684,339,345
050,44,001,"Rhode Island","Bristol County",5,56,700,357,343
050,44,001,"Rhode Island","Bristol County",5,57,699,356,343
050,44,001,"Rhode Island","Bristol County",5,58,747,354,393
050,44,001,"Rhode Island","Bristol County",5,59,788,357,431
050,44,001,"Rhode Island","Bristol County",5,60,794,369,425
050,44,001,"Rhode Island","Bristol County",5,61,814,402,412
050,44,001,"Rhode Island","Bristol County",5,62,811,375,436
050,44,001,"Rhode Island","Bristol County",5,63,799,376,423
050,44,001,"Rhode Island","Bristol County",5,64,755,368,387
050,44,001,"Rhode Island","Bristol County",5,65,777,367,410
050,44,001,"Rhode Island","Bristol County",5,66,745,352,393
050,44,001,"Rhode Island","Bristol County",5,67,729,357,372
050,44,001,"Rhode Island","Bristol County",5,68,672,311,361
050,44,001,"Rhode Island","Bristol County",5,69,633,293,340
050,44,001,"Rhode Island","Bristol County",5,70,605,283,322
050,44,001,"Rhode Island","Bristol County",5,71,586,273,313
050,44,001,"Rhode Island","Bristol County",5,72,538,248,290
050,44,001,"Rhode Island","Bristol County",5,73,519,251,268
050,44,001,"Rhode Island","Bristol County",5,74,493,216,277
050,44,001,"Rhode Island","Bristol County",5,75,472,210,262
050,44,001,"Rhode Island","Bristol County",5,76,533,256,277
050,44,001,"Rhode Island","Bristol County",5,77,357,162,195
050,44,001,"Rhode Island","Bristol County",5,78,315,123,192
050,44,001,"Rhode Island","Bristol County",5,79,341,139,202
050,44,001,"Rhode Island","Bristol County",5,80,342,160,182
050,44,001,"Rhode Island","Bristol County",5,81,278,127,151
050,44,001,"Rhode Island","Bristol County",5,82,241,118,123
050,44,001,"Rhode Island","Bristol County",5,83,208,88,120
050,44,001,"Rhode Island","Bristol County",5,84,206,100,106
050,44,001,"Rhode Island","Bristol County",5,85,1362,529,833
050,44,003,"Rhode Island","Kent County",1,0,1517,777,740
050,44,003,"Rhode Island","Kent County",1,1,1549,795,754
050,44,003,"Rhode Island","Kent County",1,2,1592,810,782
050,44,003,"Rhode Island","Kent County",1,3,1637,832,805
050,44,003,"Rhode Island","Kent County",1,4,1734,877,857
050,44,003,"Rhode Island","Kent County",1,5,1755,902,853
050,44,003,"Rhode Island","Kent County",1,6,1662,830,832
050,44,003,"Rhode Island","Kent County",1,7,1686,864,822
050,44,003,"Rhode Island","Kent County",1,8,1744,908,836
050,44,003,"Rhode Island","Kent County",1,9,1738,892,846
050,44,003,"Rhode Island","Kent County",1,10,1769,911,858
050,44,003,"Rhode Island","Kent County",1,11,1800,933,867
050,44,003,"Rhode Island","Kent County",1,12,1863,964,899
050,44,003,"Rhode Island","Kent County",1,13,1864,950,914
050,44,003,"Rhode Island","Kent County",1,14,1893,986,907
050,44,003,"Rhode Island","Kent County",1,15,1919,993,926
050,44,003,"Rhode Island","Kent County",1,16,2030,1033,997
050,44,003,"Rhode Island","Kent County",1,17,1961,1010,951
050,44,003,"Rhode Island","Kent County",1,18,1728,932,796
050,44,003,"Rhode Island","Kent County",1,19,1495,780,715
050,44,003,"Rhode Island","Kent County",1,20,1616,840,776
050,44,003,"Rhode Island","Kent County",1,21,1685,859,826
050,44,003,"Rhode Island","Kent County",1,22,1719,871,848
050,44,003,"Rhode Island","Kent County",1,23,1828,943,885
050,44,003,"Rhode Island","Kent County",1,24,1923,977,946
050,44,003,"Rhode Island","Kent County",1,25,2044,1021,1023
050,44,003,"Rhode Island","Kent County",1,26,2132,1068,1064
050,44,003,"Rhode Island","Kent County",1,27,2218,1139,1079
050,44,003,"Rhode Island","Kent County",1,28,2231,1158,1073
050,44,003,"Rhode Island","Kent County",1,29,2340,1182,1158
050,44,003,"Rhode Island","Kent County",1,30,2360,1195,1165
050,44,003,"Rhode Island","Kent County",1,31,2389,1198,1191
050,44,003,"Rhode Island","Kent County",1,32,2306,1172,1134
050,44,003,"Rhode Island","Kent County",1,33,2331,1151,1180
050,44,003,"Rhode Island","Kent County",1,34,2262,1141,1121
050,44,003,"Rhode Island","Kent County",1,35,2235,1127,1108
050,44,003,"Rhode Island","Kent County",1,36,2279,1182,1097
050,44,003,"Rhode Island","Kent County",1,37,2241,1124,1117
050,44,003,"Rhode Island","Kent County",1,38,2241,1149,1092
050,44,003,"Rhode Island","Kent County",1,39,2211,1097,1114
050,44,003,"Rhode Island","Kent County",1,40,2174,1106,1068
050,44,003,"Rhode Island","Kent County",1,41,2050,1016,1034
050,44,003,"Rhode Island","Kent County",1,42,2018,1006,1012
050,44,003,"Rhode Island","Kent County",1,43,1957,976,981
050,44,003,"Rhode Island","Kent County",1,44,1912,930,982
050,44,003,"Rhode Island","Kent County",1,45,1967,976,991
050,44,003,"Rhode Island","Kent County",1,46,1976,977,999
050,44,003,"Rhode Island","Kent County",1,47,2014,1007,1007
050,44,003,"Rhode Island","Kent County",1,48,2187,1104,1083
050,44,003,"Rhode Island","Kent County",1,49,2433,1185,1248
050,44,003,"Rhode Island","Kent County",1,50,2409,1164,1245
050,44,003,"Rhode Island","Kent County",1,51,2372,1156,1216
050,44,003,"Rhode Island","Kent County",1,52,2409,1191,1218
050,44,003,"Rhode Island","Kent County",1,53,2541,1258,1283
050,44,003,"Rhode Island","Kent County",1,54,2606,1276,1330
050,44,003,"Rhode Island","Kent County",1,55,2747,1357,1390
050,44,003,"Rhode Island","Kent County",1,56,2690,1275,1415
050,44,003,"Rhode Island","Kent County",1,57,2685,1235,1450
050,44,003,"Rhode Island","Kent County",1,58,2745,1289,1456
050,44,003,"Rhode Island","Kent County",1,59,2706,1288,1418
050,44,003,"Rhode Island","Kent County",1,60,2736,1315,1421
050,44,003,"Rhode Island","Kent County",1,61,2715,1306,1409
050,44,003,"Rhode Island","Kent County",1,62,2730,1317,1413
050,44,003,"Rhode Island","Kent County",1,63,2572,1214,1358
050,44,003,"Rhode Island","Kent County",1,64,2494,1165,1329
050,44,003,"Rhode Island","Kent County",1,65,2433,1157,1276
050,44,003,"Rhode Island","Kent County",1,66,2292,1115,1177
050,44,003,"Rhode Island","Kent County",1,67,2156,1000,1156
050,44,003,"Rhode Island","Kent County",1,68,2070,936,1134
050,44,003,"Rhode Island","Kent County",1,69,1911,908,1003
050,44,003,"Rhode Island","Kent County",1,70,1904,899,1005
050,44,003,"Rhode Island","Kent County",1,71,1824,847,977
050,44,003,"Rhode Island","Kent County",1,72,1782,805,977
050,44,003,"Rhode Island","Kent County",1,73,1849,847,1002
050,44,003,"Rhode Island","Kent County",1,74,1301,578,723
050,44,003,"Rhode Island","Kent County",1,75,1279,593,686
050,44,003,"Rhode Island","Kent County",1,76,1234,568,666
050,44,003,"Rhode Island","Kent County",1,77,1221,534,687
050,44,003,"Rhode Island","Kent County",1,78,1049,442,607
050,44,003,"Rhode Island","Kent County",1,79,895,363,532
050,44,003,"Rhode Island","Kent County",1,80,836,351,485
050,44,003,"Rhode Island","Kent County",1,81,752,307,445
050,44,003,"Rhode Island","Kent County",1,82,713,276,437
050,44,003,"Rhode Island","Kent County",1,83,685,264,421
050,44,003,"Rhode Island","Kent County",1,84,612,212,400
050,44,003,"Rhode Island","Kent County",1,85,4190,1333,2857
050,44,003,"Rhode Island","Kent County",2,0,1513,772,741
050,44,003,"Rhode Island","Kent County",2,1,1541,788,753
050,44,003,"Rhode Island","Kent County",2,2,1586,806,780
050,44,003,"Rhode Island","Kent County",2,3,1618,826,792
050,44,003,"Rhode Island","Kent County",2,4,1713,869,844
050,44,003,"Rhode Island","Kent County",2,5,1744,891,853
050,44,003,"Rhode Island","Kent County",2,6,1685,850,835
050,44,003,"Rhode Island","Kent County",2,7,1685,858,827
050,44,003,"Rhode Island","Kent County",2,8,1734,900,834
050,44,003,"Rhode Island","Kent County",2,9,1736,893,843
050,44,003,"Rhode Island","Kent County",2,10,1762,907,855
050,44,003,"Rhode Island","Kent County",2,11,1790,925,865
050,44,003,"Rhode Island","Kent County",2,12,1862,964,898
050,44,003,"Rhode Island","Kent County",2,13,1864,954,910
050,44,003,"Rhode Island","Kent County",2,14,1889,977,912
050,44,003,"Rhode Island","Kent County",2,15,1920,995,925
050,44,003,"Rhode Island","Kent County",2,16,2009,1026,983
050,44,003,"Rhode Island","Kent County",2,17,1978,1020,958
050,44,003,"Rhode Island","Kent County",2,18,1728,925,803
050,44,003,"Rhode Island","Kent County",2,19,1501,788,713
050,44,003,"Rhode Island","Kent County",2,20,1637,849,788
050,44,003,"Rhode Island","Kent County",2,21,1685,861,824
050,44,003,"Rhode Island","Kent County",2,22,1736,881,855
050,44,003,"Rhode Island","Kent County",2,23,1831,941,890
050,44,003,"Rhode Island","Kent County",2,24,1919,980,939
050,44,003,"Rhode Island","Kent County",2,25,2036,1022,1014
050,44,003,"Rhode Island","Kent County",2,26,2126,1068,1058
050,44,003,"Rhode Island","Kent County",2,27,2202,1124,1078
050,44,003,"Rhode Island","Kent County",2,28,2241,1159,1082
050,44,003,"Rhode Island","Kent County",2,29,2328,1182,1146
050,44,003,"Rhode Island","Kent County",2,30,2377,1199,1178
050,44,003,"Rhode Island","Kent County",2,31,2373,1194,1179
050,44,003,"Rhode Island","Kent County",2,32,2324,1177,1147
050,44,003,"Rhode Island","Kent County",2,33,2326,1156,1170
050,44,003,"Rhode Island","Kent County",2,34,2280,1145,1135
050,44,003,"Rhode Island","Kent County",2,35,2255,1138,1117
050,44,003,"Rhode Island","Kent County",2,36,2256,1161,1095
050,44,003,"Rhode Island","Kent County",2,37,2254,1142,1112
050,44,003,"Rhode Island","Kent County",2,38,2246,1143,1103
050,44,003,"Rhode Island","Kent County",2,39,2216,1110,1106
050,44,003,"Rhode Island","Kent County",2,40,2201,1114,1087
050,44,003,"Rhode Island","Kent County",2,41,2084,1039,1045
050,44,003,"Rhode Island","Kent County",2,42,2021,1004,1017
050,44,003,"Rhode Island","Kent County",2,43,1987,989,998
050,44,003,"Rhode Island","Kent County",2,44,1903,931,972
050,44,003,"Rhode Island","Kent County",2,45,1960,969,991
050,44,003,"Rhode Island","Kent County",2,46,1966,970,996
050,44,003,"Rhode Island","Kent County",2,47,1993,994,999
050,44,003,"Rhode Island","Kent County",2,48,2147,1079,1068
050,44,003,"Rhode Island","Kent County",2,49,2392,1176,1216
050,44,003,"Rhode Island","Kent County",2,50,2421,1173,1248
050,44,003,"Rhode Island","Kent County",2,51,2380,1157,1223
050,44,003,"Rhode Island","Kent County",2,52,2403,1184,1219
050,44,003,"Rhode Island","Kent County",2,53,2507,1241,1266
050,44,003,"Rhode Island","Kent County",2,54,2590,1275,1315
050,44,003,"Rhode Island","Kent County",2,55,2709,1337,1372
050,44,003,"Rhode Island","Kent County",2,56,2707,1296,1411
050,44,003,"Rhode Island","Kent County",2,57,2689,1248,1441
050,44,003,"Rhode Island","Kent County",2,58,2726,1276,1450
050,44,003,"Rhode Island","Kent County",2,59,2735,1296,1439
050,44,003,"Rhode Island","Kent County",2,60,2708,1298,1410
050,44,003,"Rhode Island","Kent County",2,61,2709,1304,1405
050,44,003,"Rhode Island","Kent County",2,62,2715,1305,1410
050,44,003,"Rhode Island","Kent County",2,63,2625,1244,1381
050,44,003,"Rhode Island","Kent County",2,64,2492,1167,1325
050,44,003,"Rhode Island","Kent County",2,65,2437,1156,1281
050,44,003,"Rhode Island","Kent County",2,66,2322,1126,1196
050,44,003,"Rhode Island","Kent County",2,67,2175,1022,1153
050,44,003,"Rhode Island","Kent County",2,68,2072,945,1127
050,44,003,"Rhode Island","Kent County",2,69,1966,921,1045
050,44,003,"Rhode Island","Kent County",2,70,1884,890,994
050,44,003,"Rhode Island","Kent County",2,71,1837,852,985
050,44,003,"Rhode Island","Kent County",2,72,1748,792,956
050,44,003,"Rhode Island","Kent County",2,73,1908,870,1038
050,44,003,"Rhode Island","Kent County",2,74,1332,599,733
050,44,003,"Rhode Island","Kent County",2,75,1277,584,693
050,44,003,"Rhode Island","Kent County",2,76,1228,563,665
050,44,003,"Rhode Island","Kent County",2,77,1233,542,691
050,44,003,"Rhode Island","Kent County",2,78,1059,448,611
050,44,003,"Rhode Island","Kent County",2,79,911,374,537
050,44,003,"Rhode Island","Kent County",2,80,836,349,487
050,44,003,"Rhode Island","Kent County",2,81,758,310,448
050,44,003,"Rhode Island","Kent County",2,82,716,278,438
050,44,003,"Rhode Island","Kent County",2,83,677,255,422
050,44,003,"Rhode Island","Kent County",2,84,623,220,403
050,44,003,"Rhode Island","Kent County",2,85,4131,1320,2811
050,44,003,"Rhode Island","Kent County",3,0,1455,773,682
050,44,003,"Rhode Island","Kent County",3,1,1524,759,765
050,44,003,"Rhode Island","Kent County",3,2,1568,769,799
050,44,003,"Rhode Island","Kent County",3,3,1620,834,786
050,44,003,"Rhode Island","Kent County",3,4,1660,853,807
050,44,003,"Rhode Island","Kent County",3,5,1720,895,825
050,44,003,"Rhode Island","Kent County",3,6,1764,919,845
050,44,003,"Rhode Island","Kent County",3,7,1688,847,841
050,44,003,"Rhode Island","Kent County",3,8,1664,852,812
050,44,003,"Rhode Island","Kent County",3,9,1759,891,868
050,44,003,"Rhode Island","Kent County",3,10,1717,896,821
050,44,003,"Rhode Island","Kent County",3,11,1770,902,868
050,44,003,"Rhode Island","Kent County",3,12,1806,946,860
050,44,003,"Rhode Island","Kent County",3,13,1869,974,895
050,44,003,"Rhode Island","Kent County",3,14,1866,954,912
050,44,003,"Rhode Island","Kent County",3,15,1914,994,920
050,44,003,"Rhode Island","Kent County",3,16,1949,1019,930
050,44,003,"Rhode Island","Kent County",3,17,2016,1027,989
050,44,003,"Rhode Island","Kent County",3,18,1776,939,837
050,44,003,"Rhode Island","Kent County",3,19,1458,761,697
050,44,003,"Rhode Island","Kent County",3,20,1626,832,794
050,44,003,"Rhode Island","Kent County",3,21,1707,880,827
050,44,003,"Rhode Island","Kent County",3,22,1767,895,872
050,44,003,"Rhode Island","Kent County",3,23,1861,933,928
050,44,003,"Rhode Island","Kent County",3,24,1932,992,940
050,44,003,"Rhode Island","Kent County",3,25,1994,1016,978
050,44,003,"Rhode Island","Kent County",3,26,2162,1094,1068
050,44,003,"Rhode Island","Kent County",3,27,2186,1085,1101
050,44,003,"Rhode Island","Kent County",3,28,2290,1170,1120
050,44,003,"Rhode Island","Kent County",3,29,2340,1208,1132
050,44,003,"Rhode Island","Kent County",3,30,2369,1214,1155
050,44,003,"Rhode Island","Kent County",3,31,2457,1233,1224
050,44,003,"Rhode Island","Kent County",3,32,2408,1218,1190
050,44,003,"Rhode Island","Kent County",3,33,2371,1178,1193
050,44,003,"Rhode Island","Kent County",3,34,2373,1169,1204
050,44,003,"Rhode Island","Kent County",3,35,2318,1159,1159
050,44,003,"Rhode Island","Kent County",3,36,2296,1167,1129
050,44,003,"Rhode Island","Kent County",3,37,2215,1135,1080
050,44,003,"Rhode Island","Kent County",3,38,2262,1156,1106
050,44,003,"Rhode Island","Kent County",3,39,2270,1155,1115
050,44,003,"Rhode Island","Kent County",3,40,2251,1121,1130
050,44,003,"Rhode Island","Kent County",3,41,2223,1130,1093
050,44,003,"Rhode Island","Kent County",3,42,2096,1053,1043
050,44,003,"Rhode Island","Kent County",3,43,2039,1010,1029
050,44,003,"Rhode Island","Kent County",3,44,1997,992,1005
050,44,003,"Rhode Island","Kent County",3,45,1937,955,982
050,44,003,"Rhode Island","Kent County",3,46,1976,973,1003
050,44,003,"Rhode Island","Kent County",3,47,1959,972,987
050,44,003,"Rhode Island","Kent County",3,48,1991,981,1010
050,44,003,"Rhode Island","Kent County",3,49,2174,1083,1091
050,44,003,"Rhode Island","Kent County",3,50,2385,1181,1204
050,44,003,"Rhode Island","Kent County",3,51,2448,1190,1258
050,44,003,"Rhode Island","Kent County",3,52,2417,1165,1252
050,44,003,"Rhode Island","Kent County",3,53,2378,1176,1202
050,44,003,"Rhode Island","Kent County",3,54,2487,1235,1252
050,44,003,"Rhode Island","Kent County",3,55,2570,1270,1300
050,44,003,"Rhode Island","Kent County",3,56,2700,1328,1372
050,44,003,"Rhode Island","Kent County",3,57,2696,1281,1415
050,44,003,"Rhode Island","Kent County",3,58,2656,1241,1415
050,44,003,"Rhode Island","Kent County",3,59,2659,1246,1413
050,44,003,"Rhode Island","Kent County",3,60,2714,1282,1432
050,44,003,"Rhode Island","Kent County",3,61,2645,1275,1370
050,44,003,"Rhode Island","Kent County",3,62,2650,1275,1375
050,44,003,"Rhode Island","Kent County",3,63,2678,1274,1404
050,44,003,"Rhode Island","Kent County",3,64,2577,1203,1374
050,44,003,"Rhode Island","Kent County",3,65,2437,1137,1300
050,44,003,"Rhode Island","Kent County",3,66,2412,1146,1266
050,44,003,"Rhode Island","Kent County",3,67,2288,1104,1184
050,44,003,"Rhode Island","Kent County",3,68,2112,988,1124
050,44,003,"Rhode Island","Kent County",3,69,2042,924,1118
050,44,003,"Rhode Island","Kent County",3,70,1931,897,1034
050,44,003,"Rhode Island","Kent County",3,71,1827,850,977
050,44,003,"Rhode Island","Kent County",3,72,1779,821,958
050,44,003,"Rhode Island","Kent County",3,73,1728,771,957
050,44,003,"Rhode Island","Kent County",3,74,1822,811,1011
050,44,003,"Rhode Island","Kent County",3,75,1309,591,718
050,44,003,"Rhode Island","Kent County",3,76,1248,563,685
050,44,003,"Rhode Island","Kent County",3,77,1144,521,623
050,44,003,"Rhode Island","Kent County",3,78,1203,522,681
050,44,003,"Rhode Island","Kent County",3,79,1028,436,592
050,44,003,"Rhode Island","Kent County",3,80,869,349,520
050,44,003,"Rhode Island","Kent County",3,81,797,331,466
050,44,003,"Rhode Island","Kent County",3,82,718,290,428
050,44,003,"Rhode Island","Kent County",3,83,682,256,426
050,44,003,"Rhode Island","Kent County",3,84,627,226,401
050,44,003,"Rhode Island","Kent County",3,85,4004,1267,2737
050,44,003,"Rhode Island","Kent County",4,0,1544,795,749
050,44,003,"Rhode Island","Kent County",4,1,1515,784,731
050,44,003,"Rhode Island","Kent County",4,2,1542,768,774
050,44,003,"Rhode Island","Kent County",4,3,1555,766,789
050,44,003,"Rhode Island","Kent County",4,4,1602,808,794
050,44,003,"Rhode Island","Kent County",4,5,1639,823,816
050,44,003,"Rhode Island","Kent County",4,6,1756,927,829
050,44,003,"Rhode Island","Kent County",4,7,1746,901,845
050,44,003,"Rhode Island","Kent County",4,8,1686,845,841
050,44,003,"Rhode Island","Kent County",4,9,1674,866,808
050,44,003,"Rhode Island","Kent County",4,10,1746,889,857
050,44,003,"Rhode Island","Kent County",4,11,1746,921,825
050,44,003,"Rhode Island","Kent County",4,12,1767,913,854
050,44,003,"Rhode Island","Kent County",4,13,1841,966,875
050,44,003,"Rhode Island","Kent County",4,14,1845,968,877
050,44,003,"Rhode Island","Kent County",4,15,1879,962,917
050,44,003,"Rhode Island","Kent County",4,16,1901,996,905
050,44,003,"Rhode Island","Kent County",4,17,1968,1023,945
050,44,003,"Rhode Island","Kent County",4,18,1756,929,827
050,44,003,"Rhode Island","Kent County",4,19,1461,764,697
050,44,003,"Rhode Island","Kent County",4,20,1541,798,743
050,44,003,"Rhode Island","Kent County",4,21,1677,854,823
050,44,003,"Rhode Island","Kent County",4,22,1785,908,877
050,44,003,"Rhode Island","Kent County",4,23,1835,933,902
050,44,003,"Rhode Island","Kent County",4,24,1884,960,924
050,44,003,"Rhode Island","Kent County",4,25,2011,1035,976
050,44,003,"Rhode Island","Kent County",4,26,2014,1026,988
050,44,003,"Rhode Island","Kent County",4,27,2223,1133,1090
050,44,003,"Rhode Island","Kent County",4,28,2231,1093,1138
050,44,003,"Rhode Island","Kent County",4,29,2336,1174,1162
050,44,003,"Rhode Island","Kent County",4,30,2422,1245,1177
050,44,003,"Rhode Island","Kent County",4,31,2485,1287,1198
050,44,003,"Rhode Island","Kent County",4,32,2476,1244,1232
050,44,003,"Rhode Island","Kent County",4,33,2488,1262,1226
050,44,003,"Rhode Island","Kent County",4,34,2398,1211,1187
050,44,003,"Rhode Island","Kent County",4,35,2406,1204,1202
050,44,003,"Rhode Island","Kent County",4,36,2379,1187,1192
050,44,003,"Rhode Island","Kent County",4,37,2287,1147,1140
050,44,003,"Rhode Island","Kent County",4,38,2248,1154,1094
050,44,003,"Rhode Island","Kent County",4,39,2286,1154,1132
050,44,003,"Rhode Island","Kent County",4,40,2266,1145,1121
050,44,003,"Rhode Island","Kent County",4,41,2280,1152,1128
050,44,003,"Rhode Island","Kent County",4,42,2228,1132,1096
050,44,003,"Rhode Island","Kent County",4,43,2115,1080,1035
050,44,003,"Rhode Island","Kent County",4,44,2011,981,1030
050,44,003,"Rhode Island","Kent County",4,45,2014,1004,1010
050,44,003,"Rhode Island","Kent County",4,46,1917,939,978
050,44,003,"Rhode Island","Kent County",4,47,1955,959,996
050,44,003,"Rhode Island","Kent County",4,48,1980,997,983
050,44,003,"Rhode Island","Kent County",4,49,1997,987,1010
050,44,003,"Rhode Island","Kent County",4,50,2157,1080,1077
050,44,003,"Rhode Island","Kent County",4,51,2351,1155,1196
050,44,003,"Rhode Island","Kent County",4,52,2439,1187,1252
050,44,003,"Rhode Island","Kent County",4,53,2408,1160,1248
050,44,003,"Rhode Island","Kent County",4,54,2349,1163,1186
050,44,003,"Rhode Island","Kent County",4,55,2480,1214,1266
050,44,003,"Rhode Island","Kent County",4,56,2539,1237,1302
050,44,003,"Rhode Island","Kent County",4,57,2676,1304,1372
050,44,003,"Rhode Island","Kent County",4,58,2639,1258,1381
050,44,003,"Rhode Island","Kent County",4,59,2630,1232,1398
050,44,003,"Rhode Island","Kent County",4,60,2640,1248,1392
050,44,003,"Rhode Island","Kent County",4,61,2686,1274,1412
050,44,003,"Rhode Island","Kent County",4,62,2621,1250,1371
050,44,003,"Rhode Island","Kent County",4,63,2611,1245,1366
050,44,003,"Rhode Island","Kent County",4,64,2641,1272,1369
050,44,003,"Rhode Island","Kent County",4,65,2545,1187,1358
050,44,003,"Rhode Island","Kent County",4,66,2419,1131,1288
050,44,003,"Rhode Island","Kent County",4,67,2364,1113,1251
050,44,003,"Rhode Island","Kent County",4,68,2221,1057,1164
050,44,003,"Rhode Island","Kent County",4,69,2064,950,1114
050,44,003,"Rhode Island","Kent County",4,70,2001,905,1096
050,44,003,"Rhode Island","Kent County",4,71,1890,875,1015
050,44,003,"Rhode Island","Kent County",4,72,1790,825,965
050,44,003,"Rhode Island","Kent County",4,73,1745,791,954
050,44,003,"Rhode Island","Kent County",4,74,1652,742,910
050,44,003,"Rhode Island","Kent County",4,75,1784,784,1000
050,44,003,"Rhode Island","Kent County",4,76,1255,565,690
050,44,003,"Rhode Island","Kent County",4,77,1189,538,651
050,44,003,"Rhode Island","Kent County",4,78,1109,493,616
050,44,003,"Rhode Island","Kent County",4,79,1153,499,654
050,44,003,"Rhode Island","Kent County",4,80,961,405,556
050,44,003,"Rhode Island","Kent County",4,81,830,318,512
050,44,003,"Rhode Island","Kent County",4,82,752,306,446
050,44,003,"Rhode Island","Kent County",4,83,689,264,425
050,44,003,"Rhode Island","Kent County",4,84,633,233,400
050,44,003,"Rhode Island","Kent County",4,85,3877,1237,2640
050,44,003,"Rhode Island","Kent County",5,0,1465,752,713
050,44,003,"Rhode Island","Kent County",5,1,1592,839,753
050,44,003,"Rhode Island","Kent County",5,2,1460,774,686
050,44,003,"Rhode Island","Kent County",5,3,1544,766,778
050,44,003,"Rhode Island","Kent County",5,4,1562,766,796
050,44,003,"Rhode Island","Kent County",5,5,1609,822,787
050,44,003,"Rhode Island","Kent County",5,6,1664,839,825
050,44,003,"Rhode Island","Kent County",5,7,1759,915,844
050,44,003,"Rhode Island","Kent County",5,8,1742,886,856
050,44,003,"Rhode Island","Kent County",5,9,1677,848,829
050,44,003,"Rhode Island","Kent County",5,10,1690,861,829
050,44,003,"Rhode Island","Kent County",5,11,1734,871,863
050,44,003,"Rhode Island","Kent County",5,12,1753,935,818
050,44,003,"Rhode Island","Kent County",5,13,1760,920,840
050,44,003,"Rhode Island","Kent County",5,14,1850,962,888
050,44,003,"Rhode Island","Kent County",5,15,1868,967,901
050,44,003,"Rhode Island","Kent County",5,16,1895,974,921
050,44,003,"Rhode Island","Kent County",5,17,1933,1019,914
050,44,003,"Rhode Island","Kent County",5,18,1724,902,822
050,44,003,"Rhode Island","Kent County",5,19,1476,770,706
050,44,003,"Rhode Island","Kent County",5,20,1570,815,755
050,44,003,"Rhode Island","Kent County",5,21,1621,831,790
050,44,003,"Rhode Island","Kent County",5,22,1744,878,866
050,44,003,"Rhode Island","Kent County",5,23,1852,949,903
050,44,003,"Rhode Island","Kent County",5,24,1903,980,923
050,44,003,"Rhode Island","Kent County",5,25,1924,967,957
050,44,003,"Rhode Island","Kent County",5,26,2094,1083,1011
050,44,003,"Rhode Island","Kent County",5,27,2090,1065,1025
050,44,003,"Rhode Island","Kent County",5,28,2276,1173,1103
050,44,003,"Rhode Island","Kent County",5,29,2324,1133,1191
050,44,003,"Rhode Island","Kent County",5,30,2369,1197,1172
050,44,003,"Rhode Island","Kent County",5,31,2421,1248,1173
050,44,003,"Rhode Island","Kent County",5,32,2514,1289,1225
050,44,003,"Rhode Island","Kent County",5,33,2536,1278,1258
050,44,003,"Rhode Island","Kent County",5,34,2524,1294,1230
050,44,003,"Rhode Island","Kent County",5,35,2415,1205,1210
050,44,003,"Rhode Island","Kent County",5,36,2407,1183,1224
050,44,003,"Rhode Island","Kent County",5,37,2334,1174,1160
050,44,003,"Rhode Island","Kent County",5,38,2298,1154,1144
050,44,003,"Rhode Island","Kent County",5,39,2285,1181,1104
050,44,003,"Rhode Island","Kent County",5,40,2278,1137,1141
050,44,003,"Rhode Island","Kent County",5,41,2304,1183,1121
050,44,003,"Rhode Island","Kent County",5,42,2283,1143,1140
050,44,003,"Rhode Island","Kent County",5,43,2248,1136,1112
050,44,003,"Rhode Island","Kent County",5,44,2085,1049,1036
050,44,003,"Rhode Island","Kent County",5,45,2031,1000,1031
050,44,003,"Rhode Island","Kent County",5,46,1991,1000,991
050,44,003,"Rhode Island","Kent County",5,47,1915,943,972
050,44,003,"Rhode Island","Kent County",5,48,1964,948,1016
050,44,003,"Rhode Island","Kent County",5,49,1989,1001,988
050,44,003,"Rhode Island","Kent County",5,50,1993,993,1000
050,44,003,"Rhode Island","Kent County",5,51,2150,1065,1085
050,44,003,"Rhode Island","Kent County",5,52,2319,1133,1186
050,44,003,"Rhode Island","Kent County",5,53,2416,1167,1249
050,44,003,"Rhode Island","Kent County",5,54,2405,1165,1240
050,44,003,"Rhode Island","Kent County",5,55,2358,1176,1182
050,44,003,"Rhode Island","Kent County",5,56,2488,1210,1278
050,44,003,"Rhode Island","Kent County",5,57,2559,1238,1321
050,44,003,"Rhode Island","Kent County",5,58,2651,1287,1364
050,44,003,"Rhode Island","Kent County",5,59,2634,1256,1378
050,44,003,"Rhode Island","Kent County",5,60,2599,1212,1387
050,44,003,"Rhode Island","Kent County",5,61,2628,1258,1370
050,44,003,"Rhode Island","Kent County",5,62,2658,1252,1406
050,44,003,"Rhode Island","Kent County",5,63,2556,1210,1346
050,44,003,"Rhode Island","Kent County",5,64,2561,1229,1332
050,44,003,"Rhode Island","Kent County",5,65,2589,1247,1342
050,44,003,"Rhode Island","Kent County",5,66,2514,1170,1344
050,44,003,"Rhode Island","Kent County",5,67,2418,1120,1298
050,44,003,"Rhode Island","Kent County",5,68,2329,1093,1236
050,44,003,"Rhode Island","Kent County",5,69,2201,1044,1157
050,44,003,"Rhode Island","Kent County",5,70,2014,926,1088
050,44,003,"Rhode Island","Kent County",5,71,1975,889,1086
050,44,003,"Rhode Island","Kent County",5,72,1840,846,994
050,44,003,"Rhode Island","Kent County",5,73,1756,798,958
050,44,003,"Rhode Island","Kent County",5,74,1687,764,923
050,44,003,"Rhode Island","Kent County",5,75,1617,725,892
050,44,003,"Rhode Island","Kent County",5,76,1726,751,975
050,44,003,"Rhode Island","Kent County",5,77,1192,534,658
050,44,003,"Rhode Island","Kent County",5,78,1154,514,640
050,44,003,"Rhode Island","Kent County",5,79,1072,475,597
050,44,003,"Rhode Island","Kent County",5,80,1083,463,620
050,44,003,"Rhode Island","Kent County",5,81,910,380,530
050,44,003,"Rhode Island","Kent County",5,82,784,300,484
050,44,003,"Rhode Island","Kent County",5,83,718,278,440
050,44,003,"Rhode Island","Kent County",5,84,634,242,392
050,44,003,"Rhode Island","Kent County",5,85,3744,1224,2520
050,44,005,"Rhode Island","Newport County",1,0,732,375,357
050,44,005,"Rhode Island","Newport County",1,1,751,385,366
050,44,005,"Rhode Island","Newport County",1,2,772,404,368
050,44,005,"Rhode Island","Newport County",1,3,722,397,325
050,44,005,"Rhode Island","Newport County",1,4,741,392,349
050,44,005,"Rhode Island","Newport County",1,5,732,372,360
050,44,005,"Rhode Island","Newport County",1,6,717,383,334
050,44,005,"Rhode Island","Newport County",1,7,795,400,395
050,44,005,"Rhode Island","Newport County",1,8,850,436,414
050,44,005,"Rhode Island","Newport County",1,9,785,382,403
050,44,005,"Rhode Island","Newport County",1,10,853,430,423
050,44,005,"Rhode Island","Newport County",1,11,825,415,410
050,44,005,"Rhode Island","Newport County",1,12,818,424,394
050,44,005,"Rhode Island","Newport County",1,13,894,473,421
050,44,005,"Rhode Island","Newport County",1,14,892,445,447
050,44,005,"Rhode Island","Newport County",1,15,881,450,431
050,44,005,"Rhode Island","Newport County",1,16,879,466,413
050,44,005,"Rhode Island","Newport County",1,17,871,441,430
050,44,005,"Rhode Island","Newport County",1,18,1115,524,591
050,44,005,"Rhode Island","Newport County",1,19,1329,661,668
050,44,005,"Rhode Island","Newport County",1,20,1134,549,585
050,44,005,"Rhode Island","Newport County",1,21,930,460,470
050,44,005,"Rhode Island","Newport County",1,22,1008,517,491
050,44,005,"Rhode Island","Newport County",1,23,1023,545,478
050,44,005,"Rhode Island","Newport County",1,24,1085,601,484
050,44,005,"Rhode Island","Newport County",1,25,1036,569,467
050,44,005,"Rhode Island","Newport County",1,26,1083,593,490
050,44,005,"Rhode Island","Newport County",1,27,1021,535,486
050,44,005,"Rhode Island","Newport County",1,28,1033,562,471
050,44,005,"Rhode Island","Newport County",1,29,1007,521,486
050,44,005,"Rhode Island","Newport County",1,30,1089,564,525
050,44,005,"Rhode Island","Newport County",1,31,1045,527,518
050,44,005,"Rhode Island","Newport County",1,32,1042,527,515
050,44,005,"Rhode Island","Newport County",1,33,1028,524,504
050,44,005,"Rhode Island","Newport County",1,34,1023,526,497
050,44,005,"Rhode Island","Newport County",1,35,918,478,440
050,44,005,"Rhode Island","Newport County",1,36,936,494,442
050,44,005,"Rhode Island","Newport County",1,37,1042,560,482
050,44,005,"Rhode Island","Newport County",1,38,973,522,451
050,44,005,"Rhode Island","Newport County",1,39,998,522,476
050,44,005,"Rhode Island","Newport County",1,40,916,455,461
050,44,005,"Rhode Island","Newport County",1,41,942,472,470
050,44,005,"Rhode Island","Newport County",1,42,879,452,427
050,44,005,"Rhode Island","Newport County",1,43,888,442,446
050,44,005,"Rhode Island","Newport County",1,44,881,461,420
050,44,005,"Rhode Island","Newport County",1,45,905,461,444
050,44,005,"Rhode Island","Newport County",1,46,939,468,471
050,44,005,"Rhode Island","Newport County",1,47,884,437,447
050,44,005,"Rhode Island","Newport County",1,48,987,515,472
050,44,005,"Rhode Island","Newport County",1,49,1120,562,558
050,44,005,"Rhode Island","Newport County",1,50,1094,531,563
050,44,005,"Rhode Island","Newport County",1,51,1114,539,575
050,44,005,"Rhode Island","Newport County",1,52,1102,552,550
050,44,005,"Rhode Island","Newport County",1,53,1181,552,629
050,44,005,"Rhode Island","Newport County",1,54,1214,585,629
050,44,005,"Rhode Island","Newport County",1,55,1308,643,665
050,44,005,"Rhode Island","Newport County",1,56,1325,640,685
050,44,005,"Rhode Island","Newport County",1,57,1354,656,698
050,44,005,"Rhode Island","Newport County",1,58,1395,698,697
050,44,005,"Rhode Island","Newport County",1,59,1331,649,682
050,44,005,"Rhode Island","Newport County",1,60,1259,605,654
050,44,005,"Rhode Island","Newport County",1,61,1342,652,690
050,44,005,"Rhode Island","Newport County",1,62,1390,677,713
050,44,005,"Rhode Island","Newport County",1,63,1364,653,711
050,44,005,"Rhode Island","Newport County",1,64,1299,631,668
050,44,005,"Rhode Island","Newport County",1,65,1273,607,666
050,44,005,"Rhode Island","Newport County",1,66,1239,589,650
050,44,005,"Rhode Island","Newport County",1,67,1183,576,607
050,44,005,"Rhode Island","Newport County",1,68,1149,538,611
050,44,005,"Rhode Island","Newport County",1,69,1135,544,591
050,44,005,"Rhode Island","Newport County",1,70,1152,549,603
050,44,005,"Rhode Island","Newport County",1,71,1120,548,572
050,44,005,"Rhode Island","Newport County",1,72,1107,536,571
050,44,005,"Rhode Island","Newport County",1,73,1134,544,590
050,44,005,"Rhode Island","Newport County",1,74,817,390,427
050,44,005,"Rhode Island","Newport County",1,75,827,389,438
050,44,005,"Rhode Island","Newport County",1,76,762,353,409
050,44,005,"Rhode Island","Newport County",1,77,758,356,402
050,44,005,"Rhode Island","Newport County",1,78,694,321,373
050,44,005,"Rhode Island","Newport County",1,79,595,262,333
050,44,005,"Rhode Island","Newport County",1,80,525,245,280
050,44,005,"Rhode Island","Newport County",1,81,483,231,252
050,44,005,"Rhode Island","Newport County",1,82,455,206,249
050,44,005,"Rhode Island","Newport County",1,83,394,164,230
050,44,005,"Rhode Island","Newport County",1,84,383,143,240
050,44,005,"Rhode Island","Newport County",1,85,2643,908,1735
050,44,005,"Rhode Island","Newport County",2,0,711,365,346
050,44,005,"Rhode Island","Newport County",2,1,739,382,357
050,44,005,"Rhode Island","Newport County",2,2,760,399,361
050,44,005,"Rhode Island","Newport County",2,3,728,395,333
050,44,005,"Rhode Island","Newport County",2,4,735,391,344
050,44,005,"Rhode Island","Newport County",2,5,730,378,352
050,44,005,"Rhode Island","Newport County",2,6,725,380,345
050,44,005,"Rhode Island","Newport County",2,7,779,401,378
050,44,005,"Rhode Island","Newport County",2,8,823,421,402
050,44,005,"Rhode Island","Newport County",2,9,801,393,408
050,44,005,"Rhode Island","Newport County",2,10,837,417,420
050,44,005,"Rhode Island","Newport County",2,11,828,416,412
050,44,005,"Rhode Island","Newport County",2,12,826,425,401
050,44,005,"Rhode Island","Newport County",2,13,875,461,414
050,44,005,"Rhode Island","Newport County",2,14,886,448,438
050,44,005,"Rhode Island","Newport County",2,15,880,450,430
050,44,005,"Rhode Island","Newport County",2,16,880,461,419
050,44,005,"Rhode Island","Newport County",2,17,876,450,426
050,44,005,"Rhode Island","Newport County",2,18,1104,515,589
050,44,005,"Rhode Island","Newport County",2,19,1314,651,663
050,44,005,"Rhode Island","Newport County",2,20,1149,558,591
050,44,005,"Rhode Island","Newport County",2,21,923,457,466
050,44,005,"Rhode Island","Newport County",2,22,1001,509,492
050,44,005,"Rhode Island","Newport County",2,23,1031,554,477
050,44,005,"Rhode Island","Newport County",2,24,1063,583,480
050,44,005,"Rhode Island","Newport County",2,25,1040,569,471
050,44,005,"Rhode Island","Newport County",2,26,1060,580,480
050,44,005,"Rhode Island","Newport County",2,27,1025,541,484
050,44,005,"Rhode Island","Newport County",2,28,1031,557,474
050,44,005,"Rhode Island","Newport County",2,29,1015,530,485
050,44,005,"Rhode Island","Newport County",2,30,1064,549,515
050,44,005,"Rhode Island","Newport County",2,31,1036,524,512
050,44,005,"Rhode Island","Newport County",2,32,1037,522,515
050,44,005,"Rhode Island","Newport County",2,33,1031,527,504
050,44,005,"Rhode Island","Newport County",2,34,1016,520,496
050,44,005,"Rhode Island","Newport County",2,35,942,490,452
050,44,005,"Rhode Island","Newport County",2,36,930,489,441
050,44,005,"Rhode Island","Newport County",2,37,1014,543,471
050,44,005,"Rhode Island","Newport County",2,38,988,526,462
050,44,005,"Rhode Island","Newport County",2,39,983,517,466
050,44,005,"Rhode Island","Newport County",2,40,939,473,466
050,44,005,"Rhode Island","Newport County",2,41,930,466,464
050,44,005,"Rhode Island","Newport County",2,42,896,457,439
050,44,005,"Rhode Island","Newport County",2,43,884,444,440
050,44,005,"Rhode Island","Newport County",2,44,866,448,418
050,44,005,"Rhode Island","Newport County",2,45,898,459,439
050,44,005,"Rhode Island","Newport County",2,46,924,461,463
050,44,005,"Rhode Island","Newport County",2,47,892,443,449
050,44,005,"Rhode Island","Newport County",2,48,955,493,462
050,44,005,"Rhode Island","Newport County",2,49,1092,552,540
050,44,005,"Rhode Island","Newport County",2,50,1107,540,567
050,44,005,"Rhode Island","Newport County",2,51,1107,535,572
050,44,005,"Rhode Island","Newport County",2,52,1102,548,554
050,44,005,"Rhode Island","Newport County",2,53,1165,554,611
050,44,005,"Rhode Island","Newport County",2,54,1204,577,627
050,44,005,"Rhode Island","Newport County",2,55,1283,625,658
050,44,005,"Rhode Island","Newport County",2,56,1332,646,686
050,44,005,"Rhode Island","Newport County",2,57,1347,651,696
050,44,005,"Rhode Island","Newport County",2,58,1383,685,698
050,44,005,"Rhode Island","Newport County",2,59,1348,659,689
050,44,005,"Rhode Island","Newport County",2,60,1275,616,659
050,44,005,"Rhode Island","Newport County",2,61,1316,635,681
050,44,005,"Rhode Island","Newport County",2,62,1377,670,707
050,44,005,"Rhode Island","Newport County",2,63,1381,662,719
050,44,005,"Rhode Island","Newport County",2,64,1303,629,674
050,44,005,"Rhode Island","Newport County",2,65,1275,612,663
050,44,005,"Rhode Island","Newport County",2,66,1249,595,654
050,44,005,"Rhode Island","Newport County",2,67,1195,576,619
050,44,005,"Rhode Island","Newport County",2,68,1150,545,605
050,44,005,"Rhode Island","Newport County",2,69,1146,547,599
050,44,005,"Rhode Island","Newport County",2,70,1144,546,598
050,44,005,"Rhode Island","Newport County",2,71,1130,548,582
050,44,005,"Rhode Island","Newport County",2,72,1090,529,561
050,44,005,"Rhode Island","Newport County",2,73,1178,569,609
050,44,005,"Rhode Island","Newport County",2,74,833,397,436
050,44,005,"Rhode Island","Newport County",2,75,828,390,438
050,44,005,"Rhode Island","Newport County",2,76,770,359,411
050,44,005,"Rhode Island","Newport County",2,77,776,362,414
050,44,005,"Rhode Island","Newport County",2,78,699,326,373
050,44,005,"Rhode Island","Newport County",2,79,610,270,340
050,44,005,"Rhode Island","Newport County",2,80,535,247,288
050,44,005,"Rhode Island","Newport County",2,81,479,224,255
050,44,005,"Rhode Island","Newport County",2,82,463,213,250
050,44,005,"Rhode Island","Newport County",2,83,400,171,229
050,44,005,"Rhode Island","Newport County",2,84,384,146,238
050,44,005,"Rhode Island","Newport County",2,85,2659,919,1740
050,44,005,"Rhode Island","Newport County",3,0,582,303,279
050,44,005,"Rhode Island","Newport County",3,1,707,379,328
050,44,005,"Rhode Island","Newport County",3,2,717,381,336
050,44,005,"Rhode Island","Newport County",3,3,780,395,385
050,44,005,"Rhode Island","Newport County",3,4,735,391,344
050,44,005,"Rhode Island","Newport County",3,5,769,418,351
050,44,005,"Rhode Island","Newport County",3,6,709,346,363
050,44,005,"Rhode Island","Newport County",3,7,738,392,346
050,44,005,"Rhode Island","Newport County",3,8,757,397,360
050,44,005,"Rhode Island","Newport County",3,9,777,385,392
050,44,005,"Rhode Island","Newport County",3,10,792,397,395
050,44,005,"Rhode Island","Newport County",3,11,805,398,407
050,44,005,"Rhode Island","Newport County",3,12,793,390,403
050,44,005,"Rhode Island","Newport County",3,13,807,417,390
050,44,005,"Rhode Island","Newport County",3,14,843,445,398
050,44,005,"Rhode Island","Newport County",3,15,855,435,420
050,44,005,"Rhode Island","Newport County",3,16,883,450,433
050,44,005,"Rhode Island","Newport County",3,17,867,463,404
050,44,005,"Rhode Island","Newport County",3,18,1094,511,583
050,44,005,"Rhode Island","Newport County",3,19,1317,657,660
050,44,005,"Rhode Island","Newport County",3,20,1112,554,558
050,44,005,"Rhode Island","Newport County",3,21,880,435,445
050,44,005,"Rhode Island","Newport County",3,22,1004,518,486
050,44,005,"Rhode Island","Newport County",3,23,1082,574,508
050,44,005,"Rhode Island","Newport County",3,24,1055,567,488
050,44,005,"Rhode Island","Newport County",3,25,1073,600,473
050,44,005,"Rhode Island","Newport County",3,26,1044,583,461
050,44,005,"Rhode Island","Newport County",3,27,1045,554,491
050,44,005,"Rhode Island","Newport County",3,28,1049,572,477
050,44,005,"Rhode Island","Newport County",3,29,1059,553,506
050,44,005,"Rhode Island","Newport County",3,30,1066,570,496
050,44,005,"Rhode Island","Newport County",3,31,1017,515,502
050,44,005,"Rhode Island","Newport County",3,32,1051,516,535
050,44,005,"Rhode Island","Newport County",3,33,1067,548,519
050,44,005,"Rhode Island","Newport County",3,34,1018,517,501
050,44,005,"Rhode Island","Newport County",3,35,1005,495,510
050,44,005,"Rhode Island","Newport County",3,36,971,510,461
050,44,005,"Rhode Island","Newport County",3,37,989,527,462
050,44,005,"Rhode Island","Newport County",3,38,1004,520,484
050,44,005,"Rhode Island","Newport County",3,39,1002,534,468
050,44,005,"Rhode Island","Newport County",3,40,963,503,460
050,44,005,"Rhode Island","Newport County",3,41,913,443,470
050,44,005,"Rhode Island","Newport County",3,42,925,460,465
050,44,005,"Rhode Island","Newport County",3,43,856,420,436
050,44,005,"Rhode Island","Newport County",3,44,899,452,447
050,44,005,"Rhode Island","Newport County",3,45,849,427,422
050,44,005,"Rhode Island","Newport County",3,46,896,459,437
050,44,005,"Rhode Island","Newport County",3,47,939,470,469
050,44,005,"Rhode Island","Newport County",3,48,869,436,433
050,44,005,"Rhode Island","Newport County",3,49,952,489,463
050,44,005,"Rhode Island","Newport County",3,50,1073,543,530
050,44,005,"Rhode Island","Newport County",3,51,1092,522,570
050,44,005,"Rhode Island","Newport County",3,52,1093,536,557
050,44,005,"Rhode Island","Newport County",3,53,1094,549,545
050,44,005,"Rhode Island","Newport County",3,54,1189,556,633
050,44,005,"Rhode Island","Newport County",3,55,1193,573,620
050,44,005,"Rhode Island","Newport County",3,56,1306,640,666
050,44,005,"Rhode Island","Newport County",3,57,1368,660,708
050,44,005,"Rhode Island","Newport County",3,58,1373,655,718
050,44,005,"Rhode Island","Newport County",3,59,1390,689,701
050,44,005,"Rhode Island","Newport County",3,60,1372,675,697
050,44,005,"Rhode Island","Newport County",3,61,1268,603,665
050,44,005,"Rhode Island","Newport County",3,62,1322,635,687
050,44,005,"Rhode Island","Newport County",3,63,1377,670,707
050,44,005,"Rhode Island","Newport County",3,64,1401,678,723
050,44,005,"Rhode Island","Newport County",3,65,1291,624,667
050,44,005,"Rhode Island","Newport County",3,66,1267,608,659
050,44,005,"Rhode Island","Newport County",3,67,1251,587,664
050,44,005,"Rhode Island","Newport County",3,68,1185,568,617
050,44,005,"Rhode Island","Newport County",3,69,1147,545,602
050,44,005,"Rhode Island","Newport County",3,70,1146,539,607
050,44,005,"Rhode Island","Newport County",3,71,1139,543,596
050,44,005,"Rhode Island","Newport County",3,72,1127,547,580
050,44,005,"Rhode Island","Newport County",3,73,1074,523,551
050,44,005,"Rhode Island","Newport County",3,74,1157,556,601
050,44,005,"Rhode Island","Newport County",3,75,829,390,439
050,44,005,"Rhode Island","Newport County",3,76,806,384,422
050,44,005,"Rhode Island","Newport County",3,77,744,351,393
050,44,005,"Rhode Island","Newport County",3,78,763,356,407
050,44,005,"Rhode Island","Newport County",3,79,677,310,367
050,44,005,"Rhode Island","Newport County",3,80,592,266,326
050,44,005,"Rhode Island","Newport County",3,81,502,227,275
050,44,005,"Rhode Island","Newport County",3,82,473,218,255
050,44,005,"Rhode Island","Newport County",3,83,433,194,239
050,44,005,"Rhode Island","Newport County",3,84,404,162,242
050,44,005,"Rhode Island","Newport County",3,85,2709,934,1775
050,44,005,"Rhode Island","Newport County",4,0,631,332,299
050,44,005,"Rhode Island","Newport County",4,1,606,313,293
050,44,005,"Rhode Island","Newport County",4,2,671,355,316
050,44,005,"Rhode Island","Newport County",4,3,708,382,326
050,44,005,"Rhode Island","Newport County",4,4,771,390,381
050,44,005,"Rhode Island","Newport County",4,5,705,386,319
050,44,005,"Rhode Island","Newport County",4,6,721,386,335
050,44,005,"Rhode Island","Newport County",4,7,728,361,367
050,44,005,"Rhode Island","Newport County",4,8,748,389,359
050,44,005,"Rhode Island","Newport County",4,9,765,394,371
050,44,005,"Rhode Island","Newport County",4,10,750,383,367
050,44,005,"Rhode Island","Newport County",4,11,766,384,382
050,44,005,"Rhode Island","Newport County",4,12,778,383,395
050,44,005,"Rhode Island","Newport County",4,13,791,398,393
050,44,005,"Rhode Island","Newport County",4,14,793,404,389
050,44,005,"Rhode Island","Newport County",4,15,842,455,387
050,44,005,"Rhode Island","Newport County",4,16,870,440,430
050,44,005,"Rhode Island","Newport County",4,17,895,456,439
050,44,005,"Rhode Island","Newport County",4,18,1058,508,550
050,44,005,"Rhode Island","Newport County",4,19,1288,658,630
050,44,005,"Rhode Island","Newport County",4,20,1045,509,536
050,44,005,"Rhode Island","Newport County",4,21,871,457,414
050,44,005,"Rhode Island","Newport County",4,22,984,511,473
050,44,005,"Rhode Island","Newport County",4,23,1058,597,461
050,44,005,"Rhode Island","Newport County",4,24,1058,574,484
050,44,005,"Rhode Island","Newport County",4,25,1014,574,440
050,44,005,"Rhode Island","Newport County",4,26,1015,592,423
050,44,005,"Rhode Island","Newport County",4,27,990,544,446
050,44,005,"Rhode Island","Newport County",4,28,1041,567,474
050,44,005,"Rhode Island","Newport County",4,29,1003,547,456
050,44,005,"Rhode Island","Newport County",4,30,1057,539,518
050,44,005,"Rhode Island","Newport County",4,31,986,522,464
050,44,005,"Rhode Island","Newport County",4,32,1019,515,504
050,44,005,"Rhode Island","Newport County",4,33,1018,503,515
050,44,005,"Rhode Island","Newport County",4,34,1012,515,497
050,44,005,"Rhode Island","Newport County",4,35,997,504,493
050,44,005,"Rhode Island","Newport County",4,36,1009,505,504
050,44,005,"Rhode Island","Newport County",4,37,948,486,462
050,44,005,"Rhode Island","Newport County",4,38,979,520,459
050,44,005,"Rhode Island","Newport County",4,39,997,527,470
050,44,005,"Rhode Island","Newport County",4,40,959,509,450
050,44,005,"Rhode Island","Newport County",4,41,939,486,453
050,44,005,"Rhode Island","Newport County",4,42,938,444,494
050,44,005,"Rhode Island","Newport County",4,43,898,442,456
050,44,005,"Rhode Island","Newport County",4,44,884,434,450
050,44,005,"Rhode Island","Newport County",4,45,896,452,444
050,44,005,"Rhode Island","Newport County",4,46,840,437,403
050,44,005,"Rhode Island","Newport County",4,47,864,434,430
050,44,005,"Rhode Island","Newport County",4,48,925,465,460
050,44,005,"Rhode Island","Newport County",4,49,857,421,436
050,44,005,"Rhode Island","Newport County",4,50,932,471,461
050,44,005,"Rhode Island","Newport County",4,51,1070,536,534
050,44,005,"Rhode Island","Newport County",4,52,1087,520,567
050,44,005,"Rhode Island","Newport County",4,53,1084,539,545
050,44,005,"Rhode Island","Newport County",4,54,1091,549,542
050,44,005,"Rhode Island","Newport County",4,55,1207,576,631
050,44,005,"Rhode Island","Newport County",4,56,1213,582,631
050,44,005,"Rhode Island","Newport County",4,57,1314,642,672
050,44,005,"Rhode Island","Newport County",4,58,1398,672,726
050,44,005,"Rhode Island","Newport County",4,59,1347,645,702
050,44,005,"Rhode Island","Newport County",4,60,1388,695,693
050,44,005,"Rhode Island","Newport County",4,61,1321,642,679
050,44,005,"Rhode Island","Newport County",4,62,1260,603,657
050,44,005,"Rhode Island","Newport County",4,63,1303,623,680
050,44,005,"Rhode Island","Newport County",4,64,1372,663,709
050,44,005,"Rhode Island","Newport County",4,65,1384,671,713
050,44,005,"Rhode Island","Newport County",4,66,1274,611,663
050,44,005,"Rhode Island","Newport County",4,67,1265,600,665
050,44,005,"Rhode Island","Newport County",4,68,1239,584,655
050,44,005,"Rhode Island","Newport County",4,69,1167,562,605
050,44,005,"Rhode Island","Newport County",4,70,1139,540,599
050,44,005,"Rhode Island","Newport County",4,71,1130,536,594
050,44,005,"Rhode Island","Newport County",4,72,1110,527,583
050,44,005,"Rhode Island","Newport County",4,73,1093,526,567
050,44,005,"Rhode Island","Newport County",4,74,1051,507,544
050,44,005,"Rhode Island","Newport County",4,75,1144,548,596
050,44,005,"Rhode Island","Newport County",4,76,803,376,427
050,44,005,"Rhode Island","Newport County",4,77,784,375,409
050,44,005,"Rhode Island","Newport County",4,78,728,346,382
050,44,005,"Rhode Island","Newport County",4,79,723,335,388
050,44,005,"Rhode Island","Newport County",4,80,654,305,349
050,44,005,"Rhode Island","Newport County",4,81,550,235,315
050,44,005,"Rhode Island","Newport County",4,82,508,224,284
050,44,005,"Rhode Island","Newport County",4,83,427,194,233
050,44,005,"Rhode Island","Newport County",4,84,421,183,238
050,44,005,"Rhode Island","Newport County",4,85,2754,960,1794
050,44,005,"Rhode Island","Newport County",5,0,632,329,303
050,44,005,"Rhode Island","Newport County",5,1,629,337,292
050,44,005,"Rhode Island","Newport County",5,2,599,312,287
050,44,005,"Rhode Island","Newport County",5,3,677,362,315
050,44,005,"Rhode Island","Newport County",5,4,699,367,332
050,44,005,"Rhode Island","Newport County",5,5,713,362,351
050,44,005,"Rhode Island","Newport County",5,6,693,379,314
050,44,005,"Rhode Island","Newport County",5,7,688,364,324
050,44,005,"Rhode Island","Newport County",5,8,686,350,336
050,44,005,"Rhode Island","Newport County",5,9,740,376,364
050,44,005,"Rhode Island","Newport County",5,10,736,384,352
050,44,005,"Rhode Island","Newport County",5,11,724,375,349
050,44,005,"Rhode Island","Newport County",5,12,767,384,383
050,44,005,"Rhode Island","Newport County",5,13,790,388,402
050,44,005,"Rhode Island","Newport County",5,14,767,370,397
050,44,005,"Rhode Island","Newport County",5,15,778,393,385
050,44,005,"Rhode Island","Newport County",5,16,855,455,400
050,44,005,"Rhode Island","Newport County",5,17,862,449,413
050,44,005,"Rhode Island","Newport County",5,18,1093,508,585
050,44,005,"Rhode Island","Newport County",5,19,1254,652,602
050,44,005,"Rhode Island","Newport County",5,20,1072,547,525
050,44,005,"Rhode Island","Newport County",5,21,817,412,405
050,44,005,"Rhode Island","Newport County",5,22,983,532,451
050,44,005,"Rhode Island","Newport County",5,23,1044,569,475
050,44,005,"Rhode Island","Newport County",5,24,1030,574,456
050,44,005,"Rhode Island","Newport County",5,25,1032,564,468
050,44,005,"Rhode Island","Newport County",5,26,973,556,417
050,44,005,"Rhode Island","Newport County",5,27,982,558,424
050,44,005,"Rhode Island","Newport County",5,28,973,556,417
050,44,005,"Rhode Island","Newport County",5,29,980,524,456
050,44,005,"Rhode Island","Newport County",5,30,1018,558,460
050,44,005,"Rhode Island","Newport County",5,31,970,488,482
050,44,005,"Rhode Island","Newport County",5,32,950,477,473
050,44,005,"Rhode Island","Newport County",5,33,1046,542,504
050,44,005,"Rhode Island","Newport County",5,34,990,495,495
050,44,005,"Rhode Island","Newport County",5,35,978,498,480
050,44,005,"Rhode Island","Newport County",5,36,974,486,488
050,44,005,"Rhode Island","Newport County",5,37,973,504,469
050,44,005,"Rhode Island","Newport County",5,38,901,446,455
050,44,005,"Rhode Island","Newport County",5,39,944,503,441
050,44,005,"Rhode Island","Newport County",5,40,949,507,442
050,44,005,"Rhode Island","Newport County",5,41,923,480,443
050,44,005,"Rhode Island","Newport County",5,42,990,495,495
050,44,005,"Rhode Island","Newport County",5,43,944,437,507
050,44,005,"Rhode Island","Newport County",5,44,899,436,463
050,44,005,"Rhode Island","Newport County",5,45,869,438,431
050,44,005,"Rhode Island","Newport County",5,46,874,430,444
050,44,005,"Rhode Island","Newport County",5,47,835,433,402
050,44,005,"Rhode Island","Newport County",5,48,837,422,415
050,44,005,"Rhode Island","Newport County",5,49,889,438,451
050,44,005,"Rhode Island","Newport County",5,50,853,416,437
050,44,005,"Rhode Island","Newport County",5,51,938,476,462
050,44,005,"Rhode Island","Newport County",5,52,1072,534,538
050,44,005,"Rhode Island","Newport County",5,53,1080,509,571
050,44,005,"Rhode Island","Newport County",5,54,1074,522,552
050,44,005,"Rhode Island","Newport County",5,55,1089,547,542
050,44,005,"Rhode Island","Newport County",5,56,1221,579,642
050,44,005,"Rhode Island","Newport County",5,57,1220,577,643
050,44,005,"Rhode Island","Newport County",5,58,1314,628,686
050,44,005,"Rhode Island","Newport County",5,59,1372,663,709
050,44,005,"Rhode Island","Newport County",5,60,1344,652,692
050,44,005,"Rhode Island","Newport County",5,61,1383,684,699
050,44,005,"Rhode Island","Newport County",5,62,1316,634,682
050,44,005,"Rhode Island","Newport County",5,63,1248,598,650
050,44,005,"Rhode Island","Newport County",5,64,1282,612,670
050,44,005,"Rhode Island","Newport County",5,65,1352,652,700
050,44,005,"Rhode Island","Newport County",5,66,1357,654,703
050,44,005,"Rhode Island","Newport County",5,67,1269,615,654
050,44,005,"Rhode Island","Newport County",5,68,1247,592,655
050,44,005,"Rhode Island","Newport County",5,69,1230,580,650
050,44,005,"Rhode Island","Newport County",5,70,1148,539,609
050,44,005,"Rhode Island","Newport County",5,71,1128,536,592
050,44,005,"Rhode Island","Newport County",5,72,1107,518,589
050,44,005,"Rhode Island","Newport County",5,73,1094,521,573
050,44,005,"Rhode Island","Newport County",5,74,1066,517,549
050,44,005,"Rhode Island","Newport County",5,75,1053,500,553
050,44,005,"Rhode Island","Newport County",5,76,1118,533,585
050,44,005,"Rhode Island","Newport County",5,77,781,364,417
050,44,005,"Rhode Island","Newport County",5,78,767,369,398
050,44,005,"Rhode Island","Newport County",5,79,697,323,374
050,44,005,"Rhode Island","Newport County",5,80,707,334,373
050,44,005,"Rhode Island","Newport County",5,81,625,279,346
050,44,005,"Rhode Island","Newport County",5,82,547,233,314
050,44,005,"Rhode Island","Newport County",5,83,464,201,263
050,44,005,"Rhode Island","Newport County",5,84,419,183,236
050,44,005,"Rhode Island","Newport County",5,85,2829,1001,1828
050,44,007,"Rhode Island","Providence County",1,0,7211,3673,3538
050,44,007,"Rhode Island","Providence County",1,1,7233,3645,3588
050,44,007,"Rhode Island","Providence County",1,2,7483,3779,3704
050,44,007,"Rhode Island","Providence County",1,3,7450,3825,3625
050,44,007,"Rhode Island","Providence County",1,4,7661,3930,3731
050,44,007,"Rhode Island","Providence County",1,5,7497,3873,3624
050,44,007,"Rhode Island","Providence County",1,6,7394,3818,3576
050,44,007,"Rhode Island","Providence County",1,7,7252,3685,3567
050,44,007,"Rhode Island","Providence County",1,8,7266,3732,3534
050,44,007,"Rhode Island","Providence County",1,9,7217,3801,3416
050,44,007,"Rhode Island","Providence County",1,10,7350,3745,3605
050,44,007,"Rhode Island","Providence County",1,11,7513,3851,3662
050,44,007,"Rhode Island","Providence County",1,12,7898,4000,3898
050,44,007,"Rhode Island","Providence County",1,13,7885,4063,3822
050,44,007,"Rhode Island","Providence County",1,14,7792,4037,3755
050,44,007,"Rhode Island","Providence County",1,15,7826,4047,3779
050,44,007,"Rhode Island","Providence County",1,16,7901,4055,3846
050,44,007,"Rhode Island","Providence County",1,17,8025,4104,3921
050,44,007,"Rhode Island","Providence County",1,18,9804,4776,5028
050,44,007,"Rhode Island","Providence County",1,19,11136,5436,5700
050,44,007,"Rhode Island","Providence County",1,20,10498,5120,5378
050,44,007,"Rhode Island","Providence County",1,21,9865,4908,4957
050,44,007,"Rhode Island","Providence County",1,22,8913,4530,4383
050,44,007,"Rhode Island","Providence County",1,23,8532,4343,4189
050,44,007,"Rhode Island","Providence County",1,24,8875,4410,4465
050,44,007,"Rhode Island","Providence County",1,25,9232,4592,4640
050,44,007,"Rhode Island","Providence County",1,26,9747,4891,4856
050,44,007,"Rhode Island","Providence County",1,27,10087,5099,4988
050,44,007,"Rhode Island","Providence County",1,28,10274,5202,5072
050,44,007,"Rhode Island","Providence County",1,29,10746,5526,5220
050,44,007,"Rhode Island","Providence County",1,30,10876,5571,5305
050,44,007,"Rhode Island","Providence County",1,31,10738,5410,5328
050,44,007,"Rhode Island","Providence County",1,32,10300,5217,5083
050,44,007,"Rhode Island","Providence County",1,33,9690,4980,4710
050,44,007,"Rhode Island","Providence County",1,34,9420,4916,4504
050,44,007,"Rhode Island","Providence County",1,35,9148,4625,4523
050,44,007,"Rhode Island","Providence County",1,36,8911,4464,4447
050,44,007,"Rhode Island","Providence County",1,37,8938,4532,4406
050,44,007,"Rhode Island","Providence County",1,38,8811,4491,4320
050,44,007,"Rhode Island","Providence County",1,39,8680,4423,4257
050,44,007,"Rhode Island","Providence County",1,40,8504,4352,4152
050,44,007,"Rhode Island","Providence County",1,41,7992,4020,3972
050,44,007,"Rhode Island","Providence County",1,42,7849,3947,3902
050,44,007,"Rhode Island","Providence County",1,43,7524,3778,3746
050,44,007,"Rhode Island","Providence County",1,44,7395,3719,3676
050,44,007,"Rhode Island","Providence County",1,45,7578,3725,3853
050,44,007,"Rhode Island","Providence County",1,46,7475,3659,3816
050,44,007,"Rhode Island","Providence County",1,47,7844,3890,3954
050,44,007,"Rhode Island","Providence County",1,48,8183,4029,4154
050,44,007,"Rhode Island","Providence County",1,49,8612,4207,4405
050,44,007,"Rhode Island","Providence County",1,50,8470,4183,4287
050,44,007,"Rhode Island","Providence County",1,51,8442,4157,4285
050,44,007,"Rhode Island","Providence County",1,52,8527,4190,4337
050,44,007,"Rhode Island","Providence County",1,53,8810,4337,4473
050,44,007,"Rhode Island","Providence County",1,54,8851,4370,4481
050,44,007,"Rhode Island","Providence County",1,55,9050,4452,4598
050,44,007,"Rhode Island","Providence County",1,56,8969,4405,4564
050,44,007,"Rhode Island","Providence County",1,57,8917,4379,4538
050,44,007,"Rhode Island","Providence County",1,58,9095,4425,4670
050,44,007,"Rhode Island","Providence County",1,59,8960,4354,4606
050,44,007,"Rhode Island","Providence County",1,60,8620,4172,4448
050,44,007,"Rhode Island","Providence County",1,61,8614,4135,4479
050,44,007,"Rhode Island","Providence County",1,62,8517,4087,4430
050,44,007,"Rhode Island","Providence County",1,63,8195,3972,4223
050,44,007,"Rhode Island","Providence County",1,64,8051,3916,4135
050,44,007,"Rhode Island","Providence County",1,65,7605,3661,3944
050,44,007,"Rhode Island","Providence County",1,66,7045,3308,3737
050,44,007,"Rhode Island","Providence County",1,67,6733,3195,3538
050,44,007,"Rhode Island","Providence County",1,68,6421,3045,3376
050,44,007,"Rhode Island","Providence County",1,69,5886,2755,3131
050,44,007,"Rhode Island","Providence County",1,70,5659,2699,2960
050,44,007,"Rhode Island","Providence County",1,71,5476,2578,2898
050,44,007,"Rhode Island","Providence County",1,72,5486,2526,2960
050,44,007,"Rhode Island","Providence County",1,73,5421,2531,2890
050,44,007,"Rhode Island","Providence County",1,74,3824,1742,2082
050,44,007,"Rhode Island","Providence County",1,75,3804,1721,2083
050,44,007,"Rhode Island","Providence County",1,76,3753,1685,2068
050,44,007,"Rhode Island","Providence County",1,77,3749,1639,2110
050,44,007,"Rhode Island","Providence County",1,78,3101,1283,1818
050,44,007,"Rhode Island","Providence County",1,79,2871,1199,1672
050,44,007,"Rhode Island","Providence County",1,80,2651,1099,1552
050,44,007,"Rhode Island","Providence County",1,81,2503,1018,1485
050,44,007,"Rhode Island","Providence County",1,82,2335,934,1401
050,44,007,"Rhode Island","Providence County",1,83,2095,808,1287
050,44,007,"Rhode Island","Providence County",1,84,2024,776,1248
050,44,007,"Rhode Island","Providence County",1,85,14167,4370,9797
050,44,007,"Rhode Island","Providence County",2,0,7153,3649,3504
050,44,007,"Rhode Island","Providence County",2,1,7221,3643,3578
050,44,007,"Rhode Island","Providence County",2,2,7419,3742,3677
050,44,007,"Rhode Island","Providence County",2,3,7435,3798,3637
050,44,007,"Rhode Island","Providence County",2,4,7595,3903,3692
050,44,007,"Rhode Island","Providence County",2,5,7535,3890,3645
050,44,007,"Rhode Island","Providence County",2,6,7424,3829,3595
050,44,007,"Rhode Island","Providence County",2,7,7269,3701,3568
050,44,007,"Rhode Island","Providence County",2,8,7230,3701,3529
050,44,007,"Rhode Island","Providence County",2,9,7219,3777,3442
050,44,007,"Rhode Island","Providence County",2,10,7299,3745,3554
050,44,007,"Rhode Island","Providence County",2,11,7422,3803,3619
050,44,007,"Rhode Island","Providence County",2,12,7827,3984,3843
050,44,007,"Rhode Island","Providence County",2,13,7880,4046,3834
050,44,007,"Rhode Island","Providence County",2,14,7799,4034,3765
050,44,007,"Rhode Island","Providence County",2,15,7803,4036,3767
050,44,007,"Rhode Island","Providence County",2,16,7885,4057,3828
050,44,007,"Rhode Island","Providence County",2,17,7989,4082,3907
050,44,007,"Rhode Island","Providence County",2,18,9771,4747,5024
050,44,007,"Rhode Island","Providence County",2,19,11127,5421,5706
050,44,007,"Rhode Island","Providence County",2,20,10592,5172,5420
050,44,007,"Rhode Island","Providence County",2,21,9841,4889,4952
050,44,007,"Rhode Island","Providence County",2,22,8894,4507,4387
050,44,007,"Rhode Island","Providence County",2,23,8508,4323,4185
050,44,007,"Rhode Island","Providence County",2,24,8797,4391,4406
050,44,007,"Rhode Island","Providence County",2,25,9185,4574,4611
050,44,007,"Rhode Island","Providence County",2,26,9665,4843,4822
050,44,007,"Rhode Island","Providence County",2,27,10003,5044,4959
050,44,007,"Rhode Island","Providence County",2,28,10253,5193,5060
050,44,007,"Rhode Island","Providence County",2,29,10639,5449,5190
050,44,007,"Rhode Island","Providence County",2,30,10897,5594,5303
050,44,007,"Rhode Island","Providence County",2,31,10732,5436,5296
050,44,007,"Rhode Island","Providence County",2,32,10391,5257,5134
050,44,007,"Rhode Island","Providence County",2,33,9813,5036,4777
050,44,007,"Rhode Island","Providence County",2,34,9488,4940,4548
050,44,007,"Rhode Island","Providence County",2,35,9247,4714,4533
050,44,007,"Rhode Island","Providence County",2,36,8908,4474,4434
050,44,007,"Rhode Island","Providence County",2,37,8939,4529,4410
050,44,007,"Rhode Island","Providence County",2,38,8862,4508,4354
050,44,007,"Rhode Island","Providence County",2,39,8673,4426,4247
050,44,007,"Rhode Island","Providence County",2,40,8595,4393,4202
050,44,007,"Rhode Island","Providence County",2,41,8082,4085,3997
050,44,007,"Rhode Island","Providence County",2,42,7846,3946,3900
050,44,007,"Rhode Island","Providence County",2,43,7632,3832,3800
050,44,007,"Rhode Island","Providence County",2,44,7363,3706,3657
050,44,007,"Rhode Island","Providence County",2,45,7570,3740,3830
050,44,007,"Rhode Island","Providence County",2,46,7472,3661,3811
050,44,007,"Rhode Island","Providence County",2,47,7729,3821,3908
050,44,007,"Rhode Island","Providence County",2,48,8081,3990,4091
050,44,007,"Rhode Island","Providence County",2,49,8527,4170,4357
050,44,007,"Rhode Island","Providence County",2,50,8498,4186,4312
050,44,007,"Rhode Island","Providence County",2,51,8402,4135,4267
050,44,007,"Rhode Island","Providence County",2,52,8477,4164,4313
050,44,007,"Rhode Island","Providence County",2,53,8702,4282,4420
050,44,007,"Rhode Island","Providence County",2,54,8791,4336,4455
050,44,007,"Rhode Island","Providence County",2,55,8984,4429,4555
050,44,007,"Rhode Island","Providence County",2,56,9004,4422,4582
050,44,007,"Rhode Island","Providence County",2,57,8898,4360,4538
050,44,007,"Rhode Island","Providence County",2,58,9001,4384,4617
050,44,007,"Rhode Island","Providence County",2,59,8980,4360,4620
050,44,007,"Rhode Island","Providence County",2,60,8660,4196,4464
050,44,007,"Rhode Island","Providence County",2,61,8557,4102,4455
050,44,007,"Rhode Island","Providence County",2,62,8491,4070,4421
050,44,007,"Rhode Island","Providence County",2,63,8291,4010,4281
050,44,007,"Rhode Island","Providence County",2,64,8001,3891,4110
050,44,007,"Rhode Island","Providence County",2,65,7654,3686,3968
050,44,007,"Rhode Island","Providence County",2,66,7148,3374,3774
050,44,007,"Rhode Island","Providence County",2,67,6757,3197,3560
050,44,007,"Rhode Island","Providence County",2,68,6410,3037,3373
050,44,007,"Rhode Island","Providence County",2,69,6000,2811,3189
050,44,007,"Rhode Island","Providence County",2,70,5653,2679,2974
050,44,007,"Rhode Island","Providence County",2,71,5477,2577,2900
050,44,007,"Rhode Island","Providence County",2,72,5347,2474,2873
050,44,007,"Rhode Island","Providence County",2,73,5607,2599,3008
050,44,007,"Rhode Island","Providence County",2,74,3917,1780,2137
050,44,007,"Rhode Island","Providence County",2,75,3781,1713,2068
050,44,007,"Rhode Island","Providence County",2,76,3688,1654,2034
050,44,007,"Rhode Island","Providence County",2,77,3775,1651,2124
050,44,007,"Rhode Island","Providence County",2,78,3149,1321,1828
050,44,007,"Rhode Island","Providence County",2,79,2867,1198,1669
050,44,007,"Rhode Island","Providence County",2,80,2661,1092,1569
050,44,007,"Rhode Island","Providence County",2,81,2483,1012,1471
050,44,007,"Rhode Island","Providence County",2,82,2331,935,1396
050,44,007,"Rhode Island","Providence County",2,83,2094,814,1280
050,44,007,"Rhode Island","Providence County",2,84,2002,759,1243
050,44,007,"Rhode Island","Providence County",2,85,13899,4286,9613
050,44,007,"Rhode Island","Providence County",3,0,6831,3426,3405
050,44,007,"Rhode Island","Providence County",3,1,7107,3626,3481
050,44,007,"Rhode Island","Providence County",3,2,7202,3655,3547
050,44,007,"Rhode Island","Providence County",3,3,7333,3722,3611
050,44,007,"Rhode Island","Providence County",3,4,7354,3771,3583
050,44,007,"Rhode Island","Providence County",3,5,7556,3873,3683
050,44,007,"Rhode Island","Providence County",3,6,7469,3836,3633
050,44,007,"Rhode Island","Providence County",3,7,7393,3799,3594
050,44,007,"Rhode Island","Providence County",3,8,7267,3683,3584
050,44,007,"Rhode Island","Providence County",3,9,7174,3690,3484
050,44,007,"Rhode Island","Providence County",3,10,7191,3756,3435
050,44,007,"Rhode Island","Providence County",3,11,7267,3734,3533
050,44,007,"Rhode Island","Providence County",3,12,7380,3760,3620
050,44,007,"Rhode Island","Providence County",3,13,7821,3968,3853
050,44,007,"Rhode Island","Providence County",3,14,7853,4024,3829
050,44,007,"Rhode Island","Providence County",3,15,7766,4019,3747
050,44,007,"Rhode Island","Providence County",3,16,7804,4037,3767
050,44,007,"Rhode Island","Providence County",3,17,7894,4069,3825
050,44,007,"Rhode Island","Providence County",3,18,9768,4723,5045
050,44,007,"Rhode Island","Providence County",3,19,10885,5296,5589
050,44,007,"Rhode Island","Providence County",3,20,10399,5135,5264
050,44,007,"Rhode Island","Providence County",3,21,9718,4828,4890
050,44,007,"Rhode Island","Providence County",3,22,8746,4375,4371
050,44,007,"Rhode Island","Providence County",3,23,8391,4245,4146
050,44,007,"Rhode Island","Providence County",3,24,8699,4421,4278
050,44,007,"Rhode Island","Providence County",3,25,8943,4508,4435
050,44,007,"Rhode Island","Providence County",3,26,9428,4699,4729
050,44,007,"Rhode Island","Providence County",3,27,9846,4947,4899
050,44,007,"Rhode Island","Providence County",3,28,10099,5113,4986
050,44,007,"Rhode Island","Providence County",3,29,10226,5195,5031
050,44,007,"Rhode Island","Providence County",3,30,10675,5460,5215
050,44,007,"Rhode Island","Providence County",3,31,10915,5585,5330
050,44,007,"Rhode Island","Providence County",3,32,10755,5458,5297
050,44,007,"Rhode Island","Providence County",3,33,10328,5248,5080
050,44,007,"Rhode Island","Providence County",3,34,9793,5042,4751
050,44,007,"Rhode Island","Providence County",3,35,9442,4913,4529
050,44,007,"Rhode Island","Providence County",3,36,9200,4685,4515
050,44,007,"Rhode Island","Providence County",3,37,8883,4516,4367
050,44,007,"Rhode Island","Providence County",3,38,8885,4472,4413
050,44,007,"Rhode Island","Providence County",3,39,8876,4519,4357
050,44,007,"Rhode Island","Providence County",3,40,8594,4389,4205
050,44,007,"Rhode Island","Providence County",3,41,8495,4362,4133
050,44,007,"Rhode Island","Providence County",3,42,8065,4043,4022
050,44,007,"Rhode Island","Providence County",3,43,7813,3937,3876
050,44,007,"Rhode Island","Providence County",3,44,7604,3807,3797
050,44,007,"Rhode Island","Providence County",3,45,7332,3695,3637
050,44,007,"Rhode Island","Providence County",3,46,7487,3699,3788
050,44,007,"Rhode Island","Providence County",3,47,7368,3606,3762
050,44,007,"Rhode Island","Providence County",3,48,7622,3785,3837
050,44,007,"Rhode Island","Providence County",3,49,7993,3914,4079
050,44,007,"Rhode Island","Providence County",3,50,8503,4168,4335
050,44,007,"Rhode Island","Providence County",3,51,8434,4155,4279
050,44,007,"Rhode Island","Providence County",3,52,8349,4095,4254
050,44,007,"Rhode Island","Providence County",3,53,8445,4156,4289
050,44,007,"Rhode Island","Providence County",3,54,8597,4241,4356
050,44,007,"Rhode Island","Providence County",3,55,8673,4298,4375
050,44,007,"Rhode Island","Providence County",3,56,8990,4433,4557
050,44,007,"Rhode Island","Providence County",3,57,8840,4325,4515
050,44,007,"Rhode Island","Providence County",3,58,8725,4268,4457
050,44,007,"Rhode Island","Providence County",3,59,8899,4314,4585
050,44,007,"Rhode Island","Providence County",3,60,8753,4246,4507
050,44,007,"Rhode Island","Providence County",3,61,8560,4127,4433
050,44,007,"Rhode Island","Providence County",3,62,8386,4017,4369
050,44,007,"Rhode Island","Providence County",3,63,8269,3973,4296
050,44,007,"Rhode Island","Providence County",3,64,8139,3959,4180
050,44,007,"Rhode Island","Providence County",3,65,7776,3744,4032
050,44,007,"Rhode Island","Providence County",3,66,7459,3564,3895
050,44,007,"Rhode Island","Providence County",3,67,6964,3249,3715
050,44,007,"Rhode Island","Providence County",3,68,6601,3116,3485
050,44,007,"Rhode Island","Providence County",3,69,6258,2942,3316
050,44,007,"Rhode Island","Providence County",3,70,5825,2720,3105
050,44,007,"Rhode Island","Providence County",3,71,5514,2562,2952
050,44,007,"Rhode Island","Providence County",3,72,5345,2513,2832
050,44,007,"Rhode Island","Providence County",3,73,5163,2395,2768
050,44,007,"Rhode Island","Providence County",3,74,5442,2484,2958
050,44,007,"Rhode Island","Providence County",3,75,3838,1742,2096
050,44,007,"Rhode Island","Providence County",3,76,3635,1632,2003
050,44,007,"Rhode Island","Providence County",3,77,3561,1571,1990
050,44,007,"Rhode Island","Providence County",3,78,3597,1563,2034
050,44,007,"Rhode Island","Providence County",3,79,3002,1263,1739
050,44,007,"Rhode Island","Providence County",3,80,2707,1106,1601
050,44,007,"Rhode Island","Providence County",3,81,2526,1009,1517
050,44,007,"Rhode Island","Providence County",3,82,2326,944,1382
050,44,007,"Rhode Island","Providence County",3,83,2178,871,1307
050,44,007,"Rhode Island","Providence County",3,84,1986,768,1218
050,44,007,"Rhode Island","Providence County",3,85,13582,4168,9414
050,44,007,"Rhode Island","Providence County",4,0,6955,3477,3478
050,44,007,"Rhode Island","Providence County",4,1,6704,3351,3353
050,44,007,"Rhode Island","Providence County",4,2,7092,3604,3488
050,44,007,"Rhode Island","Providence County",4,3,7242,3676,3566
050,44,007,"Rhode Island","Providence County",4,4,7261,3705,3556
050,44,007,"Rhode Island","Providence County",4,5,7344,3760,3584
050,44,007,"Rhode Island","Providence County",4,6,7495,3841,3654
050,44,007,"Rhode Island","Providence County",4,7,7429,3812,3617
050,44,007,"Rhode Island","Providence County",4,8,7332,3773,3559
050,44,007,"Rhode Island","Providence County",4,9,7243,3702,3541
050,44,007,"Rhode Island","Providence County",4,10,7183,3700,3483
050,44,007,"Rhode Island","Providence County",4,11,7197,3771,3426
050,44,007,"Rhode Island","Providence County",4,12,7205,3671,3534
050,44,007,"Rhode Island","Providence County",4,13,7368,3746,3622
050,44,007,"Rhode Island","Providence County",4,14,7845,3997,3848
050,44,007,"Rhode Island","Providence County",4,15,7820,3994,3826
050,44,007,"Rhode Island","Providence County",4,16,7826,4051,3775
050,44,007,"Rhode Island","Providence County",4,17,7866,4049,3817
050,44,007,"Rhode Island","Providence County",4,18,9575,4674,4901
050,44,007,"Rhode Island","Providence County",4,19,10815,5291,5524
050,44,007,"Rhode Island","Providence County",4,20,10214,5028,5186
050,44,007,"Rhode Island","Providence County",4,21,9542,4759,4783
050,44,007,"Rhode Island","Providence County",4,22,8725,4320,4405
050,44,007,"Rhode Island","Providence County",4,23,8283,4125,4158
050,44,007,"Rhode Island","Providence County",4,24,8513,4227,4286
050,44,007,"Rhode Island","Providence County",4,25,8806,4469,4337
050,44,007,"Rhode Island","Providence County",4,26,9098,4587,4511
050,44,007,"Rhode Island","Providence County",4,27,9505,4755,4750
050,44,007,"Rhode Island","Providence County",4,28,9931,5024,4907
050,44,007,"Rhode Island","Providence County",4,29,10187,5123,5064
050,44,007,"Rhode Island","Providence County",4,30,10239,5190,5049
050,44,007,"Rhode Island","Providence County",4,31,10659,5472,5187
050,44,007,"Rhode Island","Providence County",4,32,10826,5512,5314
050,44,007,"Rhode Island","Providence County",4,33,10665,5452,5213
050,44,007,"Rhode Island","Providence County",4,34,10212,5157,5055
050,44,007,"Rhode Island","Providence County",4,35,9691,4971,4720
050,44,007,"Rhode Island","Providence County",4,36,9335,4877,4458
050,44,007,"Rhode Island","Providence County",4,37,9167,4712,4455
050,44,007,"Rhode Island","Providence County",4,38,8878,4476,4402
050,44,007,"Rhode Island","Providence County",4,39,8843,4454,4389
050,44,007,"Rhode Island","Providence County",4,40,8847,4513,4334
050,44,007,"Rhode Island","Providence County",4,41,8541,4365,4176
050,44,007,"Rhode Island","Providence County",4,42,8526,4366,4160
050,44,007,"Rhode Island","Providence County",4,43,8042,4025,4017
050,44,007,"Rhode Island","Providence County",4,44,7755,3920,3835
050,44,007,"Rhode Island","Providence County",4,45,7613,3794,3819
050,44,007,"Rhode Island","Providence County",4,46,7274,3632,3642
050,44,007,"Rhode Island","Providence County",4,47,7450,3698,3752
050,44,007,"Rhode Island","Providence County",4,48,7211,3517,3694
050,44,007,"Rhode Island","Providence County",4,49,7565,3723,3842
050,44,007,"Rhode Island","Providence County",4,50,7990,3919,4071
050,44,007,"Rhode Island","Providence County",4,51,8421,4134,4287
050,44,007,"Rhode Island","Providence County",4,52,8356,4094,4262
050,44,007,"Rhode Island","Providence County",4,53,8220,4042,4178
050,44,007,"Rhode Island","Providence County",4,54,8332,4097,4235
050,44,007,"Rhode Island","Providence County",4,55,8409,4196,4213
050,44,007,"Rhode Island","Providence County",4,56,8652,4281,4371
050,44,007,"Rhode Island","Providence County",4,57,8837,4334,4503
050,44,007,"Rhode Island","Providence County",4,58,8681,4245,4436
050,44,007,"Rhode Island","Providence County",4,59,8627,4200,4427
050,44,007,"Rhode Island","Providence County",4,60,8701,4216,4485
050,44,007,"Rhode Island","Providence County",4,61,8562,4134,4428
050,44,007,"Rhode Island","Providence County",4,62,8391,4032,4359
050,44,007,"Rhode Island","Providence County",4,63,8168,3881,4287
050,44,007,"Rhode Island","Providence County",4,64,8121,3918,4203
050,44,007,"Rhode Island","Providence County",4,65,7941,3850,4091
050,44,007,"Rhode Island","Providence County",4,66,7510,3587,3923
050,44,007,"Rhode Island","Providence County",4,67,7284,3472,3812
050,44,007,"Rhode Island","Providence County",4,68,6771,3165,3606
050,44,007,"Rhode Island","Providence County",4,69,6452,3030,3422
050,44,007,"Rhode Island","Providence County",4,70,6089,2857,3232
050,44,007,"Rhode Island","Providence County",4,71,5686,2618,3068
050,44,007,"Rhode Island","Providence County",4,72,5373,2473,2900
050,44,007,"Rhode Island","Providence County",4,73,5178,2443,2735
050,44,007,"Rhode Island","Providence County",4,74,5009,2275,2734
050,44,007,"Rhode Island","Providence County",4,75,5283,2417,2866
050,44,007,"Rhode Island","Providence County",4,76,3704,1658,2046
050,44,007,"Rhode Island","Providence County",4,77,3503,1558,1945
050,44,007,"Rhode Island","Providence County",4,78,3407,1496,1911
050,44,007,"Rhode Island","Providence County",4,79,3458,1493,1965
050,44,007,"Rhode Island","Providence County",4,80,2834,1166,1668
050,44,007,"Rhode Island","Providence County",4,81,2583,1039,1544
050,44,007,"Rhode Island","Providence County",4,82,2351,932,1419
050,44,007,"Rhode Island","Providence County",4,83,2192,877,1315
050,44,007,"Rhode Island","Providence County",4,84,2065,825,1240
050,44,007,"Rhode Island","Providence County",4,85,13343,4161,9182
050,44,007,"Rhode Island","Providence County",5,0,6757,3367,3390
050,44,007,"Rhode Island","Providence County",5,1,7040,3468,3572
050,44,007,"Rhode Island","Providence County",5,2,6824,3394,3430
050,44,007,"Rhode Island","Providence County",5,3,7114,3644,3470
050,44,007,"Rhode Island","Providence County",5,4,7289,3675,3614
050,44,007,"Rhode Island","Providence County",5,5,7278,3693,3585
050,44,007,"Rhode Island","Providence County",5,6,7341,3782,3559
050,44,007,"Rhode Island","Providence County",5,7,7440,3821,3619
050,44,007,"Rhode Island","Providence County",5,8,7395,3773,3622
050,44,007,"Rhode Island","Providence County",5,9,7367,3788,3579
050,44,007,"Rhode Island","Providence County",5,10,7282,3740,3542
050,44,007,"Rhode Island","Providence County",5,11,7258,3787,3471
050,44,007,"Rhode Island","Providence County",5,12,7195,3763,3432
050,44,007,"Rhode Island","Providence County",5,13,7288,3692,3596
050,44,007,"Rhode Island","Providence County",5,14,7361,3759,3602
050,44,007,"Rhode Island","Providence County",5,15,7881,4010,3871
050,44,007,"Rhode Island","Providence County",5,16,7917,4058,3859
050,44,007,"Rhode Island","Providence County",5,17,7923,4097,3826
050,44,007,"Rhode Island","Providence County",5,18,9607,4706,4901
050,44,007,"Rhode Island","Providence County",5,19,10849,5349,5500
050,44,007,"Rhode Island","Providence County",5,20,10304,5076,5228
050,44,007,"Rhode Island","Providence County",5,21,9483,4730,4753
050,44,007,"Rhode Island","Providence County",5,22,8743,4362,4381
050,44,007,"Rhode Island","Providence County",5,23,8329,4056,4273
050,44,007,"Rhode Island","Providence County",5,24,8503,4207,4296
050,44,007,"Rhode Island","Providence County",5,25,8751,4356,4395
050,44,007,"Rhode Island","Providence County",5,26,9078,4608,4470
050,44,007,"Rhode Island","Providence County",5,27,9280,4690,4590
050,44,007,"Rhode Island","Providence County",5,28,9670,4842,4828
050,44,007,"Rhode Island","Providence County",5,29,10003,5009,4994
050,44,007,"Rhode Island","Providence County",5,30,10338,5240,5098
050,44,007,"Rhode Island","Providence County",5,31,10350,5278,5072
050,44,007,"Rhode Island","Providence County",5,32,10696,5491,5205
050,44,007,"Rhode Island","Providence County",5,33,10824,5527,5297
050,44,007,"Rhode Island","Providence County",5,34,10609,5423,5186
050,44,007,"Rhode Island","Providence County",5,35,10274,5225,5049
050,44,007,"Rhode Island","Providence County",5,36,9755,5057,4698
050,44,007,"Rhode Island","Providence County",5,37,9417,4968,4449
050,44,007,"Rhode Island","Providence County",5,38,9189,4708,4481
050,44,007,"Rhode Island","Providence County",5,39,8929,4521,4408
050,44,007,"Rhode Island","Providence County",5,40,8778,4408,4370
050,44,007,"Rhode Island","Providence County",5,41,8819,4468,4351
050,44,007,"Rhode Island","Providence County",5,42,8570,4359,4211
050,44,007,"Rhode Island","Providence County",5,43,8444,4293,4151
050,44,007,"Rhode Island","Providence County",5,44,8073,4020,4053
050,44,007,"Rhode Island","Providence County",5,45,7777,3916,3861
050,44,007,"Rhode Island","Providence County",5,46,7546,3730,3816
050,44,007,"Rhode Island","Providence County",5,47,7220,3598,3622
050,44,007,"Rhode Island","Providence County",5,48,7406,3699,3707
050,44,007,"Rhode Island","Providence County",5,49,7237,3516,3721
050,44,007,"Rhode Island","Providence County",5,50,7514,3724,3790
050,44,007,"Rhode Island","Providence County",5,51,7972,3945,4027
050,44,007,"Rhode Island","Providence County",5,52,8371,4093,4278
050,44,007,"Rhode Island","Providence County",5,53,8304,4074,4230
050,44,007,"Rhode Island","Providence County",5,54,8158,3977,4181
050,44,007,"Rhode Island","Providence County",5,55,8246,4061,4185
050,44,007,"Rhode Island","Providence County",5,56,8371,4149,4222
050,44,007,"Rhode Island","Providence County",5,57,8547,4197,4350
050,44,007,"Rhode Island","Providence County",5,58,8830,4343,4487
050,44,007,"Rhode Island","Providence County",5,59,8622,4205,4417
050,44,007,"Rhode Island","Providence County",5,60,8498,4144,4354
050,44,007,"Rhode Island","Providence County",5,61,8557,4129,4428
050,44,007,"Rhode Island","Providence County",5,62,8452,4094,4358
050,44,007,"Rhode Island","Providence County",5,63,8228,3937,4291
050,44,007,"Rhode Island","Providence County",5,64,8060,3834,4226
050,44,007,"Rhode Island","Providence County",5,65,8001,3836,4165
050,44,007,"Rhode Island","Providence County",5,66,7743,3713,4030
050,44,007,"Rhode Island","Providence County",5,67,7404,3527,3877
050,44,007,"Rhode Island","Providence County",5,68,7120,3388,3732
050,44,007,"Rhode Island","Providence County",5,69,6651,3071,3580
050,44,007,"Rhode Island","Providence County",5,70,6306,2961,3345
050,44,007,"Rhode Island","Providence County",5,71,5931,2765,3166
050,44,007,"Rhode Island","Providence County",5,72,5552,2547,3005
050,44,007,"Rhode Island","Providence County",5,73,5222,2415,2807
050,44,007,"Rhode Island","Providence County",5,74,5017,2328,2689
050,44,007,"Rhode Island","Providence County",5,75,4888,2225,2663
050,44,007,"Rhode Island","Providence County",5,76,5124,2320,2804
050,44,007,"Rhode Island","Providence County",5,77,3573,1586,1987
050,44,007,"Rhode Island","Providence County",5,78,3354,1482,1872
050,44,007,"Rhode Island","Providence County",5,79,3268,1441,1827
050,44,007,"Rhode Island","Providence County",5,80,3288,1400,1888
050,44,007,"Rhode Island","Providence County",5,81,2699,1096,1603
050,44,007,"Rhode Island","Providence County",5,82,2419,968,1451
050,44,007,"Rhode Island","Providence County",5,83,2196,869,1327
050,44,007,"Rhode Island","Providence County",5,84,2077,829,1248
050,44,007,"Rhode Island","Providence County",5,85,13251,4224,9027
050,44,009,"Rhode Island","Washington County",1,0,881,450,431
050,44,009,"Rhode Island","Washington County",1,1,896,453,443
050,44,009,"Rhode Island","Washington County",1,2,948,512,436
050,44,009,"Rhode Island","Washington County",1,3,1003,522,481
050,44,009,"Rhode Island","Washington County",1,4,1019,533,486
050,44,009,"Rhode Island","Washington County",1,5,979,501,478
050,44,009,"Rhode Island","Washington County",1,6,1052,541,511
050,44,009,"Rhode Island","Washington County",1,7,1067,521,546
050,44,009,"Rhode Island","Washington County",1,8,1114,572,542
050,44,009,"Rhode Island","Washington County",1,9,1113,574,539
050,44,009,"Rhode Island","Washington County",1,10,1169,606,563
050,44,009,"Rhode Island","Washington County",1,11,1264,663,601
050,44,009,"Rhode Island","Washington County",1,12,1299,639,660
050,44,009,"Rhode Island","Washington County",1,13,1319,640,679
050,44,009,"Rhode Island","Washington County",1,14,1422,697,725
050,44,009,"Rhode Island","Washington County",1,15,1429,737,692
050,44,009,"Rhode Island","Washington County",1,16,1504,766,738
050,44,009,"Rhode Island","Washington County",1,17,1504,758,746
050,44,009,"Rhode Island","Washington County",1,18,3082,1407,1675
050,44,009,"Rhode Island","Washington County",1,19,3606,1620,1986
050,44,009,"Rhode Island","Washington County",1,20,3240,1552,1688
050,44,009,"Rhode Island","Washington County",1,21,3034,1584,1450
050,44,009,"Rhode Island","Washington County",1,22,2310,1178,1132
050,44,009,"Rhode Island","Washington County",1,23,1862,955,907
050,44,009,"Rhode Island","Washington County",1,24,1605,824,781
050,44,009,"Rhode Island","Washington County",1,25,1430,748,682
050,44,009,"Rhode Island","Washington County",1,26,1416,742,674
050,44,009,"Rhode Island","Washington County",1,27,1294,687,607
050,44,009,"Rhode Island","Washington County",1,28,1210,634,576
050,44,009,"Rhode Island","Washington County",1,29,1221,624,597
050,44,009,"Rhode Island","Washington County",1,30,1244,615,629
050,44,009,"Rhode Island","Washington County",1,31,1186,574,612
050,44,009,"Rhode Island","Washington County",1,32,1235,633,602
050,44,009,"Rhode Island","Washington County",1,33,1200,612,588
050,44,009,"Rhode Island","Washington County",1,34,1197,598,599
050,44,009,"Rhode Island","Washington County",1,35,1214,610,604
050,44,009,"Rhode Island","Washington County",1,36,1218,604,614
050,44,009,"Rhode Island","Washington County",1,37,1258,650,608
050,44,009,"Rhode Island","Washington County",1,38,1307,660,647
050,44,009,"Rhode Island","Washington County",1,39,1332,679,653
050,44,009,"Rhode Island","Washington County",1,40,1305,642,663
050,44,009,"Rhode Island","Washington County",1,41,1285,620,665
050,44,009,"Rhode Island","Washington County",1,42,1254,614,640
050,44,009,"Rhode Island","Washington County",1,43,1242,630,612
050,44,009,"Rhode Island","Washington County",1,44,1234,626,608
050,44,009,"Rhode Island","Washington County",1,45,1234,601,633
050,44,009,"Rhode Island","Washington County",1,46,1220,591,629
050,44,009,"Rhode Island","Washington County",1,47,1303,636,667
050,44,009,"Rhode Island","Washington County",1,48,1484,712,772
050,44,009,"Rhode Island","Washington County",1,49,1629,797,832
050,44,009,"Rhode Island","Washington County",1,50,1665,777,888
050,44,009,"Rhode Island","Washington County",1,51,1701,818,883
050,44,009,"Rhode Island","Washington County",1,52,1756,847,909
050,44,009,"Rhode Island","Washington County",1,53,1790,868,922
050,44,009,"Rhode Island","Washington County",1,54,1845,881,964
050,44,009,"Rhode Island","Washington County",1,55,2043,976,1067
050,44,009,"Rhode Island","Washington County",1,56,2121,1030,1091
050,44,009,"Rhode Island","Washington County",1,57,2137,1043,1094
050,44,009,"Rhode Island","Washington County",1,58,2233,1074,1159
050,44,009,"Rhode Island","Washington County",1,59,2169,1014,1155
050,44,009,"Rhode Island","Washington County",1,60,2125,1031,1094
050,44,009,"Rhode Island","Washington County",1,61,2118,1027,1091
050,44,009,"Rhode Island","Washington County",1,62,2183,1045,1138
050,44,009,"Rhode Island","Washington County",1,63,2126,1048,1078
050,44,009,"Rhode Island","Washington County",1,64,2027,996,1031
050,44,009,"Rhode Island","Washington County",1,65,1997,970,1027
050,44,009,"Rhode Island","Washington County",1,66,1925,918,1007
050,44,009,"Rhode Island","Washington County",1,67,1886,930,956
050,44,009,"Rhode Island","Washington County",1,68,1861,913,948
050,44,009,"Rhode Island","Washington County",1,69,1695,814,881
050,44,009,"Rhode Island","Washington County",1,70,1636,793,843
050,44,009,"Rhode Island","Washington County",1,71,1594,769,825
050,44,009,"Rhode Island","Washington County",1,72,1590,749,841
050,44,009,"Rhode Island","Washington County",1,73,1643,784,859
050,44,009,"Rhode Island","Washington County",1,74,1100,539,561
050,44,009,"Rhode Island","Washington County",1,75,1089,530,559
050,44,009,"Rhode Island","Washington County",1,76,1091,513,578
050,44,009,"Rhode Island","Washington County",1,77,1117,531,586
050,44,009,"Rhode Island","Washington County",1,78,880,408,472
050,44,009,"Rhode Island","Washington County",1,79,751,334,417
050,44,009,"Rhode Island","Washington County",1,80,666,298,368
050,44,009,"Rhode Island","Washington County",1,81,589,250,339
050,44,009,"Rhode Island","Washington County",1,82,549,222,327
050,44,009,"Rhode Island","Washington County",1,83,520,229,291
050,44,009,"Rhode Island","Washington County",1,84,491,208,283
050,44,009,"Rhode Island","Washington County",1,85,3263,1109,2154
050,44,009,"Rhode Island","Washington County",2,0,850,433,417
050,44,009,"Rhode Island","Washington County",2,1,896,460,436
050,44,009,"Rhode Island","Washington County",2,2,945,504,441
050,44,009,"Rhode Island","Washington County",2,3,990,517,473
050,44,009,"Rhode Island","Washington County",2,4,1022,532,490
050,44,009,"Rhode Island","Washington County",2,5,996,512,484
050,44,009,"Rhode Island","Washington County",2,6,1038,534,504
050,44,009,"Rhode Island","Washington County",2,7,1066,530,536
050,44,009,"Rhode Island","Washington County",2,8,1099,557,542
050,44,009,"Rhode Island","Washington County",2,9,1113,575,538
050,44,009,"Rhode Island","Washington County",2,10,1157,600,557
050,44,009,"Rhode Island","Washington County",2,11,1240,649,591
050,44,009,"Rhode Island","Washington County",2,12,1295,646,649
050,44,009,"Rhode Island","Washington County",2,13,1309,636,673
050,44,009,"Rhode Island","Washington County",2,14,1398,684,714
050,44,009,"Rhode Island","Washington County",2,15,1431,727,704
050,44,009,"Rhode Island","Washington County",2,16,1495,762,733
050,44,009,"Rhode Island","Washington County",2,17,1516,764,752
050,44,009,"Rhode Island","Washington County",2,18,3067,1399,1668
050,44,009,"Rhode Island","Washington County",2,19,3601,1616,1985
050,44,009,"Rhode Island","Washington County",2,20,3248,1554,1694
050,44,009,"Rhode Island","Washington County",2,21,3018,1582,1436
050,44,009,"Rhode Island","Washington County",2,22,2305,1174,1131
050,44,009,"Rhode Island","Washington County",2,23,1861,949,912
050,44,009,"Rhode Island","Washington County",2,24,1603,823,780
050,44,009,"Rhode Island","Washington County",2,25,1431,750,681
050,44,009,"Rhode Island","Washington County",2,26,1405,740,665
050,44,009,"Rhode Island","Washington County",2,27,1301,688,613
050,44,009,"Rhode Island","Washington County",2,28,1226,644,582
050,44,009,"Rhode Island","Washington County",2,29,1218,627,591
050,44,009,"Rhode Island","Washington County",2,30,1245,620,625
050,44,009,"Rhode Island","Washington County",2,31,1210,589,621
050,44,009,"Rhode Island","Washington County",2,32,1226,619,607
050,44,009,"Rhode Island","Washington County",2,33,1216,623,593
050,44,009,"Rhode Island","Washington County",2,34,1205,603,602
050,44,009,"Rhode Island","Washington County",2,35,1221,613,608
050,44,009,"Rhode Island","Washington County",2,36,1208,602,606
050,44,009,"Rhode Island","Washington County",2,37,1256,640,616
050,44,009,"Rhode Island","Washington County",2,38,1305,660,645
050,44,009,"Rhode Island","Washington County",2,39,1330,680,650
050,44,009,"Rhode Island","Washington County",2,40,1322,655,667
050,44,009,"Rhode Island","Washington County",2,41,1292,624,668
050,44,009,"Rhode Island","Washington County",2,42,1251,610,641
050,44,009,"Rhode Island","Washington County",2,43,1257,633,624
050,44,009,"Rhode Island","Washington County",2,44,1227,623,604
050,44,009,"Rhode Island","Washington County",2,45,1238,608,630
050,44,009,"Rhode Island","Washington County",2,46,1220,591,629
050,44,009,"Rhode Island","Washington County",2,47,1280,624,656
050,44,009,"Rhode Island","Washington County",2,48,1435,690,745
050,44,009,"Rhode Island","Washington County",2,49,1603,781,822
050,44,009,"Rhode Island","Washington County",2,50,1660,783,877
050,44,009,"Rhode Island","Washington County",2,51,1685,804,881
050,44,009,"Rhode Island","Washington County",2,52,1733,833,900
050,44,009,"Rhode Island","Washington County",2,53,1785,863,922
050,44,009,"Rhode Island","Washington County",2,54,1829,877,952
050,44,009,"Rhode Island","Washington County",2,55,1997,953,1044
050,44,009,"Rhode Island","Washington County",2,56,2115,1025,1090
050,44,009,"Rhode Island","Washington County",2,57,2140,1041,1099
050,44,009,"Rhode Island","Washington County",2,58,2209,1064,1145
050,44,009,"Rhode Island","Washington County",2,59,2197,1037,1160
050,44,009,"Rhode Island","Washington County",2,60,2123,1019,1104
050,44,009,"Rhode Island","Washington County",2,61,2108,1023,1085
050,44,009,"Rhode Island","Washington County",2,62,2168,1044,1124
050,44,009,"Rhode Island","Washington County",2,63,2159,1057,1102
050,44,009,"Rhode Island","Washington County",2,64,2036,998,1038
050,44,009,"Rhode Island","Washington County",2,65,2002,974,1028
050,44,009,"Rhode Island","Washington County",2,66,1939,927,1012
050,44,009,"Rhode Island","Washington County",2,67,1889,924,965
050,44,009,"Rhode Island","Washington County",2,68,1850,911,939
050,44,009,"Rhode Island","Washington County",2,69,1746,842,904
050,44,009,"Rhode Island","Washington County",2,70,1645,793,852
050,44,009,"Rhode Island","Washington County",2,71,1601,768,833
050,44,009,"Rhode Island","Washington County",2,72,1565,741,824
050,44,009,"Rhode Island","Washington County",2,73,1711,813,898
050,44,009,"Rhode Island","Washington County",2,74,1147,555,592
050,44,009,"Rhode Island","Washington County",2,75,1086,527,559
050,44,009,"Rhode Island","Washington County",2,76,1070,513,557
050,44,009,"Rhode Island","Washington County",2,77,1125,531,594
050,44,009,"Rhode Island","Washington County",2,78,916,426,490
050,44,009,"Rhode Island","Washington County",2,79,773,347,426
050,44,009,"Rhode Island","Washington County",2,80,678,306,372
050,44,009,"Rhode Island","Washington County",2,81,594,254,340
050,44,009,"Rhode Island","Washington County",2,82,555,227,328
050,44,009,"Rhode Island","Washington County",2,83,517,223,294
050,44,009,"Rhode Island","Washington County",2,84,493,208,285
050,44,009,"Rhode Island","Washington County",2,85,3243,1101,2142
050,44,009,"Rhode Island","Washington County",3,0,811,388,423
050,44,009,"Rhode Island","Washington County",3,1,912,458,454
050,44,009,"Rhode Island","Washington County",3,2,949,480,469
050,44,009,"Rhode Island","Washington County",3,3,954,501,453
050,44,009,"Rhode Island","Washington County",3,4,1054,552,502
050,44,009,"Rhode Island","Washington County",3,5,1040,536,504
050,44,009,"Rhode Island","Washington County",3,6,997,519,478
050,44,009,"Rhode Island","Washington County",3,7,1055,550,505
050,44,009,"Rhode Island","Washington County",3,8,1076,532,544
050,44,009,"Rhode Island","Washington County",3,9,1109,550,559
050,44,009,"Rhode Island","Washington County",3,10,1114,575,539
050,44,009,"Rhode Island","Washington County",3,11,1175,609,566
050,44,009,"Rhode Island","Washington County",3,12,1247,652,595
050,44,009,"Rhode Island","Washington County",3,13,1308,663,645
050,44,009,"Rhode Island","Washington County",3,14,1313,636,677
050,44,009,"Rhode Island","Washington County",3,15,1398,674,724
050,44,009,"Rhode Island","Washington County",3,16,1445,727,718
050,44,009,"Rhode Island","Washington County",3,17,1530,770,760
050,44,009,"Rhode Island","Washington County",3,18,3083,1410,1673
050,44,009,"Rhode Island","Washington County",3,19,3569,1602,1967
050,44,009,"Rhode Island","Washington County",3,20,3193,1511,1682
050,44,009,"Rhode Island","Washington County",3,21,2992,1587,1405
050,44,009,"Rhode Island","Washington County",3,22,2334,1180,1154
050,44,009,"Rhode Island","Washington County",3,23,1891,930,961
050,44,009,"Rhode Island","Washington County",3,24,1626,845,781
050,44,009,"Rhode Island","Washington County",3,25,1390,741,649
050,44,009,"Rhode Island","Washington County",3,26,1366,705,661
050,44,009,"Rhode Island","Washington County",3,27,1389,725,664
050,44,009,"Rhode Island","Washington County",3,28,1328,707,621
050,44,009,"Rhode Island","Washington County",3,29,1238,666,572
050,44,009,"Rhode Island","Washington County",3,30,1280,656,624
050,44,009,"Rhode Island","Washington County",3,31,1334,639,695
050,44,009,"Rhode Island","Washington County",3,32,1283,637,646
050,44,009,"Rhode Island","Washington County",3,33,1290,662,628
050,44,009,"Rhode Island","Washington County",3,34,1276,652,624
050,44,009,"Rhode Island","Washington County",3,35,1258,630,628
050,44,009,"Rhode Island","Washington County",3,36,1254,639,615
050,44,009,"Rhode Island","Washington County",3,37,1290,641,649
050,44,009,"Rhode Island","Washington County",3,38,1289,655,634
050,44,009,"Rhode Island","Washington County",3,39,1356,691,665
050,44,009,"Rhode Island","Washington County",3,40,1350,682,668
050,44,009,"Rhode Island","Washington County",3,41,1344,659,685
050,44,009,"Rhode Island","Washington County",3,42,1330,648,682
050,44,009,"Rhode Island","Washington County",3,43,1280,625,655
050,44,009,"Rhode Island","Washington County",3,44,1258,627,631
050,44,009,"Rhode Island","Washington County",3,45,1226,616,610
050,44,009,"Rhode Island","Washington County",3,46,1255,610,645
050,44,009,"Rhode Island","Washington County",3,47,1240,617,623
050,44,009,"Rhode Island","Washington County",3,48,1288,625,663
050,44,009,"Rhode Island","Washington County",3,49,1460,720,740
050,44,009,"Rhode Island","Washington County",3,50,1617,780,837
050,44,009,"Rhode Island","Washington County",3,51,1690,791,899
050,44,009,"Rhode Island","Washington County",3,52,1681,800,881
050,44,009,"Rhode Island","Washington County",3,53,1739,835,904
050,44,009,"Rhode Island","Washington County",3,54,1819,868,951
050,44,009,"Rhode Island","Washington County",3,55,1861,887,974
050,44,009,"Rhode Island","Washington County",3,56,2006,958,1048
050,44,009,"Rhode Island","Washington County",3,57,2119,1016,1103
050,44,009,"Rhode Island","Washington County",3,58,2159,1055,1104
050,44,009,"Rhode Island","Washington County",3,59,2239,1080,1159
050,44,009,"Rhode Island","Washington County",3,60,2222,1050,1172
050,44,009,"Rhode Island","Washington County",3,61,2165,1034,1131
050,44,009,"Rhode Island","Washington County",3,62,2132,1034,1098
050,44,009,"Rhode Island","Washington County",3,63,2184,1064,1120
050,44,009,"Rhode Island","Washington County",3,64,2201,1065,1136
050,44,009,"Rhode Island","Washington County",3,65,2067,1003,1064
050,44,009,"Rhode Island","Washington County",3,66,1990,955,1035
050,44,009,"Rhode Island","Washington County",3,67,1959,938,1021
050,44,009,"Rhode Island","Washington County",3,68,1896,921,975
050,44,009,"Rhode Island","Washington County",3,69,1831,896,935
050,44,009,"Rhode Island","Washington County",3,70,1741,832,909
050,44,009,"Rhode Island","Washington County",3,71,1621,781,840
050,44,009,"Rhode Island","Washington County",3,72,1584,762,822
050,44,009,"Rhode Island","Washington County",3,73,1543,740,803
050,44,009,"Rhode Island","Washington County",3,74,1658,787,871
050,44,009,"Rhode Island","Washington County",3,75,1124,545,579
050,44,009,"Rhode Island","Washington County",3,76,1057,514,543
050,44,009,"Rhode Island","Washington County",3,77,1042,486,556
050,44,009,"Rhode Island","Washington County",3,78,1074,499,575
050,44,009,"Rhode Island","Washington County",3,79,882,403,479
050,44,009,"Rhode Island","Washington County",3,80,753,342,411
050,44,009,"Rhode Island","Washington County",3,81,633,288,345
050,44,009,"Rhode Island","Washington County",3,82,559,234,325
050,44,009,"Rhode Island","Washington County",3,83,525,217,308
050,44,009,"Rhode Island","Washington County",3,84,500,203,297
050,44,009,"Rhode Island","Washington County",3,85,3151,1066,2085
050,44,009,"Rhode Island","Washington County",4,0,873,435,438
050,44,009,"Rhode Island","Washington County",4,1,839,403,436
050,44,009,"Rhode Island","Washington County",4,2,919,464,455
050,44,009,"Rhode Island","Washington County",4,3,955,494,461
050,44,009,"Rhode Island","Washington County",4,4,977,511,466
050,44,009,"Rhode Island","Washington County",4,5,1044,552,492
050,44,009,"Rhode Island","Washington County",4,6,1064,546,518
050,44,009,"Rhode Island","Washington County",4,7,1011,520,491
050,44,009,"Rhode Island","Washington County",4,8,1052,537,515
050,44,009,"Rhode Island","Washington County",4,9,1060,528,532
050,44,009,"Rhode Island","Washington County",4,10,1099,549,550
050,44,009,"Rhode Island","Washington County",4,11,1103,571,532
050,44,009,"Rhode Island","Washington County",4,12,1178,622,556
050,44,009,"Rhode Island","Washington County",4,13,1230,645,585
050,44,009,"Rhode Island","Washington County",4,14,1307,651,656
050,44,009,"Rhode Island","Washington County",4,15,1322,644,678
050,44,009,"Rhode Island","Washington County",4,16,1436,704,732
050,44,009,"Rhode Island","Washington County",4,17,1437,726,711
050,44,009,"Rhode Island","Washington County",4,18,3025,1382,1643
050,44,009,"Rhode Island","Washington County",4,19,3520,1569,1951
050,44,009,"Rhode Island","Washington County",4,20,3101,1475,1626
050,44,009,"Rhode Island","Washington County",4,21,2941,1537,1404
050,44,009,"Rhode Island","Washington County",4,22,2320,1196,1124
050,44,009,"Rhode Island","Washington County",4,23,1923,960,963
050,44,009,"Rhode Island","Washington County",4,24,1608,803,805
050,44,009,"Rhode Island","Washington County",4,25,1370,736,634
050,44,009,"Rhode Island","Washington County",4,26,1281,690,591
050,44,009,"Rhode Island","Washington County",4,27,1295,678,617
050,44,009,"Rhode Island","Washington County",4,28,1327,686,641
050,44,009,"Rhode Island","Washington County",4,29,1301,684,617
050,44,009,"Rhode Island","Washington County",4,30,1215,659,556
050,44,009,"Rhode Island","Washington County",4,31,1273,654,619
050,44,009,"Rhode Island","Washington County",4,32,1361,673,688
050,44,009,"Rhode Island","Washington County",4,33,1273,633,640
050,44,009,"Rhode Island","Washington County",4,34,1304,669,635
050,44,009,"Rhode Island","Washington County",4,35,1317,677,640
050,44,009,"Rhode Island","Washington County",4,36,1255,628,627
050,44,009,"Rhode Island","Washington County",4,37,1310,681,629
050,44,009,"Rhode Island","Washington County",4,38,1257,611,646
050,44,009,"Rhode Island","Washington County",4,39,1288,668,620
050,44,009,"Rhode Island","Washington County",4,40,1382,724,658
050,44,009,"Rhode Island","Washington County",4,41,1361,690,671
050,44,009,"Rhode Island","Washington County",4,42,1357,659,698
050,44,009,"Rhode Island","Washington County",4,43,1307,622,685
050,44,009,"Rhode Island","Washington County",4,44,1309,634,675
050,44,009,"Rhode Island","Washington County",4,45,1269,626,643
050,44,009,"Rhode Island","Washington County",4,46,1214,610,604
050,44,009,"Rhode Island","Washington County",4,47,1237,603,634
050,44,009,"Rhode Island","Washington County",4,48,1253,617,636
050,44,009,"Rhode Island","Washington County",4,49,1285,630,655
050,44,009,"Rhode Island","Washington County",4,50,1442,714,728
050,44,009,"Rhode Island","Washington County",4,51,1620,773,847
050,44,009,"Rhode Island","Washington County",4,52,1651,777,874
050,44,009,"Rhode Island","Washington County",4,53,1698,813,885
050,44,009,"Rhode Island","Washington County",4,54,1760,842,918
050,44,009,"Rhode Island","Washington County",4,55,1829,874,955
050,44,009,"Rhode Island","Washington County",4,56,1879,900,979
050,44,009,"Rhode Island","Washington County",4,57,2000,953,1047
050,44,009,"Rhode Island","Washington County",4,58,2129,1021,1108
050,44,009,"Rhode Island","Washington County",4,59,2140,1040,1100
050,44,009,"Rhode Island","Washington County",4,60,2263,1105,1158
050,44,009,"Rhode Island","Washington County",4,61,2212,1044,1168
050,44,009,"Rhode Island","Washington County",4,62,2160,1034,1126
050,44,009,"Rhode Island","Washington County",4,63,2121,1023,1098
050,44,009,"Rhode Island","Washington County",4,64,2185,1043,1142
050,44,009,"Rhode Island","Washington County",4,65,2190,1057,1133
050,44,009,"Rhode Island","Washington County",4,66,2028,981,1047
050,44,009,"Rhode Island","Washington County",4,67,1997,957,1040
050,44,009,"Rhode Island","Washington County",4,68,1945,922,1023
050,44,009,"Rhode Island","Washington County",4,69,1877,907,970
050,44,009,"Rhode Island","Washington County",4,70,1803,883,920
050,44,009,"Rhode Island","Washington County",4,71,1726,824,902
050,44,009,"Rhode Island","Washington County",4,72,1620,785,835
050,44,009,"Rhode Island","Washington County",4,73,1579,751,828
050,44,009,"Rhode Island","Washington County",4,74,1505,712,793
050,44,009,"Rhode Island","Washington County",4,75,1624,765,859
050,44,009,"Rhode Island","Washington County",4,76,1096,533,563
050,44,009,"Rhode Island","Washington County",4,77,1035,500,535
050,44,009,"Rhode Island","Washington County",4,78,1012,464,548
050,44,009,"Rhode Island","Washington County",4,79,1045,493,552
050,44,009,"Rhode Island","Washington County",4,80,852,389,463
050,44,009,"Rhode Island","Washington County",4,81,718,335,383
050,44,009,"Rhode Island","Washington County",4,82,597,267,330
050,44,009,"Rhode Island","Washington County",4,83,516,215,301
050,44,009,"Rhode Island","Washington County",4,84,517,205,312
050,44,009,"Rhode Island","Washington County",4,85,3140,1083,2057
050,44,009,"Rhode Island","Washington County",5,0,824,411,413
050,44,009,"Rhode Island","Washington County",5,1,892,451,441
050,44,009,"Rhode Island","Washington County",5,2,877,403,474
050,44,009,"Rhode Island","Washington County",5,3,942,473,469
050,44,009,"Rhode Island","Washington County",5,4,967,501,466
050,44,009,"Rhode Island","Washington County",5,5,973,519,454
050,44,009,"Rhode Island","Washington County",5,6,1068,558,510
050,44,009,"Rhode Island","Washington County",5,7,1075,553,522
050,44,009,"Rhode Island","Washington County",5,8,1020,514,506
050,44,009,"Rhode Island","Washington County",5,9,1048,539,509
050,44,009,"Rhode Island","Washington County",5,10,1084,534,550
050,44,009,"Rhode Island","Washington County",5,11,1105,555,550
050,44,009,"Rhode Island","Washington County",5,12,1115,570,545
050,44,009,"Rhode Island","Washington County",5,13,1169,612,557
050,44,009,"Rhode Island","Washington County",5,14,1227,642,585
050,44,009,"Rhode Island","Washington County",5,15,1313,654,659
050,44,009,"Rhode Island","Washington County",5,16,1359,669,690
050,44,009,"Rhode Island","Washington County",5,17,1445,699,746
050,44,009,"Rhode Island","Washington County",5,18,2961,1352,1609
050,44,009,"Rhode Island","Washington County",5,19,3510,1571,1939
050,44,009,"Rhode Island","Washington County",5,20,3097,1472,1625
050,44,009,"Rhode Island","Washington County",5,21,2866,1517,1349
050,44,009,"Rhode Island","Washington County",5,22,2255,1134,1121
050,44,009,"Rhode Island","Washington County",5,23,1893,959,934
050,44,009,"Rhode Island","Washington County",5,24,1624,797,827
050,44,009,"Rhode Island","Washington County",5,25,1389,710,679
050,44,009,"Rhode Island","Washington County",5,26,1269,690,579
050,44,009,"Rhode Island","Washington County",5,27,1228,647,581
050,44,009,"Rhode Island","Washington County",5,28,1283,660,623
050,44,009,"Rhode Island","Washington County",5,29,1323,688,635
050,44,009,"Rhode Island","Washington County",5,30,1299,676,623
050,44,009,"Rhode Island","Washington County",5,31,1229,657,572
050,44,009,"Rhode Island","Washington County",5,32,1323,680,643
050,44,009,"Rhode Island","Washington County",5,33,1358,669,689
050,44,009,"Rhode Island","Washington County",5,34,1287,635,652
050,44,009,"Rhode Island","Washington County",5,35,1302,664,638
050,44,009,"Rhode Island","Washington County",5,36,1332,689,643
050,44,009,"Rhode Island","Washington County",5,37,1269,633,636
050,44,009,"Rhode Island","Washington County",5,38,1344,694,650
050,44,009,"Rhode Island","Washington County",5,39,1285,634,651
050,44,009,"Rhode Island","Washington County",5,40,1296,672,624
050,44,009,"Rhode Island","Washington County",5,41,1387,726,661
050,44,009,"Rhode Island","Washington County",5,42,1368,695,673
050,44,009,"Rhode Island","Washington County",5,43,1362,671,691
050,44,009,"Rhode Island","Washington County",5,44,1311,616,695
050,44,009,"Rhode Island","Washington County",5,45,1291,616,675
050,44,009,"Rhode Island","Washington County",5,46,1281,627,654
050,44,009,"Rhode Island","Washington County",5,47,1206,612,594
050,44,009,"Rhode Island","Washington County",5,48,1231,597,634
050,44,009,"Rhode Island","Washington County",5,49,1255,624,631
050,44,009,"Rhode Island","Washington County",5,50,1274,613,661
050,44,009,"Rhode Island","Washington County",5,51,1442,721,721
050,44,009,"Rhode Island","Washington County",5,52,1619,767,852
050,44,009,"Rhode Island","Washington County",5,53,1659,793,866
050,44,009,"Rhode Island","Washington County",5,54,1678,809,869
050,44,009,"Rhode Island","Washington County",5,55,1758,838,920
050,44,009,"Rhode Island","Washington County",5,56,1857,889,968
050,44,009,"Rhode Island","Washington County",5,57,1869,890,979
050,44,009,"Rhode Island","Washington County",5,58,1996,960,1036
050,44,009,"Rhode Island","Washington County",5,59,2128,1022,1106
050,44,009,"Rhode Island","Washington County",5,60,2127,1038,1089
050,44,009,"Rhode Island","Washington County",5,61,2242,1085,1157
050,44,009,"Rhode Island","Washington County",5,62,2246,1063,1183
050,44,009,"Rhode Island","Washington County",5,63,2167,1039,1128
050,44,009,"Rhode Island","Washington County",5,64,2153,1036,1117
050,44,009,"Rhode Island","Washington County",5,65,2177,1048,1129
050,44,009,"Rhode Island","Washington County",5,66,2192,1050,1142
050,44,009,"Rhode Island","Washington County",5,67,2019,964,1055
050,44,009,"Rhode Island","Washington County",5,68,1975,951,1024
050,44,009,"Rhode Island","Washington County",5,69,1916,901,1015
050,44,009,"Rhode Island","Washington County",5,70,1878,907,971
050,44,009,"Rhode Island","Washington County",5,71,1784,868,916
050,44,009,"Rhode Island","Washington County",5,72,1705,816,889
050,44,009,"Rhode Island","Washington County",5,73,1605,772,833
050,44,009,"Rhode Island","Washington County",5,74,1542,722,820
050,44,009,"Rhode Island","Washington County",5,75,1472,693,779
050,44,009,"Rhode Island","Washington County",5,76,1579,742,837
050,44,009,"Rhode Island","Washington County",5,77,1065,516,549
050,44,009,"Rhode Island","Washington County",5,78,998,470,528
050,44,009,"Rhode Island","Washington County",5,79,966,447,519
050,44,009,"Rhode Island","Washington County",5,80,995,471,524
050,44,009,"Rhode Island","Washington County",5,81,810,382,428
050,44,009,"Rhode Island","Washington County",5,82,681,309,372
050,44,009,"Rhode Island","Washington County",5,83,552,252,300
050,44,009,"Rhode Island","Washington County",5,84,499,200,299
050,44,009,"Rhode Island","Washington County",5,85,3140,1111,2029

