"SUMLEV","STATE","COUNTY","STNAME","CTYNAME","YEAR","AGE","TOT_POP","TOT_MALE","TOT_FEMALE"
050,39,001,"Ohio","Adams County",1,0,336,172,164
050,39,001,"Ohio","Adams County",1,1,343,174,169
050,39,001,"Ohio","Adams County",1,2,353,182,171
050,39,001,"Ohio","Adams County",1,3,337,179,158
050,39,001,"Ohio","Adams County",1,4,348,169,179
050,39,001,"Ohio","Adams County",1,5,327,166,161
050,39,001,"Ohio","Adams County",1,6,345,186,159
050,39,001,"Ohio","Adams County",1,7,360,195,165
050,39,001,"Ohio","Adams County",1,8,340,173,167
050,39,001,"Ohio","Adams County",1,9,364,193,171
050,39,001,"Ohio","Adams County",1,10,377,193,184
050,39,001,"Ohio","Adams County",1,11,395,209,186
050,39,001,"Ohio","Adams County",1,12,406,202,204
050,39,001,"Ohio","Adams County",1,13,419,215,204
050,39,001,"Ohio","Adams County",1,14,423,226,197
050,39,001,"Ohio","Adams County",1,15,382,201,181
050,39,001,"Ohio","Adams County",1,16,424,219,205
050,39,001,"Ohio","Adams County",1,17,406,210,196
050,39,001,"Ohio","Adams County",1,18,325,175,150
050,39,001,"Ohio","Adams County",1,19,261,131,130
050,39,001,"Ohio","Adams County",1,20,274,134,140
050,39,001,"Ohio","Adams County",1,21,281,142,139
050,39,001,"Ohio","Adams County",1,22,286,137,149
050,39,001,"Ohio","Adams County",1,23,279,144,135
050,39,001,"Ohio","Adams County",1,24,275,134,141
050,39,001,"Ohio","Adams County",1,25,295,145,150
050,39,001,"Ohio","Adams County",1,26,301,146,155
050,39,001,"Ohio","Adams County",1,27,314,151,163
050,39,001,"Ohio","Adams County",1,28,330,159,171
050,39,001,"Ohio","Adams County",1,29,308,157,151
050,39,001,"Ohio","Adams County",1,30,312,149,163
050,39,001,"Ohio","Adams County",1,31,313,147,166
050,39,001,"Ohio","Adams County",1,32,296,139,157
050,39,001,"Ohio","Adams County",1,33,285,141,144
050,39,001,"Ohio","Adams County",1,34,288,140,148
050,39,001,"Ohio","Adams County",1,35,253,124,129
050,39,001,"Ohio","Adams County",1,36,275,136,139
050,39,001,"Ohio","Adams County",1,37,285,135,150
050,39,001,"Ohio","Adams County",1,38,290,134,156
050,39,001,"Ohio","Adams County",1,39,322,150,172
050,39,001,"Ohio","Adams County",1,40,303,150,153
050,39,001,"Ohio","Adams County",1,41,335,169,166
050,39,001,"Ohio","Adams County",1,42,342,181,161
050,39,001,"Ohio","Adams County",1,43,356,180,176
050,39,001,"Ohio","Adams County",1,44,327,149,178
050,39,001,"Ohio","Adams County",1,45,333,158,175
050,39,001,"Ohio","Adams County",1,46,350,174,176
050,39,001,"Ohio","Adams County",1,47,352,184,168
050,39,001,"Ohio","Adams County",1,48,384,200,184
050,39,001,"Ohio","Adams County",1,49,406,199,207
050,39,001,"Ohio","Adams County",1,50,377,187,190
050,39,001,"Ohio","Adams County",1,51,384,199,185
050,39,001,"Ohio","Adams County",1,52,349,180,169
050,39,001,"Ohio","Adams County",1,53,364,192,172
050,39,001,"Ohio","Adams County",1,54,355,173,182
050,39,001,"Ohio","Adams County",1,55,378,186,192
050,39,001,"Ohio","Adams County",1,56,384,184,200
050,39,001,"Ohio","Adams County",1,57,420,198,222
050,39,001,"Ohio","Adams County",1,58,414,214,200
050,39,001,"Ohio","Adams County",1,59,396,205,191
050,39,001,"Ohio","Adams County",1,60,404,212,192
050,39,001,"Ohio","Adams County",1,61,429,218,211
050,39,001,"Ohio","Adams County",1,62,398,189,209
050,39,001,"Ohio","Adams County",1,63,395,193,202
050,39,001,"Ohio","Adams County",1,64,394,203,191
050,39,001,"Ohio","Adams County",1,65,387,200,187
050,39,001,"Ohio","Adams County",1,66,360,183,177
050,39,001,"Ohio","Adams County",1,67,341,173,168
050,39,001,"Ohio","Adams County",1,68,347,170,177
050,39,001,"Ohio","Adams County",1,69,296,155,141
050,39,001,"Ohio","Adams County",1,70,288,146,142
050,39,001,"Ohio","Adams County",1,71,298,144,154
050,39,001,"Ohio","Adams County",1,72,270,143,127
050,39,001,"Ohio","Adams County",1,73,277,149,128
050,39,001,"Ohio","Adams County",1,74,189,99,90
050,39,001,"Ohio","Adams County",1,75,192,96,96
050,39,001,"Ohio","Adams County",1,76,185,80,105
050,39,001,"Ohio","Adams County",1,77,196,87,109
050,39,001,"Ohio","Adams County",1,78,169,74,95
050,39,001,"Ohio","Adams County",1,79,172,89,83
050,39,001,"Ohio","Adams County",1,80,144,63,81
050,39,001,"Ohio","Adams County",1,81,121,51,70
050,39,001,"Ohio","Adams County",1,82,109,50,59
050,39,001,"Ohio","Adams County",1,83,105,41,64
050,39,001,"Ohio","Adams County",1,84,110,48,62
050,39,001,"Ohio","Adams County",1,85,453,167,286
050,39,001,"Ohio","Adams County",2,0,325,171,154
050,39,001,"Ohio","Adams County",2,1,341,172,169
050,39,001,"Ohio","Adams County",2,2,351,179,172
050,39,001,"Ohio","Adams County",2,3,340,178,162
050,39,001,"Ohio","Adams County",2,4,351,175,176
050,39,001,"Ohio","Adams County",2,5,334,168,166
050,39,001,"Ohio","Adams County",2,6,343,184,159
050,39,001,"Ohio","Adams County",2,7,356,191,165
050,39,001,"Ohio","Adams County",2,8,344,177,167
050,39,001,"Ohio","Adams County",2,9,355,187,168
050,39,001,"Ohio","Adams County",2,10,372,192,180
050,39,001,"Ohio","Adams County",2,11,390,204,186
050,39,001,"Ohio","Adams County",2,12,407,205,202
050,39,001,"Ohio","Adams County",2,13,418,213,205
050,39,001,"Ohio","Adams County",2,14,422,221,201
050,39,001,"Ohio","Adams County",2,15,394,208,186
050,39,001,"Ohio","Adams County",2,16,413,215,198
050,39,001,"Ohio","Adams County",2,17,408,212,196
050,39,001,"Ohio","Adams County",2,18,325,176,149
050,39,001,"Ohio","Adams County",2,19,257,131,126
050,39,001,"Ohio","Adams County",2,20,277,137,140
050,39,001,"Ohio","Adams County",2,21,282,141,141
050,39,001,"Ohio","Adams County",2,22,285,139,146
050,39,001,"Ohio","Adams County",2,23,282,143,139
050,39,001,"Ohio","Adams County",2,24,281,140,141
050,39,001,"Ohio","Adams County",2,25,291,142,149
050,39,001,"Ohio","Adams County",2,26,301,146,155
050,39,001,"Ohio","Adams County",2,27,310,149,161
050,39,001,"Ohio","Adams County",2,28,324,157,167
050,39,001,"Ohio","Adams County",2,29,313,158,155
050,39,001,"Ohio","Adams County",2,30,315,154,161
050,39,001,"Ohio","Adams County",2,31,310,146,164
050,39,001,"Ohio","Adams County",2,32,298,139,159
050,39,001,"Ohio","Adams County",2,33,290,142,148
050,39,001,"Ohio","Adams County",2,34,288,140,148
050,39,001,"Ohio","Adams County",2,35,264,129,135
050,39,001,"Ohio","Adams County",2,36,268,133,135
050,39,001,"Ohio","Adams County",2,37,281,134,147
050,39,001,"Ohio","Adams County",2,38,290,135,155
050,39,001,"Ohio","Adams County",2,39,313,145,168
050,39,001,"Ohio","Adams County",2,40,308,150,158
050,39,001,"Ohio","Adams County",2,41,326,164,162
050,39,001,"Ohio","Adams County",2,42,338,178,160
050,39,001,"Ohio","Adams County",2,43,353,181,172
050,39,001,"Ohio","Adams County",2,44,328,153,175
050,39,001,"Ohio","Adams County",2,45,332,156,176
050,39,001,"Ohio","Adams County",2,46,345,170,175
050,39,001,"Ohio","Adams County",2,47,349,181,168
050,39,001,"Ohio","Adams County",2,48,378,197,181
050,39,001,"Ohio","Adams County",2,49,405,202,203
050,39,001,"Ohio","Adams County",2,50,385,189,196
050,39,001,"Ohio","Adams County",2,51,379,196,183
050,39,001,"Ohio","Adams County",2,52,353,182,171
050,39,001,"Ohio","Adams County",2,53,362,190,172
050,39,001,"Ohio","Adams County",2,54,358,179,179
050,39,001,"Ohio","Adams County",2,55,372,183,189
050,39,001,"Ohio","Adams County",2,56,384,186,198
050,39,001,"Ohio","Adams County",2,57,413,196,217
050,39,001,"Ohio","Adams County",2,58,418,211,207
050,39,001,"Ohio","Adams County",2,59,401,207,194
050,39,001,"Ohio","Adams County",2,60,402,210,192
050,39,001,"Ohio","Adams County",2,61,420,215,205
050,39,001,"Ohio","Adams County",2,62,407,197,210
050,39,001,"Ohio","Adams County",2,63,396,193,203
050,39,001,"Ohio","Adams County",2,64,393,200,193
050,39,001,"Ohio","Adams County",2,65,386,199,187
050,39,001,"Ohio","Adams County",2,66,365,186,179
050,39,001,"Ohio","Adams County",2,67,343,173,170
050,39,001,"Ohio","Adams County",2,68,341,169,172
050,39,001,"Ohio","Adams County",2,69,307,157,150
050,39,001,"Ohio","Adams County",2,70,287,148,139
050,39,001,"Ohio","Adams County",2,71,296,144,152
050,39,001,"Ohio","Adams County",2,72,273,142,131
050,39,001,"Ohio","Adams County",2,73,288,154,134
050,39,001,"Ohio","Adams County",2,74,193,103,90
050,39,001,"Ohio","Adams County",2,75,189,95,94
050,39,001,"Ohio","Adams County",2,76,182,83,99
050,39,001,"Ohio","Adams County",2,77,195,85,110
050,39,001,"Ohio","Adams County",2,78,168,74,94
050,39,001,"Ohio","Adams County",2,79,166,84,82
050,39,001,"Ohio","Adams County",2,80,150,69,81
050,39,001,"Ohio","Adams County",2,81,124,53,71
050,39,001,"Ohio","Adams County",2,82,111,49,62
050,39,001,"Ohio","Adams County",2,83,102,43,59
050,39,001,"Ohio","Adams County",2,84,106,45,61
050,39,001,"Ohio","Adams County",2,85,454,169,285
050,39,001,"Ohio","Adams County",3,0,356,168,188
050,39,001,"Ohio","Adams County",3,1,332,172,160
050,39,001,"Ohio","Adams County",3,2,332,167,165
050,39,001,"Ohio","Adams County",3,3,362,186,176
050,39,001,"Ohio","Adams County",3,4,344,178,166
050,39,001,"Ohio","Adams County",3,5,343,173,170
050,39,001,"Ohio","Adams County",3,6,332,161,171
050,39,001,"Ohio","Adams County",3,7,345,189,156
050,39,001,"Ohio","Adams County",3,8,356,189,167
050,39,001,"Ohio","Adams County",3,9,364,187,177
050,39,001,"Ohio","Adams County",3,10,360,189,171
050,39,001,"Ohio","Adams County",3,11,392,199,193
050,39,001,"Ohio","Adams County",3,12,394,198,196
050,39,001,"Ohio","Adams County",3,13,427,219,208
050,39,001,"Ohio","Adams County",3,14,437,226,211
050,39,001,"Ohio","Adams County",3,15,420,218,202
050,39,001,"Ohio","Adams County",3,16,403,219,184
050,39,001,"Ohio","Adams County",3,17,407,212,195
050,39,001,"Ohio","Adams County",3,18,351,184,167
050,39,001,"Ohio","Adams County",3,19,259,137,122
050,39,001,"Ohio","Adams County",3,20,286,145,141
050,39,001,"Ohio","Adams County",3,21,305,149,156
050,39,001,"Ohio","Adams County",3,22,290,136,154
050,39,001,"Ohio","Adams County",3,23,300,146,154
050,39,001,"Ohio","Adams County",3,24,289,146,143
050,39,001,"Ohio","Adams County",3,25,272,141,131
050,39,001,"Ohio","Adams County",3,26,290,138,152
050,39,001,"Ohio","Adams County",3,27,299,148,151
050,39,001,"Ohio","Adams County",3,28,325,156,169
050,39,001,"Ohio","Adams County",3,29,328,158,170
050,39,001,"Ohio","Adams County",3,30,316,162,154
050,39,001,"Ohio","Adams County",3,31,325,166,159
050,39,001,"Ohio","Adams County",3,32,304,144,160
050,39,001,"Ohio","Adams County",3,33,300,135,165
050,39,001,"Ohio","Adams County",3,34,284,139,145
050,39,001,"Ohio","Adams County",3,35,299,150,149
050,39,001,"Ohio","Adams County",3,36,267,129,138
050,39,001,"Ohio","Adams County",3,37,260,126,134
050,39,001,"Ohio","Adams County",3,38,286,137,149
050,39,001,"Ohio","Adams County",3,39,301,135,166
050,39,001,"Ohio","Adams County",3,40,315,139,176
050,39,001,"Ohio","Adams County",3,41,315,151,164
050,39,001,"Ohio","Adams County",3,42,334,173,161
050,39,001,"Ohio","Adams County",3,43,348,183,165
050,39,001,"Ohio","Adams County",3,44,363,180,183
050,39,001,"Ohio","Adams County",3,45,324,147,177
050,39,001,"Ohio","Adams County",3,46,326,156,170
050,39,001,"Ohio","Adams County",3,47,346,166,180
050,39,001,"Ohio","Adams County",3,48,353,179,174
050,39,001,"Ohio","Adams County",3,49,387,203,184
050,39,001,"Ohio","Adams County",3,50,408,205,203
050,39,001,"Ohio","Adams County",3,51,395,194,201
050,39,001,"Ohio","Adams County",3,52,367,187,180
050,39,001,"Ohio","Adams County",3,53,355,179,176
050,39,001,"Ohio","Adams County",3,54,368,194,174
050,39,001,"Ohio","Adams County",3,55,362,185,177
050,39,001,"Ohio","Adams County",3,56,364,182,182
050,39,001,"Ohio","Adams County",3,57,389,194,195
050,39,001,"Ohio","Adams County",3,58,405,196,209
050,39,001,"Ohio","Adams County",3,59,404,201,203
050,39,001,"Ohio","Adams County",3,60,393,201,192
050,39,001,"Ohio","Adams County",3,61,391,207,184
050,39,001,"Ohio","Adams County",3,62,419,210,209
050,39,001,"Ohio","Adams County",3,63,401,196,205
050,39,001,"Ohio","Adams County",3,64,388,191,197
050,39,001,"Ohio","Adams County",3,65,378,189,189
050,39,001,"Ohio","Adams County",3,66,385,198,187
050,39,001,"Ohio","Adams County",3,67,362,185,177
050,39,001,"Ohio","Adams County",3,68,331,163,168
050,39,001,"Ohio","Adams County",3,69,329,160,169
050,39,001,"Ohio","Adams County",3,70,307,160,147
050,39,001,"Ohio","Adams County",3,71,273,142,131
050,39,001,"Ohio","Adams County",3,72,297,145,152
050,39,001,"Ohio","Adams County",3,73,259,134,125
050,39,001,"Ohio","Adams County",3,74,281,154,127
050,39,001,"Ohio","Adams County",3,75,184,97,87
050,39,001,"Ohio","Adams County",3,76,179,91,88
050,39,001,"Ohio","Adams County",3,77,170,74,96
050,39,001,"Ohio","Adams County",3,78,183,80,103
050,39,001,"Ohio","Adams County",3,79,151,64,87
050,39,001,"Ohio","Adams County",3,80,152,72,80
050,39,001,"Ohio","Adams County",3,81,141,63,78
050,39,001,"Ohio","Adams County",3,82,106,44,62
050,39,001,"Ohio","Adams County",3,83,98,37,61
050,39,001,"Ohio","Adams County",3,84,95,38,57
050,39,001,"Ohio","Adams County",3,85,451,173,278
050,39,001,"Ohio","Adams County",4,0,298,147,151
050,39,001,"Ohio","Adams County",4,1,356,170,186
050,39,001,"Ohio","Adams County",4,2,342,169,173
050,39,001,"Ohio","Adams County",4,3,342,172,170
050,39,001,"Ohio","Adams County",4,4,365,188,177
050,39,001,"Ohio","Adams County",4,5,358,186,172
050,39,001,"Ohio","Adams County",4,6,348,172,176
050,39,001,"Ohio","Adams County",4,7,343,174,169
050,39,001,"Ohio","Adams County",4,8,340,184,156
050,39,001,"Ohio","Adams County",4,9,356,188,168
050,39,001,"Ohio","Adams County",4,10,357,181,176
050,39,001,"Ohio","Adams County",4,11,356,187,169
050,39,001,"Ohio","Adams County",4,12,385,193,192
050,39,001,"Ohio","Adams County",4,13,394,210,184
050,39,001,"Ohio","Adams County",4,14,438,226,212
050,39,001,"Ohio","Adams County",4,15,436,227,209
050,39,001,"Ohio","Adams County",4,16,427,215,212
050,39,001,"Ohio","Adams County",4,17,393,217,176
050,39,001,"Ohio","Adams County",4,18,350,189,161
050,39,001,"Ohio","Adams County",4,19,257,135,122
050,39,001,"Ohio","Adams County",4,20,258,136,122
050,39,001,"Ohio","Adams County",4,21,304,153,151
050,39,001,"Ohio","Adams County",4,22,314,152,162
050,39,001,"Ohio","Adams County",4,23,315,148,167
050,39,001,"Ohio","Adams County",4,24,301,153,148
050,39,001,"Ohio","Adams County",4,25,287,146,141
050,39,001,"Ohio","Adams County",4,26,284,144,140
050,39,001,"Ohio","Adams County",4,27,310,148,162
050,39,001,"Ohio","Adams County",4,28,312,158,154
050,39,001,"Ohio","Adams County",4,29,326,161,165
050,39,001,"Ohio","Adams County",4,30,344,171,173
050,39,001,"Ohio","Adams County",4,31,312,154,158
050,39,001,"Ohio","Adams County",4,32,327,168,159
050,39,001,"Ohio","Adams County",4,33,305,141,164
050,39,001,"Ohio","Adams County",4,34,304,144,160
050,39,001,"Ohio","Adams County",4,35,286,139,147
050,39,001,"Ohio","Adams County",4,36,302,144,158
050,39,001,"Ohio","Adams County",4,37,255,117,138
050,39,001,"Ohio","Adams County",4,38,264,130,134
050,39,001,"Ohio","Adams County",4,39,289,137,152
050,39,001,"Ohio","Adams County",4,40,293,131,162
050,39,001,"Ohio","Adams County",4,41,309,139,170
050,39,001,"Ohio","Adams County",4,42,319,156,163
050,39,001,"Ohio","Adams County",4,43,327,169,158
050,39,001,"Ohio","Adams County",4,44,350,182,168
050,39,001,"Ohio","Adams County",4,45,348,177,171
050,39,001,"Ohio","Adams County",4,46,327,152,175
050,39,001,"Ohio","Adams County",4,47,330,161,169
050,39,001,"Ohio","Adams County",4,48,345,168,177
050,39,001,"Ohio","Adams County",4,49,360,188,172
050,39,001,"Ohio","Adams County",4,50,388,204,184
050,39,001,"Ohio","Adams County",4,51,418,212,206
050,39,001,"Ohio","Adams County",4,52,393,197,196
050,39,001,"Ohio","Adams County",4,53,364,187,177
050,39,001,"Ohio","Adams County",4,54,359,181,178
050,39,001,"Ohio","Adams County",4,55,370,196,174
050,39,001,"Ohio","Adams County",4,56,366,187,179
050,39,001,"Ohio","Adams County",4,57,357,177,180
050,39,001,"Ohio","Adams County",4,58,388,192,196
050,39,001,"Ohio","Adams County",4,59,388,190,198
050,39,001,"Ohio","Adams County",4,60,398,192,206
050,39,001,"Ohio","Adams County",4,61,391,197,194
050,39,001,"Ohio","Adams County",4,62,393,205,188
050,39,001,"Ohio","Adams County",4,63,399,203,196
050,39,001,"Ohio","Adams County",4,64,395,188,207
050,39,001,"Ohio","Adams County",4,65,384,188,196
050,39,001,"Ohio","Adams County",4,66,371,181,190
050,39,001,"Ohio","Adams County",4,67,381,194,187
050,39,001,"Ohio","Adams County",4,68,350,176,174
050,39,001,"Ohio","Adams County",4,69,317,154,163
050,39,001,"Ohio","Adams County",4,70,323,160,163
050,39,001,"Ohio","Adams County",4,71,294,154,140
050,39,001,"Ohio","Adams County",4,72,265,142,123
050,39,001,"Ohio","Adams County",4,73,284,131,153
050,39,001,"Ohio","Adams County",4,74,243,125,118
050,39,001,"Ohio","Adams County",4,75,271,149,122
050,39,001,"Ohio","Adams County",4,76,173,90,83
050,39,001,"Ohio","Adams County",4,77,170,87,83
050,39,001,"Ohio","Adams County",4,78,160,71,89
050,39,001,"Ohio","Adams County",4,79,163,69,94
050,39,001,"Ohio","Adams County",4,80,135,53,82
050,39,001,"Ohio","Adams County",4,81,139,61,78
050,39,001,"Ohio","Adams County",4,82,109,48,61
050,39,001,"Ohio","Adams County",4,83,84,33,51
050,39,001,"Ohio","Adams County",4,84,93,33,60
050,39,001,"Ohio","Adams County",4,85,435,170,265
050,39,001,"Ohio","Adams County",5,0,321,152,169
050,39,001,"Ohio","Adams County",5,1,297,144,153
050,39,001,"Ohio","Adams County",5,2,349,169,180
050,39,001,"Ohio","Adams County",5,3,337,170,167
050,39,001,"Ohio","Adams County",5,4,334,169,165
050,39,001,"Ohio","Adams County",5,5,377,195,182
050,39,001,"Ohio","Adams County",5,6,362,183,179
050,39,001,"Ohio","Adams County",5,7,366,181,185
050,39,001,"Ohio","Adams County",5,8,351,172,179
050,39,001,"Ohio","Adams County",5,9,353,188,165
050,39,001,"Ohio","Adams County",5,10,373,196,177
050,39,001,"Ohio","Adams County",5,11,360,183,177
050,39,001,"Ohio","Adams County",5,12,360,196,164
050,39,001,"Ohio","Adams County",5,13,402,210,192
050,39,001,"Ohio","Adams County",5,14,402,218,184
050,39,001,"Ohio","Adams County",5,15,442,226,216
050,39,001,"Ohio","Adams County",5,16,436,226,210
050,39,001,"Ohio","Adams County",5,17,432,219,213
050,39,001,"Ohio","Adams County",5,18,328,187,141
050,39,001,"Ohio","Adams County",5,19,256,136,120
050,39,001,"Ohio","Adams County",5,20,287,147,140
050,39,001,"Ohio","Adams County",5,21,289,147,142
050,39,001,"Ohio","Adams County",5,22,318,152,166
050,39,001,"Ohio","Adams County",5,23,329,167,162
050,39,001,"Ohio","Adams County",5,24,312,151,161
050,39,001,"Ohio","Adams County",5,25,293,150,143
050,39,001,"Ohio","Adams County",5,26,292,149,143
050,39,001,"Ohio","Adams County",5,27,277,141,136
050,39,001,"Ohio","Adams County",5,28,308,148,160
050,39,001,"Ohio","Adams County",5,29,315,156,159
050,39,001,"Ohio","Adams County",5,30,327,158,169
050,39,001,"Ohio","Adams County",5,31,351,174,177
050,39,001,"Ohio","Adams County",5,32,309,150,159
050,39,001,"Ohio","Adams County",5,33,328,165,163
050,39,001,"Ohio","Adams County",5,34,315,156,159
050,39,001,"Ohio","Adams County",5,35,311,142,169
050,39,001,"Ohio","Adams County",5,36,304,143,161
050,39,001,"Ohio","Adams County",5,37,308,148,160
050,39,001,"Ohio","Adams County",5,38,256,116,140
050,39,001,"Ohio","Adams County",5,39,268,134,134
050,39,001,"Ohio","Adams County",5,40,305,142,163
050,39,001,"Ohio","Adams County",5,41,298,135,163
050,39,001,"Ohio","Adams County",5,42,308,137,171
050,39,001,"Ohio","Adams County",5,43,315,161,154
050,39,001,"Ohio","Adams County",5,44,331,169,162
050,39,001,"Ohio","Adams County",5,45,347,184,163
050,39,001,"Ohio","Adams County",5,46,339,175,164
050,39,001,"Ohio","Adams County",5,47,335,148,187
050,39,001,"Ohio","Adams County",5,48,344,165,179
050,39,001,"Ohio","Adams County",5,49,346,168,178
050,39,001,"Ohio","Adams County",5,50,349,179,170
050,39,001,"Ohio","Adams County",5,51,390,208,182
050,39,001,"Ohio","Adams County",5,52,409,205,204
050,39,001,"Ohio","Adams County",5,53,403,203,200
050,39,001,"Ohio","Adams County",5,54,367,187,180
050,39,001,"Ohio","Adams County",5,55,355,182,173
050,39,001,"Ohio","Adams County",5,56,371,198,173
050,39,001,"Ohio","Adams County",5,57,356,182,174
050,39,001,"Ohio","Adams County",5,58,357,179,178
050,39,001,"Ohio","Adams County",5,59,388,190,198
050,39,001,"Ohio","Adams County",5,60,386,188,198
050,39,001,"Ohio","Adams County",5,61,395,190,205
050,39,001,"Ohio","Adams County",5,62,393,197,196
050,39,001,"Ohio","Adams County",5,63,378,195,183
050,39,001,"Ohio","Adams County",5,64,400,200,200
050,39,001,"Ohio","Adams County",5,65,390,184,206
050,39,001,"Ohio","Adams County",5,66,382,186,196
050,39,001,"Ohio","Adams County",5,67,369,178,191
050,39,001,"Ohio","Adams County",5,68,374,190,184
050,39,001,"Ohio","Adams County",5,69,345,175,170
050,39,001,"Ohio","Adams County",5,70,313,157,156
050,39,001,"Ohio","Adams County",5,71,305,151,154
050,39,001,"Ohio","Adams County",5,72,286,150,136
050,39,001,"Ohio","Adams County",5,73,252,134,118
050,39,001,"Ohio","Adams County",5,74,268,125,143
050,39,001,"Ohio","Adams County",5,75,224,112,112
050,39,001,"Ohio","Adams County",5,76,258,148,110
050,39,001,"Ohio","Adams County",5,77,166,87,79
050,39,001,"Ohio","Adams County",5,78,169,89,80
050,39,001,"Ohio","Adams County",5,79,139,60,79
050,39,001,"Ohio","Adams County",5,80,150,59,91
050,39,001,"Ohio","Adams County",5,81,122,43,79
050,39,001,"Ohio","Adams County",5,82,112,45,67
050,39,001,"Ohio","Adams County",5,83,89,37,52
050,39,001,"Ohio","Adams County",5,84,75,28,47
050,39,001,"Ohio","Adams County",5,85,433,162,271
050,39,003,"Ohio","Allen County",1,0,1245,633,612
050,39,003,"Ohio","Allen County",1,1,1239,636,603
050,39,003,"Ohio","Allen County",1,2,1298,676,622
050,39,003,"Ohio","Allen County",1,3,1248,651,597
050,39,003,"Ohio","Allen County",1,4,1324,688,636
050,39,003,"Ohio","Allen County",1,5,1318,681,637
050,39,003,"Ohio","Allen County",1,6,1327,681,646
050,39,003,"Ohio","Allen County",1,7,1299,668,631
050,39,003,"Ohio","Allen County",1,8,1262,681,581
050,39,003,"Ohio","Allen County",1,9,1339,704,635
050,39,003,"Ohio","Allen County",1,10,1339,682,657
050,39,003,"Ohio","Allen County",1,11,1408,724,684
050,39,003,"Ohio","Allen County",1,12,1448,734,714
050,39,003,"Ohio","Allen County",1,13,1447,767,680
050,39,003,"Ohio","Allen County",1,14,1442,748,694
050,39,003,"Ohio","Allen County",1,15,1438,726,712
050,39,003,"Ohio","Allen County",1,16,1454,746,708
050,39,003,"Ohio","Allen County",1,17,1440,737,703
050,39,003,"Ohio","Allen County",1,18,1313,717,596
050,39,003,"Ohio","Allen County",1,19,1395,816,579
050,39,003,"Ohio","Allen County",1,20,1382,740,642
050,39,003,"Ohio","Allen County",1,21,1357,718,639
050,39,003,"Ohio","Allen County",1,22,1291,694,597
050,39,003,"Ohio","Allen County",1,23,1231,631,600
050,39,003,"Ohio","Allen County",1,24,1262,672,590
050,39,003,"Ohio","Allen County",1,25,1196,637,559
050,39,003,"Ohio","Allen County",1,26,1220,644,576
050,39,003,"Ohio","Allen County",1,27,1272,674,598
050,39,003,"Ohio","Allen County",1,28,1349,701,648
050,39,003,"Ohio","Allen County",1,29,1409,738,671
050,39,003,"Ohio","Allen County",1,30,1241,656,585
050,39,003,"Ohio","Allen County",1,31,1215,640,575
050,39,003,"Ohio","Allen County",1,32,1168,584,584
050,39,003,"Ohio","Allen County",1,33,1150,560,590
050,39,003,"Ohio","Allen County",1,34,1118,541,577
050,39,003,"Ohio","Allen County",1,35,1118,555,563
050,39,003,"Ohio","Allen County",1,36,1109,584,525
050,39,003,"Ohio","Allen County",1,37,1169,578,591
050,39,003,"Ohio","Allen County",1,38,1274,622,652
050,39,003,"Ohio","Allen County",1,39,1255,615,640
050,39,003,"Ohio","Allen County",1,40,1219,613,606
050,39,003,"Ohio","Allen County",1,41,1241,621,620
050,39,003,"Ohio","Allen County",1,42,1229,606,623
050,39,003,"Ohio","Allen County",1,43,1151,569,582
050,39,003,"Ohio","Allen County",1,44,1127,530,597
050,39,003,"Ohio","Allen County",1,45,1148,568,580
050,39,003,"Ohio","Allen County",1,46,1073,568,505
050,39,003,"Ohio","Allen County",1,47,1085,559,526
050,39,003,"Ohio","Allen County",1,48,1207,604,603
050,39,003,"Ohio","Allen County",1,49,1303,646,657
050,39,003,"Ohio","Allen County",1,50,1152,601,551
050,39,003,"Ohio","Allen County",1,51,1144,586,558
050,39,003,"Ohio","Allen County",1,52,1197,628,569
050,39,003,"Ohio","Allen County",1,53,1211,617,594
050,39,003,"Ohio","Allen County",1,54,1256,640,616
050,39,003,"Ohio","Allen County",1,55,1345,662,683
050,39,003,"Ohio","Allen County",1,56,1400,700,700
050,39,003,"Ohio","Allen County",1,57,1410,682,728
050,39,003,"Ohio","Allen County",1,58,1370,665,705
050,39,003,"Ohio","Allen County",1,59,1383,678,705
050,39,003,"Ohio","Allen County",1,60,1447,714,733
050,39,003,"Ohio","Allen County",1,61,1479,726,753
050,39,003,"Ohio","Allen County",1,62,1434,710,724
050,39,003,"Ohio","Allen County",1,63,1358,648,710
050,39,003,"Ohio","Allen County",1,64,1372,683,689
050,39,003,"Ohio","Allen County",1,65,1365,679,686
050,39,003,"Ohio","Allen County",1,66,1288,629,659
050,39,003,"Ohio","Allen County",1,67,1221,592,629
050,39,003,"Ohio","Allen County",1,68,1202,593,609
050,39,003,"Ohio","Allen County",1,69,1125,554,571
050,39,003,"Ohio","Allen County",1,70,1107,554,553
050,39,003,"Ohio","Allen County",1,71,1062,520,542
050,39,003,"Ohio","Allen County",1,72,1026,485,541
050,39,003,"Ohio","Allen County",1,73,1007,487,520
050,39,003,"Ohio","Allen County",1,74,702,326,376
050,39,003,"Ohio","Allen County",1,75,687,318,369
050,39,003,"Ohio","Allen County",1,76,636,277,359
050,39,003,"Ohio","Allen County",1,77,678,302,376
050,39,003,"Ohio","Allen County",1,78,616,269,347
050,39,003,"Ohio","Allen County",1,79,517,212,305
050,39,003,"Ohio","Allen County",1,80,503,212,291
050,39,003,"Ohio","Allen County",1,81,464,206,258
050,39,003,"Ohio","Allen County",1,82,455,188,267
050,39,003,"Ohio","Allen County",1,83,390,156,234
050,39,003,"Ohio","Allen County",1,84,336,140,196
050,39,003,"Ohio","Allen County",1,85,2274,725,1549
050,39,003,"Ohio","Allen County",2,0,1222,639,583
050,39,003,"Ohio","Allen County",2,1,1237,635,602
050,39,003,"Ohio","Allen County",2,2,1286,666,620
050,39,003,"Ohio","Allen County",2,3,1256,655,601
050,39,003,"Ohio","Allen County",2,4,1312,683,629
050,39,003,"Ohio","Allen County",2,5,1325,686,639
050,39,003,"Ohio","Allen County",2,6,1333,686,647
050,39,003,"Ohio","Allen County",2,7,1307,671,636
050,39,003,"Ohio","Allen County",2,8,1266,674,592
050,39,003,"Ohio","Allen County",2,9,1314,697,617
050,39,003,"Ohio","Allen County",2,10,1338,689,649
050,39,003,"Ohio","Allen County",2,11,1382,708,674
050,39,003,"Ohio","Allen County",2,12,1442,733,709
050,39,003,"Ohio","Allen County",2,13,1450,760,690
050,39,003,"Ohio","Allen County",2,14,1446,754,692
050,39,003,"Ohio","Allen County",2,15,1443,733,710
050,39,003,"Ohio","Allen County",2,16,1455,743,712
050,39,003,"Ohio","Allen County",2,17,1445,740,705
050,39,003,"Ohio","Allen County",2,18,1318,719,599
050,39,003,"Ohio","Allen County",2,19,1388,812,576
050,39,003,"Ohio","Allen County",2,20,1381,741,640
050,39,003,"Ohio","Allen County",2,21,1353,714,639
050,39,003,"Ohio","Allen County",2,22,1305,699,606
050,39,003,"Ohio","Allen County",2,23,1237,635,602
050,39,003,"Ohio","Allen County",2,24,1254,664,590
050,39,003,"Ohio","Allen County",2,25,1195,636,559
050,39,003,"Ohio","Allen County",2,26,1216,645,571
050,39,003,"Ohio","Allen County",2,27,1254,663,591
050,39,003,"Ohio","Allen County",2,28,1338,701,637
050,39,003,"Ohio","Allen County",2,29,1385,717,668
050,39,003,"Ohio","Allen County",2,30,1278,670,608
050,39,003,"Ohio","Allen County",2,31,1226,647,579
050,39,003,"Ohio","Allen County",2,32,1171,595,576
050,39,003,"Ohio","Allen County",2,33,1151,564,587
050,39,003,"Ohio","Allen County",2,34,1124,542,582
050,39,003,"Ohio","Allen County",2,35,1119,549,570
050,39,003,"Ohio","Allen County",2,36,1108,577,531
050,39,003,"Ohio","Allen County",2,37,1146,570,576
050,39,003,"Ohio","Allen County",2,38,1263,621,642
050,39,003,"Ohio","Allen County",2,39,1251,615,636
050,39,003,"Ohio","Allen County",2,40,1237,621,616
050,39,003,"Ohio","Allen County",2,41,1237,618,619
050,39,003,"Ohio","Allen County",2,42,1219,604,615
050,39,003,"Ohio","Allen County",2,43,1167,577,590
050,39,003,"Ohio","Allen County",2,44,1117,528,589
050,39,003,"Ohio","Allen County",2,45,1151,565,586
050,39,003,"Ohio","Allen County",2,46,1085,564,521
050,39,003,"Ohio","Allen County",2,47,1077,560,517
050,39,003,"Ohio","Allen County",2,48,1177,594,583
050,39,003,"Ohio","Allen County",2,49,1282,637,645
050,39,003,"Ohio","Allen County",2,50,1192,613,579
050,39,003,"Ohio","Allen County",2,51,1138,586,552
050,39,003,"Ohio","Allen County",2,52,1185,621,564
050,39,003,"Ohio","Allen County",2,53,1202,615,587
050,39,003,"Ohio","Allen County",2,54,1242,635,607
050,39,003,"Ohio","Allen County",2,55,1319,653,666
050,39,003,"Ohio","Allen County",2,56,1389,691,698
050,39,003,"Ohio","Allen County",2,57,1406,682,724
050,39,003,"Ohio","Allen County",2,58,1371,666,705
050,39,003,"Ohio","Allen County",2,59,1379,675,704
050,39,003,"Ohio","Allen County",2,60,1421,696,725
050,39,003,"Ohio","Allen County",2,61,1461,716,745
050,39,003,"Ohio","Allen County",2,62,1436,709,727
050,39,003,"Ohio","Allen County",2,63,1380,662,718
050,39,003,"Ohio","Allen County",2,64,1355,666,689
050,39,003,"Ohio","Allen County",2,65,1365,679,686
050,39,003,"Ohio","Allen County",2,66,1300,635,665
050,39,003,"Ohio","Allen County",2,67,1229,594,635
050,39,003,"Ohio","Allen County",2,68,1193,587,606
050,39,003,"Ohio","Allen County",2,69,1149,564,585
050,39,003,"Ohio","Allen County",2,70,1104,548,556
050,39,003,"Ohio","Allen County",2,71,1068,524,544
050,39,003,"Ohio","Allen County",2,72,1015,481,534
050,39,003,"Ohio","Allen County",2,73,1058,510,548
050,39,003,"Ohio","Allen County",2,74,726,337,389
050,39,003,"Ohio","Allen County",2,75,681,315,366
050,39,003,"Ohio","Allen County",2,76,635,281,354
050,39,003,"Ohio","Allen County",2,77,674,298,376
050,39,003,"Ohio","Allen County",2,78,613,266,347
050,39,003,"Ohio","Allen County",2,79,529,221,308
050,39,003,"Ohio","Allen County",2,80,501,210,291
050,39,003,"Ohio","Allen County",2,81,468,206,262
050,39,003,"Ohio","Allen County",2,82,460,192,268
050,39,003,"Ohio","Allen County",2,83,398,160,238
050,39,003,"Ohio","Allen County",2,84,343,142,201
050,39,003,"Ohio","Allen County",2,85,2271,720,1551
050,39,003,"Ohio","Allen County",3,0,1165,599,566
050,39,003,"Ohio","Allen County",3,1,1199,617,582
050,39,003,"Ohio","Allen County",3,2,1247,644,603
050,39,003,"Ohio","Allen County",3,3,1273,664,609
050,39,003,"Ohio","Allen County",3,4,1271,663,608
050,39,003,"Ohio","Allen County",3,5,1307,680,627
050,39,003,"Ohio","Allen County",3,6,1330,684,646
050,39,003,"Ohio","Allen County",3,7,1350,685,665
050,39,003,"Ohio","Allen County",3,8,1301,669,632
050,39,003,"Ohio","Allen County",3,9,1276,682,594
050,39,003,"Ohio","Allen County",3,10,1346,712,634
050,39,003,"Ohio","Allen County",3,11,1348,700,648
050,39,003,"Ohio","Allen County",3,12,1389,710,679
050,39,003,"Ohio","Allen County",3,13,1453,742,711
050,39,003,"Ohio","Allen County",3,14,1469,773,696
050,39,003,"Ohio","Allen County",3,15,1444,743,701
050,39,003,"Ohio","Allen County",3,16,1445,737,708
050,39,003,"Ohio","Allen County",3,17,1445,732,713
050,39,003,"Ohio","Allen County",3,18,1370,745,625
050,39,003,"Ohio","Allen County",3,19,1391,834,557
050,39,003,"Ohio","Allen County",3,20,1340,740,600
050,39,003,"Ohio","Allen County",3,21,1369,706,663
050,39,003,"Ohio","Allen County",3,22,1375,726,649
050,39,003,"Ohio","Allen County",3,23,1289,666,623
050,39,003,"Ohio","Allen County",3,24,1229,645,584
050,39,003,"Ohio","Allen County",3,25,1179,617,562
050,39,003,"Ohio","Allen County",3,26,1196,640,556
050,39,003,"Ohio","Allen County",3,27,1222,649,573
050,39,003,"Ohio","Allen County",3,28,1284,680,604
050,39,003,"Ohio","Allen County",3,29,1305,675,630
050,39,003,"Ohio","Allen County",3,30,1349,683,666
050,39,003,"Ohio","Allen County",3,31,1294,687,607
050,39,003,"Ohio","Allen County",3,32,1218,635,583
050,39,003,"Ohio","Allen County",3,33,1175,606,569
050,39,003,"Ohio","Allen County",3,34,1141,554,587
050,39,003,"Ohio","Allen County",3,35,1132,551,581
050,39,003,"Ohio","Allen County",3,36,1176,595,581
050,39,003,"Ohio","Allen County",3,37,1100,549,551
050,39,003,"Ohio","Allen County",3,38,1199,598,601
050,39,003,"Ohio","Allen County",3,39,1213,590,623
050,39,003,"Ohio","Allen County",3,40,1243,610,633
050,39,003,"Ohio","Allen County",3,41,1248,623,625
050,39,003,"Ohio","Allen County",3,42,1233,616,617
050,39,003,"Ohio","Allen County",3,43,1202,601,601
050,39,003,"Ohio","Allen County",3,44,1178,581,597
050,39,003,"Ohio","Allen County",3,45,1109,531,578
050,39,003,"Ohio","Allen County",3,46,1134,553,581
050,39,003,"Ohio","Allen County",3,47,1062,550,512
050,39,003,"Ohio","Allen County",3,48,1088,574,514
050,39,003,"Ohio","Allen County",3,49,1179,596,583
050,39,003,"Ohio","Allen County",3,50,1287,634,653
050,39,003,"Ohio","Allen County",3,51,1188,613,575
050,39,003,"Ohio","Allen County",3,52,1148,604,544
050,39,003,"Ohio","Allen County",3,53,1151,601,550
050,39,003,"Ohio","Allen County",3,54,1204,618,586
050,39,003,"Ohio","Allen County",3,55,1196,608,588
050,39,003,"Ohio","Allen County",3,56,1303,654,649
050,39,003,"Ohio","Allen County",3,57,1358,671,687
050,39,003,"Ohio","Allen County",3,58,1368,663,705
050,39,003,"Ohio","Allen County",3,59,1373,672,701
050,39,003,"Ohio","Allen County",3,60,1354,649,705
050,39,003,"Ohio","Allen County",3,61,1404,688,716
050,39,003,"Ohio","Allen County",3,62,1435,696,739
050,39,003,"Ohio","Allen County",3,63,1408,689,719
050,39,003,"Ohio","Allen County",3,64,1357,656,701
050,39,003,"Ohio","Allen County",3,65,1328,659,669
050,39,003,"Ohio","Allen County",3,66,1323,646,677
050,39,003,"Ohio","Allen County",3,67,1280,623,657
050,39,003,"Ohio","Allen County",3,68,1172,569,603
050,39,003,"Ohio","Allen County",3,69,1150,554,596
050,39,003,"Ohio","Allen County",3,70,1113,543,570
050,39,003,"Ohio","Allen County",3,71,1070,529,541
050,39,003,"Ohio","Allen County",3,72,1029,503,526
050,39,003,"Ohio","Allen County",3,73,994,483,511
050,39,003,"Ohio","Allen County",3,74,995,457,538
050,39,003,"Ohio","Allen County",3,75,676,306,370
050,39,003,"Ohio","Allen County",3,76,653,303,350
050,39,003,"Ohio","Allen County",3,77,616,275,341
050,39,003,"Ohio","Allen County",3,78,639,276,363
050,39,003,"Ohio","Allen County",3,79,574,236,338
050,39,003,"Ohio","Allen County",3,80,500,212,288
050,39,003,"Ohio","Allen County",3,81,460,189,271
050,39,003,"Ohio","Allen County",3,82,444,184,260
050,39,003,"Ohio","Allen County",3,83,409,166,243
050,39,003,"Ohio","Allen County",3,84,348,143,205
050,39,003,"Ohio","Allen County",3,85,2197,705,1492
050,39,003,"Ohio","Allen County",4,0,1183,572,611
050,39,003,"Ohio","Allen County",4,1,1209,604,605
050,39,003,"Ohio","Allen County",4,2,1226,640,586
050,39,003,"Ohio","Allen County",4,3,1240,625,615
050,39,003,"Ohio","Allen County",4,4,1281,670,611
050,39,003,"Ohio","Allen County",4,5,1286,670,616
050,39,003,"Ohio","Allen County",4,6,1291,664,627
050,39,003,"Ohio","Allen County",4,7,1348,699,649
050,39,003,"Ohio","Allen County",4,8,1335,685,650
050,39,003,"Ohio","Allen County",4,9,1304,662,642
050,39,003,"Ohio","Allen County",4,10,1269,668,601
050,39,003,"Ohio","Allen County",4,11,1328,704,624
050,39,003,"Ohio","Allen County",4,12,1350,699,651
050,39,003,"Ohio","Allen County",4,13,1358,700,658
050,39,003,"Ohio","Allen County",4,14,1458,744,714
050,39,003,"Ohio","Allen County",4,15,1464,763,701
050,39,003,"Ohio","Allen County",4,16,1434,737,697
050,39,003,"Ohio","Allen County",4,17,1440,737,703
050,39,003,"Ohio","Allen County",4,18,1328,737,591
050,39,003,"Ohio","Allen County",4,19,1369,814,555
050,39,003,"Ohio","Allen County",4,20,1318,741,577
050,39,003,"Ohio","Allen County",4,21,1304,692,612
050,39,003,"Ohio","Allen County",4,22,1368,700,668
050,39,003,"Ohio","Allen County",4,23,1308,662,646
050,39,003,"Ohio","Allen County",4,24,1250,662,588
050,39,003,"Ohio","Allen County",4,25,1187,613,574
050,39,003,"Ohio","Allen County",4,26,1163,614,549
050,39,003,"Ohio","Allen County",4,27,1202,638,564
050,39,003,"Ohio","Allen County",4,28,1238,667,571
050,39,003,"Ohio","Allen County",4,29,1230,637,593
050,39,003,"Ohio","Allen County",4,30,1260,638,622
050,39,003,"Ohio","Allen County",4,31,1392,707,685
050,39,003,"Ohio","Allen County",4,32,1289,697,592
050,39,003,"Ohio","Allen County",4,33,1216,632,584
050,39,003,"Ohio","Allen County",4,34,1168,602,566
050,39,003,"Ohio","Allen County",4,35,1165,563,602
050,39,003,"Ohio","Allen County",4,36,1215,613,602
050,39,003,"Ohio","Allen County",4,37,1149,564,585
050,39,003,"Ohio","Allen County",4,38,1136,572,564
050,39,003,"Ohio","Allen County",4,39,1157,587,570
050,39,003,"Ohio","Allen County",4,40,1203,593,610
050,39,003,"Ohio","Allen County",4,41,1266,621,645
050,39,003,"Ohio","Allen County",4,42,1241,623,618
050,39,003,"Ohio","Allen County",4,43,1235,613,622
050,39,003,"Ohio","Allen County",4,44,1163,581,582
050,39,003,"Ohio","Allen County",4,45,1168,583,585
050,39,003,"Ohio","Allen County",4,46,1091,526,565
050,39,003,"Ohio","Allen County",4,47,1136,547,589
050,39,003,"Ohio","Allen County",4,48,1070,553,517
050,39,003,"Ohio","Allen County",4,49,1075,567,508
050,39,003,"Ohio","Allen County",4,50,1172,591,581
050,39,003,"Ohio","Allen County",4,51,1262,616,646
050,39,003,"Ohio","Allen County",4,52,1188,622,566
050,39,003,"Ohio","Allen County",4,53,1120,571,549
050,39,003,"Ohio","Allen County",4,54,1159,603,556
050,39,003,"Ohio","Allen County",4,55,1177,597,580
050,39,003,"Ohio","Allen County",4,56,1181,604,577
050,39,003,"Ohio","Allen County",4,57,1283,629,654
050,39,003,"Ohio","Allen County",4,58,1320,646,674
050,39,003,"Ohio","Allen County",4,59,1358,663,695
050,39,003,"Ohio","Allen County",4,60,1341,651,690
050,39,003,"Ohio","Allen County",4,61,1335,640,695
050,39,003,"Ohio","Allen County",4,62,1375,670,705
050,39,003,"Ohio","Allen County",4,63,1399,681,718
050,39,003,"Ohio","Allen County",4,64,1395,681,714
050,39,003,"Ohio","Allen County",4,65,1329,642,687
050,39,003,"Ohio","Allen County",4,66,1285,623,662
050,39,003,"Ohio","Allen County",4,67,1295,645,650
050,39,003,"Ohio","Allen County",4,68,1226,598,628
050,39,003,"Ohio","Allen County",4,69,1145,544,601
050,39,003,"Ohio","Allen County",4,70,1108,533,575
050,39,003,"Ohio","Allen County",4,71,1065,514,551
050,39,003,"Ohio","Allen County",4,72,1038,517,521
050,39,003,"Ohio","Allen County",4,73,1004,506,498
050,39,003,"Ohio","Allen County",4,74,949,446,503
050,39,003,"Ohio","Allen County",4,75,962,441,521
050,39,003,"Ohio","Allen County",4,76,646,292,354
050,39,003,"Ohio","Allen County",4,77,632,294,338
050,39,003,"Ohio","Allen County",4,78,573,248,325
050,39,003,"Ohio","Allen County",4,79,591,248,343
050,39,003,"Ohio","Allen County",4,80,539,221,318
050,39,003,"Ohio","Allen County",4,81,462,189,273
050,39,003,"Ohio","Allen County",4,82,443,170,273
050,39,003,"Ohio","Allen County",4,83,398,163,235
050,39,003,"Ohio","Allen County",4,84,364,152,212
050,39,003,"Ohio","Allen County",4,85,2114,681,1433
050,39,003,"Ohio","Allen County",5,0,1199,579,620
050,39,003,"Ohio","Allen County",5,1,1222,582,640
050,39,003,"Ohio","Allen County",5,2,1214,612,602
050,39,003,"Ohio","Allen County",5,3,1214,632,582
050,39,003,"Ohio","Allen County",5,4,1255,647,608
050,39,003,"Ohio","Allen County",5,5,1307,676,631
050,39,003,"Ohio","Allen County",5,6,1298,683,615
050,39,003,"Ohio","Allen County",5,7,1299,669,630
050,39,003,"Ohio","Allen County",5,8,1354,704,650
050,39,003,"Ohio","Allen County",5,9,1339,676,663
050,39,003,"Ohio","Allen County",5,10,1279,659,620
050,39,003,"Ohio","Allen County",5,11,1284,673,611
050,39,003,"Ohio","Allen County",5,12,1352,713,639
050,39,003,"Ohio","Allen County",5,13,1321,685,636
050,39,003,"Ohio","Allen County",5,14,1369,696,673
050,39,003,"Ohio","Allen County",5,15,1421,722,699
050,39,003,"Ohio","Allen County",5,16,1453,756,697
050,39,003,"Ohio","Allen County",5,17,1424,731,693
050,39,003,"Ohio","Allen County",5,18,1314,713,601
050,39,003,"Ohio","Allen County",5,19,1340,797,543
050,39,003,"Ohio","Allen County",5,20,1355,749,606
050,39,003,"Ohio","Allen County",5,21,1309,720,589
050,39,003,"Ohio","Allen County",5,22,1314,690,624
050,39,003,"Ohio","Allen County",5,23,1324,659,665
050,39,003,"Ohio","Allen County",5,24,1264,649,615
050,39,003,"Ohio","Allen County",5,25,1175,622,553
050,39,003,"Ohio","Allen County",5,26,1170,609,561
050,39,003,"Ohio","Allen County",5,27,1145,607,538
050,39,003,"Ohio","Allen County",5,28,1249,673,576
050,39,003,"Ohio","Allen County",5,29,1234,646,588
050,39,003,"Ohio","Allen County",5,30,1245,649,596
050,39,003,"Ohio","Allen County",5,31,1310,664,646
050,39,003,"Ohio","Allen County",5,32,1358,686,672
050,39,003,"Ohio","Allen County",5,33,1272,677,595
050,39,003,"Ohio","Allen County",5,34,1204,613,591
050,39,003,"Ohio","Allen County",5,35,1153,597,556
050,39,003,"Ohio","Allen County",5,36,1218,610,608
050,39,003,"Ohio","Allen County",5,37,1205,593,612
050,39,003,"Ohio","Allen County",5,38,1194,590,604
050,39,003,"Ohio","Allen County",5,39,1088,545,543
050,39,003,"Ohio","Allen County",5,40,1130,566,564
050,39,003,"Ohio","Allen County",5,41,1207,590,617
050,39,003,"Ohio","Allen County",5,42,1262,623,639
050,39,003,"Ohio","Allen County",5,43,1238,623,615
050,39,003,"Ohio","Allen County",5,44,1226,609,617
050,39,003,"Ohio","Allen County",5,45,1162,591,571
050,39,003,"Ohio","Allen County",5,46,1159,570,589
050,39,003,"Ohio","Allen County",5,47,1091,531,560
050,39,003,"Ohio","Allen County",5,48,1137,559,578
050,39,003,"Ohio","Allen County",5,49,1068,543,525
050,39,003,"Ohio","Allen County",5,50,1065,555,510
050,39,003,"Ohio","Allen County",5,51,1147,576,571
050,39,003,"Ohio","Allen County",5,52,1255,634,621
050,39,003,"Ohio","Allen County",5,53,1180,610,570
050,39,003,"Ohio","Allen County",5,54,1120,576,544
050,39,003,"Ohio","Allen County",5,55,1156,591,565
050,39,003,"Ohio","Allen County",5,56,1165,589,576
050,39,003,"Ohio","Allen County",5,57,1169,574,595
050,39,003,"Ohio","Allen County",5,58,1259,619,640
050,39,003,"Ohio","Allen County",5,59,1332,660,672
050,39,003,"Ohio","Allen County",5,60,1344,652,692
050,39,003,"Ohio","Allen County",5,61,1330,642,688
050,39,003,"Ohio","Allen County",5,62,1315,630,685
050,39,003,"Ohio","Allen County",5,63,1347,650,697
050,39,003,"Ohio","Allen County",5,64,1375,677,698
050,39,003,"Ohio","Allen County",5,65,1377,674,703
050,39,003,"Ohio","Allen County",5,66,1292,615,677
050,39,003,"Ohio","Allen County",5,67,1279,624,655
050,39,003,"Ohio","Allen County",5,68,1247,623,624
050,39,003,"Ohio","Allen County",5,69,1206,579,627
050,39,003,"Ohio","Allen County",5,70,1125,529,596
050,39,003,"Ohio","Allen County",5,71,1062,503,559
050,39,003,"Ohio","Allen County",5,72,1029,503,526
050,39,003,"Ohio","Allen County",5,73,998,507,491
050,39,003,"Ohio","Allen County",5,74,966,472,494
050,39,003,"Ohio","Allen County",5,75,909,428,481
050,39,003,"Ohio","Allen County",5,76,936,425,511
050,39,003,"Ohio","Allen County",5,77,620,282,338
050,39,003,"Ohio","Allen County",5,78,608,273,335
050,39,003,"Ohio","Allen County",5,79,531,227,304
050,39,003,"Ohio","Allen County",5,80,557,231,326
050,39,003,"Ohio","Allen County",5,81,500,200,300
050,39,003,"Ohio","Allen County",5,82,443,171,272
050,39,003,"Ohio","Allen County",5,83,394,150,244
050,39,003,"Ohio","Allen County",5,84,356,148,208
050,39,003,"Ohio","Allen County",5,85,2120,699,1421
050,39,005,"Ohio","Ashland County",1,0,585,299,286
050,39,005,"Ohio","Ashland County",1,1,610,296,314
050,39,005,"Ohio","Ashland County",1,2,622,311,311
050,39,005,"Ohio","Ashland County",1,3,604,311,293
050,39,005,"Ohio","Ashland County",1,4,584,288,296
050,39,005,"Ohio","Ashland County",1,5,647,329,318
050,39,005,"Ohio","Ashland County",1,6,680,366,314
050,39,005,"Ohio","Ashland County",1,7,663,339,324
050,39,005,"Ohio","Ashland County",1,8,631,323,308
050,39,005,"Ohio","Ashland County",1,9,632,329,303
050,39,005,"Ohio","Ashland County",1,10,683,356,327
050,39,005,"Ohio","Ashland County",1,11,666,348,318
050,39,005,"Ohio","Ashland County",1,12,735,372,363
050,39,005,"Ohio","Ashland County",1,13,725,371,354
050,39,005,"Ohio","Ashland County",1,14,728,381,347
050,39,005,"Ohio","Ashland County",1,15,719,366,353
050,39,005,"Ohio","Ashland County",1,16,709,344,365
050,39,005,"Ohio","Ashland County",1,17,733,377,356
050,39,005,"Ohio","Ashland County",1,18,717,372,345
050,39,005,"Ohio","Ashland County",1,19,719,376,343
050,39,005,"Ohio","Ashland County",1,20,715,343,372
050,39,005,"Ohio","Ashland County",1,21,683,333,350
050,39,005,"Ohio","Ashland County",1,22,632,315,317
050,39,005,"Ohio","Ashland County",1,23,599,296,303
050,39,005,"Ohio","Ashland County",1,24,606,315,291
050,39,005,"Ohio","Ashland County",1,25,643,329,314
050,39,005,"Ohio","Ashland County",1,26,630,338,292
050,39,005,"Ohio","Ashland County",1,27,607,304,303
050,39,005,"Ohio","Ashland County",1,28,603,307,296
050,39,005,"Ohio","Ashland County",1,29,578,296,282
050,39,005,"Ohio","Ashland County",1,30,602,313,289
050,39,005,"Ohio","Ashland County",1,31,569,285,284
050,39,005,"Ohio","Ashland County",1,32,548,274,274
050,39,005,"Ohio","Ashland County",1,33,560,287,273
050,39,005,"Ohio","Ashland County",1,34,600,299,301
050,39,005,"Ohio","Ashland County",1,35,653,332,321
050,39,005,"Ohio","Ashland County",1,36,627,320,307
050,39,005,"Ohio","Ashland County",1,37,602,306,296
050,39,005,"Ohio","Ashland County",1,38,609,322,287
050,39,005,"Ohio","Ashland County",1,39,599,320,279
050,39,005,"Ohio","Ashland County",1,40,605,312,293
050,39,005,"Ohio","Ashland County",1,41,576,289,287
050,39,005,"Ohio","Ashland County",1,42,568,291,277
050,39,005,"Ohio","Ashland County",1,43,575,294,281
050,39,005,"Ohio","Ashland County",1,44,575,289,286
050,39,005,"Ohio","Ashland County",1,45,593,299,294
050,39,005,"Ohio","Ashland County",1,46,557,280,277
050,39,005,"Ohio","Ashland County",1,47,591,308,283
050,39,005,"Ohio","Ashland County",1,48,613,307,306
050,39,005,"Ohio","Ashland County",1,49,694,342,352
050,39,005,"Ohio","Ashland County",1,50,663,323,340
050,39,005,"Ohio","Ashland County",1,51,669,351,318
050,39,005,"Ohio","Ashland County",1,52,654,331,323
050,39,005,"Ohio","Ashland County",1,53,646,307,339
050,39,005,"Ohio","Ashland County",1,54,633,304,329
050,39,005,"Ohio","Ashland County",1,55,689,348,341
050,39,005,"Ohio","Ashland County",1,56,724,369,355
050,39,005,"Ohio","Ashland County",1,57,711,348,363
050,39,005,"Ohio","Ashland County",1,58,725,367,358
050,39,005,"Ohio","Ashland County",1,59,737,344,393
050,39,005,"Ohio","Ashland County",1,60,750,362,388
050,39,005,"Ohio","Ashland County",1,61,756,378,378
050,39,005,"Ohio","Ashland County",1,62,793,383,410
050,39,005,"Ohio","Ashland County",1,63,776,383,393
050,39,005,"Ohio","Ashland County",1,64,723,355,368
050,39,005,"Ohio","Ashland County",1,65,713,354,359
050,39,005,"Ohio","Ashland County",1,66,668,321,347
050,39,005,"Ohio","Ashland County",1,67,670,322,348
050,39,005,"Ohio","Ashland County",1,68,649,330,319
050,39,005,"Ohio","Ashland County",1,69,573,281,292
050,39,005,"Ohio","Ashland County",1,70,554,265,289
050,39,005,"Ohio","Ashland County",1,71,530,259,271
050,39,005,"Ohio","Ashland County",1,72,551,266,285
050,39,005,"Ohio","Ashland County",1,73,575,267,308
050,39,005,"Ohio","Ashland County",1,74,362,164,198
050,39,005,"Ohio","Ashland County",1,75,398,185,213
050,39,005,"Ohio","Ashland County",1,76,400,189,211
050,39,005,"Ohio","Ashland County",1,77,405,181,224
050,39,005,"Ohio","Ashland County",1,78,386,171,215
050,39,005,"Ohio","Ashland County",1,79,308,134,174
050,39,005,"Ohio","Ashland County",1,80,277,123,154
050,39,005,"Ohio","Ashland County",1,81,279,123,156
050,39,005,"Ohio","Ashland County",1,82,248,110,138
050,39,005,"Ohio","Ashland County",1,83,231,99,132
050,39,005,"Ohio","Ashland County",1,84,207,92,115
050,39,005,"Ohio","Ashland County",1,85,1200,417,783
050,39,005,"Ohio","Ashland County",2,0,578,291,287
050,39,005,"Ohio","Ashland County",2,1,604,297,307
050,39,005,"Ohio","Ashland County",2,2,616,307,309
050,39,005,"Ohio","Ashland County",2,3,608,312,296
050,39,005,"Ohio","Ashland County",2,4,588,291,297
050,39,005,"Ohio","Ashland County",2,5,634,319,315
050,39,005,"Ohio","Ashland County",2,6,674,357,317
050,39,005,"Ohio","Ashland County",2,7,665,345,320
050,39,005,"Ohio","Ashland County",2,8,639,328,311
050,39,005,"Ohio","Ashland County",2,9,631,326,305
050,39,005,"Ohio","Ashland County",2,10,670,349,321
050,39,005,"Ohio","Ashland County",2,11,665,347,318
050,39,005,"Ohio","Ashland County",2,12,725,368,357
050,39,005,"Ohio","Ashland County",2,13,727,371,356
050,39,005,"Ohio","Ashland County",2,14,729,379,350
050,39,005,"Ohio","Ashland County",2,15,721,368,353
050,39,005,"Ohio","Ashland County",2,16,717,354,363
050,39,005,"Ohio","Ashland County",2,17,732,374,358
050,39,005,"Ohio","Ashland County",2,18,702,363,339
050,39,005,"Ohio","Ashland County",2,19,714,370,344
050,39,005,"Ohio","Ashland County",2,20,721,351,370
050,39,005,"Ohio","Ashland County",2,21,689,335,354
050,39,005,"Ohio","Ashland County",2,22,636,317,319
050,39,005,"Ohio","Ashland County",2,23,597,298,299
050,39,005,"Ohio","Ashland County",2,24,602,312,290
050,39,005,"Ohio","Ashland County",2,25,632,323,309
050,39,005,"Ohio","Ashland County",2,26,635,335,300
050,39,005,"Ohio","Ashland County",2,27,615,313,302
050,39,005,"Ohio","Ashland County",2,28,606,308,298
050,39,005,"Ohio","Ashland County",2,29,584,299,285
050,39,005,"Ohio","Ashland County",2,30,601,310,291
050,39,005,"Ohio","Ashland County",2,31,578,292,286
050,39,005,"Ohio","Ashland County",2,32,554,277,277
050,39,005,"Ohio","Ashland County",2,33,557,284,273
050,39,005,"Ohio","Ashland County",2,34,598,300,298
050,39,005,"Ohio","Ashland County",2,35,650,329,321
050,39,005,"Ohio","Ashland County",2,36,628,319,309
050,39,005,"Ohio","Ashland County",2,37,613,312,301
050,39,005,"Ohio","Ashland County",2,38,608,318,290
050,39,005,"Ohio","Ashland County",2,39,598,319,279
050,39,005,"Ohio","Ashland County",2,40,609,316,293
050,39,005,"Ohio","Ashland County",2,41,580,292,288
050,39,005,"Ohio","Ashland County",2,42,567,289,278
050,39,005,"Ohio","Ashland County",2,43,579,297,282
050,39,005,"Ohio","Ashland County",2,44,569,287,282
050,39,005,"Ohio","Ashland County",2,45,593,299,294
050,39,005,"Ohio","Ashland County",2,46,562,284,278
050,39,005,"Ohio","Ashland County",2,47,578,299,279
050,39,005,"Ohio","Ashland County",2,48,609,307,302
050,39,005,"Ohio","Ashland County",2,49,680,337,343
050,39,005,"Ohio","Ashland County",2,50,675,331,344
050,39,005,"Ohio","Ashland County",2,51,668,344,324
050,39,005,"Ohio","Ashland County",2,52,656,336,320
050,39,005,"Ohio","Ashland County",2,53,650,315,335
050,39,005,"Ohio","Ashland County",2,54,632,303,329
050,39,005,"Ohio","Ashland County",2,55,679,337,342
050,39,005,"Ohio","Ashland County",2,56,714,362,352
050,39,005,"Ohio","Ashland County",2,57,717,356,361
050,39,005,"Ohio","Ashland County",2,58,724,365,359
050,39,005,"Ohio","Ashland County",2,59,738,351,387
050,39,005,"Ohio","Ashland County",2,60,746,356,390
050,39,005,"Ohio","Ashland County",2,61,750,371,379
050,39,005,"Ohio","Ashland County",2,62,784,381,403
050,39,005,"Ohio","Ashland County",2,63,787,388,399
050,39,005,"Ohio","Ashland County",2,64,731,360,371
050,39,005,"Ohio","Ashland County",2,65,712,352,360
050,39,005,"Ohio","Ashland County",2,66,679,326,353
050,39,005,"Ohio","Ashland County",2,67,664,319,345
050,39,005,"Ohio","Ashland County",2,68,646,324,322
050,39,005,"Ohio","Ashland County",2,69,592,295,297
050,39,005,"Ohio","Ashland County",2,70,557,269,288
050,39,005,"Ohio","Ashland County",2,71,534,258,276
050,39,005,"Ohio","Ashland County",2,72,537,258,279
050,39,005,"Ohio","Ashland County",2,73,595,279,316
050,39,005,"Ohio","Ashland County",2,74,390,178,212
050,39,005,"Ohio","Ashland County",2,75,389,181,208
050,39,005,"Ohio","Ashland County",2,76,395,185,210
050,39,005,"Ohio","Ashland County",2,77,409,185,224
050,39,005,"Ohio","Ashland County",2,78,380,168,212
050,39,005,"Ohio","Ashland County",2,79,319,139,180
050,39,005,"Ohio","Ashland County",2,80,279,124,155
050,39,005,"Ohio","Ashland County",2,81,279,123,156
050,39,005,"Ohio","Ashland County",2,82,247,105,142
050,39,005,"Ohio","Ashland County",2,83,232,101,131
050,39,005,"Ohio","Ashland County",2,84,204,91,113
050,39,005,"Ohio","Ashland County",2,85,1213,426,787
050,39,005,"Ohio","Ashland County",3,0,548,299,249
050,39,005,"Ohio","Ashland County",3,1,575,286,289
050,39,005,"Ohio","Ashland County",3,2,589,288,301
050,39,005,"Ohio","Ashland County",3,3,605,306,299
050,39,005,"Ohio","Ashland County",3,4,617,312,305
050,39,005,"Ohio","Ashland County",3,5,602,291,311
050,39,005,"Ohio","Ashland County",3,6,631,313,318
050,39,005,"Ohio","Ashland County",3,7,666,346,320
050,39,005,"Ohio","Ashland County",3,8,684,355,329
050,39,005,"Ohio","Ashland County",3,9,625,315,310
050,39,005,"Ohio","Ashland County",3,10,650,332,318
050,39,005,"Ohio","Ashland County",3,11,666,346,320
050,39,005,"Ohio","Ashland County",3,12,684,355,329
050,39,005,"Ohio","Ashland County",3,13,716,370,346
050,39,005,"Ohio","Ashland County",3,14,731,375,356
050,39,005,"Ohio","Ashland County",3,15,749,393,356
050,39,005,"Ohio","Ashland County",3,16,724,363,361
050,39,005,"Ohio","Ashland County",3,17,718,361,357
050,39,005,"Ohio","Ashland County",3,18,654,326,328
050,39,005,"Ohio","Ashland County",3,19,620,321,299
050,39,005,"Ohio","Ashland County",3,20,684,344,340
050,39,005,"Ohio","Ashland County",3,21,690,337,353
050,39,005,"Ohio","Ashland County",3,22,640,318,322
050,39,005,"Ohio","Ashland County",3,23,596,307,289
050,39,005,"Ohio","Ashland County",3,24,607,308,299
050,39,005,"Ohio","Ashland County",3,25,600,304,296
050,39,005,"Ohio","Ashland County",3,26,610,309,301
050,39,005,"Ohio","Ashland County",3,27,643,341,302
050,39,005,"Ohio","Ashland County",3,28,603,315,288
050,39,005,"Ohio","Ashland County",3,29,596,299,297
050,39,005,"Ohio","Ashland County",3,30,591,299,292
050,39,005,"Ohio","Ashland County",3,31,599,312,287
050,39,005,"Ohio","Ashland County",3,32,586,303,283
050,39,005,"Ohio","Ashland County",3,33,546,270,276
050,39,005,"Ohio","Ashland County",3,34,562,284,278
050,39,005,"Ohio","Ashland County",3,35,610,304,306
050,39,005,"Ohio","Ashland County",3,36,657,336,321
050,39,005,"Ohio","Ashland County",3,37,624,311,313
050,39,005,"Ohio","Ashland County",3,38,614,314,300
050,39,005,"Ohio","Ashland County",3,39,599,313,286
050,39,005,"Ohio","Ashland County",3,40,612,327,285
050,39,005,"Ohio","Ashland County",3,41,598,310,288
050,39,005,"Ohio","Ashland County",3,42,586,298,288
050,39,005,"Ohio","Ashland County",3,43,573,294,279
050,39,005,"Ohio","Ashland County",3,44,587,289,298
050,39,005,"Ohio","Ashland County",3,45,563,283,280
050,39,005,"Ohio","Ashland County",3,46,608,306,302
050,39,005,"Ohio","Ashland County",3,47,550,277,273
050,39,005,"Ohio","Ashland County",3,48,579,297,282
050,39,005,"Ohio","Ashland County",3,49,609,308,301
050,39,005,"Ohio","Ashland County",3,50,664,325,339
050,39,005,"Ohio","Ashland County",3,51,676,329,347
050,39,005,"Ohio","Ashland County",3,52,668,341,327
050,39,005,"Ohio","Ashland County",3,53,656,339,317
050,39,005,"Ohio","Ashland County",3,54,651,321,330
050,39,005,"Ohio","Ashland County",3,55,638,305,333
050,39,005,"Ohio","Ashland County",3,56,659,329,330
050,39,005,"Ohio","Ashland County",3,57,715,359,356
050,39,005,"Ohio","Ashland County",3,58,725,361,364
050,39,005,"Ohio","Ashland County",3,59,727,375,352
050,39,005,"Ohio","Ashland County",3,60,746,353,393
050,39,005,"Ohio","Ashland County",3,61,737,346,391
050,39,005,"Ohio","Ashland County",3,62,741,369,372
050,39,005,"Ohio","Ashland County",3,63,779,377,402
050,39,005,"Ohio","Ashland County",3,64,780,373,407
050,39,005,"Ohio","Ashland County",3,65,733,358,375
050,39,005,"Ohio","Ashland County",3,66,702,340,362
050,39,005,"Ohio","Ashland County",3,67,665,315,350
050,39,005,"Ohio","Ashland County",3,68,655,316,339
050,39,005,"Ohio","Ashland County",3,69,637,319,318
050,39,005,"Ohio","Ashland County",3,70,571,283,288
050,39,005,"Ohio","Ashland County",3,71,528,248,280
050,39,005,"Ohio","Ashland County",3,72,534,257,277
050,39,005,"Ohio","Ashland County",3,73,518,248,270
050,39,005,"Ohio","Ashland County",3,74,575,264,311
050,39,005,"Ohio","Ashland County",3,75,372,172,200
050,39,005,"Ohio","Ashland County",3,76,377,169,208
050,39,005,"Ohio","Ashland County",3,77,374,173,201
050,39,005,"Ohio","Ashland County",3,78,391,175,216
050,39,005,"Ohio","Ashland County",3,79,352,146,206
050,39,005,"Ohio","Ashland County",3,80,292,132,160
050,39,005,"Ohio","Ashland County",3,81,282,122,160
050,39,005,"Ohio","Ashland County",3,82,253,104,149
050,39,005,"Ohio","Ashland County",3,83,229,89,140
050,39,005,"Ohio","Ashland County",3,84,193,86,107
050,39,005,"Ohio","Ashland County",3,85,1212,436,776
050,39,005,"Ohio","Ashland County",4,0,572,292,280
050,39,005,"Ohio","Ashland County",4,1,556,303,253
050,39,005,"Ohio","Ashland County",4,2,588,298,290
050,39,005,"Ohio","Ashland County",4,3,580,287,293
050,39,005,"Ohio","Ashland County",4,4,588,301,287
050,39,005,"Ohio","Ashland County",4,5,639,334,305
050,39,005,"Ohio","Ashland County",4,6,609,301,308
050,39,005,"Ohio","Ashland County",4,7,632,314,318
050,39,005,"Ohio","Ashland County",4,8,656,336,320
050,39,005,"Ohio","Ashland County",4,9,679,357,322
050,39,005,"Ohio","Ashland County",4,10,642,337,305
050,39,005,"Ohio","Ashland County",4,11,632,328,304
050,39,005,"Ohio","Ashland County",4,12,680,350,330
050,39,005,"Ohio","Ashland County",4,13,681,361,320
050,39,005,"Ohio","Ashland County",4,14,725,379,346
050,39,005,"Ohio","Ashland County",4,15,727,376,351
050,39,005,"Ohio","Ashland County",4,16,747,388,359
050,39,005,"Ohio","Ashland County",4,17,739,375,364
050,39,005,"Ohio","Ashland County",4,18,638,319,319
050,39,005,"Ohio","Ashland County",4,19,577,288,289
050,39,005,"Ohio","Ashland County",4,20,600,300,300
050,39,005,"Ohio","Ashland County",4,21,702,348,354
050,39,005,"Ohio","Ashland County",4,22,696,347,349
050,39,005,"Ohio","Ashland County",4,23,611,304,307
050,39,005,"Ohio","Ashland County",4,24,613,318,295
050,39,005,"Ohio","Ashland County",4,25,581,291,290
050,39,005,"Ohio","Ashland County",4,26,609,310,299
050,39,005,"Ohio","Ashland County",4,27,620,316,304
050,39,005,"Ohio","Ashland County",4,28,635,336,299
050,39,005,"Ohio","Ashland County",4,29,604,314,290
050,39,005,"Ohio","Ashland County",4,30,587,306,281
050,39,005,"Ohio","Ashland County",4,31,588,297,291
050,39,005,"Ohio","Ashland County",4,32,627,332,295
050,39,005,"Ohio","Ashland County",4,33,593,313,280
050,39,005,"Ohio","Ashland County",4,34,554,276,278
050,39,005,"Ohio","Ashland County",4,35,572,286,286
050,39,005,"Ohio","Ashland County",4,36,624,313,311
050,39,005,"Ohio","Ashland County",4,37,636,327,309
050,39,005,"Ohio","Ashland County",4,38,622,308,314
050,39,005,"Ohio","Ashland County",4,39,602,307,295
050,39,005,"Ohio","Ashland County",4,40,599,317,282
050,39,005,"Ohio","Ashland County",4,41,619,332,287
050,39,005,"Ohio","Ashland County",4,42,605,311,294
050,39,005,"Ohio","Ashland County",4,43,577,291,286
050,39,005,"Ohio","Ashland County",4,44,571,285,286
050,39,005,"Ohio","Ashland County",4,45,585,292,293
050,39,005,"Ohio","Ashland County",4,46,564,283,281
050,39,005,"Ohio","Ashland County",4,47,616,306,310
050,39,005,"Ohio","Ashland County",4,48,552,272,280
050,39,005,"Ohio","Ashland County",4,49,579,299,280
050,39,005,"Ohio","Ashland County",4,50,609,314,295
050,39,005,"Ohio","Ashland County",4,51,660,330,330
050,39,005,"Ohio","Ashland County",4,52,675,324,351
050,39,005,"Ohio","Ashland County",4,53,659,338,321
050,39,005,"Ohio","Ashland County",4,54,659,345,314
050,39,005,"Ohio","Ashland County",4,55,650,320,330
050,39,005,"Ohio","Ashland County",4,56,624,296,328
050,39,005,"Ohio","Ashland County",4,57,644,319,325
050,39,005,"Ohio","Ashland County",4,58,715,357,358
050,39,005,"Ohio","Ashland County",4,59,721,366,355
050,39,005,"Ohio","Ashland County",4,60,735,368,367
050,39,005,"Ohio","Ashland County",4,61,732,350,382
050,39,005,"Ohio","Ashland County",4,62,736,346,390
050,39,005,"Ohio","Ashland County",4,63,723,369,354
050,39,005,"Ohio","Ashland County",4,64,790,375,415
050,39,005,"Ohio","Ashland County",4,65,777,366,411
050,39,005,"Ohio","Ashland County",4,66,727,356,371
050,39,005,"Ohio","Ashland County",4,67,689,331,358
050,39,005,"Ohio","Ashland County",4,68,647,305,342
050,39,005,"Ohio","Ashland County",4,69,637,307,330
050,39,005,"Ohio","Ashland County",4,70,628,320,308
050,39,005,"Ohio","Ashland County",4,71,548,271,277
050,39,005,"Ohio","Ashland County",4,72,516,239,277
050,39,005,"Ohio","Ashland County",4,73,502,242,260
050,39,005,"Ohio","Ashland County",4,74,503,237,266
050,39,005,"Ohio","Ashland County",4,75,560,259,301
050,39,005,"Ohio","Ashland County",4,76,356,159,197
050,39,005,"Ohio","Ashland County",4,77,352,154,198
050,39,005,"Ohio","Ashland County",4,78,356,156,200
050,39,005,"Ohio","Ashland County",4,79,358,153,205
050,39,005,"Ohio","Ashland County",4,80,317,136,181
050,39,005,"Ohio","Ashland County",4,81,290,125,165
050,39,005,"Ohio","Ashland County",4,82,248,100,148
050,39,005,"Ohio","Ashland County",4,83,231,88,143
050,39,005,"Ohio","Ashland County",4,84,200,80,120
050,39,005,"Ohio","Ashland County",4,85,1220,439,781
050,39,005,"Ohio","Ashland County",5,0,568,290,278
050,39,005,"Ohio","Ashland County",5,1,597,301,296
050,39,005,"Ohio","Ashland County",5,2,547,299,248
050,39,005,"Ohio","Ashland County",5,3,589,290,299
050,39,005,"Ohio","Ashland County",5,4,587,284,303
050,39,005,"Ohio","Ashland County",5,5,590,305,285
050,39,005,"Ohio","Ashland County",5,6,648,339,309
050,39,005,"Ohio","Ashland County",5,7,606,293,313
050,39,005,"Ohio","Ashland County",5,8,640,323,317
050,39,005,"Ohio","Ashland County",5,9,665,336,329
050,39,005,"Ohio","Ashland County",5,10,706,373,333
050,39,005,"Ohio","Ashland County",5,11,650,338,312
050,39,005,"Ohio","Ashland County",5,12,652,333,319
050,39,005,"Ohio","Ashland County",5,13,681,357,324
050,39,005,"Ohio","Ashland County",5,14,695,375,320
050,39,005,"Ohio","Ashland County",5,15,736,393,343
050,39,005,"Ohio","Ashland County",5,16,738,387,351
050,39,005,"Ohio","Ashland County",5,17,750,395,355
050,39,005,"Ohio","Ashland County",5,18,620,325,295
050,39,005,"Ohio","Ashland County",5,19,516,256,260
050,39,005,"Ohio","Ashland County",5,20,553,263,290
050,39,005,"Ohio","Ashland County",5,21,597,294,303
050,39,005,"Ohio","Ashland County",5,22,694,341,353
050,39,005,"Ohio","Ashland County",5,23,691,344,347
050,39,005,"Ohio","Ashland County",5,24,645,319,326
050,39,005,"Ohio","Ashland County",5,25,627,324,303
050,39,005,"Ohio","Ashland County",5,26,592,315,277
050,39,005,"Ohio","Ashland County",5,27,603,307,296
050,39,005,"Ohio","Ashland County",5,28,624,323,301
050,39,005,"Ohio","Ashland County",5,29,652,349,303
050,39,005,"Ohio","Ashland County",5,30,606,307,299
050,39,005,"Ohio","Ashland County",5,31,642,331,311
050,39,005,"Ohio","Ashland County",5,32,590,310,280
050,39,005,"Ohio","Ashland County",5,33,640,338,302
050,39,005,"Ohio","Ashland County",5,34,590,308,282
050,39,005,"Ohio","Ashland County",5,35,580,288,292
050,39,005,"Ohio","Ashland County",5,36,592,295,297
050,39,005,"Ohio","Ashland County",5,37,614,303,311
050,39,005,"Ohio","Ashland County",5,38,638,332,306
050,39,005,"Ohio","Ashland County",5,39,633,318,315
050,39,005,"Ohio","Ashland County",5,40,615,313,302
050,39,005,"Ohio","Ashland County",5,41,595,306,289
050,39,005,"Ohio","Ashland County",5,42,628,337,291
050,39,005,"Ohio","Ashland County",5,43,608,313,295
050,39,005,"Ohio","Ashland County",5,44,585,290,295
050,39,005,"Ohio","Ashland County",5,45,577,289,288
050,39,005,"Ohio","Ashland County",5,46,597,306,291
050,39,005,"Ohio","Ashland County",5,47,566,283,283
050,39,005,"Ohio","Ashland County",5,48,620,308,312
050,39,005,"Ohio","Ashland County",5,49,562,278,284
050,39,005,"Ohio","Ashland County",5,50,583,305,278
050,39,005,"Ohio","Ashland County",5,51,617,313,304
050,39,005,"Ohio","Ashland County",5,52,663,336,327
050,39,005,"Ohio","Ashland County",5,53,672,331,341
050,39,005,"Ohio","Ashland County",5,54,653,336,317
050,39,005,"Ohio","Ashland County",5,55,674,347,327
050,39,005,"Ohio","Ashland County",5,56,642,311,331
050,39,005,"Ohio","Ashland County",5,57,617,292,325
050,39,005,"Ohio","Ashland County",5,58,666,330,336
050,39,005,"Ohio","Ashland County",5,59,719,367,352
050,39,005,"Ohio","Ashland County",5,60,728,366,362
050,39,005,"Ohio","Ashland County",5,61,717,363,354
050,39,005,"Ohio","Ashland County",5,62,731,348,383
050,39,005,"Ohio","Ashland County",5,63,723,349,374
050,39,005,"Ohio","Ashland County",5,64,724,362,362
050,39,005,"Ohio","Ashland County",5,65,793,379,414
050,39,005,"Ohio","Ashland County",5,66,779,365,414
050,39,005,"Ohio","Ashland County",5,67,705,346,359
050,39,005,"Ohio","Ashland County",5,68,674,327,347
050,39,005,"Ohio","Ashland County",5,69,635,298,337
050,39,005,"Ohio","Ashland County",5,70,621,298,323
050,39,005,"Ohio","Ashland County",5,71,599,307,292
050,39,005,"Ohio","Ashland County",5,72,547,265,282
050,39,005,"Ohio","Ashland County",5,73,494,229,265
050,39,005,"Ohio","Ashland County",5,74,496,234,262
050,39,005,"Ohio","Ashland County",5,75,477,225,252
050,39,005,"Ohio","Ashland County",5,76,540,246,294
050,39,005,"Ohio","Ashland County",5,77,332,146,186
050,39,005,"Ohio","Ashland County",5,78,332,142,190
050,39,005,"Ohio","Ashland County",5,79,316,133,183
050,39,005,"Ohio","Ashland County",5,80,334,142,192
050,39,005,"Ohio","Ashland County",5,81,314,130,184
050,39,005,"Ohio","Ashland County",5,82,270,108,162
050,39,005,"Ohio","Ashland County",5,83,231,85,146
050,39,005,"Ohio","Ashland County",5,84,196,75,121
050,39,005,"Ohio","Ashland County",5,85,1239,444,795
050,39,007,"Ohio","Ashtabula County",1,0,1072,550,522
050,39,007,"Ohio","Ashtabula County",1,1,1095,564,531
050,39,007,"Ohio","Ashtabula County",1,2,1144,611,533
050,39,007,"Ohio","Ashtabula County",1,3,1140,600,540
050,39,007,"Ohio","Ashtabula County",1,4,1087,558,529
050,39,007,"Ohio","Ashtabula County",1,5,1100,572,528
050,39,007,"Ohio","Ashtabula County",1,6,1145,583,562
050,39,007,"Ohio","Ashtabula County",1,7,1143,580,563
050,39,007,"Ohio","Ashtabula County",1,8,1126,566,560
050,39,007,"Ohio","Ashtabula County",1,9,1191,614,577
050,39,007,"Ohio","Ashtabula County",1,10,1272,684,588
050,39,007,"Ohio","Ashtabula County",1,11,1268,630,638
050,39,007,"Ohio","Ashtabula County",1,12,1325,688,637
050,39,007,"Ohio","Ashtabula County",1,13,1342,704,638
050,39,007,"Ohio","Ashtabula County",1,14,1301,659,642
050,39,007,"Ohio","Ashtabula County",1,15,1296,659,637
050,39,007,"Ohio","Ashtabula County",1,16,1312,684,628
050,39,007,"Ohio","Ashtabula County",1,17,1282,645,637
050,39,007,"Ohio","Ashtabula County",1,18,1150,607,543
050,39,007,"Ohio","Ashtabula County",1,19,979,545,434
050,39,007,"Ohio","Ashtabula County",1,20,1012,563,449
050,39,007,"Ohio","Ashtabula County",1,21,1016,544,472
050,39,007,"Ohio","Ashtabula County",1,22,1088,566,522
050,39,007,"Ohio","Ashtabula County",1,23,1115,589,526
050,39,007,"Ohio","Ashtabula County",1,24,1115,609,506
050,39,007,"Ohio","Ashtabula County",1,25,1116,623,493
050,39,007,"Ohio","Ashtabula County",1,26,1118,618,500
050,39,007,"Ohio","Ashtabula County",1,27,1193,649,544
050,39,007,"Ohio","Ashtabula County",1,28,1233,661,572
050,39,007,"Ohio","Ashtabula County",1,29,1178,641,537
050,39,007,"Ohio","Ashtabula County",1,30,1155,626,529
050,39,007,"Ohio","Ashtabula County",1,31,1164,620,544
050,39,007,"Ohio","Ashtabula County",1,32,1081,568,513
050,39,007,"Ohio","Ashtabula County",1,33,1101,583,518
050,39,007,"Ohio","Ashtabula County",1,34,1102,572,530
050,39,007,"Ohio","Ashtabula County",1,35,1092,582,510
050,39,007,"Ohio","Ashtabula County",1,36,1045,551,494
050,39,007,"Ohio","Ashtabula County",1,37,1097,589,508
050,39,007,"Ohio","Ashtabula County",1,38,1159,605,554
050,39,007,"Ohio","Ashtabula County",1,39,1106,557,549
050,39,007,"Ohio","Ashtabula County",1,40,1112,567,545
050,39,007,"Ohio","Ashtabula County",1,41,1100,553,547
050,39,007,"Ohio","Ashtabula County",1,42,1094,560,534
050,39,007,"Ohio","Ashtabula County",1,43,1073,569,504
050,39,007,"Ohio","Ashtabula County",1,44,1069,558,511
050,39,007,"Ohio","Ashtabula County",1,45,1108,554,554
050,39,007,"Ohio","Ashtabula County",1,46,1171,613,558
050,39,007,"Ohio","Ashtabula County",1,47,1154,605,549
050,39,007,"Ohio","Ashtabula County",1,48,1312,690,622
050,39,007,"Ohio","Ashtabula County",1,49,1391,730,661
050,39,007,"Ohio","Ashtabula County",1,50,1289,663,626
050,39,007,"Ohio","Ashtabula County",1,51,1330,704,626
050,39,007,"Ohio","Ashtabula County",1,52,1279,656,623
050,39,007,"Ohio","Ashtabula County",1,53,1330,652,678
050,39,007,"Ohio","Ashtabula County",1,54,1315,652,663
050,39,007,"Ohio","Ashtabula County",1,55,1424,732,692
050,39,007,"Ohio","Ashtabula County",1,56,1433,740,693
050,39,007,"Ohio","Ashtabula County",1,57,1467,768,699
050,39,007,"Ohio","Ashtabula County",1,58,1491,749,742
050,39,007,"Ohio","Ashtabula County",1,59,1448,714,734
050,39,007,"Ohio","Ashtabula County",1,60,1437,722,715
050,39,007,"Ohio","Ashtabula County",1,61,1436,720,716
050,39,007,"Ohio","Ashtabula County",1,62,1497,753,744
050,39,007,"Ohio","Ashtabula County",1,63,1481,735,746
050,39,007,"Ohio","Ashtabula County",1,64,1422,698,724
050,39,007,"Ohio","Ashtabula County",1,65,1420,686,734
050,39,007,"Ohio","Ashtabula County",1,66,1377,703,674
050,39,007,"Ohio","Ashtabula County",1,67,1289,653,636
050,39,007,"Ohio","Ashtabula County",1,68,1242,609,633
050,39,007,"Ohio","Ashtabula County",1,69,1092,531,561
050,39,007,"Ohio","Ashtabula County",1,70,1061,504,557
050,39,007,"Ohio","Ashtabula County",1,71,1062,516,546
050,39,007,"Ohio","Ashtabula County",1,72,1043,493,550
050,39,007,"Ohio","Ashtabula County",1,73,1092,500,592
050,39,007,"Ohio","Ashtabula County",1,74,723,339,384
050,39,007,"Ohio","Ashtabula County",1,75,710,336,374
050,39,007,"Ohio","Ashtabula County",1,76,725,362,363
050,39,007,"Ohio","Ashtabula County",1,77,742,366,376
050,39,007,"Ohio","Ashtabula County",1,78,620,284,336
050,39,007,"Ohio","Ashtabula County",1,79,571,270,301
050,39,007,"Ohio","Ashtabula County",1,80,472,213,259
050,39,007,"Ohio","Ashtabula County",1,81,447,211,236
050,39,007,"Ohio","Ashtabula County",1,82,421,197,224
050,39,007,"Ohio","Ashtabula County",1,83,390,173,217
050,39,007,"Ohio","Ashtabula County",1,84,323,135,188
050,39,007,"Ohio","Ashtabula County",1,85,2026,711,1315
050,39,007,"Ohio","Ashtabula County",2,0,1073,556,517
050,39,007,"Ohio","Ashtabula County",2,1,1087,559,528
050,39,007,"Ohio","Ashtabula County",2,2,1134,600,534
050,39,007,"Ohio","Ashtabula County",2,3,1134,598,536
050,39,007,"Ohio","Ashtabula County",2,4,1102,571,531
050,39,007,"Ohio","Ashtabula County",2,5,1099,571,528
050,39,007,"Ohio","Ashtabula County",2,6,1140,583,557
050,39,007,"Ohio","Ashtabula County",2,7,1141,578,563
050,39,007,"Ohio","Ashtabula County",2,8,1127,568,559
050,39,007,"Ohio","Ashtabula County",2,9,1175,602,573
050,39,007,"Ohio","Ashtabula County",2,10,1249,663,586
050,39,007,"Ohio","Ashtabula County",2,11,1263,640,623
050,39,007,"Ohio","Ashtabula County",2,12,1319,679,640
050,39,007,"Ohio","Ashtabula County",2,13,1337,700,637
050,39,007,"Ohio","Ashtabula County",2,14,1314,671,643
050,39,007,"Ohio","Ashtabula County",2,15,1299,659,640
050,39,007,"Ohio","Ashtabula County",2,16,1308,678,630
050,39,007,"Ohio","Ashtabula County",2,17,1289,655,634
050,39,007,"Ohio","Ashtabula County",2,18,1130,597,533
050,39,007,"Ohio","Ashtabula County",2,19,981,542,439
050,39,007,"Ohio","Ashtabula County",2,20,1028,570,458
050,39,007,"Ohio","Ashtabula County",2,21,1023,555,468
050,39,007,"Ohio","Ashtabula County",2,22,1080,564,516
050,39,007,"Ohio","Ashtabula County",2,23,1122,592,530
050,39,007,"Ohio","Ashtabula County",2,24,1116,604,512
050,39,007,"Ohio","Ashtabula County",2,25,1119,624,495
050,39,007,"Ohio","Ashtabula County",2,26,1120,621,499
050,39,007,"Ohio","Ashtabula County",2,27,1171,635,536
050,39,007,"Ohio","Ashtabula County",2,28,1229,661,568
050,39,007,"Ohio","Ashtabula County",2,29,1189,645,544
050,39,007,"Ohio","Ashtabula County",2,30,1168,633,535
050,39,007,"Ohio","Ashtabula County",2,31,1167,627,540
050,39,007,"Ohio","Ashtabula County",2,32,1088,571,517
050,39,007,"Ohio","Ashtabula County",2,33,1091,577,514
050,39,007,"Ohio","Ashtabula County",2,34,1098,573,525
050,39,007,"Ohio","Ashtabula County",2,35,1102,584,518
050,39,007,"Ohio","Ashtabula County",2,36,1046,552,494
050,39,007,"Ohio","Ashtabula County",2,37,1086,581,505
050,39,007,"Ohio","Ashtabula County",2,38,1150,604,546
050,39,007,"Ohio","Ashtabula County",2,39,1115,566,549
050,39,007,"Ohio","Ashtabula County",2,40,1103,557,546
050,39,007,"Ohio","Ashtabula County",2,41,1106,560,546
050,39,007,"Ohio","Ashtabula County",2,42,1090,556,534
050,39,007,"Ohio","Ashtabula County",2,43,1085,569,516
050,39,007,"Ohio","Ashtabula County",2,44,1062,558,504
050,39,007,"Ohio","Ashtabula County",2,45,1105,557,548
050,39,007,"Ohio","Ashtabula County",2,46,1160,603,557
050,39,007,"Ohio","Ashtabula County",2,47,1150,600,550
050,39,007,"Ohio","Ashtabula County",2,48,1275,674,601
050,39,007,"Ohio","Ashtabula County",2,49,1373,719,654
050,39,007,"Ohio","Ashtabula County",2,50,1312,680,632
050,39,007,"Ohio","Ashtabula County",2,51,1316,694,622
050,39,007,"Ohio","Ashtabula County",2,52,1285,661,624
050,39,007,"Ohio","Ashtabula County",2,53,1316,653,663
050,39,007,"Ohio","Ashtabula County",2,54,1306,647,659
050,39,007,"Ohio","Ashtabula County",2,55,1392,710,682
050,39,007,"Ohio","Ashtabula County",2,56,1439,741,698
050,39,007,"Ohio","Ashtabula County",2,57,1459,761,698
050,39,007,"Ohio","Ashtabula County",2,58,1476,745,731
050,39,007,"Ohio","Ashtabula County",2,59,1462,723,739
050,39,007,"Ohio","Ashtabula County",2,60,1430,718,712
050,39,007,"Ohio","Ashtabula County",2,61,1427,712,715
050,39,007,"Ohio","Ashtabula County",2,62,1478,741,737
050,39,007,"Ohio","Ashtabula County",2,63,1492,742,750
050,39,007,"Ohio","Ashtabula County",2,64,1418,696,722
050,39,007,"Ohio","Ashtabula County",2,65,1416,684,732
050,39,007,"Ohio","Ashtabula County",2,66,1389,700,689
050,39,007,"Ohio","Ashtabula County",2,67,1300,657,643
050,39,007,"Ohio","Ashtabula County",2,68,1243,616,627
050,39,007,"Ohio","Ashtabula County",2,69,1127,550,577
050,39,007,"Ohio","Ashtabula County",2,70,1065,507,558
050,39,007,"Ohio","Ashtabula County",2,71,1052,507,545
050,39,007,"Ohio","Ashtabula County",2,72,1030,491,539
050,39,007,"Ohio","Ashtabula County",2,73,1122,519,603
050,39,007,"Ohio","Ashtabula County",2,74,753,348,405
050,39,007,"Ohio","Ashtabula County",2,75,710,334,376
050,39,007,"Ohio","Ashtabula County",2,76,711,353,358
050,39,007,"Ohio","Ashtabula County",2,77,753,371,382
050,39,007,"Ohio","Ashtabula County",2,78,631,294,337
050,39,007,"Ohio","Ashtabula County",2,79,569,264,305
050,39,007,"Ohio","Ashtabula County",2,80,492,226,266
050,39,007,"Ohio","Ashtabula County",2,81,445,209,236
050,39,007,"Ohio","Ashtabula County",2,82,424,200,224
050,39,007,"Ohio","Ashtabula County",2,83,390,174,216
050,39,007,"Ohio","Ashtabula County",2,84,329,139,190
050,39,007,"Ohio","Ashtabula County",2,85,2018,718,1300
050,39,007,"Ohio","Ashtabula County",3,0,981,526,455
050,39,007,"Ohio","Ashtabula County",3,1,1050,530,520
050,39,007,"Ohio","Ashtabula County",3,2,1097,564,533
050,39,007,"Ohio","Ashtabula County",3,3,1143,607,536
050,39,007,"Ohio","Ashtabula County",3,4,1160,622,538
050,39,007,"Ohio","Ashtabula County",3,5,1101,571,530
050,39,007,"Ohio","Ashtabula County",3,6,1119,585,534
050,39,007,"Ohio","Ashtabula County",3,7,1163,596,567
050,39,007,"Ohio","Ashtabula County",3,8,1139,573,566
050,39,007,"Ohio","Ashtabula County",3,9,1141,587,554
050,39,007,"Ohio","Ashtabula County",3,10,1177,605,572
050,39,007,"Ohio","Ashtabula County",3,11,1240,660,580
050,39,007,"Ohio","Ashtabula County",3,12,1280,658,622
050,39,007,"Ohio","Ashtabula County",3,13,1314,680,634
050,39,007,"Ohio","Ashtabula County",3,14,1350,706,644
050,39,007,"Ohio","Ashtabula County",3,15,1316,674,642
050,39,007,"Ohio","Ashtabula County",3,16,1289,656,633
050,39,007,"Ohio","Ashtabula County",3,17,1303,675,628
050,39,007,"Ohio","Ashtabula County",3,18,1118,589,529
050,39,007,"Ohio","Ashtabula County",3,19,967,534,433
050,39,007,"Ohio","Ashtabula County",3,20,1060,588,472
050,39,007,"Ohio","Ashtabula County",3,21,1077,606,471
050,39,007,"Ohio","Ashtabula County",3,22,1070,585,485
050,39,007,"Ohio","Ashtabula County",3,23,1131,601,530
050,39,007,"Ohio","Ashtabula County",3,24,1122,607,515
050,39,007,"Ohio","Ashtabula County",3,25,1146,635,511
050,39,007,"Ohio","Ashtabula County",3,26,1124,620,504
050,39,007,"Ohio","Ashtabula County",3,27,1110,609,501
050,39,007,"Ohio","Ashtabula County",3,28,1216,661,555
050,39,007,"Ohio","Ashtabula County",3,29,1232,680,552
050,39,007,"Ohio","Ashtabula County",3,30,1225,650,575
050,39,007,"Ohio","Ashtabula County",3,31,1241,696,545
050,39,007,"Ohio","Ashtabula County",3,32,1123,597,526
050,39,007,"Ohio","Ashtabula County",3,33,1088,568,520
050,39,007,"Ohio","Ashtabula County",3,34,1105,585,520
050,39,007,"Ohio","Ashtabula County",3,35,1103,579,524
050,39,007,"Ohio","Ashtabula County",3,36,1092,572,520
050,39,007,"Ohio","Ashtabula County",3,37,1063,561,502
050,39,007,"Ohio","Ashtabula County",3,38,1090,584,506
050,39,007,"Ohio","Ashtabula County",3,39,1161,612,549
050,39,007,"Ohio","Ashtabula County",3,40,1094,541,553
050,39,007,"Ohio","Ashtabula County",3,41,1132,593,539
050,39,007,"Ohio","Ashtabula County",3,42,1119,567,552
050,39,007,"Ohio","Ashtabula County",3,43,1058,534,524
050,39,007,"Ohio","Ashtabula County",3,44,1084,571,513
050,39,007,"Ohio","Ashtabula County",3,45,1071,559,512
050,39,007,"Ohio","Ashtabula County",3,46,1150,598,552
050,39,007,"Ohio","Ashtabula County",3,47,1134,573,561
050,39,007,"Ohio","Ashtabula County",3,48,1165,626,539
050,39,007,"Ohio","Ashtabula County",3,49,1251,656,595
050,39,007,"Ohio","Ashtabula County",3,50,1368,706,662
050,39,007,"Ohio","Ashtabula County",3,51,1333,696,637
050,39,007,"Ohio","Ashtabula County",3,52,1314,684,630
050,39,007,"Ohio","Ashtabula County",3,53,1280,657,623
050,39,007,"Ohio","Ashtabula County",3,54,1296,648,648
050,39,007,"Ohio","Ashtabula County",3,55,1311,656,655
050,39,007,"Ohio","Ashtabula County",3,56,1400,713,687
050,39,007,"Ohio","Ashtabula County",3,57,1424,730,694
050,39,007,"Ohio","Ashtabula County",3,58,1437,750,687
050,39,007,"Ohio","Ashtabula County",3,59,1502,754,748
050,39,007,"Ohio","Ashtabula County",3,60,1450,728,722
050,39,007,"Ohio","Ashtabula County",3,61,1432,706,726
050,39,007,"Ohio","Ashtabula County",3,62,1431,706,725
050,39,007,"Ohio","Ashtabula County",3,63,1458,729,729
050,39,007,"Ohio","Ashtabula County",3,64,1464,729,735
050,39,007,"Ohio","Ashtabula County",3,65,1398,676,722
050,39,007,"Ohio","Ashtabula County",3,66,1391,667,724
050,39,007,"Ohio","Ashtabula County",3,67,1339,680,659
050,39,007,"Ohio","Ashtabula County",3,68,1288,654,634
050,39,007,"Ohio","Ashtabula County",3,69,1189,588,601
050,39,007,"Ohio","Ashtabula County",3,70,1096,525,571
050,39,007,"Ohio","Ashtabula County",3,71,1025,490,535
050,39,007,"Ohio","Ashtabula County",3,72,1026,494,532
050,39,007,"Ohio","Ashtabula County",3,73,992,471,521
050,39,007,"Ohio","Ashtabula County",3,74,1077,499,578
050,39,007,"Ohio","Ashtabula County",3,75,713,329,384
050,39,007,"Ohio","Ashtabula County",3,76,680,312,368
050,39,007,"Ohio","Ashtabula County",3,77,658,321,337
050,39,007,"Ohio","Ashtabula County",3,78,714,354,360
050,39,007,"Ohio","Ashtabula County",3,79,569,260,309
050,39,007,"Ohio","Ashtabula County",3,80,533,257,276
050,39,007,"Ohio","Ashtabula County",3,81,477,220,257
050,39,007,"Ohio","Ashtabula County",3,82,409,189,220
050,39,007,"Ohio","Ashtabula County",3,83,388,178,210
050,39,007,"Ohio","Ashtabula County",3,84,350,154,196
050,39,007,"Ohio","Ashtabula County",3,85,1942,700,1242
050,39,007,"Ohio","Ashtabula County",4,0,1046,524,522
050,39,007,"Ohio","Ashtabula County",4,1,1019,529,490
050,39,007,"Ohio","Ashtabula County",4,2,1073,542,531
050,39,007,"Ohio","Ashtabula County",4,3,1072,561,511
050,39,007,"Ohio","Ashtabula County",4,4,1157,622,535
050,39,007,"Ohio","Ashtabula County",4,5,1149,609,540
050,39,007,"Ohio","Ashtabula County",4,6,1121,586,535
050,39,007,"Ohio","Ashtabula County",4,7,1116,579,537
050,39,007,"Ohio","Ashtabula County",4,8,1150,583,567
050,39,007,"Ohio","Ashtabula County",4,9,1130,569,561
050,39,007,"Ohio","Ashtabula County",4,10,1149,582,567
050,39,007,"Ohio","Ashtabula County",4,11,1181,607,574
050,39,007,"Ohio","Ashtabula County",4,12,1223,651,572
050,39,007,"Ohio","Ashtabula County",4,13,1302,663,639
050,39,007,"Ohio","Ashtabula County",4,14,1317,681,636
050,39,007,"Ohio","Ashtabula County",4,15,1379,725,654
050,39,007,"Ohio","Ashtabula County",4,16,1326,687,639
050,39,007,"Ohio","Ashtabula County",4,17,1289,651,638
050,39,007,"Ohio","Ashtabula County",4,18,1104,596,508
050,39,007,"Ohio","Ashtabula County",4,19,909,494,415
050,39,007,"Ohio","Ashtabula County",4,20,1012,554,458
050,39,007,"Ohio","Ashtabula County",4,21,1078,612,466
050,39,007,"Ohio","Ashtabula County",4,22,1126,630,496
050,39,007,"Ohio","Ashtabula County",4,23,1108,606,502
050,39,007,"Ohio","Ashtabula County",4,24,1131,617,514
050,39,007,"Ohio","Ashtabula County",4,25,1122,614,508
050,39,007,"Ohio","Ashtabula County",4,26,1150,621,529
050,39,007,"Ohio","Ashtabula County",4,27,1103,606,497
050,39,007,"Ohio","Ashtabula County",4,28,1103,617,486
050,39,007,"Ohio","Ashtabula County",4,29,1203,669,534
050,39,007,"Ohio","Ashtabula County",4,30,1204,668,536
050,39,007,"Ohio","Ashtabula County",4,31,1259,673,586
050,39,007,"Ohio","Ashtabula County",4,32,1202,661,541
050,39,007,"Ohio","Ashtabula County",4,33,1111,585,526
050,39,007,"Ohio","Ashtabula County",4,34,1082,564,518
050,39,007,"Ohio","Ashtabula County",4,35,1135,607,528
050,39,007,"Ohio","Ashtabula County",4,36,1086,563,523
050,39,007,"Ohio","Ashtabula County",4,37,1087,565,522
050,39,007,"Ohio","Ashtabula County",4,38,1089,591,498
050,39,007,"Ohio","Ashtabula County",4,39,1094,591,503
050,39,007,"Ohio","Ashtabula County",4,40,1139,581,558
050,39,007,"Ohio","Ashtabula County",4,41,1135,571,564
050,39,007,"Ohio","Ashtabula County",4,42,1151,602,549
050,39,007,"Ohio","Ashtabula County",4,43,1083,550,533
050,39,007,"Ohio","Ashtabula County",4,44,1059,541,518
050,39,007,"Ohio","Ashtabula County",4,45,1067,557,510
050,39,007,"Ohio","Ashtabula County",4,46,1113,603,510
050,39,007,"Ohio","Ashtabula County",4,47,1122,558,564
050,39,007,"Ohio","Ashtabula County",4,48,1151,586,565
050,39,007,"Ohio","Ashtabula County",4,49,1145,603,542
050,39,007,"Ohio","Ashtabula County",4,50,1224,640,584
050,39,007,"Ohio","Ashtabula County",4,51,1384,724,660
050,39,007,"Ohio","Ashtabula County",4,52,1313,675,638
050,39,007,"Ohio","Ashtabula County",4,53,1320,685,635
050,39,007,"Ohio","Ashtabula County",4,54,1272,656,616
050,39,007,"Ohio","Ashtabula County",4,55,1289,648,641
050,39,007,"Ohio","Ashtabula County",4,56,1313,649,664
050,39,007,"Ohio","Ashtabula County",4,57,1372,698,674
050,39,007,"Ohio","Ashtabula County",4,58,1419,723,696
050,39,007,"Ohio","Ashtabula County",4,59,1432,749,683
050,39,007,"Ohio","Ashtabula County",4,60,1493,753,740
050,39,007,"Ohio","Ashtabula County",4,61,1457,724,733
050,39,007,"Ohio","Ashtabula County",4,62,1427,702,725
050,39,007,"Ohio","Ashtabula County",4,63,1403,687,716
050,39,007,"Ohio","Ashtabula County",4,64,1430,715,715
050,39,007,"Ohio","Ashtabula County",4,65,1431,699,732
050,39,007,"Ohio","Ashtabula County",4,66,1382,674,708
050,39,007,"Ohio","Ashtabula County",4,67,1360,651,709
050,39,007,"Ohio","Ashtabula County",4,68,1303,668,635
050,39,007,"Ohio","Ashtabula County",4,69,1253,631,622
050,39,007,"Ohio","Ashtabula County",4,70,1162,563,599
050,39,007,"Ohio","Ashtabula County",4,71,1061,517,544
050,39,007,"Ohio","Ashtabula County",4,72,988,473,515
050,39,007,"Ohio","Ashtabula County",4,73,996,476,520
050,39,007,"Ohio","Ashtabula County",4,74,951,449,502
050,39,007,"Ohio","Ashtabula County",4,75,1016,475,541
050,39,007,"Ohio","Ashtabula County",4,76,674,311,363
050,39,007,"Ohio","Ashtabula County",4,77,640,285,355
050,39,007,"Ohio","Ashtabula County",4,78,635,310,325
050,39,007,"Ohio","Ashtabula County",4,79,646,316,330
050,39,007,"Ohio","Ashtabula County",4,80,528,246,282
050,39,007,"Ohio","Ashtabula County",4,81,498,233,265
050,39,007,"Ohio","Ashtabula County",4,82,444,208,236
050,39,007,"Ohio","Ashtabula County",4,83,368,163,205
050,39,007,"Ohio","Ashtabula County",4,84,337,152,185
050,39,007,"Ohio","Ashtabula County",4,85,1877,688,1189
050,39,007,"Ohio","Ashtabula County",5,0,997,497,500
050,39,007,"Ohio","Ashtabula County",5,1,1089,527,562
050,39,007,"Ohio","Ashtabula County",5,2,1018,529,489
050,39,007,"Ohio","Ashtabula County",5,3,1080,542,538
050,39,007,"Ohio","Ashtabula County",5,4,1082,557,525
050,39,007,"Ohio","Ashtabula County",5,5,1149,622,527
050,39,007,"Ohio","Ashtabula County",5,6,1171,622,549
050,39,007,"Ohio","Ashtabula County",5,7,1114,585,529
050,39,007,"Ohio","Ashtabula County",5,8,1126,593,533
050,39,007,"Ohio","Ashtabula County",5,9,1167,591,576
050,39,007,"Ohio","Ashtabula County",5,10,1122,559,563
050,39,007,"Ohio","Ashtabula County",5,11,1151,596,555
050,39,007,"Ohio","Ashtabula County",5,12,1208,623,585
050,39,007,"Ohio","Ashtabula County",5,13,1250,671,579
050,39,007,"Ohio","Ashtabula County",5,14,1311,666,645
050,39,007,"Ohio","Ashtabula County",5,15,1337,679,658
050,39,007,"Ohio","Ashtabula County",5,16,1376,727,649
050,39,007,"Ohio","Ashtabula County",5,17,1313,681,632
050,39,007,"Ohio","Ashtabula County",5,18,1078,567,511
050,39,007,"Ohio","Ashtabula County",5,19,901,509,392
050,39,007,"Ohio","Ashtabula County",5,20,1000,532,468
050,39,007,"Ohio","Ashtabula County",5,21,1050,577,473
050,39,007,"Ohio","Ashtabula County",5,22,1094,600,494
050,39,007,"Ohio","Ashtabula County",5,23,1183,660,523
050,39,007,"Ohio","Ashtabula County",5,24,1117,609,508
050,39,007,"Ohio","Ashtabula County",5,25,1130,623,507
050,39,007,"Ohio","Ashtabula County",5,26,1115,610,505
050,39,007,"Ohio","Ashtabula County",5,27,1133,618,515
050,39,007,"Ohio","Ashtabula County",5,28,1100,607,493
050,39,007,"Ohio","Ashtabula County",5,29,1107,625,482
050,39,007,"Ohio","Ashtabula County",5,30,1179,644,535
050,39,007,"Ohio","Ashtabula County",5,31,1257,718,539
050,39,007,"Ohio","Ashtabula County",5,32,1234,651,583
050,39,007,"Ohio","Ashtabula County",5,33,1212,659,553
050,39,007,"Ohio","Ashtabula County",5,34,1120,587,533
050,39,007,"Ohio","Ashtabula County",5,35,1088,576,512
050,39,007,"Ohio","Ashtabula County",5,36,1132,606,526
050,39,007,"Ohio","Ashtabula County",5,37,1095,564,531
050,39,007,"Ohio","Ashtabula County",5,38,1108,587,521
050,39,007,"Ohio","Ashtabula County",5,39,1085,592,493
050,39,007,"Ohio","Ashtabula County",5,40,1063,554,509
050,39,007,"Ohio","Ashtabula County",5,41,1161,595,566
050,39,007,"Ohio","Ashtabula County",5,42,1161,583,578
050,39,007,"Ohio","Ashtabula County",5,43,1124,581,543
050,39,007,"Ohio","Ashtabula County",5,44,1082,555,527
050,39,007,"Ohio","Ashtabula County",5,45,1056,535,521
050,39,007,"Ohio","Ashtabula County",5,46,1117,594,523
050,39,007,"Ohio","Ashtabula County",5,47,1096,577,519
050,39,007,"Ohio","Ashtabula County",5,48,1147,584,563
050,39,007,"Ohio","Ashtabula County",5,49,1135,562,573
050,39,007,"Ohio","Ashtabula County",5,50,1128,587,541
050,39,007,"Ohio","Ashtabula County",5,51,1251,664,587
050,39,007,"Ohio","Ashtabula County",5,52,1371,704,667
050,39,007,"Ohio","Ashtabula County",5,53,1313,673,640
050,39,007,"Ohio","Ashtabula County",5,54,1279,658,621
050,39,007,"Ohio","Ashtabula County",5,55,1280,662,618
050,39,007,"Ohio","Ashtabula County",5,56,1295,651,644
050,39,007,"Ohio","Ashtabula County",5,57,1301,643,658
050,39,007,"Ohio","Ashtabula County",5,58,1361,694,667
050,39,007,"Ohio","Ashtabula County",5,59,1425,722,703
050,39,007,"Ohio","Ashtabula County",5,60,1424,746,678
050,39,007,"Ohio","Ashtabula County",5,61,1489,741,748
050,39,007,"Ohio","Ashtabula County",5,62,1456,728,728
050,39,007,"Ohio","Ashtabula County",5,63,1407,684,723
050,39,007,"Ohio","Ashtabula County",5,64,1375,672,703
050,39,007,"Ohio","Ashtabula County",5,65,1413,695,718
050,39,007,"Ohio","Ashtabula County",5,66,1419,692,727
050,39,007,"Ohio","Ashtabula County",5,67,1355,653,702
050,39,007,"Ohio","Ashtabula County",5,68,1332,644,688
050,39,007,"Ohio","Ashtabula County",5,69,1261,642,619
050,39,007,"Ohio","Ashtabula County",5,70,1228,608,620
050,39,007,"Ohio","Ashtabula County",5,71,1115,542,573
050,39,007,"Ohio","Ashtabula County",5,72,1043,504,539
050,39,007,"Ohio","Ashtabula County",5,73,976,464,512
050,39,007,"Ohio","Ashtabula County",5,74,974,468,506
050,39,007,"Ohio","Ashtabula County",5,75,905,428,477
050,39,007,"Ohio","Ashtabula County",5,76,959,439,520
050,39,007,"Ohio","Ashtabula County",5,77,645,292,353
050,39,007,"Ohio","Ashtabula County",5,78,617,277,340
050,39,007,"Ohio","Ashtabula County",5,79,575,274,301
050,39,007,"Ohio","Ashtabula County",5,80,602,299,303
050,39,007,"Ohio","Ashtabula County",5,81,488,224,264
050,39,007,"Ohio","Ashtabula County",5,82,462,220,242
050,39,007,"Ohio","Ashtabula County",5,83,401,182,219
050,39,007,"Ohio","Ashtabula County",5,84,324,143,181
050,39,007,"Ohio","Ashtabula County",5,85,1875,706,1169
050,39,009,"Ohio","Athens County",1,0,459,235,224
050,39,009,"Ohio","Athens County",1,1,441,233,208
050,39,009,"Ohio","Athens County",1,2,485,256,229
050,39,009,"Ohio","Athens County",1,3,496,256,240
050,39,009,"Ohio","Athens County",1,4,494,263,231
050,39,009,"Ohio","Athens County",1,5,469,252,217
050,39,009,"Ohio","Athens County",1,6,505,255,250
050,39,009,"Ohio","Athens County",1,7,509,249,260
050,39,009,"Ohio","Athens County",1,8,522,278,244
050,39,009,"Ohio","Athens County",1,9,503,258,245
050,39,009,"Ohio","Athens County",1,10,508,262,246
050,39,009,"Ohio","Athens County",1,11,515,264,251
050,39,009,"Ohio","Athens County",1,12,556,286,270
050,39,009,"Ohio","Athens County",1,13,521,265,256
050,39,009,"Ohio","Athens County",1,14,559,280,279
050,39,009,"Ohio","Athens County",1,15,562,286,276
050,39,009,"Ohio","Athens County",1,16,617,314,303
050,39,009,"Ohio","Athens County",1,17,568,286,282
050,39,009,"Ohio","Athens County",1,18,1781,752,1029
050,39,009,"Ohio","Athens County",1,19,4023,1951,2072
050,39,009,"Ohio","Athens County",1,20,3455,1657,1798
050,39,009,"Ohio","Athens County",1,21,2776,1390,1386
050,39,009,"Ohio","Athens County",1,22,2128,1104,1024
050,39,009,"Ohio","Athens County",1,23,1361,727,634
050,39,009,"Ohio","Athens County",1,24,1058,592,466
050,39,009,"Ohio","Athens County",1,25,881,499,382
050,39,009,"Ohio","Athens County",1,26,773,417,356
050,39,009,"Ohio","Athens County",1,27,728,374,354
050,39,009,"Ohio","Athens County",1,28,711,378,333
050,39,009,"Ohio","Athens County",1,29,728,371,357
050,39,009,"Ohio","Athens County",1,30,769,405,364
050,39,009,"Ohio","Athens County",1,31,813,445,368
050,39,009,"Ohio","Athens County",1,32,753,400,353
050,39,009,"Ohio","Athens County",1,33,697,382,315
050,39,009,"Ohio","Athens County",1,34,663,324,339
050,39,009,"Ohio","Athens County",1,35,647,336,311
050,39,009,"Ohio","Athens County",1,36,648,346,302
050,39,009,"Ohio","Athens County",1,37,684,353,331
050,39,009,"Ohio","Athens County",1,38,690,331,359
050,39,009,"Ohio","Athens County",1,39,729,362,367
050,39,009,"Ohio","Athens County",1,40,684,330,354
050,39,009,"Ohio","Athens County",1,41,708,371,337
050,39,009,"Ohio","Athens County",1,42,666,350,316
050,39,009,"Ohio","Athens County",1,43,642,328,314
050,39,009,"Ohio","Athens County",1,44,582,305,277
050,39,009,"Ohio","Athens County",1,45,569,285,284
050,39,009,"Ohio","Athens County",1,46,565,305,260
050,39,009,"Ohio","Athens County",1,47,606,317,289
050,39,009,"Ohio","Athens County",1,48,681,346,335
050,39,009,"Ohio","Athens County",1,49,734,377,357
050,39,009,"Ohio","Athens County",1,50,643,313,330
050,39,009,"Ohio","Athens County",1,51,644,307,337
050,39,009,"Ohio","Athens County",1,52,650,318,332
050,39,009,"Ohio","Athens County",1,53,650,328,322
050,39,009,"Ohio","Athens County",1,54,637,316,321
050,39,009,"Ohio","Athens County",1,55,699,353,346
050,39,009,"Ohio","Athens County",1,56,719,354,365
050,39,009,"Ohio","Athens County",1,57,744,372,372
050,39,009,"Ohio","Athens County",1,58,728,342,386
050,39,009,"Ohio","Athens County",1,59,725,371,354
050,39,009,"Ohio","Athens County",1,60,716,355,361
050,39,009,"Ohio","Athens County",1,61,718,373,345
050,39,009,"Ohio","Athens County",1,62,768,387,381
050,39,009,"Ohio","Athens County",1,63,731,362,369
050,39,009,"Ohio","Athens County",1,64,691,337,354
050,39,009,"Ohio","Athens County",1,65,672,331,341
050,39,009,"Ohio","Athens County",1,66,657,315,342
050,39,009,"Ohio","Athens County",1,67,688,345,343
050,39,009,"Ohio","Athens County",1,68,643,315,328
050,39,009,"Ohio","Athens County",1,69,563,263,300
050,39,009,"Ohio","Athens County",1,70,533,260,273
050,39,009,"Ohio","Athens County",1,71,519,255,264
050,39,009,"Ohio","Athens County",1,72,514,263,251
050,39,009,"Ohio","Athens County",1,73,506,244,262
050,39,009,"Ohio","Athens County",1,74,325,147,178
050,39,009,"Ohio","Athens County",1,75,309,144,165
050,39,009,"Ohio","Athens County",1,76,294,137,157
050,39,009,"Ohio","Athens County",1,77,283,134,149
050,39,009,"Ohio","Athens County",1,78,269,122,147
050,39,009,"Ohio","Athens County",1,79,243,100,143
050,39,009,"Ohio","Athens County",1,80,231,96,135
050,39,009,"Ohio","Athens County",1,81,225,93,132
050,39,009,"Ohio","Athens County",1,82,173,67,106
050,39,009,"Ohio","Athens County",1,83,152,56,96
050,39,009,"Ohio","Athens County",1,84,151,59,92
050,39,009,"Ohio","Athens County",1,85,802,241,561
050,39,009,"Ohio","Athens County",2,0,457,225,232
050,39,009,"Ohio","Athens County",2,1,443,232,211
050,39,009,"Ohio","Athens County",2,2,475,249,226
050,39,009,"Ohio","Athens County",2,3,491,256,235
050,39,009,"Ohio","Athens County",2,4,495,261,234
050,39,009,"Ohio","Athens County",2,5,476,255,221
050,39,009,"Ohio","Athens County",2,6,496,255,241
050,39,009,"Ohio","Athens County",2,7,506,249,257
050,39,009,"Ohio","Athens County",2,8,520,271,249
050,39,009,"Ohio","Athens County",2,9,508,263,245
050,39,009,"Ohio","Athens County",2,10,511,263,248
050,39,009,"Ohio","Athens County",2,11,519,267,252
050,39,009,"Ohio","Athens County",2,12,548,282,266
050,39,009,"Ohio","Athens County",2,13,528,270,258
050,39,009,"Ohio","Athens County",2,14,549,276,273
050,39,009,"Ohio","Athens County",2,15,564,286,278
050,39,009,"Ohio","Athens County",2,16,602,307,295
050,39,009,"Ohio","Athens County",2,17,583,294,289
050,39,009,"Ohio","Athens County",2,18,1778,746,1032
050,39,009,"Ohio","Athens County",2,19,4006,1941,2065
050,39,009,"Ohio","Athens County",2,20,3480,1669,1811
050,39,009,"Ohio","Athens County",2,21,2788,1395,1393
050,39,009,"Ohio","Athens County",2,22,2102,1094,1008
050,39,009,"Ohio","Athens County",2,23,1359,721,638
050,39,009,"Ohio","Athens County",2,24,1060,584,476
050,39,009,"Ohio","Athens County",2,25,871,491,380
050,39,009,"Ohio","Athens County",2,26,772,420,352
050,39,009,"Ohio","Athens County",2,27,710,368,342
050,39,009,"Ohio","Athens County",2,28,703,372,331
050,39,009,"Ohio","Athens County",2,29,719,372,347
050,39,009,"Ohio","Athens County",2,30,755,396,359
050,39,009,"Ohio","Athens County",2,31,787,426,361
050,39,009,"Ohio","Athens County",2,32,759,404,355
050,39,009,"Ohio","Athens County",2,33,708,383,325
050,39,009,"Ohio","Athens County",2,34,665,335,330
050,39,009,"Ohio","Athens County",2,35,652,336,316
050,39,009,"Ohio","Athens County",2,36,637,338,299
050,39,009,"Ohio","Athens County",2,37,671,348,323
050,39,009,"Ohio","Athens County",2,38,692,339,353
050,39,009,"Ohio","Athens County",2,39,718,353,365
050,39,009,"Ohio","Athens County",2,40,699,339,360
050,39,009,"Ohio","Athens County",2,41,701,360,341
050,39,009,"Ohio","Athens County",2,42,673,351,322
050,39,009,"Ohio","Athens County",2,43,647,333,314
050,39,009,"Ohio","Athens County",2,44,587,304,283
050,39,009,"Ohio","Athens County",2,45,578,293,285
050,39,009,"Ohio","Athens County",2,46,564,299,265
050,39,009,"Ohio","Athens County",2,47,594,312,282
050,39,009,"Ohio","Athens County",2,48,666,342,324
050,39,009,"Ohio","Athens County",2,49,720,371,349
050,39,009,"Ohio","Athens County",2,50,664,327,337
050,39,009,"Ohio","Athens County",2,51,642,306,336
050,39,009,"Ohio","Athens County",2,52,648,313,335
050,39,009,"Ohio","Athens County",2,53,650,326,324
050,39,009,"Ohio","Athens County",2,54,640,318,322
050,39,009,"Ohio","Athens County",2,55,683,344,339
050,39,009,"Ohio","Athens County",2,56,718,357,361
050,39,009,"Ohio","Athens County",2,57,738,367,371
050,39,009,"Ohio","Athens County",2,58,733,349,384
050,39,009,"Ohio","Athens County",2,59,730,365,365
050,39,009,"Ohio","Athens County",2,60,716,359,357
050,39,009,"Ohio","Athens County",2,61,714,365,349
050,39,009,"Ohio","Athens County",2,62,752,383,369
050,39,009,"Ohio","Athens County",2,63,739,369,370
050,39,009,"Ohio","Athens County",2,64,696,341,355
050,39,009,"Ohio","Athens County",2,65,676,333,343
050,39,009,"Ohio","Athens County",2,66,662,321,341
050,39,009,"Ohio","Athens County",2,67,679,338,341
050,39,009,"Ohio","Athens County",2,68,647,321,326
050,39,009,"Ohio","Athens County",2,69,587,279,308
050,39,009,"Ohio","Athens County",2,70,535,258,277
050,39,009,"Ohio","Athens County",2,71,520,254,266
050,39,009,"Ohio","Athens County",2,72,504,256,248
050,39,009,"Ohio","Athens County",2,73,535,262,273
050,39,009,"Ohio","Athens County",2,74,341,156,185
050,39,009,"Ohio","Athens County",2,75,309,142,167
050,39,009,"Ohio","Athens County",2,76,299,140,159
050,39,009,"Ohio","Athens County",2,77,287,133,154
050,39,009,"Ohio","Athens County",2,78,266,122,144
050,39,009,"Ohio","Athens County",2,79,247,103,144
050,39,009,"Ohio","Athens County",2,80,232,95,137
050,39,009,"Ohio","Athens County",2,81,220,92,128
050,39,009,"Ohio","Athens County",2,82,183,72,111
050,39,009,"Ohio","Athens County",2,83,156,59,97
050,39,009,"Ohio","Athens County",2,84,146,55,91
050,39,009,"Ohio","Athens County",2,85,807,246,561
050,39,009,"Ohio","Athens County",3,0,459,262,197
050,39,009,"Ohio","Athens County",3,1,462,232,230
050,39,009,"Ohio","Athens County",3,2,445,232,213
050,39,009,"Ohio","Athens County",3,3,479,242,237
050,39,009,"Ohio","Athens County",3,4,479,253,226
050,39,009,"Ohio","Athens County",3,5,507,274,233
050,39,009,"Ohio","Athens County",3,6,483,259,224
050,39,009,"Ohio","Athens County",3,7,497,262,235
050,39,009,"Ohio","Athens County",3,8,497,245,252
050,39,009,"Ohio","Athens County",3,9,511,270,241
050,39,009,"Ohio","Athens County",3,10,495,259,236
050,39,009,"Ohio","Athens County",3,11,517,264,253
050,39,009,"Ohio","Athens County",3,12,529,267,262
050,39,009,"Ohio","Athens County",3,13,560,292,268
050,39,009,"Ohio","Athens County",3,14,521,262,259
050,39,009,"Ohio","Athens County",3,15,536,271,265
050,39,009,"Ohio","Athens County",3,16,566,288,278
050,39,009,"Ohio","Athens County",3,17,606,305,301
050,39,009,"Ohio","Athens County",3,18,1291,560,731
050,39,009,"Ohio","Athens County",3,19,2606,1278,1328
050,39,009,"Ohio","Athens County",3,20,2626,1231,1395
050,39,009,"Ohio","Athens County",3,21,2718,1353,1365
050,39,009,"Ohio","Athens County",3,22,2025,1058,967
050,39,009,"Ohio","Athens County",3,23,1323,701,622
050,39,009,"Ohio","Athens County",3,24,1035,530,505
050,39,009,"Ohio","Athens County",3,25,792,418,374
050,39,009,"Ohio","Athens County",3,26,776,433,343
050,39,009,"Ohio","Athens County",3,27,681,377,304
050,39,009,"Ohio","Athens County",3,28,688,363,325
050,39,009,"Ohio","Athens County",3,29,687,358,329
050,39,009,"Ohio","Athens County",3,30,672,335,337
050,39,009,"Ohio","Athens County",3,31,699,371,328
050,39,009,"Ohio","Athens County",3,32,746,392,354
050,39,009,"Ohio","Athens County",3,33,738,385,353
050,39,009,"Ohio","Athens County",3,34,703,381,322
050,39,009,"Ohio","Athens County",3,35,643,340,303
050,39,009,"Ohio","Athens County",3,36,651,335,316
050,39,009,"Ohio","Athens County",3,37,644,344,300
050,39,009,"Ohio","Athens County",3,38,676,348,328
050,39,009,"Ohio","Athens County",3,39,678,336,342
050,39,009,"Ohio","Athens County",3,40,688,336,352
050,39,009,"Ohio","Athens County",3,41,712,349,363
050,39,009,"Ohio","Athens County",3,42,694,352,342
050,39,009,"Ohio","Athens County",3,43,662,341,321
050,39,009,"Ohio","Athens County",3,44,636,329,307
050,39,009,"Ohio","Athens County",3,45,587,302,285
050,39,009,"Ohio","Athens County",3,46,577,286,291
050,39,009,"Ohio","Athens County",3,47,566,304,262
050,39,009,"Ohio","Athens County",3,48,613,319,294
050,39,009,"Ohio","Athens County",3,49,640,330,310
050,39,009,"Ohio","Athens County",3,50,741,376,365
050,39,009,"Ohio","Athens County",3,51,662,329,333
050,39,009,"Ohio","Athens County",3,52,631,302,329
050,39,009,"Ohio","Athens County",3,53,640,311,329
050,39,009,"Ohio","Athens County",3,54,643,322,321
050,39,009,"Ohio","Athens County",3,55,659,332,327
050,39,009,"Ohio","Athens County",3,56,678,345,333
050,39,009,"Ohio","Athens County",3,57,718,358,360
050,39,009,"Ohio","Athens County",3,58,734,358,376
050,39,009,"Ohio","Athens County",3,59,745,356,389
050,39,009,"Ohio","Athens County",3,60,708,350,358
050,39,009,"Ohio","Athens County",3,61,700,353,347
050,39,009,"Ohio","Athens County",3,62,701,362,339
050,39,009,"Ohio","Athens County",3,63,740,382,358
050,39,009,"Ohio","Athens County",3,64,729,360,369
050,39,009,"Ohio","Athens County",3,65,686,332,354
050,39,009,"Ohio","Athens County",3,66,667,330,337
050,39,009,"Ohio","Athens County",3,67,643,310,333
050,39,009,"Ohio","Athens County",3,68,668,334,334
050,39,009,"Ohio","Athens County",3,69,634,308,326
050,39,009,"Ohio","Athens County",3,70,581,272,309
050,39,009,"Ohio","Athens County",3,71,524,251,273
050,39,009,"Ohio","Athens County",3,72,495,244,251
050,39,009,"Ohio","Athens County",3,73,486,245,241
050,39,009,"Ohio","Athens County",3,74,513,246,267
050,39,009,"Ohio","Athens County",3,75,316,144,172
050,39,009,"Ohio","Athens County",3,76,305,139,166
050,39,009,"Ohio","Athens County",3,77,276,126,150
050,39,009,"Ohio","Athens County",3,78,269,123,146
050,39,009,"Ohio","Athens County",3,79,253,111,142
050,39,009,"Ohio","Athens County",3,80,227,97,130
050,39,009,"Ohio","Athens County",3,81,204,83,121
050,39,009,"Ohio","Athens County",3,82,201,83,118
050,39,009,"Ohio","Athens County",3,83,174,65,109
050,39,009,"Ohio","Athens County",3,84,137,50,87
050,39,009,"Ohio","Athens County",3,85,786,247,539
050,39,009,"Ohio","Athens County",4,0,465,237,228
050,39,009,"Ohio","Athens County",4,1,469,255,214
050,39,009,"Ohio","Athens County",4,2,456,225,231
050,39,009,"Ohio","Athens County",4,3,445,240,205
050,39,009,"Ohio","Athens County",4,4,484,248,236
050,39,009,"Ohio","Athens County",4,5,476,252,224
050,39,009,"Ohio","Athens County",4,6,486,262,224
050,39,009,"Ohio","Athens County",4,7,479,252,227
050,39,009,"Ohio","Athens County",4,8,503,267,236
050,39,009,"Ohio","Athens County",4,9,508,252,256
050,39,009,"Ohio","Athens County",4,10,500,256,244
050,39,009,"Ohio","Athens County",4,11,497,268,229
050,39,009,"Ohio","Athens County",4,12,509,263,246
050,39,009,"Ohio","Athens County",4,13,539,271,268
050,39,009,"Ohio","Athens County",4,14,546,289,257
050,39,009,"Ohio","Athens County",4,15,529,272,257
050,39,009,"Ohio","Athens County",4,16,547,277,270
050,39,009,"Ohio","Athens County",4,17,585,296,289
050,39,009,"Ohio","Athens County",4,18,1635,703,932
050,39,009,"Ohio","Athens County",4,19,3477,1687,1790
050,39,009,"Ohio","Athens County",4,20,3082,1472,1610
050,39,009,"Ohio","Athens County",4,21,2787,1396,1391
050,39,009,"Ohio","Athens County",4,22,2178,1124,1054
050,39,009,"Ohio","Athens County",4,23,1302,686,616
050,39,009,"Ohio","Athens County",4,24,1048,547,501
050,39,009,"Ohio","Athens County",4,25,817,389,428
050,39,009,"Ohio","Athens County",4,26,707,357,350
050,39,009,"Ohio","Athens County",4,27,698,383,315
050,39,009,"Ohio","Athens County",4,28,625,347,278
050,39,009,"Ohio","Athens County",4,29,701,361,340
050,39,009,"Ohio","Athens County",4,30,675,366,309
050,39,009,"Ohio","Athens County",4,31,681,350,331
050,39,009,"Ohio","Athens County",4,32,693,368,325
050,39,009,"Ohio","Athens County",4,33,739,390,349
050,39,009,"Ohio","Athens County",4,34,726,377,349
050,39,009,"Ohio","Athens County",4,35,678,369,309
050,39,009,"Ohio","Athens County",4,36,642,332,310
050,39,009,"Ohio","Athens County",4,37,663,343,320
050,39,009,"Ohio","Athens County",4,38,641,340,301
050,39,009,"Ohio","Athens County",4,39,666,345,321
050,39,009,"Ohio","Athens County",4,40,664,330,334
050,39,009,"Ohio","Athens County",4,41,687,333,354
050,39,009,"Ohio","Athens County",4,42,718,353,365
050,39,009,"Ohio","Athens County",4,43,690,351,339
050,39,009,"Ohio","Athens County",4,44,667,331,336
050,39,009,"Ohio","Athens County",4,45,631,323,308
050,39,009,"Ohio","Athens County",4,46,582,310,272
050,39,009,"Ohio","Athens County",4,47,572,282,290
050,39,009,"Ohio","Athens County",4,48,581,301,280
050,39,009,"Ohio","Athens County",4,49,590,308,282
050,39,009,"Ohio","Athens County",4,50,631,322,309
050,39,009,"Ohio","Athens County",4,51,748,382,366
050,39,009,"Ohio","Athens County",4,52,676,334,342
050,39,009,"Ohio","Athens County",4,53,635,308,327
050,39,009,"Ohio","Athens County",4,54,652,313,339
050,39,009,"Ohio","Athens County",4,55,633,310,323
050,39,009,"Ohio","Athens County",4,56,653,324,329
050,39,009,"Ohio","Athens County",4,57,678,338,340
050,39,009,"Ohio","Athens County",4,58,705,349,356
050,39,009,"Ohio","Athens County",4,59,724,354,370
050,39,009,"Ohio","Athens County",4,60,723,343,380
050,39,009,"Ohio","Athens County",4,61,704,356,348
050,39,009,"Ohio","Athens County",4,62,706,364,342
050,39,009,"Ohio","Athens County",4,63,700,362,338
050,39,009,"Ohio","Athens County",4,64,730,377,353
050,39,009,"Ohio","Athens County",4,65,730,358,372
050,39,009,"Ohio","Athens County",4,66,672,317,355
050,39,009,"Ohio","Athens County",4,67,642,312,330
050,39,009,"Ohio","Athens County",4,68,641,310,331
050,39,009,"Ohio","Athens County",4,69,649,325,324
050,39,009,"Ohio","Athens County",4,70,612,297,315
050,39,009,"Ohio","Athens County",4,71,570,264,306
050,39,009,"Ohio","Athens County",4,72,505,243,262
050,39,009,"Ohio","Athens County",4,73,484,239,245
050,39,009,"Ohio","Athens County",4,74,472,237,235
050,39,009,"Ohio","Athens County",4,75,494,237,257
050,39,009,"Ohio","Athens County",4,76,322,147,175
050,39,009,"Ohio","Athens County",4,77,284,129,155
050,39,009,"Ohio","Athens County",4,78,263,122,141
050,39,009,"Ohio","Athens County",4,79,253,113,140
050,39,009,"Ohio","Athens County",4,80,234,97,137
050,39,009,"Ohio","Athens County",4,81,204,83,121
050,39,009,"Ohio","Athens County",4,82,181,70,111
050,39,009,"Ohio","Athens County",4,83,190,74,116
050,39,009,"Ohio","Athens County",4,84,154,54,100
050,39,009,"Ohio","Athens County",4,85,761,234,527
050,39,009,"Ohio","Athens County",5,0,460,236,224
050,39,009,"Ohio","Athens County",5,1,496,259,237
050,39,009,"Ohio","Athens County",5,2,463,250,213
050,39,009,"Ohio","Athens County",5,3,471,220,251
050,39,009,"Ohio","Athens County",5,4,455,242,213
050,39,009,"Ohio","Athens County",5,5,485,249,236
050,39,009,"Ohio","Athens County",5,6,486,258,228
050,39,009,"Ohio","Athens County",5,7,493,261,232
050,39,009,"Ohio","Athens County",5,8,491,265,226
050,39,009,"Ohio","Athens County",5,9,495,254,241
050,39,009,"Ohio","Athens County",5,10,521,257,264
050,39,009,"Ohio","Athens County",5,11,511,259,252
050,39,009,"Ohio","Athens County",5,12,497,263,234
050,39,009,"Ohio","Athens County",5,13,518,265,253
050,39,009,"Ohio","Athens County",5,14,551,270,281
050,39,009,"Ohio","Athens County",5,15,567,301,266
050,39,009,"Ohio","Athens County",5,16,517,264,253
050,39,009,"Ohio","Athens County",5,17,560,280,280
050,39,009,"Ohio","Athens County",5,18,1925,813,1112
050,39,009,"Ohio","Athens County",5,19,4325,2109,2216
050,39,009,"Ohio","Athens County",5,20,3637,1766,1871
050,39,009,"Ohio","Athens County",5,21,2785,1383,1402
050,39,009,"Ohio","Athens County",5,22,2128,1103,1025
050,39,009,"Ohio","Athens County",5,23,1408,734,674
050,39,009,"Ohio","Athens County",5,24,1074,563,511
050,39,009,"Ohio","Athens County",5,25,812,413,399
050,39,009,"Ohio","Athens County",5,26,718,347,371
050,39,009,"Ohio","Athens County",5,27,613,311,302
050,39,009,"Ohio","Athens County",5,28,656,348,308
050,39,009,"Ohio","Athens County",5,29,642,344,298
050,39,009,"Ohio","Athens County",5,30,671,333,338
050,39,009,"Ohio","Athens County",5,31,653,361,292
050,39,009,"Ohio","Athens County",5,32,684,357,327
050,39,009,"Ohio","Athens County",5,33,731,404,327
050,39,009,"Ohio","Athens County",5,34,723,377,346
050,39,009,"Ohio","Athens County",5,35,695,365,330
050,39,009,"Ohio","Athens County",5,36,664,351,313
050,39,009,"Ohio","Athens County",5,37,634,316,318
050,39,009,"Ohio","Athens County",5,38,662,335,327
050,39,009,"Ohio","Athens County",5,39,640,334,306
050,39,009,"Ohio","Athens County",5,40,673,348,325
050,39,009,"Ohio","Athens County",5,41,677,337,340
050,39,009,"Ohio","Athens County",5,42,690,326,364
050,39,009,"Ohio","Athens County",5,43,721,356,365
050,39,009,"Ohio","Athens County",5,44,680,347,333
050,39,009,"Ohio","Athens County",5,45,666,333,333
050,39,009,"Ohio","Athens County",5,46,627,322,305
050,39,009,"Ohio","Athens County",5,47,584,309,275
050,39,009,"Ohio","Athens County",5,48,587,290,297
050,39,009,"Ohio","Athens County",5,49,557,290,267
050,39,009,"Ohio","Athens County",5,50,594,309,285
050,39,009,"Ohio","Athens County",5,51,645,327,318
050,39,009,"Ohio","Athens County",5,52,750,381,369
050,39,009,"Ohio","Athens County",5,53,657,333,324
050,39,009,"Ohio","Athens County",5,54,632,305,327
050,39,009,"Ohio","Athens County",5,55,648,316,332
050,39,009,"Ohio","Athens County",5,56,631,303,328
050,39,009,"Ohio","Athens County",5,57,644,325,319
050,39,009,"Ohio","Athens County",5,58,657,325,332
050,39,009,"Ohio","Athens County",5,59,698,345,353
050,39,009,"Ohio","Athens County",5,60,730,352,378
050,39,009,"Ohio","Athens County",5,61,715,342,373
050,39,009,"Ohio","Athens County",5,62,705,360,345
050,39,009,"Ohio","Athens County",5,63,701,359,342
050,39,009,"Ohio","Athens County",5,64,689,353,336
050,39,009,"Ohio","Athens County",5,65,724,372,352
050,39,009,"Ohio","Athens County",5,66,726,345,381
050,39,009,"Ohio","Athens County",5,67,646,309,337
050,39,009,"Ohio","Athens County",5,68,624,298,326
050,39,009,"Ohio","Athens County",5,69,622,298,324
050,39,009,"Ohio","Athens County",5,70,631,315,316
050,39,009,"Ohio","Athens County",5,71,606,294,312
050,39,009,"Ohio","Athens County",5,72,555,256,299
050,39,009,"Ohio","Athens County",5,73,500,241,259
050,39,009,"Ohio","Athens County",5,74,474,230,244
050,39,009,"Ohio","Athens County",5,75,466,232,234
050,39,009,"Ohio","Athens County",5,76,494,234,260
050,39,009,"Ohio","Athens County",5,77,299,138,161
050,39,009,"Ohio","Athens County",5,78,274,125,149
050,39,009,"Ohio","Athens County",5,79,246,110,136
050,39,009,"Ohio","Athens County",5,80,227,97,130
050,39,009,"Ohio","Athens County",5,81,210,86,124
050,39,009,"Ohio","Athens County",5,82,182,73,109
050,39,009,"Ohio","Athens County",5,83,172,61,111
050,39,009,"Ohio","Athens County",5,84,165,64,101
050,39,009,"Ohio","Athens County",5,85,788,240,548
050,39,011,"Ohio","Auglaize County",1,0,536,276,260
050,39,011,"Ohio","Auglaize County",1,1,544,275,269
050,39,011,"Ohio","Auglaize County",1,2,603,318,285
050,39,011,"Ohio","Auglaize County",1,3,591,301,290
050,39,011,"Ohio","Auglaize County",1,4,621,321,300
050,39,011,"Ohio","Auglaize County",1,5,611,297,314
050,39,011,"Ohio","Auglaize County",1,6,590,289,301
050,39,011,"Ohio","Auglaize County",1,7,558,288,270
050,39,011,"Ohio","Auglaize County",1,8,601,309,292
050,39,011,"Ohio","Auglaize County",1,9,651,327,324
050,39,011,"Ohio","Auglaize County",1,10,689,333,356
050,39,011,"Ohio","Auglaize County",1,11,683,351,332
050,39,011,"Ohio","Auglaize County",1,12,673,367,306
050,39,011,"Ohio","Auglaize County",1,13,671,354,317
050,39,011,"Ohio","Auglaize County",1,14,657,331,326
050,39,011,"Ohio","Auglaize County",1,15,681,337,344
050,39,011,"Ohio","Auglaize County",1,16,664,345,319
050,39,011,"Ohio","Auglaize County",1,17,658,353,305
050,39,011,"Ohio","Auglaize County",1,18,552,293,259
050,39,011,"Ohio","Auglaize County",1,19,456,234,222
050,39,011,"Ohio","Auglaize County",1,20,491,259,232
050,39,011,"Ohio","Auglaize County",1,21,493,252,241
050,39,011,"Ohio","Auglaize County",1,22,503,264,239
050,39,011,"Ohio","Auglaize County",1,23,526,288,238
050,39,011,"Ohio","Auglaize County",1,24,533,295,238
050,39,011,"Ohio","Auglaize County",1,25,567,312,255
050,39,011,"Ohio","Auglaize County",1,26,549,275,274
050,39,011,"Ohio","Auglaize County",1,27,531,267,264
050,39,011,"Ohio","Auglaize County",1,28,571,299,272
050,39,011,"Ohio","Auglaize County",1,29,565,285,280
050,39,011,"Ohio","Auglaize County",1,30,499,259,240
050,39,011,"Ohio","Auglaize County",1,31,545,272,273
050,39,011,"Ohio","Auglaize County",1,32,560,284,276
050,39,011,"Ohio","Auglaize County",1,33,519,262,257
050,39,011,"Ohio","Auglaize County",1,34,500,254,246
050,39,011,"Ohio","Auglaize County",1,35,514,251,263
050,39,011,"Ohio","Auglaize County",1,36,498,249,249
050,39,011,"Ohio","Auglaize County",1,37,534,261,273
050,39,011,"Ohio","Auglaize County",1,38,580,296,284
050,39,011,"Ohio","Auglaize County",1,39,580,302,278
050,39,011,"Ohio","Auglaize County",1,40,528,256,272
050,39,011,"Ohio","Auglaize County",1,41,556,291,265
050,39,011,"Ohio","Auglaize County",1,42,554,291,263
050,39,011,"Ohio","Auglaize County",1,43,518,262,256
050,39,011,"Ohio","Auglaize County",1,44,492,254,238
050,39,011,"Ohio","Auglaize County",1,45,502,262,240
050,39,011,"Ohio","Auglaize County",1,46,535,271,264
050,39,011,"Ohio","Auglaize County",1,47,546,282,264
050,39,011,"Ohio","Auglaize County",1,48,585,307,278
050,39,011,"Ohio","Auglaize County",1,49,588,294,294
050,39,011,"Ohio","Auglaize County",1,50,546,276,270
050,39,011,"Ohio","Auglaize County",1,51,560,275,285
050,39,011,"Ohio","Auglaize County",1,52,579,293,286
050,39,011,"Ohio","Auglaize County",1,53,580,294,286
050,39,011,"Ohio","Auglaize County",1,54,583,285,298
050,39,011,"Ohio","Auglaize County",1,55,650,320,330
050,39,011,"Ohio","Auglaize County",1,56,644,321,323
050,39,011,"Ohio","Auglaize County",1,57,658,334,324
050,39,011,"Ohio","Auglaize County",1,58,675,335,340
050,39,011,"Ohio","Auglaize County",1,59,672,351,321
050,39,011,"Ohio","Auglaize County",1,60,696,369,327
050,39,011,"Ohio","Auglaize County",1,61,685,347,338
050,39,011,"Ohio","Auglaize County",1,62,674,345,329
050,39,011,"Ohio","Auglaize County",1,63,628,326,302
050,39,011,"Ohio","Auglaize County",1,64,622,320,302
050,39,011,"Ohio","Auglaize County",1,65,612,304,308
050,39,011,"Ohio","Auglaize County",1,66,612,303,309
050,39,011,"Ohio","Auglaize County",1,67,596,310,286
050,39,011,"Ohio","Auglaize County",1,68,574,280,294
050,39,011,"Ohio","Auglaize County",1,69,516,261,255
050,39,011,"Ohio","Auglaize County",1,70,478,232,246
050,39,011,"Ohio","Auglaize County",1,71,452,203,249
050,39,011,"Ohio","Auglaize County",1,72,439,211,228
050,39,011,"Ohio","Auglaize County",1,73,450,203,247
050,39,011,"Ohio","Auglaize County",1,74,307,143,164
050,39,011,"Ohio","Auglaize County",1,75,343,163,180
050,39,011,"Ohio","Auglaize County",1,76,318,152,166
050,39,011,"Ohio","Auglaize County",1,77,318,144,174
050,39,011,"Ohio","Auglaize County",1,78,259,118,141
050,39,011,"Ohio","Auglaize County",1,79,232,96,136
050,39,011,"Ohio","Auglaize County",1,80,225,101,124
050,39,011,"Ohio","Auglaize County",1,81,239,109,130
050,39,011,"Ohio","Auglaize County",1,82,221,100,121
050,39,011,"Ohio","Auglaize County",1,83,199,89,110
050,39,011,"Ohio","Auglaize County",1,84,176,73,103
050,39,011,"Ohio","Auglaize County",1,85,1057,363,694
050,39,011,"Ohio","Auglaize County",2,0,544,293,251
050,39,011,"Ohio","Auglaize County",2,1,547,276,271
050,39,011,"Ohio","Auglaize County",2,2,592,307,285
050,39,011,"Ohio","Auglaize County",2,3,595,304,291
050,39,011,"Ohio","Auglaize County",2,4,615,316,299
050,39,011,"Ohio","Auglaize County",2,5,616,303,313
050,39,011,"Ohio","Auglaize County",2,6,598,291,307
050,39,011,"Ohio","Auglaize County",2,7,567,289,278
050,39,011,"Ohio","Auglaize County",2,8,590,303,287
050,39,011,"Ohio","Auglaize County",2,9,642,324,318
050,39,011,"Ohio","Auglaize County",2,10,683,334,349
050,39,011,"Ohio","Auglaize County",2,11,681,344,337
050,39,011,"Ohio","Auglaize County",2,12,682,365,317
050,39,011,"Ohio","Auglaize County",2,13,673,357,316
050,39,011,"Ohio","Auglaize County",2,14,660,335,325
050,39,011,"Ohio","Auglaize County",2,15,674,333,341
050,39,011,"Ohio","Auglaize County",2,16,671,346,325
050,39,011,"Ohio","Auglaize County",2,17,662,352,310
050,39,011,"Ohio","Auglaize County",2,18,553,297,256
050,39,011,"Ohio","Auglaize County",2,19,453,234,219
050,39,011,"Ohio","Auglaize County",2,20,499,261,238
050,39,011,"Ohio","Auglaize County",2,21,496,256,240
050,39,011,"Ohio","Auglaize County",2,22,507,265,242
050,39,011,"Ohio","Auglaize County",2,23,528,289,239
050,39,011,"Ohio","Auglaize County",2,24,535,296,239
050,39,011,"Ohio","Auglaize County",2,25,560,306,254
050,39,011,"Ohio","Auglaize County",2,26,552,284,268
050,39,011,"Ohio","Auglaize County",2,27,539,270,269
050,39,011,"Ohio","Auglaize County",2,28,563,291,272
050,39,011,"Ohio","Auglaize County",2,29,569,289,280
050,39,011,"Ohio","Auglaize County",2,30,523,269,254
050,39,011,"Ohio","Auglaize County",2,31,536,271,265
050,39,011,"Ohio","Auglaize County",2,32,556,280,276
050,39,011,"Ohio","Auglaize County",2,33,529,266,263
050,39,011,"Ohio","Auglaize County",2,34,509,258,251
050,39,011,"Ohio","Auglaize County",2,35,516,255,261
050,39,011,"Ohio","Auglaize County",2,36,498,248,250
050,39,011,"Ohio","Auglaize County",2,37,527,259,268
050,39,011,"Ohio","Auglaize County",2,38,572,289,283
050,39,011,"Ohio","Auglaize County",2,39,578,299,279
050,39,011,"Ohio","Auglaize County",2,40,546,271,275
050,39,011,"Ohio","Auglaize County",2,41,549,284,265
050,39,011,"Ohio","Auglaize County",2,42,552,290,262
050,39,011,"Ohio","Auglaize County",2,43,535,273,262
050,39,011,"Ohio","Auglaize County",2,44,494,254,240
050,39,011,"Ohio","Auglaize County",2,45,503,262,241
050,39,011,"Ohio","Auglaize County",2,46,525,267,258
050,39,011,"Ohio","Auglaize County",2,47,539,277,262
050,39,011,"Ohio","Auglaize County",2,48,574,299,275
050,39,011,"Ohio","Auglaize County",2,49,591,300,291
050,39,011,"Ohio","Auglaize County",2,50,557,281,276
050,39,011,"Ohio","Auglaize County",2,51,552,273,279
050,39,011,"Ohio","Auglaize County",2,52,572,286,286
050,39,011,"Ohio","Auglaize County",2,53,577,292,285
050,39,011,"Ohio","Auglaize County",2,54,580,286,294
050,39,011,"Ohio","Auglaize County",2,55,630,309,321
050,39,011,"Ohio","Auglaize County",2,56,644,320,324
050,39,011,"Ohio","Auglaize County",2,57,655,332,323
050,39,011,"Ohio","Auglaize County",2,58,668,334,334
050,39,011,"Ohio","Auglaize County",2,59,671,347,324
050,39,011,"Ohio","Auglaize County",2,60,686,361,325
050,39,011,"Ohio","Auglaize County",2,61,681,348,333
050,39,011,"Ohio","Auglaize County",2,62,672,342,330
050,39,011,"Ohio","Auglaize County",2,63,644,334,310
050,39,011,"Ohio","Auglaize County",2,64,613,316,297
050,39,011,"Ohio","Auglaize County",2,65,608,305,303
050,39,011,"Ohio","Auglaize County",2,66,615,305,310
050,39,011,"Ohio","Auglaize County",2,67,592,303,289
050,39,011,"Ohio","Auglaize County",2,68,574,285,289
050,39,011,"Ohio","Auglaize County",2,69,530,266,264
050,39,011,"Ohio","Auglaize County",2,70,486,239,247
050,39,011,"Ohio","Auglaize County",2,71,456,208,248
050,39,011,"Ohio","Auglaize County",2,72,430,204,226
050,39,011,"Ohio","Auglaize County",2,73,468,216,252
050,39,011,"Ohio","Auglaize County",2,74,318,146,172
050,39,011,"Ohio","Auglaize County",2,75,335,158,177
050,39,011,"Ohio","Auglaize County",2,76,318,151,167
050,39,011,"Ohio","Auglaize County",2,77,320,147,173
050,39,011,"Ohio","Auglaize County",2,78,268,121,147
050,39,011,"Ohio","Auglaize County",2,79,236,98,138
050,39,011,"Ohio","Auglaize County",2,80,226,100,126
050,39,011,"Ohio","Auglaize County",2,81,233,104,129
050,39,011,"Ohio","Auglaize County",2,82,219,100,119
050,39,011,"Ohio","Auglaize County",2,83,201,89,112
050,39,011,"Ohio","Auglaize County",2,84,182,77,105
050,39,011,"Ohio","Auglaize County",2,85,1057,370,687
050,39,011,"Ohio","Auglaize County",3,0,527,262,265
050,39,011,"Ohio","Auglaize County",3,1,569,295,274
050,39,011,"Ohio","Auglaize County",3,2,561,282,279
050,39,011,"Ohio","Auglaize County",3,3,576,302,274
050,39,011,"Ohio","Auglaize County",3,4,619,324,295
050,39,011,"Ohio","Auglaize County",3,5,600,316,284
050,39,011,"Ohio","Auglaize County",3,6,621,309,312
050,39,011,"Ohio","Auglaize County",3,7,590,289,301
050,39,011,"Ohio","Auglaize County",3,8,571,294,277
050,39,011,"Ohio","Auglaize County",3,9,590,300,290
050,39,011,"Ohio","Auglaize County",3,10,642,330,312
050,39,011,"Ohio","Auglaize County",3,11,685,338,347
050,39,011,"Ohio","Auglaize County",3,12,681,349,332
050,39,011,"Ohio","Auglaize County",3,13,693,375,318
050,39,011,"Ohio","Auglaize County",3,14,656,347,309
050,39,011,"Ohio","Auglaize County",3,15,645,329,316
050,39,011,"Ohio","Auglaize County",3,16,672,330,342
050,39,011,"Ohio","Auglaize County",3,17,656,334,322
050,39,011,"Ohio","Auglaize County",3,18,549,306,243
050,39,011,"Ohio","Auglaize County",3,19,435,229,206
050,39,011,"Ohio","Auglaize County",3,20,480,236,244
050,39,011,"Ohio","Auglaize County",3,21,521,265,256
050,39,011,"Ohio","Auglaize County",3,22,544,267,277
050,39,011,"Ohio","Auglaize County",3,23,525,278,247
050,39,011,"Ohio","Auglaize County",3,24,534,291,243
050,39,011,"Ohio","Auglaize County",3,25,520,284,236
050,39,011,"Ohio","Auglaize County",3,26,537,299,238
050,39,011,"Ohio","Auglaize County",3,27,555,301,254
050,39,011,"Ohio","Auglaize County",3,28,525,262,263
050,39,011,"Ohio","Auglaize County",3,29,554,280,274
050,39,011,"Ohio","Auglaize County",3,30,556,277,279
050,39,011,"Ohio","Auglaize County",3,31,555,294,261
050,39,011,"Ohio","Auglaize County",3,32,545,285,260
050,39,011,"Ohio","Auglaize County",3,33,567,293,274
050,39,011,"Ohio","Auglaize County",3,34,520,259,261
050,39,011,"Ohio","Auglaize County",3,35,509,257,252
050,39,011,"Ohio","Auglaize County",3,36,521,257,264
050,39,011,"Ohio","Auglaize County",3,37,488,243,245
050,39,011,"Ohio","Auglaize County",3,38,527,262,265
050,39,011,"Ohio","Auglaize County",3,39,577,292,285
050,39,011,"Ohio","Auglaize County",3,40,586,305,281
050,39,011,"Ohio","Auglaize County",3,41,553,279,274
050,39,011,"Ohio","Auglaize County",3,42,547,280,267
050,39,011,"Ohio","Auglaize County",3,43,547,284,263
050,39,011,"Ohio","Auglaize County",3,44,521,264,257
050,39,011,"Ohio","Auglaize County",3,45,496,256,240
050,39,011,"Ohio","Auglaize County",3,46,517,270,247
050,39,011,"Ohio","Auglaize County",3,47,518,265,253
050,39,011,"Ohio","Auglaize County",3,48,539,275,264
050,39,011,"Ohio","Auglaize County",3,49,580,304,276
050,39,011,"Ohio","Auglaize County",3,50,588,294,294
050,39,011,"Ohio","Auglaize County",3,51,558,282,276
050,39,011,"Ohio","Auglaize County",3,52,558,277,281
050,39,011,"Ohio","Auglaize County",3,53,560,279,281
050,39,011,"Ohio","Auglaize County",3,54,566,282,284
050,39,011,"Ohio","Auglaize County",3,55,575,285,290
050,39,011,"Ohio","Auglaize County",3,56,619,308,311
050,39,011,"Ohio","Auglaize County",3,57,637,316,321
050,39,011,"Ohio","Auglaize County",3,58,656,332,324
050,39,011,"Ohio","Auglaize County",3,59,656,331,325
050,39,011,"Ohio","Auglaize County",3,60,672,350,322
050,39,011,"Ohio","Auglaize County",3,61,672,347,325
050,39,011,"Ohio","Auglaize County",3,62,668,341,327
050,39,011,"Ohio","Auglaize County",3,63,657,338,319
050,39,011,"Ohio","Auglaize County",3,64,635,331,304
050,39,011,"Ohio","Auglaize County",3,65,599,301,298
050,39,011,"Ohio","Auglaize County",3,66,596,297,299
050,39,011,"Ohio","Auglaize County",3,67,601,298,303
050,39,011,"Ohio","Auglaize County",3,68,578,292,286
050,39,011,"Ohio","Auglaize County",3,69,568,286,282
050,39,011,"Ohio","Auglaize County",3,70,523,262,261
050,39,011,"Ohio","Auglaize County",3,71,468,234,234
050,39,011,"Ohio","Auglaize County",3,72,437,199,238
050,39,011,"Ohio","Auglaize County",3,73,412,190,222
050,39,011,"Ohio","Auglaize County",3,74,464,209,255
050,39,011,"Ohio","Auglaize County",3,75,304,139,165
050,39,011,"Ohio","Auglaize County",3,76,323,154,169
050,39,011,"Ohio","Auglaize County",3,77,298,142,156
050,39,011,"Ohio","Auglaize County",3,78,308,140,168
050,39,011,"Ohio","Auglaize County",3,79,259,113,146
050,39,011,"Ohio","Auglaize County",3,80,225,91,134
050,39,011,"Ohio","Auglaize County",3,81,209,89,120
050,39,011,"Ohio","Auglaize County",3,82,219,98,121
050,39,011,"Ohio","Auglaize County",3,83,197,89,108
050,39,011,"Ohio","Auglaize County",3,84,184,82,102
050,39,011,"Ohio","Auglaize County",3,85,1004,350,654
050,39,011,"Ohio","Auglaize County",4,0,516,260,256
050,39,011,"Ohio","Auglaize County",4,1,520,275,245
050,39,011,"Ohio","Auglaize County",4,2,567,294,273
050,39,011,"Ohio","Auglaize County",4,3,564,279,285
050,39,011,"Ohio","Auglaize County",4,4,587,310,277
050,39,011,"Ohio","Auglaize County",4,5,602,310,292
050,39,011,"Ohio","Auglaize County",4,6,594,313,281
050,39,011,"Ohio","Auglaize County",4,7,623,306,317
050,39,011,"Ohio","Auglaize County",4,8,596,289,307
050,39,011,"Ohio","Auglaize County",4,9,559,288,271
050,39,011,"Ohio","Auglaize County",4,10,596,305,291
050,39,011,"Ohio","Auglaize County",4,11,636,322,314
050,39,011,"Ohio","Auglaize County",4,12,679,330,349
050,39,011,"Ohio","Auglaize County",4,13,674,345,329
050,39,011,"Ohio","Auglaize County",4,14,672,364,308
050,39,011,"Ohio","Auglaize County",4,15,653,349,304
050,39,011,"Ohio","Auglaize County",4,16,630,319,311
050,39,011,"Ohio","Auglaize County",4,17,676,332,344
050,39,011,"Ohio","Auglaize County",4,18,544,290,254
050,39,011,"Ohio","Auglaize County",4,19,407,224,183
050,39,011,"Ohio","Auglaize County",4,20,454,240,214
050,39,011,"Ohio","Auglaize County",4,21,503,246,257
050,39,011,"Ohio","Auglaize County",4,22,554,277,277
050,39,011,"Ohio","Auglaize County",4,23,566,286,280
050,39,011,"Ohio","Auglaize County",4,24,508,263,245
050,39,011,"Ohio","Auglaize County",4,25,530,289,241
050,39,011,"Ohio","Auglaize County",4,26,517,271,246
050,39,011,"Ohio","Auglaize County",4,27,549,302,247
050,39,011,"Ohio","Auglaize County",4,28,544,292,252
050,39,011,"Ohio","Auglaize County",4,29,521,263,258
050,39,011,"Ohio","Auglaize County",4,30,543,286,257
050,39,011,"Ohio","Auglaize County",4,31,540,261,279
050,39,011,"Ohio","Auglaize County",4,32,567,299,268
050,39,011,"Ohio","Auglaize County",4,33,534,270,264
050,39,011,"Ohio","Auglaize County",4,34,560,281,279
050,39,011,"Ohio","Auglaize County",4,35,502,253,249
050,39,011,"Ohio","Auglaize County",4,36,516,254,262
050,39,011,"Ohio","Auglaize County",4,37,522,261,261
050,39,011,"Ohio","Auglaize County",4,38,481,241,240
050,39,011,"Ohio","Auglaize County",4,39,521,262,259
050,39,011,"Ohio","Auglaize County",4,40,568,284,284
050,39,011,"Ohio","Auglaize County",4,41,592,311,281
050,39,011,"Ohio","Auglaize County",4,42,557,275,282
050,39,011,"Ohio","Auglaize County",4,43,541,278,263
050,39,011,"Ohio","Auglaize County",4,44,539,280,259
050,39,011,"Ohio","Auglaize County",4,45,527,270,257
050,39,011,"Ohio","Auglaize County",4,46,486,244,242
050,39,011,"Ohio","Auglaize County",4,47,519,274,245
050,39,011,"Ohio","Auglaize County",4,48,514,267,247
050,39,011,"Ohio","Auglaize County",4,49,546,280,266
050,39,011,"Ohio","Auglaize County",4,50,580,303,277
050,39,011,"Ohio","Auglaize County",4,51,594,300,294
050,39,011,"Ohio","Auglaize County",4,52,557,280,277
050,39,011,"Ohio","Auglaize County",4,53,547,273,274
050,39,011,"Ohio","Auglaize County",4,54,553,276,277
050,39,011,"Ohio","Auglaize County",4,55,564,285,279
050,39,011,"Ohio","Auglaize County",4,56,561,276,285
050,39,011,"Ohio","Auglaize County",4,57,600,296,304
050,39,011,"Ohio","Auglaize County",4,58,646,316,330
050,39,011,"Ohio","Auglaize County",4,59,642,323,319
050,39,011,"Ohio","Auglaize County",4,60,651,327,324
050,39,011,"Ohio","Auglaize County",4,61,671,355,316
050,39,011,"Ohio","Auglaize County",4,62,666,344,322
050,39,011,"Ohio","Auglaize County",4,63,670,341,329
050,39,011,"Ohio","Auglaize County",4,64,644,328,316
050,39,011,"Ohio","Auglaize County",4,65,618,320,298
050,39,011,"Ohio","Auglaize County",4,66,592,291,301
050,39,011,"Ohio","Auglaize County",4,67,580,290,290
050,39,011,"Ohio","Auglaize County",4,68,591,291,300
050,39,011,"Ohio","Auglaize County",4,69,560,284,276
050,39,011,"Ohio","Auglaize County",4,70,566,285,281
050,39,011,"Ohio","Auglaize County",4,71,519,258,261
050,39,011,"Ohio","Auglaize County",4,72,452,224,228
050,39,011,"Ohio","Auglaize County",4,73,425,194,231
050,39,011,"Ohio","Auglaize County",4,74,404,178,226
050,39,011,"Ohio","Auglaize County",4,75,455,205,250
050,39,011,"Ohio","Auglaize County",4,76,302,134,168
050,39,011,"Ohio","Auglaize County",4,77,299,144,155
050,39,011,"Ohio","Auglaize County",4,78,286,134,152
050,39,011,"Ohio","Auglaize County",4,79,298,134,164
050,39,011,"Ohio","Auglaize County",4,80,253,112,141
050,39,011,"Ohio","Auglaize County",4,81,219,87,132
050,39,011,"Ohio","Auglaize County",4,82,196,85,111
050,39,011,"Ohio","Auglaize County",4,83,190,77,113
050,39,011,"Ohio","Auglaize County",4,84,171,76,95
050,39,011,"Ohio","Auglaize County",4,85,1008,375,633
050,39,011,"Ohio","Auglaize County",5,0,517,258,259
050,39,011,"Ohio","Auglaize County",5,1,557,274,283
050,39,011,"Ohio","Auglaize County",5,2,523,271,252
050,39,011,"Ohio","Auglaize County",5,3,552,287,265
050,39,011,"Ohio","Auglaize County",5,4,576,286,290
050,39,011,"Ohio","Auglaize County",5,5,610,316,294
050,39,011,"Ohio","Auglaize County",5,6,580,300,280
050,39,011,"Ohio","Auglaize County",5,7,617,324,293
050,39,011,"Ohio","Auglaize County",5,8,621,310,311
050,39,011,"Ohio","Auglaize County",5,9,601,295,306
050,39,011,"Ohio","Auglaize County",5,10,576,297,279
050,39,011,"Ohio","Auglaize County",5,11,592,307,285
050,39,011,"Ohio","Auglaize County",5,12,633,312,321
050,39,011,"Ohio","Auglaize County",5,13,686,339,347
050,39,011,"Ohio","Auglaize County",5,14,680,347,333
050,39,011,"Ohio","Auglaize County",5,15,694,379,315
050,39,011,"Ohio","Auglaize County",5,16,653,358,295
050,39,011,"Ohio","Auglaize County",5,17,638,320,318
050,39,011,"Ohio","Auglaize County",5,18,568,294,274
050,39,011,"Ohio","Auglaize County",5,19,414,221,193
050,39,011,"Ohio","Auglaize County",5,20,452,245,207
050,39,011,"Ohio","Auglaize County",5,21,477,246,231
050,39,011,"Ohio","Auglaize County",5,22,534,261,273
050,39,011,"Ohio","Auglaize County",5,23,565,277,288
050,39,011,"Ohio","Auglaize County",5,24,580,298,282
050,39,011,"Ohio","Auglaize County",5,25,539,279,260
050,39,011,"Ohio","Auglaize County",5,26,535,292,243
050,39,011,"Ohio","Auglaize County",5,27,532,285,247
050,39,011,"Ohio","Auglaize County",5,28,560,305,255
050,39,011,"Ohio","Auglaize County",5,29,540,297,243
050,39,011,"Ohio","Auglaize County",5,30,514,259,255
050,39,011,"Ohio","Auglaize County",5,31,544,296,248
050,39,011,"Ohio","Auglaize County",5,32,540,263,277
050,39,011,"Ohio","Auglaize County",5,33,559,297,262
050,39,011,"Ohio","Auglaize County",5,34,539,268,271
050,39,011,"Ohio","Auglaize County",5,35,560,280,280
050,39,011,"Ohio","Auglaize County",5,36,513,260,253
050,39,011,"Ohio","Auglaize County",5,37,513,253,260
050,39,011,"Ohio","Auglaize County",5,38,518,256,262
050,39,011,"Ohio","Auglaize County",5,39,466,230,236
050,39,011,"Ohio","Auglaize County",5,40,531,266,265
050,39,011,"Ohio","Auglaize County",5,41,564,283,281
050,39,011,"Ohio","Auglaize County",5,42,589,311,278
050,39,011,"Ohio","Auglaize County",5,43,555,272,283
050,39,011,"Ohio","Auglaize County",5,44,544,283,261
050,39,011,"Ohio","Auglaize County",5,45,540,282,258
050,39,011,"Ohio","Auglaize County",5,46,522,267,255
050,39,011,"Ohio","Auglaize County",5,47,484,242,242
050,39,011,"Ohio","Auglaize County",5,48,522,271,251
050,39,011,"Ohio","Auglaize County",5,49,518,272,246
050,39,011,"Ohio","Auglaize County",5,50,529,276,253
050,39,011,"Ohio","Auglaize County",5,51,572,299,273
050,39,011,"Ohio","Auglaize County",5,52,592,299,293
050,39,011,"Ohio","Auglaize County",5,53,554,278,276
050,39,011,"Ohio","Auglaize County",5,54,549,276,273
050,39,011,"Ohio","Auglaize County",5,55,559,279,280
050,39,011,"Ohio","Auglaize County",5,56,548,280,268
050,39,011,"Ohio","Auglaize County",5,57,559,277,282
050,39,011,"Ohio","Auglaize County",5,58,602,295,307
050,39,011,"Ohio","Auglaize County",5,59,631,308,323
050,39,011,"Ohio","Auglaize County",5,60,649,323,326
050,39,011,"Ohio","Auglaize County",5,61,655,331,324
050,39,011,"Ohio","Auglaize County",5,62,672,358,314
050,39,011,"Ohio","Auglaize County",5,63,656,332,324
050,39,011,"Ohio","Auglaize County",5,64,656,336,320
050,39,011,"Ohio","Auglaize County",5,65,625,317,308
050,39,011,"Ohio","Auglaize County",5,66,611,309,302
050,39,011,"Ohio","Auglaize County",5,67,581,284,297
050,39,011,"Ohio","Auglaize County",5,68,570,283,287
050,39,011,"Ohio","Auglaize County",5,69,575,288,287
050,39,011,"Ohio","Auglaize County",5,70,567,288,279
050,39,011,"Ohio","Auglaize County",5,71,550,279,271
050,39,011,"Ohio","Auglaize County",5,72,507,251,256
050,39,011,"Ohio","Auglaize County",5,73,444,218,226
050,39,011,"Ohio","Auglaize County",5,74,421,192,229
050,39,011,"Ohio","Auglaize County",5,75,390,170,220
050,39,011,"Ohio","Auglaize County",5,76,442,197,245
050,39,011,"Ohio","Auglaize County",5,77,281,126,155
050,39,011,"Ohio","Auglaize County",5,78,284,136,148
050,39,011,"Ohio","Auglaize County",5,79,282,129,153
050,39,011,"Ohio","Auglaize County",5,80,290,129,161
050,39,011,"Ohio","Auglaize County",5,81,246,104,142
050,39,011,"Ohio","Auglaize County",5,82,206,81,125
050,39,011,"Ohio","Auglaize County",5,83,177,72,105
050,39,011,"Ohio","Auglaize County",5,84,165,64,101
050,39,011,"Ohio","Auglaize County",5,85,1016,396,620
050,39,013,"Ohio","Belmont County",1,0,632,327,305
050,39,013,"Ohio","Belmont County",1,1,631,335,296
050,39,013,"Ohio","Belmont County",1,2,605,286,319
050,39,013,"Ohio","Belmont County",1,3,640,314,326
050,39,013,"Ohio","Belmont County",1,4,634,322,312
050,39,013,"Ohio","Belmont County",1,5,667,332,335
050,39,013,"Ohio","Belmont County",1,6,707,352,355
050,39,013,"Ohio","Belmont County",1,7,691,360,331
050,39,013,"Ohio","Belmont County",1,8,696,356,340
050,39,013,"Ohio","Belmont County",1,9,739,382,357
050,39,013,"Ohio","Belmont County",1,10,726,387,339
050,39,013,"Ohio","Belmont County",1,11,762,400,362
050,39,013,"Ohio","Belmont County",1,12,717,347,370
050,39,013,"Ohio","Belmont County",1,13,751,369,382
050,39,013,"Ohio","Belmont County",1,14,748,371,377
050,39,013,"Ohio","Belmont County",1,15,738,373,365
050,39,013,"Ohio","Belmont County",1,16,767,422,345
050,39,013,"Ohio","Belmont County",1,17,757,410,347
050,39,013,"Ohio","Belmont County",1,18,682,376,306
050,39,013,"Ohio","Belmont County",1,19,587,354,233
050,39,013,"Ohio","Belmont County",1,20,661,404,257
050,39,013,"Ohio","Belmont County",1,21,685,415,270
050,39,013,"Ohio","Belmont County",1,22,772,456,316
050,39,013,"Ohio","Belmont County",1,23,782,470,312
050,39,013,"Ohio","Belmont County",1,24,793,474,319
050,39,013,"Ohio","Belmont County",1,25,801,462,339
050,39,013,"Ohio","Belmont County",1,26,832,482,350
050,39,013,"Ohio","Belmont County",1,27,827,451,376
050,39,013,"Ohio","Belmont County",1,28,888,501,387
050,39,013,"Ohio","Belmont County",1,29,935,537,398
050,39,013,"Ohio","Belmont County",1,30,857,507,350
050,39,013,"Ohio","Belmont County",1,31,853,502,351
050,39,013,"Ohio","Belmont County",1,32,838,470,368
050,39,013,"Ohio","Belmont County",1,33,786,439,347
050,39,013,"Ohio","Belmont County",1,34,826,469,357
050,39,013,"Ohio","Belmont County",1,35,777,430,347
050,39,013,"Ohio","Belmont County",1,36,776,418,358
050,39,013,"Ohio","Belmont County",1,37,827,436,391
050,39,013,"Ohio","Belmont County",1,38,821,428,393
050,39,013,"Ohio","Belmont County",1,39,830,460,370
050,39,013,"Ohio","Belmont County",1,40,803,444,359
050,39,013,"Ohio","Belmont County",1,41,774,425,349
050,39,013,"Ohio","Belmont County",1,42,759,410,349
050,39,013,"Ohio","Belmont County",1,43,768,406,362
050,39,013,"Ohio","Belmont County",1,44,742,397,345
050,39,013,"Ohio","Belmont County",1,45,764,403,361
050,39,013,"Ohio","Belmont County",1,46,803,428,375
050,39,013,"Ohio","Belmont County",1,47,812,438,374
050,39,013,"Ohio","Belmont County",1,48,859,463,396
050,39,013,"Ohio","Belmont County",1,49,912,477,435
050,39,013,"Ohio","Belmont County",1,50,883,471,412
050,39,013,"Ohio","Belmont County",1,51,863,480,383
050,39,013,"Ohio","Belmont County",1,52,842,446,396
050,39,013,"Ohio","Belmont County",1,53,840,420,420
050,39,013,"Ohio","Belmont County",1,54,862,429,433
050,39,013,"Ohio","Belmont County",1,55,886,435,451
050,39,013,"Ohio","Belmont County",1,56,944,475,469
050,39,013,"Ohio","Belmont County",1,57,977,477,500
050,39,013,"Ohio","Belmont County",1,58,1025,510,515
050,39,013,"Ohio","Belmont County",1,59,1076,546,530
050,39,013,"Ohio","Belmont County",1,60,1054,522,532
050,39,013,"Ohio","Belmont County",1,61,1052,516,536
050,39,013,"Ohio","Belmont County",1,62,1111,542,569
050,39,013,"Ohio","Belmont County",1,63,1089,536,553
050,39,013,"Ohio","Belmont County",1,64,1029,511,518
050,39,013,"Ohio","Belmont County",1,65,979,495,484
050,39,013,"Ohio","Belmont County",1,66,979,481,498
050,39,013,"Ohio","Belmont County",1,67,945,478,467
050,39,013,"Ohio","Belmont County",1,68,928,456,472
050,39,013,"Ohio","Belmont County",1,69,880,429,451
050,39,013,"Ohio","Belmont County",1,70,807,403,404
050,39,013,"Ohio","Belmont County",1,71,800,383,417
050,39,013,"Ohio","Belmont County",1,72,787,379,408
050,39,013,"Ohio","Belmont County",1,73,814,414,400
050,39,013,"Ohio","Belmont County",1,74,532,256,276
050,39,013,"Ohio","Belmont County",1,75,468,218,250
050,39,013,"Ohio","Belmont County",1,76,462,209,253
050,39,013,"Ohio","Belmont County",1,77,466,207,259
050,39,013,"Ohio","Belmont County",1,78,404,161,243
050,39,013,"Ohio","Belmont County",1,79,387,171,216
050,39,013,"Ohio","Belmont County",1,80,352,151,201
050,39,013,"Ohio","Belmont County",1,81,362,144,218
050,39,013,"Ohio","Belmont County",1,82,323,119,204
050,39,013,"Ohio","Belmont County",1,83,297,111,186
050,39,013,"Ohio","Belmont County",1,84,279,98,181
050,39,013,"Ohio","Belmont County",1,85,1673,545,1128
050,39,013,"Ohio","Belmont County",2,0,628,332,296
050,39,013,"Ohio","Belmont County",2,1,629,332,297
050,39,013,"Ohio","Belmont County",2,2,608,296,312
050,39,013,"Ohio","Belmont County",2,3,625,304,321
050,39,013,"Ohio","Belmont County",2,4,632,319,313
050,39,013,"Ohio","Belmont County",2,5,658,329,329
050,39,013,"Ohio","Belmont County",2,6,694,346,348
050,39,013,"Ohio","Belmont County",2,7,693,356,337
050,39,013,"Ohio","Belmont County",2,8,693,356,337
050,39,013,"Ohio","Belmont County",2,9,723,373,350
050,39,013,"Ohio","Belmont County",2,10,727,385,342
050,39,013,"Ohio","Belmont County",2,11,749,395,354
050,39,013,"Ohio","Belmont County",2,12,734,362,372
050,39,013,"Ohio","Belmont County",2,13,743,363,380
050,39,013,"Ohio","Belmont County",2,14,753,372,381
050,39,013,"Ohio","Belmont County",2,15,741,373,368
050,39,013,"Ohio","Belmont County",2,16,764,414,350
050,39,013,"Ohio","Belmont County",2,17,760,413,347
050,39,013,"Ohio","Belmont County",2,18,674,376,298
050,39,013,"Ohio","Belmont County",2,19,584,349,235
050,39,013,"Ohio","Belmont County",2,20,672,414,258
050,39,013,"Ohio","Belmont County",2,21,685,415,270
050,39,013,"Ohio","Belmont County",2,22,766,458,308
050,39,013,"Ohio","Belmont County",2,23,785,470,315
050,39,013,"Ohio","Belmont County",2,24,784,469,315
050,39,013,"Ohio","Belmont County",2,25,796,464,332
050,39,013,"Ohio","Belmont County",2,26,825,480,345
050,39,013,"Ohio","Belmont County",2,27,820,454,366
050,39,013,"Ohio","Belmont County",2,28,874,491,383
050,39,013,"Ohio","Belmont County",2,29,924,532,392
050,39,013,"Ohio","Belmont County",2,30,873,508,365
050,39,013,"Ohio","Belmont County",2,31,846,498,348
050,39,013,"Ohio","Belmont County",2,32,838,475,363
050,39,013,"Ohio","Belmont County",2,33,791,439,352
050,39,013,"Ohio","Belmont County",2,34,809,456,353
050,39,013,"Ohio","Belmont County",2,35,791,440,351
050,39,013,"Ohio","Belmont County",2,36,766,414,352
050,39,013,"Ohio","Belmont County",2,37,818,433,385
050,39,013,"Ohio","Belmont County",2,38,824,429,395
050,39,013,"Ohio","Belmont County",2,39,827,454,373
050,39,013,"Ohio","Belmont County",2,40,806,446,360
050,39,013,"Ohio","Belmont County",2,41,776,428,348
050,39,013,"Ohio","Belmont County",2,42,758,410,348
050,39,013,"Ohio","Belmont County",2,43,768,407,361
050,39,013,"Ohio","Belmont County",2,44,741,394,347
050,39,013,"Ohio","Belmont County",2,45,763,404,359
050,39,013,"Ohio","Belmont County",2,46,791,422,369
050,39,013,"Ohio","Belmont County",2,47,802,430,372
050,39,013,"Ohio","Belmont County",2,48,849,459,390
050,39,013,"Ohio","Belmont County",2,49,901,475,426
050,39,013,"Ohio","Belmont County",2,50,892,475,417
050,39,013,"Ohio","Belmont County",2,51,858,471,387
050,39,013,"Ohio","Belmont County",2,52,842,451,391
050,39,013,"Ohio","Belmont County",2,53,838,423,415
050,39,013,"Ohio","Belmont County",2,54,852,425,427
050,39,013,"Ohio","Belmont County",2,55,876,431,445
050,39,013,"Ohio","Belmont County",2,56,928,464,464
050,39,013,"Ohio","Belmont County",2,57,967,471,496
050,39,013,"Ohio","Belmont County",2,58,1011,499,512
050,39,013,"Ohio","Belmont County",2,59,1061,535,526
050,39,013,"Ohio","Belmont County",2,60,1049,523,526
050,39,013,"Ohio","Belmont County",2,61,1047,514,533
050,39,013,"Ohio","Belmont County",2,62,1091,533,558
050,39,013,"Ohio","Belmont County",2,63,1100,540,560
050,39,013,"Ohio","Belmont County",2,64,1032,511,521
050,39,013,"Ohio","Belmont County",2,65,987,497,490
050,39,013,"Ohio","Belmont County",2,66,973,481,492
050,39,013,"Ohio","Belmont County",2,67,946,474,472
050,39,013,"Ohio","Belmont County",2,68,923,458,465
050,39,013,"Ohio","Belmont County",2,69,894,435,459
050,39,013,"Ohio","Belmont County",2,70,814,403,411
050,39,013,"Ohio","Belmont County",2,71,794,383,411
050,39,013,"Ohio","Belmont County",2,72,770,371,399
050,39,013,"Ohio","Belmont County",2,73,847,425,422
050,39,013,"Ohio","Belmont County",2,74,559,274,285
050,39,013,"Ohio","Belmont County",2,75,480,225,255
050,39,013,"Ohio","Belmont County",2,76,451,202,249
050,39,013,"Ohio","Belmont County",2,77,477,211,266
050,39,013,"Ohio","Belmont County",2,78,397,162,235
050,39,013,"Ohio","Belmont County",2,79,382,164,218
050,39,013,"Ohio","Belmont County",2,80,353,152,201
050,39,013,"Ohio","Belmont County",2,81,354,142,212
050,39,013,"Ohio","Belmont County",2,82,326,120,206
050,39,013,"Ohio","Belmont County",2,83,297,111,186
050,39,013,"Ohio","Belmont County",2,84,276,96,180
050,39,013,"Ohio","Belmont County",2,85,1667,543,1124
050,39,013,"Ohio","Belmont County",3,0,597,308,289
050,39,013,"Ohio","Belmont County",3,1,626,330,296
050,39,013,"Ohio","Belmont County",3,2,606,318,288
050,39,013,"Ohio","Belmont County",3,3,616,305,311
050,39,013,"Ohio","Belmont County",3,4,630,313,317
050,39,013,"Ohio","Belmont County",3,5,638,327,311
050,39,013,"Ohio","Belmont County",3,6,658,322,336
050,39,013,"Ohio","Belmont County",3,7,694,346,348
050,39,013,"Ohio","Belmont County",3,8,700,370,330
050,39,013,"Ohio","Belmont County",3,9,698,357,341
050,39,013,"Ohio","Belmont County",3,10,740,377,363
050,39,013,"Ohio","Belmont County",3,11,728,389,339
050,39,013,"Ohio","Belmont County",3,12,763,398,365
050,39,013,"Ohio","Belmont County",3,13,726,356,370
050,39,013,"Ohio","Belmont County",3,14,761,368,393
050,39,013,"Ohio","Belmont County",3,15,768,389,379
050,39,013,"Ohio","Belmont County",3,16,742,379,363
050,39,013,"Ohio","Belmont County",3,17,759,414,345
050,39,013,"Ohio","Belmont County",3,18,654,370,284
050,39,013,"Ohio","Belmont County",3,19,580,352,228
050,39,013,"Ohio","Belmont County",3,20,687,427,260
050,39,013,"Ohio","Belmont County",3,21,695,426,269
050,39,013,"Ohio","Belmont County",3,22,764,456,308
050,39,013,"Ohio","Belmont County",3,23,783,461,322
050,39,013,"Ohio","Belmont County",3,24,762,458,304
050,39,013,"Ohio","Belmont County",3,25,768,465,303
050,39,013,"Ohio","Belmont County",3,26,779,450,329
050,39,013,"Ohio","Belmont County",3,27,801,468,333
050,39,013,"Ohio","Belmont County",3,28,812,455,357
050,39,013,"Ohio","Belmont County",3,29,879,510,369
050,39,013,"Ohio","Belmont County",3,30,917,520,397
050,39,013,"Ohio","Belmont County",3,31,867,498,369
050,39,013,"Ohio","Belmont County",3,32,898,531,367
050,39,013,"Ohio","Belmont County",3,33,815,451,364
050,39,013,"Ohio","Belmont County",3,34,788,427,361
050,39,013,"Ohio","Belmont County",3,35,809,461,348
050,39,013,"Ohio","Belmont County",3,36,773,422,351
050,39,013,"Ohio","Belmont County",3,37,783,427,356
050,39,013,"Ohio","Belmont County",3,38,813,422,391
050,39,013,"Ohio","Belmont County",3,39,854,457,397
050,39,013,"Ohio","Belmont County",3,40,819,447,372
050,39,013,"Ohio","Belmont County",3,41,826,460,366
050,39,013,"Ohio","Belmont County",3,42,786,432,354
050,39,013,"Ohio","Belmont County",3,43,733,396,337
050,39,013,"Ohio","Belmont County",3,44,772,410,362
050,39,013,"Ohio","Belmont County",3,45,733,393,340
050,39,013,"Ohio","Belmont County",3,46,759,405,354
050,39,013,"Ohio","Belmont County",3,47,796,425,371
050,39,013,"Ohio","Belmont County",3,48,811,442,369
050,39,013,"Ohio","Belmont County",3,49,830,450,380
050,39,013,"Ohio","Belmont County",3,50,918,482,436
050,39,013,"Ohio","Belmont County",3,51,881,474,407
050,39,013,"Ohio","Belmont County",3,52,847,456,391
050,39,013,"Ohio","Belmont County",3,53,830,432,398
050,39,013,"Ohio","Belmont County",3,54,849,438,411
050,39,013,"Ohio","Belmont County",3,55,842,418,424
050,39,013,"Ohio","Belmont County",3,56,875,428,447
050,39,013,"Ohio","Belmont County",3,57,917,454,463
050,39,013,"Ohio","Belmont County",3,58,948,465,483
050,39,013,"Ohio","Belmont County",3,59,997,488,509
050,39,013,"Ohio","Belmont County",3,60,1041,526,515
050,39,013,"Ohio","Belmont County",3,61,1040,516,524
050,39,013,"Ohio","Belmont County",3,62,1048,517,531
050,39,013,"Ohio","Belmont County",3,63,1076,525,551
050,39,013,"Ohio","Belmont County",3,64,1055,511,544
050,39,013,"Ohio","Belmont County",3,65,1007,494,513
050,39,013,"Ohio","Belmont County",3,66,966,488,478
050,39,013,"Ohio","Belmont County",3,67,962,473,489
050,39,013,"Ohio","Belmont County",3,68,923,457,466
050,39,013,"Ohio","Belmont County",3,69,899,441,458
050,39,013,"Ohio","Belmont County",3,70,854,405,449
050,39,013,"Ohio","Belmont County",3,71,787,390,397
050,39,013,"Ohio","Belmont County",3,72,773,370,403
050,39,013,"Ohio","Belmont County",3,73,740,362,378
050,39,013,"Ohio","Belmont County",3,74,812,400,412
050,39,013,"Ohio","Belmont County",3,75,528,257,271
050,39,013,"Ohio","Belmont County",3,76,452,216,236
050,39,013,"Ohio","Belmont County",3,77,437,188,249
050,39,013,"Ohio","Belmont County",3,78,447,195,252
050,39,013,"Ohio","Belmont County",3,79,373,151,222
050,39,013,"Ohio","Belmont County",3,80,343,143,200
050,39,013,"Ohio","Belmont County",3,81,345,146,199
050,39,013,"Ohio","Belmont County",3,82,319,130,189
050,39,013,"Ohio","Belmont County",3,83,288,98,190
050,39,013,"Ohio","Belmont County",3,84,269,95,174
050,39,013,"Ohio","Belmont County",3,85,1615,516,1099
050,39,013,"Ohio","Belmont County",4,0,548,289,259
050,39,013,"Ohio","Belmont County",4,1,620,318,302
050,39,013,"Ohio","Belmont County",4,2,629,338,291
050,39,013,"Ohio","Belmont County",4,3,613,319,294
050,39,013,"Ohio","Belmont County",4,4,612,298,314
050,39,013,"Ohio","Belmont County",4,5,651,318,333
050,39,013,"Ohio","Belmont County",4,6,642,322,320
050,39,013,"Ohio","Belmont County",4,7,657,328,329
050,39,013,"Ohio","Belmont County",4,8,698,350,348
050,39,013,"Ohio","Belmont County",4,9,689,358,331
050,39,013,"Ohio","Belmont County",4,10,702,352,350
050,39,013,"Ohio","Belmont County",4,11,727,378,349
050,39,013,"Ohio","Belmont County",4,12,721,383,338
050,39,013,"Ohio","Belmont County",4,13,760,397,363
050,39,013,"Ohio","Belmont County",4,14,748,374,374
050,39,013,"Ohio","Belmont County",4,15,773,382,391
050,39,013,"Ohio","Belmont County",4,16,794,400,394
050,39,013,"Ohio","Belmont County",4,17,746,380,366
050,39,013,"Ohio","Belmont County",4,18,678,381,297
050,39,013,"Ohio","Belmont County",4,19,540,339,201
050,39,013,"Ohio","Belmont County",4,20,683,434,249
050,39,013,"Ohio","Belmont County",4,21,715,444,271
050,39,013,"Ohio","Belmont County",4,22,781,480,301
050,39,013,"Ohio","Belmont County",4,23,772,455,317
050,39,013,"Ohio","Belmont County",4,24,780,448,332
050,39,013,"Ohio","Belmont County",4,25,772,459,313
050,39,013,"Ohio","Belmont County",4,26,783,458,325
050,39,013,"Ohio","Belmont County",4,27,770,437,333
050,39,013,"Ohio","Belmont County",4,28,825,485,340
050,39,013,"Ohio","Belmont County",4,29,837,486,351
050,39,013,"Ohio","Belmont County",4,30,857,487,370
050,39,013,"Ohio","Belmont County",4,31,913,522,391
050,39,013,"Ohio","Belmont County",4,32,859,501,358
050,39,013,"Ohio","Belmont County",4,33,876,504,372
050,39,013,"Ohio","Belmont County",4,34,813,448,365
050,39,013,"Ohio","Belmont County",4,35,773,418,355
050,39,013,"Ohio","Belmont County",4,36,801,445,356
050,39,013,"Ohio","Belmont County",4,37,793,439,354
050,39,013,"Ohio","Belmont County",4,38,766,410,356
050,39,013,"Ohio","Belmont County",4,39,829,439,390
050,39,013,"Ohio","Belmont County",4,40,841,444,397
050,39,013,"Ohio","Belmont County",4,41,824,456,368
050,39,013,"Ohio","Belmont County",4,42,842,463,379
050,39,013,"Ohio","Belmont County",4,43,776,423,353
050,39,013,"Ohio","Belmont County",4,44,719,387,332
050,39,013,"Ohio","Belmont County",4,45,774,413,361
050,39,013,"Ohio","Belmont County",4,46,742,401,341
050,39,013,"Ohio","Belmont County",4,47,748,392,356
050,39,013,"Ohio","Belmont County",4,48,778,415,363
050,39,013,"Ohio","Belmont County",4,49,794,427,367
050,39,013,"Ohio","Belmont County",4,50,827,445,382
050,39,013,"Ohio","Belmont County",4,51,903,475,428
050,39,013,"Ohio","Belmont County",4,52,865,465,400
050,39,013,"Ohio","Belmont County",4,53,843,444,399
050,39,013,"Ohio","Belmont County",4,54,818,427,391
050,39,013,"Ohio","Belmont County",4,55,832,429,403
050,39,013,"Ohio","Belmont County",4,56,837,416,421
050,39,013,"Ohio","Belmont County",4,57,855,414,441
050,39,013,"Ohio","Belmont County",4,58,903,445,458
050,39,013,"Ohio","Belmont County",4,59,929,448,481
050,39,013,"Ohio","Belmont County",4,60,972,478,494
050,39,013,"Ohio","Belmont County",4,61,1041,525,516
050,39,013,"Ohio","Belmont County",4,62,1036,520,516
050,39,013,"Ohio","Belmont County",4,63,1035,517,518
050,39,013,"Ohio","Belmont County",4,64,1043,495,548
050,39,013,"Ohio","Belmont County",4,65,1038,500,538
050,39,013,"Ohio","Belmont County",4,66,999,487,512
050,39,013,"Ohio","Belmont County",4,67,953,480,473
050,39,013,"Ohio","Belmont County",4,68,952,455,497
050,39,013,"Ohio","Belmont County",4,69,890,445,445
050,39,013,"Ohio","Belmont County",4,70,855,415,440
050,39,013,"Ohio","Belmont County",4,71,820,387,433
050,39,013,"Ohio","Belmont County",4,72,766,381,385
050,39,013,"Ohio","Belmont County",4,73,754,359,395
050,39,013,"Ohio","Belmont County",4,74,707,342,365
050,39,013,"Ohio","Belmont County",4,75,783,385,398
050,39,013,"Ohio","Belmont County",4,76,493,241,252
050,39,013,"Ohio","Belmont County",4,77,437,202,235
050,39,013,"Ohio","Belmont County",4,78,414,175,239
050,39,013,"Ohio","Belmont County",4,79,426,186,240
050,39,013,"Ohio","Belmont County",4,80,339,131,208
050,39,013,"Ohio","Belmont County",4,81,328,132,196
050,39,013,"Ohio","Belmont County",4,82,313,130,183
050,39,013,"Ohio","Belmont County",4,83,280,112,168
050,39,013,"Ohio","Belmont County",4,84,267,82,185
050,39,013,"Ohio","Belmont County",4,85,1558,487,1071
050,39,013,"Ohio","Belmont County",5,0,478,250,228
050,39,013,"Ohio","Belmont County",5,1,554,297,257
050,39,013,"Ohio","Belmont County",5,2,604,311,293
050,39,013,"Ohio","Belmont County",5,3,632,345,287
050,39,013,"Ohio","Belmont County",5,4,618,328,290
050,39,013,"Ohio","Belmont County",5,5,612,292,320
050,39,013,"Ohio","Belmont County",5,6,647,315,332
050,39,013,"Ohio","Belmont County",5,7,621,321,300
050,39,013,"Ohio","Belmont County",5,8,669,335,334
050,39,013,"Ohio","Belmont County",5,9,702,352,350
050,39,013,"Ohio","Belmont County",5,10,698,354,344
050,39,013,"Ohio","Belmont County",5,11,693,351,342
050,39,013,"Ohio","Belmont County",5,12,735,388,347
050,39,013,"Ohio","Belmont County",5,13,727,380,347
050,39,013,"Ohio","Belmont County",5,14,767,406,361
050,39,013,"Ohio","Belmont County",5,15,750,373,377
050,39,013,"Ohio","Belmont County",5,16,772,379,393
050,39,013,"Ohio","Belmont County",5,17,781,398,383
050,39,013,"Ohio","Belmont County",5,18,656,355,301
050,39,013,"Ohio","Belmont County",5,19,575,347,228
050,39,013,"Ohio","Belmont County",5,20,636,422,214
050,39,013,"Ohio","Belmont County",5,21,712,443,269
050,39,013,"Ohio","Belmont County",5,22,782,485,297
050,39,013,"Ohio","Belmont County",5,23,789,484,305
050,39,013,"Ohio","Belmont County",5,24,769,456,313
050,39,013,"Ohio","Belmont County",5,25,772,441,331
050,39,013,"Ohio","Belmont County",5,26,758,448,310
050,39,013,"Ohio","Belmont County",5,27,768,446,322
050,39,013,"Ohio","Belmont County",5,28,772,451,321
050,39,013,"Ohio","Belmont County",5,29,834,495,339
050,39,013,"Ohio","Belmont County",5,30,804,460,344
050,39,013,"Ohio","Belmont County",5,31,838,470,368
050,39,013,"Ohio","Belmont County",5,32,919,525,394
050,39,013,"Ohio","Belmont County",5,33,837,473,364
050,39,013,"Ohio","Belmont County",5,34,864,497,367
050,39,013,"Ohio","Belmont County",5,35,808,447,361
050,39,013,"Ohio","Belmont County",5,36,730,388,342
050,39,013,"Ohio","Belmont County",5,37,825,466,359
050,39,013,"Ohio","Belmont County",5,38,777,418,359
050,39,013,"Ohio","Belmont County",5,39,780,417,363
050,39,013,"Ohio","Belmont County",5,40,826,432,394
050,39,013,"Ohio","Belmont County",5,41,858,463,395
050,39,013,"Ohio","Belmont County",5,42,854,469,385
050,39,013,"Ohio","Belmont County",5,43,830,458,372
050,39,013,"Ohio","Belmont County",5,44,768,417,351
050,39,013,"Ohio","Belmont County",5,45,705,375,330
050,39,013,"Ohio","Belmont County",5,46,765,411,354
050,39,013,"Ohio","Belmont County",5,47,744,401,343
050,39,013,"Ohio","Belmont County",5,48,742,397,345
050,39,013,"Ohio","Belmont County",5,49,765,399,366
050,39,013,"Ohio","Belmont County",5,50,803,428,375
050,39,013,"Ohio","Belmont County",5,51,812,433,379
050,39,013,"Ohio","Belmont County",5,52,893,468,425
050,39,013,"Ohio","Belmont County",5,53,850,440,410
050,39,013,"Ohio","Belmont County",5,54,846,452,394
050,39,013,"Ohio","Belmont County",5,55,800,417,383
050,39,013,"Ohio","Belmont County",5,56,839,431,408
050,39,013,"Ohio","Belmont County",5,57,838,414,424
050,39,013,"Ohio","Belmont County",5,58,846,408,438
050,39,013,"Ohio","Belmont County",5,59,884,427,457
050,39,013,"Ohio","Belmont County",5,60,912,440,472
050,39,013,"Ohio","Belmont County",5,61,959,473,486
050,39,013,"Ohio","Belmont County",5,62,1034,520,514
050,39,013,"Ohio","Belmont County",5,63,1018,514,504
050,39,013,"Ohio","Belmont County",5,64,1007,499,508
050,39,013,"Ohio","Belmont County",5,65,1029,482,547
050,39,013,"Ohio","Belmont County",5,66,1017,490,527
050,39,013,"Ohio","Belmont County",5,67,988,482,506
050,39,013,"Ohio","Belmont County",5,68,930,461,469
050,39,013,"Ohio","Belmont County",5,69,926,443,483
050,39,013,"Ohio","Belmont County",5,70,859,429,430
050,39,013,"Ohio","Belmont County",5,71,820,399,421
050,39,013,"Ohio","Belmont County",5,72,803,379,424
050,39,013,"Ohio","Belmont County",5,73,755,375,380
050,39,013,"Ohio","Belmont County",5,74,734,346,388
050,39,013,"Ohio","Belmont County",5,75,682,326,356
050,39,013,"Ohio","Belmont County",5,76,745,368,377
050,39,013,"Ohio","Belmont County",5,77,484,233,251
050,39,013,"Ohio","Belmont County",5,78,413,190,223
050,39,013,"Ohio","Belmont County",5,79,396,169,227
050,39,013,"Ohio","Belmont County",5,80,382,159,223
050,39,013,"Ohio","Belmont County",5,81,328,119,209
050,39,013,"Ohio","Belmont County",5,82,291,116,175
050,39,013,"Ohio","Belmont County",5,83,282,115,167
050,39,013,"Ohio","Belmont County",5,84,256,98,158
050,39,013,"Ohio","Belmont County",5,85,1535,474,1061
050,39,015,"Ohio","Brown County",1,0,486,246,240
050,39,015,"Ohio","Brown County",1,1,491,256,235
050,39,015,"Ohio","Brown County",1,2,504,242,262
050,39,015,"Ohio","Brown County",1,3,518,271,247
050,39,015,"Ohio","Brown County",1,4,519,267,252
050,39,015,"Ohio","Brown County",1,5,537,259,278
050,39,015,"Ohio","Brown County",1,6,505,265,240
050,39,015,"Ohio","Brown County",1,7,534,280,254
050,39,015,"Ohio","Brown County",1,8,537,265,272
050,39,015,"Ohio","Brown County",1,9,560,267,293
050,39,015,"Ohio","Brown County",1,10,572,288,284
050,39,015,"Ohio","Brown County",1,11,607,299,308
050,39,015,"Ohio","Brown County",1,12,617,297,320
050,39,015,"Ohio","Brown County",1,13,604,306,298
050,39,015,"Ohio","Brown County",1,14,595,320,275
050,39,015,"Ohio","Brown County",1,15,626,334,292
050,39,015,"Ohio","Brown County",1,16,631,326,305
050,39,015,"Ohio","Brown County",1,17,617,318,299
050,39,015,"Ohio","Brown County",1,18,516,278,238
050,39,015,"Ohio","Brown County",1,19,388,211,177
050,39,015,"Ohio","Brown County",1,20,419,214,205
050,39,015,"Ohio","Brown County",1,21,442,230,212
050,39,015,"Ohio","Brown County",1,22,448,221,227
050,39,015,"Ohio","Brown County",1,23,476,228,248
050,39,015,"Ohio","Brown County",1,24,471,229,242
050,39,015,"Ohio","Brown County",1,25,512,249,263
050,39,015,"Ohio","Brown County",1,26,504,247,257
050,39,015,"Ohio","Brown County",1,27,529,283,246
050,39,015,"Ohio","Brown County",1,28,531,268,263
050,39,015,"Ohio","Brown County",1,29,510,237,273
050,39,015,"Ohio","Brown County",1,30,496,251,245
050,39,015,"Ohio","Brown County",1,31,482,259,223
050,39,015,"Ohio","Brown County",1,32,463,247,216
050,39,015,"Ohio","Brown County",1,33,471,241,230
050,39,015,"Ohio","Brown County",1,34,469,240,229
050,39,015,"Ohio","Brown County",1,35,487,236,251
050,39,015,"Ohio","Brown County",1,36,499,256,243
050,39,015,"Ohio","Brown County",1,37,506,240,266
050,39,015,"Ohio","Brown County",1,38,505,243,262
050,39,015,"Ohio","Brown County",1,39,539,246,293
050,39,015,"Ohio","Brown County",1,40,532,281,251
050,39,015,"Ohio","Brown County",1,41,525,260,265
050,39,015,"Ohio","Brown County",1,42,521,268,253
050,39,015,"Ohio","Brown County",1,43,539,266,273
050,39,015,"Ohio","Brown County",1,44,502,269,233
050,39,015,"Ohio","Brown County",1,45,527,275,252
050,39,015,"Ohio","Brown County",1,46,534,280,254
050,39,015,"Ohio","Brown County",1,47,588,301,287
050,39,015,"Ohio","Brown County",1,48,640,326,314
050,39,015,"Ohio","Brown County",1,49,640,331,309
050,39,015,"Ohio","Brown County",1,50,581,276,305
050,39,015,"Ohio","Brown County",1,51,538,266,272
050,39,015,"Ohio","Brown County",1,52,533,265,268
050,39,015,"Ohio","Brown County",1,53,559,288,271
050,39,015,"Ohio","Brown County",1,54,597,310,287
050,39,015,"Ohio","Brown County",1,55,644,340,304
050,39,015,"Ohio","Brown County",1,56,704,358,346
050,39,015,"Ohio","Brown County",1,57,674,347,327
050,39,015,"Ohio","Brown County",1,58,674,344,330
050,39,015,"Ohio","Brown County",1,59,661,322,339
050,39,015,"Ohio","Brown County",1,60,654,315,339
050,39,015,"Ohio","Brown County",1,61,670,322,348
050,39,015,"Ohio","Brown County",1,62,667,345,322
050,39,015,"Ohio","Brown County",1,63,650,328,322
050,39,015,"Ohio","Brown County",1,64,626,304,322
050,39,015,"Ohio","Brown County",1,65,616,295,321
050,39,015,"Ohio","Brown County",1,66,534,256,278
050,39,015,"Ohio","Brown County",1,67,513,257,256
050,39,015,"Ohio","Brown County",1,68,499,251,248
050,39,015,"Ohio","Brown County",1,69,465,233,232
050,39,015,"Ohio","Brown County",1,70,460,217,243
050,39,015,"Ohio","Brown County",1,71,449,220,229
050,39,015,"Ohio","Brown County",1,72,440,228,212
050,39,015,"Ohio","Brown County",1,73,455,238,217
050,39,015,"Ohio","Brown County",1,74,327,158,169
050,39,015,"Ohio","Brown County",1,75,306,148,158
050,39,015,"Ohio","Brown County",1,76,311,150,161
050,39,015,"Ohio","Brown County",1,77,296,134,162
050,39,015,"Ohio","Brown County",1,78,259,118,141
050,39,015,"Ohio","Brown County",1,79,254,113,141
050,39,015,"Ohio","Brown County",1,80,237,108,129
050,39,015,"Ohio","Brown County",1,81,207,94,113
050,39,015,"Ohio","Brown County",1,82,192,82,110
050,39,015,"Ohio","Brown County",1,83,173,77,96
050,39,015,"Ohio","Brown County",1,84,154,63,91
050,39,015,"Ohio","Brown County",1,85,823,342,481
050,39,015,"Ohio","Brown County",2,0,500,260,240
050,39,015,"Ohio","Brown County",2,1,488,253,235
050,39,015,"Ohio","Brown County",2,2,499,245,254
050,39,015,"Ohio","Brown County",2,3,510,261,249
050,39,015,"Ohio","Brown County",2,4,519,267,252
050,39,015,"Ohio","Brown County",2,5,533,264,269
050,39,015,"Ohio","Brown County",2,6,517,266,251
050,39,015,"Ohio","Brown County",2,7,524,274,250
050,39,015,"Ohio","Brown County",2,8,535,266,269
050,39,015,"Ohio","Brown County",2,9,551,264,287
050,39,015,"Ohio","Brown County",2,10,568,284,284
050,39,015,"Ohio","Brown County",2,11,598,297,301
050,39,015,"Ohio","Brown County",2,12,618,300,318
050,39,015,"Ohio","Brown County",2,13,608,304,304
050,39,015,"Ohio","Brown County",2,14,599,319,280
050,39,015,"Ohio","Brown County",2,15,618,329,289
050,39,015,"Ohio","Brown County",2,16,632,328,304
050,39,015,"Ohio","Brown County",2,17,621,318,303
050,39,015,"Ohio","Brown County",2,18,511,274,237
050,39,015,"Ohio","Brown County",2,19,395,213,182
050,39,015,"Ohio","Brown County",2,20,427,221,206
050,39,015,"Ohio","Brown County",2,21,442,228,214
050,39,015,"Ohio","Brown County",2,22,452,222,230
050,39,015,"Ohio","Brown County",2,23,477,231,246
050,39,015,"Ohio","Brown County",2,24,475,229,246
050,39,015,"Ohio","Brown County",2,25,505,249,256
050,39,015,"Ohio","Brown County",2,26,509,253,256
050,39,015,"Ohio","Brown County",2,27,525,276,249
050,39,015,"Ohio","Brown County",2,28,531,272,259
050,39,015,"Ohio","Brown County",2,29,517,246,271
050,39,015,"Ohio","Brown County",2,30,499,246,253
050,39,015,"Ohio","Brown County",2,31,486,255,231
050,39,015,"Ohio","Brown County",2,32,466,248,218
050,39,015,"Ohio","Brown County",2,33,470,243,227
050,39,015,"Ohio","Brown County",2,34,467,239,228
050,39,015,"Ohio","Brown County",2,35,484,239,245
050,39,015,"Ohio","Brown County",2,36,494,250,244
050,39,015,"Ohio","Brown County",2,37,507,245,262
050,39,015,"Ohio","Brown County",2,38,503,241,262
050,39,015,"Ohio","Brown County",2,39,528,245,283
050,39,015,"Ohio","Brown County",2,40,536,273,263
050,39,015,"Ohio","Brown County",2,41,530,267,263
050,39,015,"Ohio","Brown County",2,42,522,265,257
050,39,015,"Ohio","Brown County",2,43,538,269,269
050,39,015,"Ohio","Brown County",2,44,506,265,241
050,39,015,"Ohio","Brown County",2,45,522,275,247
050,39,015,"Ohio","Brown County",2,46,531,280,251
050,39,015,"Ohio","Brown County",2,47,576,296,280
050,39,015,"Ohio","Brown County",2,48,622,316,306
050,39,015,"Ohio","Brown County",2,49,642,331,311
050,39,015,"Ohio","Brown County",2,50,593,287,306
050,39,015,"Ohio","Brown County",2,51,546,268,278
050,39,015,"Ohio","Brown County",2,52,530,264,266
050,39,015,"Ohio","Brown County",2,53,549,280,269
050,39,015,"Ohio","Brown County",2,54,587,305,282
050,39,015,"Ohio","Brown County",2,55,634,332,302
050,39,015,"Ohio","Brown County",2,56,694,355,339
050,39,015,"Ohio","Brown County",2,57,680,349,331
050,39,015,"Ohio","Brown County",2,58,672,345,327
050,39,015,"Ohio","Brown County",2,59,669,329,340
050,39,015,"Ohio","Brown County",2,60,650,317,333
050,39,015,"Ohio","Brown County",2,61,662,318,344
050,39,015,"Ohio","Brown County",2,62,665,337,328
050,39,015,"Ohio","Brown County",2,63,661,334,327
050,39,015,"Ohio","Brown County",2,64,627,307,320
050,39,015,"Ohio","Brown County",2,65,615,294,321
050,39,015,"Ohio","Brown County",2,66,556,266,290
050,39,015,"Ohio","Brown County",2,67,517,257,260
050,39,015,"Ohio","Brown County",2,68,496,250,246
050,39,015,"Ohio","Brown County",2,69,469,235,234
050,39,015,"Ohio","Brown County",2,70,456,222,234
050,39,015,"Ohio","Brown County",2,71,449,218,231
050,39,015,"Ohio","Brown County",2,72,432,221,211
050,39,015,"Ohio","Brown County",2,73,473,247,226
050,39,015,"Ohio","Brown County",2,74,334,166,168
050,39,015,"Ohio","Brown County",2,75,307,148,159
050,39,015,"Ohio","Brown County",2,76,300,142,158
050,39,015,"Ohio","Brown County",2,77,303,140,163
050,39,015,"Ohio","Brown County",2,78,261,118,143
050,39,015,"Ohio","Brown County",2,79,252,111,141
050,39,015,"Ohio","Brown County",2,80,238,107,131
050,39,015,"Ohio","Brown County",2,81,209,95,114
050,39,015,"Ohio","Brown County",2,82,197,85,112
050,39,015,"Ohio","Brown County",2,83,176,76,100
050,39,015,"Ohio","Brown County",2,84,156,64,92
050,39,015,"Ohio","Brown County",2,85,825,338,487
050,39,015,"Ohio","Brown County",3,0,440,196,244
050,39,015,"Ohio","Brown County",3,1,511,260,251
050,39,015,"Ohio","Brown County",3,2,508,264,244
050,39,015,"Ohio","Brown County",3,3,497,252,245
050,39,015,"Ohio","Brown County",3,4,521,259,262
050,39,015,"Ohio","Brown County",3,5,538,265,273
050,39,015,"Ohio","Brown County",3,6,560,279,281
050,39,015,"Ohio","Brown County",3,7,526,263,263
050,39,015,"Ohio","Brown County",3,8,536,287,249
050,39,015,"Ohio","Brown County",3,9,539,279,260
050,39,015,"Ohio","Brown County",3,10,562,282,280
050,39,015,"Ohio","Brown County",3,11,568,296,272
050,39,015,"Ohio","Brown County",3,12,599,295,304
050,39,015,"Ohio","Brown County",3,13,630,295,335
050,39,015,"Ohio","Brown County",3,14,600,296,304
050,39,015,"Ohio","Brown County",3,15,604,322,282
050,39,015,"Ohio","Brown County",3,16,601,319,282
050,39,015,"Ohio","Brown County",3,17,631,331,300
050,39,015,"Ohio","Brown County",3,18,512,271,241
050,39,015,"Ohio","Brown County",3,19,399,219,180
050,39,015,"Ohio","Brown County",3,20,402,216,186
050,39,015,"Ohio","Brown County",3,21,430,215,215
050,39,015,"Ohio","Brown County",3,22,446,225,221
050,39,015,"Ohio","Brown County",3,23,490,248,242
050,39,015,"Ohio","Brown County",3,24,464,220,244
050,39,015,"Ohio","Brown County",3,25,493,237,256
050,39,015,"Ohio","Brown County",3,26,507,244,263
050,39,015,"Ohio","Brown County",3,27,508,255,253
050,39,015,"Ohio","Brown County",3,28,517,274,243
050,39,015,"Ohio","Brown County",3,29,535,271,264
050,39,015,"Ohio","Brown County",3,30,528,253,275
050,39,015,"Ohio","Brown County",3,31,500,248,252
050,39,015,"Ohio","Brown County",3,32,505,270,235
050,39,015,"Ohio","Brown County",3,33,449,240,209
050,39,015,"Ohio","Brown County",3,34,493,265,228
050,39,015,"Ohio","Brown County",3,35,465,235,230
050,39,015,"Ohio","Brown County",3,36,507,246,261
050,39,015,"Ohio","Brown County",3,37,510,256,254
050,39,015,"Ohio","Brown County",3,38,503,244,259
050,39,015,"Ohio","Brown County",3,39,521,241,280
050,39,015,"Ohio","Brown County",3,40,529,242,287
050,39,015,"Ohio","Brown County",3,41,544,282,262
050,39,015,"Ohio","Brown County",3,42,544,267,277
050,39,015,"Ohio","Brown County",3,43,515,268,247
050,39,015,"Ohio","Brown County",3,44,542,278,264
050,39,015,"Ohio","Brown County",3,45,499,264,235
050,39,015,"Ohio","Brown County",3,46,525,276,249
050,39,015,"Ohio","Brown County",3,47,537,279,258
050,39,015,"Ohio","Brown County",3,48,572,290,282
050,39,015,"Ohio","Brown County",3,49,617,316,301
050,39,015,"Ohio","Brown County",3,50,627,321,306
050,39,015,"Ohio","Brown County",3,51,596,290,306
050,39,015,"Ohio","Brown County",3,52,548,261,287
050,39,015,"Ohio","Brown County",3,53,531,260,271
050,39,015,"Ohio","Brown County",3,54,558,280,278
050,39,015,"Ohio","Brown County",3,55,600,316,284
050,39,015,"Ohio","Brown County",3,56,635,337,298
050,39,015,"Ohio","Brown County",3,57,686,352,334
050,39,015,"Ohio","Brown County",3,58,685,354,331
050,39,015,"Ohio","Brown County",3,59,674,341,333
050,39,015,"Ohio","Brown County",3,60,657,323,334
050,39,015,"Ohio","Brown County",3,61,650,313,337
050,39,015,"Ohio","Brown County",3,62,656,319,337
050,39,015,"Ohio","Brown County",3,63,649,325,324
050,39,015,"Ohio","Brown County",3,64,656,331,325
050,39,015,"Ohio","Brown County",3,65,615,303,312
050,39,015,"Ohio","Brown County",3,66,606,287,319
050,39,015,"Ohio","Brown County",3,67,535,255,280
050,39,015,"Ohio","Brown County",3,68,507,246,261
050,39,015,"Ohio","Brown County",3,69,487,244,243
050,39,015,"Ohio","Brown County",3,70,450,227,223
050,39,015,"Ohio","Brown County",3,71,454,218,236
050,39,015,"Ohio","Brown County",3,72,438,215,223
050,39,015,"Ohio","Brown County",3,73,407,201,206
050,39,015,"Ohio","Brown County",3,74,460,239,221
050,39,015,"Ohio","Brown County",3,75,323,158,165
050,39,015,"Ohio","Brown County",3,76,291,138,153
050,39,015,"Ohio","Brown County",3,77,284,132,152
050,39,015,"Ohio","Brown County",3,78,296,135,161
050,39,015,"Ohio","Brown County",3,79,248,109,139
050,39,015,"Ohio","Brown County",3,80,230,103,127
050,39,015,"Ohio","Brown County",3,81,212,100,112
050,39,015,"Ohio","Brown County",3,82,195,89,106
050,39,015,"Ohio","Brown County",3,83,196,83,113
050,39,015,"Ohio","Brown County",3,84,165,69,96
050,39,015,"Ohio","Brown County",3,85,810,320,490
050,39,015,"Ohio","Brown County",4,0,465,233,232
050,39,015,"Ohio","Brown County",4,1,461,208,253
050,39,015,"Ohio","Brown County",4,2,512,257,255
050,39,015,"Ohio","Brown County",4,3,521,266,255
050,39,015,"Ohio","Brown County",4,4,496,249,247
050,39,015,"Ohio","Brown County",4,5,526,267,259
050,39,015,"Ohio","Brown County",4,6,548,285,263
050,39,015,"Ohio","Brown County",4,7,574,283,291
050,39,015,"Ohio","Brown County",4,8,544,274,270
050,39,015,"Ohio","Brown County",4,9,540,295,245
050,39,015,"Ohio","Brown County",4,10,529,279,250
050,39,015,"Ohio","Brown County",4,11,559,275,284
050,39,015,"Ohio","Brown County",4,12,590,304,286
050,39,015,"Ohio","Brown County",4,13,603,290,313
050,39,015,"Ohio","Brown County",4,14,640,295,345
050,39,015,"Ohio","Brown County",4,15,610,302,308
050,39,015,"Ohio","Brown County",4,16,616,329,287
050,39,015,"Ohio","Brown County",4,17,614,317,297
050,39,015,"Ohio","Brown County",4,18,530,293,237
050,39,015,"Ohio","Brown County",4,19,371,206,165
050,39,015,"Ohio","Brown County",4,20,414,225,189
050,39,015,"Ohio","Brown County",4,21,407,219,188
050,39,015,"Ohio","Brown County",4,22,468,227,241
050,39,015,"Ohio","Brown County",4,23,470,231,239
050,39,015,"Ohio","Brown County",4,24,488,240,248
050,39,015,"Ohio","Brown County",4,25,448,228,220
050,39,015,"Ohio","Brown County",4,26,491,237,254
050,39,015,"Ohio","Brown County",4,27,505,245,260
050,39,015,"Ohio","Brown County",4,28,511,264,247
050,39,015,"Ohio","Brown County",4,29,519,258,261
050,39,015,"Ohio","Brown County",4,30,533,268,265
050,39,015,"Ohio","Brown County",4,31,546,263,283
050,39,015,"Ohio","Brown County",4,32,503,245,258
050,39,015,"Ohio","Brown County",4,33,501,259,242
050,39,015,"Ohio","Brown County",4,34,472,252,220
050,39,015,"Ohio","Brown County",4,35,491,255,236
050,39,015,"Ohio","Brown County",4,36,472,237,235
050,39,015,"Ohio","Brown County",4,37,525,260,265
050,39,015,"Ohio","Brown County",4,38,510,253,257
050,39,015,"Ohio","Brown County",4,39,501,239,262
050,39,015,"Ohio","Brown County",4,40,506,235,271
050,39,015,"Ohio","Brown County",4,41,540,244,296
050,39,015,"Ohio","Brown County",4,42,557,293,264
050,39,015,"Ohio","Brown County",4,43,560,278,282
050,39,015,"Ohio","Brown County",4,44,507,267,240
050,39,015,"Ohio","Brown County",4,45,553,272,281
050,39,015,"Ohio","Brown County",4,46,508,268,240
050,39,015,"Ohio","Brown County",4,47,530,270,260
050,39,015,"Ohio","Brown County",4,48,529,271,258
050,39,015,"Ohio","Brown County",4,49,565,292,273
050,39,015,"Ohio","Brown County",4,50,633,322,311
050,39,015,"Ohio","Brown County",4,51,639,331,308
050,39,015,"Ohio","Brown County",4,52,585,284,301
050,39,015,"Ohio","Brown County",4,53,543,256,287
050,39,015,"Ohio","Brown County",4,54,536,257,279
050,39,015,"Ohio","Brown County",4,55,553,280,273
050,39,015,"Ohio","Brown County",4,56,600,314,286
050,39,015,"Ohio","Brown County",4,57,637,335,302
050,39,015,"Ohio","Brown County",4,58,674,344,330
050,39,015,"Ohio","Brown County",4,59,683,355,328
050,39,015,"Ohio","Brown County",4,60,663,335,328
050,39,015,"Ohio","Brown County",4,61,650,319,331
050,39,015,"Ohio","Brown County",4,62,639,309,330
050,39,015,"Ohio","Brown County",4,63,634,305,329
050,39,015,"Ohio","Brown County",4,64,635,322,313
050,39,015,"Ohio","Brown County",4,65,645,320,325
050,39,015,"Ohio","Brown County",4,66,619,305,314
050,39,015,"Ohio","Brown County",4,67,593,284,309
050,39,015,"Ohio","Brown County",4,68,533,250,283
050,39,015,"Ohio","Brown County",4,69,492,235,257
050,39,015,"Ohio","Brown County",4,70,480,242,238
050,39,015,"Ohio","Brown County",4,71,444,221,223
050,39,015,"Ohio","Brown County",4,72,436,204,232
050,39,015,"Ohio","Brown County",4,73,418,200,218
050,39,015,"Ohio","Brown County",4,74,386,185,201
050,39,015,"Ohio","Brown County",4,75,451,233,218
050,39,015,"Ohio","Brown County",4,76,300,150,150
050,39,015,"Ohio","Brown County",4,77,278,132,146
050,39,015,"Ohio","Brown County",4,78,267,122,145
050,39,015,"Ohio","Brown County",4,79,286,128,158
050,39,015,"Ohio","Brown County",4,80,225,96,129
050,39,015,"Ohio","Brown County",4,81,209,94,115
050,39,015,"Ohio","Brown County",4,82,203,98,105
050,39,015,"Ohio","Brown County",4,83,181,83,98
050,39,015,"Ohio","Brown County",4,84,175,73,102
050,39,015,"Ohio","Brown County",4,85,796,304,492
050,39,015,"Ohio","Brown County",5,0,476,238,238
050,39,015,"Ohio","Brown County",5,1,461,226,235
050,39,015,"Ohio","Brown County",5,2,479,216,263
050,39,015,"Ohio","Brown County",5,3,538,272,266
050,39,015,"Ohio","Brown County",5,4,526,264,262
050,39,015,"Ohio","Brown County",5,5,534,273,261
050,39,015,"Ohio","Brown County",5,6,553,276,277
050,39,015,"Ohio","Brown County",5,7,534,280,254
050,39,015,"Ohio","Brown County",5,8,589,291,298
050,39,015,"Ohio","Brown County",5,9,563,285,278
050,39,015,"Ohio","Brown County",5,10,543,288,255
050,39,015,"Ohio","Brown County",5,11,535,285,250
050,39,015,"Ohio","Brown County",5,12,569,282,287
050,39,015,"Ohio","Brown County",5,13,583,299,284
050,39,015,"Ohio","Brown County",5,14,606,305,301
050,39,015,"Ohio","Brown County",5,15,631,291,340
050,39,015,"Ohio","Brown County",5,16,606,302,304
050,39,015,"Ohio","Brown County",5,17,605,320,285
050,39,015,"Ohio","Brown County",5,18,504,276,228
050,39,015,"Ohio","Brown County",5,19,396,221,175
050,39,015,"Ohio","Brown County",5,20,389,213,176
050,39,015,"Ohio","Brown County",5,21,433,237,196
050,39,015,"Ohio","Brown County",5,22,419,225,194
050,39,015,"Ohio","Brown County",5,23,481,243,238
050,39,015,"Ohio","Brown County",5,24,501,244,257
050,39,015,"Ohio","Brown County",5,25,509,262,247
050,39,015,"Ohio","Brown County",5,26,461,233,228
050,39,015,"Ohio","Brown County",5,27,494,246,248
050,39,015,"Ohio","Brown County",5,28,509,252,257
050,39,015,"Ohio","Brown County",5,29,520,273,247
050,39,015,"Ohio","Brown County",5,30,541,265,276
050,39,015,"Ohio","Brown County",5,31,518,264,254
050,39,015,"Ohio","Brown County",5,32,566,269,297
050,39,015,"Ohio","Brown County",5,33,528,260,268
050,39,015,"Ohio","Brown County",5,34,502,257,245
050,39,015,"Ohio","Brown County",5,35,461,241,220
050,39,015,"Ohio","Brown County",5,36,489,250,239
050,39,015,"Ohio","Brown County",5,37,462,236,226
050,39,015,"Ohio","Brown County",5,38,528,263,265
050,39,015,"Ohio","Brown County",5,39,503,252,251
050,39,015,"Ohio","Brown County",5,40,510,248,262
050,39,015,"Ohio","Brown County",5,41,491,225,266
050,39,015,"Ohio","Brown County",5,42,534,237,297
050,39,015,"Ohio","Brown County",5,43,567,298,269
050,39,015,"Ohio","Brown County",5,44,569,281,288
050,39,015,"Ohio","Brown County",5,45,505,263,242
050,39,015,"Ohio","Brown County",5,46,535,263,272
050,39,015,"Ohio","Brown County",5,47,507,265,242
050,39,015,"Ohio","Brown County",5,48,530,269,261
050,39,015,"Ohio","Brown County",5,49,517,274,243
050,39,015,"Ohio","Brown County",5,50,559,285,274
050,39,015,"Ohio","Brown County",5,51,641,330,311
050,39,015,"Ohio","Brown County",5,52,645,326,319
050,39,015,"Ohio","Brown County",5,53,584,279,305
050,39,015,"Ohio","Brown County",5,54,532,250,282
050,39,015,"Ohio","Brown County",5,55,539,257,282
050,39,015,"Ohio","Brown County",5,56,553,282,271
050,39,015,"Ohio","Brown County",5,57,599,312,287
050,39,015,"Ohio","Brown County",5,58,637,340,297
050,39,015,"Ohio","Brown County",5,59,682,350,332
050,39,015,"Ohio","Brown County",5,60,676,344,332
050,39,015,"Ohio","Brown County",5,61,663,341,322
050,39,015,"Ohio","Brown County",5,62,647,314,333
050,39,015,"Ohio","Brown County",5,63,630,306,324
050,39,015,"Ohio","Brown County",5,64,648,316,332
050,39,015,"Ohio","Brown County",5,65,629,316,313
050,39,015,"Ohio","Brown County",5,66,641,320,321
050,39,015,"Ohio","Brown County",5,67,600,294,306
050,39,015,"Ohio","Brown County",5,68,578,274,304
050,39,015,"Ohio","Brown County",5,69,517,234,283
050,39,015,"Ohio","Brown County",5,70,479,237,242
050,39,015,"Ohio","Brown County",5,71,472,239,233
050,39,015,"Ohio","Brown County",5,72,438,216,222
050,39,015,"Ohio","Brown County",5,73,431,199,232
050,39,015,"Ohio","Brown County",5,74,400,190,210
050,39,015,"Ohio","Brown County",5,75,380,181,199
050,39,015,"Ohio","Brown County",5,76,432,225,207
050,39,015,"Ohio","Brown County",5,77,280,143,137
050,39,015,"Ohio","Brown County",5,78,271,125,146
050,39,015,"Ohio","Brown County",5,79,255,109,146
050,39,015,"Ohio","Brown County",5,80,251,109,142
050,39,015,"Ohio","Brown County",5,81,206,88,118
050,39,015,"Ohio","Brown County",5,82,201,94,107
050,39,015,"Ohio","Brown County",5,83,190,91,99
050,39,015,"Ohio","Brown County",5,84,166,75,91
050,39,015,"Ohio","Brown County",5,85,815,310,505
050,39,017,"Ohio","Butler County",1,0,4475,2288,2187
050,39,017,"Ohio","Butler County",1,1,4597,2326,2271
050,39,017,"Ohio","Butler County",1,2,4657,2324,2333
050,39,017,"Ohio","Butler County",1,3,4681,2377,2304
050,39,017,"Ohio","Butler County",1,4,4951,2512,2439
050,39,017,"Ohio","Butler County",1,5,5052,2561,2491
050,39,017,"Ohio","Butler County",1,6,5028,2530,2498
050,39,017,"Ohio","Butler County",1,7,5261,2679,2582
050,39,017,"Ohio","Butler County",1,8,5105,2645,2460
050,39,017,"Ohio","Butler County",1,9,5072,2607,2465
050,39,017,"Ohio","Butler County",1,10,5273,2673,2600
050,39,017,"Ohio","Butler County",1,11,5543,2825,2718
050,39,017,"Ohio","Butler County",1,12,5515,2810,2705
050,39,017,"Ohio","Butler County",1,13,5644,2936,2708
050,39,017,"Ohio","Butler County",1,14,5520,2838,2682
050,39,017,"Ohio","Butler County",1,15,5490,2831,2659
050,39,017,"Ohio","Butler County",1,16,5422,2742,2680
050,39,017,"Ohio","Butler County",1,17,5383,2750,2633
050,39,017,"Ohio","Butler County",1,18,6112,3033,3079
050,39,017,"Ohio","Butler County",1,19,8041,3860,4181
050,39,017,"Ohio","Butler County",1,20,8271,4199,4072
050,39,017,"Ohio","Butler County",1,21,7607,3873,3734
050,39,017,"Ohio","Butler County",1,22,6667,3257,3410
050,39,017,"Ohio","Butler County",1,23,5654,2845,2809
050,39,017,"Ohio","Butler County",1,24,5060,2591,2469
050,39,017,"Ohio","Butler County",1,25,4661,2344,2317
050,39,017,"Ohio","Butler County",1,26,4550,2283,2267
050,39,017,"Ohio","Butler County",1,27,4591,2262,2329
050,39,017,"Ohio","Butler County",1,28,4668,2300,2368
050,39,017,"Ohio","Butler County",1,29,4443,2193,2250
050,39,017,"Ohio","Butler County",1,30,4576,2249,2327
050,39,017,"Ohio","Butler County",1,31,4571,2265,2306
050,39,017,"Ohio","Butler County",1,32,4553,2301,2252
050,39,017,"Ohio","Butler County",1,33,4510,2310,2200
050,39,017,"Ohio","Butler County",1,34,4729,2334,2395
050,39,017,"Ohio","Butler County",1,35,4767,2351,2416
050,39,017,"Ohio","Butler County",1,36,4738,2348,2390
050,39,017,"Ohio","Butler County",1,37,4934,2468,2466
050,39,017,"Ohio","Butler County",1,38,5085,2567,2518
050,39,017,"Ohio","Butler County",1,39,5138,2619,2519
050,39,017,"Ohio","Butler County",1,40,4985,2511,2474
050,39,017,"Ohio","Butler County",1,41,4752,2335,2417
050,39,017,"Ohio","Butler County",1,42,4572,2245,2327
050,39,017,"Ohio","Butler County",1,43,4532,2273,2259
050,39,017,"Ohio","Butler County",1,44,4416,2232,2184
050,39,017,"Ohio","Butler County",1,45,4481,2223,2258
050,39,017,"Ohio","Butler County",1,46,4325,2147,2178
050,39,017,"Ohio","Butler County",1,47,4521,2243,2278
050,39,017,"Ohio","Butler County",1,48,4817,2444,2373
050,39,017,"Ohio","Butler County",1,49,5229,2634,2595
050,39,017,"Ohio","Butler County",1,50,5038,2503,2535
050,39,017,"Ohio","Butler County",1,51,4795,2359,2436
050,39,017,"Ohio","Butler County",1,52,4671,2338,2333
050,39,017,"Ohio","Butler County",1,53,4847,2447,2400
050,39,017,"Ohio","Butler County",1,54,4874,2451,2423
050,39,017,"Ohio","Butler County",1,55,5108,2546,2562
050,39,017,"Ohio","Butler County",1,56,5248,2614,2634
050,39,017,"Ohio","Butler County",1,57,5191,2577,2614
050,39,017,"Ohio","Butler County",1,58,5215,2575,2640
050,39,017,"Ohio","Butler County",1,59,5182,2580,2602
050,39,017,"Ohio","Butler County",1,60,5060,2467,2593
050,39,017,"Ohio","Butler County",1,61,5070,2520,2550
050,39,017,"Ohio","Butler County",1,62,5096,2453,2643
050,39,017,"Ohio","Butler County",1,63,4814,2336,2478
050,39,017,"Ohio","Butler County",1,64,4499,2212,2287
050,39,017,"Ohio","Butler County",1,65,4413,2172,2241
050,39,017,"Ohio","Butler County",1,66,4118,1994,2124
050,39,017,"Ohio","Butler County",1,67,3891,1886,2005
050,39,017,"Ohio","Butler County",1,68,3814,1799,2015
050,39,017,"Ohio","Butler County",1,69,3670,1718,1952
050,39,017,"Ohio","Butler County",1,70,3545,1666,1879
050,39,017,"Ohio","Butler County",1,71,3406,1557,1849
050,39,017,"Ohio","Butler County",1,72,3369,1585,1784
050,39,017,"Ohio","Butler County",1,73,3286,1593,1693
050,39,017,"Ohio","Butler County",1,74,2241,1052,1189
050,39,017,"Ohio","Butler County",1,75,2133,995,1138
050,39,017,"Ohio","Butler County",1,76,2100,950,1150
050,39,017,"Ohio","Butler County",1,77,2126,965,1161
050,39,017,"Ohio","Butler County",1,78,1821,802,1019
050,39,017,"Ohio","Butler County",1,79,1627,705,922
050,39,017,"Ohio","Butler County",1,80,1506,631,875
050,39,017,"Ohio","Butler County",1,81,1418,609,809
050,39,017,"Ohio","Butler County",1,82,1331,545,786
050,39,017,"Ohio","Butler County",1,83,1168,462,706
050,39,017,"Ohio","Butler County",1,84,1122,436,686
050,39,017,"Ohio","Butler County",1,85,6314,2226,4088
050,39,017,"Ohio","Butler County",2,0,4535,2326,2209
050,39,017,"Ohio","Butler County",2,1,4574,2319,2255
050,39,017,"Ohio","Butler County",2,2,4662,2334,2328
050,39,017,"Ohio","Butler County",2,3,4692,2374,2318
050,39,017,"Ohio","Butler County",2,4,4930,2505,2425
050,39,017,"Ohio","Butler County",2,5,5052,2564,2488
050,39,017,"Ohio","Butler County",2,6,5055,2545,2510
050,39,017,"Ohio","Butler County",2,7,5211,2641,2570
050,39,017,"Ohio","Butler County",2,8,5142,2651,2491
050,39,017,"Ohio","Butler County",2,9,5078,2619,2459
050,39,017,"Ohio","Butler County",2,10,5229,2660,2569
050,39,017,"Ohio","Butler County",2,11,5462,2779,2683
050,39,017,"Ohio","Butler County",2,12,5559,2831,2728
050,39,017,"Ohio","Butler County",2,13,5618,2911,2707
050,39,017,"Ohio","Butler County",2,14,5552,2866,2686
050,39,017,"Ohio","Butler County",2,15,5504,2836,2668
050,39,017,"Ohio","Butler County",2,16,5446,2769,2677
050,39,017,"Ohio","Butler County",2,17,5406,2758,2648
050,39,017,"Ohio","Butler County",2,18,6065,3001,3064
050,39,017,"Ohio","Butler County",2,19,8065,3878,4187
050,39,017,"Ohio","Butler County",2,20,8359,4229,4130
050,39,017,"Ohio","Butler County",2,21,7583,3861,3722
050,39,017,"Ohio","Butler County",2,22,6652,3270,3382
050,39,017,"Ohio","Butler County",2,23,5682,2857,2825
050,39,017,"Ohio","Butler County",2,24,5052,2572,2480
050,39,017,"Ohio","Butler County",2,25,4676,2361,2315
050,39,017,"Ohio","Butler County",2,26,4551,2286,2265
050,39,017,"Ohio","Butler County",2,27,4567,2253,2314
050,39,017,"Ohio","Butler County",2,28,4655,2296,2359
050,39,017,"Ohio","Butler County",2,29,4514,2227,2287
050,39,017,"Ohio","Butler County",2,30,4596,2265,2331
050,39,017,"Ohio","Butler County",2,31,4584,2268,2316
050,39,017,"Ohio","Butler County",2,32,4564,2291,2273
050,39,017,"Ohio","Butler County",2,33,4537,2314,2223
050,39,017,"Ohio","Butler County",2,34,4688,2337,2351
050,39,017,"Ohio","Butler County",2,35,4799,2373,2426
050,39,017,"Ohio","Butler County",2,36,4723,2344,2379
050,39,017,"Ohio","Butler County",2,37,4912,2454,2458
050,39,017,"Ohio","Butler County",2,38,5073,2547,2526
050,39,017,"Ohio","Butler County",2,39,5113,2598,2515
050,39,017,"Ohio","Butler County",2,40,5049,2552,2497
050,39,017,"Ohio","Butler County",2,41,4804,2371,2433
050,39,017,"Ohio","Butler County",2,42,4591,2259,2332
050,39,017,"Ohio","Butler County",2,43,4569,2283,2286
050,39,017,"Ohio","Butler County",2,44,4405,2220,2185
050,39,017,"Ohio","Butler County",2,45,4486,2234,2252
050,39,017,"Ohio","Butler County",2,46,4356,2160,2196
050,39,017,"Ohio","Butler County",2,47,4462,2210,2252
050,39,017,"Ohio","Butler County",2,48,4751,2398,2353
050,39,017,"Ohio","Butler County",2,49,5152,2601,2551
050,39,017,"Ohio","Butler County",2,50,5091,2539,2552
050,39,017,"Ohio","Butler County",2,51,4838,2384,2454
050,39,017,"Ohio","Butler County",2,52,4675,2332,2343
050,39,017,"Ohio","Butler County",2,53,4786,2406,2380
050,39,017,"Ohio","Butler County",2,54,4853,2440,2413
050,39,017,"Ohio","Butler County",2,55,5039,2512,2527
050,39,017,"Ohio","Butler County",2,56,5221,2603,2618
050,39,017,"Ohio","Butler County",2,57,5196,2580,2616
050,39,017,"Ohio","Butler County",2,58,5197,2571,2626
050,39,017,"Ohio","Butler County",2,59,5195,2581,2614
050,39,017,"Ohio","Butler County",2,60,5067,2481,2586
050,39,017,"Ohio","Butler County",2,61,5030,2485,2545
050,39,017,"Ohio","Butler County",2,62,5067,2458,2609
050,39,017,"Ohio","Butler County",2,63,4901,2372,2529
050,39,017,"Ohio","Butler County",2,64,4536,2224,2312
050,39,017,"Ohio","Butler County",2,65,4408,2164,2244
050,39,017,"Ohio","Butler County",2,66,4182,2029,2153
050,39,017,"Ohio","Butler County",2,67,3916,1897,2019
050,39,017,"Ohio","Butler County",2,68,3790,1800,1990
050,39,017,"Ohio","Butler County",2,69,3710,1737,1973
050,39,017,"Ohio","Butler County",2,70,3541,1668,1873
050,39,017,"Ohio","Butler County",2,71,3428,1574,1854
050,39,017,"Ohio","Butler County",2,72,3306,1543,1763
050,39,017,"Ohio","Butler County",2,73,3447,1652,1795
050,39,017,"Ohio","Butler County",2,74,2331,1099,1232
050,39,017,"Ohio","Butler County",2,75,2147,1001,1146
050,39,017,"Ohio","Butler County",2,76,2078,952,1126
050,39,017,"Ohio","Butler County",2,77,2148,968,1180
050,39,017,"Ohio","Butler County",2,78,1851,819,1032
050,39,017,"Ohio","Butler County",2,79,1661,723,938
050,39,017,"Ohio","Butler County",2,80,1519,635,884
050,39,017,"Ohio","Butler County",2,81,1412,604,808
050,39,017,"Ohio","Butler County",2,82,1340,551,789
050,39,017,"Ohio","Butler County",2,83,1184,471,713
050,39,017,"Ohio","Butler County",2,84,1110,436,674
050,39,017,"Ohio","Butler County",2,85,6335,2217,4118
050,39,017,"Ohio","Butler County",3,0,4178,2116,2062
050,39,017,"Ohio","Butler County",3,1,4551,2334,2217
050,39,017,"Ohio","Butler County",3,2,4644,2384,2260
050,39,017,"Ohio","Butler County",3,3,4675,2331,2344
050,39,017,"Ohio","Butler County",3,4,4788,2431,2357
050,39,017,"Ohio","Butler County",3,5,4957,2531,2426
050,39,017,"Ohio","Butler County",3,6,5074,2600,2474
050,39,017,"Ohio","Butler County",3,7,5079,2581,2498
050,39,017,"Ohio","Butler County",3,8,5236,2683,2553
050,39,017,"Ohio","Butler County",3,9,5159,2680,2479
050,39,017,"Ohio","Butler County",3,10,5093,2625,2468
050,39,017,"Ohio","Butler County",3,11,5237,2659,2578
050,39,017,"Ohio","Butler County",3,12,5505,2794,2711
050,39,017,"Ohio","Butler County",3,13,5612,2865,2747
050,39,017,"Ohio","Butler County",3,14,5657,2946,2711
050,39,017,"Ohio","Butler County",3,15,5560,2886,2674
050,39,017,"Ohio","Butler County",3,16,5503,2801,2702
050,39,017,"Ohio","Butler County",3,17,5501,2809,2692
050,39,017,"Ohio","Butler County",3,18,5584,2794,2790
050,39,017,"Ohio","Butler County",3,19,6626,3233,3393
050,39,017,"Ohio","Butler County",3,20,7412,3700,3712
050,39,017,"Ohio","Butler County",3,21,7427,3717,3710
050,39,017,"Ohio","Butler County",3,22,6561,3271,3290
050,39,017,"Ohio","Butler County",3,23,5721,2916,2805
050,39,017,"Ohio","Butler County",3,24,5148,2595,2553
050,39,017,"Ohio","Butler County",3,25,4730,2416,2314
050,39,017,"Ohio","Butler County",3,26,4541,2310,2231
050,39,017,"Ohio","Butler County",3,27,4405,2207,2198
050,39,017,"Ohio","Butler County",3,28,4495,2229,2266
050,39,017,"Ohio","Butler County",3,29,4630,2259,2371
050,39,017,"Ohio","Butler County",3,30,4511,2249,2262
050,39,017,"Ohio","Butler County",3,31,4683,2329,2354
050,39,017,"Ohio","Butler County",3,32,4672,2276,2396
050,39,017,"Ohio","Butler County",3,33,4636,2328,2308
050,39,017,"Ohio","Butler County",3,34,4581,2345,2236
050,39,017,"Ohio","Butler County",3,35,4754,2371,2383
050,39,017,"Ohio","Butler County",3,36,4803,2373,2430
050,39,017,"Ohio","Butler County",3,37,4699,2329,2370
050,39,017,"Ohio","Butler County",3,38,4879,2405,2474
050,39,017,"Ohio","Butler County",3,39,5150,2601,2549
050,39,017,"Ohio","Butler County",3,40,5126,2592,2534
050,39,017,"Ohio","Butler County",3,41,5040,2542,2498
050,39,017,"Ohio","Butler County",3,42,4783,2369,2414
050,39,017,"Ohio","Butler County",3,43,4624,2291,2333
050,39,017,"Ohio","Butler County",3,44,4545,2291,2254
050,39,017,"Ohio","Butler County",3,45,4392,2198,2194
050,39,017,"Ohio","Butler County",3,46,4468,2235,2233
050,39,017,"Ohio","Butler County",3,47,4308,2128,2180
050,39,017,"Ohio","Butler County",3,48,4458,2222,2236
050,39,017,"Ohio","Butler County",3,49,4714,2391,2323
050,39,017,"Ohio","Butler County",3,50,5088,2564,2524
050,39,017,"Ohio","Butler County",3,51,5067,2530,2537
050,39,017,"Ohio","Butler County",3,52,4782,2335,2447
050,39,017,"Ohio","Butler County",3,53,4630,2300,2330
050,39,017,"Ohio","Butler County",3,54,4726,2364,2362
050,39,017,"Ohio","Butler County",3,55,4777,2398,2379
050,39,017,"Ohio","Butler County",3,56,4959,2450,2509
050,39,017,"Ohio","Butler County",3,57,5139,2562,2577
050,39,017,"Ohio","Butler County",3,58,5162,2568,2594
050,39,017,"Ohio","Butler County",3,59,5097,2530,2567
050,39,017,"Ohio","Butler County",3,60,5143,2521,2622
050,39,017,"Ohio","Butler County",3,61,4964,2409,2555
050,39,017,"Ohio","Butler County",3,62,4914,2424,2490
050,39,017,"Ohio","Butler County",3,63,4987,2414,2573
050,39,017,"Ohio","Butler County",3,64,4793,2311,2482
050,39,017,"Ohio","Butler County",3,65,4403,2155,2248
050,39,017,"Ohio","Butler County",3,66,4315,2109,2206
050,39,017,"Ohio","Butler County",3,67,4090,1976,2114
050,39,017,"Ohio","Butler County",3,68,3839,1846,1993
050,39,017,"Ohio","Butler County",3,69,3700,1753,1947
050,39,017,"Ohio","Butler County",3,70,3591,1669,1922
050,39,017,"Ohio","Butler County",3,71,3456,1611,1845
050,39,017,"Ohio","Butler County",3,72,3355,1532,1823
050,39,017,"Ohio","Butler County",3,73,3198,1471,1727
050,39,017,"Ohio","Butler County",3,74,3344,1587,1757
050,39,017,"Ohio","Butler County",3,75,2256,1052,1204
050,39,017,"Ohio","Butler County",3,76,2065,955,1110
050,39,017,"Ohio","Butler County",3,77,1991,922,1069
050,39,017,"Ohio","Butler County",3,78,2062,919,1143
050,39,017,"Ohio","Butler County",3,79,1754,774,980
050,39,017,"Ohio","Butler County",3,80,1572,670,902
050,39,017,"Ohio","Butler County",3,81,1415,591,824
050,39,017,"Ohio","Butler County",3,82,1316,541,775
050,39,017,"Ohio","Butler County",3,83,1217,486,731
050,39,017,"Ohio","Butler County",3,84,1093,437,656
050,39,017,"Ohio","Butler County",3,85,6244,2173,4071
050,39,017,"Ohio","Butler County",4,0,4250,2149,2101
050,39,017,"Ohio","Butler County",4,1,4247,2155,2092
050,39,017,"Ohio","Butler County",4,2,4616,2395,2221
050,39,017,"Ohio","Butler County",4,3,4689,2391,2298
050,39,017,"Ohio","Butler County",4,4,4746,2367,2379
050,39,017,"Ohio","Butler County",4,5,4897,2499,2398
050,39,017,"Ohio","Butler County",4,6,4983,2548,2435
050,39,017,"Ohio","Butler County",4,7,5147,2663,2484
050,39,017,"Ohio","Butler County",4,8,5105,2584,2521
050,39,017,"Ohio","Butler County",4,9,5285,2696,2589
050,39,017,"Ohio","Butler County",4,10,5168,2689,2479
050,39,017,"Ohio","Butler County",4,11,5105,2641,2464
050,39,017,"Ohio","Butler County",4,12,5224,2670,2554
050,39,017,"Ohio","Butler County",4,13,5556,2844,2712
050,39,017,"Ohio","Butler County",4,14,5645,2881,2764
050,39,017,"Ohio","Butler County",4,15,5712,2991,2721
050,39,017,"Ohio","Butler County",4,16,5522,2853,2669
050,39,017,"Ohio","Butler County",4,17,5546,2844,2702
050,39,017,"Ohio","Butler County",4,18,5879,2932,2947
050,39,017,"Ohio","Butler County",4,19,7181,3507,3674
050,39,017,"Ohio","Butler County",4,20,7701,3856,3845
050,39,017,"Ohio","Butler County",4,21,7596,3814,3782
050,39,017,"Ohio","Butler County",4,22,6682,3309,3373
050,39,017,"Ohio","Butler County",4,23,5698,2940,2758
050,39,017,"Ohio","Butler County",4,24,5178,2611,2567
050,39,017,"Ohio","Butler County",4,25,4814,2406,2408
050,39,017,"Ohio","Butler County",4,26,4585,2335,2250
050,39,017,"Ohio","Butler County",4,27,4443,2285,2158
050,39,017,"Ohio","Butler County",4,28,4424,2210,2214
050,39,017,"Ohio","Butler County",4,29,4583,2250,2333
050,39,017,"Ohio","Butler County",4,30,4641,2291,2350
050,39,017,"Ohio","Butler County",4,31,4625,2315,2310
050,39,017,"Ohio","Butler County",4,32,4690,2310,2380
050,39,017,"Ohio","Butler County",4,33,4740,2297,2443
050,39,017,"Ohio","Butler County",4,34,4646,2329,2317
050,39,017,"Ohio","Butler County",4,35,4689,2388,2301
050,39,017,"Ohio","Butler County",4,36,4776,2388,2388
050,39,017,"Ohio","Butler County",4,37,4838,2388,2450
050,39,017,"Ohio","Butler County",4,38,4709,2317,2392
050,39,017,"Ohio","Butler County",4,39,4955,2419,2536
050,39,017,"Ohio","Butler County",4,40,5162,2608,2554
050,39,017,"Ohio","Butler County",4,41,5087,2574,2513
050,39,017,"Ohio","Butler County",4,42,5026,2554,2472
050,39,017,"Ohio","Butler County",4,43,4803,2386,2417
050,39,017,"Ohio","Butler County",4,44,4635,2310,2325
050,39,017,"Ohio","Butler County",4,45,4520,2270,2250
050,39,017,"Ohio","Butler County",4,46,4394,2190,2204
050,39,017,"Ohio","Butler County",4,47,4466,2216,2250
050,39,017,"Ohio","Butler County",4,48,4316,2137,2179
050,39,017,"Ohio","Butler County",4,49,4424,2194,2230
050,39,017,"Ohio","Butler County",4,50,4702,2376,2326
050,39,017,"Ohio","Butler County",4,51,5086,2562,2524
050,39,017,"Ohio","Butler County",4,52,5030,2520,2510
050,39,017,"Ohio","Butler County",4,53,4725,2288,2437
050,39,017,"Ohio","Butler County",4,54,4611,2314,2297
050,39,017,"Ohio","Butler County",4,55,4668,2335,2333
050,39,017,"Ohio","Butler County",4,56,4758,2381,2377
050,39,017,"Ohio","Butler County",4,57,4879,2414,2465
050,39,017,"Ohio","Butler County",4,58,5075,2518,2557
050,39,017,"Ohio","Butler County",4,59,5080,2520,2560
050,39,017,"Ohio","Butler County",4,60,5039,2499,2540
050,39,017,"Ohio","Butler County",4,61,5054,2480,2574
050,39,017,"Ohio","Butler County",4,62,4905,2373,2532
050,39,017,"Ohio","Butler County",4,63,4801,2367,2434
050,39,017,"Ohio","Butler County",4,64,4846,2320,2526
050,39,017,"Ohio","Butler County",4,65,4674,2230,2444
050,39,017,"Ohio","Butler County",4,66,4286,2091,2195
050,39,017,"Ohio","Butler County",4,67,4241,2074,2167
050,39,017,"Ohio","Butler County",4,68,4005,1929,2076
050,39,017,"Ohio","Butler County",4,69,3764,1803,1961
050,39,017,"Ohio","Butler County",4,70,3602,1700,1902
050,39,017,"Ohio","Butler County",4,71,3496,1624,1872
050,39,017,"Ohio","Butler County",4,72,3379,1554,1825
050,39,017,"Ohio","Butler County",4,73,3246,1473,1773
050,39,017,"Ohio","Butler County",4,74,3080,1412,1668
050,39,017,"Ohio","Butler County",4,75,3234,1538,1696
050,39,017,"Ohio","Butler County",4,76,2180,1012,1168
050,39,017,"Ohio","Butler County",4,77,2001,927,1074
050,39,017,"Ohio","Butler County",4,78,1922,888,1034
050,39,017,"Ohio","Butler County",4,79,1959,871,1088
050,39,017,"Ohio","Butler County",4,80,1654,720,934
050,39,017,"Ohio","Butler County",4,81,1475,631,844
050,39,017,"Ohio","Butler County",4,82,1332,548,784
050,39,017,"Ohio","Butler County",4,83,1201,483,718
050,39,017,"Ohio","Butler County",4,84,1141,459,682
050,39,017,"Ohio","Butler County",4,85,6248,2162,4086
050,39,017,"Ohio","Butler County",5,0,4278,2162,2116
050,39,017,"Ohio","Butler County",5,1,4290,2158,2132
050,39,017,"Ohio","Butler County",5,2,4303,2184,2119
050,39,017,"Ohio","Butler County",5,3,4651,2406,2245
050,39,017,"Ohio","Butler County",5,4,4685,2385,2300
050,39,017,"Ohio","Butler County",5,5,4832,2412,2420
050,39,017,"Ohio","Butler County",5,6,4907,2534,2373
050,39,017,"Ohio","Butler County",5,7,5039,2561,2478
050,39,017,"Ohio","Butler County",5,8,5169,2648,2521
050,39,017,"Ohio","Butler County",5,9,5120,2590,2530
050,39,017,"Ohio","Butler County",5,10,5265,2682,2583
050,39,017,"Ohio","Butler County",5,11,5211,2725,2486
050,39,017,"Ohio","Butler County",5,12,5180,2691,2489
050,39,017,"Ohio","Butler County",5,13,5281,2696,2585
050,39,017,"Ohio","Butler County",5,14,5536,2831,2705
050,39,017,"Ohio","Butler County",5,15,5689,2921,2768
050,39,017,"Ohio","Butler County",5,16,5735,3000,2735
050,39,017,"Ohio","Butler County",5,17,5584,2890,2694
050,39,017,"Ohio","Butler County",5,18,6152,3073,3079
050,39,017,"Ohio","Butler County",5,19,7836,3819,4017
050,39,017,"Ohio","Butler County",5,20,8186,4125,4061
050,39,017,"Ohio","Butler County",5,21,7608,3828,3780
050,39,017,"Ohio","Butler County",5,22,6832,3366,3466
050,39,017,"Ohio","Butler County",5,23,5859,3032,2827
050,39,017,"Ohio","Butler County",5,24,5189,2669,2520
050,39,017,"Ohio","Butler County",5,25,4838,2441,2397
050,39,017,"Ohio","Butler County",5,26,4752,2426,2326
050,39,017,"Ohio","Butler County",5,27,4507,2294,2213
050,39,017,"Ohio","Butler County",5,28,4482,2297,2185
050,39,017,"Ohio","Butler County",5,29,4541,2254,2287
050,39,017,"Ohio","Butler County",5,30,4638,2288,2350
050,39,017,"Ohio","Butler County",5,31,4760,2375,2385
050,39,017,"Ohio","Butler County",5,32,4666,2300,2366
050,39,017,"Ohio","Butler County",5,33,4769,2350,2419
050,39,017,"Ohio","Butler County",5,34,4804,2348,2456
050,39,017,"Ohio","Butler County",5,35,4779,2424,2355
050,39,017,"Ohio","Butler County",5,36,4738,2419,2319
050,39,017,"Ohio","Butler County",5,37,4835,2412,2423
050,39,017,"Ohio","Butler County",5,38,4888,2391,2497
050,39,017,"Ohio","Butler County",5,39,4790,2353,2437
050,39,017,"Ohio","Butler County",5,40,5001,2436,2565
050,39,017,"Ohio","Butler County",5,41,5178,2625,2553
050,39,017,"Ohio","Butler County",5,42,5044,2553,2491
050,39,017,"Ohio","Butler County",5,43,5014,2549,2465
050,39,017,"Ohio","Butler County",5,44,4828,2405,2423
050,39,017,"Ohio","Butler County",5,45,4626,2317,2309
050,39,017,"Ohio","Butler County",5,46,4499,2227,2272
050,39,017,"Ohio","Butler County",5,47,4374,2177,2197
050,39,017,"Ohio","Butler County",5,48,4482,2216,2266
050,39,017,"Ohio","Butler County",5,49,4327,2123,2204
050,39,017,"Ohio","Butler County",5,50,4389,2172,2217
050,39,017,"Ohio","Butler County",5,51,4663,2365,2298
050,39,017,"Ohio","Butler County",5,52,5073,2578,2495
050,39,017,"Ohio","Butler County",5,53,5005,2484,2521
050,39,017,"Ohio","Butler County",5,54,4715,2291,2424
050,39,017,"Ohio","Butler County",5,55,4545,2272,2273
050,39,017,"Ohio","Butler County",5,56,4634,2307,2327
050,39,017,"Ohio","Butler County",5,57,4725,2373,2352
050,39,017,"Ohio","Butler County",5,58,4849,2391,2458
050,39,017,"Ohio","Butler County",5,59,5034,2507,2527
050,39,017,"Ohio","Butler County",5,60,5028,2482,2546
050,39,017,"Ohio","Butler County",5,61,4945,2452,2493
050,39,017,"Ohio","Butler County",5,62,5008,2455,2553
050,39,017,"Ohio","Butler County",5,63,4814,2328,2486
050,39,017,"Ohio","Butler County",5,64,4704,2302,2402
050,39,017,"Ohio","Butler County",5,65,4759,2260,2499
050,39,017,"Ohio","Butler County",5,66,4581,2169,2412
050,39,017,"Ohio","Butler County",5,67,4219,2061,2158
050,39,017,"Ohio","Butler County",5,68,4181,2036,2145
050,39,017,"Ohio","Butler County",5,69,3946,1885,2061
050,39,017,"Ohio","Butler County",5,70,3661,1757,1904
050,39,017,"Ohio","Butler County",5,71,3519,1647,1872
050,39,017,"Ohio","Butler County",5,72,3421,1569,1852
050,39,017,"Ohio","Butler County",5,73,3259,1491,1768
050,39,017,"Ohio","Butler County",5,74,3161,1436,1725
050,39,017,"Ohio","Butler County",5,75,2993,1373,1620
050,39,017,"Ohio","Butler County",5,76,3137,1482,1655
050,39,017,"Ohio","Butler County",5,77,2114,989,1125
050,39,017,"Ohio","Butler County",5,78,1925,888,1037
050,39,017,"Ohio","Butler County",5,79,1840,854,986
050,39,017,"Ohio","Butler County",5,80,1868,813,1055
050,39,017,"Ohio","Butler County",5,81,1578,685,893
050,39,017,"Ohio","Butler County",5,82,1399,588,811
050,39,017,"Ohio","Butler County",5,83,1223,490,733
050,39,017,"Ohio","Butler County",5,84,1140,466,674
050,39,017,"Ohio","Butler County",5,85,6411,2234,4177
050,39,019,"Ohio","Carroll County",1,0,264,136,128
050,39,019,"Ohio","Carroll County",1,1,269,145,124
050,39,019,"Ohio","Carroll County",1,2,303,161,142
050,39,019,"Ohio","Carroll County",1,3,288,154,134
050,39,019,"Ohio","Carroll County",1,4,278,145,133
050,39,019,"Ohio","Carroll County",1,5,290,154,136
050,39,019,"Ohio","Carroll County",1,6,285,135,150
050,39,019,"Ohio","Carroll County",1,7,287,143,144
050,39,019,"Ohio","Carroll County",1,8,268,143,125
050,39,019,"Ohio","Carroll County",1,9,314,152,162
050,39,019,"Ohio","Carroll County",1,10,306,151,155
050,39,019,"Ohio","Carroll County",1,11,348,187,161
050,39,019,"Ohio","Carroll County",1,12,364,196,168
050,39,019,"Ohio","Carroll County",1,13,359,199,160
050,39,019,"Ohio","Carroll County",1,14,339,185,154
050,39,019,"Ohio","Carroll County",1,15,333,178,155
050,39,019,"Ohio","Carroll County",1,16,344,180,164
050,39,019,"Ohio","Carroll County",1,17,358,176,182
050,39,019,"Ohio","Carroll County",1,18,325,166,159
050,39,019,"Ohio","Carroll County",1,19,257,130,127
050,39,019,"Ohio","Carroll County",1,20,249,132,117
050,39,019,"Ohio","Carroll County",1,21,261,139,122
050,39,019,"Ohio","Carroll County",1,22,257,128,129
050,39,019,"Ohio","Carroll County",1,23,295,153,142
050,39,019,"Ohio","Carroll County",1,24,298,154,144
050,39,019,"Ohio","Carroll County",1,25,267,133,134
050,39,019,"Ohio","Carroll County",1,26,279,153,126
050,39,019,"Ohio","Carroll County",1,27,295,161,134
050,39,019,"Ohio","Carroll County",1,28,289,149,140
050,39,019,"Ohio","Carroll County",1,29,268,134,134
050,39,019,"Ohio","Carroll County",1,30,251,125,126
050,39,019,"Ohio","Carroll County",1,31,250,121,129
050,39,019,"Ohio","Carroll County",1,32,271,131,140
050,39,019,"Ohio","Carroll County",1,33,286,146,140
050,39,019,"Ohio","Carroll County",1,34,284,140,144
050,39,019,"Ohio","Carroll County",1,35,281,149,132
050,39,019,"Ohio","Carroll County",1,36,261,134,127
050,39,019,"Ohio","Carroll County",1,37,280,141,139
050,39,019,"Ohio","Carroll County",1,38,277,145,132
050,39,019,"Ohio","Carroll County",1,39,275,140,135
050,39,019,"Ohio","Carroll County",1,40,300,160,140
050,39,019,"Ohio","Carroll County",1,41,307,161,146
050,39,019,"Ohio","Carroll County",1,42,308,159,149
050,39,019,"Ohio","Carroll County",1,43,316,165,151
050,39,019,"Ohio","Carroll County",1,44,286,141,145
050,39,019,"Ohio","Carroll County",1,45,302,156,146
050,39,019,"Ohio","Carroll County",1,46,325,152,173
050,39,019,"Ohio","Carroll County",1,47,330,186,144
050,39,019,"Ohio","Carroll County",1,48,371,197,174
050,39,019,"Ohio","Carroll County",1,49,366,181,185
050,39,019,"Ohio","Carroll County",1,50,360,188,172
050,39,019,"Ohio","Carroll County",1,51,316,160,156
050,39,019,"Ohio","Carroll County",1,52,319,166,153
050,39,019,"Ohio","Carroll County",1,53,347,188,159
050,39,019,"Ohio","Carroll County",1,54,369,194,175
050,39,019,"Ohio","Carroll County",1,55,400,201,199
050,39,019,"Ohio","Carroll County",1,56,424,213,211
050,39,019,"Ohio","Carroll County",1,57,440,211,229
050,39,019,"Ohio","Carroll County",1,58,462,242,220
050,39,019,"Ohio","Carroll County",1,59,455,252,203
050,39,019,"Ohio","Carroll County",1,60,447,230,217
050,39,019,"Ohio","Carroll County",1,61,444,212,232
050,39,019,"Ohio","Carroll County",1,62,451,223,228
050,39,019,"Ohio","Carroll County",1,63,440,227,213
050,39,019,"Ohio","Carroll County",1,64,425,221,204
050,39,019,"Ohio","Carroll County",1,65,414,207,207
050,39,019,"Ohio","Carroll County",1,66,402,201,201
050,39,019,"Ohio","Carroll County",1,67,373,171,202
050,39,019,"Ohio","Carroll County",1,68,385,200,185
050,39,019,"Ohio","Carroll County",1,69,334,167,167
050,39,019,"Ohio","Carroll County",1,70,314,153,161
050,39,019,"Ohio","Carroll County",1,71,335,172,163
050,39,019,"Ohio","Carroll County",1,72,348,169,179
050,39,019,"Ohio","Carroll County",1,73,343,175,168
050,39,019,"Ohio","Carroll County",1,74,221,113,108
050,39,019,"Ohio","Carroll County",1,75,219,114,105
050,39,019,"Ohio","Carroll County",1,76,218,106,112
050,39,019,"Ohio","Carroll County",1,77,232,104,128
050,39,019,"Ohio","Carroll County",1,78,202,94,108
050,39,019,"Ohio","Carroll County",1,79,184,86,98
050,39,019,"Ohio","Carroll County",1,80,157,72,85
050,39,019,"Ohio","Carroll County",1,81,144,75,69
050,39,019,"Ohio","Carroll County",1,82,139,65,74
050,39,019,"Ohio","Carroll County",1,83,111,46,65
050,39,019,"Ohio","Carroll County",1,84,101,44,57
050,39,019,"Ohio","Carroll County",1,85,577,227,350
050,39,019,"Ohio","Carroll County",2,0,276,146,130
050,39,019,"Ohio","Carroll County",2,1,269,144,125
050,39,019,"Ohio","Carroll County",2,2,295,157,138
050,39,019,"Ohio","Carroll County",2,3,292,156,136
050,39,019,"Ohio","Carroll County",2,4,284,148,136
050,39,019,"Ohio","Carroll County",2,5,290,153,137
050,39,019,"Ohio","Carroll County",2,6,288,142,146
050,39,019,"Ohio","Carroll County",2,7,286,142,144
050,39,019,"Ohio","Carroll County",2,8,272,141,131
050,39,019,"Ohio","Carroll County",2,9,299,148,151
050,39,019,"Ohio","Carroll County",2,10,305,150,155
050,39,019,"Ohio","Carroll County",2,11,336,178,158
050,39,019,"Ohio","Carroll County",2,12,362,194,168
050,39,019,"Ohio","Carroll County",2,13,360,198,162
050,39,019,"Ohio","Carroll County",2,14,342,187,155
050,39,019,"Ohio","Carroll County",2,15,337,182,155
050,39,019,"Ohio","Carroll County",2,16,342,181,161
050,39,019,"Ohio","Carroll County",2,17,354,177,177
050,39,019,"Ohio","Carroll County",2,18,317,162,155
050,39,019,"Ohio","Carroll County",2,19,259,131,128
050,39,019,"Ohio","Carroll County",2,20,257,135,122
050,39,019,"Ohio","Carroll County",2,21,258,138,120
050,39,019,"Ohio","Carroll County",2,22,263,133,130
050,39,019,"Ohio","Carroll County",2,23,291,150,141
050,39,019,"Ohio","Carroll County",2,24,296,153,143
050,39,019,"Ohio","Carroll County",2,25,276,140,136
050,39,019,"Ohio","Carroll County",2,26,277,150,127
050,39,019,"Ohio","Carroll County",2,27,292,160,132
050,39,019,"Ohio","Carroll County",2,28,287,148,139
050,39,019,"Ohio","Carroll County",2,29,270,133,137
050,39,019,"Ohio","Carroll County",2,30,259,130,129
050,39,019,"Ohio","Carroll County",2,31,251,123,128
050,39,019,"Ohio","Carroll County",2,32,266,129,137
050,39,019,"Ohio","Carroll County",2,33,283,143,140
050,39,019,"Ohio","Carroll County",2,34,285,142,143
050,39,019,"Ohio","Carroll County",2,35,283,148,135
050,39,019,"Ohio","Carroll County",2,36,264,137,127
050,39,019,"Ohio","Carroll County",2,37,277,140,137
050,39,019,"Ohio","Carroll County",2,38,280,145,135
050,39,019,"Ohio","Carroll County",2,39,273,140,133
050,39,019,"Ohio","Carroll County",2,40,296,157,139
050,39,019,"Ohio","Carroll County",2,41,306,162,144
050,39,019,"Ohio","Carroll County",2,42,307,161,146
050,39,019,"Ohio","Carroll County",2,43,317,166,151
050,39,019,"Ohio","Carroll County",2,44,291,147,144
050,39,019,"Ohio","Carroll County",2,45,302,154,148
050,39,019,"Ohio","Carroll County",2,46,319,153,166
050,39,019,"Ohio","Carroll County",2,47,327,177,150
050,39,019,"Ohio","Carroll County",2,48,361,194,167
050,39,019,"Ohio","Carroll County",2,49,368,185,183
050,39,019,"Ohio","Carroll County",2,50,361,187,174
050,39,019,"Ohio","Carroll County",2,51,325,166,159
050,39,019,"Ohio","Carroll County",2,52,319,165,154
050,39,019,"Ohio","Carroll County",2,53,342,182,160
050,39,019,"Ohio","Carroll County",2,54,360,190,170
050,39,019,"Ohio","Carroll County",2,55,392,200,192
050,39,019,"Ohio","Carroll County",2,56,421,212,209
050,39,019,"Ohio","Carroll County",2,57,439,214,225
050,39,019,"Ohio","Carroll County",2,58,457,235,222
050,39,019,"Ohio","Carroll County",2,59,459,250,209
050,39,019,"Ohio","Carroll County",2,60,450,237,213
050,39,019,"Ohio","Carroll County",2,61,440,214,226
050,39,019,"Ohio","Carroll County",2,62,449,222,227
050,39,019,"Ohio","Carroll County",2,63,444,225,219
050,39,019,"Ohio","Carroll County",2,64,422,217,205
050,39,019,"Ohio","Carroll County",2,65,414,209,205
050,39,019,"Ohio","Carroll County",2,66,407,204,203
050,39,019,"Ohio","Carroll County",2,67,377,177,200
050,39,019,"Ohio","Carroll County",2,68,372,185,187
050,39,019,"Ohio","Carroll County",2,69,352,177,175
050,39,019,"Ohio","Carroll County",2,70,314,155,159
050,39,019,"Ohio","Carroll County",2,71,328,166,162
050,39,019,"Ohio","Carroll County",2,72,339,167,172
050,39,019,"Ohio","Carroll County",2,73,352,179,173
050,39,019,"Ohio","Carroll County",2,74,233,118,115
050,39,019,"Ohio","Carroll County",2,75,216,111,105
050,39,019,"Ohio","Carroll County",2,76,215,106,109
050,39,019,"Ohio","Carroll County",2,77,231,105,126
050,39,019,"Ohio","Carroll County",2,78,201,92,109
050,39,019,"Ohio","Carroll County",2,79,185,86,99
050,39,019,"Ohio","Carroll County",2,80,164,76,88
050,39,019,"Ohio","Carroll County",2,81,142,72,70
050,39,019,"Ohio","Carroll County",2,82,139,67,72
050,39,019,"Ohio","Carroll County",2,83,117,51,66
050,39,019,"Ohio","Carroll County",2,84,102,44,58
050,39,019,"Ohio","Carroll County",2,85,575,224,351
050,39,019,"Ohio","Carroll County",3,0,237,124,113
050,39,019,"Ohio","Carroll County",3,1,289,150,139
050,39,019,"Ohio","Carroll County",3,2,274,152,122
050,39,019,"Ohio","Carroll County",3,3,278,150,128
050,39,019,"Ohio","Carroll County",3,4,286,150,136
050,39,019,"Ohio","Carroll County",3,5,275,143,132
050,39,019,"Ohio","Carroll County",3,6,293,154,139
050,39,019,"Ohio","Carroll County",3,7,289,153,136
050,39,019,"Ohio","Carroll County",3,8,289,142,147
050,39,019,"Ohio","Carroll County",3,9,286,151,135
050,39,019,"Ohio","Carroll County",3,10,308,152,156
050,39,019,"Ohio","Carroll County",3,11,313,160,153
050,39,019,"Ohio","Carroll County",3,12,350,190,160
050,39,019,"Ohio","Carroll County",3,13,374,196,178
050,39,019,"Ohio","Carroll County",3,14,362,198,164
050,39,019,"Ohio","Carroll County",3,15,363,192,171
050,39,019,"Ohio","Carroll County",3,16,346,187,159
050,39,019,"Ohio","Carroll County",3,17,350,178,172
050,39,019,"Ohio","Carroll County",3,18,304,153,151
050,39,019,"Ohio","Carroll County",3,19,248,126,122
050,39,019,"Ohio","Carroll County",3,20,277,130,147
050,39,019,"Ohio","Carroll County",3,21,258,141,117
050,39,019,"Ohio","Carroll County",3,22,263,138,125
050,39,019,"Ohio","Carroll County",3,23,267,141,126
050,39,019,"Ohio","Carroll County",3,24,261,141,120
050,39,019,"Ohio","Carroll County",3,25,284,144,140
050,39,019,"Ohio","Carroll County",3,26,277,142,135
050,39,019,"Ohio","Carroll County",3,27,270,146,124
050,39,019,"Ohio","Carroll County",3,28,294,158,136
050,39,019,"Ohio","Carroll County",3,29,270,136,134
050,39,019,"Ohio","Carroll County",3,30,275,131,144
050,39,019,"Ohio","Carroll County",3,31,254,125,129
050,39,019,"Ohio","Carroll County",3,32,263,130,133
050,39,019,"Ohio","Carroll County",3,33,282,143,139
050,39,019,"Ohio","Carroll County",3,34,311,155,156
050,39,019,"Ohio","Carroll County",3,35,288,146,142
050,39,019,"Ohio","Carroll County",3,36,291,156,135
050,39,019,"Ohio","Carroll County",3,37,267,140,127
050,39,019,"Ohio","Carroll County",3,38,296,147,149
050,39,019,"Ohio","Carroll County",3,39,275,139,136
050,39,019,"Ohio","Carroll County",3,40,273,143,130
050,39,019,"Ohio","Carroll County",3,41,303,163,140
050,39,019,"Ohio","Carroll County",3,42,305,157,148
050,39,019,"Ohio","Carroll County",3,43,311,161,150
050,39,019,"Ohio","Carroll County",3,44,314,167,147
050,39,019,"Ohio","Carroll County",3,45,290,148,142
050,39,019,"Ohio","Carroll County",3,46,308,152,156
050,39,019,"Ohio","Carroll County",3,47,320,157,163
050,39,019,"Ohio","Carroll County",3,48,329,177,152
050,39,019,"Ohio","Carroll County",3,49,369,195,174
050,39,019,"Ohio","Carroll County",3,50,387,193,194
050,39,019,"Ohio","Carroll County",3,51,357,183,174
050,39,019,"Ohio","Carroll County",3,52,326,166,160
050,39,019,"Ohio","Carroll County",3,53,332,176,156
050,39,019,"Ohio","Carroll County",3,54,343,181,162
050,39,019,"Ohio","Carroll County",3,55,365,196,169
050,39,019,"Ohio","Carroll County",3,56,399,202,197
050,39,019,"Ohio","Carroll County",3,57,422,210,212
050,39,019,"Ohio","Carroll County",3,58,444,218,226
050,39,019,"Ohio","Carroll County",3,59,448,227,221
050,39,019,"Ohio","Carroll County",3,60,455,253,202
050,39,019,"Ohio","Carroll County",3,61,447,236,211
050,39,019,"Ohio","Carroll County",3,62,451,222,229
050,39,019,"Ohio","Carroll County",3,63,443,214,229
050,39,019,"Ohio","Carroll County",3,64,441,222,219
050,39,019,"Ohio","Carroll County",3,65,409,207,202
050,39,019,"Ohio","Carroll County",3,66,400,205,195
050,39,019,"Ohio","Carroll County",3,67,406,201,205
050,39,019,"Ohio","Carroll County",3,68,369,172,197
050,39,019,"Ohio","Carroll County",3,69,368,181,187
050,39,019,"Ohio","Carroll County",3,70,342,172,170
050,39,019,"Ohio","Carroll County",3,71,308,150,158
050,39,019,"Ohio","Carroll County",3,72,324,164,160
050,39,019,"Ohio","Carroll County",3,73,320,158,162
050,39,019,"Ohio","Carroll County",3,74,341,173,168
050,39,019,"Ohio","Carroll County",3,75,228,111,117
050,39,019,"Ohio","Carroll County",3,76,211,110,101
050,39,019,"Ohio","Carroll County",3,77,207,99,108
050,39,019,"Ohio","Carroll County",3,78,221,102,119
050,39,019,"Ohio","Carroll County",3,79,179,78,101
050,39,019,"Ohio","Carroll County",3,80,175,82,93
050,39,019,"Ohio","Carroll County",3,81,146,64,82
050,39,019,"Ohio","Carroll County",3,82,127,66,61
050,39,019,"Ohio","Carroll County",3,83,127,62,65
050,39,019,"Ohio","Carroll County",3,84,107,46,61
050,39,019,"Ohio","Carroll County",3,85,566,213,353
050,39,019,"Ohio","Carroll County",4,0,229,108,121
050,39,019,"Ohio","Carroll County",4,1,233,125,108
050,39,019,"Ohio","Carroll County",4,2,300,152,148
050,39,019,"Ohio","Carroll County",4,3,279,150,129
050,39,019,"Ohio","Carroll County",4,4,304,159,145
050,39,019,"Ohio","Carroll County",4,5,284,153,131
050,39,019,"Ohio","Carroll County",4,6,287,145,142
050,39,019,"Ohio","Carroll County",4,7,300,157,143
050,39,019,"Ohio","Carroll County",4,8,287,149,138
050,39,019,"Ohio","Carroll County",4,9,304,151,153
050,39,019,"Ohio","Carroll County",4,10,283,158,125
050,39,019,"Ohio","Carroll County",4,11,315,160,155
050,39,019,"Ohio","Carroll County",4,12,325,172,153
050,39,019,"Ohio","Carroll County",4,13,350,192,158
050,39,019,"Ohio","Carroll County",4,14,367,185,182
050,39,019,"Ohio","Carroll County",4,15,366,200,166
050,39,019,"Ohio","Carroll County",4,16,367,193,174
050,39,019,"Ohio","Carroll County",4,17,342,182,160
050,39,019,"Ohio","Carroll County",4,18,284,150,134
050,39,019,"Ohio","Carroll County",4,19,232,121,111
050,39,019,"Ohio","Carroll County",4,20,253,131,122
050,39,019,"Ohio","Carroll County",4,21,275,131,144
050,39,019,"Ohio","Carroll County",4,22,266,138,128
050,39,019,"Ohio","Carroll County",4,23,281,151,130
050,39,019,"Ohio","Carroll County",4,24,271,145,126
050,39,019,"Ohio","Carroll County",4,25,271,148,123
050,39,019,"Ohio","Carroll County",4,26,284,142,142
050,39,019,"Ohio","Carroll County",4,27,274,140,134
050,39,019,"Ohio","Carroll County",4,28,283,152,131
050,39,019,"Ohio","Carroll County",4,29,298,159,139
050,39,019,"Ohio","Carroll County",4,30,271,135,136
050,39,019,"Ohio","Carroll County",4,31,284,138,146
050,39,019,"Ohio","Carroll County",4,32,275,133,142
050,39,019,"Ohio","Carroll County",4,33,273,132,141
050,39,019,"Ohio","Carroll County",4,34,287,140,147
050,39,019,"Ohio","Carroll County",4,35,302,149,153
050,39,019,"Ohio","Carroll County",4,36,294,150,144
050,39,019,"Ohio","Carroll County",4,37,280,150,130
050,39,019,"Ohio","Carroll County",4,38,281,143,138
050,39,019,"Ohio","Carroll County",4,39,297,150,147
050,39,019,"Ohio","Carroll County",4,40,280,139,141
050,39,019,"Ohio","Carroll County",4,41,276,148,128
050,39,019,"Ohio","Carroll County",4,42,296,158,138
050,39,019,"Ohio","Carroll County",4,43,307,160,147
050,39,019,"Ohio","Carroll County",4,44,322,164,158
050,39,019,"Ohio","Carroll County",4,45,307,164,143
050,39,019,"Ohio","Carroll County",4,46,298,153,145
050,39,019,"Ohio","Carroll County",4,47,303,155,148
050,39,019,"Ohio","Carroll County",4,48,316,156,160
050,39,019,"Ohio","Carroll County",4,49,341,185,156
050,39,019,"Ohio","Carroll County",4,50,370,195,175
050,39,019,"Ohio","Carroll County",4,51,380,192,188
050,39,019,"Ohio","Carroll County",4,52,366,189,177
050,39,019,"Ohio","Carroll County",4,53,338,171,167
050,39,019,"Ohio","Carroll County",4,54,319,170,149
050,39,019,"Ohio","Carroll County",4,55,337,179,158
050,39,019,"Ohio","Carroll County",4,56,363,193,170
050,39,019,"Ohio","Carroll County",4,57,398,201,197
050,39,019,"Ohio","Carroll County",4,58,431,218,213
050,39,019,"Ohio","Carroll County",4,59,449,216,233
050,39,019,"Ohio","Carroll County",4,60,444,232,212
050,39,019,"Ohio","Carroll County",4,61,451,246,205
050,39,019,"Ohio","Carroll County",4,62,449,246,203
050,39,019,"Ohio","Carroll County",4,63,442,220,222
050,39,019,"Ohio","Carroll County",4,64,453,217,236
050,39,019,"Ohio","Carroll County",4,65,425,209,216
050,39,019,"Ohio","Carroll County",4,66,402,201,201
050,39,019,"Ohio","Carroll County",4,67,398,202,196
050,39,019,"Ohio","Carroll County",4,68,402,198,204
050,39,019,"Ohio","Carroll County",4,69,369,168,201
050,39,019,"Ohio","Carroll County",4,70,352,172,180
050,39,019,"Ohio","Carroll County",4,71,335,166,169
050,39,019,"Ohio","Carroll County",4,72,297,140,157
050,39,019,"Ohio","Carroll County",4,73,299,154,145
050,39,019,"Ohio","Carroll County",4,74,308,151,157
050,39,019,"Ohio","Carroll County",4,75,327,162,165
050,39,019,"Ohio","Carroll County",4,76,221,106,115
050,39,019,"Ohio","Carroll County",4,77,200,100,100
050,39,019,"Ohio","Carroll County",4,78,198,96,102
050,39,019,"Ohio","Carroll County",4,79,203,92,111
050,39,019,"Ohio","Carroll County",4,80,168,70,98
050,39,019,"Ohio","Carroll County",4,81,165,76,89
050,39,019,"Ohio","Carroll County",4,82,136,64,72
050,39,019,"Ohio","Carroll County",4,83,117,60,57
050,39,019,"Ohio","Carroll County",4,84,117,64,53
050,39,019,"Ohio","Carroll County",4,85,573,222,351
050,39,019,"Ohio","Carroll County",5,0,227,108,119
050,39,019,"Ohio","Carroll County",5,1,255,119,136
050,39,019,"Ohio","Carroll County",5,2,240,131,109
050,39,019,"Ohio","Carroll County",5,3,309,164,145
050,39,019,"Ohio","Carroll County",5,4,294,158,136
050,39,019,"Ohio","Carroll County",5,5,313,166,147
050,39,019,"Ohio","Carroll County",5,6,275,143,132
050,39,019,"Ohio","Carroll County",5,7,293,157,136
050,39,019,"Ohio","Carroll County",5,8,312,164,148
050,39,019,"Ohio","Carroll County",5,9,291,155,136
050,39,019,"Ohio","Carroll County",5,10,316,153,163
050,39,019,"Ohio","Carroll County",5,11,291,158,133
050,39,019,"Ohio","Carroll County",5,12,308,149,159
050,39,019,"Ohio","Carroll County",5,13,349,180,169
050,39,019,"Ohio","Carroll County",5,14,364,200,164
050,39,019,"Ohio","Carroll County",5,15,380,186,194
050,39,019,"Ohio","Carroll County",5,16,370,199,171
050,39,019,"Ohio","Carroll County",5,17,376,201,175
050,39,019,"Ohio","Carroll County",5,18,290,158,132
050,39,019,"Ohio","Carroll County",5,19,217,113,104
050,39,019,"Ohio","Carroll County",5,20,263,130,133
050,39,019,"Ohio","Carroll County",5,21,256,135,121
050,39,019,"Ohio","Carroll County",5,22,281,132,149
050,39,019,"Ohio","Carroll County",5,23,274,146,128
050,39,019,"Ohio","Carroll County",5,24,272,148,124
050,39,019,"Ohio","Carroll County",5,25,260,133,127
050,39,019,"Ohio","Carroll County",5,26,273,145,128
050,39,019,"Ohio","Carroll County",5,27,287,142,145
050,39,019,"Ohio","Carroll County",5,28,277,141,136
050,39,019,"Ohio","Carroll County",5,29,286,151,135
050,39,019,"Ohio","Carroll County",5,30,287,154,133
050,39,019,"Ohio","Carroll County",5,31,273,134,139
050,39,019,"Ohio","Carroll County",5,32,287,132,155
050,39,019,"Ohio","Carroll County",5,33,286,141,145
050,39,019,"Ohio","Carroll County",5,34,288,137,151
050,39,019,"Ohio","Carroll County",5,35,296,140,156
050,39,019,"Ohio","Carroll County",5,36,304,155,149
050,39,019,"Ohio","Carroll County",5,37,287,148,139
050,39,019,"Ohio","Carroll County",5,38,297,154,143
050,39,019,"Ohio","Carroll County",5,39,297,149,148
050,39,019,"Ohio","Carroll County",5,40,295,144,151
050,39,019,"Ohio","Carroll County",5,41,287,142,145
050,39,019,"Ohio","Carroll County",5,42,287,152,135
050,39,019,"Ohio","Carroll County",5,43,311,174,137
050,39,019,"Ohio","Carroll County",5,44,320,166,154
050,39,019,"Ohio","Carroll County",5,45,317,163,154
050,39,019,"Ohio","Carroll County",5,46,317,170,147
050,39,019,"Ohio","Carroll County",5,47,308,160,148
050,39,019,"Ohio","Carroll County",5,48,302,159,143
050,39,019,"Ohio","Carroll County",5,49,321,156,165
050,39,019,"Ohio","Carroll County",5,50,344,186,158
050,39,019,"Ohio","Carroll County",5,51,368,198,170
050,39,019,"Ohio","Carroll County",5,52,386,196,190
050,39,019,"Ohio","Carroll County",5,53,375,194,181
050,39,019,"Ohio","Carroll County",5,54,334,170,164
050,39,019,"Ohio","Carroll County",5,55,317,164,153
050,39,019,"Ohio","Carroll County",5,56,338,178,160
050,39,019,"Ohio","Carroll County",5,57,360,193,167
050,39,019,"Ohio","Carroll County",5,58,401,201,200
050,39,019,"Ohio","Carroll County",5,59,430,211,219
050,39,019,"Ohio","Carroll County",5,60,438,217,221
050,39,019,"Ohio","Carroll County",5,61,439,229,210
050,39,019,"Ohio","Carroll County",5,62,442,245,197
050,39,019,"Ohio","Carroll County",5,63,441,241,200
050,39,019,"Ohio","Carroll County",5,64,436,216,220
050,39,019,"Ohio","Carroll County",5,65,439,207,232
050,39,019,"Ohio","Carroll County",5,66,416,205,211
050,39,019,"Ohio","Carroll County",5,67,391,199,192
050,39,019,"Ohio","Carroll County",5,68,389,200,189
050,39,019,"Ohio","Carroll County",5,69,395,189,206
050,39,019,"Ohio","Carroll County",5,70,349,157,192
050,39,019,"Ohio","Carroll County",5,71,346,169,177
050,39,019,"Ohio","Carroll County",5,72,325,157,168
050,39,019,"Ohio","Carroll County",5,73,273,132,141
050,39,019,"Ohio","Carroll County",5,74,298,154,144
050,39,019,"Ohio","Carroll County",5,75,302,145,157
050,39,019,"Ohio","Carroll County",5,76,308,152,156
050,39,019,"Ohio","Carroll County",5,77,211,96,115
050,39,019,"Ohio","Carroll County",5,78,194,97,97
050,39,019,"Ohio","Carroll County",5,79,184,88,96
050,39,019,"Ohio","Carroll County",5,80,186,83,103
050,39,019,"Ohio","Carroll County",5,81,156,62,94
050,39,019,"Ohio","Carroll County",5,82,153,71,82
050,39,019,"Ohio","Carroll County",5,83,130,60,70
050,39,019,"Ohio","Carroll County",5,84,109,59,50
050,39,019,"Ohio","Carroll County",5,85,589,241,348
050,39,021,"Ohio","Champaign County",1,0,381,196,185
050,39,021,"Ohio","Champaign County",1,1,421,214,207
050,39,021,"Ohio","Champaign County",1,2,444,226,218
050,39,021,"Ohio","Champaign County",1,3,448,234,214
050,39,021,"Ohio","Champaign County",1,4,439,230,209
050,39,021,"Ohio","Champaign County",1,5,411,213,198
050,39,021,"Ohio","Champaign County",1,6,426,213,213
050,39,021,"Ohio","Champaign County",1,7,447,219,228
050,39,021,"Ohio","Champaign County",1,8,458,232,226
050,39,021,"Ohio","Champaign County",1,9,473,247,226
050,39,021,"Ohio","Champaign County",1,10,498,273,225
050,39,021,"Ohio","Champaign County",1,11,521,258,263
050,39,021,"Ohio","Champaign County",1,12,544,279,265
050,39,021,"Ohio","Champaign County",1,13,566,284,282
050,39,021,"Ohio","Champaign County",1,14,556,279,277
050,39,021,"Ohio","Champaign County",1,15,543,278,265
050,39,021,"Ohio","Champaign County",1,16,561,295,266
050,39,021,"Ohio","Champaign County",1,17,588,301,287
050,39,021,"Ohio","Champaign County",1,18,458,244,214
050,39,021,"Ohio","Champaign County",1,19,358,190,168
050,39,021,"Ohio","Champaign County",1,20,389,208,181
050,39,021,"Ohio","Champaign County",1,21,397,198,199
050,39,021,"Ohio","Champaign County",1,22,434,218,216
050,39,021,"Ohio","Champaign County",1,23,431,210,221
050,39,021,"Ohio","Champaign County",1,24,460,251,209
050,39,021,"Ohio","Champaign County",1,25,482,265,217
050,39,021,"Ohio","Champaign County",1,26,492,263,229
050,39,021,"Ohio","Champaign County",1,27,497,254,243
050,39,021,"Ohio","Champaign County",1,28,499,255,244
050,39,021,"Ohio","Champaign County",1,29,472,233,239
050,39,021,"Ohio","Champaign County",1,30,435,221,214
050,39,021,"Ohio","Champaign County",1,31,437,222,215
050,39,021,"Ohio","Champaign County",1,32,428,226,202
050,39,021,"Ohio","Champaign County",1,33,454,239,215
050,39,021,"Ohio","Champaign County",1,34,442,222,220
050,39,021,"Ohio","Champaign County",1,35,456,227,229
050,39,021,"Ohio","Champaign County",1,36,418,202,216
050,39,021,"Ohio","Champaign County",1,37,439,224,215
050,39,021,"Ohio","Champaign County",1,38,473,242,231
050,39,021,"Ohio","Champaign County",1,39,424,208,216
050,39,021,"Ohio","Champaign County",1,40,412,208,204
050,39,021,"Ohio","Champaign County",1,41,440,225,215
050,39,021,"Ohio","Champaign County",1,42,470,241,229
050,39,021,"Ohio","Champaign County",1,43,443,225,218
050,39,021,"Ohio","Champaign County",1,44,417,208,209
050,39,021,"Ohio","Champaign County",1,45,432,217,215
050,39,021,"Ohio","Champaign County",1,46,454,222,232
050,39,021,"Ohio","Champaign County",1,47,481,245,236
050,39,021,"Ohio","Champaign County",1,48,523,263,260
050,39,021,"Ohio","Champaign County",1,49,582,311,271
050,39,021,"Ohio","Champaign County",1,50,554,279,275
050,39,021,"Ohio","Champaign County",1,51,519,270,249
050,39,021,"Ohio","Champaign County",1,52,503,261,242
050,39,021,"Ohio","Champaign County",1,53,561,283,278
050,39,021,"Ohio","Champaign County",1,54,586,294,292
050,39,021,"Ohio","Champaign County",1,55,566,294,272
050,39,021,"Ohio","Champaign County",1,56,588,311,277
050,39,021,"Ohio","Champaign County",1,57,566,289,277
050,39,021,"Ohio","Champaign County",1,58,580,286,294
050,39,021,"Ohio","Champaign County",1,59,583,291,292
050,39,021,"Ohio","Champaign County",1,60,575,280,295
050,39,021,"Ohio","Champaign County",1,61,564,286,278
050,39,021,"Ohio","Champaign County",1,62,582,293,289
050,39,021,"Ohio","Champaign County",1,63,570,292,278
050,39,021,"Ohio","Champaign County",1,64,512,254,258
050,39,021,"Ohio","Champaign County",1,65,477,237,240
050,39,021,"Ohio","Champaign County",1,66,470,221,249
050,39,021,"Ohio","Champaign County",1,67,441,202,239
050,39,021,"Ohio","Champaign County",1,68,440,206,234
050,39,021,"Ohio","Champaign County",1,69,399,201,198
050,39,021,"Ohio","Champaign County",1,70,411,205,206
050,39,021,"Ohio","Champaign County",1,71,410,209,201
050,39,021,"Ohio","Champaign County",1,72,431,188,243
050,39,021,"Ohio","Champaign County",1,73,420,190,230
050,39,021,"Ohio","Champaign County",1,74,289,133,156
050,39,021,"Ohio","Champaign County",1,75,303,153,150
050,39,021,"Ohio","Champaign County",1,76,277,137,140
050,39,021,"Ohio","Champaign County",1,77,284,132,152
050,39,021,"Ohio","Champaign County",1,78,257,112,145
050,39,021,"Ohio","Champaign County",1,79,241,114,127
050,39,021,"Ohio","Champaign County",1,80,189,82,107
050,39,021,"Ohio","Champaign County",1,81,198,86,112
050,39,021,"Ohio","Champaign County",1,82,185,77,108
050,39,021,"Ohio","Champaign County",1,83,157,70,87
050,39,021,"Ohio","Champaign County",1,84,147,64,83
050,39,021,"Ohio","Champaign County",1,85,723,260,463
050,39,021,"Ohio","Champaign County",2,0,396,200,196
050,39,021,"Ohio","Champaign County",2,1,413,211,202
050,39,021,"Ohio","Champaign County",2,2,443,227,216
050,39,021,"Ohio","Champaign County",2,3,448,235,213
050,39,021,"Ohio","Champaign County",2,4,441,231,210
050,39,021,"Ohio","Champaign County",2,5,420,217,203
050,39,021,"Ohio","Champaign County",2,6,426,215,211
050,39,021,"Ohio","Champaign County",2,7,441,218,223
050,39,021,"Ohio","Champaign County",2,8,452,226,226
050,39,021,"Ohio","Champaign County",2,9,469,244,225
050,39,021,"Ohio","Champaign County",2,10,490,265,225
050,39,021,"Ohio","Champaign County",2,11,512,261,251
050,39,021,"Ohio","Champaign County",2,12,541,275,266
050,39,021,"Ohio","Champaign County",2,13,563,284,279
050,39,021,"Ohio","Champaign County",2,14,561,281,280
050,39,021,"Ohio","Champaign County",2,15,547,277,270
050,39,021,"Ohio","Champaign County",2,16,560,291,269
050,39,021,"Ohio","Champaign County",2,17,583,301,282
050,39,021,"Ohio","Champaign County",2,18,463,247,216
050,39,021,"Ohio","Champaign County",2,19,363,191,172
050,39,021,"Ohio","Champaign County",2,20,391,208,183
050,39,021,"Ohio","Champaign County",2,21,401,201,200
050,39,021,"Ohio","Champaign County",2,22,430,214,216
050,39,021,"Ohio","Champaign County",2,23,438,215,223
050,39,021,"Ohio","Champaign County",2,24,456,245,211
050,39,021,"Ohio","Champaign County",2,25,477,260,217
050,39,021,"Ohio","Champaign County",2,26,493,265,228
050,39,021,"Ohio","Champaign County",2,27,495,254,241
050,39,021,"Ohio","Champaign County",2,28,500,256,244
050,39,021,"Ohio","Champaign County",2,29,481,241,240
050,39,021,"Ohio","Champaign County",2,30,449,225,224
050,39,021,"Ohio","Champaign County",2,31,440,224,216
050,39,021,"Ohio","Champaign County",2,32,433,225,208
050,39,021,"Ohio","Champaign County",2,33,449,237,212
050,39,021,"Ohio","Champaign County",2,34,448,226,222
050,39,021,"Ohio","Champaign County",2,35,455,227,228
050,39,021,"Ohio","Champaign County",2,36,426,207,219
050,39,021,"Ohio","Champaign County",2,37,439,220,219
050,39,021,"Ohio","Champaign County",2,38,466,239,227
050,39,021,"Ohio","Champaign County",2,39,433,215,218
050,39,021,"Ohio","Champaign County",2,40,415,208,207
050,39,021,"Ohio","Champaign County",2,41,434,222,212
050,39,021,"Ohio","Champaign County",2,42,461,237,224
050,39,021,"Ohio","Champaign County",2,43,453,232,221
050,39,021,"Ohio","Champaign County",2,44,418,209,209
050,39,021,"Ohio","Champaign County",2,45,430,215,215
050,39,021,"Ohio","Champaign County",2,46,447,219,228
050,39,021,"Ohio","Champaign County",2,47,474,241,233
050,39,021,"Ohio","Champaign County",2,48,510,257,253
050,39,021,"Ohio","Champaign County",2,49,568,299,269
050,39,021,"Ohio","Champaign County",2,50,561,286,275
050,39,021,"Ohio","Champaign County",2,51,525,273,252
050,39,021,"Ohio","Champaign County",2,52,504,263,241
050,39,021,"Ohio","Champaign County",2,53,549,278,271
050,39,021,"Ohio","Champaign County",2,54,578,290,288
050,39,021,"Ohio","Champaign County",2,55,572,295,277
050,39,021,"Ohio","Champaign County",2,56,582,306,276
050,39,021,"Ohio","Champaign County",2,57,572,296,276
050,39,021,"Ohio","Champaign County",2,58,573,284,289
050,39,021,"Ohio","Champaign County",2,59,588,293,295
050,39,021,"Ohio","Champaign County",2,60,573,280,293
050,39,021,"Ohio","Champaign County",2,61,565,283,282
050,39,021,"Ohio","Champaign County",2,62,576,289,287
050,39,021,"Ohio","Champaign County",2,63,574,294,280
050,39,021,"Ohio","Champaign County",2,64,519,262,257
050,39,021,"Ohio","Champaign County",2,65,486,242,244
050,39,021,"Ohio","Champaign County",2,66,473,225,248
050,39,021,"Ohio","Champaign County",2,67,446,206,240
050,39,021,"Ohio","Champaign County",2,68,434,202,232
050,39,021,"Ohio","Champaign County",2,69,407,201,206
050,39,021,"Ohio","Champaign County",2,70,407,203,204
050,39,021,"Ohio","Champaign County",2,71,412,208,204
050,39,021,"Ohio","Champaign County",2,72,414,186,228
050,39,021,"Ohio","Champaign County",2,73,443,199,244
050,39,021,"Ohio","Champaign County",2,74,298,136,162
050,39,021,"Ohio","Champaign County",2,75,299,147,152
050,39,021,"Ohio","Champaign County",2,76,279,139,140
050,39,021,"Ohio","Champaign County",2,77,289,137,152
050,39,021,"Ohio","Champaign County",2,78,255,112,143
050,39,021,"Ohio","Champaign County",2,79,241,111,130
050,39,021,"Ohio","Champaign County",2,80,197,86,111
050,39,021,"Ohio","Champaign County",2,81,189,82,107
050,39,021,"Ohio","Champaign County",2,82,188,78,110
050,39,021,"Ohio","Champaign County",2,83,162,71,91
050,39,021,"Ohio","Champaign County",2,84,140,59,81
050,39,021,"Ohio","Champaign County",2,85,731,265,466
050,39,021,"Ohio","Champaign County",3,0,377,190,187
050,39,021,"Ohio","Champaign County",3,1,410,195,215
050,39,021,"Ohio","Champaign County",3,2,427,211,216
050,39,021,"Ohio","Champaign County",3,3,437,223,214
050,39,021,"Ohio","Champaign County",3,4,454,243,211
050,39,021,"Ohio","Champaign County",3,5,452,233,219
050,39,021,"Ohio","Champaign County",3,6,430,221,209
050,39,021,"Ohio","Champaign County",3,7,430,211,219
050,39,021,"Ohio","Champaign County",3,8,447,218,229
050,39,021,"Ohio","Champaign County",3,9,470,236,234
050,39,021,"Ohio","Champaign County",3,10,473,249,224
050,39,021,"Ohio","Champaign County",3,11,503,269,234
050,39,021,"Ohio","Champaign County",3,12,513,260,253
050,39,021,"Ohio","Champaign County",3,13,550,278,272
050,39,021,"Ohio","Champaign County",3,14,573,297,276
050,39,021,"Ohio","Champaign County",3,15,548,274,274
050,39,021,"Ohio","Champaign County",3,16,555,281,274
050,39,021,"Ohio","Champaign County",3,17,546,282,264
050,39,021,"Ohio","Champaign County",3,18,481,264,217
050,39,021,"Ohio","Champaign County",3,19,386,208,178
050,39,021,"Ohio","Champaign County",3,20,397,209,188
050,39,021,"Ohio","Champaign County",3,21,395,211,184
050,39,021,"Ohio","Champaign County",3,22,434,227,207
050,39,021,"Ohio","Champaign County",3,23,403,215,188
050,39,021,"Ohio","Champaign County",3,24,419,206,213
050,39,021,"Ohio","Champaign County",3,25,483,245,238
050,39,021,"Ohio","Champaign County",3,26,487,251,236
050,39,021,"Ohio","Champaign County",3,27,476,251,225
050,39,021,"Ohio","Champaign County",3,28,487,251,236
050,39,021,"Ohio","Champaign County",3,29,498,256,242
050,39,021,"Ohio","Champaign County",3,30,499,249,250
050,39,021,"Ohio","Champaign County",3,31,462,229,233
050,39,021,"Ohio","Champaign County",3,32,458,231,227
050,39,021,"Ohio","Champaign County",3,33,440,221,219
050,39,021,"Ohio","Champaign County",3,34,454,239,215
050,39,021,"Ohio","Champaign County",3,35,456,235,221
050,39,021,"Ohio","Champaign County",3,36,466,232,234
050,39,021,"Ohio","Champaign County",3,37,440,211,229
050,39,021,"Ohio","Champaign County",3,38,440,222,218
050,39,021,"Ohio","Champaign County",3,39,468,236,232
050,39,021,"Ohio","Champaign County",3,40,423,207,216
050,39,021,"Ohio","Champaign County",3,41,428,219,209
050,39,021,"Ohio","Champaign County",3,42,440,228,212
050,39,021,"Ohio","Champaign County",3,43,469,244,225
050,39,021,"Ohio","Champaign County",3,44,446,230,216
050,39,021,"Ohio","Champaign County",3,45,414,203,211
050,39,021,"Ohio","Champaign County",3,46,443,222,221
050,39,021,"Ohio","Champaign County",3,47,447,221,226
050,39,021,"Ohio","Champaign County",3,48,490,247,243
050,39,021,"Ohio","Champaign County",3,49,517,259,258
050,39,021,"Ohio","Champaign County",3,50,570,295,275
050,39,021,"Ohio","Champaign County",3,51,562,278,284
050,39,021,"Ohio","Champaign County",3,52,519,274,245
050,39,021,"Ohio","Champaign County",3,53,521,274,247
050,39,021,"Ohio","Champaign County",3,54,556,285,271
050,39,021,"Ohio","Champaign County",3,55,571,282,289
050,39,021,"Ohio","Champaign County",3,56,572,289,283
050,39,021,"Ohio","Champaign County",3,57,573,300,273
050,39,021,"Ohio","Champaign County",3,58,572,295,277
050,39,021,"Ohio","Champaign County",3,59,573,281,292
050,39,021,"Ohio","Champaign County",3,60,572,290,282
050,39,021,"Ohio","Champaign County",3,61,572,278,294
050,39,021,"Ohio","Champaign County",3,62,550,272,278
050,39,021,"Ohio","Champaign County",3,63,560,275,285
050,39,021,"Ohio","Champaign County",3,64,564,289,275
050,39,021,"Ohio","Champaign County",3,65,509,258,251
050,39,021,"Ohio","Champaign County",3,66,492,244,248
050,39,021,"Ohio","Champaign County",3,67,458,215,243
050,39,021,"Ohio","Champaign County",3,68,439,207,232
050,39,021,"Ohio","Champaign County",3,69,418,194,224
050,39,021,"Ohio","Champaign County",3,70,393,197,196
050,39,021,"Ohio","Champaign County",3,71,400,198,202
050,39,021,"Ohio","Champaign County",3,72,405,200,205
050,39,021,"Ohio","Champaign County",3,73,395,182,213
050,39,021,"Ohio","Champaign County",3,74,431,191,240
050,39,021,"Ohio","Champaign County",3,75,285,129,156
050,39,021,"Ohio","Champaign County",3,76,287,141,146
050,39,021,"Ohio","Champaign County",3,77,275,137,138
050,39,021,"Ohio","Champaign County",3,78,274,132,142
050,39,021,"Ohio","Champaign County",3,79,241,107,134
050,39,021,"Ohio","Champaign County",3,80,221,101,120
050,39,021,"Ohio","Champaign County",3,81,188,81,107
050,39,021,"Ohio","Champaign County",3,82,175,77,98
050,39,021,"Ohio","Champaign County",3,83,181,71,110
050,39,021,"Ohio","Champaign County",3,84,140,59,81
050,39,021,"Ohio","Champaign County",3,85,739,277,462
050,39,021,"Ohio","Champaign County",4,0,417,213,204
050,39,021,"Ohio","Champaign County",4,1,398,202,196
050,39,021,"Ohio","Champaign County",4,2,425,209,216
050,39,021,"Ohio","Champaign County",4,3,460,228,232
050,39,021,"Ohio","Champaign County",4,4,429,221,208
050,39,021,"Ohio","Champaign County",4,5,459,250,209
050,39,021,"Ohio","Champaign County",4,6,442,234,208
050,39,021,"Ohio","Champaign County",4,7,448,224,224
050,39,021,"Ohio","Champaign County",4,8,437,208,229
050,39,021,"Ohio","Champaign County",4,9,458,233,225
050,39,021,"Ohio","Champaign County",4,10,477,230,247
050,39,021,"Ohio","Champaign County",4,11,471,236,235
050,39,021,"Ohio","Champaign County",4,12,502,260,242
050,39,021,"Ohio","Champaign County",4,13,529,258,271
050,39,021,"Ohio","Champaign County",4,14,558,280,278
050,39,021,"Ohio","Champaign County",4,15,559,284,275
050,39,021,"Ohio","Champaign County",4,16,556,279,277
050,39,021,"Ohio","Champaign County",4,17,537,272,265
050,39,021,"Ohio","Champaign County",4,18,438,238,200
050,39,021,"Ohio","Champaign County",4,19,380,206,174
050,39,021,"Ohio","Champaign County",4,20,380,205,175
050,39,021,"Ohio","Champaign County",4,21,400,210,190
050,39,021,"Ohio","Champaign County",4,22,419,214,205
050,39,021,"Ohio","Champaign County",4,23,457,240,217
050,39,021,"Ohio","Champaign County",4,24,427,218,209
050,39,021,"Ohio","Champaign County",4,25,436,209,227
050,39,021,"Ohio","Champaign County",4,26,484,248,236
050,39,021,"Ohio","Champaign County",4,27,505,253,252
050,39,021,"Ohio","Champaign County",4,28,467,252,215
050,39,021,"Ohio","Champaign County",4,29,495,254,241
050,39,021,"Ohio","Champaign County",4,30,510,265,245
050,39,021,"Ohio","Champaign County",4,31,512,251,261
050,39,021,"Ohio","Champaign County",4,32,476,233,243
050,39,021,"Ohio","Champaign County",4,33,467,232,235
050,39,021,"Ohio","Champaign County",4,34,461,224,237
050,39,021,"Ohio","Champaign County",4,35,459,238,221
050,39,021,"Ohio","Champaign County",4,36,474,234,240
050,39,021,"Ohio","Champaign County",4,37,468,237,231
050,39,021,"Ohio","Champaign County",4,38,438,212,226
050,39,021,"Ohio","Champaign County",4,39,435,219,216
050,39,021,"Ohio","Champaign County",4,40,458,232,226
050,39,021,"Ohio","Champaign County",4,41,436,219,217
050,39,021,"Ohio","Champaign County",4,42,412,200,212
050,39,021,"Ohio","Champaign County",4,43,435,223,212
050,39,021,"Ohio","Champaign County",4,44,452,236,216
050,39,021,"Ohio","Champaign County",4,45,449,230,219
050,39,021,"Ohio","Champaign County",4,46,409,201,208
050,39,021,"Ohio","Champaign County",4,47,436,225,211
050,39,021,"Ohio","Champaign County",4,48,434,213,221
050,39,021,"Ohio","Champaign County",4,49,485,249,236
050,39,021,"Ohio","Champaign County",4,50,521,259,262
050,39,021,"Ohio","Champaign County",4,51,583,303,280
050,39,021,"Ohio","Champaign County",4,52,557,278,279
050,39,021,"Ohio","Champaign County",4,53,517,272,245
050,39,021,"Ohio","Champaign County",4,54,516,274,242
050,39,021,"Ohio","Champaign County",4,55,543,275,268
050,39,021,"Ohio","Champaign County",4,56,567,278,289
050,39,021,"Ohio","Champaign County",4,57,564,284,280
050,39,021,"Ohio","Champaign County",4,58,570,303,267
050,39,021,"Ohio","Champaign County",4,59,560,282,278
050,39,021,"Ohio","Champaign County",4,60,570,278,292
050,39,021,"Ohio","Champaign County",4,61,574,288,286
050,39,021,"Ohio","Champaign County",4,62,559,265,294
050,39,021,"Ohio","Champaign County",4,63,532,269,263
050,39,021,"Ohio","Champaign County",4,64,547,266,281
050,39,021,"Ohio","Champaign County",4,65,551,283,268
050,39,021,"Ohio","Champaign County",4,66,505,252,253
050,39,021,"Ohio","Champaign County",4,67,480,236,244
050,39,021,"Ohio","Champaign County",4,68,458,214,244
050,39,021,"Ohio","Champaign County",4,69,434,205,229
050,39,021,"Ohio","Champaign County",4,70,410,193,217
050,39,021,"Ohio","Champaign County",4,71,385,193,192
050,39,021,"Ohio","Champaign County",4,72,395,193,202
050,39,021,"Ohio","Champaign County",4,73,381,189,192
050,39,021,"Ohio","Champaign County",4,74,372,171,201
050,39,021,"Ohio","Champaign County",4,75,419,189,230
050,39,021,"Ohio","Champaign County",4,76,274,122,152
050,39,021,"Ohio","Champaign County",4,77,275,129,146
050,39,021,"Ohio","Champaign County",4,78,250,126,124
050,39,021,"Ohio","Champaign County",4,79,255,121,134
050,39,021,"Ohio","Champaign County",4,80,216,96,120
050,39,021,"Ohio","Champaign County",4,81,213,95,118
050,39,021,"Ohio","Champaign County",4,82,173,77,96
050,39,021,"Ohio","Champaign County",4,83,162,66,96
050,39,021,"Ohio","Champaign County",4,84,155,57,98
050,39,021,"Ohio","Champaign County",4,85,744,279,465
050,39,021,"Ohio","Champaign County",5,0,426,216,210
050,39,021,"Ohio","Champaign County",5,1,418,213,205
050,39,021,"Ohio","Champaign County",5,2,408,211,197
050,39,021,"Ohio","Champaign County",5,3,449,226,223
050,39,021,"Ohio","Champaign County",5,4,457,231,226
050,39,021,"Ohio","Champaign County",5,5,443,223,220
050,39,021,"Ohio","Champaign County",5,6,449,250,199
050,39,021,"Ohio","Champaign County",5,7,446,232,214
050,39,021,"Ohio","Champaign County",5,8,438,213,225
050,39,021,"Ohio","Champaign County",5,9,420,193,227
050,39,021,"Ohio","Champaign County",5,10,444,221,223
050,39,021,"Ohio","Champaign County",5,11,486,237,249
050,39,021,"Ohio","Champaign County",5,12,491,258,233
050,39,021,"Ohio","Champaign County",5,13,514,266,248
050,39,021,"Ohio","Champaign County",5,14,526,263,263
050,39,021,"Ohio","Champaign County",5,15,561,285,276
050,39,021,"Ohio","Champaign County",5,16,551,268,283
050,39,021,"Ohio","Champaign County",5,17,561,289,272
050,39,021,"Ohio","Champaign County",5,18,439,226,213
050,39,021,"Ohio","Champaign County",5,19,351,190,161
050,39,021,"Ohio","Champaign County",5,20,410,231,179
050,39,021,"Ohio","Champaign County",5,21,390,199,191
050,39,021,"Ohio","Champaign County",5,22,421,208,213
050,39,021,"Ohio","Champaign County",5,23,457,241,216
050,39,021,"Ohio","Champaign County",5,24,468,255,213
050,39,021,"Ohio","Champaign County",5,25,429,212,217
050,39,021,"Ohio","Champaign County",5,26,467,225,242
050,39,021,"Ohio","Champaign County",5,27,474,243,231
050,39,021,"Ohio","Champaign County",5,28,509,255,254
050,39,021,"Ohio","Champaign County",5,29,472,248,224
050,39,021,"Ohio","Champaign County",5,30,507,254,253
050,39,021,"Ohio","Champaign County",5,31,494,252,242
050,39,021,"Ohio","Champaign County",5,32,514,264,250
050,39,021,"Ohio","Champaign County",5,33,472,231,241
050,39,021,"Ohio","Champaign County",5,34,473,228,245
050,39,021,"Ohio","Champaign County",5,35,461,220,241
050,39,021,"Ohio","Champaign County",5,36,472,248,224
050,39,021,"Ohio","Champaign County",5,37,470,238,232
050,39,021,"Ohio","Champaign County",5,38,481,253,228
050,39,021,"Ohio","Champaign County",5,39,450,213,237
050,39,021,"Ohio","Champaign County",5,40,432,219,213
050,39,021,"Ohio","Champaign County",5,41,472,244,228
050,39,021,"Ohio","Champaign County",5,42,441,226,215
050,39,021,"Ohio","Champaign County",5,43,409,207,202
050,39,021,"Ohio","Champaign County",5,44,435,217,218
050,39,021,"Ohio","Champaign County",5,45,460,239,221
050,39,021,"Ohio","Champaign County",5,46,438,215,223
050,39,021,"Ohio","Champaign County",5,47,416,212,204
050,39,021,"Ohio","Champaign County",5,48,432,217,215
050,39,021,"Ohio","Champaign County",5,49,429,215,214
050,39,021,"Ohio","Champaign County",5,50,488,246,242
050,39,021,"Ohio","Champaign County",5,51,529,263,266
050,39,021,"Ohio","Champaign County",5,52,577,300,277
050,39,021,"Ohio","Champaign County",5,53,557,282,275
050,39,021,"Ohio","Champaign County",5,54,507,261,246
050,39,021,"Ohio","Champaign County",5,55,502,262,240
050,39,021,"Ohio","Champaign County",5,56,535,268,267
050,39,021,"Ohio","Champaign County",5,57,560,276,284
050,39,021,"Ohio","Champaign County",5,58,572,289,283
050,39,021,"Ohio","Champaign County",5,59,577,302,275
050,39,021,"Ohio","Champaign County",5,60,563,286,277
050,39,021,"Ohio","Champaign County",5,61,572,277,295
050,39,021,"Ohio","Champaign County",5,62,579,286,293
050,39,021,"Ohio","Champaign County",5,63,548,261,287
050,39,021,"Ohio","Champaign County",5,64,533,267,266
050,39,021,"Ohio","Champaign County",5,65,547,267,280
050,39,021,"Ohio","Champaign County",5,66,544,278,266
050,39,021,"Ohio","Champaign County",5,67,493,249,244
050,39,021,"Ohio","Champaign County",5,68,467,231,236
050,39,021,"Ohio","Champaign County",5,69,449,211,238
050,39,021,"Ohio","Champaign County",5,70,434,203,231
050,39,021,"Ohio","Champaign County",5,71,405,186,219
050,39,021,"Ohio","Champaign County",5,72,381,186,195
050,39,021,"Ohio","Champaign County",5,73,372,187,185
050,39,021,"Ohio","Champaign County",5,74,362,183,179
050,39,021,"Ohio","Champaign County",5,75,360,169,191
050,39,021,"Ohio","Champaign County",5,76,403,181,222
050,39,021,"Ohio","Champaign County",5,77,266,114,152
050,39,021,"Ohio","Champaign County",5,78,258,120,138
050,39,021,"Ohio","Champaign County",5,79,245,117,128
050,39,021,"Ohio","Champaign County",5,80,234,112,122
050,39,021,"Ohio","Champaign County",5,81,215,98,117
050,39,021,"Ohio","Champaign County",5,82,200,92,108
050,39,021,"Ohio","Champaign County",5,83,161,65,96
050,39,021,"Ohio","Champaign County",5,84,139,52,87
050,39,021,"Ohio","Champaign County",5,85,778,289,489
050,39,023,"Ohio","Clark County",1,0,1546,789,757
050,39,023,"Ohio","Clark County",1,1,1586,799,787
050,39,023,"Ohio","Clark County",1,2,1657,854,803
050,39,023,"Ohio","Clark County",1,3,1600,820,780
050,39,023,"Ohio","Clark County",1,4,1652,818,834
050,39,023,"Ohio","Clark County",1,5,1696,856,840
050,39,023,"Ohio","Clark County",1,6,1664,850,814
050,39,023,"Ohio","Clark County",1,7,1686,857,829
050,39,023,"Ohio","Clark County",1,8,1628,869,759
050,39,023,"Ohio","Clark County",1,9,1671,859,812
050,39,023,"Ohio","Clark County",1,10,1743,898,845
050,39,023,"Ohio","Clark County",1,11,1803,923,880
050,39,023,"Ohio","Clark County",1,12,1912,994,918
050,39,023,"Ohio","Clark County",1,13,1883,970,913
050,39,023,"Ohio","Clark County",1,14,1823,942,881
050,39,023,"Ohio","Clark County",1,15,1766,908,858
050,39,023,"Ohio","Clark County",1,16,1817,956,861
050,39,023,"Ohio","Clark County",1,17,1800,922,878
050,39,023,"Ohio","Clark County",1,18,1720,897,823
050,39,023,"Ohio","Clark County",1,19,1605,807,798
050,39,023,"Ohio","Clark County",1,20,1628,814,814
050,39,023,"Ohio","Clark County",1,21,1562,794,768
050,39,023,"Ohio","Clark County",1,22,1570,796,774
050,39,023,"Ohio","Clark County",1,23,1578,788,790
050,39,023,"Ohio","Clark County",1,24,1518,766,752
050,39,023,"Ohio","Clark County",1,25,1562,783,779
050,39,023,"Ohio","Clark County",1,26,1613,806,807
050,39,023,"Ohio","Clark County",1,27,1600,800,800
050,39,023,"Ohio","Clark County",1,28,1622,787,835
050,39,023,"Ohio","Clark County",1,29,1646,810,836
050,39,023,"Ohio","Clark County",1,30,1603,765,838
050,39,023,"Ohio","Clark County",1,31,1654,823,831
050,39,023,"Ohio","Clark County",1,32,1582,794,788
050,39,023,"Ohio","Clark County",1,33,1528,756,772
050,39,023,"Ohio","Clark County",1,34,1587,780,807
050,39,023,"Ohio","Clark County",1,35,1607,772,835
050,39,023,"Ohio","Clark County",1,36,1567,765,802
050,39,023,"Ohio","Clark County",1,37,1538,745,793
050,39,023,"Ohio","Clark County",1,38,1515,736,779
050,39,023,"Ohio","Clark County",1,39,1461,693,768
050,39,023,"Ohio","Clark County",1,40,1535,734,801
050,39,023,"Ohio","Clark County",1,41,1538,749,789
050,39,023,"Ohio","Clark County",1,42,1554,773,781
050,39,023,"Ohio","Clark County",1,43,1463,709,754
050,39,023,"Ohio","Clark County",1,44,1440,713,727
050,39,023,"Ohio","Clark County",1,45,1471,722,749
050,39,023,"Ohio","Clark County",1,46,1444,702,742
050,39,023,"Ohio","Clark County",1,47,1579,797,782
050,39,023,"Ohio","Clark County",1,48,1694,835,859
050,39,023,"Ohio","Clark County",1,49,1886,955,931
050,39,023,"Ohio","Clark County",1,50,1768,894,874
050,39,023,"Ohio","Clark County",1,51,1783,892,891
050,39,023,"Ohio","Clark County",1,52,1657,814,843
050,39,023,"Ohio","Clark County",1,53,1774,902,872
050,39,023,"Ohio","Clark County",1,54,1812,929,883
050,39,023,"Ohio","Clark County",1,55,1877,928,949
050,39,023,"Ohio","Clark County",1,56,1858,928,930
050,39,023,"Ohio","Clark County",1,57,1894,928,966
050,39,023,"Ohio","Clark County",1,58,1972,967,1005
050,39,023,"Ohio","Clark County",1,59,1969,954,1015
050,39,023,"Ohio","Clark County",1,60,1926,930,996
050,39,023,"Ohio","Clark County",1,61,1888,904,984
050,39,023,"Ohio","Clark County",1,62,1920,933,987
050,39,023,"Ohio","Clark County",1,63,1853,886,967
050,39,023,"Ohio","Clark County",1,64,1823,896,927
050,39,023,"Ohio","Clark County",1,65,1783,873,910
050,39,023,"Ohio","Clark County",1,66,1754,831,923
050,39,023,"Ohio","Clark County",1,67,1782,828,954
050,39,023,"Ohio","Clark County",1,68,1743,812,931
050,39,023,"Ohio","Clark County",1,69,1598,749,849
050,39,023,"Ohio","Clark County",1,70,1546,716,830
050,39,023,"Ohio","Clark County",1,71,1557,725,832
050,39,023,"Ohio","Clark County",1,72,1552,739,813
050,39,023,"Ohio","Clark County",1,73,1504,700,804
050,39,023,"Ohio","Clark County",1,74,1003,445,558
050,39,023,"Ohio","Clark County",1,75,940,430,510
050,39,023,"Ohio","Clark County",1,76,994,451,543
050,39,023,"Ohio","Clark County",1,77,1032,484,548
050,39,023,"Ohio","Clark County",1,78,928,429,499
050,39,023,"Ohio","Clark County",1,79,802,341,461
050,39,023,"Ohio","Clark County",1,80,743,314,429
050,39,023,"Ohio","Clark County",1,81,713,311,402
050,39,023,"Ohio","Clark County",1,82,679,294,385
050,39,023,"Ohio","Clark County",1,83,572,237,335
050,39,023,"Ohio","Clark County",1,84,495,193,302
050,39,023,"Ohio","Clark County",1,85,3074,1108,1966
050,39,023,"Ohio","Clark County",2,0,1543,781,762
050,39,023,"Ohio","Clark County",2,1,1576,795,781
050,39,023,"Ohio","Clark County",2,2,1647,846,801
050,39,023,"Ohio","Clark County",2,3,1612,826,786
050,39,023,"Ohio","Clark County",2,4,1649,822,827
050,39,023,"Ohio","Clark County",2,5,1688,848,840
050,39,023,"Ohio","Clark County",2,6,1678,854,824
050,39,023,"Ohio","Clark County",2,7,1678,855,823
050,39,023,"Ohio","Clark County",2,8,1637,863,774
050,39,023,"Ohio","Clark County",2,9,1657,860,797
050,39,023,"Ohio","Clark County",2,10,1721,882,839
050,39,023,"Ohio","Clark County",2,11,1780,913,867
050,39,023,"Ohio","Clark County",2,12,1896,981,915
050,39,023,"Ohio","Clark County",2,13,1887,976,911
050,39,023,"Ohio","Clark County",2,14,1834,946,888
050,39,023,"Ohio","Clark County",2,15,1790,924,866
050,39,023,"Ohio","Clark County",2,16,1808,947,861
050,39,023,"Ohio","Clark County",2,17,1807,935,872
050,39,023,"Ohio","Clark County",2,18,1687,873,814
050,39,023,"Ohio","Clark County",2,19,1603,805,798
050,39,023,"Ohio","Clark County",2,20,1642,818,824
050,39,023,"Ohio","Clark County",2,21,1566,798,768
050,39,023,"Ohio","Clark County",2,22,1569,794,775
050,39,023,"Ohio","Clark County",2,23,1575,788,787
050,39,023,"Ohio","Clark County",2,24,1530,769,761
050,39,023,"Ohio","Clark County",2,25,1557,783,774
050,39,023,"Ohio","Clark County",2,26,1597,798,799
050,39,023,"Ohio","Clark County",2,27,1593,797,796
050,39,023,"Ohio","Clark County",2,28,1619,791,828
050,39,023,"Ohio","Clark County",2,29,1648,809,839
050,39,023,"Ohio","Clark County",2,30,1624,783,841
050,39,023,"Ohio","Clark County",2,31,1638,806,832
050,39,023,"Ohio","Clark County",2,32,1598,798,800
050,39,023,"Ohio","Clark County",2,33,1541,763,778
050,39,023,"Ohio","Clark County",2,34,1573,773,800
050,39,023,"Ohio","Clark County",2,35,1607,780,827
050,39,023,"Ohio","Clark County",2,36,1563,765,798
050,39,023,"Ohio","Clark County",2,37,1557,757,800
050,39,023,"Ohio","Clark County",2,38,1525,740,785
050,39,023,"Ohio","Clark County",2,39,1473,705,768
050,39,023,"Ohio","Clark County",2,40,1519,726,793
050,39,023,"Ohio","Clark County",2,41,1536,746,790
050,39,023,"Ohio","Clark County",2,42,1542,759,783
050,39,023,"Ohio","Clark County",2,43,1501,731,770
050,39,023,"Ohio","Clark County",2,44,1430,707,723
050,39,023,"Ohio","Clark County",2,45,1464,720,744
050,39,023,"Ohio","Clark County",2,46,1447,707,740
050,39,023,"Ohio","Clark County",2,47,1542,774,768
050,39,023,"Ohio","Clark County",2,48,1667,826,841
050,39,023,"Ohio","Clark County",2,49,1848,929,919
050,39,023,"Ohio","Clark County",2,50,1798,908,890
050,39,023,"Ohio","Clark County",2,51,1772,886,886
050,39,023,"Ohio","Clark County",2,52,1676,824,852
050,39,023,"Ohio","Clark County",2,53,1746,884,862
050,39,023,"Ohio","Clark County",2,54,1796,918,878
050,39,023,"Ohio","Clark County",2,55,1857,924,933
050,39,023,"Ohio","Clark County",2,56,1860,929,931
050,39,023,"Ohio","Clark County",2,57,1888,928,960
050,39,023,"Ohio","Clark County",2,58,1943,954,989
050,39,023,"Ohio","Clark County",2,59,1981,960,1021
050,39,023,"Ohio","Clark County",2,60,1923,930,993
050,39,023,"Ohio","Clark County",2,61,1890,906,984
050,39,023,"Ohio","Clark County",2,62,1906,922,984
050,39,023,"Ohio","Clark County",2,63,1883,903,980
050,39,023,"Ohio","Clark County",2,64,1812,886,926
050,39,023,"Ohio","Clark County",2,65,1780,869,911
050,39,023,"Ohio","Clark County",2,66,1759,840,919
050,39,023,"Ohio","Clark County",2,67,1763,820,943
050,39,023,"Ohio","Clark County",2,68,1734,808,926
050,39,023,"Ohio","Clark County",2,69,1630,762,868
050,39,023,"Ohio","Clark County",2,70,1539,716,823
050,39,023,"Ohio","Clark County",2,71,1543,716,827
050,39,023,"Ohio","Clark County",2,72,1515,719,796
050,39,023,"Ohio","Clark County",2,73,1587,743,844
050,39,023,"Ohio","Clark County",2,74,1049,471,578
050,39,023,"Ohio","Clark County",2,75,953,431,522
050,39,023,"Ohio","Clark County",2,76,972,442,530
050,39,023,"Ohio","Clark County",2,77,1042,487,555
050,39,023,"Ohio","Clark County",2,78,921,425,496
050,39,023,"Ohio","Clark County",2,79,817,357,460
050,39,023,"Ohio","Clark County",2,80,746,314,432
050,39,023,"Ohio","Clark County",2,81,701,307,394
050,39,023,"Ohio","Clark County",2,82,683,296,387
050,39,023,"Ohio","Clark County",2,83,584,245,339
050,39,023,"Ohio","Clark County",2,84,505,201,304
050,39,023,"Ohio","Clark County",2,85,3064,1104,1960
050,39,023,"Ohio","Clark County",3,0,1465,746,719
050,39,023,"Ohio","Clark County",3,1,1528,778,750
050,39,023,"Ohio","Clark County",3,2,1609,805,804
050,39,023,"Ohio","Clark County",3,3,1669,869,800
050,39,023,"Ohio","Clark County",3,4,1605,806,799
050,39,023,"Ohio","Clark County",3,5,1644,832,812
050,39,023,"Ohio","Clark County",3,6,1717,867,850
050,39,023,"Ohio","Clark County",3,7,1670,842,828
050,39,023,"Ohio","Clark County",3,8,1673,866,807
050,39,023,"Ohio","Clark County",3,9,1629,863,766
050,39,023,"Ohio","Clark County",3,10,1663,874,789
050,39,023,"Ohio","Clark County",3,11,1743,897,846
050,39,023,"Ohio","Clark County",3,12,1777,922,855
050,39,023,"Ohio","Clark County",3,13,1910,991,919
050,39,023,"Ohio","Clark County",3,14,1888,967,921
050,39,023,"Ohio","Clark County",3,15,1854,946,908
050,39,023,"Ohio","Clark County",3,16,1796,920,876
050,39,023,"Ohio","Clark County",3,17,1819,948,871
050,39,023,"Ohio","Clark County",3,18,1643,853,790
050,39,023,"Ohio","Clark County",3,19,1587,785,802
050,39,023,"Ohio","Clark County",3,20,1675,834,841
050,39,023,"Ohio","Clark County",3,21,1663,852,811
050,39,023,"Ohio","Clark County",3,22,1599,804,795
050,39,023,"Ohio","Clark County",3,23,1592,828,764
050,39,023,"Ohio","Clark County",3,24,1579,787,792
050,39,023,"Ohio","Clark County",3,25,1495,762,733
050,39,023,"Ohio","Clark County",3,26,1567,803,764
050,39,023,"Ohio","Clark County",3,27,1607,802,805
050,39,023,"Ohio","Clark County",3,28,1619,805,814
050,39,023,"Ohio","Clark County",3,29,1654,802,852
050,39,023,"Ohio","Clark County",3,30,1651,806,845
050,39,023,"Ohio","Clark County",3,31,1605,755,850
050,39,023,"Ohio","Clark County",3,32,1654,820,834
050,39,023,"Ohio","Clark County",3,33,1596,807,789
050,39,023,"Ohio","Clark County",3,34,1562,766,796
050,39,023,"Ohio","Clark County",3,35,1595,785,810
050,39,023,"Ohio","Clark County",3,36,1593,788,805
050,39,023,"Ohio","Clark County",3,37,1584,766,818
050,39,023,"Ohio","Clark County",3,38,1550,752,798
050,39,023,"Ohio","Clark County",3,39,1532,743,789
050,39,023,"Ohio","Clark County",3,40,1466,695,771
050,39,023,"Ohio","Clark County",3,41,1522,715,807
050,39,023,"Ohio","Clark County",3,42,1502,729,773
050,39,023,"Ohio","Clark County",3,43,1574,774,800
050,39,023,"Ohio","Clark County",3,44,1520,736,784
050,39,023,"Ohio","Clark County",3,45,1436,705,731
050,39,023,"Ohio","Clark County",3,46,1470,723,747
050,39,023,"Ohio","Clark County",3,47,1462,728,734
050,39,023,"Ohio","Clark County",3,48,1544,774,770
050,39,023,"Ohio","Clark County",3,49,1696,832,864
050,39,023,"Ohio","Clark County",3,50,1851,926,925
050,39,023,"Ohio","Clark County",3,51,1771,901,870
050,39,023,"Ohio","Clark County",3,52,1739,857,882
050,39,023,"Ohio","Clark County",3,53,1691,832,859
050,39,023,"Ohio","Clark County",3,54,1740,876,864
050,39,023,"Ohio","Clark County",3,55,1782,908,874
050,39,023,"Ohio","Clark County",3,56,1848,912,936
050,39,023,"Ohio","Clark County",3,57,1844,916,928
050,39,023,"Ohio","Clark County",3,58,1881,927,954
050,39,023,"Ohio","Clark County",3,59,1951,949,1002
050,39,023,"Ohio","Clark County",3,60,1971,960,1011
050,39,023,"Ohio","Clark County",3,61,1893,906,987
050,39,023,"Ohio","Clark County",3,62,1868,893,975
050,39,023,"Ohio","Clark County",3,63,1899,906,993
050,39,023,"Ohio","Clark County",3,64,1835,879,956
050,39,023,"Ohio","Clark County",3,65,1778,858,920
050,39,023,"Ohio","Clark County",3,66,1756,852,904
050,39,023,"Ohio","Clark County",3,67,1693,813,880
050,39,023,"Ohio","Clark County",3,68,1722,797,925
050,39,023,"Ohio","Clark County",3,69,1663,777,886
050,39,023,"Ohio","Clark County",3,70,1574,734,840
050,39,023,"Ohio","Clark County",3,71,1484,689,795
050,39,023,"Ohio","Clark County",3,72,1475,686,789
050,39,023,"Ohio","Clark County",3,73,1438,668,770
050,39,023,"Ohio","Clark County",3,74,1515,702,813
050,39,023,"Ohio","Clark County",3,75,1012,456,556
050,39,023,"Ohio","Clark County",3,76,909,408,501
050,39,023,"Ohio","Clark County",3,77,920,416,504
050,39,023,"Ohio","Clark County",3,78,965,452,513
050,39,023,"Ohio","Clark County",3,79,847,383,464
050,39,023,"Ohio","Clark County",3,80,773,332,441
050,39,023,"Ohio","Clark County",3,81,688,283,405
050,39,023,"Ohio","Clark County",3,82,665,280,385
050,39,023,"Ohio","Clark County",3,83,628,268,360
050,39,023,"Ohio","Clark County",3,84,519,217,302
050,39,023,"Ohio","Clark County",3,85,2967,1086,1881
050,39,023,"Ohio","Clark County",4,0,1529,779,750
050,39,023,"Ohio","Clark County",4,1,1489,760,729
050,39,023,"Ohio","Clark County",4,2,1518,781,737
050,39,023,"Ohio","Clark County",4,3,1626,811,815
050,39,023,"Ohio","Clark County",4,4,1719,885,834
050,39,023,"Ohio","Clark County",4,5,1611,810,801
050,39,023,"Ohio","Clark County",4,6,1651,837,814
050,39,023,"Ohio","Clark County",4,7,1701,874,827
050,39,023,"Ohio","Clark County",4,8,1675,842,833
050,39,023,"Ohio","Clark County",4,9,1676,873,803
050,39,023,"Ohio","Clark County",4,10,1632,857,775
050,39,023,"Ohio","Clark County",4,11,1656,883,773
050,39,023,"Ohio","Clark County",4,12,1732,884,848
050,39,023,"Ohio","Clark County",4,13,1754,910,844
050,39,023,"Ohio","Clark County",4,14,1911,989,922
050,39,023,"Ohio","Clark County",4,15,1885,959,926
050,39,023,"Ohio","Clark County",4,16,1861,953,908
050,39,023,"Ohio","Clark County",4,17,1783,923,860
050,39,023,"Ohio","Clark County",4,18,1642,863,779
050,39,023,"Ohio","Clark County",4,19,1497,758,739
050,39,023,"Ohio","Clark County",4,20,1593,775,818
050,39,023,"Ohio","Clark County",4,21,1592,813,779
050,39,023,"Ohio","Clark County",4,22,1634,816,818
050,39,023,"Ohio","Clark County",4,23,1551,783,768
050,39,023,"Ohio","Clark County",4,24,1602,838,764
050,39,023,"Ohio","Clark County",4,25,1576,770,806
050,39,023,"Ohio","Clark County",4,26,1473,767,706
050,39,023,"Ohio","Clark County",4,27,1584,820,764
050,39,023,"Ohio","Clark County",4,28,1572,780,792
050,39,023,"Ohio","Clark County",4,29,1620,813,807
050,39,023,"Ohio","Clark County",4,30,1670,801,869
050,39,023,"Ohio","Clark County",4,31,1626,796,830
050,39,023,"Ohio","Clark County",4,32,1621,762,859
050,39,023,"Ohio","Clark County",4,33,1629,802,827
050,39,023,"Ohio","Clark County",4,34,1596,799,797
050,39,023,"Ohio","Clark County",4,35,1557,752,805
050,39,023,"Ohio","Clark County",4,36,1601,799,802
050,39,023,"Ohio","Clark County",4,37,1609,810,799
050,39,023,"Ohio","Clark County",4,38,1582,768,814
050,39,023,"Ohio","Clark County",4,39,1551,748,803
050,39,023,"Ohio","Clark County",4,40,1530,741,789
050,39,023,"Ohio","Clark County",4,41,1466,703,763
050,39,023,"Ohio","Clark County",4,42,1518,706,812
050,39,023,"Ohio","Clark County",4,43,1495,722,773
050,39,023,"Ohio","Clark County",4,44,1571,764,807
050,39,023,"Ohio","Clark County",4,45,1509,746,763
050,39,023,"Ohio","Clark County",4,46,1422,694,728
050,39,023,"Ohio","Clark County",4,47,1471,724,747
050,39,023,"Ohio","Clark County",4,48,1433,717,716
050,39,023,"Ohio","Clark County",4,49,1559,788,771
050,39,023,"Ohio","Clark County",4,50,1677,833,844
050,39,023,"Ohio","Clark County",4,51,1827,905,922
050,39,023,"Ohio","Clark County",4,52,1754,882,872
050,39,023,"Ohio","Clark County",4,53,1729,859,870
050,39,023,"Ohio","Clark County",4,54,1676,818,858
050,39,023,"Ohio","Clark County",4,55,1722,860,862
050,39,023,"Ohio","Clark County",4,56,1760,898,862
050,39,023,"Ohio","Clark County",4,57,1830,899,931
050,39,023,"Ohio","Clark County",4,58,1819,908,911
050,39,023,"Ohio","Clark County",4,59,1883,921,962
050,39,023,"Ohio","Clark County",4,60,1934,939,995
050,39,023,"Ohio","Clark County",4,61,1934,937,997
050,39,023,"Ohio","Clark County",4,62,1857,893,964
050,39,023,"Ohio","Clark County",4,63,1872,885,987
050,39,023,"Ohio","Clark County",4,64,1839,881,958
050,39,023,"Ohio","Clark County",4,65,1790,853,937
050,39,023,"Ohio","Clark County",4,66,1744,834,910
050,39,023,"Ohio","Clark County",4,67,1714,822,892
050,39,023,"Ohio","Clark County",4,68,1646,785,861
050,39,023,"Ohio","Clark County",4,69,1642,761,881
050,39,023,"Ohio","Clark County",4,70,1628,759,869
050,39,023,"Ohio","Clark County",4,71,1532,712,820
050,39,023,"Ohio","Clark County",4,72,1445,664,781
050,39,023,"Ohio","Clark County",4,73,1423,652,771
050,39,023,"Ohio","Clark County",4,74,1377,634,743
050,39,023,"Ohio","Clark County",4,75,1460,672,788
050,39,023,"Ohio","Clark County",4,76,958,426,532
050,39,023,"Ohio","Clark County",4,77,866,384,482
050,39,023,"Ohio","Clark County",4,78,860,390,470
050,39,023,"Ohio","Clark County",4,79,916,420,496
050,39,023,"Ohio","Clark County",4,80,792,359,433
050,39,023,"Ohio","Clark County",4,81,715,300,415
050,39,023,"Ohio","Clark County",4,82,655,262,393
050,39,023,"Ohio","Clark County",4,83,616,258,358
050,39,023,"Ohio","Clark County",4,84,562,234,328
050,39,023,"Ohio","Clark County",4,85,2917,1102,1815
050,39,023,"Ohio","Clark County",5,0,1518,774,744
050,39,023,"Ohio","Clark County",5,1,1515,783,732
050,39,023,"Ohio","Clark County",5,2,1488,763,725
050,39,023,"Ohio","Clark County",5,3,1546,798,748
050,39,023,"Ohio","Clark County",5,4,1650,832,818
050,39,023,"Ohio","Clark County",5,5,1734,893,841
050,39,023,"Ohio","Clark County",5,6,1638,815,823
050,39,023,"Ohio","Clark County",5,7,1655,836,819
050,39,023,"Ohio","Clark County",5,8,1719,869,850
050,39,023,"Ohio","Clark County",5,9,1677,837,840
050,39,023,"Ohio","Clark County",5,10,1691,866,825
050,39,023,"Ohio","Clark County",5,11,1631,859,772
050,39,023,"Ohio","Clark County",5,12,1653,868,785
050,39,023,"Ohio","Clark County",5,13,1735,890,845
050,39,023,"Ohio","Clark County",5,14,1755,908,847
050,39,023,"Ohio","Clark County",5,15,1927,1006,921
050,39,023,"Ohio","Clark County",5,16,1870,977,893
050,39,023,"Ohio","Clark County",5,17,1840,942,898
050,39,023,"Ohio","Clark County",5,18,1592,836,756
050,39,023,"Ohio","Clark County",5,19,1490,750,740
050,39,023,"Ohio","Clark County",5,20,1522,767,755
050,39,023,"Ohio","Clark County",5,21,1526,759,767
050,39,023,"Ohio","Clark County",5,22,1610,810,800
050,39,023,"Ohio","Clark County",5,23,1654,839,815
050,39,023,"Ohio","Clark County",5,24,1535,808,727
050,39,023,"Ohio","Clark County",5,25,1614,846,768
050,39,023,"Ohio","Clark County",5,26,1582,759,823
050,39,023,"Ohio","Clark County",5,27,1496,772,724
050,39,023,"Ohio","Clark County",5,28,1555,802,753
050,39,023,"Ohio","Clark County",5,29,1589,791,798
050,39,023,"Ohio","Clark County",5,30,1637,812,825
050,39,023,"Ohio","Clark County",5,31,1690,819,871
050,39,023,"Ohio","Clark County",5,32,1645,796,849
050,39,023,"Ohio","Clark County",5,33,1644,781,863
050,39,023,"Ohio","Clark County",5,34,1623,786,837
050,39,023,"Ohio","Clark County",5,35,1614,799,815
050,39,023,"Ohio","Clark County",5,36,1571,768,803
050,39,023,"Ohio","Clark County",5,37,1602,788,814
050,39,023,"Ohio","Clark County",5,38,1623,808,815
050,39,023,"Ohio","Clark County",5,39,1598,772,826
050,39,023,"Ohio","Clark County",5,40,1535,741,794
050,39,023,"Ohio","Clark County",5,41,1550,759,791
050,39,023,"Ohio","Clark County",5,42,1497,714,783
050,39,023,"Ohio","Clark County",5,43,1519,710,809
050,39,023,"Ohio","Clark County",5,44,1488,721,767
050,39,023,"Ohio","Clark County",5,45,1581,777,804
050,39,023,"Ohio","Clark County",5,46,1517,743,774
050,39,023,"Ohio","Clark County",5,47,1428,700,728
050,39,023,"Ohio","Clark County",5,48,1448,720,728
050,39,023,"Ohio","Clark County",5,49,1424,702,722
050,39,023,"Ohio","Clark County",5,50,1589,810,779
050,39,023,"Ohio","Clark County",5,51,1690,851,839
050,39,023,"Ohio","Clark County",5,52,1812,894,918
050,39,023,"Ohio","Clark County",5,53,1752,893,859
050,39,023,"Ohio","Clark County",5,54,1731,864,867
050,39,023,"Ohio","Clark County",5,55,1677,809,868
050,39,023,"Ohio","Clark County",5,56,1696,838,858
050,39,023,"Ohio","Clark County",5,57,1756,900,856
050,39,023,"Ohio","Clark County",5,58,1803,883,920
050,39,023,"Ohio","Clark County",5,59,1820,905,915
050,39,023,"Ohio","Clark County",5,60,1864,912,952
050,39,023,"Ohio","Clark County",5,61,1895,911,984
050,39,023,"Ohio","Clark County",5,62,1908,921,987
050,39,023,"Ohio","Clark County",5,63,1829,883,946
050,39,023,"Ohio","Clark County",5,64,1820,857,963
050,39,023,"Ohio","Clark County",5,65,1815,859,956
050,39,023,"Ohio","Clark County",5,66,1767,836,931
050,39,023,"Ohio","Clark County",5,67,1719,817,902
050,39,023,"Ohio","Clark County",5,68,1678,801,877
050,39,023,"Ohio","Clark County",5,69,1594,759,835
050,39,023,"Ohio","Clark County",5,70,1602,737,865
050,39,023,"Ohio","Clark County",5,71,1583,734,849
050,39,023,"Ohio","Clark County",5,72,1504,690,814
050,39,023,"Ohio","Clark County",5,73,1379,622,757
050,39,023,"Ohio","Clark County",5,74,1383,632,751
050,39,023,"Ohio","Clark County",5,75,1344,617,727
050,39,023,"Ohio","Clark County",5,76,1401,639,762
050,39,023,"Ohio","Clark County",5,77,914,407,507
050,39,023,"Ohio","Clark County",5,78,805,361,444
050,39,023,"Ohio","Clark County",5,79,811,366,445
050,39,023,"Ohio","Clark County",5,80,867,396,471
050,39,023,"Ohio","Clark County",5,81,746,327,419
050,39,023,"Ohio","Clark County",5,82,684,284,400
050,39,023,"Ohio","Clark County",5,83,604,246,358
050,39,023,"Ohio","Clark County",5,84,560,229,331
050,39,023,"Ohio","Clark County",5,85,2967,1151,1816
050,39,025,"Ohio","Clermont County",1,0,2231,1140,1091
050,39,025,"Ohio","Clermont County",1,1,2262,1150,1112
050,39,025,"Ohio","Clermont County",1,2,2353,1205,1148
050,39,025,"Ohio","Clermont County",1,3,2410,1268,1142
050,39,025,"Ohio","Clermont County",1,4,2458,1280,1178
050,39,025,"Ohio","Clermont County",1,5,2452,1254,1198
050,39,025,"Ohio","Clermont County",1,6,2446,1235,1211
050,39,025,"Ohio","Clermont County",1,7,2545,1300,1245
050,39,025,"Ohio","Clermont County",1,8,2564,1313,1251
050,39,025,"Ohio","Clermont County",1,9,2661,1335,1326
050,39,025,"Ohio","Clermont County",1,10,2755,1404,1351
050,39,025,"Ohio","Clermont County",1,11,2921,1481,1440
050,39,025,"Ohio","Clermont County",1,12,2955,1501,1454
050,39,025,"Ohio","Clermont County",1,13,2946,1478,1468
050,39,025,"Ohio","Clermont County",1,14,2872,1489,1383
050,39,025,"Ohio","Clermont County",1,15,2899,1513,1386
050,39,025,"Ohio","Clermont County",1,16,2961,1552,1409
050,39,025,"Ohio","Clermont County",1,17,2853,1459,1394
050,39,025,"Ohio","Clermont County",1,18,2433,1316,1117
050,39,025,"Ohio","Clermont County",1,19,1953,1074,879
050,39,025,"Ohio","Clermont County",1,20,2083,1094,989
050,39,025,"Ohio","Clermont County",1,21,2222,1129,1093
050,39,025,"Ohio","Clermont County",1,22,2316,1160,1156
050,39,025,"Ohio","Clermont County",1,23,2385,1186,1199
050,39,025,"Ohio","Clermont County",1,24,2471,1242,1229
050,39,025,"Ohio","Clermont County",1,25,2462,1245,1217
050,39,025,"Ohio","Clermont County",1,26,2473,1249,1224
050,39,025,"Ohio","Clermont County",1,27,2579,1295,1284
050,39,025,"Ohio","Clermont County",1,28,2634,1315,1319
050,39,025,"Ohio","Clermont County",1,29,2702,1366,1336
050,39,025,"Ohio","Clermont County",1,30,2644,1328,1316
050,39,025,"Ohio","Clermont County",1,31,2590,1321,1269
050,39,025,"Ohio","Clermont County",1,32,2526,1309,1217
050,39,025,"Ohio","Clermont County",1,33,2676,1353,1323
050,39,025,"Ohio","Clermont County",1,34,2655,1375,1280
050,39,025,"Ohio","Clermont County",1,35,2691,1386,1305
050,39,025,"Ohio","Clermont County",1,36,2584,1313,1271
050,39,025,"Ohio","Clermont County",1,37,2632,1385,1247
050,39,025,"Ohio","Clermont County",1,38,2673,1374,1299
050,39,025,"Ohio","Clermont County",1,39,2733,1393,1340
050,39,025,"Ohio","Clermont County",1,40,2747,1368,1379
050,39,025,"Ohio","Clermont County",1,41,2646,1326,1320
050,39,025,"Ohio","Clermont County",1,42,2590,1290,1300
050,39,025,"Ohio","Clermont County",1,43,2442,1223,1219
050,39,025,"Ohio","Clermont County",1,44,2416,1177,1239
050,39,025,"Ohio","Clermont County",1,45,2457,1208,1249
050,39,025,"Ohio","Clermont County",1,46,2448,1200,1248
050,39,025,"Ohio","Clermont County",1,47,2476,1205,1271
050,39,025,"Ohio","Clermont County",1,48,2665,1334,1331
050,39,025,"Ohio","Clermont County",1,49,2957,1487,1470
050,39,025,"Ohio","Clermont County",1,50,2813,1397,1416
050,39,025,"Ohio","Clermont County",1,51,2818,1441,1377
050,39,025,"Ohio","Clermont County",1,52,2738,1423,1315
050,39,025,"Ohio","Clermont County",1,53,2826,1418,1408
050,39,025,"Ohio","Clermont County",1,54,2866,1417,1449
050,39,025,"Ohio","Clermont County",1,55,2949,1470,1479
050,39,025,"Ohio","Clermont County",1,56,3021,1509,1512
050,39,025,"Ohio","Clermont County",1,57,2999,1467,1532
050,39,025,"Ohio","Clermont County",1,58,3095,1564,1531
050,39,025,"Ohio","Clermont County",1,59,3139,1542,1597
050,39,025,"Ohio","Clermont County",1,60,3032,1489,1543
050,39,025,"Ohio","Clermont County",1,61,3144,1521,1623
050,39,025,"Ohio","Clermont County",1,62,3066,1496,1570
050,39,025,"Ohio","Clermont County",1,63,2958,1429,1529
050,39,025,"Ohio","Clermont County",1,64,2858,1380,1478
050,39,025,"Ohio","Clermont County",1,65,2705,1312,1393
050,39,025,"Ohio","Clermont County",1,66,2588,1228,1360
050,39,025,"Ohio","Clermont County",1,67,2448,1183,1265
050,39,025,"Ohio","Clermont County",1,68,2397,1183,1214
050,39,025,"Ohio","Clermont County",1,69,2192,1043,1149
050,39,025,"Ohio","Clermont County",1,70,2084,981,1103
050,39,025,"Ohio","Clermont County",1,71,2008,946,1062
050,39,025,"Ohio","Clermont County",1,72,2068,952,1116
050,39,025,"Ohio","Clermont County",1,73,2128,1017,1111
050,39,025,"Ohio","Clermont County",1,74,1401,660,741
050,39,025,"Ohio","Clermont County",1,75,1338,614,724
050,39,025,"Ohio","Clermont County",1,76,1322,598,724
050,39,025,"Ohio","Clermont County",1,77,1367,615,752
050,39,025,"Ohio","Clermont County",1,78,1189,525,664
050,39,025,"Ohio","Clermont County",1,79,1069,479,590
050,39,025,"Ohio","Clermont County",1,80,899,380,519
050,39,025,"Ohio","Clermont County",1,81,859,361,498
050,39,025,"Ohio","Clermont County",1,82,781,324,457
050,39,025,"Ohio","Clermont County",1,83,690,289,401
050,39,025,"Ohio","Clermont County",1,84,618,243,375
050,39,025,"Ohio","Clermont County",1,85,3617,1240,2377
050,39,025,"Ohio","Clermont County",2,0,2195,1131,1064
050,39,025,"Ohio","Clermont County",2,1,2248,1141,1107
050,39,025,"Ohio","Clermont County",2,2,2346,1200,1146
050,39,025,"Ohio","Clermont County",2,3,2390,1249,1141
050,39,025,"Ohio","Clermont County",2,4,2451,1277,1174
050,39,025,"Ohio","Clermont County",2,5,2456,1261,1195
050,39,025,"Ohio","Clermont County",2,6,2458,1244,1214
050,39,025,"Ohio","Clermont County",2,7,2524,1284,1240
050,39,025,"Ohio","Clermont County",2,8,2556,1308,1248
050,39,025,"Ohio","Clermont County",2,9,2636,1327,1309
050,39,025,"Ohio","Clermont County",2,10,2736,1390,1346
050,39,025,"Ohio","Clermont County",2,11,2871,1458,1413
050,39,025,"Ohio","Clermont County",2,12,2960,1500,1460
050,39,025,"Ohio","Clermont County",2,13,2947,1483,1464
050,39,025,"Ohio","Clermont County",2,14,2883,1483,1400
050,39,025,"Ohio","Clermont County",2,15,2892,1507,1385
050,39,025,"Ohio","Clermont County",2,16,2941,1543,1398
050,39,025,"Ohio","Clermont County",2,17,2884,1487,1397
050,39,025,"Ohio","Clermont County",2,18,2417,1302,1115
050,39,025,"Ohio","Clermont County",2,19,1967,1076,891
050,39,025,"Ohio","Clermont County",2,20,2121,1120,1001
050,39,025,"Ohio","Clermont County",2,21,2226,1139,1087
050,39,025,"Ohio","Clermont County",2,22,2329,1166,1163
050,39,025,"Ohio","Clermont County",2,23,2407,1201,1206
050,39,025,"Ohio","Clermont County",2,24,2456,1236,1220
050,39,025,"Ohio","Clermont County",2,25,2476,1251,1225
050,39,025,"Ohio","Clermont County",2,26,2492,1257,1235
050,39,025,"Ohio","Clermont County",2,27,2551,1283,1268
050,39,025,"Ohio","Clermont County",2,28,2628,1313,1315
050,39,025,"Ohio","Clermont County",2,29,2687,1348,1339
050,39,025,"Ohio","Clermont County",2,30,2684,1351,1333
050,39,025,"Ohio","Clermont County",2,31,2606,1329,1277
050,39,025,"Ohio","Clermont County",2,32,2561,1318,1243
050,39,025,"Ohio","Clermont County",2,33,2636,1341,1295
050,39,025,"Ohio","Clermont County",2,34,2659,1368,1291
050,39,025,"Ohio","Clermont County",2,35,2698,1393,1305
050,39,025,"Ohio","Clermont County",2,36,2594,1320,1274
050,39,025,"Ohio","Clermont County",2,37,2631,1373,1258
050,39,025,"Ohio","Clermont County",2,38,2676,1381,1295
050,39,025,"Ohio","Clermont County",2,39,2722,1388,1334
050,39,025,"Ohio","Clermont County",2,40,2763,1384,1379
050,39,025,"Ohio","Clermont County",2,41,2660,1333,1327
050,39,025,"Ohio","Clermont County",2,42,2585,1292,1293
050,39,025,"Ohio","Clermont County",2,43,2495,1247,1248
050,39,025,"Ohio","Clermont County",2,44,2398,1177,1221
050,39,025,"Ohio","Clermont County",2,45,2461,1207,1254
050,39,025,"Ohio","Clermont County",2,46,2443,1197,1246
050,39,025,"Ohio","Clermont County",2,47,2462,1200,1262
050,39,025,"Ohio","Clermont County",2,48,2616,1304,1312
050,39,025,"Ohio","Clermont County",2,49,2894,1454,1440
050,39,025,"Ohio","Clermont County",2,50,2847,1416,1431
050,39,025,"Ohio","Clermont County",2,51,2811,1427,1384
050,39,025,"Ohio","Clermont County",2,52,2748,1425,1323
050,39,025,"Ohio","Clermont County",2,53,2806,1418,1388
050,39,025,"Ohio","Clermont County",2,54,2843,1412,1431
050,39,025,"Ohio","Clermont County",2,55,2923,1450,1473
050,39,025,"Ohio","Clermont County",2,56,3010,1506,1504
050,39,025,"Ohio","Clermont County",2,57,3001,1479,1522
050,39,025,"Ohio","Clermont County",2,58,3057,1534,1523
050,39,025,"Ohio","Clermont County",2,59,3130,1549,1581
050,39,025,"Ohio","Clermont County",2,60,3048,1493,1555
050,39,025,"Ohio","Clermont County",2,61,3094,1502,1592
050,39,025,"Ohio","Clermont County",2,62,3073,1496,1577
050,39,025,"Ohio","Clermont County",2,63,3000,1455,1545
050,39,025,"Ohio","Clermont County",2,64,2854,1376,1478
050,39,025,"Ohio","Clermont County",2,65,2730,1317,1413
050,39,025,"Ohio","Clermont County",2,66,2616,1248,1368
050,39,025,"Ohio","Clermont County",2,67,2464,1183,1281
050,39,025,"Ohio","Clermont County",2,68,2380,1165,1215
050,39,025,"Ohio","Clermont County",2,69,2247,1078,1169
050,39,025,"Ohio","Clermont County",2,70,2096,986,1110
050,39,025,"Ohio","Clermont County",2,71,2017,950,1067
050,39,025,"Ohio","Clermont County",2,72,2013,929,1084
050,39,025,"Ohio","Clermont County",2,73,2209,1049,1160
050,39,025,"Ohio","Clermont County",2,74,1477,694,783
050,39,025,"Ohio","Clermont County",2,75,1352,627,725
050,39,025,"Ohio","Clermont County",2,76,1311,596,715
050,39,025,"Ohio","Clermont County",2,77,1378,624,754
050,39,025,"Ohio","Clermont County",2,78,1196,528,668
050,39,025,"Ohio","Clermont County",2,79,1091,484,607
050,39,025,"Ohio","Clermont County",2,80,931,402,529
050,39,025,"Ohio","Clermont County",2,81,853,359,494
050,39,025,"Ohio","Clermont County",2,82,794,334,460
050,39,025,"Ohio","Clermont County",2,83,696,293,403
050,39,025,"Ohio","Clermont County",2,84,633,252,381
050,39,025,"Ohio","Clermont County",2,85,3646,1250,2396
050,39,025,"Ohio","Clermont County",3,0,2181,1097,1084
050,39,025,"Ohio","Clermont County",3,1,2290,1182,1108
050,39,025,"Ohio","Clermont County",3,2,2343,1185,1158
050,39,025,"Ohio","Clermont County",3,3,2424,1241,1183
050,39,025,"Ohio","Clermont County",3,4,2380,1225,1155
050,39,025,"Ohio","Clermont County",3,5,2482,1311,1171
050,39,025,"Ohio","Clermont County",3,6,2519,1286,1233
050,39,025,"Ohio","Clermont County",3,7,2461,1245,1216
050,39,025,"Ohio","Clermont County",3,8,2519,1299,1220
050,39,025,"Ohio","Clermont County",3,9,2555,1308,1247
050,39,025,"Ohio","Clermont County",3,10,2668,1324,1344
050,39,025,"Ohio","Clermont County",3,11,2734,1392,1342
050,39,025,"Ohio","Clermont County",3,12,2845,1444,1401
050,39,025,"Ohio","Clermont County",3,13,2958,1500,1458
050,39,025,"Ohio","Clermont County",3,14,2950,1490,1460
050,39,025,"Ohio","Clermont County",3,15,2848,1466,1382
050,39,025,"Ohio","Clermont County",3,16,2935,1542,1393
050,39,025,"Ohio","Clermont County",3,17,2938,1529,1409
050,39,025,"Ohio","Clermont County",3,18,2444,1289,1155
050,39,025,"Ohio","Clermont County",3,19,1929,1023,906
050,39,025,"Ohio","Clermont County",3,20,2204,1190,1014
050,39,025,"Ohio","Clermont County",3,21,2282,1194,1088
050,39,025,"Ohio","Clermont County",3,22,2439,1219,1220
050,39,025,"Ohio","Clermont County",3,23,2455,1243,1212
050,39,025,"Ohio","Clermont County",3,24,2454,1219,1235
050,39,025,"Ohio","Clermont County",3,25,2510,1264,1246
050,39,025,"Ohio","Clermont County",3,26,2527,1275,1252
050,39,025,"Ohio","Clermont County",3,27,2490,1264,1226
050,39,025,"Ohio","Clermont County",3,28,2625,1304,1321
050,39,025,"Ohio","Clermont County",3,29,2686,1351,1335
050,39,025,"Ohio","Clermont County",3,30,2780,1405,1375
050,39,025,"Ohio","Clermont County",3,31,2743,1392,1351
050,39,025,"Ohio","Clermont County",3,32,2672,1346,1326
050,39,025,"Ohio","Clermont County",3,33,2593,1327,1266
050,39,025,"Ohio","Clermont County",3,34,2699,1377,1322
050,39,025,"Ohio","Clermont County",3,35,2714,1411,1303
050,39,025,"Ohio","Clermont County",3,36,2742,1407,1335
050,39,025,"Ohio","Clermont County",3,37,2598,1322,1276
050,39,025,"Ohio","Clermont County",3,38,2672,1389,1283
050,39,025,"Ohio","Clermont County",3,39,2654,1366,1288
050,39,025,"Ohio","Clermont County",3,40,2742,1404,1338
050,39,025,"Ohio","Clermont County",3,41,2789,1402,1387
050,39,025,"Ohio","Clermont County",3,42,2672,1344,1328
050,39,025,"Ohio","Clermont County",3,43,2602,1282,1320
050,39,025,"Ohio","Clermont County",3,44,2494,1251,1243
050,39,025,"Ohio","Clermont County",3,45,2397,1178,1219
050,39,025,"Ohio","Clermont County",3,46,2454,1205,1249
050,39,025,"Ohio","Clermont County",3,47,2451,1195,1256
050,39,025,"Ohio","Clermont County",3,48,2473,1207,1266
050,39,025,"Ohio","Clermont County",3,49,2601,1302,1299
050,39,025,"Ohio","Clermont County",3,50,2901,1450,1451
050,39,025,"Ohio","Clermont County",3,51,2822,1405,1417
050,39,025,"Ohio","Clermont County",3,52,2792,1429,1363
050,39,025,"Ohio","Clermont County",3,53,2709,1391,1318
050,39,025,"Ohio","Clermont County",3,54,2790,1415,1375
050,39,025,"Ohio","Clermont County",3,55,2806,1385,1421
050,39,025,"Ohio","Clermont County",3,56,2921,1448,1473
050,39,025,"Ohio","Clermont County",3,57,2996,1491,1505
050,39,025,"Ohio","Clermont County",3,58,2966,1468,1498
050,39,025,"Ohio","Clermont County",3,59,3020,1514,1506
050,39,025,"Ohio","Clermont County",3,60,3110,1535,1575
050,39,025,"Ohio","Clermont County",3,61,3035,1474,1561
050,39,025,"Ohio","Clermont County",3,62,3069,1469,1600
050,39,025,"Ohio","Clermont County",3,63,3041,1477,1564
050,39,025,"Ohio","Clermont County",3,64,2937,1436,1501
050,39,025,"Ohio","Clermont County",3,65,2824,1349,1475
050,39,025,"Ohio","Clermont County",3,66,2690,1303,1387
050,39,025,"Ohio","Clermont County",3,67,2575,1225,1350
050,39,025,"Ohio","Clermont County",3,68,2446,1175,1271
050,39,025,"Ohio","Clermont County",3,69,2318,1130,1188
050,39,025,"Ohio","Clermont County",3,70,2238,1062,1176
050,39,025,"Ohio","Clermont County",3,71,2047,957,1090
050,39,025,"Ohio","Clermont County",3,72,1973,914,1059
050,39,025,"Ohio","Clermont County",3,73,1953,892,1061
050,39,025,"Ohio","Clermont County",3,74,2139,1012,1127
050,39,025,"Ohio","Clermont County",3,75,1426,665,761
050,39,025,"Ohio","Clermont County",3,76,1309,610,699
050,39,025,"Ohio","Clermont County",3,77,1263,570,693
050,39,025,"Ohio","Clermont County",3,78,1285,570,715
050,39,025,"Ohio","Clermont County",3,79,1139,488,651
050,39,025,"Ohio","Clermont County",3,80,1027,459,568
050,39,025,"Ohio","Clermont County",3,81,876,367,509
050,39,025,"Ohio","Clermont County",3,82,777,315,462
050,39,025,"Ohio","Clermont County",3,83,714,302,412
050,39,025,"Ohio","Clermont County",3,84,660,258,402
050,39,025,"Ohio","Clermont County",3,85,3682,1262,2420
050,39,025,"Ohio","Clermont County",4,0,2194,1107,1087
050,39,025,"Ohio","Clermont County",4,1,2221,1101,1120
050,39,025,"Ohio","Clermont County",4,2,2357,1231,1126
050,39,025,"Ohio","Clermont County",4,3,2439,1248,1191
050,39,025,"Ohio","Clermont County",4,4,2465,1260,1205
050,39,025,"Ohio","Clermont County",4,5,2411,1252,1159
050,39,025,"Ohio","Clermont County",4,6,2516,1308,1208
050,39,025,"Ohio","Clermont County",4,7,2523,1288,1235
050,39,025,"Ohio","Clermont County",4,8,2474,1232,1242
050,39,025,"Ohio","Clermont County",4,9,2557,1311,1246
050,39,025,"Ohio","Clermont County",4,10,2601,1322,1279
050,39,025,"Ohio","Clermont County",4,11,2692,1335,1357
050,39,025,"Ohio","Clermont County",4,12,2754,1405,1349
050,39,025,"Ohio","Clermont County",4,13,2880,1469,1411
050,39,025,"Ohio","Clermont County",4,14,2961,1498,1463
050,39,025,"Ohio","Clermont County",4,15,2921,1469,1452
050,39,025,"Ohio","Clermont County",4,16,2862,1462,1400
050,39,025,"Ohio","Clermont County",4,17,2937,1550,1387
050,39,025,"Ohio","Clermont County",4,18,2448,1327,1121
050,39,025,"Ohio","Clermont County",4,19,1907,997,910
050,39,025,"Ohio","Clermont County",4,20,2105,1105,1000
050,39,025,"Ohio","Clermont County",4,21,2344,1235,1109
050,39,025,"Ohio","Clermont County",4,22,2455,1262,1193
050,39,025,"Ohio","Clermont County",4,23,2587,1321,1266
050,39,025,"Ohio","Clermont County",4,24,2469,1254,1215
050,39,025,"Ohio","Clermont County",4,25,2462,1204,1258
050,39,025,"Ohio","Clermont County",4,26,2495,1241,1254
050,39,025,"Ohio","Clermont County",4,27,2512,1287,1225
050,39,025,"Ohio","Clermont County",4,28,2551,1282,1269
050,39,025,"Ohio","Clermont County",4,29,2609,1299,1310
050,39,025,"Ohio","Clermont County",4,30,2746,1380,1366
050,39,025,"Ohio","Clermont County",4,31,2833,1461,1372
050,39,025,"Ohio","Clermont County",4,32,2818,1419,1399
050,39,025,"Ohio","Clermont County",4,33,2714,1371,1343
050,39,025,"Ohio","Clermont County",4,34,2669,1368,1301
050,39,025,"Ohio","Clermont County",4,35,2750,1426,1324
050,39,025,"Ohio","Clermont County",4,36,2713,1412,1301
050,39,025,"Ohio","Clermont County",4,37,2763,1409,1354
050,39,025,"Ohio","Clermont County",4,38,2619,1337,1282
050,39,025,"Ohio","Clermont County",4,39,2708,1405,1303
050,39,025,"Ohio","Clermont County",4,40,2677,1372,1305
050,39,025,"Ohio","Clermont County",4,41,2746,1420,1326
050,39,025,"Ohio","Clermont County",4,42,2793,1408,1385
050,39,025,"Ohio","Clermont County",4,43,2659,1331,1328
050,39,025,"Ohio","Clermont County",4,44,2606,1305,1301
050,39,025,"Ohio","Clermont County",4,45,2461,1243,1218
050,39,025,"Ohio","Clermont County",4,46,2407,1194,1213
050,39,025,"Ohio","Clermont County",4,47,2442,1198,1244
050,39,025,"Ohio","Clermont County",4,48,2420,1178,1242
050,39,025,"Ohio","Clermont County",4,49,2492,1230,1262
050,39,025,"Ohio","Clermont County",4,50,2559,1271,1288
050,39,025,"Ohio","Clermont County",4,51,2907,1455,1452
050,39,025,"Ohio","Clermont County",4,52,2816,1391,1425
050,39,025,"Ohio","Clermont County",4,53,2803,1428,1375
050,39,025,"Ohio","Clermont County",4,54,2718,1402,1316
050,39,025,"Ohio","Clermont County",4,55,2773,1418,1355
050,39,025,"Ohio","Clermont County",4,56,2774,1353,1421
050,39,025,"Ohio","Clermont County",4,57,2897,1429,1468
050,39,025,"Ohio","Clermont County",4,58,2953,1474,1479
050,39,025,"Ohio","Clermont County",4,59,2932,1432,1500
050,39,025,"Ohio","Clermont County",4,60,3004,1490,1514
050,39,025,"Ohio","Clermont County",4,61,3076,1511,1565
050,39,025,"Ohio","Clermont County",4,62,2981,1433,1548
050,39,025,"Ohio","Clermont County",4,63,3042,1464,1578
050,39,025,"Ohio","Clermont County",4,64,2998,1452,1546
050,39,025,"Ohio","Clermont County",4,65,2886,1410,1476
050,39,025,"Ohio","Clermont County",4,66,2800,1324,1476
050,39,025,"Ohio","Clermont County",4,67,2651,1280,1371
050,39,025,"Ohio","Clermont County",4,68,2538,1187,1351
050,39,025,"Ohio","Clermont County",4,69,2372,1142,1230
050,39,025,"Ohio","Clermont County",4,70,2290,1099,1191
050,39,025,"Ohio","Clermont County",4,71,2199,1048,1151
050,39,025,"Ohio","Clermont County",4,72,2005,920,1085
050,39,025,"Ohio","Clermont County",4,73,1919,889,1030
050,39,025,"Ohio","Clermont County",4,74,1898,864,1034
050,39,025,"Ohio","Clermont County",4,75,2090,982,1108
050,39,025,"Ohio","Clermont County",4,76,1385,639,746
050,39,025,"Ohio","Clermont County",4,77,1264,584,680
050,39,025,"Ohio","Clermont County",4,78,1207,538,669
050,39,025,"Ohio","Clermont County",4,79,1227,539,688
050,39,025,"Ohio","Clermont County",4,80,1068,459,609
050,39,025,"Ohio","Clermont County",4,81,967,426,541
050,39,025,"Ohio","Clermont County",4,82,816,335,481
050,39,025,"Ohio","Clermont County",4,83,706,286,420
050,39,025,"Ohio","Clermont County",4,84,677,274,403
050,39,025,"Ohio","Clermont County",4,85,3736,1285,2451
050,39,025,"Ohio","Clermont County",5,0,2171,1097,1074
050,39,025,"Ohio","Clermont County",5,1,2250,1133,1117
050,39,025,"Ohio","Clermont County",5,2,2255,1099,1156
050,39,025,"Ohio","Clermont County",5,3,2386,1242,1144
050,39,025,"Ohio","Clermont County",5,4,2478,1274,1204
050,39,025,"Ohio","Clermont County",5,5,2470,1262,1208
050,39,025,"Ohio","Clermont County",5,6,2437,1248,1189
050,39,025,"Ohio","Clermont County",5,7,2527,1328,1199
050,39,025,"Ohio","Clermont County",5,8,2524,1295,1229
050,39,025,"Ohio","Clermont County",5,9,2468,1230,1238
050,39,025,"Ohio","Clermont County",5,10,2594,1322,1272
050,39,025,"Ohio","Clermont County",5,11,2594,1319,1275
050,39,025,"Ohio","Clermont County",5,12,2679,1332,1347
050,39,025,"Ohio","Clermont County",5,13,2738,1401,1337
050,39,025,"Ohio","Clermont County",5,14,2868,1464,1404
050,39,025,"Ohio","Clermont County",5,15,2956,1501,1455
050,39,025,"Ohio","Clermont County",5,16,2965,1485,1480
050,39,025,"Ohio","Clermont County",5,17,2869,1479,1390
050,39,025,"Ohio","Clermont County",5,18,2414,1321,1093
050,39,025,"Ohio","Clermont County",5,19,1935,1042,893
050,39,025,"Ohio","Clermont County",5,20,2129,1103,1026
050,39,025,"Ohio","Clermont County",5,21,2300,1173,1127
050,39,025,"Ohio","Clermont County",5,22,2521,1287,1234
050,39,025,"Ohio","Clermont County",5,23,2673,1368,1305
050,39,025,"Ohio","Clermont County",5,24,2618,1365,1253
050,39,025,"Ohio","Clermont County",5,25,2516,1288,1228
050,39,025,"Ohio","Clermont County",5,26,2529,1245,1284
050,39,025,"Ohio","Clermont County",5,27,2487,1227,1260
050,39,025,"Ohio","Clermont County",5,28,2532,1298,1234
050,39,025,"Ohio","Clermont County",5,29,2578,1327,1251
050,39,025,"Ohio","Clermont County",5,30,2697,1367,1330
050,39,025,"Ohio","Clermont County",5,31,2796,1411,1385
050,39,025,"Ohio","Clermont County",5,32,2902,1472,1430
050,39,025,"Ohio","Clermont County",5,33,2821,1434,1387
050,39,025,"Ohio","Clermont County",5,34,2769,1394,1375
050,39,025,"Ohio","Clermont County",5,35,2713,1396,1317
050,39,025,"Ohio","Clermont County",5,36,2753,1431,1322
050,39,025,"Ohio","Clermont County",5,37,2785,1434,1351
050,39,025,"Ohio","Clermont County",5,38,2795,1424,1371
050,39,025,"Ohio","Clermont County",5,39,2619,1327,1292
050,39,025,"Ohio","Clermont County",5,40,2741,1407,1334
050,39,025,"Ohio","Clermont County",5,41,2677,1377,1300
050,39,025,"Ohio","Clermont County",5,42,2746,1411,1335
050,39,025,"Ohio","Clermont County",5,43,2792,1408,1384
050,39,025,"Ohio","Clermont County",5,44,2665,1341,1324
050,39,025,"Ohio","Clermont County",5,45,2609,1316,1293
050,39,025,"Ohio","Clermont County",5,46,2482,1249,1233
050,39,025,"Ohio","Clermont County",5,47,2401,1186,1215
050,39,025,"Ohio","Clermont County",5,48,2443,1200,1243
050,39,025,"Ohio","Clermont County",5,49,2419,1192,1227
050,39,025,"Ohio","Clermont County",5,50,2491,1219,1272
050,39,025,"Ohio","Clermont County",5,51,2571,1274,1297
050,39,025,"Ohio","Clermont County",5,52,2901,1458,1443
050,39,025,"Ohio","Clermont County",5,53,2797,1373,1424
050,39,025,"Ohio","Clermont County",5,54,2815,1430,1385
050,39,025,"Ohio","Clermont County",5,55,2720,1410,1310
050,39,025,"Ohio","Clermont County",5,56,2787,1413,1374
050,39,025,"Ohio","Clermont County",5,57,2785,1343,1442
050,39,025,"Ohio","Clermont County",5,58,2882,1413,1469
050,39,025,"Ohio","Clermont County",5,59,2923,1448,1475
050,39,025,"Ohio","Clermont County",5,60,2944,1441,1503
050,39,025,"Ohio","Clermont County",5,61,3007,1487,1520
050,39,025,"Ohio","Clermont County",5,62,3046,1485,1561
050,39,025,"Ohio","Clermont County",5,63,2949,1413,1536
050,39,025,"Ohio","Clermont County",5,64,2997,1440,1557
050,39,025,"Ohio","Clermont County",5,65,2934,1422,1512
050,39,025,"Ohio","Clermont County",5,66,2884,1390,1494
050,39,025,"Ohio","Clermont County",5,67,2773,1311,1462
050,39,025,"Ohio","Clermont County",5,68,2628,1273,1355
050,39,025,"Ohio","Clermont County",5,69,2501,1167,1334
050,39,025,"Ohio","Clermont County",5,70,2341,1120,1221
050,39,025,"Ohio","Clermont County",5,71,2250,1086,1164
050,39,025,"Ohio","Clermont County",5,72,2159,1024,1135
050,39,025,"Ohio","Clermont County",5,73,1938,893,1045
050,39,025,"Ohio","Clermont County",5,74,1862,853,1009
050,39,025,"Ohio","Clermont County",5,75,1873,851,1022
050,39,025,"Ohio","Clermont County",5,76,2029,957,1072
050,39,025,"Ohio","Clermont County",5,77,1351,615,736
050,39,025,"Ohio","Clermont County",5,78,1217,557,660
050,39,025,"Ohio","Clermont County",5,79,1158,503,655
050,39,025,"Ohio","Clermont County",5,80,1165,512,653
050,39,025,"Ohio","Clermont County",5,81,1012,430,582
050,39,025,"Ohio","Clermont County",5,82,915,392,523
050,39,025,"Ohio","Clermont County",5,83,749,317,432
050,39,025,"Ohio","Clermont County",5,84,667,257,410
050,39,025,"Ohio","Clermont County",5,85,3865,1341,2524
050,39,027,"Ohio","Clinton County",1,0,444,226,218
050,39,027,"Ohio","Clinton County",1,1,453,231,222
050,39,027,"Ohio","Clinton County",1,2,495,259,236
050,39,027,"Ohio","Clinton County",1,3,511,259,252
050,39,027,"Ohio","Clinton County",1,4,540,290,250
050,39,027,"Ohio","Clinton County",1,5,531,265,266
050,39,027,"Ohio","Clinton County",1,6,521,281,240
050,39,027,"Ohio","Clinton County",1,7,509,270,239
050,39,027,"Ohio","Clinton County",1,8,522,279,243
050,39,027,"Ohio","Clinton County",1,9,498,257,241
050,39,027,"Ohio","Clinton County",1,10,548,282,266
050,39,027,"Ohio","Clinton County",1,11,562,272,290
050,39,027,"Ohio","Clinton County",1,12,550,266,284
050,39,027,"Ohio","Clinton County",1,13,580,306,274
050,39,027,"Ohio","Clinton County",1,14,577,313,264
050,39,027,"Ohio","Clinton County",1,15,587,318,269
050,39,027,"Ohio","Clinton County",1,16,604,332,272
050,39,027,"Ohio","Clinton County",1,17,577,293,284
050,39,027,"Ohio","Clinton County",1,18,576,286,290
050,39,027,"Ohio","Clinton County",1,19,597,302,295
050,39,027,"Ohio","Clinton County",1,20,590,298,292
050,39,027,"Ohio","Clinton County",1,21,615,317,298
050,39,027,"Ohio","Clinton County",1,22,572,283,289
050,39,027,"Ohio","Clinton County",1,23,506,250,256
050,39,027,"Ohio","Clinton County",1,24,516,256,260
050,39,027,"Ohio","Clinton County",1,25,476,237,239
050,39,027,"Ohio","Clinton County",1,26,478,248,230
050,39,027,"Ohio","Clinton County",1,27,512,265,247
050,39,027,"Ohio","Clinton County",1,28,469,238,231
050,39,027,"Ohio","Clinton County",1,29,498,254,244
050,39,027,"Ohio","Clinton County",1,30,475,234,241
050,39,027,"Ohio","Clinton County",1,31,481,235,246
050,39,027,"Ohio","Clinton County",1,32,473,235,238
050,39,027,"Ohio","Clinton County",1,33,522,279,243
050,39,027,"Ohio","Clinton County",1,34,460,227,233
050,39,027,"Ohio","Clinton County",1,35,459,228,231
050,39,027,"Ohio","Clinton County",1,36,472,243,229
050,39,027,"Ohio","Clinton County",1,37,496,250,246
050,39,027,"Ohio","Clinton County",1,38,530,267,263
050,39,027,"Ohio","Clinton County",1,39,530,258,272
050,39,027,"Ohio","Clinton County",1,40,512,255,257
050,39,027,"Ohio","Clinton County",1,41,503,248,255
050,39,027,"Ohio","Clinton County",1,42,512,255,257
050,39,027,"Ohio","Clinton County",1,43,472,244,228
050,39,027,"Ohio","Clinton County",1,44,470,238,232
050,39,027,"Ohio","Clinton County",1,45,465,231,234
050,39,027,"Ohio","Clinton County",1,46,470,223,247
050,39,027,"Ohio","Clinton County",1,47,503,244,259
050,39,027,"Ohio","Clinton County",1,48,549,276,273
050,39,027,"Ohio","Clinton County",1,49,577,277,300
050,39,027,"Ohio","Clinton County",1,50,552,276,276
050,39,027,"Ohio","Clinton County",1,51,510,255,255
050,39,027,"Ohio","Clinton County",1,52,500,244,256
050,39,027,"Ohio","Clinton County",1,53,531,267,264
050,39,027,"Ohio","Clinton County",1,54,548,285,263
050,39,027,"Ohio","Clinton County",1,55,598,310,288
050,39,027,"Ohio","Clinton County",1,56,597,304,293
050,39,027,"Ohio","Clinton County",1,57,591,290,301
050,39,027,"Ohio","Clinton County",1,58,598,295,303
050,39,027,"Ohio","Clinton County",1,59,602,284,318
050,39,027,"Ohio","Clinton County",1,60,567,286,281
050,39,027,"Ohio","Clinton County",1,61,623,319,304
050,39,027,"Ohio","Clinton County",1,62,630,314,316
050,39,027,"Ohio","Clinton County",1,63,625,309,316
050,39,027,"Ohio","Clinton County",1,64,607,281,326
050,39,027,"Ohio","Clinton County",1,65,571,283,288
050,39,027,"Ohio","Clinton County",1,66,494,253,241
050,39,027,"Ohio","Clinton County",1,67,459,222,237
050,39,027,"Ohio","Clinton County",1,68,469,221,248
050,39,027,"Ohio","Clinton County",1,69,469,225,244
050,39,027,"Ohio","Clinton County",1,70,449,210,239
050,39,027,"Ohio","Clinton County",1,71,426,200,226
050,39,027,"Ohio","Clinton County",1,72,403,201,202
050,39,027,"Ohio","Clinton County",1,73,401,195,206
050,39,027,"Ohio","Clinton County",1,74,287,138,149
050,39,027,"Ohio","Clinton County",1,75,284,133,151
050,39,027,"Ohio","Clinton County",1,76,287,125,162
050,39,027,"Ohio","Clinton County",1,77,283,124,159
050,39,027,"Ohio","Clinton County",1,78,245,111,134
050,39,027,"Ohio","Clinton County",1,79,241,108,133
050,39,027,"Ohio","Clinton County",1,80,194,86,108
050,39,027,"Ohio","Clinton County",1,81,172,61,111
050,39,027,"Ohio","Clinton County",1,82,162,68,94
050,39,027,"Ohio","Clinton County",1,83,137,46,91
050,39,027,"Ohio","Clinton County",1,84,143,57,86
050,39,027,"Ohio","Clinton County",1,85,822,289,533
050,39,027,"Ohio","Clinton County",2,0,467,240,227
050,39,027,"Ohio","Clinton County",2,1,454,229,225
050,39,027,"Ohio","Clinton County",2,2,486,253,233
050,39,027,"Ohio","Clinton County",2,3,505,259,246
050,39,027,"Ohio","Clinton County",2,4,533,281,252
050,39,027,"Ohio","Clinton County",2,5,530,268,262
050,39,027,"Ohio","Clinton County",2,6,521,277,244
050,39,027,"Ohio","Clinton County",2,7,510,270,240
050,39,027,"Ohio","Clinton County",2,8,520,276,244
050,39,027,"Ohio","Clinton County",2,9,502,262,240
050,39,027,"Ohio","Clinton County",2,10,535,276,259
050,39,027,"Ohio","Clinton County",2,11,555,274,281
050,39,027,"Ohio","Clinton County",2,12,557,269,288
050,39,027,"Ohio","Clinton County",2,13,575,299,276
050,39,027,"Ohio","Clinton County",2,14,578,313,265
050,39,027,"Ohio","Clinton County",2,15,585,318,267
050,39,027,"Ohio","Clinton County",2,16,603,330,273
050,39,027,"Ohio","Clinton County",2,17,587,305,282
050,39,027,"Ohio","Clinton County",2,18,573,284,289
050,39,027,"Ohio","Clinton County",2,19,598,301,297
050,39,027,"Ohio","Clinton County",2,20,597,302,295
050,39,027,"Ohio","Clinton County",2,21,620,319,301
050,39,027,"Ohio","Clinton County",2,22,570,283,287
050,39,027,"Ohio","Clinton County",2,23,507,251,256
050,39,027,"Ohio","Clinton County",2,24,513,254,259
050,39,027,"Ohio","Clinton County",2,25,489,244,245
050,39,027,"Ohio","Clinton County",2,26,481,248,233
050,39,027,"Ohio","Clinton County",2,27,497,257,240
050,39,027,"Ohio","Clinton County",2,28,476,241,235
050,39,027,"Ohio","Clinton County",2,29,487,247,240
050,39,027,"Ohio","Clinton County",2,30,486,241,245
050,39,027,"Ohio","Clinton County",2,31,477,235,242
050,39,027,"Ohio","Clinton County",2,32,477,237,240
050,39,027,"Ohio","Clinton County",2,33,506,266,240
050,39,027,"Ohio","Clinton County",2,34,474,239,235
050,39,027,"Ohio","Clinton County",2,35,460,227,233
050,39,027,"Ohio","Clinton County",2,36,465,236,229
050,39,027,"Ohio","Clinton County",2,37,492,252,240
050,39,027,"Ohio","Clinton County",2,38,522,262,260
050,39,027,"Ohio","Clinton County",2,39,532,263,269
050,39,027,"Ohio","Clinton County",2,40,519,258,261
050,39,027,"Ohio","Clinton County",2,41,503,248,255
050,39,027,"Ohio","Clinton County",2,42,505,251,254
050,39,027,"Ohio","Clinton County",2,43,486,248,238
050,39,027,"Ohio","Clinton County",2,44,464,236,228
050,39,027,"Ohio","Clinton County",2,45,473,237,236
050,39,027,"Ohio","Clinton County",2,46,469,226,243
050,39,027,"Ohio","Clinton County",2,47,494,236,258
050,39,027,"Ohio","Clinton County",2,48,533,265,268
050,39,027,"Ohio","Clinton County",2,49,578,283,295
050,39,027,"Ohio","Clinton County",2,50,562,278,284
050,39,027,"Ohio","Clinton County",2,51,515,256,259
050,39,027,"Ohio","Clinton County",2,52,501,244,257
050,39,027,"Ohio","Clinton County",2,53,520,258,262
050,39,027,"Ohio","Clinton County",2,54,542,282,260
050,39,027,"Ohio","Clinton County",2,55,583,302,281
050,39,027,"Ohio","Clinton County",2,56,596,304,292
050,39,027,"Ohio","Clinton County",2,57,594,294,300
050,39,027,"Ohio","Clinton County",2,58,594,293,301
050,39,027,"Ohio","Clinton County",2,59,603,289,314
050,39,027,"Ohio","Clinton County",2,60,574,283,291
050,39,027,"Ohio","Clinton County",2,61,607,308,299
050,39,027,"Ohio","Clinton County",2,62,624,314,310
050,39,027,"Ohio","Clinton County",2,63,632,314,318
050,39,027,"Ohio","Clinton County",2,64,606,284,322
050,39,027,"Ohio","Clinton County",2,65,577,282,295
050,39,027,"Ohio","Clinton County",2,66,511,258,253
050,39,027,"Ohio","Clinton County",2,67,462,228,234
050,39,027,"Ohio","Clinton County",2,68,458,217,241
050,39,027,"Ohio","Clinton County",2,69,473,227,246
050,39,027,"Ohio","Clinton County",2,70,454,212,242
050,39,027,"Ohio","Clinton County",2,71,424,200,224
050,39,027,"Ohio","Clinton County",2,72,400,195,205
050,39,027,"Ohio","Clinton County",2,73,422,206,216
050,39,027,"Ohio","Clinton County",2,74,295,140,155
050,39,027,"Ohio","Clinton County",2,75,283,133,150
050,39,027,"Ohio","Clinton County",2,76,281,124,157
050,39,027,"Ohio","Clinton County",2,77,292,129,163
050,39,027,"Ohio","Clinton County",2,78,242,109,133
050,39,027,"Ohio","Clinton County",2,79,232,104,128
050,39,027,"Ohio","Clinton County",2,80,203,89,114
050,39,027,"Ohio","Clinton County",2,81,176,66,110
050,39,027,"Ohio","Clinton County",2,82,160,64,96
050,39,027,"Ohio","Clinton County",2,83,141,49,92
050,39,027,"Ohio","Clinton County",2,84,139,53,86
050,39,027,"Ohio","Clinton County",2,85,824,291,533
050,39,027,"Ohio","Clinton County",3,0,483,247,236
050,39,027,"Ohio","Clinton County",3,1,484,260,224
050,39,027,"Ohio","Clinton County",3,2,462,227,235
050,39,027,"Ohio","Clinton County",3,3,494,247,247
050,39,027,"Ohio","Clinton County",3,4,506,265,241
050,39,027,"Ohio","Clinton County",3,5,549,286,263
050,39,027,"Ohio","Clinton County",3,6,534,278,256
050,39,027,"Ohio","Clinton County",3,7,515,268,247
050,39,027,"Ohio","Clinton County",3,8,510,274,236
050,39,027,"Ohio","Clinton County",3,9,533,280,253
050,39,027,"Ohio","Clinton County",3,10,512,262,250
050,39,027,"Ohio","Clinton County",3,11,546,279,267
050,39,027,"Ohio","Clinton County",3,12,552,284,268
050,39,027,"Ohio","Clinton County",3,13,557,273,284
050,39,027,"Ohio","Clinton County",3,14,575,296,279
050,39,027,"Ohio","Clinton County",3,15,579,308,271
050,39,027,"Ohio","Clinton County",3,16,571,312,259
050,39,027,"Ohio","Clinton County",3,17,596,321,275
050,39,027,"Ohio","Clinton County",3,18,575,283,292
050,39,027,"Ohio","Clinton County",3,19,604,307,297
050,39,027,"Ohio","Clinton County",3,20,600,299,301
050,39,027,"Ohio","Clinton County",3,21,633,326,307
050,39,027,"Ohio","Clinton County",3,22,599,302,297
050,39,027,"Ohio","Clinton County",3,23,497,259,238
050,39,027,"Ohio","Clinton County",3,24,497,244,253
050,39,027,"Ohio","Clinton County",3,25,510,247,263
050,39,027,"Ohio","Clinton County",3,26,478,244,234
050,39,027,"Ohio","Clinton County",3,27,471,239,232
050,39,027,"Ohio","Clinton County",3,28,494,246,248
050,39,027,"Ohio","Clinton County",3,29,498,257,241
050,39,027,"Ohio","Clinton County",3,30,492,244,248
050,39,027,"Ohio","Clinton County",3,31,487,244,243
050,39,027,"Ohio","Clinton County",3,32,482,231,251
050,39,027,"Ohio","Clinton County",3,33,482,236,246
050,39,027,"Ohio","Clinton County",3,34,492,259,233
050,39,027,"Ohio","Clinton County",3,35,469,240,229
050,39,027,"Ohio","Clinton County",3,36,462,229,233
050,39,027,"Ohio","Clinton County",3,37,487,242,245
050,39,027,"Ohio","Clinton County",3,38,504,264,240
050,39,027,"Ohio","Clinton County",3,39,511,254,257
050,39,027,"Ohio","Clinton County",3,40,536,267,269
050,39,027,"Ohio","Clinton County",3,41,521,264,257
050,39,027,"Ohio","Clinton County",3,42,519,256,263
050,39,027,"Ohio","Clinton County",3,43,502,253,249
050,39,027,"Ohio","Clinton County",3,44,482,246,236
050,39,027,"Ohio","Clinton County",3,45,467,233,234
050,39,027,"Ohio","Clinton County",3,46,488,249,239
050,39,027,"Ohio","Clinton County",3,47,464,216,248
050,39,027,"Ohio","Clinton County",3,48,485,240,245
050,39,027,"Ohio","Clinton County",3,49,532,265,267
050,39,027,"Ohio","Clinton County",3,50,569,276,293
050,39,027,"Ohio","Clinton County",3,51,552,274,278
050,39,027,"Ohio","Clinton County",3,52,518,255,263
050,39,027,"Ohio","Clinton County",3,53,514,250,264
050,39,027,"Ohio","Clinton County",3,54,526,261,265
050,39,027,"Ohio","Clinton County",3,55,536,277,259
050,39,027,"Ohio","Clinton County",3,56,589,305,284
050,39,027,"Ohio","Clinton County",3,57,597,297,300
050,39,027,"Ohio","Clinton County",3,58,586,289,297
050,39,027,"Ohio","Clinton County",3,59,600,301,299
050,39,027,"Ohio","Clinton County",3,60,590,287,303
050,39,027,"Ohio","Clinton County",3,61,585,289,296
050,39,027,"Ohio","Clinton County",3,62,598,305,293
050,39,027,"Ohio","Clinton County",3,63,606,305,301
050,39,027,"Ohio","Clinton County",3,64,628,313,315
050,39,027,"Ohio","Clinton County",3,65,587,270,317
050,39,027,"Ohio","Clinton County",3,66,579,280,299
050,39,027,"Ohio","Clinton County",3,67,501,249,252
050,39,027,"Ohio","Clinton County",3,68,445,218,227
050,39,027,"Ohio","Clinton County",3,69,458,217,241
050,39,027,"Ohio","Clinton County",3,70,467,223,244
050,39,027,"Ohio","Clinton County",3,71,421,194,227
050,39,027,"Ohio","Clinton County",3,72,408,190,218
050,39,027,"Ohio","Clinton County",3,73,381,188,193
050,39,027,"Ohio","Clinton County",3,74,398,192,206
050,39,027,"Ohio","Clinton County",3,75,279,129,150
050,39,027,"Ohio","Clinton County",3,76,269,130,139
050,39,027,"Ohio","Clinton County",3,77,278,122,156
050,39,027,"Ohio","Clinton County",3,78,257,112,145
050,39,027,"Ohio","Clinton County",3,79,227,102,125
050,39,027,"Ohio","Clinton County",3,80,211,89,122
050,39,027,"Ohio","Clinton County",3,81,184,79,105
050,39,027,"Ohio","Clinton County",3,82,165,66,99
050,39,027,"Ohio","Clinton County",3,83,160,56,104
050,39,027,"Ohio","Clinton County",3,84,126,46,80
050,39,027,"Ohio","Clinton County",3,85,842,295,547
050,39,027,"Ohio","Clinton County",4,0,464,243,221
050,39,027,"Ohio","Clinton County",4,1,489,246,243
050,39,027,"Ohio","Clinton County",4,2,490,267,223
050,39,027,"Ohio","Clinton County",4,3,458,227,231
050,39,027,"Ohio","Clinton County",4,4,500,248,252
050,39,027,"Ohio","Clinton County",4,5,511,258,253
050,39,027,"Ohio","Clinton County",4,6,552,293,259
050,39,027,"Ohio","Clinton County",4,7,530,271,259
050,39,027,"Ohio","Clinton County",4,8,524,267,257
050,39,027,"Ohio","Clinton County",4,9,532,268,264
050,39,027,"Ohio","Clinton County",4,10,511,268,243
050,39,027,"Ohio","Clinton County",4,11,501,258,243
050,39,027,"Ohio","Clinton County",4,12,543,269,274
050,39,027,"Ohio","Clinton County",4,13,541,276,265
050,39,027,"Ohio","Clinton County",4,14,549,263,286
050,39,027,"Ohio","Clinton County",4,15,577,301,276
050,39,027,"Ohio","Clinton County",4,16,569,297,272
050,39,027,"Ohio","Clinton County",4,17,568,312,256
050,39,027,"Ohio","Clinton County",4,18,578,301,277
050,39,027,"Ohio","Clinton County",4,19,554,280,274
050,39,027,"Ohio","Clinton County",4,20,574,304,270
050,39,027,"Ohio","Clinton County",4,21,610,319,291
050,39,027,"Ohio","Clinton County",4,22,573,288,285
050,39,027,"Ohio","Clinton County",4,23,525,265,260
050,39,027,"Ohio","Clinton County",4,24,497,256,241
050,39,027,"Ohio","Clinton County",4,25,502,249,253
050,39,027,"Ohio","Clinton County",4,26,504,251,253
050,39,027,"Ohio","Clinton County",4,27,465,240,225
050,39,027,"Ohio","Clinton County",4,28,462,233,229
050,39,027,"Ohio","Clinton County",4,29,497,248,249
050,39,027,"Ohio","Clinton County",4,30,489,244,245
050,39,027,"Ohio","Clinton County",4,31,499,242,257
050,39,027,"Ohio","Clinton County",4,32,503,254,249
050,39,027,"Ohio","Clinton County",4,33,495,246,249
050,39,027,"Ohio","Clinton County",4,34,479,243,236
050,39,027,"Ohio","Clinton County",4,35,498,249,249
050,39,027,"Ohio","Clinton County",4,36,485,246,239
050,39,027,"Ohio","Clinton County",4,37,477,231,246
050,39,027,"Ohio","Clinton County",4,38,479,242,237
050,39,027,"Ohio","Clinton County",4,39,511,266,245
050,39,027,"Ohio","Clinton County",4,40,504,249,255
050,39,027,"Ohio","Clinton County",4,41,523,257,266
050,39,027,"Ohio","Clinton County",4,42,523,266,257
050,39,027,"Ohio","Clinton County",4,43,504,250,254
050,39,027,"Ohio","Clinton County",4,44,479,236,243
050,39,027,"Ohio","Clinton County",4,45,501,259,242
050,39,027,"Ohio","Clinton County",4,46,478,247,231
050,39,027,"Ohio","Clinton County",4,47,473,236,237
050,39,027,"Ohio","Clinton County",4,48,462,226,236
050,39,027,"Ohio","Clinton County",4,49,486,241,245
050,39,027,"Ohio","Clinton County",4,50,530,254,276
050,39,027,"Ohio","Clinton County",4,51,566,268,298
050,39,027,"Ohio","Clinton County",4,52,558,275,283
050,39,027,"Ohio","Clinton County",4,53,502,245,257
050,39,027,"Ohio","Clinton County",4,54,518,258,260
050,39,027,"Ohio","Clinton County",4,55,520,255,265
050,39,027,"Ohio","Clinton County",4,56,540,281,259
050,39,027,"Ohio","Clinton County",4,57,590,309,281
050,39,027,"Ohio","Clinton County",4,58,587,292,295
050,39,027,"Ohio","Clinton County",4,59,579,282,297
050,39,027,"Ohio","Clinton County",4,60,586,298,288
050,39,027,"Ohio","Clinton County",4,61,588,285,303
050,39,027,"Ohio","Clinton County",4,62,572,281,291
050,39,027,"Ohio","Clinton County",4,63,595,304,291
050,39,027,"Ohio","Clinton County",4,64,594,293,301
050,39,027,"Ohio","Clinton County",4,65,612,306,306
050,39,027,"Ohio","Clinton County",4,66,569,258,311
050,39,027,"Ohio","Clinton County",4,67,574,276,298
050,39,027,"Ohio","Clinton County",4,68,473,235,238
050,39,027,"Ohio","Clinton County",4,69,444,221,223
050,39,027,"Ohio","Clinton County",4,70,451,207,244
050,39,027,"Ohio","Clinton County",4,71,439,213,226
050,39,027,"Ohio","Clinton County",4,72,408,187,221
050,39,027,"Ohio","Clinton County",4,73,395,182,213
050,39,027,"Ohio","Clinton County",4,74,370,176,194
050,39,027,"Ohio","Clinton County",4,75,374,183,191
050,39,027,"Ohio","Clinton County",4,76,271,124,147
050,39,027,"Ohio","Clinton County",4,77,249,117,132
050,39,027,"Ohio","Clinton County",4,78,253,106,147
050,39,027,"Ohio","Clinton County",4,79,242,104,138
050,39,027,"Ohio","Clinton County",4,80,209,92,117
050,39,027,"Ohio","Clinton County",4,81,199,84,115
050,39,027,"Ohio","Clinton County",4,82,175,82,93
050,39,027,"Ohio","Clinton County",4,83,158,54,104
050,39,027,"Ohio","Clinton County",4,84,149,53,96
050,39,027,"Ohio","Clinton County",4,85,853,298,555
050,39,027,"Ohio","Clinton County",5,0,478,249,229
050,39,027,"Ohio","Clinton County",5,1,480,244,236
050,39,027,"Ohio","Clinton County",5,2,502,265,237
050,39,027,"Ohio","Clinton County",5,3,507,280,227
050,39,027,"Ohio","Clinton County",5,4,467,237,230
050,39,027,"Ohio","Clinton County",5,5,493,240,253
050,39,027,"Ohio","Clinton County",5,6,515,266,249
050,39,027,"Ohio","Clinton County",5,7,560,296,264
050,39,027,"Ohio","Clinton County",5,8,554,285,269
050,39,027,"Ohio","Clinton County",5,9,550,274,276
050,39,027,"Ohio","Clinton County",5,10,534,268,266
050,39,027,"Ohio","Clinton County",5,11,525,277,248
050,39,027,"Ohio","Clinton County",5,12,521,269,252
050,39,027,"Ohio","Clinton County",5,13,535,269,266
050,39,027,"Ohio","Clinton County",5,14,541,273,268
050,39,027,"Ohio","Clinton County",5,15,539,260,279
050,39,027,"Ohio","Clinton County",5,16,565,289,276
050,39,027,"Ohio","Clinton County",5,17,566,299,267
050,39,027,"Ohio","Clinton County",5,18,565,307,258
050,39,027,"Ohio","Clinton County",5,19,559,293,266
050,39,027,"Ohio","Clinton County",5,20,536,276,260
050,39,027,"Ohio","Clinton County",5,21,571,308,263
050,39,027,"Ohio","Clinton County",5,22,577,291,286
050,39,027,"Ohio","Clinton County",5,23,510,257,253
050,39,027,"Ohio","Clinton County",5,24,527,264,263
050,39,027,"Ohio","Clinton County",5,25,483,247,236
050,39,027,"Ohio","Clinton County",5,26,478,238,240
050,39,027,"Ohio","Clinton County",5,27,521,265,256
050,39,027,"Ohio","Clinton County",5,28,470,235,235
050,39,027,"Ohio","Clinton County",5,29,473,241,232
050,39,027,"Ohio","Clinton County",5,30,493,239,254
050,39,027,"Ohio","Clinton County",5,31,490,247,243
050,39,027,"Ohio","Clinton County",5,32,515,249,266
050,39,027,"Ohio","Clinton County",5,33,517,269,248
050,39,027,"Ohio","Clinton County",5,34,492,247,245
050,39,027,"Ohio","Clinton County",5,35,495,247,248
050,39,027,"Ohio","Clinton County",5,36,511,256,255
050,39,027,"Ohio","Clinton County",5,37,512,258,254
050,39,027,"Ohio","Clinton County",5,38,491,237,254
050,39,027,"Ohio","Clinton County",5,39,468,232,236
050,39,027,"Ohio","Clinton County",5,40,501,255,246
050,39,027,"Ohio","Clinton County",5,41,502,255,247
050,39,027,"Ohio","Clinton County",5,42,527,262,265
050,39,027,"Ohio","Clinton County",5,43,524,268,256
050,39,027,"Ohio","Clinton County",5,44,495,242,253
050,39,027,"Ohio","Clinton County",5,45,484,240,244
050,39,027,"Ohio","Clinton County",5,46,488,251,237
050,39,027,"Ohio","Clinton County",5,47,464,224,240
050,39,027,"Ohio","Clinton County",5,48,467,240,227
050,39,027,"Ohio","Clinton County",5,49,456,229,227
050,39,027,"Ohio","Clinton County",5,50,490,239,251
050,39,027,"Ohio","Clinton County",5,51,511,239,272
050,39,027,"Ohio","Clinton County",5,52,567,270,297
050,39,027,"Ohio","Clinton County",5,53,535,256,279
050,39,027,"Ohio","Clinton County",5,54,500,246,254
050,39,027,"Ohio","Clinton County",5,55,519,253,266
050,39,027,"Ohio","Clinton County",5,56,510,255,255
050,39,027,"Ohio","Clinton County",5,57,546,284,262
050,39,027,"Ohio","Clinton County",5,58,573,298,275
050,39,027,"Ohio","Clinton County",5,59,576,287,289
050,39,027,"Ohio","Clinton County",5,60,578,282,296
050,39,027,"Ohio","Clinton County",5,61,581,287,294
050,39,027,"Ohio","Clinton County",5,62,594,298,296
050,39,027,"Ohio","Clinton County",5,63,558,271,287
050,39,027,"Ohio","Clinton County",5,64,584,297,287
050,39,027,"Ohio","Clinton County",5,65,587,285,302
050,39,027,"Ohio","Clinton County",5,66,607,299,308
050,39,027,"Ohio","Clinton County",5,67,567,250,317
050,39,027,"Ohio","Clinton County",5,68,559,264,295
050,39,027,"Ohio","Clinton County",5,69,463,234,229
050,39,027,"Ohio","Clinton County",5,70,442,218,224
050,39,027,"Ohio","Clinton County",5,71,423,197,226
050,39,027,"Ohio","Clinton County",5,72,425,198,227
050,39,027,"Ohio","Clinton County",5,73,399,182,217
050,39,027,"Ohio","Clinton County",5,74,393,174,219
050,39,027,"Ohio","Clinton County",5,75,354,170,184
050,39,027,"Ohio","Clinton County",5,76,363,180,183
050,39,027,"Ohio","Clinton County",5,77,256,113,143
050,39,027,"Ohio","Clinton County",5,78,225,102,123
050,39,027,"Ohio","Clinton County",5,79,243,100,143
050,39,027,"Ohio","Clinton County",5,80,225,93,132
050,39,027,"Ohio","Clinton County",5,81,196,87,109
050,39,027,"Ohio","Clinton County",5,82,183,84,99
050,39,027,"Ohio","Clinton County",5,83,167,74,93
050,39,027,"Ohio","Clinton County",5,84,150,51,99
050,39,027,"Ohio","Clinton County",5,85,895,313,582
050,39,029,"Ohio","Columbiana County",1,0,969,491,478
050,39,029,"Ohio","Columbiana County",1,1,986,476,510
050,39,029,"Ohio","Columbiana County",1,2,1054,531,523
050,39,029,"Ohio","Columbiana County",1,3,1074,556,518
050,39,029,"Ohio","Columbiana County",1,4,1128,582,546
050,39,029,"Ohio","Columbiana County",1,5,1053,518,535
050,39,029,"Ohio","Columbiana County",1,6,1074,550,524
050,39,029,"Ohio","Columbiana County",1,7,1124,581,543
050,39,029,"Ohio","Columbiana County",1,8,1168,601,567
050,39,029,"Ohio","Columbiana County",1,9,1153,593,560
050,39,029,"Ohio","Columbiana County",1,10,1241,637,604
050,39,029,"Ohio","Columbiana County",1,11,1298,677,621
050,39,029,"Ohio","Columbiana County",1,12,1252,653,599
050,39,029,"Ohio","Columbiana County",1,13,1252,647,605
050,39,029,"Ohio","Columbiana County",1,14,1204,631,573
050,39,029,"Ohio","Columbiana County",1,15,1226,640,586
050,39,029,"Ohio","Columbiana County",1,16,1281,662,619
050,39,029,"Ohio","Columbiana County",1,17,1284,653,631
050,39,029,"Ohio","Columbiana County",1,18,1082,575,507
050,39,029,"Ohio","Columbiana County",1,19,878,471,407
050,39,029,"Ohio","Columbiana County",1,20,974,501,473
050,39,029,"Ohio","Columbiana County",1,21,1011,532,479
050,39,029,"Ohio","Columbiana County",1,22,1075,548,527
050,39,029,"Ohio","Columbiana County",1,23,1056,562,494
050,39,029,"Ohio","Columbiana County",1,24,1073,593,480
050,39,029,"Ohio","Columbiana County",1,25,1116,585,531
050,39,029,"Ohio","Columbiana County",1,26,1135,590,545
050,39,029,"Ohio","Columbiana County",1,27,1151,627,524
050,39,029,"Ohio","Columbiana County",1,28,1197,661,536
050,39,029,"Ohio","Columbiana County",1,29,1220,647,573
050,39,029,"Ohio","Columbiana County",1,30,1197,628,569
050,39,029,"Ohio","Columbiana County",1,31,1186,624,562
050,39,029,"Ohio","Columbiana County",1,32,1147,622,525
050,39,029,"Ohio","Columbiana County",1,33,1116,620,496
050,39,029,"Ohio","Columbiana County",1,34,1178,641,537
050,39,029,"Ohio","Columbiana County",1,35,1178,632,546
050,39,029,"Ohio","Columbiana County",1,36,1139,614,525
050,39,029,"Ohio","Columbiana County",1,37,1160,631,529
050,39,029,"Ohio","Columbiana County",1,38,1213,676,537
050,39,029,"Ohio","Columbiana County",1,39,1231,680,551
050,39,029,"Ohio","Columbiana County",1,40,1251,698,553
050,39,029,"Ohio","Columbiana County",1,41,1211,667,544
050,39,029,"Ohio","Columbiana County",1,42,1216,660,556
050,39,029,"Ohio","Columbiana County",1,43,1184,629,555
050,39,029,"Ohio","Columbiana County",1,44,1220,651,569
050,39,029,"Ohio","Columbiana County",1,45,1190,618,572
050,39,029,"Ohio","Columbiana County",1,46,1179,631,548
050,39,029,"Ohio","Columbiana County",1,47,1289,687,602
050,39,029,"Ohio","Columbiana County",1,48,1361,723,638
050,39,029,"Ohio","Columbiana County",1,49,1410,755,655
050,39,029,"Ohio","Columbiana County",1,50,1313,696,617
050,39,029,"Ohio","Columbiana County",1,51,1339,707,632
050,39,029,"Ohio","Columbiana County",1,52,1326,683,643
050,39,029,"Ohio","Columbiana County",1,53,1340,699,641
050,39,029,"Ohio","Columbiana County",1,54,1386,728,658
050,39,029,"Ohio","Columbiana County",1,55,1417,710,707
050,39,029,"Ohio","Columbiana County",1,56,1465,732,733
050,39,029,"Ohio","Columbiana County",1,57,1484,749,735
050,39,029,"Ohio","Columbiana County",1,58,1628,815,813
050,39,029,"Ohio","Columbiana County",1,59,1613,821,792
050,39,029,"Ohio","Columbiana County",1,60,1629,828,801
050,39,029,"Ohio","Columbiana County",1,61,1666,855,811
050,39,029,"Ohio","Columbiana County",1,62,1709,869,840
050,39,029,"Ohio","Columbiana County",1,63,1627,786,841
050,39,029,"Ohio","Columbiana County",1,64,1538,738,800
050,39,029,"Ohio","Columbiana County",1,65,1552,752,800
050,39,029,"Ohio","Columbiana County",1,66,1505,752,753
050,39,029,"Ohio","Columbiana County",1,67,1480,729,751
050,39,029,"Ohio","Columbiana County",1,68,1446,718,728
050,39,029,"Ohio","Columbiana County",1,69,1259,631,628
050,39,029,"Ohio","Columbiana County",1,70,1240,627,613
050,39,029,"Ohio","Columbiana County",1,71,1187,553,634
050,39,029,"Ohio","Columbiana County",1,72,1186,547,639
050,39,029,"Ohio","Columbiana County",1,73,1224,593,631
050,39,029,"Ohio","Columbiana County",1,74,789,373,416
050,39,029,"Ohio","Columbiana County",1,75,770,379,391
050,39,029,"Ohio","Columbiana County",1,76,796,392,404
050,39,029,"Ohio","Columbiana County",1,77,779,355,424
050,39,029,"Ohio","Columbiana County",1,78,685,295,390
050,39,029,"Ohio","Columbiana County",1,79,652,272,380
050,39,029,"Ohio","Columbiana County",1,80,549,228,321
050,39,029,"Ohio","Columbiana County",1,81,536,220,316
050,39,029,"Ohio","Columbiana County",1,82,497,200,297
050,39,029,"Ohio","Columbiana County",1,83,431,158,273
050,39,029,"Ohio","Columbiana County",1,84,395,153,242
050,39,029,"Ohio","Columbiana County",1,85,2396,825,1571
050,39,029,"Ohio","Columbiana County",2,0,944,474,470
050,39,029,"Ohio","Columbiana County",2,1,982,479,503
050,39,029,"Ohio","Columbiana County",2,2,1035,517,518
050,39,029,"Ohio","Columbiana County",2,3,1064,547,517
050,39,029,"Ohio","Columbiana County",2,4,1118,577,541
050,39,029,"Ohio","Columbiana County",2,5,1071,535,536
050,39,029,"Ohio","Columbiana County",2,6,1071,542,529
050,39,029,"Ohio","Columbiana County",2,7,1113,574,539
050,39,029,"Ohio","Columbiana County",2,8,1150,591,559
050,39,029,"Ohio","Columbiana County",2,9,1155,594,561
050,39,029,"Ohio","Columbiana County",2,10,1217,625,592
050,39,029,"Ohio","Columbiana County",2,11,1281,665,616
050,39,029,"Ohio","Columbiana County",2,12,1272,664,608
050,39,029,"Ohio","Columbiana County",2,13,1253,649,604
050,39,029,"Ohio","Columbiana County",2,14,1221,639,582
050,39,029,"Ohio","Columbiana County",2,15,1224,641,583
050,39,029,"Ohio","Columbiana County",2,16,1271,658,613
050,39,029,"Ohio","Columbiana County",2,17,1279,653,626
050,39,029,"Ohio","Columbiana County",2,18,1072,568,504
050,39,029,"Ohio","Columbiana County",2,19,882,471,411
050,39,029,"Ohio","Columbiana County",2,20,980,508,472
050,39,029,"Ohio","Columbiana County",2,21,1015,529,486
050,39,029,"Ohio","Columbiana County",2,22,1075,550,525
050,39,029,"Ohio","Columbiana County",2,23,1064,560,504
050,39,029,"Ohio","Columbiana County",2,24,1067,586,481
050,39,029,"Ohio","Columbiana County",2,25,1105,588,517
050,39,029,"Ohio","Columbiana County",2,26,1127,588,539
050,39,029,"Ohio","Columbiana County",2,27,1147,620,527
050,39,029,"Ohio","Columbiana County",2,28,1195,662,533
050,39,029,"Ohio","Columbiana County",2,29,1205,642,563
050,39,029,"Ohio","Columbiana County",2,30,1211,638,573
050,39,029,"Ohio","Columbiana County",2,31,1186,623,563
050,39,029,"Ohio","Columbiana County",2,32,1158,620,538
050,39,029,"Ohio","Columbiana County",2,33,1122,618,504
050,39,029,"Ohio","Columbiana County",2,34,1162,635,527
050,39,029,"Ohio","Columbiana County",2,35,1184,639,545
050,39,029,"Ohio","Columbiana County",2,36,1140,615,525
050,39,029,"Ohio","Columbiana County",2,37,1159,628,531
050,39,029,"Ohio","Columbiana County",2,38,1211,674,537
050,39,029,"Ohio","Columbiana County",2,39,1218,672,546
050,39,029,"Ohio","Columbiana County",2,40,1250,695,555
050,39,029,"Ohio","Columbiana County",2,41,1217,670,547
050,39,029,"Ohio","Columbiana County",2,42,1206,656,550
050,39,029,"Ohio","Columbiana County",2,43,1199,638,561
050,39,029,"Ohio","Columbiana County",2,44,1194,635,559
050,39,029,"Ohio","Columbiana County",2,45,1203,629,574
050,39,029,"Ohio","Columbiana County",2,46,1175,623,552
050,39,029,"Ohio","Columbiana County",2,47,1262,676,586
050,39,029,"Ohio","Columbiana County",2,48,1338,710,628
050,39,029,"Ohio","Columbiana County",2,49,1404,752,652
050,39,029,"Ohio","Columbiana County",2,50,1334,708,626
050,39,029,"Ohio","Columbiana County",2,51,1328,702,626
050,39,029,"Ohio","Columbiana County",2,52,1315,679,636
050,39,029,"Ohio","Columbiana County",2,53,1337,697,640
050,39,029,"Ohio","Columbiana County",2,54,1375,722,653
050,39,029,"Ohio","Columbiana County",2,55,1401,707,694
050,39,029,"Ohio","Columbiana County",2,56,1449,723,726
050,39,029,"Ohio","Columbiana County",2,57,1479,745,734
050,39,029,"Ohio","Columbiana County",2,58,1597,802,795
050,39,029,"Ohio","Columbiana County",2,59,1617,820,797
050,39,029,"Ohio","Columbiana County",2,60,1613,819,794
050,39,029,"Ohio","Columbiana County",2,61,1644,842,802
050,39,029,"Ohio","Columbiana County",2,62,1690,860,830
050,39,029,"Ohio","Columbiana County",2,63,1647,799,848
050,39,029,"Ohio","Columbiana County",2,64,1542,738,804
050,39,029,"Ohio","Columbiana County",2,65,1542,744,798
050,39,029,"Ohio","Columbiana County",2,66,1517,752,765
050,39,029,"Ohio","Columbiana County",2,67,1480,731,749
050,39,029,"Ohio","Columbiana County",2,68,1435,710,725
050,39,029,"Ohio","Columbiana County",2,69,1305,652,653
050,39,029,"Ohio","Columbiana County",2,70,1237,621,616
050,39,029,"Ohio","Columbiana County",2,71,1188,566,622
050,39,029,"Ohio","Columbiana County",2,72,1159,535,624
050,39,029,"Ohio","Columbiana County",2,73,1260,600,660
050,39,029,"Ohio","Columbiana County",2,74,828,392,436
050,39,029,"Ohio","Columbiana County",2,75,774,378,396
050,39,029,"Ohio","Columbiana County",2,76,768,378,390
050,39,029,"Ohio","Columbiana County",2,77,794,368,426
050,39,029,"Ohio","Columbiana County",2,78,692,304,388
050,39,029,"Ohio","Columbiana County",2,79,651,272,379
050,39,029,"Ohio","Columbiana County",2,80,559,228,331
050,39,029,"Ohio","Columbiana County",2,81,526,218,308
050,39,029,"Ohio","Columbiana County",2,82,497,201,296
050,39,029,"Ohio","Columbiana County",2,83,437,164,273
050,39,029,"Ohio","Columbiana County",2,84,396,153,243
050,39,029,"Ohio","Columbiana County",2,85,2375,811,1564
050,39,029,"Ohio","Columbiana County",3,0,1011,514,497
050,39,029,"Ohio","Columbiana County",3,1,980,496,484
050,39,029,"Ohio","Columbiana County",3,2,1005,505,500
050,39,029,"Ohio","Columbiana County",3,3,1016,502,514
050,39,029,"Ohio","Columbiana County",3,4,1070,559,511
050,39,029,"Ohio","Columbiana County",3,5,1131,583,548
050,39,029,"Ohio","Columbiana County",3,6,1081,547,534
050,39,029,"Ohio","Columbiana County",3,7,1099,565,534
050,39,029,"Ohio","Columbiana County",3,8,1127,585,542
050,39,029,"Ohio","Columbiana County",3,9,1165,599,566
050,39,029,"Ohio","Columbiana County",3,10,1159,598,561
050,39,029,"Ohio","Columbiana County",3,11,1229,626,603
050,39,029,"Ohio","Columbiana County",3,12,1289,669,620
050,39,029,"Ohio","Columbiana County",3,13,1267,668,599
050,39,029,"Ohio","Columbiana County",3,14,1257,652,605
050,39,029,"Ohio","Columbiana County",3,15,1223,643,580
050,39,029,"Ohio","Columbiana County",3,16,1221,623,598
050,39,029,"Ohio","Columbiana County",3,17,1288,671,617
050,39,029,"Ohio","Columbiana County",3,18,1087,569,518
050,39,029,"Ohio","Columbiana County",3,19,873,474,399
050,39,029,"Ohio","Columbiana County",3,20,961,502,459
050,39,029,"Ohio","Columbiana County",3,21,1029,528,501
050,39,029,"Ohio","Columbiana County",3,22,1092,562,530
050,39,029,"Ohio","Columbiana County",3,23,1100,586,514
050,39,029,"Ohio","Columbiana County",3,24,1069,566,503
050,39,029,"Ohio","Columbiana County",3,25,1096,595,501
050,39,029,"Ohio","Columbiana County",3,26,1097,600,497
050,39,029,"Ohio","Columbiana County",3,27,1142,604,538
050,39,029,"Ohio","Columbiana County",3,28,1188,645,543
050,39,029,"Ohio","Columbiana County",3,29,1189,643,546
050,39,029,"Ohio","Columbiana County",3,30,1229,669,560
050,39,029,"Ohio","Columbiana County",3,31,1198,619,579
050,39,029,"Ohio","Columbiana County",3,32,1188,619,569
050,39,029,"Ohio","Columbiana County",3,33,1159,606,553
050,39,029,"Ohio","Columbiana County",3,34,1111,620,491
050,39,029,"Ohio","Columbiana County",3,35,1174,655,519
050,39,029,"Ohio","Columbiana County",3,36,1186,641,545
050,39,029,"Ohio","Columbiana County",3,37,1158,627,531
050,39,029,"Ohio","Columbiana County",3,38,1205,667,538
050,39,029,"Ohio","Columbiana County",3,39,1195,651,544
050,39,029,"Ohio","Columbiana County",3,40,1233,673,560
050,39,029,"Ohio","Columbiana County",3,41,1224,680,544
050,39,029,"Ohio","Columbiana County",3,42,1196,662,534
050,39,029,"Ohio","Columbiana County",3,43,1183,641,542
050,39,029,"Ohio","Columbiana County",3,44,1197,638,559
050,39,029,"Ohio","Columbiana County",3,45,1199,644,555
050,39,029,"Ohio","Columbiana County",3,46,1192,618,574
050,39,029,"Ohio","Columbiana County",3,47,1172,618,554
050,39,029,"Ohio","Columbiana County",3,48,1238,658,580
050,39,029,"Ohio","Columbiana County",3,49,1352,732,620
050,39,029,"Ohio","Columbiana County",3,50,1356,715,641
050,39,029,"Ohio","Columbiana County",3,51,1364,726,638
050,39,029,"Ohio","Columbiana County",3,52,1314,689,625
050,39,029,"Ohio","Columbiana County",3,53,1326,689,637
050,39,029,"Ohio","Columbiana County",3,54,1348,711,637
050,39,029,"Ohio","Columbiana County",3,55,1360,699,661
050,39,029,"Ohio","Columbiana County",3,56,1378,694,684
050,39,029,"Ohio","Columbiana County",3,57,1425,713,712
050,39,029,"Ohio","Columbiana County",3,58,1504,760,744
050,39,029,"Ohio","Columbiana County",3,59,1565,781,784
050,39,029,"Ohio","Columbiana County",3,60,1614,812,802
050,39,029,"Ohio","Columbiana County",3,61,1598,809,789
050,39,029,"Ohio","Columbiana County",3,62,1634,839,795
050,39,029,"Ohio","Columbiana County",3,63,1642,822,820
050,39,029,"Ohio","Columbiana County",3,64,1618,767,851
050,39,029,"Ohio","Columbiana County",3,65,1501,720,781
050,39,029,"Ohio","Columbiana County",3,66,1527,743,784
050,39,029,"Ohio","Columbiana County",3,67,1485,737,748
050,39,029,"Ohio","Columbiana County",3,68,1447,704,743
050,39,029,"Ohio","Columbiana County",3,69,1379,680,699
050,39,029,"Ohio","Columbiana County",3,70,1284,630,654
050,39,029,"Ohio","Columbiana County",3,71,1207,601,606
050,39,029,"Ohio","Columbiana County",3,72,1155,552,603
050,39,029,"Ohio","Columbiana County",3,73,1109,512,597
050,39,029,"Ohio","Columbiana County",3,74,1216,576,640
050,39,029,"Ohio","Columbiana County",3,75,797,371,426
050,39,029,"Ohio","Columbiana County",3,76,737,356,381
050,39,029,"Ohio","Columbiana County",3,77,712,345,367
050,39,029,"Ohio","Columbiana County",3,78,750,349,401
050,39,029,"Ohio","Columbiana County",3,79,669,294,375
050,39,029,"Ohio","Columbiana County",3,80,591,240,351
050,39,029,"Ohio","Columbiana County",3,81,526,213,313
050,39,029,"Ohio","Columbiana County",3,82,491,204,287
050,39,029,"Ohio","Columbiana County",3,83,460,177,283
050,39,029,"Ohio","Columbiana County",3,84,409,156,253
050,39,029,"Ohio","Columbiana County",3,85,2324,767,1557
050,39,029,"Ohio","Columbiana County",4,0,964,494,470
050,39,029,"Ohio","Columbiana County",4,1,1005,520,485
050,39,029,"Ohio","Columbiana County",4,2,994,495,499
050,39,029,"Ohio","Columbiana County",4,3,1020,518,502
050,39,029,"Ohio","Columbiana County",4,4,1013,509,504
050,39,029,"Ohio","Columbiana County",4,5,1068,557,511
050,39,029,"Ohio","Columbiana County",4,6,1122,578,544
050,39,029,"Ohio","Columbiana County",4,7,1076,548,528
050,39,029,"Ohio","Columbiana County",4,8,1099,555,544
050,39,029,"Ohio","Columbiana County",4,9,1157,593,564
050,39,029,"Ohio","Columbiana County",4,10,1165,606,559
050,39,029,"Ohio","Columbiana County",4,11,1158,602,556
050,39,029,"Ohio","Columbiana County",4,12,1238,637,601
050,39,029,"Ohio","Columbiana County",4,13,1286,671,615
050,39,029,"Ohio","Columbiana County",4,14,1265,666,599
050,39,029,"Ohio","Columbiana County",4,15,1259,656,603
050,39,029,"Ohio","Columbiana County",4,16,1229,638,591
050,39,029,"Ohio","Columbiana County",4,17,1219,629,590
050,39,029,"Ohio","Columbiana County",4,18,1068,573,495
050,39,029,"Ohio","Columbiana County",4,19,830,440,390
050,39,029,"Ohio","Columbiana County",4,20,906,479,427
050,39,029,"Ohio","Columbiana County",4,21,1013,531,482
050,39,029,"Ohio","Columbiana County",4,22,1083,547,536
050,39,029,"Ohio","Columbiana County",4,23,1144,601,543
050,39,029,"Ohio","Columbiana County",4,24,1100,595,505
050,39,029,"Ohio","Columbiana County",4,25,1065,564,501
050,39,029,"Ohio","Columbiana County",4,26,1071,589,482
050,39,029,"Ohio","Columbiana County",4,27,1105,613,492
050,39,029,"Ohio","Columbiana County",4,28,1162,624,538
050,39,029,"Ohio","Columbiana County",4,29,1179,619,560
050,39,029,"Ohio","Columbiana County",4,30,1220,674,546
050,39,029,"Ohio","Columbiana County",4,31,1229,663,566
050,39,029,"Ohio","Columbiana County",4,32,1205,623,582
050,39,029,"Ohio","Columbiana County",4,33,1176,603,573
050,39,029,"Ohio","Columbiana County",4,34,1192,636,556
050,39,029,"Ohio","Columbiana County",4,35,1148,633,515
050,39,029,"Ohio","Columbiana County",4,36,1185,655,530
050,39,029,"Ohio","Columbiana County",4,37,1184,641,543
050,39,029,"Ohio","Columbiana County",4,38,1198,662,536
050,39,029,"Ohio","Columbiana County",4,39,1200,646,554
050,39,029,"Ohio","Columbiana County",4,40,1178,636,542
050,39,029,"Ohio","Columbiana County",4,41,1214,667,547
050,39,029,"Ohio","Columbiana County",4,42,1233,684,549
050,39,029,"Ohio","Columbiana County",4,43,1164,639,525
050,39,029,"Ohio","Columbiana County",4,44,1175,632,543
050,39,029,"Ohio","Columbiana County",4,45,1185,631,554
050,39,029,"Ohio","Columbiana County",4,46,1185,631,554
050,39,029,"Ohio","Columbiana County",4,47,1202,632,570
050,39,029,"Ohio","Columbiana County",4,48,1172,605,567
050,39,029,"Ohio","Columbiana County",4,49,1264,674,590
050,39,029,"Ohio","Columbiana County",4,50,1311,703,608
050,39,029,"Ohio","Columbiana County",4,51,1362,727,635
050,39,029,"Ohio","Columbiana County",4,52,1339,699,640
050,39,029,"Ohio","Columbiana County",4,53,1317,697,620
050,39,029,"Ohio","Columbiana County",4,54,1334,698,636
050,39,029,"Ohio","Columbiana County",4,55,1314,683,631
050,39,029,"Ohio","Columbiana County",4,56,1357,695,662
050,39,029,"Ohio","Columbiana County",4,57,1354,676,678
050,39,029,"Ohio","Columbiana County",4,58,1434,726,708
050,39,029,"Ohio","Columbiana County",4,59,1484,747,737
050,39,029,"Ohio","Columbiana County",4,60,1547,773,774
050,39,029,"Ohio","Columbiana County",4,61,1589,802,787
050,39,029,"Ohio","Columbiana County",4,62,1591,809,782
050,39,029,"Ohio","Columbiana County",4,63,1572,790,782
050,39,029,"Ohio","Columbiana County",4,64,1610,801,809
050,39,029,"Ohio","Columbiana County",4,65,1554,737,817
050,39,029,"Ohio","Columbiana County",4,66,1478,715,763
050,39,029,"Ohio","Columbiana County",4,67,1492,728,764
050,39,029,"Ohio","Columbiana County",4,68,1434,696,738
050,39,029,"Ohio","Columbiana County",4,69,1404,686,718
050,39,029,"Ohio","Columbiana County",4,70,1350,656,694
050,39,029,"Ohio","Columbiana County",4,71,1243,602,641
050,39,029,"Ohio","Columbiana County",4,72,1174,588,586
050,39,029,"Ohio","Columbiana County",4,73,1089,510,579
050,39,029,"Ohio","Columbiana County",4,74,1062,485,577
050,39,029,"Ohio","Columbiana County",4,75,1157,539,618
050,39,029,"Ohio","Columbiana County",4,76,762,350,412
050,39,029,"Ohio","Columbiana County",4,77,692,330,362
050,39,029,"Ohio","Columbiana County",4,78,671,328,343
050,39,029,"Ohio","Columbiana County",4,79,724,335,389
050,39,029,"Ohio","Columbiana County",4,80,612,263,349
050,39,029,"Ohio","Columbiana County",4,81,549,218,331
050,39,029,"Ohio","Columbiana County",4,82,493,196,297
050,39,029,"Ohio","Columbiana County",4,83,446,178,268
050,39,029,"Ohio","Columbiana County",4,84,422,161,261
050,39,029,"Ohio","Columbiana County",4,85,2274,752,1522
050,39,029,"Ohio","Columbiana County",5,0,951,488,463
050,39,029,"Ohio","Columbiana County",5,1,977,510,467
050,39,029,"Ohio","Columbiana County",5,2,992,511,481
050,39,029,"Ohio","Columbiana County",5,3,1013,511,502
050,39,029,"Ohio","Columbiana County",5,4,1042,531,511
050,39,029,"Ohio","Columbiana County",5,5,1031,513,518
050,39,029,"Ohio","Columbiana County",5,6,1072,562,510
050,39,029,"Ohio","Columbiana County",5,7,1133,585,548
050,39,029,"Ohio","Columbiana County",5,8,1079,553,526
050,39,029,"Ohio","Columbiana County",5,9,1100,553,547
050,39,029,"Ohio","Columbiana County",5,10,1140,585,555
050,39,029,"Ohio","Columbiana County",5,11,1180,612,568
050,39,029,"Ohio","Columbiana County",5,12,1160,599,561
050,39,029,"Ohio","Columbiana County",5,13,1240,643,597
050,39,029,"Ohio","Columbiana County",5,14,1291,673,618
050,39,029,"Ohio","Columbiana County",5,15,1266,666,600
050,39,029,"Ohio","Columbiana County",5,16,1255,667,588
050,39,029,"Ohio","Columbiana County",5,17,1205,623,582
050,39,029,"Ohio","Columbiana County",5,18,1004,537,467
050,39,029,"Ohio","Columbiana County",5,19,829,450,379
050,39,029,"Ohio","Columbiana County",5,20,897,470,427
050,39,029,"Ohio","Columbiana County",5,21,968,512,456
050,39,029,"Ohio","Columbiana County",5,22,1083,575,508
050,39,029,"Ohio","Columbiana County",5,23,1143,591,552
050,39,029,"Ohio","Columbiana County",5,24,1163,624,539
050,39,029,"Ohio","Columbiana County",5,25,1114,595,519
050,39,029,"Ohio","Columbiana County",5,26,1031,555,476
050,39,029,"Ohio","Columbiana County",5,27,1080,598,482
050,39,029,"Ohio","Columbiana County",5,28,1130,637,493
050,39,029,"Ohio","Columbiana County",5,29,1131,590,541
050,39,029,"Ohio","Columbiana County",5,30,1198,636,562
050,39,029,"Ohio","Columbiana County",5,31,1222,675,547
050,39,029,"Ohio","Columbiana County",5,32,1228,666,562
050,39,029,"Ohio","Columbiana County",5,33,1195,611,584
050,39,029,"Ohio","Columbiana County",5,34,1158,600,558
050,39,029,"Ohio","Columbiana County",5,35,1215,655,560
050,39,029,"Ohio","Columbiana County",5,36,1154,643,511
050,39,029,"Ohio","Columbiana County",5,37,1192,651,541
050,39,029,"Ohio","Columbiana County",5,38,1204,662,542
050,39,029,"Ohio","Columbiana County",5,39,1183,646,537
050,39,029,"Ohio","Columbiana County",5,40,1176,635,541
050,39,029,"Ohio","Columbiana County",5,41,1173,628,545
050,39,029,"Ohio","Columbiana County",5,42,1214,673,541
050,39,029,"Ohio","Columbiana County",5,43,1216,674,542
050,39,029,"Ohio","Columbiana County",5,44,1151,622,529
050,39,029,"Ohio","Columbiana County",5,45,1181,636,545
050,39,029,"Ohio","Columbiana County",5,46,1172,612,560
050,39,029,"Ohio","Columbiana County",5,47,1194,640,554
050,39,029,"Ohio","Columbiana County",5,48,1215,631,584
050,39,029,"Ohio","Columbiana County",5,49,1177,614,563
050,39,029,"Ohio","Columbiana County",5,50,1243,650,593
050,39,029,"Ohio","Columbiana County",5,51,1318,714,604
050,39,029,"Ohio","Columbiana County",5,52,1335,707,628
050,39,029,"Ohio","Columbiana County",5,53,1335,703,632
050,39,029,"Ohio","Columbiana County",5,54,1327,699,628
050,39,029,"Ohio","Columbiana County",5,55,1312,672,640
050,39,029,"Ohio","Columbiana County",5,56,1313,678,635
050,39,029,"Ohio","Columbiana County",5,57,1354,689,665
050,39,029,"Ohio","Columbiana County",5,58,1369,687,682
050,39,029,"Ohio","Columbiana County",5,59,1425,717,708
050,39,029,"Ohio","Columbiana County",5,60,1477,745,732
050,39,029,"Ohio","Columbiana County",5,61,1520,760,760
050,39,029,"Ohio","Columbiana County",5,62,1589,807,782
050,39,029,"Ohio","Columbiana County",5,63,1537,768,769
050,39,029,"Ohio","Columbiana County",5,64,1554,774,780
050,39,029,"Ohio","Columbiana County",5,65,1581,781,800
050,39,029,"Ohio","Columbiana County",5,66,1540,725,815
050,39,029,"Ohio","Columbiana County",5,67,1474,712,762
050,39,029,"Ohio","Columbiana County",5,68,1453,698,755
050,39,029,"Ohio","Columbiana County",5,69,1399,679,720
050,39,029,"Ohio","Columbiana County",5,70,1387,675,712
050,39,029,"Ohio","Columbiana County",5,71,1314,629,685
050,39,029,"Ohio","Columbiana County",5,72,1213,589,624
050,39,029,"Ohio","Columbiana County",5,73,1132,560,572
050,39,029,"Ohio","Columbiana County",5,74,1054,485,569
050,39,029,"Ohio","Columbiana County",5,75,1017,459,558
050,39,029,"Ohio","Columbiana County",5,76,1120,516,604
050,39,029,"Ohio","Columbiana County",5,77,715,323,392
050,39,029,"Ohio","Columbiana County",5,78,659,319,340
050,39,029,"Ohio","Columbiana County",5,79,643,315,328
050,39,029,"Ohio","Columbiana County",5,80,665,304,361
050,39,029,"Ohio","Columbiana County",5,81,578,250,328
050,39,029,"Ohio","Columbiana County",5,82,518,199,319
050,39,029,"Ohio","Columbiana County",5,83,461,176,285
050,39,029,"Ohio","Columbiana County",5,84,417,169,248
050,39,029,"Ohio","Columbiana County",5,85,2316,774,1542
050,39,031,"Ohio","Coshocton County",1,0,441,229,212
050,39,031,"Ohio","Coshocton County",1,1,435,227,208
050,39,031,"Ohio","Coshocton County",1,2,476,245,231
050,39,031,"Ohio","Coshocton County",1,3,502,263,239
050,39,031,"Ohio","Coshocton County",1,4,510,288,222
050,39,031,"Ohio","Coshocton County",1,5,485,260,225
050,39,031,"Ohio","Coshocton County",1,6,472,229,243
050,39,031,"Ohio","Coshocton County",1,7,504,263,241
050,39,031,"Ohio","Coshocton County",1,8,487,240,247
050,39,031,"Ohio","Coshocton County",1,9,480,234,246
050,39,031,"Ohio","Coshocton County",1,10,496,275,221
050,39,031,"Ohio","Coshocton County",1,11,487,261,226
050,39,031,"Ohio","Coshocton County",1,12,491,251,240
050,39,031,"Ohio","Coshocton County",1,13,516,257,259
050,39,031,"Ohio","Coshocton County",1,14,516,263,253
050,39,031,"Ohio","Coshocton County",1,15,524,282,242
050,39,031,"Ohio","Coshocton County",1,16,526,280,246
050,39,031,"Ohio","Coshocton County",1,17,512,263,249
050,39,031,"Ohio","Coshocton County",1,18,436,240,196
050,39,031,"Ohio","Coshocton County",1,19,321,176,145
050,39,031,"Ohio","Coshocton County",1,20,364,185,179
050,39,031,"Ohio","Coshocton County",1,21,360,190,170
050,39,031,"Ohio","Coshocton County",1,22,382,193,189
050,39,031,"Ohio","Coshocton County",1,23,401,203,198
050,39,031,"Ohio","Coshocton County",1,24,376,185,191
050,39,031,"Ohio","Coshocton County",1,25,376,185,191
050,39,031,"Ohio","Coshocton County",1,26,423,209,214
050,39,031,"Ohio","Coshocton County",1,27,425,208,217
050,39,031,"Ohio","Coshocton County",1,28,439,215,224
050,39,031,"Ohio","Coshocton County",1,29,441,223,218
050,39,031,"Ohio","Coshocton County",1,30,423,198,225
050,39,031,"Ohio","Coshocton County",1,31,425,199,226
050,39,031,"Ohio","Coshocton County",1,32,415,194,221
050,39,031,"Ohio","Coshocton County",1,33,412,200,212
050,39,031,"Ohio","Coshocton County",1,34,405,214,191
050,39,031,"Ohio","Coshocton County",1,35,404,206,198
050,39,031,"Ohio","Coshocton County",1,36,405,207,198
050,39,031,"Ohio","Coshocton County",1,37,442,238,204
050,39,031,"Ohio","Coshocton County",1,38,455,232,223
050,39,031,"Ohio","Coshocton County",1,39,453,229,224
050,39,031,"Ohio","Coshocton County",1,40,454,227,227
050,39,031,"Ohio","Coshocton County",1,41,399,190,209
050,39,031,"Ohio","Coshocton County",1,42,381,190,191
050,39,031,"Ohio","Coshocton County",1,43,378,191,187
050,39,031,"Ohio","Coshocton County",1,44,371,178,193
050,39,031,"Ohio","Coshocton County",1,45,381,191,190
050,39,031,"Ohio","Coshocton County",1,46,407,217,190
050,39,031,"Ohio","Coshocton County",1,47,448,231,217
050,39,031,"Ohio","Coshocton County",1,48,465,242,223
050,39,031,"Ohio","Coshocton County",1,49,464,225,239
050,39,031,"Ohio","Coshocton County",1,50,466,231,235
050,39,031,"Ohio","Coshocton County",1,51,453,229,224
050,39,031,"Ohio","Coshocton County",1,52,462,239,223
050,39,031,"Ohio","Coshocton County",1,53,456,239,217
050,39,031,"Ohio","Coshocton County",1,54,463,244,219
050,39,031,"Ohio","Coshocton County",1,55,496,257,239
050,39,031,"Ohio","Coshocton County",1,56,522,252,270
050,39,031,"Ohio","Coshocton County",1,57,513,259,254
050,39,031,"Ohio","Coshocton County",1,58,517,259,258
050,39,031,"Ohio","Coshocton County",1,59,529,254,275
050,39,031,"Ohio","Coshocton County",1,60,501,260,241
050,39,031,"Ohio","Coshocton County",1,61,546,275,271
050,39,031,"Ohio","Coshocton County",1,62,580,278,302
050,39,031,"Ohio","Coshocton County",1,63,510,254,256
050,39,031,"Ohio","Coshocton County",1,64,502,257,245
050,39,031,"Ohio","Coshocton County",1,65,509,251,258
050,39,031,"Ohio","Coshocton County",1,66,486,241,245
050,39,031,"Ohio","Coshocton County",1,67,478,246,232
050,39,031,"Ohio","Coshocton County",1,68,461,227,234
050,39,031,"Ohio","Coshocton County",1,69,412,210,202
050,39,031,"Ohio","Coshocton County",1,70,398,190,208
050,39,031,"Ohio","Coshocton County",1,71,400,182,218
050,39,031,"Ohio","Coshocton County",1,72,409,200,209
050,39,031,"Ohio","Coshocton County",1,73,406,208,198
050,39,031,"Ohio","Coshocton County",1,74,265,122,143
050,39,031,"Ohio","Coshocton County",1,75,263,121,142
050,39,031,"Ohio","Coshocton County",1,76,247,120,127
050,39,031,"Ohio","Coshocton County",1,77,251,112,139
050,39,031,"Ohio","Coshocton County",1,78,249,102,147
050,39,031,"Ohio","Coshocton County",1,79,228,91,137
050,39,031,"Ohio","Coshocton County",1,80,197,79,118
050,39,031,"Ohio","Coshocton County",1,81,175,72,103
050,39,031,"Ohio","Coshocton County",1,82,186,70,116
050,39,031,"Ohio","Coshocton County",1,83,166,73,93
050,39,031,"Ohio","Coshocton County",1,84,166,71,95
050,39,031,"Ohio","Coshocton County",1,85,747,278,469
050,39,031,"Ohio","Coshocton County",2,0,444,233,211
050,39,031,"Ohio","Coshocton County",2,1,437,227,210
050,39,031,"Ohio","Coshocton County",2,2,468,241,227
050,39,031,"Ohio","Coshocton County",2,3,496,260,236
050,39,031,"Ohio","Coshocton County",2,4,510,282,228
050,39,031,"Ohio","Coshocton County",2,5,491,265,226
050,39,031,"Ohio","Coshocton County",2,6,478,239,239
050,39,031,"Ohio","Coshocton County",2,7,500,255,245
050,39,031,"Ohio","Coshocton County",2,8,489,244,245
050,39,031,"Ohio","Coshocton County",2,9,480,235,245
050,39,031,"Ohio","Coshocton County",2,10,491,265,226
050,39,031,"Ohio","Coshocton County",2,11,484,262,222
050,39,031,"Ohio","Coshocton County",2,12,493,256,237
050,39,031,"Ohio","Coshocton County",2,13,512,257,255
050,39,031,"Ohio","Coshocton County",2,14,515,263,252
050,39,031,"Ohio","Coshocton County",2,15,520,277,243
050,39,031,"Ohio","Coshocton County",2,16,530,283,247
050,39,031,"Ohio","Coshocton County",2,17,517,268,249
050,39,031,"Ohio","Coshocton County",2,18,428,234,194
050,39,031,"Ohio","Coshocton County",2,19,332,181,151
050,39,031,"Ohio","Coshocton County",2,20,361,187,174
050,39,031,"Ohio","Coshocton County",2,21,361,188,173
050,39,031,"Ohio","Coshocton County",2,22,380,194,186
050,39,031,"Ohio","Coshocton County",2,23,400,201,199
050,39,031,"Ohio","Coshocton County",2,24,380,190,190
050,39,031,"Ohio","Coshocton County",2,25,377,186,191
050,39,031,"Ohio","Coshocton County",2,26,417,206,211
050,39,031,"Ohio","Coshocton County",2,27,426,209,217
050,39,031,"Ohio","Coshocton County",2,28,433,213,220
050,39,031,"Ohio","Coshocton County",2,29,442,221,221
050,39,031,"Ohio","Coshocton County",2,30,433,207,226
050,39,031,"Ohio","Coshocton County",2,31,427,200,227
050,39,031,"Ohio","Coshocton County",2,32,421,197,224
050,39,031,"Ohio","Coshocton County",2,33,413,199,214
050,39,031,"Ohio","Coshocton County",2,34,406,208,198
050,39,031,"Ohio","Coshocton County",2,35,405,208,197
050,39,031,"Ohio","Coshocton County",2,36,403,206,197
050,39,031,"Ohio","Coshocton County",2,37,439,235,204
050,39,031,"Ohio","Coshocton County",2,38,453,235,218
050,39,031,"Ohio","Coshocton County",2,39,450,227,223
050,39,031,"Ohio","Coshocton County",2,40,454,227,227
050,39,031,"Ohio","Coshocton County",2,41,405,197,208
050,39,031,"Ohio","Coshocton County",2,42,381,188,193
050,39,031,"Ohio","Coshocton County",2,43,380,193,187
050,39,031,"Ohio","Coshocton County",2,44,369,179,190
050,39,031,"Ohio","Coshocton County",2,45,380,189,191
050,39,031,"Ohio","Coshocton County",2,46,399,209,190
050,39,031,"Ohio","Coshocton County",2,47,436,227,209
050,39,031,"Ohio","Coshocton County",2,48,457,238,219
050,39,031,"Ohio","Coshocton County",2,49,467,232,235
050,39,031,"Ohio","Coshocton County",2,50,466,230,236
050,39,031,"Ohio","Coshocton County",2,51,452,228,224
050,39,031,"Ohio","Coshocton County",2,52,459,235,224
050,39,031,"Ohio","Coshocton County",2,53,455,238,217
050,39,031,"Ohio","Coshocton County",2,54,459,244,215
050,39,031,"Ohio","Coshocton County",2,55,488,252,236
050,39,031,"Ohio","Coshocton County",2,56,518,254,264
050,39,031,"Ohio","Coshocton County",2,57,517,259,258
050,39,031,"Ohio","Coshocton County",2,58,516,256,260
050,39,031,"Ohio","Coshocton County",2,59,525,257,268
050,39,031,"Ohio","Coshocton County",2,60,506,259,247
050,39,031,"Ohio","Coshocton County",2,61,537,271,266
050,39,031,"Ohio","Coshocton County",2,62,566,275,291
050,39,031,"Ohio","Coshocton County",2,63,530,263,267
050,39,031,"Ohio","Coshocton County",2,64,500,255,245
050,39,031,"Ohio","Coshocton County",2,65,501,250,251
050,39,031,"Ohio","Coshocton County",2,66,492,243,249
050,39,031,"Ohio","Coshocton County",2,67,473,241,232
050,39,031,"Ohio","Coshocton County",2,68,462,230,232
050,39,031,"Ohio","Coshocton County",2,69,424,215,209
050,39,031,"Ohio","Coshocton County",2,70,400,194,206
050,39,031,"Ohio","Coshocton County",2,71,398,181,217
050,39,031,"Ohio","Coshocton County",2,72,399,192,207
050,39,031,"Ohio","Coshocton County",2,73,427,215,212
050,39,031,"Ohio","Coshocton County",2,74,276,132,144
050,39,031,"Ohio","Coshocton County",2,75,263,121,142
050,39,031,"Ohio","Coshocton County",2,76,246,118,128
050,39,031,"Ohio","Coshocton County",2,77,252,114,138
050,39,031,"Ohio","Coshocton County",2,78,244,103,141
050,39,031,"Ohio","Coshocton County",2,79,232,94,138
050,39,031,"Ohio","Coshocton County",2,80,199,79,120
050,39,031,"Ohio","Coshocton County",2,81,171,70,101
050,39,031,"Ohio","Coshocton County",2,82,179,67,112
050,39,031,"Ohio","Coshocton County",2,83,167,69,98
050,39,031,"Ohio","Coshocton County",2,84,161,68,93
050,39,031,"Ohio","Coshocton County",2,85,754,285,469
050,39,031,"Ohio","Coshocton County",3,0,440,215,225
050,39,031,"Ohio","Coshocton County",3,1,435,225,210
050,39,031,"Ohio","Coshocton County",3,2,448,228,220
050,39,031,"Ohio","Coshocton County",3,3,460,237,223
050,39,031,"Ohio","Coshocton County",3,4,501,260,241
050,39,031,"Ohio","Coshocton County",3,5,516,288,228
050,39,031,"Ohio","Coshocton County",3,6,500,266,234
050,39,031,"Ohio","Coshocton County",3,7,476,246,230
050,39,031,"Ohio","Coshocton County",3,8,506,260,246
050,39,031,"Ohio","Coshocton County",3,9,488,247,241
050,39,031,"Ohio","Coshocton County",3,10,492,242,250
050,39,031,"Ohio","Coshocton County",3,11,479,266,213
050,39,031,"Ohio","Coshocton County",3,12,479,260,219
050,39,031,"Ohio","Coshocton County",3,13,513,269,244
050,39,031,"Ohio","Coshocton County",3,14,522,266,256
050,39,031,"Ohio","Coshocton County",3,15,533,273,260
050,39,031,"Ohio","Coshocton County",3,16,539,284,255
050,39,031,"Ohio","Coshocton County",3,17,529,284,245
050,39,031,"Ohio","Coshocton County",3,18,437,229,208
050,39,031,"Ohio","Coshocton County",3,19,329,174,155
050,39,031,"Ohio","Coshocton County",3,20,355,186,169
050,39,031,"Ohio","Coshocton County",3,21,373,187,186
050,39,031,"Ohio","Coshocton County",3,22,371,190,181
050,39,031,"Ohio","Coshocton County",3,23,401,202,199
050,39,031,"Ohio","Coshocton County",3,24,403,203,200
050,39,031,"Ohio","Coshocton County",3,25,380,200,180
050,39,031,"Ohio","Coshocton County",3,26,361,179,182
050,39,031,"Ohio","Coshocton County",3,27,440,219,221
050,39,031,"Ohio","Coshocton County",3,28,420,204,216
050,39,031,"Ohio","Coshocton County",3,29,456,223,233
050,39,031,"Ohio","Coshocton County",3,30,448,225,223
050,39,031,"Ohio","Coshocton County",3,31,422,204,218
050,39,031,"Ohio","Coshocton County",3,32,430,199,231
050,39,031,"Ohio","Coshocton County",3,33,420,194,226
050,39,031,"Ohio","Coshocton County",3,34,410,200,210
050,39,031,"Ohio","Coshocton County",3,35,407,206,201
050,39,031,"Ohio","Coshocton County",3,36,420,217,203
050,39,031,"Ohio","Coshocton County",3,37,409,203,206
050,39,031,"Ohio","Coshocton County",3,38,439,226,213
050,39,031,"Ohio","Coshocton County",3,39,448,227,221
050,39,031,"Ohio","Coshocton County",3,40,452,229,223
050,39,031,"Ohio","Coshocton County",3,41,452,224,228
050,39,031,"Ohio","Coshocton County",3,42,416,207,209
050,39,031,"Ohio","Coshocton County",3,43,387,192,195
050,39,031,"Ohio","Coshocton County",3,44,379,196,183
050,39,031,"Ohio","Coshocton County",3,45,378,183,195
050,39,031,"Ohio","Coshocton County",3,46,388,190,198
050,39,031,"Ohio","Coshocton County",3,47,406,211,195
050,39,031,"Ohio","Coshocton County",3,48,434,226,208
050,39,031,"Ohio","Coshocton County",3,49,455,238,217
050,39,031,"Ohio","Coshocton County",3,50,473,235,238
050,39,031,"Ohio","Coshocton County",3,51,469,236,233
050,39,031,"Ohio","Coshocton County",3,52,460,224,236
050,39,031,"Ohio","Coshocton County",3,53,448,230,218
050,39,031,"Ohio","Coshocton County",3,54,444,234,210
050,39,031,"Ohio","Coshocton County",3,55,459,243,216
050,39,031,"Ohio","Coshocton County",3,56,491,253,238
050,39,031,"Ohio","Coshocton County",3,57,532,263,269
050,39,031,"Ohio","Coshocton County",3,58,511,250,261
050,39,031,"Ohio","Coshocton County",3,59,516,256,260
050,39,031,"Ohio","Coshocton County",3,60,522,259,263
050,39,031,"Ohio","Coshocton County",3,61,511,260,251
050,39,031,"Ohio","Coshocton County",3,62,522,261,261
050,39,031,"Ohio","Coshocton County",3,63,555,269,286
050,39,031,"Ohio","Coshocton County",3,64,527,265,262
050,39,031,"Ohio","Coshocton County",3,65,487,247,240
050,39,031,"Ohio","Coshocton County",3,66,500,248,252
050,39,031,"Ohio","Coshocton County",3,67,486,243,243
050,39,031,"Ohio","Coshocton County",3,68,464,233,231
050,39,031,"Ohio","Coshocton County",3,69,443,219,224
050,39,031,"Ohio","Coshocton County",3,70,417,208,209
050,39,031,"Ohio","Coshocton County",3,71,396,191,205
050,39,031,"Ohio","Coshocton County",3,72,386,172,214
050,39,031,"Ohio","Coshocton County",3,73,380,182,198
050,39,031,"Ohio","Coshocton County",3,74,402,200,202
050,39,031,"Ohio","Coshocton County",3,75,266,125,141
050,39,031,"Ohio","Coshocton County",3,76,256,121,135
050,39,031,"Ohio","Coshocton County",3,77,235,108,127
050,39,031,"Ohio","Coshocton County",3,78,236,105,131
050,39,031,"Ohio","Coshocton County",3,79,230,97,133
050,39,031,"Ohio","Coshocton County",3,80,214,82,132
050,39,031,"Ohio","Coshocton County",3,81,179,73,106
050,39,031,"Ohio","Coshocton County",3,82,160,64,96
050,39,031,"Ohio","Coshocton County",3,83,167,61,106
050,39,031,"Ohio","Coshocton County",3,84,162,62,100
050,39,031,"Ohio","Coshocton County",3,85,770,301,469
050,39,031,"Ohio","Coshocton County",4,0,428,200,228
050,39,031,"Ohio","Coshocton County",4,1,448,219,229
050,39,031,"Ohio","Coshocton County",4,2,447,232,215
050,39,031,"Ohio","Coshocton County",4,3,439,222,217
050,39,031,"Ohio","Coshocton County",4,4,463,230,233
050,39,031,"Ohio","Coshocton County",4,5,507,264,243
050,39,031,"Ohio","Coshocton County",4,6,528,291,237
050,39,031,"Ohio","Coshocton County",4,7,508,275,233
050,39,031,"Ohio","Coshocton County",4,8,483,251,232
050,39,031,"Ohio","Coshocton County",4,9,506,262,244
050,39,031,"Ohio","Coshocton County",4,10,484,244,240
050,39,031,"Ohio","Coshocton County",4,11,496,247,249
050,39,031,"Ohio","Coshocton County",4,12,488,272,216
050,39,031,"Ohio","Coshocton County",4,13,487,259,228
050,39,031,"Ohio","Coshocton County",4,14,500,264,236
050,39,031,"Ohio","Coshocton County",4,15,525,267,258
050,39,031,"Ohio","Coshocton County",4,16,528,276,252
050,39,031,"Ohio","Coshocton County",4,17,525,274,251
050,39,031,"Ohio","Coshocton County",4,18,442,248,194
050,39,031,"Ohio","Coshocton County",4,19,326,170,156
050,39,031,"Ohio","Coshocton County",4,20,351,179,172
050,39,031,"Ohio","Coshocton County",4,21,372,197,175
050,39,031,"Ohio","Coshocton County",4,22,385,191,194
050,39,031,"Ohio","Coshocton County",4,23,387,198,189
050,39,031,"Ohio","Coshocton County",4,24,420,211,209
050,39,031,"Ohio","Coshocton County",4,25,402,202,200
050,39,031,"Ohio","Coshocton County",4,26,382,205,177
050,39,031,"Ohio","Coshocton County",4,27,379,193,186
050,39,031,"Ohio","Coshocton County",4,28,437,216,221
050,39,031,"Ohio","Coshocton County",4,29,411,198,213
050,39,031,"Ohio","Coshocton County",4,30,442,214,228
050,39,031,"Ohio","Coshocton County",4,31,453,231,222
050,39,031,"Ohio","Coshocton County",4,32,419,199,220
050,39,031,"Ohio","Coshocton County",4,33,442,211,231
050,39,031,"Ohio","Coshocton County",4,34,418,194,224
050,39,031,"Ohio","Coshocton County",4,35,411,199,212
050,39,031,"Ohio","Coshocton County",4,36,403,204,199
050,39,031,"Ohio","Coshocton County",4,37,423,216,207
050,39,031,"Ohio","Coshocton County",4,38,417,202,215
050,39,031,"Ohio","Coshocton County",4,39,453,230,223
050,39,031,"Ohio","Coshocton County",4,40,458,231,227
050,39,031,"Ohio","Coshocton County",4,41,453,232,221
050,39,031,"Ohio","Coshocton County",4,42,459,222,237
050,39,031,"Ohio","Coshocton County",4,43,411,206,205
050,39,031,"Ohio","Coshocton County",4,44,392,194,198
050,39,031,"Ohio","Coshocton County",4,45,377,198,179
050,39,031,"Ohio","Coshocton County",4,46,376,176,200
050,39,031,"Ohio","Coshocton County",4,47,396,197,199
050,39,031,"Ohio","Coshocton County",4,48,414,213,201
050,39,031,"Ohio","Coshocton County",4,49,435,224,211
050,39,031,"Ohio","Coshocton County",4,50,462,238,224
050,39,031,"Ohio","Coshocton County",4,51,476,240,236
050,39,031,"Ohio","Coshocton County",4,52,468,231,237
050,39,031,"Ohio","Coshocton County",4,53,445,219,226
050,39,031,"Ohio","Coshocton County",4,54,441,227,214
050,39,031,"Ohio","Coshocton County",4,55,440,232,208
050,39,031,"Ohio","Coshocton County",4,56,448,236,212
050,39,031,"Ohio","Coshocton County",4,57,484,255,229
050,39,031,"Ohio","Coshocton County",4,58,531,259,272
050,39,031,"Ohio","Coshocton County",4,59,510,254,256
050,39,031,"Ohio","Coshocton County",4,60,514,256,258
050,39,031,"Ohio","Coshocton County",4,61,527,262,265
050,39,031,"Ohio","Coshocton County",4,62,505,253,252
050,39,031,"Ohio","Coshocton County",4,63,504,253,251
050,39,031,"Ohio","Coshocton County",4,64,550,270,280
050,39,031,"Ohio","Coshocton County",4,65,513,251,262
050,39,031,"Ohio","Coshocton County",4,66,482,244,238
050,39,031,"Ohio","Coshocton County",4,67,485,242,243
050,39,031,"Ohio","Coshocton County",4,68,478,236,242
050,39,031,"Ohio","Coshocton County",4,69,444,217,227
050,39,031,"Ohio","Coshocton County",4,70,424,208,216
050,39,031,"Ohio","Coshocton County",4,71,409,204,205
050,39,031,"Ohio","Coshocton County",4,72,396,192,204
050,39,031,"Ohio","Coshocton County",4,73,373,162,211
050,39,031,"Ohio","Coshocton County",4,74,364,172,192
050,39,031,"Ohio","Coshocton County",4,75,381,185,196
050,39,031,"Ohio","Coshocton County",4,76,257,122,135
050,39,031,"Ohio","Coshocton County",4,77,251,114,137
050,39,031,"Ohio","Coshocton County",4,78,227,105,122
050,39,031,"Ohio","Coshocton County",4,79,227,99,128
050,39,031,"Ohio","Coshocton County",4,80,215,88,127
050,39,031,"Ohio","Coshocton County",4,81,191,73,118
050,39,031,"Ohio","Coshocton County",4,82,171,67,104
050,39,031,"Ohio","Coshocton County",4,83,149,60,89
050,39,031,"Ohio","Coshocton County",4,84,152,48,104
050,39,031,"Ohio","Coshocton County",4,85,785,301,484
050,39,031,"Ohio","Coshocton County",5,0,423,197,226
050,39,031,"Ohio","Coshocton County",5,1,439,201,238
050,39,031,"Ohio","Coshocton County",5,2,463,230,233
050,39,031,"Ohio","Coshocton County",5,3,456,236,220
050,39,031,"Ohio","Coshocton County",5,4,439,231,208
050,39,031,"Ohio","Coshocton County",5,5,467,235,232
050,39,031,"Ohio","Coshocton County",5,6,506,266,240
050,39,031,"Ohio","Coshocton County",5,7,533,292,241
050,39,031,"Ohio","Coshocton County",5,8,507,274,233
050,39,031,"Ohio","Coshocton County",5,9,500,256,244
050,39,031,"Ohio","Coshocton County",5,10,512,263,249
050,39,031,"Ohio","Coshocton County",5,11,490,247,243
050,39,031,"Ohio","Coshocton County",5,12,501,249,252
050,39,031,"Ohio","Coshocton County",5,13,486,273,213
050,39,031,"Ohio","Coshocton County",5,14,497,264,233
050,39,031,"Ohio","Coshocton County",5,15,504,261,243
050,39,031,"Ohio","Coshocton County",5,16,523,263,260
050,39,031,"Ohio","Coshocton County",5,17,538,277,261
050,39,031,"Ohio","Coshocton County",5,18,427,229,198
050,39,031,"Ohio","Coshocton County",5,19,340,194,146
050,39,031,"Ohio","Coshocton County",5,20,343,179,164
050,39,031,"Ohio","Coshocton County",5,21,376,194,182
050,39,031,"Ohio","Coshocton County",5,22,417,212,205
050,39,031,"Ohio","Coshocton County",5,23,416,214,202
050,39,031,"Ohio","Coshocton County",5,24,407,208,199
050,39,031,"Ohio","Coshocton County",5,25,425,218,207
050,39,031,"Ohio","Coshocton County",5,26,397,200,197
050,39,031,"Ohio","Coshocton County",5,27,394,207,187
050,39,031,"Ohio","Coshocton County",5,28,392,196,196
050,39,031,"Ohio","Coshocton County",5,29,437,217,220
050,39,031,"Ohio","Coshocton County",5,30,421,203,218
050,39,031,"Ohio","Coshocton County",5,31,443,213,230
050,39,031,"Ohio","Coshocton County",5,32,458,225,233
050,39,031,"Ohio","Coshocton County",5,33,423,203,220
050,39,031,"Ohio","Coshocton County",5,34,445,218,227
050,39,031,"Ohio","Coshocton County",5,35,419,199,220
050,39,031,"Ohio","Coshocton County",5,36,419,202,217
050,39,031,"Ohio","Coshocton County",5,37,428,216,212
050,39,031,"Ohio","Coshocton County",5,38,432,222,210
050,39,031,"Ohio","Coshocton County",5,39,424,204,220
050,39,031,"Ohio","Coshocton County",5,40,460,239,221
050,39,031,"Ohio","Coshocton County",5,41,466,238,228
050,39,031,"Ohio","Coshocton County",5,42,459,234,225
050,39,031,"Ohio","Coshocton County",5,43,455,221,234
050,39,031,"Ohio","Coshocton County",5,44,411,208,203
050,39,031,"Ohio","Coshocton County",5,45,402,203,199
050,39,031,"Ohio","Coshocton County",5,46,376,194,182
050,39,031,"Ohio","Coshocton County",5,47,379,179,200
050,39,031,"Ohio","Coshocton County",5,48,387,192,195
050,39,031,"Ohio","Coshocton County",5,49,411,213,198
050,39,031,"Ohio","Coshocton County",5,50,437,221,216
050,39,031,"Ohio","Coshocton County",5,51,459,243,216
050,39,031,"Ohio","Coshocton County",5,52,486,239,247
050,39,031,"Ohio","Coshocton County",5,53,457,226,231
050,39,031,"Ohio","Coshocton County",5,54,446,227,219
050,39,031,"Ohio","Coshocton County",5,55,456,232,224
050,39,031,"Ohio","Coshocton County",5,56,448,236,212
050,39,031,"Ohio","Coshocton County",5,57,448,241,207
050,39,031,"Ohio","Coshocton County",5,58,494,255,239
050,39,031,"Ohio","Coshocton County",5,59,534,264,270
050,39,031,"Ohio","Coshocton County",5,60,507,257,250
050,39,031,"Ohio","Coshocton County",5,61,515,253,262
050,39,031,"Ohio","Coshocton County",5,62,517,252,265
050,39,031,"Ohio","Coshocton County",5,63,502,253,249
050,39,031,"Ohio","Coshocton County",5,64,514,262,252
050,39,031,"Ohio","Coshocton County",5,65,547,267,280
050,39,031,"Ohio","Coshocton County",5,66,521,253,268
050,39,031,"Ohio","Coshocton County",5,67,467,240,227
050,39,031,"Ohio","Coshocton County",5,68,483,241,242
050,39,031,"Ohio","Coshocton County",5,69,469,230,239
050,39,031,"Ohio","Coshocton County",5,70,438,214,224
050,39,031,"Ohio","Coshocton County",5,71,418,206,212
050,39,031,"Ohio","Coshocton County",5,72,403,205,198
050,39,031,"Ohio","Coshocton County",5,73,375,180,195
050,39,031,"Ohio","Coshocton County",5,74,355,151,204
050,39,031,"Ohio","Coshocton County",5,75,352,162,190
050,39,031,"Ohio","Coshocton County",5,76,368,180,188
050,39,031,"Ohio","Coshocton County",5,77,251,113,138
050,39,031,"Ohio","Coshocton County",5,78,242,110,132
050,39,031,"Ohio","Coshocton County",5,79,216,100,116
050,39,031,"Ohio","Coshocton County",5,80,206,88,118
050,39,031,"Ohio","Coshocton County",5,81,197,85,112
050,39,031,"Ohio","Coshocton County",5,82,181,67,114
050,39,031,"Ohio","Coshocton County",5,83,159,63,96
050,39,031,"Ohio","Coshocton County",5,84,134,48,86
050,39,031,"Ohio","Coshocton County",5,85,794,289,505
050,39,033,"Ohio","Crawford County",1,0,460,234,226
050,39,033,"Ohio","Crawford County",1,1,483,246,237
050,39,033,"Ohio","Crawford County",1,2,479,240,239
050,39,033,"Ohio","Crawford County",1,3,462,230,232
050,39,033,"Ohio","Crawford County",1,4,489,252,237
050,39,033,"Ohio","Crawford County",1,5,512,259,253
050,39,033,"Ohio","Crawford County",1,6,472,253,219
050,39,033,"Ohio","Crawford County",1,7,504,258,246
050,39,033,"Ohio","Crawford County",1,8,502,265,237
050,39,033,"Ohio","Crawford County",1,9,509,263,246
050,39,033,"Ohio","Crawford County",1,10,496,247,249
050,39,033,"Ohio","Crawford County",1,11,542,271,271
050,39,033,"Ohio","Crawford County",1,12,536,274,262
050,39,033,"Ohio","Crawford County",1,13,543,274,269
050,39,033,"Ohio","Crawford County",1,14,561,284,277
050,39,033,"Ohio","Crawford County",1,15,554,291,263
050,39,033,"Ohio","Crawford County",1,16,603,329,274
050,39,033,"Ohio","Crawford County",1,17,545,283,262
050,39,033,"Ohio","Crawford County",1,18,462,240,222
050,39,033,"Ohio","Crawford County",1,19,386,203,183
050,39,033,"Ohio","Crawford County",1,20,421,216,205
050,39,033,"Ohio","Crawford County",1,21,434,211,223
050,39,033,"Ohio","Crawford County",1,22,459,216,243
050,39,033,"Ohio","Crawford County",1,23,475,238,237
050,39,033,"Ohio","Crawford County",1,24,501,255,246
050,39,033,"Ohio","Crawford County",1,25,481,251,230
050,39,033,"Ohio","Crawford County",1,26,496,258,238
050,39,033,"Ohio","Crawford County",1,27,504,266,238
050,39,033,"Ohio","Crawford County",1,28,487,257,230
050,39,033,"Ohio","Crawford County",1,29,513,259,254
050,39,033,"Ohio","Crawford County",1,30,483,229,254
050,39,033,"Ohio","Crawford County",1,31,439,211,228
050,39,033,"Ohio","Crawford County",1,32,433,214,219
050,39,033,"Ohio","Crawford County",1,33,429,215,214
050,39,033,"Ohio","Crawford County",1,34,434,223,211
050,39,033,"Ohio","Crawford County",1,35,443,221,222
050,39,033,"Ohio","Crawford County",1,36,459,218,241
050,39,033,"Ohio","Crawford County",1,37,458,233,225
050,39,033,"Ohio","Crawford County",1,38,454,205,249
050,39,033,"Ohio","Crawford County",1,39,475,212,263
050,39,033,"Ohio","Crawford County",1,40,488,236,252
050,39,033,"Ohio","Crawford County",1,41,477,233,244
050,39,033,"Ohio","Crawford County",1,42,498,235,263
050,39,033,"Ohio","Crawford County",1,43,490,247,243
050,39,033,"Ohio","Crawford County",1,44,501,249,252
050,39,033,"Ohio","Crawford County",1,45,500,257,243
050,39,033,"Ohio","Crawford County",1,46,498,255,243
050,39,033,"Ohio","Crawford County",1,47,510,263,247
050,39,033,"Ohio","Crawford County",1,48,583,309,274
050,39,033,"Ohio","Crawford County",1,49,585,297,288
050,39,033,"Ohio","Crawford County",1,50,542,272,270
050,39,033,"Ohio","Crawford County",1,51,535,279,256
050,39,033,"Ohio","Crawford County",1,52,556,289,267
050,39,033,"Ohio","Crawford County",1,53,544,278,266
050,39,033,"Ohio","Crawford County",1,54,546,290,256
050,39,033,"Ohio","Crawford County",1,55,554,293,261
050,39,033,"Ohio","Crawford County",1,56,574,293,281
050,39,033,"Ohio","Crawford County",1,57,583,283,300
050,39,033,"Ohio","Crawford County",1,58,605,299,306
050,39,033,"Ohio","Crawford County",1,59,615,292,323
050,39,033,"Ohio","Crawford County",1,60,623,306,317
050,39,033,"Ohio","Crawford County",1,61,629,329,300
050,39,033,"Ohio","Crawford County",1,62,616,311,305
050,39,033,"Ohio","Crawford County",1,63,613,296,317
050,39,033,"Ohio","Crawford County",1,64,605,294,311
050,39,033,"Ohio","Crawford County",1,65,567,282,285
050,39,033,"Ohio","Crawford County",1,66,557,279,278
050,39,033,"Ohio","Crawford County",1,67,561,271,290
050,39,033,"Ohio","Crawford County",1,68,566,253,313
050,39,033,"Ohio","Crawford County",1,69,534,262,272
050,39,033,"Ohio","Crawford County",1,70,500,236,264
050,39,033,"Ohio","Crawford County",1,71,478,213,265
050,39,033,"Ohio","Crawford County",1,72,477,225,252
050,39,033,"Ohio","Crawford County",1,73,491,246,245
050,39,033,"Ohio","Crawford County",1,74,311,140,171
050,39,033,"Ohio","Crawford County",1,75,338,144,194
050,39,033,"Ohio","Crawford County",1,76,347,142,205
050,39,033,"Ohio","Crawford County",1,77,361,154,207
050,39,033,"Ohio","Crawford County",1,78,316,143,173
050,39,033,"Ohio","Crawford County",1,79,252,118,134
050,39,033,"Ohio","Crawford County",1,80,251,106,145
050,39,033,"Ohio","Crawford County",1,81,242,104,138
050,39,033,"Ohio","Crawford County",1,82,213,91,122
050,39,033,"Ohio","Crawford County",1,83,198,88,110
050,39,033,"Ohio","Crawford County",1,84,188,73,115
050,39,033,"Ohio","Crawford County",1,85,1020,359,661
050,39,033,"Ohio","Crawford County",2,0,467,237,230
050,39,033,"Ohio","Crawford County",2,1,475,241,234
050,39,033,"Ohio","Crawford County",2,2,481,241,240
050,39,033,"Ohio","Crawford County",2,3,467,233,234
050,39,033,"Ohio","Crawford County",2,4,487,249,238
050,39,033,"Ohio","Crawford County",2,5,503,256,247
050,39,033,"Ohio","Crawford County",2,6,483,255,228
050,39,033,"Ohio","Crawford County",2,7,493,256,237
050,39,033,"Ohio","Crawford County",2,8,501,263,238
050,39,033,"Ohio","Crawford County",2,9,507,263,244
050,39,033,"Ohio","Crawford County",2,10,498,250,248
050,39,033,"Ohio","Crawford County",2,11,531,266,265
050,39,033,"Ohio","Crawford County",2,12,540,274,266
050,39,033,"Ohio","Crawford County",2,13,543,278,265
050,39,033,"Ohio","Crawford County",2,14,559,283,276
050,39,033,"Ohio","Crawford County",2,15,558,291,267
050,39,033,"Ohio","Crawford County",2,16,594,322,272
050,39,033,"Ohio","Crawford County",2,17,558,295,263
050,39,033,"Ohio","Crawford County",2,18,460,242,218
050,39,033,"Ohio","Crawford County",2,19,383,200,183
050,39,033,"Ohio","Crawford County",2,20,424,217,207
050,39,033,"Ohio","Crawford County",2,21,431,209,222
050,39,033,"Ohio","Crawford County",2,22,456,216,240
050,39,033,"Ohio","Crawford County",2,23,479,238,241
050,39,033,"Ohio","Crawford County",2,24,497,254,243
050,39,033,"Ohio","Crawford County",2,25,483,251,232
050,39,033,"Ohio","Crawford County",2,26,493,259,234
050,39,033,"Ohio","Crawford County",2,27,497,262,235
050,39,033,"Ohio","Crawford County",2,28,490,259,231
050,39,033,"Ohio","Crawford County",2,29,509,259,250
050,39,033,"Ohio","Crawford County",2,30,490,235,255
050,39,033,"Ohio","Crawford County",2,31,450,214,236
050,39,033,"Ohio","Crawford County",2,32,435,213,222
050,39,033,"Ohio","Crawford County",2,33,431,217,214
050,39,033,"Ohio","Crawford County",2,34,433,221,212
050,39,033,"Ohio","Crawford County",2,35,447,226,221
050,39,033,"Ohio","Crawford County",2,36,451,217,234
050,39,033,"Ohio","Crawford County",2,37,458,230,228
050,39,033,"Ohio","Crawford County",2,38,457,213,244
050,39,033,"Ohio","Crawford County",2,39,473,211,262
050,39,033,"Ohio","Crawford County",2,40,488,230,258
050,39,033,"Ohio","Crawford County",2,41,480,233,247
050,39,033,"Ohio","Crawford County",2,42,489,234,255
050,39,033,"Ohio","Crawford County",2,43,498,248,250
050,39,033,"Ohio","Crawford County",2,44,495,247,248
050,39,033,"Ohio","Crawford County",2,45,505,259,246
050,39,033,"Ohio","Crawford County",2,46,494,253,241
050,39,033,"Ohio","Crawford County",2,47,505,261,244
050,39,033,"Ohio","Crawford County",2,48,569,301,268
050,39,033,"Ohio","Crawford County",2,49,588,304,284
050,39,033,"Ohio","Crawford County",2,50,550,276,274
050,39,033,"Ohio","Crawford County",2,51,532,276,256
050,39,033,"Ohio","Crawford County",2,52,548,284,264
050,39,033,"Ohio","Crawford County",2,53,548,280,268
050,39,033,"Ohio","Crawford County",2,54,546,288,258
050,39,033,"Ohio","Crawford County",2,55,551,291,260
050,39,033,"Ohio","Crawford County",2,56,568,292,276
050,39,033,"Ohio","Crawford County",2,57,580,285,295
050,39,033,"Ohio","Crawford County",2,58,597,292,305
050,39,033,"Ohio","Crawford County",2,59,612,293,319
050,39,033,"Ohio","Crawford County",2,60,615,299,316
050,39,033,"Ohio","Crawford County",2,61,626,323,303
050,39,033,"Ohio","Crawford County",2,62,614,315,299
050,39,033,"Ohio","Crawford County",2,63,619,302,317
050,39,033,"Ohio","Crawford County",2,64,598,289,309
050,39,033,"Ohio","Crawford County",2,65,579,285,294
050,39,033,"Ohio","Crawford County",2,66,561,281,280
050,39,033,"Ohio","Crawford County",2,67,558,271,287
050,39,033,"Ohio","Crawford County",2,68,560,256,304
050,39,033,"Ohio","Crawford County",2,69,546,262,284
050,39,033,"Ohio","Crawford County",2,70,505,240,265
050,39,033,"Ohio","Crawford County",2,71,481,218,263
050,39,033,"Ohio","Crawford County",2,72,470,219,251
050,39,033,"Ohio","Crawford County",2,73,509,252,257
050,39,033,"Ohio","Crawford County",2,74,330,154,176
050,39,033,"Ohio","Crawford County",2,75,332,143,189
050,39,033,"Ohio","Crawford County",2,76,339,140,199
050,39,033,"Ohio","Crawford County",2,77,368,156,212
050,39,033,"Ohio","Crawford County",2,78,314,140,174
050,39,033,"Ohio","Crawford County",2,79,266,123,143
050,39,033,"Ohio","Crawford County",2,80,249,107,142
050,39,033,"Ohio","Crawford County",2,81,235,100,135
050,39,033,"Ohio","Crawford County",2,82,210,89,121
050,39,033,"Ohio","Crawford County",2,83,200,88,112
050,39,033,"Ohio","Crawford County",2,84,184,72,112
050,39,033,"Ohio","Crawford County",2,85,1030,360,670
050,39,033,"Ohio","Crawford County",3,0,450,231,219
050,39,033,"Ohio","Crawford County",3,1,461,242,219
050,39,033,"Ohio","Crawford County",3,2,478,230,248
050,39,033,"Ohio","Crawford County",3,3,467,236,231
050,39,033,"Ohio","Crawford County",3,4,470,239,231
050,39,033,"Ohio","Crawford County",3,5,491,253,238
050,39,033,"Ohio","Crawford County",3,6,502,251,251
050,39,033,"Ohio","Crawford County",3,7,497,258,239
050,39,033,"Ohio","Crawford County",3,8,503,259,244
050,39,033,"Ohio","Crawford County",3,9,512,269,243
050,39,033,"Ohio","Crawford County",3,10,521,261,260
050,39,033,"Ohio","Crawford County",3,11,506,254,252
050,39,033,"Ohio","Crawford County",3,12,549,276,273
050,39,033,"Ohio","Crawford County",3,13,526,269,257
050,39,033,"Ohio","Crawford County",3,14,538,268,270
050,39,033,"Ohio","Crawford County",3,15,557,264,293
050,39,033,"Ohio","Crawford County",3,16,558,290,268
050,39,033,"Ohio","Crawford County",3,17,600,321,279
050,39,033,"Ohio","Crawford County",3,18,470,257,213
050,39,033,"Ohio","Crawford County",3,19,373,196,177
050,39,033,"Ohio","Crawford County",3,20,433,221,212
050,39,033,"Ohio","Crawford County",3,21,446,220,226
050,39,033,"Ohio","Crawford County",3,22,470,235,235
050,39,033,"Ohio","Crawford County",3,23,476,228,248
050,39,033,"Ohio","Crawford County",3,24,482,243,239
050,39,033,"Ohio","Crawford County",3,25,492,255,237
050,39,033,"Ohio","Crawford County",3,26,483,251,232
050,39,033,"Ohio","Crawford County",3,27,485,261,224
050,39,033,"Ohio","Crawford County",3,28,498,258,240
050,39,033,"Ohio","Crawford County",3,29,481,259,222
050,39,033,"Ohio","Crawford County",3,30,510,255,255
050,39,033,"Ohio","Crawford County",3,31,498,247,251
050,39,033,"Ohio","Crawford County",3,32,459,224,235
050,39,033,"Ohio","Crawford County",3,33,436,209,227
050,39,033,"Ohio","Crawford County",3,34,438,232,206
050,39,033,"Ohio","Crawford County",3,35,429,215,214
050,39,033,"Ohio","Crawford County",3,36,461,239,222
050,39,033,"Ohio","Crawford County",3,37,453,215,238
050,39,033,"Ohio","Crawford County",3,38,460,225,235
050,39,033,"Ohio","Crawford County",3,39,467,220,247
050,39,033,"Ohio","Crawford County",3,40,453,201,252
050,39,033,"Ohio","Crawford County",3,41,494,234,260
050,39,033,"Ohio","Crawford County",3,42,470,232,238
050,39,033,"Ohio","Crawford County",3,43,497,237,260
050,39,033,"Ohio","Crawford County",3,44,495,242,253
050,39,033,"Ohio","Crawford County",3,45,512,250,262
050,39,033,"Ohio","Crawford County",3,46,506,260,246
050,39,033,"Ohio","Crawford County",3,47,499,255,244
050,39,033,"Ohio","Crawford County",3,48,506,262,244
050,39,033,"Ohio","Crawford County",3,49,562,298,264
050,39,033,"Ohio","Crawford County",3,50,587,298,289
050,39,033,"Ohio","Crawford County",3,51,565,280,285
050,39,033,"Ohio","Crawford County",3,52,526,276,250
050,39,033,"Ohio","Crawford County",3,53,546,280,266
050,39,033,"Ohio","Crawford County",3,54,550,285,265
050,39,033,"Ohio","Crawford County",3,55,534,282,252
050,39,033,"Ohio","Crawford County",3,56,541,285,256
050,39,033,"Ohio","Crawford County",3,57,572,293,279
050,39,033,"Ohio","Crawford County",3,58,570,276,294
050,39,033,"Ohio","Crawford County",3,59,584,281,303
050,39,033,"Ohio","Crawford County",3,60,609,292,317
050,39,033,"Ohio","Crawford County",3,61,608,292,316
050,39,033,"Ohio","Crawford County",3,62,585,299,286
050,39,033,"Ohio","Crawford County",3,63,607,307,300
050,39,033,"Ohio","Crawford County",3,64,598,291,307
050,39,033,"Ohio","Crawford County",3,65,590,286,304
050,39,033,"Ohio","Crawford County",3,66,560,275,285
050,39,033,"Ohio","Crawford County",3,67,542,269,273
050,39,033,"Ohio","Crawford County",3,68,544,257,287
050,39,033,"Ohio","Crawford County",3,69,541,247,294
050,39,033,"Ohio","Crawford County",3,70,536,256,280
050,39,033,"Ohio","Crawford County",3,71,486,233,253
050,39,033,"Ohio","Crawford County",3,72,468,209,259
050,39,033,"Ohio","Crawford County",3,73,459,213,246
050,39,033,"Ohio","Crawford County",3,74,492,240,252
050,39,033,"Ohio","Crawford County",3,75,320,150,170
050,39,033,"Ohio","Crawford County",3,76,309,132,177
050,39,033,"Ohio","Crawford County",3,77,323,133,190
050,39,033,"Ohio","Crawford County",3,78,335,143,192
050,39,033,"Ohio","Crawford County",3,79,291,126,165
050,39,033,"Ohio","Crawford County",3,80,248,112,136
050,39,033,"Ohio","Crawford County",3,81,228,95,133
050,39,033,"Ohio","Crawford County",3,82,204,89,115
050,39,033,"Ohio","Crawford County",3,83,192,85,107
050,39,033,"Ohio","Crawford County",3,84,174,72,102
050,39,033,"Ohio","Crawford County",3,85,978,348,630
050,39,033,"Ohio","Crawford County",4,0,430,209,221
050,39,033,"Ohio","Crawford County",4,1,470,256,214
050,39,033,"Ohio","Crawford County",4,2,459,232,227
050,39,033,"Ohio","Crawford County",4,3,480,242,238
050,39,033,"Ohio","Crawford County",4,4,450,228,222
050,39,033,"Ohio","Crawford County",4,5,457,234,223
050,39,033,"Ohio","Crawford County",4,6,506,266,240
050,39,033,"Ohio","Crawford County",4,7,512,253,259
050,39,033,"Ohio","Crawford County",4,8,483,251,232
050,39,033,"Ohio","Crawford County",4,9,508,258,250
050,39,033,"Ohio","Crawford County",4,10,505,263,242
050,39,033,"Ohio","Crawford County",4,11,516,257,259
050,39,033,"Ohio","Crawford County",4,12,505,254,251
050,39,033,"Ohio","Crawford County",4,13,536,275,261
050,39,033,"Ohio","Crawford County",4,14,519,264,255
050,39,033,"Ohio","Crawford County",4,15,540,273,267
050,39,033,"Ohio","Crawford County",4,16,551,271,280
050,39,033,"Ohio","Crawford County",4,17,565,291,274
050,39,033,"Ohio","Crawford County",4,18,494,275,219
050,39,033,"Ohio","Crawford County",4,19,351,191,160
050,39,033,"Ohio","Crawford County",4,20,388,192,196
050,39,033,"Ohio","Crawford County",4,21,438,217,221
050,39,033,"Ohio","Crawford County",4,22,484,236,248
050,39,033,"Ohio","Crawford County",4,23,472,250,222
050,39,033,"Ohio","Crawford County",4,24,501,246,255
050,39,033,"Ohio","Crawford County",4,25,440,221,219
050,39,033,"Ohio","Crawford County",4,26,496,262,234
050,39,033,"Ohio","Crawford County",4,27,484,248,236
050,39,033,"Ohio","Crawford County",4,28,488,264,224
050,39,033,"Ohio","Crawford County",4,29,522,276,246
050,39,033,"Ohio","Crawford County",4,30,483,254,229
050,39,033,"Ohio","Crawford County",4,31,510,262,248
050,39,033,"Ohio","Crawford County",4,32,516,250,266
050,39,033,"Ohio","Crawford County",4,33,467,227,240
050,39,033,"Ohio","Crawford County",4,34,427,203,224
050,39,033,"Ohio","Crawford County",4,35,435,230,205
050,39,033,"Ohio","Crawford County",4,36,439,220,219
050,39,033,"Ohio","Crawford County",4,37,456,236,220
050,39,033,"Ohio","Crawford County",4,38,458,219,239
050,39,033,"Ohio","Crawford County",4,39,458,226,232
050,39,033,"Ohio","Crawford County",4,40,466,222,244
050,39,033,"Ohio","Crawford County",4,41,467,202,265
050,39,033,"Ohio","Crawford County",4,42,505,249,256
050,39,033,"Ohio","Crawford County",4,43,484,242,242
050,39,033,"Ohio","Crawford County",4,44,492,229,263
050,39,033,"Ohio","Crawford County",4,45,494,242,252
050,39,033,"Ohio","Crawford County",4,46,528,264,264
050,39,033,"Ohio","Crawford County",4,47,504,256,248
050,39,033,"Ohio","Crawford County",4,48,492,249,243
050,39,033,"Ohio","Crawford County",4,49,503,256,247
050,39,033,"Ohio","Crawford County",4,50,555,290,265
050,39,033,"Ohio","Crawford County",4,51,593,294,299
050,39,033,"Ohio","Crawford County",4,52,551,271,280
050,39,033,"Ohio","Crawford County",4,53,527,269,258
050,39,033,"Ohio","Crawford County",4,54,544,278,266
050,39,033,"Ohio","Crawford County",4,55,538,281,257
050,39,033,"Ohio","Crawford County",4,56,528,276,252
050,39,033,"Ohio","Crawford County",4,57,542,291,251
050,39,033,"Ohio","Crawford County",4,58,566,291,275
050,39,033,"Ohio","Crawford County",4,59,560,274,286
050,39,033,"Ohio","Crawford County",4,60,581,284,297
050,39,033,"Ohio","Crawford County",4,61,606,289,317
050,39,033,"Ohio","Crawford County",4,62,601,286,315
050,39,033,"Ohio","Crawford County",4,63,586,301,285
050,39,033,"Ohio","Crawford County",4,64,595,299,296
050,39,033,"Ohio","Crawford County",4,65,581,279,302
050,39,033,"Ohio","Crawford County",4,66,577,282,295
050,39,033,"Ohio","Crawford County",4,67,557,268,289
050,39,033,"Ohio","Crawford County",4,68,527,255,272
050,39,033,"Ohio","Crawford County",4,69,530,252,278
050,39,033,"Ohio","Crawford County",4,70,531,242,289
050,39,033,"Ohio","Crawford County",4,71,517,250,267
050,39,033,"Ohio","Crawford County",4,72,479,230,249
050,39,033,"Ohio","Crawford County",4,73,456,201,255
050,39,033,"Ohio","Crawford County",4,74,438,201,237
050,39,033,"Ohio","Crawford County",4,75,474,228,246
050,39,033,"Ohio","Crawford County",4,76,303,146,157
050,39,033,"Ohio","Crawford County",4,77,303,126,177
050,39,033,"Ohio","Crawford County",4,78,293,121,172
050,39,033,"Ohio","Crawford County",4,79,306,124,182
050,39,033,"Ohio","Crawford County",4,80,275,115,160
050,39,033,"Ohio","Crawford County",4,81,229,106,123
050,39,033,"Ohio","Crawford County",4,82,210,87,123
050,39,033,"Ohio","Crawford County",4,83,195,84,111
050,39,033,"Ohio","Crawford County",4,84,172,74,98
050,39,033,"Ohio","Crawford County",4,85,949,344,605
050,39,033,"Ohio","Crawford County",5,0,438,214,224
050,39,033,"Ohio","Crawford County",5,1,447,219,228
050,39,033,"Ohio","Crawford County",5,2,475,265,210
050,39,033,"Ohio","Crawford County",5,3,477,243,234
050,39,033,"Ohio","Crawford County",5,4,491,260,231
050,39,033,"Ohio","Crawford County",5,5,453,219,234
050,39,033,"Ohio","Crawford County",5,6,462,233,229
050,39,033,"Ohio","Crawford County",5,7,504,259,245
050,39,033,"Ohio","Crawford County",5,8,511,250,261
050,39,033,"Ohio","Crawford County",5,9,485,255,230
050,39,033,"Ohio","Crawford County",5,10,494,251,243
050,39,033,"Ohio","Crawford County",5,11,507,263,244
050,39,033,"Ohio","Crawford County",5,12,514,253,261
050,39,033,"Ohio","Crawford County",5,13,505,259,246
050,39,033,"Ohio","Crawford County",5,14,533,268,265
050,39,033,"Ohio","Crawford County",5,15,518,264,254
050,39,033,"Ohio","Crawford County",5,16,539,273,266
050,39,033,"Ohio","Crawford County",5,17,558,267,291
050,39,033,"Ohio","Crawford County",5,18,468,250,218
050,39,033,"Ohio","Crawford County",5,19,388,214,174
050,39,033,"Ohio","Crawford County",5,20,404,214,190
050,39,033,"Ohio","Crawford County",5,21,407,195,212
050,39,033,"Ohio","Crawford County",5,22,487,245,242
050,39,033,"Ohio","Crawford County",5,23,513,248,265
050,39,033,"Ohio","Crawford County",5,24,483,259,224
050,39,033,"Ohio","Crawford County",5,25,491,247,244
050,39,033,"Ohio","Crawford County",5,26,450,233,217
050,39,033,"Ohio","Crawford County",5,27,509,268,241
050,39,033,"Ohio","Crawford County",5,28,500,265,235
050,39,033,"Ohio","Crawford County",5,29,486,258,228
050,39,033,"Ohio","Crawford County",5,30,509,265,244
050,39,033,"Ohio","Crawford County",5,31,492,257,235
050,39,033,"Ohio","Crawford County",5,32,543,281,262
050,39,033,"Ohio","Crawford County",5,33,530,255,275
050,39,033,"Ohio","Crawford County",5,34,465,229,236
050,39,033,"Ohio","Crawford County",5,35,438,210,228
050,39,033,"Ohio","Crawford County",5,36,440,230,210
050,39,033,"Ohio","Crawford County",5,37,429,217,212
050,39,033,"Ohio","Crawford County",5,38,465,241,224
050,39,033,"Ohio","Crawford County",5,39,453,213,240
050,39,033,"Ohio","Crawford County",5,40,466,235,231
050,39,033,"Ohio","Crawford County",5,41,481,227,254
050,39,033,"Ohio","Crawford County",5,42,467,208,259
050,39,033,"Ohio","Crawford County",5,43,525,271,254
050,39,033,"Ohio","Crawford County",5,44,465,232,233
050,39,033,"Ohio","Crawford County",5,45,485,225,260
050,39,033,"Ohio","Crawford County",5,46,492,242,250
050,39,033,"Ohio","Crawford County",5,47,518,250,268
050,39,033,"Ohio","Crawford County",5,48,501,254,247
050,39,033,"Ohio","Crawford County",5,49,491,249,242
050,39,033,"Ohio","Crawford County",5,50,513,254,259
050,39,033,"Ohio","Crawford County",5,51,555,283,272
050,39,033,"Ohio","Crawford County",5,52,599,304,295
050,39,033,"Ohio","Crawford County",5,53,560,272,288
050,39,033,"Ohio","Crawford County",5,54,534,269,265
050,39,033,"Ohio","Crawford County",5,55,546,284,262
050,39,033,"Ohio","Crawford County",5,56,529,277,252
050,39,033,"Ohio","Crawford County",5,57,524,278,246
050,39,033,"Ohio","Crawford County",5,58,541,289,252
050,39,033,"Ohio","Crawford County",5,59,553,282,271
050,39,033,"Ohio","Crawford County",5,60,560,275,285
050,39,033,"Ohio","Crawford County",5,61,588,288,300
050,39,033,"Ohio","Crawford County",5,62,597,285,312
050,39,033,"Ohio","Crawford County",5,63,596,283,313
050,39,033,"Ohio","Crawford County",5,64,576,296,280
050,39,033,"Ohio","Crawford County",5,65,582,290,292
050,39,033,"Ohio","Crawford County",5,66,568,270,298
050,39,033,"Ohio","Crawford County",5,67,567,277,290
050,39,033,"Ohio","Crawford County",5,68,545,260,285
050,39,033,"Ohio","Crawford County",5,69,515,249,266
050,39,033,"Ohio","Crawford County",5,70,521,247,274
050,39,033,"Ohio","Crawford County",5,71,521,238,283
050,39,033,"Ohio","Crawford County",5,72,511,248,263
050,39,033,"Ohio","Crawford County",5,73,467,224,243
050,39,033,"Ohio","Crawford County",5,74,443,193,250
050,39,033,"Ohio","Crawford County",5,75,426,194,232
050,39,033,"Ohio","Crawford County",5,76,456,220,236
050,39,033,"Ohio","Crawford County",5,77,287,138,149
050,39,033,"Ohio","Crawford County",5,78,275,118,157
050,39,033,"Ohio","Crawford County",5,79,268,107,161
050,39,033,"Ohio","Crawford County",5,80,288,115,173
050,39,033,"Ohio","Crawford County",5,81,256,108,148
050,39,033,"Ohio","Crawford County",5,82,202,95,107
050,39,033,"Ohio","Crawford County",5,83,200,85,115
050,39,033,"Ohio","Crawford County",5,84,173,67,106
050,39,033,"Ohio","Crawford County",5,85,935,341,594
050,39,035,"Ohio","Cuyahoga County",1,0,13898,7102,6796
050,39,035,"Ohio","Cuyahoga County",1,1,13918,7095,6823
050,39,035,"Ohio","Cuyahoga County",1,2,14249,7308,6941
050,39,035,"Ohio","Cuyahoga County",1,3,14380,7329,7051
050,39,035,"Ohio","Cuyahoga County",1,4,14363,7337,7026
050,39,035,"Ohio","Cuyahoga County",1,5,14427,7367,7060
050,39,035,"Ohio","Cuyahoga County",1,6,14511,7419,7092
050,39,035,"Ohio","Cuyahoga County",1,7,14190,7155,7035
050,39,035,"Ohio","Cuyahoga County",1,8,14202,7319,6883
050,39,035,"Ohio","Cuyahoga County",1,9,14256,7380,6876
050,39,035,"Ohio","Cuyahoga County",1,10,14413,7423,6990
050,39,035,"Ohio","Cuyahoga County",1,11,14855,7548,7307
050,39,035,"Ohio","Cuyahoga County",1,12,15327,7794,7533
050,39,035,"Ohio","Cuyahoga County",1,13,15304,7836,7468
050,39,035,"Ohio","Cuyahoga County",1,14,15179,7696,7483
050,39,035,"Ohio","Cuyahoga County",1,15,15157,7704,7453
050,39,035,"Ohio","Cuyahoga County",1,16,15366,7827,7539
050,39,035,"Ohio","Cuyahoga County",1,17,15298,7701,7597
050,39,035,"Ohio","Cuyahoga County",1,18,14631,7463,7168
050,39,035,"Ohio","Cuyahoga County",1,19,14581,7386,7195
050,39,035,"Ohio","Cuyahoga County",1,20,14890,7536,7354
050,39,035,"Ohio","Cuyahoga County",1,21,14905,7424,7481
050,39,035,"Ohio","Cuyahoga County",1,22,15284,7580,7704
050,39,035,"Ohio","Cuyahoga County",1,23,15674,7669,8005
050,39,035,"Ohio","Cuyahoga County",1,24,16640,8127,8513
050,39,035,"Ohio","Cuyahoga County",1,25,17436,8535,8901
050,39,035,"Ohio","Cuyahoga County",1,26,18262,8902,9360
050,39,035,"Ohio","Cuyahoga County",1,27,18973,9208,9765
050,39,035,"Ohio","Cuyahoga County",1,28,19359,9463,9896
050,39,035,"Ohio","Cuyahoga County",1,29,19117,9358,9759
050,39,035,"Ohio","Cuyahoga County",1,30,18678,9100,9578
050,39,035,"Ohio","Cuyahoga County",1,31,18040,8794,9246
050,39,035,"Ohio","Cuyahoga County",1,32,17526,8620,8906
050,39,035,"Ohio","Cuyahoga County",1,33,16951,8315,8636
050,39,035,"Ohio","Cuyahoga County",1,34,16643,8140,8503
050,39,035,"Ohio","Cuyahoga County",1,35,16137,7867,8270
050,39,035,"Ohio","Cuyahoga County",1,36,15833,7725,8108
050,39,035,"Ohio","Cuyahoga County",1,37,16044,7730,8314
050,39,035,"Ohio","Cuyahoga County",1,38,15648,7631,8017
050,39,035,"Ohio","Cuyahoga County",1,39,15627,7649,7978
050,39,035,"Ohio","Cuyahoga County",1,40,15233,7470,7763
050,39,035,"Ohio","Cuyahoga County",1,41,14560,6988,7572
050,39,035,"Ohio","Cuyahoga County",1,42,14256,6948,7308
050,39,035,"Ohio","Cuyahoga County",1,43,13755,6629,7126
050,39,035,"Ohio","Cuyahoga County",1,44,13556,6521,7035
050,39,035,"Ohio","Cuyahoga County",1,45,13698,6621,7077
050,39,035,"Ohio","Cuyahoga County",1,46,13218,6360,6858
050,39,035,"Ohio","Cuyahoga County",1,47,13905,6650,7255
050,39,035,"Ohio","Cuyahoga County",1,48,15267,7344,7923
050,39,035,"Ohio","Cuyahoga County",1,49,16349,7892,8457
050,39,035,"Ohio","Cuyahoga County",1,50,16024,7711,8313
050,39,035,"Ohio","Cuyahoga County",1,51,15554,7517,8037
050,39,035,"Ohio","Cuyahoga County",1,52,15133,7317,7816
050,39,035,"Ohio","Cuyahoga County",1,53,15800,7567,8233
050,39,035,"Ohio","Cuyahoga County",1,54,16155,7710,8445
050,39,035,"Ohio","Cuyahoga County",1,55,17073,8075,8998
050,39,035,"Ohio","Cuyahoga County",1,56,17325,8275,9050
050,39,035,"Ohio","Cuyahoga County",1,57,17396,8270,9126
050,39,035,"Ohio","Cuyahoga County",1,58,18203,8710,9493
050,39,035,"Ohio","Cuyahoga County",1,59,18543,8973,9570
050,39,035,"Ohio","Cuyahoga County",1,60,18551,8904,9647
050,39,035,"Ohio","Cuyahoga County",1,61,18674,8837,9837
050,39,035,"Ohio","Cuyahoga County",1,62,18608,8848,9760
050,39,035,"Ohio","Cuyahoga County",1,63,17855,8540,9315
050,39,035,"Ohio","Cuyahoga County",1,64,17164,8159,9005
050,39,035,"Ohio","Cuyahoga County",1,65,16771,7913,8858
050,39,035,"Ohio","Cuyahoga County",1,66,15958,7476,8482
050,39,035,"Ohio","Cuyahoga County",1,67,15333,7178,8155
050,39,035,"Ohio","Cuyahoga County",1,68,14994,7000,7994
050,39,035,"Ohio","Cuyahoga County",1,69,13801,6390,7411
050,39,035,"Ohio","Cuyahoga County",1,70,13260,6129,7131
050,39,035,"Ohio","Cuyahoga County",1,71,12854,5801,7053
050,39,035,"Ohio","Cuyahoga County",1,72,12687,5638,7049
050,39,035,"Ohio","Cuyahoga County",1,73,12331,5617,6714
050,39,035,"Ohio","Cuyahoga County",1,74,8514,3718,4796
050,39,035,"Ohio","Cuyahoga County",1,75,8252,3569,4683
050,39,035,"Ohio","Cuyahoga County",1,76,8285,3558,4727
050,39,035,"Ohio","Cuyahoga County",1,77,8376,3481,4895
050,39,035,"Ohio","Cuyahoga County",1,78,7474,3097,4377
050,39,035,"Ohio","Cuyahoga County",1,79,6703,2756,3947
050,39,035,"Ohio","Cuyahoga County",1,80,6157,2472,3685
050,39,035,"Ohio","Cuyahoga County",1,81,5936,2355,3581
050,39,035,"Ohio","Cuyahoga County",1,82,5513,2149,3364
050,39,035,"Ohio","Cuyahoga County",1,83,4948,1859,3089
050,39,035,"Ohio","Cuyahoga County",1,84,4592,1765,2827
050,39,035,"Ohio","Cuyahoga County",1,85,30009,9972,20037
050,39,035,"Ohio","Cuyahoga County",2,0,13683,6985,6698
050,39,035,"Ohio","Cuyahoga County",2,1,13862,7059,6803
050,39,035,"Ohio","Cuyahoga County",2,2,14160,7246,6914
050,39,035,"Ohio","Cuyahoga County",2,3,14275,7291,6984
050,39,035,"Ohio","Cuyahoga County",2,4,14347,7329,7018
050,39,035,"Ohio","Cuyahoga County",2,5,14387,7352,7035
050,39,035,"Ohio","Cuyahoga County",2,6,14476,7394,7082
050,39,035,"Ohio","Cuyahoga County",2,7,14235,7197,7038
050,39,035,"Ohio","Cuyahoga County",2,8,14141,7251,6890
050,39,035,"Ohio","Cuyahoga County",2,9,14205,7353,6852
050,39,035,"Ohio","Cuyahoga County",2,10,14331,7394,6937
050,39,035,"Ohio","Cuyahoga County",2,11,14675,7477,7198
050,39,035,"Ohio","Cuyahoga County",2,12,15254,7751,7503
050,39,035,"Ohio","Cuyahoga County",2,13,15278,7813,7465
050,39,035,"Ohio","Cuyahoga County",2,14,15164,7706,7458
050,39,035,"Ohio","Cuyahoga County",2,15,15143,7690,7453
050,39,035,"Ohio","Cuyahoga County",2,16,15311,7796,7515
050,39,035,"Ohio","Cuyahoga County",2,17,15283,7708,7575
050,39,035,"Ohio","Cuyahoga County",2,18,14530,7403,7127
050,39,035,"Ohio","Cuyahoga County",2,19,14533,7359,7174
050,39,035,"Ohio","Cuyahoga County",2,20,15030,7583,7447
050,39,035,"Ohio","Cuyahoga County",2,21,14877,7407,7470
050,39,035,"Ohio","Cuyahoga County",2,22,15260,7552,7708
050,39,035,"Ohio","Cuyahoga County",2,23,15706,7683,8023
050,39,035,"Ohio","Cuyahoga County",2,24,16460,8044,8416
050,39,035,"Ohio","Cuyahoga County",2,25,17348,8506,8842
050,39,035,"Ohio","Cuyahoga County",2,26,18137,8856,9281
050,39,035,"Ohio","Cuyahoga County",2,27,18779,9117,9662
050,39,035,"Ohio","Cuyahoga County",2,28,19271,9428,9843
050,39,035,"Ohio","Cuyahoga County",2,29,19165,9385,9780
050,39,035,"Ohio","Cuyahoga County",2,30,18867,9204,9663
050,39,035,"Ohio","Cuyahoga County",2,31,18114,8834,9280
050,39,035,"Ohio","Cuyahoga County",2,32,17544,8606,8938
050,39,035,"Ohio","Cuyahoga County",2,33,17037,8367,8670
050,39,035,"Ohio","Cuyahoga County",2,34,16645,8135,8510
050,39,035,"Ohio","Cuyahoga County",2,35,16288,7950,8338
050,39,035,"Ohio","Cuyahoga County",2,36,15761,7680,8081
050,39,035,"Ohio","Cuyahoga County",2,37,15985,7727,8258
050,39,035,"Ohio","Cuyahoga County",2,38,15773,7664,8109
050,39,035,"Ohio","Cuyahoga County",2,39,15533,7600,7933
050,39,035,"Ohio","Cuyahoga County",2,40,15394,7541,7853
050,39,035,"Ohio","Cuyahoga County",2,41,14657,7069,7588
050,39,035,"Ohio","Cuyahoga County",2,42,14241,6930,7311
050,39,035,"Ohio","Cuyahoga County",2,43,13928,6722,7206
050,39,035,"Ohio","Cuyahoga County",2,44,13477,6491,6986
050,39,035,"Ohio","Cuyahoga County",2,45,13709,6616,7093
050,39,035,"Ohio","Cuyahoga County",2,46,13239,6373,6866
050,39,035,"Ohio","Cuyahoga County",2,47,13675,6545,7130
050,39,035,"Ohio","Cuyahoga County",2,48,14903,7153,7750
050,39,035,"Ohio","Cuyahoga County",2,49,16129,7781,8348
050,39,035,"Ohio","Cuyahoga County",2,50,16086,7748,8338
050,39,035,"Ohio","Cuyahoga County",2,51,15539,7496,8043
050,39,035,"Ohio","Cuyahoga County",2,52,15189,7343,7846
050,39,035,"Ohio","Cuyahoga County",2,53,15590,7486,8104
050,39,035,"Ohio","Cuyahoga County",2,54,15970,7634,8336
050,39,035,"Ohio","Cuyahoga County",2,55,16795,7954,8841
050,39,035,"Ohio","Cuyahoga County",2,56,17213,8190,9023
050,39,035,"Ohio","Cuyahoga County",2,57,17324,8235,9089
050,39,035,"Ohio","Cuyahoga County",2,58,17934,8571,9363
050,39,035,"Ohio","Cuyahoga County",2,59,18446,8891,9555
050,39,035,"Ohio","Cuyahoga County",2,60,18460,8876,9584
050,39,035,"Ohio","Cuyahoga County",2,61,18522,8797,9725
050,39,035,"Ohio","Cuyahoga County",2,62,18502,8784,9718
050,39,035,"Ohio","Cuyahoga County",2,63,18095,8630,9465
050,39,035,"Ohio","Cuyahoga County",2,64,17184,8175,9009
050,39,035,"Ohio","Cuyahoga County",2,65,16752,7911,8841
050,39,035,"Ohio","Cuyahoga County",2,66,16112,7556,8556
050,39,035,"Ohio","Cuyahoga County",2,67,15360,7181,8179
050,39,035,"Ohio","Cuyahoga County",2,68,14905,6955,7950
050,39,035,"Ohio","Cuyahoga County",2,69,14094,6524,7570
050,39,035,"Ohio","Cuyahoga County",2,70,13291,6133,7158
050,39,035,"Ohio","Cuyahoga County",2,71,12867,5836,7031
050,39,035,"Ohio","Cuyahoga County",2,72,12459,5549,6910
050,39,035,"Ohio","Cuyahoga County",2,73,12857,5825,7032
050,39,035,"Ohio","Cuyahoga County",2,74,8848,3900,4948
050,39,035,"Ohio","Cuyahoga County",2,75,8280,3588,4692
050,39,035,"Ohio","Cuyahoga County",2,76,8121,3483,4638
050,39,035,"Ohio","Cuyahoga County",2,77,8408,3517,4891
050,39,035,"Ohio","Cuyahoga County",2,78,7474,3085,4389
050,39,035,"Ohio","Cuyahoga County",2,79,6780,2782,3998
050,39,035,"Ohio","Cuyahoga County",2,80,6211,2494,3717
050,39,035,"Ohio","Cuyahoga County",2,81,5864,2328,3536
050,39,035,"Ohio","Cuyahoga County",2,82,5541,2170,3371
050,39,035,"Ohio","Cuyahoga County",2,83,4954,1865,3089
050,39,035,"Ohio","Cuyahoga County",2,84,4566,1754,2812
050,39,035,"Ohio","Cuyahoga County",2,85,29775,9908,19867
050,39,035,"Ohio","Cuyahoga County",3,0,12979,6551,6428
050,39,035,"Ohio","Cuyahoga County",3,1,13362,6860,6502
050,39,035,"Ohio","Cuyahoga County",3,2,13557,6933,6624
050,39,035,"Ohio","Cuyahoga County",3,3,13924,7118,6806
050,39,035,"Ohio","Cuyahoga County",3,4,14121,7239,6882
050,39,035,"Ohio","Cuyahoga County",3,5,14184,7234,6950
050,39,035,"Ohio","Cuyahoga County",3,6,14255,7262,6993
050,39,035,"Ohio","Cuyahoga County",3,7,14299,7313,6986
050,39,035,"Ohio","Cuyahoga County",3,8,14153,7170,6983
050,39,035,"Ohio","Cuyahoga County",3,9,14051,7224,6827
050,39,035,"Ohio","Cuyahoga County",3,10,14063,7276,6787
050,39,035,"Ohio","Cuyahoga County",3,11,14217,7321,6896
050,39,035,"Ohio","Cuyahoga County",3,12,14653,7465,7188
050,39,035,"Ohio","Cuyahoga County",3,13,15136,7692,7444
050,39,035,"Ohio","Cuyahoga County",3,14,15200,7775,7425
050,39,035,"Ohio","Cuyahoga County",3,15,15016,7595,7421
050,39,035,"Ohio","Cuyahoga County",3,16,15117,7683,7434
050,39,035,"Ohio","Cuyahoga County",3,17,15269,7785,7484
050,39,035,"Ohio","Cuyahoga County",3,18,13940,7144,6796
050,39,035,"Ohio","Cuyahoga County",3,19,13153,6642,6511
050,39,035,"Ohio","Cuyahoga County",3,20,13972,7028,6944
050,39,035,"Ohio","Cuyahoga County",3,21,14355,7159,7196
050,39,035,"Ohio","Cuyahoga County",3,22,14757,7258,7499
050,39,035,"Ohio","Cuyahoga County",3,23,15488,7495,7993
050,39,035,"Ohio","Cuyahoga County",3,24,16151,7878,8273
050,39,035,"Ohio","Cuyahoga County",3,25,16691,8267,8424
050,39,035,"Ohio","Cuyahoga County",3,26,17400,8532,8868
050,39,035,"Ohio","Cuyahoga County",3,27,18136,8911,9225
050,39,035,"Ohio","Cuyahoga County",3,28,18499,8981,9518
050,39,035,"Ohio","Cuyahoga County",3,29,19077,9282,9795
050,39,035,"Ohio","Cuyahoga County",3,30,18941,9269,9672
050,39,035,"Ohio","Cuyahoga County",3,31,18630,9070,9560
050,39,035,"Ohio","Cuyahoga County",3,32,17839,8717,9122
050,39,035,"Ohio","Cuyahoga County",3,33,17275,8438,8837
050,39,035,"Ohio","Cuyahoga County",3,34,16737,8201,8536
050,39,035,"Ohio","Cuyahoga County",3,35,16298,7931,8367
050,39,035,"Ohio","Cuyahoga County",3,36,15990,7781,8209
050,39,035,"Ohio","Cuyahoga County",3,37,15557,7571,7986
050,39,035,"Ohio","Cuyahoga County",3,38,15797,7632,8165
050,39,035,"Ohio","Cuyahoga County",3,39,15536,7544,7992
050,39,035,"Ohio","Cuyahoga County",3,40,15419,7493,7926
050,39,035,"Ohio","Cuyahoga County",3,41,15199,7419,7780
050,39,035,"Ohio","Cuyahoga County",3,42,14632,7105,7527
050,39,035,"Ohio","Cuyahoga County",3,43,14053,6836,7217
050,39,035,"Ohio","Cuyahoga County",3,44,13802,6664,7138
050,39,035,"Ohio","Cuyahoga County",3,45,13347,6393,6954
050,39,035,"Ohio","Cuyahoga County",3,46,13475,6470,7005
050,39,035,"Ohio","Cuyahoga County",3,47,13121,6316,6805
050,39,035,"Ohio","Cuyahoga County",3,48,13531,6476,7055
050,39,035,"Ohio","Cuyahoga County",3,49,14710,7053,7657
050,39,035,"Ohio","Cuyahoga County",3,50,15923,7667,8256
050,39,035,"Ohio","Cuyahoga County",3,51,15879,7625,8254
050,39,035,"Ohio","Cuyahoga County",3,52,15329,7406,7923
050,39,035,"Ohio","Cuyahoga County",3,53,14965,7220,7745
050,39,035,"Ohio","Cuyahoga County",3,54,15284,7348,7936
050,39,035,"Ohio","Cuyahoga County",3,55,15729,7509,8220
050,39,035,"Ohio","Cuyahoga County",3,56,16507,7758,8749
050,39,035,"Ohio","Cuyahoga County",3,57,16959,8052,8907
050,39,035,"Ohio","Cuyahoga County",3,58,17039,8094,8945
050,39,035,"Ohio","Cuyahoga County",3,59,17609,8374,9235
050,39,035,"Ohio","Cuyahoga County",3,60,18101,8700,9401
050,39,035,"Ohio","Cuyahoga County",3,61,18069,8674,9395
050,39,035,"Ohio","Cuyahoga County",3,62,18123,8528,9595
050,39,035,"Ohio","Cuyahoga County",3,63,18092,8541,9551
050,39,035,"Ohio","Cuyahoga County",3,64,17636,8360,9276
050,39,035,"Ohio","Cuyahoga County",3,65,16701,7885,8816
050,39,035,"Ohio","Cuyahoga County",3,66,16342,7652,8690
050,39,035,"Ohio","Cuyahoga County",3,67,15712,7350,8362
050,39,035,"Ohio","Cuyahoga County",3,68,15036,7002,8034
050,39,035,"Ohio","Cuyahoga County",3,69,14475,6708,7767
050,39,035,"Ohio","Cuyahoga County",3,70,13765,6342,7423
050,39,035,"Ohio","Cuyahoga County",3,71,12843,5886,6957
050,39,035,"Ohio","Cuyahoga County",3,72,12474,5618,6856
050,39,035,"Ohio","Cuyahoga County",3,73,12012,5321,6691
050,39,035,"Ohio","Cuyahoga County",3,74,12421,5584,6837
050,39,035,"Ohio","Cuyahoga County",3,75,8550,3721,4829
050,39,035,"Ohio","Cuyahoga County",3,76,7954,3419,4535
050,39,035,"Ohio","Cuyahoga County",3,77,7685,3269,4416
050,39,035,"Ohio","Cuyahoga County",3,78,8068,3330,4738
050,39,035,"Ohio","Cuyahoga County",3,79,7079,2916,4163
050,39,035,"Ohio","Cuyahoga County",3,80,6404,2581,3823
050,39,035,"Ohio","Cuyahoga County",3,81,5851,2307,3544
050,39,035,"Ohio","Cuyahoga County",3,82,5452,2127,3325
050,39,035,"Ohio","Cuyahoga County",3,83,5120,1919,3201
050,39,035,"Ohio","Cuyahoga County",3,84,4457,1688,2769
050,39,035,"Ohio","Cuyahoga County",3,85,28787,9605,19182
050,39,035,"Ohio","Cuyahoga County",4,0,12876,6504,6372
050,39,035,"Ohio","Cuyahoga County",4,1,12805,6452,6353
050,39,035,"Ohio","Cuyahoga County",4,2,13195,6759,6436
050,39,035,"Ohio","Cuyahoga County",4,3,13414,6874,6540
050,39,035,"Ohio","Cuyahoga County",4,4,13867,7136,6731
050,39,035,"Ohio","Cuyahoga County",4,5,14017,7202,6815
050,39,035,"Ohio","Cuyahoga County",4,6,14074,7222,6852
050,39,035,"Ohio","Cuyahoga County",4,7,14076,7163,6913
050,39,035,"Ohio","Cuyahoga County",4,8,14229,7271,6958
050,39,035,"Ohio","Cuyahoga County",4,9,14032,7114,6918
050,39,035,"Ohio","Cuyahoga County",4,10,13990,7157,6833
050,39,035,"Ohio","Cuyahoga County",4,11,13970,7216,6754
050,39,035,"Ohio","Cuyahoga County",4,12,14196,7359,6837
050,39,035,"Ohio","Cuyahoga County",4,13,14525,7410,7115
050,39,035,"Ohio","Cuyahoga County",4,14,15021,7643,7378
050,39,035,"Ohio","Cuyahoga County",4,15,15161,7714,7447
050,39,035,"Ohio","Cuyahoga County",4,16,14969,7521,7448
050,39,035,"Ohio","Cuyahoga County",4,17,15058,7637,7421
050,39,035,"Ohio","Cuyahoga County",4,18,14080,7286,6794
050,39,035,"Ohio","Cuyahoga County",4,19,13132,6722,6410
050,39,035,"Ohio","Cuyahoga County",4,20,13777,6902,6875
050,39,035,"Ohio","Cuyahoga County",4,21,14213,7088,7125
050,39,035,"Ohio","Cuyahoga County",4,22,14702,7276,7426
050,39,035,"Ohio","Cuyahoga County",4,23,15350,7486,7864
050,39,035,"Ohio","Cuyahoga County",4,24,15900,7803,8097
050,39,035,"Ohio","Cuyahoga County",4,25,16400,8031,8369
050,39,035,"Ohio","Cuyahoga County",4,26,16653,8262,8391
050,39,035,"Ohio","Cuyahoga County",4,27,17477,8549,8928
050,39,035,"Ohio","Cuyahoga County",4,28,18020,8844,9176
050,39,035,"Ohio","Cuyahoga County",4,29,18306,8816,9490
050,39,035,"Ohio","Cuyahoga County",4,30,18962,9287,9675
050,39,035,"Ohio","Cuyahoga County",4,31,18695,9111,9584
050,39,035,"Ohio","Cuyahoga County",4,32,18291,8930,9361
050,39,035,"Ohio","Cuyahoga County",4,33,17681,8656,9025
050,39,035,"Ohio","Cuyahoga County",4,34,17013,8317,8696
050,39,035,"Ohio","Cuyahoga County",4,35,16529,8077,8452
050,39,035,"Ohio","Cuyahoga County",4,36,16005,7752,8253
050,39,035,"Ohio","Cuyahoga County",4,37,15765,7692,8073
050,39,035,"Ohio","Cuyahoga County",4,38,15340,7439,7901
050,39,035,"Ohio","Cuyahoga County",4,39,15517,7492,8025
050,39,035,"Ohio","Cuyahoga County",4,40,15439,7493,7946
050,39,035,"Ohio","Cuyahoga County",4,41,15188,7353,7835
050,39,035,"Ohio","Cuyahoga County",4,42,15088,7402,7686
050,39,035,"Ohio","Cuyahoga County",4,43,14437,7008,7429
050,39,035,"Ohio","Cuyahoga County",4,44,13921,6738,7183
050,39,035,"Ohio","Cuyahoga County",4,45,13608,6568,7040
050,39,035,"Ohio","Cuyahoga County",4,46,13121,6255,6866
050,39,035,"Ohio","Cuyahoga County",4,47,13323,6409,6914
050,39,035,"Ohio","Cuyahoga County",4,48,13032,6249,6783
050,39,035,"Ohio","Cuyahoga County",4,49,13406,6407,6999
050,39,035,"Ohio","Cuyahoga County",4,50,14506,6955,7551
050,39,035,"Ohio","Cuyahoga County",4,51,15695,7540,8155
050,39,035,"Ohio","Cuyahoga County",4,52,15635,7511,8124
050,39,035,"Ohio","Cuyahoga County",4,53,15116,7275,7841
050,39,035,"Ohio","Cuyahoga County",4,54,14749,7122,7627
050,39,035,"Ohio","Cuyahoga County",4,55,15082,7256,7826
050,39,035,"Ohio","Cuyahoga County",4,56,15378,7319,8059
050,39,035,"Ohio","Cuyahoga County",4,57,16243,7621,8622
050,39,035,"Ohio","Cuyahoga County",4,58,16712,7921,8791
050,39,035,"Ohio","Cuyahoga County",4,59,16738,7920,8818
050,39,035,"Ohio","Cuyahoga County",4,60,17290,8217,9073
050,39,035,"Ohio","Cuyahoga County",4,61,17765,8526,9239
050,39,035,"Ohio","Cuyahoga County",4,62,17608,8395,9213
050,39,035,"Ohio","Cuyahoga County",4,63,17701,8276,9425
050,39,035,"Ohio","Cuyahoga County",4,64,17630,8257,9373
050,39,035,"Ohio","Cuyahoga County",4,65,17168,8106,9062
050,39,035,"Ohio","Cuyahoga County",4,66,16283,7640,8643
050,39,035,"Ohio","Cuyahoga County",4,67,15909,7434,8475
050,39,035,"Ohio","Cuyahoga County",4,68,15315,7126,8189
050,39,035,"Ohio","Cuyahoga County",4,69,14570,6752,7818
050,39,035,"Ohio","Cuyahoga County",4,70,14092,6480,7612
050,39,035,"Ohio","Cuyahoga County",4,71,13319,6101,7218
050,39,035,"Ohio","Cuyahoga County",4,72,12448,5687,6761
050,39,035,"Ohio","Cuyahoga County",4,73,12064,5417,6647
050,39,035,"Ohio","Cuyahoga County",4,74,11598,5095,6503
050,39,035,"Ohio","Cuyahoga County",4,75,11949,5334,6615
050,39,035,"Ohio","Cuyahoga County",4,76,8218,3542,4676
050,39,035,"Ohio","Cuyahoga County",4,77,7597,3225,4372
050,39,035,"Ohio","Cuyahoga County",4,78,7323,3091,4232
050,39,035,"Ohio","Cuyahoga County",4,79,7653,3148,4505
050,39,035,"Ohio","Cuyahoga County",4,80,6620,2694,3926
050,39,035,"Ohio","Cuyahoga County",4,81,6041,2371,3670
050,39,035,"Ohio","Cuyahoga County",4,82,5473,2126,3347
050,39,035,"Ohio","Cuyahoga County",4,83,5041,1900,3141
050,39,035,"Ohio","Cuyahoga County",4,84,4608,1725,2883
050,39,035,"Ohio","Cuyahoga County",4,85,28011,9322,18689
050,39,035,"Ohio","Cuyahoga County",5,0,12974,6559,6415
050,39,035,"Ohio","Cuyahoga County",5,1,12764,6405,6359
050,39,035,"Ohio","Cuyahoga County",5,2,12774,6451,6323
050,39,035,"Ohio","Cuyahoga County",5,3,13150,6706,6444
050,39,035,"Ohio","Cuyahoga County",5,4,13469,6909,6560
050,39,035,"Ohio","Cuyahoga County",5,5,13845,7144,6701
050,39,035,"Ohio","Cuyahoga County",5,6,13996,7176,6820
050,39,035,"Ohio","Cuyahoga County",5,7,14017,7177,6840
050,39,035,"Ohio","Cuyahoga County",5,8,13990,7138,6852
050,39,035,"Ohio","Cuyahoga County",5,9,14199,7273,6926
050,39,035,"Ohio","Cuyahoga County",5,10,13962,7087,6875
050,39,035,"Ohio","Cuyahoga County",5,11,13948,7120,6828
050,39,035,"Ohio","Cuyahoga County",5,12,13935,7190,6745
050,39,035,"Ohio","Cuyahoga County",5,13,14129,7313,6816
050,39,035,"Ohio","Cuyahoga County",5,14,14506,7378,7128
050,39,035,"Ohio","Cuyahoga County",5,15,14962,7575,7387
050,39,035,"Ohio","Cuyahoga County",5,16,15127,7679,7448
050,39,035,"Ohio","Cuyahoga County",5,17,14957,7522,7435
050,39,035,"Ohio","Cuyahoga County",5,18,14039,7233,6806
050,39,035,"Ohio","Cuyahoga County",5,19,13582,6985,6597
050,39,035,"Ohio","Cuyahoga County",5,20,13784,6987,6797
050,39,035,"Ohio","Cuyahoga County",5,21,14008,6959,7049
050,39,035,"Ohio","Cuyahoga County",5,22,14568,7247,7321
050,39,035,"Ohio","Cuyahoga County",5,23,15150,7438,7712
050,39,035,"Ohio","Cuyahoga County",5,24,15764,7697,8067
050,39,035,"Ohio","Cuyahoga County",5,25,16189,7899,8290
050,39,035,"Ohio","Cuyahoga County",5,26,16632,8140,8492
050,39,035,"Ohio","Cuyahoga County",5,27,16862,8260,8602
050,39,035,"Ohio","Cuyahoga County",5,28,17528,8538,8990
050,39,035,"Ohio","Cuyahoga County",5,29,18062,8801,9261
050,39,035,"Ohio","Cuyahoga County",5,30,18216,8795,9421
050,39,035,"Ohio","Cuyahoga County",5,31,18816,9232,9584
050,39,035,"Ohio","Cuyahoga County",5,32,18498,9006,9492
050,39,035,"Ohio","Cuyahoga County",5,33,18107,8824,9283
050,39,035,"Ohio","Cuyahoga County",5,34,17571,8613,8958
050,39,035,"Ohio","Cuyahoga County",5,35,16819,8241,8578
050,39,035,"Ohio","Cuyahoga County",5,36,16295,7928,8367
050,39,035,"Ohio","Cuyahoga County",5,37,15903,7721,8182
050,39,035,"Ohio","Cuyahoga County",5,38,15609,7564,8045
050,39,035,"Ohio","Cuyahoga County",5,39,15165,7320,7845
050,39,035,"Ohio","Cuyahoga County",5,40,15393,7435,7958
050,39,035,"Ohio","Cuyahoga County",5,41,15323,7402,7921
050,39,035,"Ohio","Cuyahoga County",5,42,15099,7350,7749
050,39,035,"Ohio","Cuyahoga County",5,43,14990,7332,7658
050,39,035,"Ohio","Cuyahoga County",5,44,14329,6927,7402
050,39,035,"Ohio","Cuyahoga County",5,45,13878,6734,7144
050,39,035,"Ohio","Cuyahoga County",5,46,13540,6503,7037
050,39,035,"Ohio","Cuyahoga County",5,47,13012,6183,6829
050,39,035,"Ohio","Cuyahoga County",5,48,13187,6350,6837
050,39,035,"Ohio","Cuyahoga County",5,49,12986,6222,6764
050,39,035,"Ohio","Cuyahoga County",5,50,13270,6319,6951
050,39,035,"Ohio","Cuyahoga County",5,51,14377,6879,7498
050,39,035,"Ohio","Cuyahoga County",5,52,15515,7462,8053
050,39,035,"Ohio","Cuyahoga County",5,53,15491,7418,8073
050,39,035,"Ohio","Cuyahoga County",5,54,14885,7165,7720
050,39,035,"Ohio","Cuyahoga County",5,55,14592,7025,7567
050,39,035,"Ohio","Cuyahoga County",5,56,14822,7099,7723
050,39,035,"Ohio","Cuyahoga County",5,57,15136,7186,7950
050,39,035,"Ohio","Cuyahoga County",5,58,16026,7524,8502
050,39,035,"Ohio","Cuyahoga County",5,59,16487,7805,8682
050,39,035,"Ohio","Cuyahoga County",5,60,16460,7760,8700
050,39,035,"Ohio","Cuyahoga County",5,61,16995,8050,8945
050,39,035,"Ohio","Cuyahoga County",5,62,17461,8330,9131
050,39,035,"Ohio","Cuyahoga County",5,63,17231,8173,9058
050,39,035,"Ohio","Cuyahoga County",5,64,17352,8075,9277
050,39,035,"Ohio","Cuyahoga County",5,65,17225,8032,9193
050,39,035,"Ohio","Cuyahoga County",5,66,16802,7915,8887
050,39,035,"Ohio","Cuyahoga County",5,67,15939,7454,8485
050,39,035,"Ohio","Cuyahoga County",5,68,15638,7274,8364
050,39,035,"Ohio","Cuyahoga County",5,69,14943,6922,8021
050,39,035,"Ohio","Cuyahoga County",5,70,14238,6547,7691
050,39,035,"Ohio","Cuyahoga County",5,71,13758,6302,7456
050,39,035,"Ohio","Cuyahoga County",5,72,13016,5947,7069
050,39,035,"Ohio","Cuyahoga County",5,73,12106,5515,6591
050,39,035,"Ohio","Cuyahoga County",5,74,11747,5242,6505
050,39,035,"Ohio","Cuyahoga County",5,75,11292,4909,6383
050,39,035,"Ohio","Cuyahoga County",5,76,11534,5093,6441
050,39,035,"Ohio","Cuyahoga County",5,77,7872,3379,4493
050,39,035,"Ohio","Cuyahoga County",5,78,7335,3084,4251
050,39,035,"Ohio","Cuyahoga County",5,79,6995,2942,4053
050,39,035,"Ohio","Cuyahoga County",5,80,7264,2957,4307
050,39,035,"Ohio","Cuyahoga County",5,81,6307,2514,3793
050,39,035,"Ohio","Cuyahoga County",5,82,5706,2223,3483
050,39,035,"Ohio","Cuyahoga County",5,83,5136,1926,3210
050,39,035,"Ohio","Cuyahoga County",5,84,4574,1737,2837
050,39,035,"Ohio","Cuyahoga County",5,85,27953,9297,18656
050,39,037,"Ohio","Darke County",1,0,613,315,298
050,39,037,"Ohio","Darke County",1,1,644,328,316
050,39,037,"Ohio","Darke County",1,2,652,335,317
050,39,037,"Ohio","Darke County",1,3,664,349,315
050,39,037,"Ohio","Darke County",1,4,646,336,310
050,39,037,"Ohio","Darke County",1,5,649,339,310
050,39,037,"Ohio","Darke County",1,6,661,340,321
050,39,037,"Ohio","Darke County",1,7,645,322,323
050,39,037,"Ohio","Darke County",1,8,653,327,326
050,39,037,"Ohio","Darke County",1,9,660,347,313
050,39,037,"Ohio","Darke County",1,10,705,366,339
050,39,037,"Ohio","Darke County",1,11,754,385,369
050,39,037,"Ohio","Darke County",1,12,786,429,357
050,39,037,"Ohio","Darke County",1,13,745,378,367
050,39,037,"Ohio","Darke County",1,14,733,361,372
050,39,037,"Ohio","Darke County",1,15,738,369,369
050,39,037,"Ohio","Darke County",1,16,771,400,371
050,39,037,"Ohio","Darke County",1,17,705,371,334
050,39,037,"Ohio","Darke County",1,18,618,324,294
050,39,037,"Ohio","Darke County",1,19,500,265,235
050,39,037,"Ohio","Darke County",1,20,542,288,254
050,39,037,"Ohio","Darke County",1,21,577,304,273
050,39,037,"Ohio","Darke County",1,22,572,288,284
050,39,037,"Ohio","Darke County",1,23,568,289,279
050,39,037,"Ohio","Darke County",1,24,579,291,288
050,39,037,"Ohio","Darke County",1,25,561,306,255
050,39,037,"Ohio","Darke County",1,26,565,314,251
050,39,037,"Ohio","Darke County",1,27,601,304,297
050,39,037,"Ohio","Darke County",1,28,592,308,284
050,39,037,"Ohio","Darke County",1,29,547,273,274
050,39,037,"Ohio","Darke County",1,30,554,275,279
050,39,037,"Ohio","Darke County",1,31,555,283,272
050,39,037,"Ohio","Darke County",1,32,554,296,258
050,39,037,"Ohio","Darke County",1,33,540,281,259
050,39,037,"Ohio","Darke County",1,34,552,268,284
050,39,037,"Ohio","Darke County",1,35,534,271,263
050,39,037,"Ohio","Darke County",1,36,548,282,266
050,39,037,"Ohio","Darke County",1,37,580,302,278
050,39,037,"Ohio","Darke County",1,38,572,286,286
050,39,037,"Ohio","Darke County",1,39,602,298,304
050,39,037,"Ohio","Darke County",1,40,626,315,311
050,39,037,"Ohio","Darke County",1,41,616,308,308
050,39,037,"Ohio","Darke County",1,42,617,311,306
050,39,037,"Ohio","Darke County",1,43,572,292,280
050,39,037,"Ohio","Darke County",1,44,542,282,260
050,39,037,"Ohio","Darke County",1,45,558,297,261
050,39,037,"Ohio","Darke County",1,46,585,307,278
050,39,037,"Ohio","Darke County",1,47,587,308,279
050,39,037,"Ohio","Darke County",1,48,639,313,326
050,39,037,"Ohio","Darke County",1,49,667,348,319
050,39,037,"Ohio","Darke County",1,50,646,345,301
050,39,037,"Ohio","Darke County",1,51,678,339,339
050,39,037,"Ohio","Darke County",1,52,623,311,312
050,39,037,"Ohio","Darke County",1,53,664,324,340
050,39,037,"Ohio","Darke County",1,54,680,329,351
050,39,037,"Ohio","Darke County",1,55,756,380,376
050,39,037,"Ohio","Darke County",1,56,792,396,396
050,39,037,"Ohio","Darke County",1,57,739,364,375
050,39,037,"Ohio","Darke County",1,58,743,387,356
050,39,037,"Ohio","Darke County",1,59,754,388,366
050,39,037,"Ohio","Darke County",1,60,760,367,393
050,39,037,"Ohio","Darke County",1,61,759,372,387
050,39,037,"Ohio","Darke County",1,62,749,387,362
050,39,037,"Ohio","Darke County",1,63,732,373,359
050,39,037,"Ohio","Darke County",1,64,698,358,340
050,39,037,"Ohio","Darke County",1,65,668,324,344
050,39,037,"Ohio","Darke County",1,66,636,321,315
050,39,037,"Ohio","Darke County",1,67,632,298,334
050,39,037,"Ohio","Darke County",1,68,608,285,323
050,39,037,"Ohio","Darke County",1,69,594,296,298
050,39,037,"Ohio","Darke County",1,70,573,276,297
050,39,037,"Ohio","Darke County",1,71,561,265,296
050,39,037,"Ohio","Darke County",1,72,549,255,294
050,39,037,"Ohio","Darke County",1,73,532,259,273
050,39,037,"Ohio","Darke County",1,74,371,171,200
050,39,037,"Ohio","Darke County",1,75,396,183,213
050,39,037,"Ohio","Darke County",1,76,418,189,229
050,39,037,"Ohio","Darke County",1,77,432,194,238
050,39,037,"Ohio","Darke County",1,78,369,166,203
050,39,037,"Ohio","Darke County",1,79,361,163,198
050,39,037,"Ohio","Darke County",1,80,311,128,183
050,39,037,"Ohio","Darke County",1,81,278,126,152
050,39,037,"Ohio","Darke County",1,82,260,116,144
050,39,037,"Ohio","Darke County",1,83,230,100,130
050,39,037,"Ohio","Darke County",1,84,212,92,120
050,39,037,"Ohio","Darke County",1,85,1263,425,838
050,39,037,"Ohio","Darke County",2,0,613,311,302
050,39,037,"Ohio","Darke County",2,1,636,324,312
050,39,037,"Ohio","Darke County",2,2,654,336,318
050,39,037,"Ohio","Darke County",2,3,661,346,315
050,39,037,"Ohio","Darke County",2,4,654,341,313
050,39,037,"Ohio","Darke County",2,5,652,341,311
050,39,037,"Ohio","Darke County",2,6,662,342,320
050,39,037,"Ohio","Darke County",2,7,648,326,322
050,39,037,"Ohio","Darke County",2,8,654,329,325
050,39,037,"Ohio","Darke County",2,9,660,342,318
050,39,037,"Ohio","Darke County",2,10,696,361,335
050,39,037,"Ohio","Darke County",2,11,743,382,361
050,39,037,"Ohio","Darke County",2,12,780,418,362
050,39,037,"Ohio","Darke County",2,13,753,391,362
050,39,037,"Ohio","Darke County",2,14,737,366,371
050,39,037,"Ohio","Darke County",2,15,739,368,371
050,39,037,"Ohio","Darke County",2,16,765,394,371
050,39,037,"Ohio","Darke County",2,17,720,378,342
050,39,037,"Ohio","Darke County",2,18,606,321,285
050,39,037,"Ohio","Darke County",2,19,499,264,235
050,39,037,"Ohio","Darke County",2,20,551,292,259
050,39,037,"Ohio","Darke County",2,21,575,302,273
050,39,037,"Ohio","Darke County",2,22,581,295,286
050,39,037,"Ohio","Darke County",2,23,572,290,282
050,39,037,"Ohio","Darke County",2,24,575,289,286
050,39,037,"Ohio","Darke County",2,25,567,303,264
050,39,037,"Ohio","Darke County",2,26,567,313,254
050,39,037,"Ohio","Darke County",2,27,595,309,286
050,39,037,"Ohio","Darke County",2,28,596,308,288
050,39,037,"Ohio","Darke County",2,29,557,282,275
050,39,037,"Ohio","Darke County",2,30,557,277,280
050,39,037,"Ohio","Darke County",2,31,558,283,275
050,39,037,"Ohio","Darke County",2,32,551,291,260
050,39,037,"Ohio","Darke County",2,33,544,284,260
050,39,037,"Ohio","Darke County",2,34,548,268,280
050,39,037,"Ohio","Darke County",2,35,544,273,271
050,39,037,"Ohio","Darke County",2,36,542,278,264
050,39,037,"Ohio","Darke County",2,37,573,297,276
050,39,037,"Ohio","Darke County",2,38,578,290,288
050,39,037,"Ohio","Darke County",2,39,594,297,297
050,39,037,"Ohio","Darke County",2,40,623,312,311
050,39,037,"Ohio","Darke County",2,41,619,311,308
050,39,037,"Ohio","Darke County",2,42,614,310,304
050,39,037,"Ohio","Darke County",2,43,589,301,288
050,39,037,"Ohio","Darke County",2,44,547,284,263
050,39,037,"Ohio","Darke County",2,45,557,294,263
050,39,037,"Ohio","Darke County",2,46,575,302,273
050,39,037,"Ohio","Darke County",2,47,588,308,280
050,39,037,"Ohio","Darke County",2,48,629,313,316
050,39,037,"Ohio","Darke County",2,49,666,342,324
050,39,037,"Ohio","Darke County",2,50,652,347,305
050,39,037,"Ohio","Darke County",2,51,668,339,329
050,39,037,"Ohio","Darke County",2,52,634,318,316
050,39,037,"Ohio","Darke County",2,53,654,321,333
050,39,037,"Ohio","Darke County",2,54,674,327,347
050,39,037,"Ohio","Darke County",2,55,739,368,371
050,39,037,"Ohio","Darke County",2,56,782,393,389
050,39,037,"Ohio","Darke County",2,57,750,371,379
050,39,037,"Ohio","Darke County",2,58,737,378,359
050,39,037,"Ohio","Darke County",2,59,749,386,363
050,39,037,"Ohio","Darke County",2,60,755,371,384
050,39,037,"Ohio","Darke County",2,61,756,369,387
050,39,037,"Ohio","Darke County",2,62,747,382,365
050,39,037,"Ohio","Darke County",2,63,739,377,362
050,39,037,"Ohio","Darke County",2,64,696,354,342
050,39,037,"Ohio","Darke County",2,65,670,330,340
050,39,037,"Ohio","Darke County",2,66,639,321,318
050,39,037,"Ohio","Darke County",2,67,629,301,328
050,39,037,"Ohio","Darke County",2,68,611,287,324
050,39,037,"Ohio","Darke County",2,69,601,295,306
050,39,037,"Ohio","Darke County",2,70,575,280,295
050,39,037,"Ohio","Darke County",2,71,562,267,295
050,39,037,"Ohio","Darke County",2,72,541,253,288
050,39,037,"Ohio","Darke County",2,73,564,271,293
050,39,037,"Ohio","Darke County",2,74,380,179,201
050,39,037,"Ohio","Darke County",2,75,392,180,212
050,39,037,"Ohio","Darke County",2,76,408,183,225
050,39,037,"Ohio","Darke County",2,77,434,196,238
050,39,037,"Ohio","Darke County",2,78,376,169,207
050,39,037,"Ohio","Darke County",2,79,354,159,195
050,39,037,"Ohio","Darke County",2,80,323,135,188
050,39,037,"Ohio","Darke County",2,81,274,124,150
050,39,037,"Ohio","Darke County",2,82,259,114,145
050,39,037,"Ohio","Darke County",2,83,231,99,132
050,39,037,"Ohio","Darke County",2,84,212,93,119
050,39,037,"Ohio","Darke County",2,85,1262,422,840
050,39,037,"Ohio","Darke County",3,0,589,332,257
050,39,037,"Ohio","Darke County",3,1,611,307,304
050,39,037,"Ohio","Darke County",3,2,628,323,305
050,39,037,"Ohio","Darke County",3,3,645,330,315
050,39,037,"Ohio","Darke County",3,4,663,349,314
050,39,037,"Ohio","Darke County",3,5,635,333,302
050,39,037,"Ohio","Darke County",3,6,659,338,321
050,39,037,"Ohio","Darke County",3,7,665,345,320
050,39,037,"Ohio","Darke County",3,8,654,327,327
050,39,037,"Ohio","Darke County",3,9,662,336,326
050,39,037,"Ohio","Darke County",3,10,654,344,310
050,39,037,"Ohio","Darke County",3,11,697,365,332
050,39,037,"Ohio","Darke County",3,12,755,384,371
050,39,037,"Ohio","Darke County",3,13,777,413,364
050,39,037,"Ohio","Darke County",3,14,774,404,370
050,39,037,"Ohio","Darke County",3,15,748,366,382
050,39,037,"Ohio","Darke County",3,16,746,376,370
050,39,037,"Ohio","Darke County",3,17,770,389,381
050,39,037,"Ohio","Darke County",3,18,609,330,279
050,39,037,"Ohio","Darke County",3,19,486,262,224
050,39,037,"Ohio","Darke County",3,20,527,275,252
050,39,037,"Ohio","Darke County",3,21,579,299,280
050,39,037,"Ohio","Darke County",3,22,593,309,284
050,39,037,"Ohio","Darke County",3,23,589,308,281
050,39,037,"Ohio","Darke County",3,24,559,291,268
050,39,037,"Ohio","Darke County",3,25,571,280,291
050,39,037,"Ohio","Darke County",3,26,565,304,261
050,39,037,"Ohio","Darke County",3,27,550,303,247
050,39,037,"Ohio","Darke County",3,28,600,316,284
050,39,037,"Ohio","Darke County",3,29,584,301,283
050,39,037,"Ohio","Darke County",3,30,565,275,290
050,39,037,"Ohio","Darke County",3,31,564,281,283
050,39,037,"Ohio","Darke County",3,32,559,283,276
050,39,037,"Ohio","Darke County",3,33,563,299,264
050,39,037,"Ohio","Darke County",3,34,552,290,262
050,39,037,"Ohio","Darke County",3,35,555,264,291
050,39,037,"Ohio","Darke County",3,36,526,264,262
050,39,037,"Ohio","Darke County",3,37,563,291,272
050,39,037,"Ohio","Darke County",3,38,565,293,272
050,39,037,"Ohio","Darke County",3,39,579,297,282
050,39,037,"Ohio","Darke County",3,40,612,307,305
050,39,037,"Ohio","Darke County",3,41,633,321,312
050,39,037,"Ohio","Darke County",3,42,611,308,303
050,39,037,"Ohio","Darke County",3,43,610,312,298
050,39,037,"Ohio","Darke County",3,44,583,292,291
050,39,037,"Ohio","Darke County",3,45,539,280,259
050,39,037,"Ohio","Darke County",3,46,549,284,265
050,39,037,"Ohio","Darke County",3,47,562,300,262
050,39,037,"Ohio","Darke County",3,48,587,300,287
050,39,037,"Ohio","Darke County",3,49,630,308,322
050,39,037,"Ohio","Darke County",3,50,650,334,316
050,39,037,"Ohio","Darke County",3,51,656,344,312
050,39,037,"Ohio","Darke County",3,52,668,337,331
050,39,037,"Ohio","Darke County",3,53,635,325,310
050,39,037,"Ohio","Darke County",3,54,647,327,320
050,39,037,"Ohio","Darke County",3,55,678,330,348
050,39,037,"Ohio","Darke County",3,56,736,364,372
050,39,037,"Ohio","Darke County",3,57,771,385,386
050,39,037,"Ohio","Darke County",3,58,742,363,379
050,39,037,"Ohio","Darke County",3,59,725,369,356
050,39,037,"Ohio","Darke County",3,60,749,377,372
050,39,037,"Ohio","Darke County",3,61,737,356,381
050,39,037,"Ohio","Darke County",3,62,738,364,374
050,39,037,"Ohio","Darke County",3,63,748,381,367
050,39,037,"Ohio","Darke County",3,64,727,367,360
050,39,037,"Ohio","Darke County",3,65,683,349,334
050,39,037,"Ohio","Darke County",3,66,661,330,331
050,39,037,"Ohio","Darke County",3,67,617,304,313
050,39,037,"Ohio","Darke County",3,68,614,297,317
050,39,037,"Ohio","Darke County",3,69,586,273,313
050,39,037,"Ohio","Darke County",3,70,574,282,292
050,39,037,"Ohio","Darke County",3,71,557,267,290
050,39,037,"Ohio","Darke County",3,72,542,246,296
050,39,037,"Ohio","Darke County",3,73,528,240,288
050,39,037,"Ohio","Darke County",3,74,548,267,281
050,39,037,"Ohio","Darke County",3,75,370,171,199
050,39,037,"Ohio","Darke County",3,76,382,172,210
050,39,037,"Ohio","Darke County",3,77,382,171,211
050,39,037,"Ohio","Darke County",3,78,402,179,223
050,39,037,"Ohio","Darke County",3,79,358,157,201
050,39,037,"Ohio","Darke County",3,80,343,150,193
050,39,037,"Ohio","Darke County",3,81,288,120,168
050,39,037,"Ohio","Darke County",3,82,248,106,142
050,39,037,"Ohio","Darke County",3,83,242,100,142
050,39,037,"Ohio","Darke County",3,84,215,92,123
050,39,037,"Ohio","Darke County",3,85,1244,434,810
050,39,037,"Ohio","Darke County",4,0,572,308,264
050,39,037,"Ohio","Darke County",4,1,600,336,264
050,39,037,"Ohio","Darke County",4,2,623,308,315
050,39,037,"Ohio","Darke County",4,3,636,329,307
050,39,037,"Ohio","Darke County",4,4,654,335,319
050,39,037,"Ohio","Darke County",4,5,658,340,318
050,39,037,"Ohio","Darke County",4,6,641,334,307
050,39,037,"Ohio","Darke County",4,7,674,340,334
050,39,037,"Ohio","Darke County",4,8,670,351,319
050,39,037,"Ohio","Darke County",4,9,661,334,327
050,39,037,"Ohio","Darke County",4,10,661,335,326
050,39,037,"Ohio","Darke County",4,11,651,336,315
050,39,037,"Ohio","Darke County",4,12,726,368,358
050,39,037,"Ohio","Darke County",4,13,748,374,374
050,39,037,"Ohio","Darke County",4,14,783,422,361
050,39,037,"Ohio","Darke County",4,15,768,396,372
050,39,037,"Ohio","Darke County",4,16,755,367,388
050,39,037,"Ohio","Darke County",4,17,748,375,373
050,39,037,"Ohio","Darke County",4,18,648,346,302
050,39,037,"Ohio","Darke County",4,19,458,246,212
050,39,037,"Ohio","Darke County",4,20,503,268,235
050,39,037,"Ohio","Darke County",4,21,540,284,256
050,39,037,"Ohio","Darke County",4,22,599,301,298
050,39,037,"Ohio","Darke County",4,23,605,325,280
050,39,037,"Ohio","Darke County",4,24,587,308,279
050,39,037,"Ohio","Darke County",4,25,589,301,288
050,39,037,"Ohio","Darke County",4,26,581,289,292
050,39,037,"Ohio","Darke County",4,27,578,315,263
050,39,037,"Ohio","Darke County",4,28,553,307,246
050,39,037,"Ohio","Darke County",4,29,601,310,291
050,39,037,"Ohio","Darke County",4,30,587,308,279
050,39,037,"Ohio","Darke County",4,31,594,294,300
050,39,037,"Ohio","Darke County",4,32,564,285,279
050,39,037,"Ohio","Darke County",4,33,560,277,283
050,39,037,"Ohio","Darke County",4,34,574,307,267
050,39,037,"Ohio","Darke County",4,35,553,285,268
050,39,037,"Ohio","Darke County",4,36,566,274,292
050,39,037,"Ohio","Darke County",4,37,524,260,264
050,39,037,"Ohio","Darke County",4,38,573,287,286
050,39,037,"Ohio","Darke County",4,39,554,280,274
050,39,037,"Ohio","Darke County",4,40,588,300,288
050,39,037,"Ohio","Darke County",4,41,608,307,301
050,39,037,"Ohio","Darke County",4,42,626,325,301
050,39,037,"Ohio","Darke County",4,43,611,307,304
050,39,037,"Ohio","Darke County",4,44,608,311,297
050,39,037,"Ohio","Darke County",4,45,580,292,288
050,39,037,"Ohio","Darke County",4,46,537,276,261
050,39,037,"Ohio","Darke County",4,47,540,288,252
050,39,037,"Ohio","Darke County",4,48,572,305,267
050,39,037,"Ohio","Darke County",4,49,585,299,286
050,39,037,"Ohio","Darke County",4,50,619,302,317
050,39,037,"Ohio","Darke County",4,51,660,337,323
050,39,037,"Ohio","Darke County",4,52,645,338,307
050,39,037,"Ohio","Darke County",4,53,651,329,322
050,39,037,"Ohio","Darke County",4,54,618,315,303
050,39,037,"Ohio","Darke County",4,55,644,328,316
050,39,037,"Ohio","Darke County",4,56,665,322,343
050,39,037,"Ohio","Darke County",4,57,732,364,368
050,39,037,"Ohio","Darke County",4,58,771,389,382
050,39,037,"Ohio","Darke County",4,59,731,354,377
050,39,037,"Ohio","Darke County",4,60,718,357,361
050,39,037,"Ohio","Darke County",4,61,745,370,375
050,39,037,"Ohio","Darke County",4,62,725,353,372
050,39,037,"Ohio","Darke County",4,63,734,360,374
050,39,037,"Ohio","Darke County",4,64,742,380,362
050,39,037,"Ohio","Darke County",4,65,715,356,359
050,39,037,"Ohio","Darke County",4,66,675,347,328
050,39,037,"Ohio","Darke County",4,67,646,320,326
050,39,037,"Ohio","Darke County",4,68,610,301,309
050,39,037,"Ohio","Darke County",4,69,594,288,306
050,39,037,"Ohio","Darke County",4,70,562,257,305
050,39,037,"Ohio","Darke County",4,71,561,273,288
050,39,037,"Ohio","Darke County",4,72,545,256,289
050,39,037,"Ohio","Darke County",4,73,527,234,293
050,39,037,"Ohio","Darke County",4,74,507,234,273
050,39,037,"Ohio","Darke County",4,75,518,246,272
050,39,037,"Ohio","Darke County",4,76,360,163,197
050,39,037,"Ohio","Darke County",4,77,355,157,198
050,39,037,"Ohio","Darke County",4,78,359,156,203
050,39,037,"Ohio","Darke County",4,79,376,161,215
050,39,037,"Ohio","Darke County",4,80,356,152,204
050,39,037,"Ohio","Darke County",4,81,301,133,168
050,39,037,"Ohio","Darke County",4,82,270,107,163
050,39,037,"Ohio","Darke County",4,83,226,87,139
050,39,037,"Ohio","Darke County",4,84,220,92,128
050,39,037,"Ohio","Darke County",4,85,1268,456,812
050,39,037,"Ohio","Darke County",5,0,583,307,276
050,39,037,"Ohio","Darke County",5,1,597,322,275
050,39,037,"Ohio","Darke County",5,2,592,335,257
050,39,037,"Ohio","Darke County",5,3,641,319,322
050,39,037,"Ohio","Darke County",5,4,616,319,297
050,39,037,"Ohio","Darke County",5,5,655,346,309
050,39,037,"Ohio","Darke County",5,6,656,333,323
050,39,037,"Ohio","Darke County",5,7,639,332,307
050,39,037,"Ohio","Darke County",5,8,660,333,327
050,39,037,"Ohio","Darke County",5,9,659,341,318
050,39,037,"Ohio","Darke County",5,10,661,331,330
050,39,037,"Ohio","Darke County",5,11,669,335,334
050,39,037,"Ohio","Darke County",5,12,661,335,326
050,39,037,"Ohio","Darke County",5,13,713,366,347
050,39,037,"Ohio","Darke County",5,14,766,383,383
050,39,037,"Ohio","Darke County",5,15,793,417,376
050,39,037,"Ohio","Darke County",5,16,768,402,366
050,39,037,"Ohio","Darke County",5,17,757,364,393
050,39,037,"Ohio","Darke County",5,18,612,316,296
050,39,037,"Ohio","Darke County",5,19,491,261,230
050,39,037,"Ohio","Darke County",5,20,517,272,245
050,39,037,"Ohio","Darke County",5,21,538,289,249
050,39,037,"Ohio","Darke County",5,22,588,312,276
050,39,037,"Ohio","Darke County",5,23,596,298,298
050,39,037,"Ohio","Darke County",5,24,592,305,287
050,39,037,"Ohio","Darke County",5,25,589,310,279
050,39,037,"Ohio","Darke County",5,26,583,295,288
050,39,037,"Ohio","Darke County",5,27,603,297,306
050,39,037,"Ohio","Darke County",5,28,572,316,256
050,39,037,"Ohio","Darke County",5,29,548,313,235
050,39,037,"Ohio","Darke County",5,30,597,309,288
050,39,037,"Ohio","Darke County",5,31,600,315,285
050,39,037,"Ohio","Darke County",5,32,604,304,300
050,39,037,"Ohio","Darke County",5,33,575,294,281
050,39,037,"Ohio","Darke County",5,34,561,283,278
050,39,037,"Ohio","Darke County",5,35,582,305,277
050,39,037,"Ohio","Darke County",5,36,548,279,269
050,39,037,"Ohio","Darke County",5,37,561,270,291
050,39,037,"Ohio","Darke County",5,38,534,264,270
050,39,037,"Ohio","Darke County",5,39,569,294,275
050,39,037,"Ohio","Darke County",5,40,566,280,286
050,39,037,"Ohio","Darke County",5,41,591,301,290
050,39,037,"Ohio","Darke County",5,42,610,309,301
050,39,037,"Ohio","Darke County",5,43,629,325,304
050,39,037,"Ohio","Darke County",5,44,594,299,295
050,39,037,"Ohio","Darke County",5,45,601,306,295
050,39,037,"Ohio","Darke County",5,46,573,287,286
050,39,037,"Ohio","Darke County",5,47,554,285,269
050,39,037,"Ohio","Darke County",5,48,539,289,250
050,39,037,"Ohio","Darke County",5,49,570,304,266
050,39,037,"Ohio","Darke County",5,50,582,295,287
050,39,037,"Ohio","Darke County",5,51,619,299,320
050,39,037,"Ohio","Darke County",5,52,654,334,320
050,39,037,"Ohio","Darke County",5,53,642,336,306
050,39,037,"Ohio","Darke County",5,54,646,325,321
050,39,037,"Ohio","Darke County",5,55,608,308,300
050,39,037,"Ohio","Darke County",5,56,642,326,316
050,39,037,"Ohio","Darke County",5,57,673,327,346
050,39,037,"Ohio","Darke County",5,58,732,358,374
050,39,037,"Ohio","Darke County",5,59,771,386,385
050,39,037,"Ohio","Darke County",5,60,741,355,386
050,39,037,"Ohio","Darke County",5,61,704,349,355
050,39,037,"Ohio","Darke County",5,62,723,364,359
050,39,037,"Ohio","Darke County",5,63,724,347,377
050,39,037,"Ohio","Darke County",5,64,721,349,372
050,39,037,"Ohio","Darke County",5,65,732,375,357
050,39,037,"Ohio","Darke County",5,66,711,354,357
050,39,037,"Ohio","Darke County",5,67,664,342,322
050,39,037,"Ohio","Darke County",5,68,635,310,325
050,39,037,"Ohio","Darke County",5,69,594,294,300
050,39,037,"Ohio","Darke County",5,70,569,266,303
050,39,037,"Ohio","Darke County",5,71,553,251,302
050,39,037,"Ohio","Darke County",5,72,541,262,279
050,39,037,"Ohio","Darke County",5,73,529,243,286
050,39,037,"Ohio","Darke County",5,74,511,231,280
050,39,037,"Ohio","Darke County",5,75,491,222,269
050,39,037,"Ohio","Darke County",5,76,514,244,270
050,39,037,"Ohio","Darke County",5,77,336,151,185
050,39,037,"Ohio","Darke County",5,78,334,144,190
050,39,037,"Ohio","Darke County",5,79,336,137,199
050,39,037,"Ohio","Darke County",5,80,371,154,217
050,39,037,"Ohio","Darke County",5,81,316,136,180
050,39,037,"Ohio","Darke County",5,82,280,117,163
050,39,037,"Ohio","Darke County",5,83,246,90,156
050,39,037,"Ohio","Darke County",5,84,206,77,129
050,39,037,"Ohio","Darke County",5,85,1291,478,813
050,39,039,"Ohio","Defiance County",1,0,399,205,194
050,39,039,"Ohio","Defiance County",1,1,428,232,196
050,39,039,"Ohio","Defiance County",1,2,435,222,213
050,39,039,"Ohio","Defiance County",1,3,427,217,210
050,39,039,"Ohio","Defiance County",1,4,432,233,199
050,39,039,"Ohio","Defiance County",1,5,451,224,227
050,39,039,"Ohio","Defiance County",1,6,439,219,220
050,39,039,"Ohio","Defiance County",1,7,496,246,250
050,39,039,"Ohio","Defiance County",1,8,492,241,251
050,39,039,"Ohio","Defiance County",1,9,480,249,231
050,39,039,"Ohio","Defiance County",1,10,487,273,214
050,39,039,"Ohio","Defiance County",1,11,513,261,252
050,39,039,"Ohio","Defiance County",1,12,551,294,257
050,39,039,"Ohio","Defiance County",1,13,537,293,244
050,39,039,"Ohio","Defiance County",1,14,525,266,259
050,39,039,"Ohio","Defiance County",1,15,520,275,245
050,39,039,"Ohio","Defiance County",1,16,585,293,292
050,39,039,"Ohio","Defiance County",1,17,577,292,285
050,39,039,"Ohio","Defiance County",1,18,512,271,241
050,39,039,"Ohio","Defiance County",1,19,462,250,212
050,39,039,"Ohio","Defiance County",1,20,477,245,232
050,39,039,"Ohio","Defiance County",1,21,496,251,245
050,39,039,"Ohio","Defiance County",1,22,453,229,224
050,39,039,"Ohio","Defiance County",1,23,416,211,205
050,39,039,"Ohio","Defiance County",1,24,419,223,196
050,39,039,"Ohio","Defiance County",1,25,434,229,205
050,39,039,"Ohio","Defiance County",1,26,410,207,203
050,39,039,"Ohio","Defiance County",1,27,456,234,222
050,39,039,"Ohio","Defiance County",1,28,427,211,216
050,39,039,"Ohio","Defiance County",1,29,449,245,204
050,39,039,"Ohio","Defiance County",1,30,436,218,218
050,39,039,"Ohio","Defiance County",1,31,455,232,223
050,39,039,"Ohio","Defiance County",1,32,426,208,218
050,39,039,"Ohio","Defiance County",1,33,436,224,212
050,39,039,"Ohio","Defiance County",1,34,453,245,208
050,39,039,"Ohio","Defiance County",1,35,474,247,227
050,39,039,"Ohio","Defiance County",1,36,445,226,219
050,39,039,"Ohio","Defiance County",1,37,482,225,257
050,39,039,"Ohio","Defiance County",1,38,493,236,257
050,39,039,"Ohio","Defiance County",1,39,481,244,237
050,39,039,"Ohio","Defiance County",1,40,505,262,243
050,39,039,"Ohio","Defiance County",1,41,477,234,243
050,39,039,"Ohio","Defiance County",1,42,458,224,234
050,39,039,"Ohio","Defiance County",1,43,458,222,236
050,39,039,"Ohio","Defiance County",1,44,413,197,216
050,39,039,"Ohio","Defiance County",1,45,419,223,196
050,39,039,"Ohio","Defiance County",1,46,430,220,210
050,39,039,"Ohio","Defiance County",1,47,455,228,227
050,39,039,"Ohio","Defiance County",1,48,490,264,226
050,39,039,"Ohio","Defiance County",1,49,524,274,250
050,39,039,"Ohio","Defiance County",1,50,474,233,241
050,39,039,"Ohio","Defiance County",1,51,460,233,227
050,39,039,"Ohio","Defiance County",1,52,434,217,217
050,39,039,"Ohio","Defiance County",1,53,457,240,217
050,39,039,"Ohio","Defiance County",1,54,440,229,211
050,39,039,"Ohio","Defiance County",1,55,474,239,235
050,39,039,"Ohio","Defiance County",1,56,491,245,246
050,39,039,"Ohio","Defiance County",1,57,513,247,266
050,39,039,"Ohio","Defiance County",1,58,535,257,278
050,39,039,"Ohio","Defiance County",1,59,536,256,280
050,39,039,"Ohio","Defiance County",1,60,521,253,268
050,39,039,"Ohio","Defiance County",1,61,575,284,291
050,39,039,"Ohio","Defiance County",1,62,593,297,296
050,39,039,"Ohio","Defiance County",1,63,537,258,279
050,39,039,"Ohio","Defiance County",1,64,540,281,259
050,39,039,"Ohio","Defiance County",1,65,550,287,263
050,39,039,"Ohio","Defiance County",1,66,504,255,249
050,39,039,"Ohio","Defiance County",1,67,493,240,253
050,39,039,"Ohio","Defiance County",1,68,463,228,235
050,39,039,"Ohio","Defiance County",1,69,425,205,220
050,39,039,"Ohio","Defiance County",1,70,399,190,209
050,39,039,"Ohio","Defiance County",1,71,392,202,190
050,39,039,"Ohio","Defiance County",1,72,415,206,209
050,39,039,"Ohio","Defiance County",1,73,425,213,212
050,39,039,"Ohio","Defiance County",1,74,274,141,133
050,39,039,"Ohio","Defiance County",1,75,260,127,133
050,39,039,"Ohio","Defiance County",1,76,276,127,149
050,39,039,"Ohio","Defiance County",1,77,296,133,163
050,39,039,"Ohio","Defiance County",1,78,253,120,133
050,39,039,"Ohio","Defiance County",1,79,207,84,123
050,39,039,"Ohio","Defiance County",1,80,199,79,120
050,39,039,"Ohio","Defiance County",1,81,187,80,107
050,39,039,"Ohio","Defiance County",1,82,164,77,87
050,39,039,"Ohio","Defiance County",1,83,158,72,86
050,39,039,"Ohio","Defiance County",1,84,160,66,94
050,39,039,"Ohio","Defiance County",1,85,804,268,536
050,39,039,"Ohio","Defiance County",2,0,416,212,204
050,39,039,"Ohio","Defiance County",2,1,419,224,195
050,39,039,"Ohio","Defiance County",2,2,434,223,211
050,39,039,"Ohio","Defiance County",2,3,430,218,212
050,39,039,"Ohio","Defiance County",2,4,432,229,203
050,39,039,"Ohio","Defiance County",2,5,447,226,221
050,39,039,"Ohio","Defiance County",2,6,443,221,222
050,39,039,"Ohio","Defiance County",2,7,482,240,242
050,39,039,"Ohio","Defiance County",2,8,494,244,250
050,39,039,"Ohio","Defiance County",2,9,482,246,236
050,39,039,"Ohio","Defiance County",2,10,485,268,217
050,39,039,"Ohio","Defiance County",2,11,507,268,239
050,39,039,"Ohio","Defiance County",2,12,541,288,253
050,39,039,"Ohio","Defiance County",2,13,540,293,247
050,39,039,"Ohio","Defiance County",2,14,525,272,253
050,39,039,"Ohio","Defiance County",2,15,523,273,250
050,39,039,"Ohio","Defiance County",2,16,570,290,280
050,39,039,"Ohio","Defiance County",2,17,580,293,287
050,39,039,"Ohio","Defiance County",2,18,513,272,241
050,39,039,"Ohio","Defiance County",2,19,465,250,215
050,39,039,"Ohio","Defiance County",2,20,483,252,231
050,39,039,"Ohio","Defiance County",2,21,492,248,244
050,39,039,"Ohio","Defiance County",2,22,456,231,225
050,39,039,"Ohio","Defiance County",2,23,422,214,208
050,39,039,"Ohio","Defiance County",2,24,414,216,198
050,39,039,"Ohio","Defiance County",2,25,426,226,200
050,39,039,"Ohio","Defiance County",2,26,417,213,204
050,39,039,"Ohio","Defiance County",2,27,439,224,215
050,39,039,"Ohio","Defiance County",2,28,433,217,216
050,39,039,"Ohio","Defiance County",2,29,446,238,208
050,39,039,"Ohio","Defiance County",2,30,440,224,216
050,39,039,"Ohio","Defiance County",2,31,449,227,222
050,39,039,"Ohio","Defiance County",2,32,434,215,219
050,39,039,"Ohio","Defiance County",2,33,436,221,215
050,39,039,"Ohio","Defiance County",2,34,452,242,210
050,39,039,"Ohio","Defiance County",2,35,474,249,225
050,39,039,"Ohio","Defiance County",2,36,447,230,217
050,39,039,"Ohio","Defiance County",2,37,474,225,249
050,39,039,"Ohio","Defiance County",2,38,489,232,257
050,39,039,"Ohio","Defiance County",2,39,482,243,239
050,39,039,"Ohio","Defiance County",2,40,503,260,243
050,39,039,"Ohio","Defiance County",2,41,482,241,241
050,39,039,"Ohio","Defiance County",2,42,461,226,235
050,39,039,"Ohio","Defiance County",2,43,460,223,237
050,39,039,"Ohio","Defiance County",2,44,419,201,218
050,39,039,"Ohio","Defiance County",2,45,418,218,200
050,39,039,"Ohio","Defiance County",2,46,424,219,205
050,39,039,"Ohio","Defiance County",2,47,443,223,220
050,39,039,"Ohio","Defiance County",2,48,479,255,224
050,39,039,"Ohio","Defiance County",2,49,519,273,246
050,39,039,"Ohio","Defiance County",2,50,487,243,244
050,39,039,"Ohio","Defiance County",2,51,463,235,228
050,39,039,"Ohio","Defiance County",2,52,438,220,218
050,39,039,"Ohio","Defiance County",2,53,453,235,218
050,39,039,"Ohio","Defiance County",2,54,442,231,211
050,39,039,"Ohio","Defiance County",2,55,468,239,229
050,39,039,"Ohio","Defiance County",2,56,491,246,245
050,39,039,"Ohio","Defiance County",2,57,511,249,262
050,39,039,"Ohio","Defiance County",2,58,528,252,276
050,39,039,"Ohio","Defiance County",2,59,538,255,283
050,39,039,"Ohio","Defiance County",2,60,520,252,268
050,39,039,"Ohio","Defiance County",2,61,560,276,284
050,39,039,"Ohio","Defiance County",2,62,589,293,296
050,39,039,"Ohio","Defiance County",2,63,553,268,285
050,39,039,"Ohio","Defiance County",2,64,533,273,260
050,39,039,"Ohio","Defiance County",2,65,543,282,261
050,39,039,"Ohio","Defiance County",2,66,512,261,251
050,39,039,"Ohio","Defiance County",2,67,493,241,252
050,39,039,"Ohio","Defiance County",2,68,463,227,236
050,39,039,"Ohio","Defiance County",2,69,435,211,224
050,39,039,"Ohio","Defiance County",2,70,403,192,211
050,39,039,"Ohio","Defiance County",2,71,393,196,197
050,39,039,"Ohio","Defiance County",2,72,400,202,198
050,39,039,"Ohio","Defiance County",2,73,441,221,220
050,39,039,"Ohio","Defiance County",2,74,288,145,143
050,39,039,"Ohio","Defiance County",2,75,264,130,134
050,39,039,"Ohio","Defiance County",2,76,269,123,146
050,39,039,"Ohio","Defiance County",2,77,295,133,162
050,39,039,"Ohio","Defiance County",2,78,255,119,136
050,39,039,"Ohio","Defiance County",2,79,217,92,125
050,39,039,"Ohio","Defiance County",2,80,200,81,119
050,39,039,"Ohio","Defiance County",2,81,185,76,109
050,39,039,"Ohio","Defiance County",2,82,172,79,93
050,39,039,"Ohio","Defiance County",2,83,152,69,83
050,39,039,"Ohio","Defiance County",2,84,158,67,91
050,39,039,"Ohio","Defiance County",2,85,809,271,538
050,39,039,"Ohio","Defiance County",3,0,397,212,185
050,39,039,"Ohio","Defiance County",3,1,419,211,208
050,39,039,"Ohio","Defiance County",3,2,425,222,203
050,39,039,"Ohio","Defiance County",3,3,452,241,211
050,39,039,"Ohio","Defiance County",3,4,428,219,209
050,39,039,"Ohio","Defiance County",3,5,459,244,215
050,39,039,"Ohio","Defiance County",3,6,437,219,218
050,39,039,"Ohio","Defiance County",3,7,449,225,224
050,39,039,"Ohio","Defiance County",3,8,499,245,254
050,39,039,"Ohio","Defiance County",3,9,501,249,252
050,39,039,"Ohio","Defiance County",3,10,492,258,234
050,39,039,"Ohio","Defiance County",3,11,491,278,213
050,39,039,"Ohio","Defiance County",3,12,523,267,256
050,39,039,"Ohio","Defiance County",3,13,550,284,266
050,39,039,"Ohio","Defiance County",3,14,541,289,252
050,39,039,"Ohio","Defiance County",3,15,524,266,258
050,39,039,"Ohio","Defiance County",3,16,530,270,260
050,39,039,"Ohio","Defiance County",3,17,567,289,278
050,39,039,"Ohio","Defiance County",3,18,534,280,254
050,39,039,"Ohio","Defiance County",3,19,474,253,221
050,39,039,"Ohio","Defiance County",3,20,477,253,224
050,39,039,"Ohio","Defiance County",3,21,478,244,234
050,39,039,"Ohio","Defiance County",3,22,469,233,236
050,39,039,"Ohio","Defiance County",3,23,430,232,198
050,39,039,"Ohio","Defiance County",3,24,394,202,192
050,39,039,"Ohio","Defiance County",3,25,398,208,190
050,39,039,"Ohio","Defiance County",3,26,417,217,200
050,39,039,"Ohio","Defiance County",3,27,432,225,207
050,39,039,"Ohio","Defiance County",3,28,451,234,217
050,39,039,"Ohio","Defiance County",3,29,441,228,213
050,39,039,"Ohio","Defiance County",3,30,456,233,223
050,39,039,"Ohio","Defiance County",3,31,449,229,220
050,39,039,"Ohio","Defiance County",3,32,461,226,235
050,39,039,"Ohio","Defiance County",3,33,451,224,227
050,39,039,"Ohio","Defiance County",3,34,433,216,217
050,39,039,"Ohio","Defiance County",3,35,459,250,209
050,39,039,"Ohio","Defiance County",3,36,493,261,232
050,39,039,"Ohio","Defiance County",3,37,448,227,221
050,39,039,"Ohio","Defiance County",3,38,492,236,256
050,39,039,"Ohio","Defiance County",3,39,478,230,248
050,39,039,"Ohio","Defiance County",3,40,483,243,240
050,39,039,"Ohio","Defiance County",3,41,512,269,243
050,39,039,"Ohio","Defiance County",3,42,482,247,235
050,39,039,"Ohio","Defiance County",3,43,454,222,232
050,39,039,"Ohio","Defiance County",3,44,457,220,237
050,39,039,"Ohio","Defiance County",3,45,417,199,218
050,39,039,"Ohio","Defiance County",3,46,411,211,200
050,39,039,"Ohio","Defiance County",3,47,432,223,209
050,39,039,"Ohio","Defiance County",3,48,438,218,220
050,39,039,"Ohio","Defiance County",3,49,484,259,225
050,39,039,"Ohio","Defiance County",3,50,528,278,250
050,39,039,"Ohio","Defiance County",3,51,496,250,246
050,39,039,"Ohio","Defiance County",3,52,448,221,227
050,39,039,"Ohio","Defiance County",3,53,441,224,217
050,39,039,"Ohio","Defiance County",3,54,449,230,219
050,39,039,"Ohio","Defiance County",3,55,429,227,202
050,39,039,"Ohio","Defiance County",3,56,463,233,230
050,39,039,"Ohio","Defiance County",3,57,494,254,240
050,39,039,"Ohio","Defiance County",3,58,498,239,259
050,39,039,"Ohio","Defiance County",3,59,510,240,270
050,39,039,"Ohio","Defiance County",3,60,527,252,275
050,39,039,"Ohio","Defiance County",3,61,505,249,256
050,39,039,"Ohio","Defiance County",3,62,553,272,281
050,39,039,"Ohio","Defiance County",3,63,576,286,290
050,39,039,"Ohio","Defiance County",3,64,536,256,280
050,39,039,"Ohio","Defiance County",3,65,524,262,262
050,39,039,"Ohio","Defiance County",3,66,526,273,253
050,39,039,"Ohio","Defiance County",3,67,511,255,256
050,39,039,"Ohio","Defiance County",3,68,479,242,237
050,39,039,"Ohio","Defiance County",3,69,445,216,229
050,39,039,"Ohio","Defiance County",3,70,427,210,217
050,39,039,"Ohio","Defiance County",3,71,386,181,205
050,39,039,"Ohio","Defiance County",3,72,383,190,193
050,39,039,"Ohio","Defiance County",3,73,380,194,186
050,39,039,"Ohio","Defiance County",3,74,428,210,218
050,39,039,"Ohio","Defiance County",3,75,277,143,134
050,39,039,"Ohio","Defiance County",3,76,257,123,134
050,39,039,"Ohio","Defiance County",3,77,249,108,141
050,39,039,"Ohio","Defiance County",3,78,273,125,148
050,39,039,"Ohio","Defiance County",3,79,244,109,135
050,39,039,"Ohio","Defiance County",3,80,205,87,118
050,39,039,"Ohio","Defiance County",3,81,184,75,109
050,39,039,"Ohio","Defiance County",3,82,177,69,108
050,39,039,"Ohio","Defiance County",3,83,147,68,79
050,39,039,"Ohio","Defiance County",3,84,135,57,78
050,39,039,"Ohio","Defiance County",3,85,811,271,540
050,39,039,"Ohio","Defiance County",4,0,395,205,190
050,39,039,"Ohio","Defiance County",4,1,414,213,201
050,39,039,"Ohio","Defiance County",4,2,440,221,219
050,39,039,"Ohio","Defiance County",4,3,434,226,208
050,39,039,"Ohio","Defiance County",4,4,462,244,218
050,39,039,"Ohio","Defiance County",4,5,444,230,214
050,39,039,"Ohio","Defiance County",4,6,443,234,209
050,39,039,"Ohio","Defiance County",4,7,459,232,227
050,39,039,"Ohio","Defiance County",4,8,451,224,227
050,39,039,"Ohio","Defiance County",4,9,505,254,251
050,39,039,"Ohio","Defiance County",4,10,494,246,248
050,39,039,"Ohio","Defiance County",4,11,487,251,236
050,39,039,"Ohio","Defiance County",4,12,512,283,229
050,39,039,"Ohio","Defiance County",4,13,525,280,245
050,39,039,"Ohio","Defiance County",4,14,561,296,265
050,39,039,"Ohio","Defiance County",4,15,537,287,250
050,39,039,"Ohio","Defiance County",4,16,519,269,250
050,39,039,"Ohio","Defiance County",4,17,528,271,257
050,39,039,"Ohio","Defiance County",4,18,526,276,250
050,39,039,"Ohio","Defiance County",4,19,467,249,218
050,39,039,"Ohio","Defiance County",4,20,474,263,211
050,39,039,"Ohio","Defiance County",4,21,484,245,239
050,39,039,"Ohio","Defiance County",4,22,473,239,234
050,39,039,"Ohio","Defiance County",4,23,477,255,222
050,39,039,"Ohio","Defiance County",4,24,400,216,184
050,39,039,"Ohio","Defiance County",4,25,383,193,190
050,39,039,"Ohio","Defiance County",4,26,396,208,188
050,39,039,"Ohio","Defiance County",4,27,414,206,208
050,39,039,"Ohio","Defiance County",4,28,457,238,219
050,39,039,"Ohio","Defiance County",4,29,464,253,211
050,39,039,"Ohio","Defiance County",4,30,429,220,209
050,39,039,"Ohio","Defiance County",4,31,464,233,231
050,39,039,"Ohio","Defiance County",4,32,446,228,218
050,39,039,"Ohio","Defiance County",4,33,469,239,230
050,39,039,"Ohio","Defiance County",4,34,460,230,230
050,39,039,"Ohio","Defiance County",4,35,442,228,214
050,39,039,"Ohio","Defiance County",4,36,471,264,207
050,39,039,"Ohio","Defiance County",4,37,478,244,234
050,39,039,"Ohio","Defiance County",4,38,475,250,225
050,39,039,"Ohio","Defiance County",4,39,493,239,254
050,39,039,"Ohio","Defiance County",4,40,474,230,244
050,39,039,"Ohio","Defiance County",4,41,480,241,239
050,39,039,"Ohio","Defiance County",4,42,515,285,230
050,39,039,"Ohio","Defiance County",4,43,486,255,231
050,39,039,"Ohio","Defiance County",4,44,442,215,227
050,39,039,"Ohio","Defiance County",4,45,460,224,236
050,39,039,"Ohio","Defiance County",4,46,421,204,217
050,39,039,"Ohio","Defiance County",4,47,405,206,199
050,39,039,"Ohio","Defiance County",4,48,436,222,214
050,39,039,"Ohio","Defiance County",4,49,433,213,220
050,39,039,"Ohio","Defiance County",4,50,472,250,222
050,39,039,"Ohio","Defiance County",4,51,522,279,243
050,39,039,"Ohio","Defiance County",4,52,485,233,252
050,39,039,"Ohio","Defiance County",4,53,444,219,225
050,39,039,"Ohio","Defiance County",4,54,439,218,221
050,39,039,"Ohio","Defiance County",4,55,447,228,219
050,39,039,"Ohio","Defiance County",4,56,433,225,208
050,39,039,"Ohio","Defiance County",4,57,467,230,237
050,39,039,"Ohio","Defiance County",4,58,486,254,232
050,39,039,"Ohio","Defiance County",4,59,490,234,256
050,39,039,"Ohio","Defiance County",4,60,498,236,262
050,39,039,"Ohio","Defiance County",4,61,501,241,260
050,39,039,"Ohio","Defiance County",4,62,500,247,253
050,39,039,"Ohio","Defiance County",4,63,539,266,273
050,39,039,"Ohio","Defiance County",4,64,575,286,289
050,39,039,"Ohio","Defiance County",4,65,535,254,281
050,39,039,"Ohio","Defiance County",4,66,517,257,260
050,39,039,"Ohio","Defiance County",4,67,515,256,259
050,39,039,"Ohio","Defiance County",4,68,493,246,247
050,39,039,"Ohio","Defiance County",4,69,468,235,233
050,39,039,"Ohio","Defiance County",4,70,440,214,226
050,39,039,"Ohio","Defiance County",4,71,412,202,210
050,39,039,"Ohio","Defiance County",4,72,377,173,204
050,39,039,"Ohio","Defiance County",4,73,368,182,186
050,39,039,"Ohio","Defiance County",4,74,370,184,186
050,39,039,"Ohio","Defiance County",4,75,416,205,211
050,39,039,"Ohio","Defiance County",4,76,274,138,136
050,39,039,"Ohio","Defiance County",4,77,242,112,130
050,39,039,"Ohio","Defiance County",4,78,239,106,133
050,39,039,"Ohio","Defiance County",4,79,255,108,147
050,39,039,"Ohio","Defiance County",4,80,238,109,129
050,39,039,"Ohio","Defiance County",4,81,194,82,112
050,39,039,"Ohio","Defiance County",4,82,174,69,105
050,39,039,"Ohio","Defiance County",4,83,161,66,95
050,39,039,"Ohio","Defiance County",4,84,137,63,74
050,39,039,"Ohio","Defiance County",4,85,801,266,535
050,39,039,"Ohio","Defiance County",5,0,400,208,192
050,39,039,"Ohio","Defiance County",5,1,412,203,209
050,39,039,"Ohio","Defiance County",5,2,416,226,190
050,39,039,"Ohio","Defiance County",5,3,447,230,217
050,39,039,"Ohio","Defiance County",5,4,450,236,214
050,39,039,"Ohio","Defiance County",5,5,472,249,223
050,39,039,"Ohio","Defiance County",5,6,456,231,225
050,39,039,"Ohio","Defiance County",5,7,455,244,211
050,39,039,"Ohio","Defiance County",5,8,454,234,220
050,39,039,"Ohio","Defiance County",5,9,450,233,217
050,39,039,"Ohio","Defiance County",5,10,511,254,257
050,39,039,"Ohio","Defiance County",5,11,503,250,253
050,39,039,"Ohio","Defiance County",5,12,504,266,238
050,39,039,"Ohio","Defiance County",5,13,509,282,227
050,39,039,"Ohio","Defiance County",5,14,534,284,250
050,39,039,"Ohio","Defiance County",5,15,561,284,277
050,39,039,"Ohio","Defiance County",5,16,532,277,255
050,39,039,"Ohio","Defiance County",5,17,527,263,264
050,39,039,"Ohio","Defiance County",5,18,496,270,226
050,39,039,"Ohio","Defiance County",5,19,463,247,216
050,39,039,"Ohio","Defiance County",5,20,475,256,219
050,39,039,"Ohio","Defiance County",5,21,499,271,228
050,39,039,"Ohio","Defiance County",5,22,478,242,236
050,39,039,"Ohio","Defiance County",5,23,499,275,224
050,39,039,"Ohio","Defiance County",5,24,474,250,224
050,39,039,"Ohio","Defiance County",5,25,389,207,182
050,39,039,"Ohio","Defiance County",5,26,384,182,202
050,39,039,"Ohio","Defiance County",5,27,404,208,196
050,39,039,"Ohio","Defiance County",5,28,419,219,200
050,39,039,"Ohio","Defiance County",5,29,464,242,222
050,39,039,"Ohio","Defiance County",5,30,479,259,220
050,39,039,"Ohio","Defiance County",5,31,443,225,218
050,39,039,"Ohio","Defiance County",5,32,458,227,231
050,39,039,"Ohio","Defiance County",5,33,460,233,227
050,39,039,"Ohio","Defiance County",5,34,460,235,225
050,39,039,"Ohio","Defiance County",5,35,471,240,231
050,39,039,"Ohio","Defiance County",5,36,436,227,209
050,39,039,"Ohio","Defiance County",5,37,482,272,210
050,39,039,"Ohio","Defiance County",5,38,530,283,247
050,39,039,"Ohio","Defiance County",5,39,482,253,229
050,39,039,"Ohio","Defiance County",5,40,500,241,259
050,39,039,"Ohio","Defiance County",5,41,482,227,255
050,39,039,"Ohio","Defiance County",5,42,482,243,239
050,39,039,"Ohio","Defiance County",5,43,516,279,237
050,39,039,"Ohio","Defiance County",5,44,500,262,238
050,39,039,"Ohio","Defiance County",5,45,443,221,222
050,39,039,"Ohio","Defiance County",5,46,460,219,241
050,39,039,"Ohio","Defiance County",5,47,424,208,216
050,39,039,"Ohio","Defiance County",5,48,406,205,201
050,39,039,"Ohio","Defiance County",5,49,427,216,211
050,39,039,"Ohio","Defiance County",5,50,419,204,215
050,39,039,"Ohio","Defiance County",5,51,471,249,222
050,39,039,"Ohio","Defiance County",5,52,516,272,244
050,39,039,"Ohio","Defiance County",5,53,490,239,251
050,39,039,"Ohio","Defiance County",5,54,443,213,230
050,39,039,"Ohio","Defiance County",5,55,437,216,221
050,39,039,"Ohio","Defiance County",5,56,445,223,222
050,39,039,"Ohio","Defiance County",5,57,435,225,210
050,39,039,"Ohio","Defiance County",5,58,460,227,233
050,39,039,"Ohio","Defiance County",5,59,479,244,235
050,39,039,"Ohio","Defiance County",5,60,470,227,243
050,39,039,"Ohio","Defiance County",5,61,485,224,261
050,39,039,"Ohio","Defiance County",5,62,507,244,263
050,39,039,"Ohio","Defiance County",5,63,498,245,253
050,39,039,"Ohio","Defiance County",5,64,531,260,271
050,39,039,"Ohio","Defiance County",5,65,562,281,281
050,39,039,"Ohio","Defiance County",5,66,524,245,279
050,39,039,"Ohio","Defiance County",5,67,515,247,268
050,39,039,"Ohio","Defiance County",5,68,501,257,244
050,39,039,"Ohio","Defiance County",5,69,480,238,242
050,39,039,"Ohio","Defiance County",5,70,462,233,229
050,39,039,"Ohio","Defiance County",5,71,422,204,218
050,39,039,"Ohio","Defiance County",5,72,402,195,207
050,39,039,"Ohio","Defiance County",5,73,366,166,200
050,39,039,"Ohio","Defiance County",5,74,358,175,183
050,39,039,"Ohio","Defiance County",5,75,362,184,178
050,39,039,"Ohio","Defiance County",5,76,405,198,207
050,39,039,"Ohio","Defiance County",5,77,262,130,132
050,39,039,"Ohio","Defiance County",5,78,231,113,118
050,39,039,"Ohio","Defiance County",5,79,221,92,129
050,39,039,"Ohio","Defiance County",5,80,247,107,140
050,39,039,"Ohio","Defiance County",5,81,224,103,121
050,39,039,"Ohio","Defiance County",5,82,190,78,112
050,39,039,"Ohio","Defiance County",5,83,151,61,90
050,39,039,"Ohio","Defiance County",5,84,149,59,90
050,39,039,"Ohio","Defiance County",5,85,817,279,538
050,39,041,"Ohio","Delaware County",1,0,2112,1087,1025
050,39,041,"Ohio","Delaware County",1,1,2316,1193,1123
050,39,041,"Ohio","Delaware County",1,2,2459,1300,1159
050,39,041,"Ohio","Delaware County",1,3,2715,1403,1312
050,39,041,"Ohio","Delaware County",1,4,2852,1453,1399
050,39,041,"Ohio","Delaware County",1,5,2920,1464,1456
050,39,041,"Ohio","Delaware County",1,6,3060,1562,1498
050,39,041,"Ohio","Delaware County",1,7,3064,1568,1496
050,39,041,"Ohio","Delaware County",1,8,3178,1610,1568
050,39,041,"Ohio","Delaware County",1,9,3208,1657,1551
050,39,041,"Ohio","Delaware County",1,10,3256,1663,1593
050,39,041,"Ohio","Delaware County",1,11,3323,1743,1580
050,39,041,"Ohio","Delaware County",1,12,3375,1731,1644
050,39,041,"Ohio","Delaware County",1,13,3498,1790,1708
050,39,041,"Ohio","Delaware County",1,14,3546,1846,1700
050,39,041,"Ohio","Delaware County",1,15,3563,1838,1725
050,39,041,"Ohio","Delaware County",1,16,3574,1827,1747
050,39,041,"Ohio","Delaware County",1,17,3434,1768,1666
050,39,041,"Ohio","Delaware County",1,18,2947,1532,1415
050,39,041,"Ohio","Delaware County",1,19,2509,1297,1212
050,39,041,"Ohio","Delaware County",1,20,2526,1286,1240
050,39,041,"Ohio","Delaware County",1,21,2447,1266,1181
050,39,041,"Ohio","Delaware County",1,22,2301,1151,1150
050,39,041,"Ohio","Delaware County",1,23,2077,1056,1021
050,39,041,"Ohio","Delaware County",1,24,1895,970,925
050,39,041,"Ohio","Delaware County",1,25,1858,938,920
050,39,041,"Ohio","Delaware County",1,26,1734,890,844
050,39,041,"Ohio","Delaware County",1,27,1715,867,848
050,39,041,"Ohio","Delaware County",1,28,1734,844,890
050,39,041,"Ohio","Delaware County",1,29,1844,876,968
050,39,041,"Ohio","Delaware County",1,30,2009,964,1045
050,39,041,"Ohio","Delaware County",1,31,2201,1064,1137
050,39,041,"Ohio","Delaware County",1,32,2253,1120,1133
050,39,041,"Ohio","Delaware County",1,33,2482,1202,1280
050,39,041,"Ohio","Delaware County",1,34,2740,1310,1430
050,39,041,"Ohio","Delaware County",1,35,2876,1382,1494
050,39,041,"Ohio","Delaware County",1,36,3042,1496,1546
050,39,041,"Ohio","Delaware County",1,37,3215,1611,1604
050,39,041,"Ohio","Delaware County",1,38,3366,1676,1690
050,39,041,"Ohio","Delaware County",1,39,3453,1764,1689
050,39,041,"Ohio","Delaware County",1,40,3371,1700,1671
050,39,041,"Ohio","Delaware County",1,41,3383,1703,1680
050,39,041,"Ohio","Delaware County",1,42,3303,1647,1656
050,39,041,"Ohio","Delaware County",1,43,3256,1652,1604
050,39,041,"Ohio","Delaware County",1,44,3286,1678,1608
050,39,041,"Ohio","Delaware County",1,45,3279,1682,1597
050,39,041,"Ohio","Delaware County",1,46,3233,1654,1579
050,39,041,"Ohio","Delaware County",1,47,3325,1719,1606
050,39,041,"Ohio","Delaware County",1,48,3506,1783,1723
050,39,041,"Ohio","Delaware County",1,49,3687,1904,1783
050,39,041,"Ohio","Delaware County",1,50,3400,1740,1660
050,39,041,"Ohio","Delaware County",1,51,3191,1642,1549
050,39,041,"Ohio","Delaware County",1,52,3002,1538,1464
050,39,041,"Ohio","Delaware County",1,53,2910,1492,1418
050,39,041,"Ohio","Delaware County",1,54,2858,1449,1409
050,39,041,"Ohio","Delaware County",1,55,2832,1430,1402
050,39,041,"Ohio","Delaware County",1,56,2872,1447,1425
050,39,041,"Ohio","Delaware County",1,57,2772,1384,1388
050,39,041,"Ohio","Delaware County",1,58,2770,1406,1364
050,39,041,"Ohio","Delaware County",1,59,2650,1370,1280
050,39,041,"Ohio","Delaware County",1,60,2528,1283,1245
050,39,041,"Ohio","Delaware County",1,61,2500,1223,1277
050,39,041,"Ohio","Delaware County",1,62,2509,1219,1290
050,39,041,"Ohio","Delaware County",1,63,2399,1157,1242
050,39,041,"Ohio","Delaware County",1,64,2304,1130,1174
050,39,041,"Ohio","Delaware County",1,65,2207,1077,1130
050,39,041,"Ohio","Delaware County",1,66,2171,1059,1112
050,39,041,"Ohio","Delaware County",1,67,2097,1049,1048
050,39,041,"Ohio","Delaware County",1,68,2086,1033,1053
050,39,041,"Ohio","Delaware County",1,69,1967,940,1027
050,39,041,"Ohio","Delaware County",1,70,1881,900,981
050,39,041,"Ohio","Delaware County",1,71,1819,851,968
050,39,041,"Ohio","Delaware County",1,72,1873,894,979
050,39,041,"Ohio","Delaware County",1,73,1877,922,955
050,39,041,"Ohio","Delaware County",1,74,1236,575,661
050,39,041,"Ohio","Delaware County",1,75,1128,513,615
050,39,041,"Ohio","Delaware County",1,76,1133,516,617
050,39,041,"Ohio","Delaware County",1,77,1129,515,614
050,39,041,"Ohio","Delaware County",1,78,928,411,517
050,39,041,"Ohio","Delaware County",1,79,807,366,441
050,39,041,"Ohio","Delaware County",1,80,728,317,411
050,39,041,"Ohio","Delaware County",1,81,705,315,390
050,39,041,"Ohio","Delaware County",1,82,646,287,359
050,39,041,"Ohio","Delaware County",1,83,560,232,328
050,39,041,"Ohio","Delaware County",1,84,493,205,288
050,39,041,"Ohio","Delaware County",1,85,2861,1063,1798
050,39,041,"Ohio","Delaware County",2,0,2122,1093,1029
050,39,041,"Ohio","Delaware County",2,1,2302,1185,1117
050,39,041,"Ohio","Delaware County",2,2,2467,1297,1170
050,39,041,"Ohio","Delaware County",2,3,2676,1389,1287
050,39,041,"Ohio","Delaware County",2,4,2859,1460,1399
050,39,041,"Ohio","Delaware County",2,5,2927,1473,1454
050,39,041,"Ohio","Delaware County",2,6,3052,1553,1499
050,39,041,"Ohio","Delaware County",2,7,3080,1574,1506
050,39,041,"Ohio","Delaware County",2,8,3156,1607,1549
050,39,041,"Ohio","Delaware County",2,9,3208,1650,1558
050,39,041,"Ohio","Delaware County",2,10,3260,1669,1591
050,39,041,"Ohio","Delaware County",2,11,3305,1722,1583
050,39,041,"Ohio","Delaware County",2,12,3388,1744,1644
050,39,041,"Ohio","Delaware County",2,13,3476,1778,1698
050,39,041,"Ohio","Delaware County",2,14,3540,1834,1706
050,39,041,"Ohio","Delaware County",2,15,3568,1847,1721
050,39,041,"Ohio","Delaware County",2,16,3582,1833,1749
050,39,041,"Ohio","Delaware County",2,17,3476,1787,1689
050,39,041,"Ohio","Delaware County",2,18,2935,1530,1405
050,39,041,"Ohio","Delaware County",2,19,2535,1306,1229
050,39,041,"Ohio","Delaware County",2,20,2577,1312,1265
050,39,041,"Ohio","Delaware County",2,21,2465,1265,1200
050,39,041,"Ohio","Delaware County",2,22,2320,1169,1151
050,39,041,"Ohio","Delaware County",2,23,2098,1063,1035
050,39,041,"Ohio","Delaware County",2,24,1927,985,942
050,39,041,"Ohio","Delaware County",2,25,1860,939,921
050,39,041,"Ohio","Delaware County",2,26,1768,905,863
050,39,041,"Ohio","Delaware County",2,27,1738,879,859
050,39,041,"Ohio","Delaware County",2,28,1767,863,904
050,39,041,"Ohio","Delaware County",2,29,1856,887,969
050,39,041,"Ohio","Delaware County",2,30,2027,972,1055
050,39,041,"Ohio","Delaware County",2,31,2176,1055,1121
050,39,041,"Ohio","Delaware County",2,32,2274,1122,1152
050,39,041,"Ohio","Delaware County",2,33,2468,1204,1264
050,39,041,"Ohio","Delaware County",2,34,2718,1303,1415
050,39,041,"Ohio","Delaware County",2,35,2900,1397,1503
050,39,041,"Ohio","Delaware County",2,36,3018,1479,1539
050,39,041,"Ohio","Delaware County",2,37,3216,1603,1613
050,39,041,"Ohio","Delaware County",2,38,3382,1694,1688
050,39,041,"Ohio","Delaware County",2,39,3451,1758,1693
050,39,041,"Ohio","Delaware County",2,40,3440,1743,1697
050,39,041,"Ohio","Delaware County",2,41,3392,1706,1686
050,39,041,"Ohio","Delaware County",2,42,3328,1667,1661
050,39,041,"Ohio","Delaware County",2,43,3306,1671,1635
050,39,041,"Ohio","Delaware County",2,44,3263,1666,1597
050,39,041,"Ohio","Delaware County",2,45,3313,1699,1614
050,39,041,"Ohio","Delaware County",2,46,3242,1664,1578
050,39,041,"Ohio","Delaware County",2,47,3304,1704,1600
050,39,041,"Ohio","Delaware County",2,48,3466,1769,1697
050,39,041,"Ohio","Delaware County",2,49,3657,1883,1774
050,39,041,"Ohio","Delaware County",2,50,3470,1780,1690
050,39,041,"Ohio","Delaware County",2,51,3235,1662,1573
050,39,041,"Ohio","Delaware County",2,52,3043,1562,1481
050,39,041,"Ohio","Delaware County",2,53,2943,1509,1434
050,39,041,"Ohio","Delaware County",2,54,2863,1456,1407
050,39,041,"Ohio","Delaware County",2,55,2829,1428,1401
050,39,041,"Ohio","Delaware County",2,56,2870,1447,1423
050,39,041,"Ohio","Delaware County",2,57,2799,1399,1400
050,39,041,"Ohio","Delaware County",2,58,2767,1399,1368
050,39,041,"Ohio","Delaware County",2,59,2683,1379,1304
050,39,041,"Ohio","Delaware County",2,60,2553,1304,1249
050,39,041,"Ohio","Delaware County",2,61,2504,1233,1271
050,39,041,"Ohio","Delaware County",2,62,2506,1220,1286
050,39,041,"Ohio","Delaware County",2,63,2451,1183,1268
050,39,041,"Ohio","Delaware County",2,64,2308,1129,1179
050,39,041,"Ohio","Delaware County",2,65,2230,1087,1143
050,39,041,"Ohio","Delaware County",2,66,2186,1061,1125
050,39,041,"Ohio","Delaware County",2,67,2109,1049,1060
050,39,041,"Ohio","Delaware County",2,68,2075,1031,1044
050,39,041,"Ohio","Delaware County",2,69,2012,967,1045
050,39,041,"Ohio","Delaware County",2,70,1897,904,993
050,39,041,"Ohio","Delaware County",2,71,1834,863,971
050,39,041,"Ohio","Delaware County",2,72,1831,869,962
050,39,041,"Ohio","Delaware County",2,73,1981,962,1019
050,39,041,"Ohio","Delaware County",2,74,1306,616,690
050,39,041,"Ohio","Delaware County",2,75,1158,529,629
050,39,041,"Ohio","Delaware County",2,76,1123,511,612
050,39,041,"Ohio","Delaware County",2,77,1147,519,628
050,39,041,"Ohio","Delaware County",2,78,954,425,529
050,39,041,"Ohio","Delaware County",2,79,826,369,457
050,39,041,"Ohio","Delaware County",2,80,741,329,412
050,39,041,"Ohio","Delaware County",2,81,700,309,391
050,39,041,"Ohio","Delaware County",2,82,657,292,365
050,39,041,"Ohio","Delaware County",2,83,564,233,331
050,39,041,"Ohio","Delaware County",2,84,503,210,293
050,39,041,"Ohio","Delaware County",2,85,2877,1074,1803
050,39,041,"Ohio","Delaware County",3,0,2084,1079,1005
050,39,041,"Ohio","Delaware County",3,1,2374,1218,1156
050,39,041,"Ohio","Delaware County",3,2,2538,1292,1246
050,39,041,"Ohio","Delaware County",3,3,2651,1393,1258
050,39,041,"Ohio","Delaware County",3,4,2878,1510,1368
050,39,041,"Ohio","Delaware County",3,5,3011,1543,1468
050,39,041,"Ohio","Delaware County",3,6,3129,1564,1565
050,39,041,"Ohio","Delaware County",3,7,3182,1614,1568
050,39,041,"Ohio","Delaware County",3,8,3179,1604,1575
050,39,041,"Ohio","Delaware County",3,9,3258,1664,1594
050,39,041,"Ohio","Delaware County",3,10,3311,1692,1619
050,39,041,"Ohio","Delaware County",3,11,3317,1709,1608
050,39,041,"Ohio","Delaware County",3,12,3362,1757,1605
050,39,041,"Ohio","Delaware County",3,13,3437,1781,1656
050,39,041,"Ohio","Delaware County",3,14,3529,1813,1716
050,39,041,"Ohio","Delaware County",3,15,3569,1863,1706
050,39,041,"Ohio","Delaware County",3,16,3619,1890,1729
050,39,041,"Ohio","Delaware County",3,17,3606,1852,1754
050,39,041,"Ohio","Delaware County",3,18,3074,1613,1461
050,39,041,"Ohio","Delaware County",3,19,2589,1337,1252
050,39,041,"Ohio","Delaware County",3,20,2748,1377,1371
050,39,041,"Ohio","Delaware County",3,21,2624,1329,1295
050,39,041,"Ohio","Delaware County",3,22,2520,1305,1215
050,39,041,"Ohio","Delaware County",3,23,2341,1216,1125
050,39,041,"Ohio","Delaware County",3,24,2055,1041,1014
050,39,041,"Ohio","Delaware County",3,25,1858,959,899
050,39,041,"Ohio","Delaware County",3,26,1871,945,926
050,39,041,"Ohio","Delaware County",3,27,1829,910,919
050,39,041,"Ohio","Delaware County",3,28,1844,905,939
050,39,041,"Ohio","Delaware County",3,29,1981,958,1023
050,39,041,"Ohio","Delaware County",3,30,2078,981,1097
050,39,041,"Ohio","Delaware County",3,31,2262,1102,1160
050,39,041,"Ohio","Delaware County",3,32,2363,1128,1235
050,39,041,"Ohio","Delaware County",3,33,2576,1262,1314
050,39,041,"Ohio","Delaware County",3,34,2732,1338,1394
050,39,041,"Ohio","Delaware County",3,35,2962,1424,1538
050,39,041,"Ohio","Delaware County",3,36,3179,1529,1650
050,39,041,"Ohio","Delaware County",3,37,3258,1612,1646
050,39,041,"Ohio","Delaware County",3,38,3376,1679,1697
050,39,041,"Ohio","Delaware County",3,39,3547,1779,1768
050,39,041,"Ohio","Delaware County",3,40,3627,1859,1768
050,39,041,"Ohio","Delaware County",3,41,3560,1802,1758
050,39,041,"Ohio","Delaware County",3,42,3524,1777,1747
050,39,041,"Ohio","Delaware County",3,43,3449,1733,1716
050,39,041,"Ohio","Delaware County",3,44,3351,1708,1643
050,39,041,"Ohio","Delaware County",3,45,3287,1687,1600
050,39,041,"Ohio","Delaware County",3,46,3346,1713,1633
050,39,041,"Ohio","Delaware County",3,47,3292,1702,1590
050,39,041,"Ohio","Delaware County",3,48,3317,1714,1603
050,39,041,"Ohio","Delaware County",3,49,3446,1744,1702
050,39,041,"Ohio","Delaware County",3,50,3679,1873,1806
050,39,041,"Ohio","Delaware County",3,51,3486,1803,1683
050,39,041,"Ohio","Delaware County",3,52,3224,1643,1581
050,39,041,"Ohio","Delaware County",3,53,3043,1565,1478
050,39,041,"Ohio","Delaware County",3,54,2988,1538,1450
050,39,041,"Ohio","Delaware County",3,55,2841,1448,1393
050,39,041,"Ohio","Delaware County",3,56,2827,1431,1396
050,39,041,"Ohio","Delaware County",3,57,2877,1450,1427
050,39,041,"Ohio","Delaware County",3,58,2770,1375,1395
050,39,041,"Ohio","Delaware County",3,59,2750,1397,1353
050,39,041,"Ohio","Delaware County",3,60,2734,1426,1308
050,39,041,"Ohio","Delaware County",3,61,2562,1309,1253
050,39,041,"Ohio","Delaware County",3,62,2485,1210,1275
050,39,041,"Ohio","Delaware County",3,63,2505,1200,1305
050,39,041,"Ohio","Delaware County",3,64,2435,1181,1254
050,39,041,"Ohio","Delaware County",3,65,2292,1109,1183
050,39,041,"Ohio","Delaware County",3,66,2251,1081,1170
050,39,041,"Ohio","Delaware County",3,67,2171,1055,1116
050,39,041,"Ohio","Delaware County",3,68,2101,1030,1071
050,39,041,"Ohio","Delaware County",3,69,2076,1029,1047
050,39,041,"Ohio","Delaware County",3,70,2014,953,1061
050,39,041,"Ohio","Delaware County",3,71,1849,872,977
050,39,041,"Ohio","Delaware County",3,72,1833,855,978
050,39,041,"Ohio","Delaware County",3,73,1827,863,964
050,39,041,"Ohio","Delaware County",3,74,1969,962,1007
050,39,041,"Ohio","Delaware County",3,75,1303,608,695
050,39,041,"Ohio","Delaware County",3,76,1126,512,614
050,39,041,"Ohio","Delaware County",3,77,1075,485,590
050,39,041,"Ohio","Delaware County",3,78,1103,485,618
050,39,041,"Ohio","Delaware County",3,79,941,424,517
050,39,041,"Ohio","Delaware County",3,80,791,347,444
050,39,041,"Ohio","Delaware County",3,81,719,318,401
050,39,041,"Ohio","Delaware County",3,82,657,289,368
050,39,041,"Ohio","Delaware County",3,83,639,274,365
050,39,041,"Ohio","Delaware County",3,84,535,218,317
050,39,041,"Ohio","Delaware County",3,85,2904,1100,1804
050,39,041,"Ohio","Delaware County",4,0,2177,1107,1070
050,39,041,"Ohio","Delaware County",4,1,2293,1184,1109
050,39,041,"Ohio","Delaware County",4,2,2617,1355,1262
050,39,041,"Ohio","Delaware County",4,3,2730,1397,1333
050,39,041,"Ohio","Delaware County",4,4,2812,1476,1336
050,39,041,"Ohio","Delaware County",4,5,3001,1576,1425
050,39,041,"Ohio","Delaware County",4,6,3165,1618,1547
050,39,041,"Ohio","Delaware County",4,7,3213,1626,1587
050,39,041,"Ohio","Delaware County",4,8,3233,1620,1613
050,39,041,"Ohio","Delaware County",4,9,3278,1629,1649
050,39,041,"Ohio","Delaware County",4,10,3312,1655,1657
050,39,041,"Ohio","Delaware County",4,11,3401,1738,1663
050,39,041,"Ohio","Delaware County",4,12,3338,1720,1618
050,39,041,"Ohio","Delaware County",4,13,3410,1776,1634
050,39,041,"Ohio","Delaware County",4,14,3483,1803,1680
050,39,041,"Ohio","Delaware County",4,15,3547,1812,1735
050,39,041,"Ohio","Delaware County",4,16,3609,1876,1733
050,39,041,"Ohio","Delaware County",4,17,3584,1855,1729
050,39,041,"Ohio","Delaware County",4,18,3150,1647,1503
050,39,041,"Ohio","Delaware County",4,19,2614,1376,1238
050,39,041,"Ohio","Delaware County",4,20,2680,1373,1307
050,39,041,"Ohio","Delaware County",4,21,2791,1386,1405
050,39,041,"Ohio","Delaware County",4,22,2682,1346,1336
050,39,041,"Ohio","Delaware County",4,23,2440,1259,1181
050,39,041,"Ohio","Delaware County",4,24,2221,1177,1044
050,39,041,"Ohio","Delaware County",4,25,1944,975,969
050,39,041,"Ohio","Delaware County",4,26,1907,1003,904
050,39,041,"Ohio","Delaware County",4,27,1915,943,972
050,39,041,"Ohio","Delaware County",4,28,1954,971,983
050,39,041,"Ohio","Delaware County",4,29,2046,999,1047
050,39,041,"Ohio","Delaware County",4,30,2163,1035,1128
050,39,041,"Ohio","Delaware County",4,31,2332,1100,1232
050,39,041,"Ohio","Delaware County",4,32,2535,1259,1276
050,39,041,"Ohio","Delaware County",4,33,2665,1287,1378
050,39,041,"Ohio","Delaware County",4,34,2756,1324,1432
050,39,041,"Ohio","Delaware County",4,35,2947,1441,1506
050,39,041,"Ohio","Delaware County",4,36,3165,1543,1622
050,39,041,"Ohio","Delaware County",4,37,3372,1638,1734
050,39,041,"Ohio","Delaware County",4,38,3442,1719,1723
050,39,041,"Ohio","Delaware County",4,39,3517,1783,1734
050,39,041,"Ohio","Delaware County",4,40,3684,1865,1819
050,39,041,"Ohio","Delaware County",4,41,3726,1922,1804
050,39,041,"Ohio","Delaware County",4,42,3652,1863,1789
050,39,041,"Ohio","Delaware County",4,43,3598,1804,1794
050,39,041,"Ohio","Delaware County",4,44,3447,1744,1703
050,39,041,"Ohio","Delaware County",4,45,3428,1755,1673
050,39,041,"Ohio","Delaware County",4,46,3275,1682,1593
050,39,041,"Ohio","Delaware County",4,47,3401,1752,1649
050,39,041,"Ohio","Delaware County",4,48,3303,1698,1605
050,39,041,"Ohio","Delaware County",4,49,3332,1726,1606
050,39,041,"Ohio","Delaware County",4,50,3450,1761,1689
050,39,041,"Ohio","Delaware County",4,51,3707,1890,1817
050,39,041,"Ohio","Delaware County",4,52,3533,1835,1698
050,39,041,"Ohio","Delaware County",4,53,3228,1650,1578
050,39,041,"Ohio","Delaware County",4,54,3050,1576,1474
050,39,041,"Ohio","Delaware County",4,55,2960,1520,1440
050,39,041,"Ohio","Delaware County",4,56,2800,1435,1365
050,39,041,"Ohio","Delaware County",4,57,2826,1433,1393
050,39,041,"Ohio","Delaware County",4,58,2883,1449,1434
050,39,041,"Ohio","Delaware County",4,59,2756,1361,1395
050,39,041,"Ohio","Delaware County",4,60,2757,1391,1366
050,39,041,"Ohio","Delaware County",4,61,2744,1413,1331
050,39,041,"Ohio","Delaware County",4,62,2557,1298,1259
050,39,041,"Ohio","Delaware County",4,63,2498,1205,1293
050,39,041,"Ohio","Delaware County",4,64,2505,1202,1303
050,39,041,"Ohio","Delaware County",4,65,2425,1160,1265
050,39,041,"Ohio","Delaware County",4,66,2297,1103,1194
050,39,041,"Ohio","Delaware County",4,67,2240,1067,1173
050,39,041,"Ohio","Delaware County",4,68,2177,1047,1130
050,39,041,"Ohio","Delaware County",4,69,2127,1050,1077
050,39,041,"Ohio","Delaware County",4,70,2056,1024,1032
050,39,041,"Ohio","Delaware County",4,71,1996,927,1069
050,39,041,"Ohio","Delaware County",4,72,1848,870,978
050,39,041,"Ohio","Delaware County",4,73,1826,854,972
050,39,041,"Ohio","Delaware County",4,74,1845,870,975
050,39,041,"Ohio","Delaware County",4,75,1964,952,1012
050,39,041,"Ohio","Delaware County",4,76,1284,583,701
050,39,041,"Ohio","Delaware County",4,77,1100,495,605
050,39,041,"Ohio","Delaware County",4,78,1043,458,585
050,39,041,"Ohio","Delaware County",4,79,1086,484,602
050,39,041,"Ohio","Delaware County",4,80,918,411,507
050,39,041,"Ohio","Delaware County",4,81,776,337,439
050,39,041,"Ohio","Delaware County",4,82,715,318,397
050,39,041,"Ohio","Delaware County",4,83,643,269,374
050,39,041,"Ohio","Delaware County",4,84,611,269,342
050,39,041,"Ohio","Delaware County",4,85,3008,1131,1877
050,39,041,"Ohio","Delaware County",5,0,2147,1092,1055
050,39,041,"Ohio","Delaware County",5,1,2435,1237,1198
050,39,041,"Ohio","Delaware County",5,2,2521,1303,1218
050,39,041,"Ohio","Delaware County",5,3,2830,1453,1377
050,39,041,"Ohio","Delaware County",5,4,2877,1462,1415
050,39,041,"Ohio","Delaware County",5,5,2950,1529,1421
050,39,041,"Ohio","Delaware County",5,6,3138,1656,1482
050,39,041,"Ohio","Delaware County",5,7,3273,1696,1577
050,39,041,"Ohio","Delaware County",5,8,3301,1682,1619
050,39,041,"Ohio","Delaware County",5,9,3353,1689,1664
050,39,041,"Ohio","Delaware County",5,10,3377,1688,1689
050,39,041,"Ohio","Delaware County",5,11,3364,1686,1678
050,39,041,"Ohio","Delaware County",5,12,3433,1768,1665
050,39,041,"Ohio","Delaware County",5,13,3383,1741,1642
050,39,041,"Ohio","Delaware County",5,14,3475,1810,1665
050,39,041,"Ohio","Delaware County",5,15,3506,1813,1693
050,39,041,"Ohio","Delaware County",5,16,3587,1830,1757
050,39,041,"Ohio","Delaware County",5,17,3616,1871,1745
050,39,041,"Ohio","Delaware County",5,18,3128,1668,1460
050,39,041,"Ohio","Delaware County",5,19,2686,1404,1282
050,39,041,"Ohio","Delaware County",5,20,2815,1461,1354
050,39,041,"Ohio","Delaware County",5,21,2759,1408,1351
050,39,041,"Ohio","Delaware County",5,22,2844,1399,1445
050,39,041,"Ohio","Delaware County",5,23,2592,1305,1287
050,39,041,"Ohio","Delaware County",5,24,2341,1246,1095
050,39,041,"Ohio","Delaware County",5,25,2097,1126,971
050,39,041,"Ohio","Delaware County",5,26,1902,961,941
050,39,041,"Ohio","Delaware County",5,27,1919,975,944
050,39,041,"Ohio","Delaware County",5,28,1965,967,998
050,39,041,"Ohio","Delaware County",5,29,2140,1050,1090
050,39,041,"Ohio","Delaware County",5,30,2210,1072,1138
050,39,041,"Ohio","Delaware County",5,31,2401,1143,1258
050,39,041,"Ohio","Delaware County",5,32,2580,1240,1340
050,39,041,"Ohio","Delaware County",5,33,2717,1346,1371
050,39,041,"Ohio","Delaware County",5,34,2871,1383,1488
050,39,041,"Ohio","Delaware County",5,35,2943,1432,1511
050,39,041,"Ohio","Delaware County",5,36,3149,1544,1605
050,39,041,"Ohio","Delaware County",5,37,3390,1673,1717
050,39,041,"Ohio","Delaware County",5,38,3578,1760,1818
050,39,041,"Ohio","Delaware County",5,39,3626,1825,1801
050,39,041,"Ohio","Delaware County",5,40,3647,1844,1803
050,39,041,"Ohio","Delaware County",5,41,3804,1961,1843
050,39,041,"Ohio","Delaware County",5,42,3765,1932,1833
050,39,041,"Ohio","Delaware County",5,43,3710,1885,1825
050,39,041,"Ohio","Delaware County",5,44,3645,1858,1787
050,39,041,"Ohio","Delaware County",5,45,3507,1791,1716
050,39,041,"Ohio","Delaware County",5,46,3459,1769,1690
050,39,041,"Ohio","Delaware County",5,47,3280,1686,1594
050,39,041,"Ohio","Delaware County",5,48,3461,1759,1702
050,39,041,"Ohio","Delaware County",5,49,3326,1724,1602
050,39,041,"Ohio","Delaware County",5,50,3317,1723,1594
050,39,041,"Ohio","Delaware County",5,51,3413,1775,1638
050,39,041,"Ohio","Delaware County",5,52,3717,1913,1804
050,39,041,"Ohio","Delaware County",5,53,3549,1829,1720
050,39,041,"Ohio","Delaware County",5,54,3239,1666,1573
050,39,041,"Ohio","Delaware County",5,55,2991,1550,1441
050,39,041,"Ohio","Delaware County",5,56,2945,1508,1437
050,39,041,"Ohio","Delaware County",5,57,2824,1432,1392
050,39,041,"Ohio","Delaware County",5,58,2812,1412,1400
050,39,041,"Ohio","Delaware County",5,59,2894,1449,1445
050,39,041,"Ohio","Delaware County",5,60,2766,1354,1412
050,39,041,"Ohio","Delaware County",5,61,2740,1374,1366
050,39,041,"Ohio","Delaware County",5,62,2713,1393,1320
050,39,041,"Ohio","Delaware County",5,63,2532,1282,1250
050,39,041,"Ohio","Delaware County",5,64,2503,1199,1304
050,39,041,"Ohio","Delaware County",5,65,2464,1175,1289
050,39,041,"Ohio","Delaware County",5,66,2407,1149,1258
050,39,041,"Ohio","Delaware County",5,67,2308,1099,1209
050,39,041,"Ohio","Delaware County",5,68,2236,1057,1179
050,39,041,"Ohio","Delaware County",5,69,2198,1050,1148
050,39,041,"Ohio","Delaware County",5,70,2125,1054,1071
050,39,041,"Ohio","Delaware County",5,71,2057,1007,1050
050,39,041,"Ohio","Delaware County",5,72,1992,929,1063
050,39,041,"Ohio","Delaware County",5,73,1848,865,983
050,39,041,"Ohio","Delaware County",5,74,1854,864,990
050,39,041,"Ohio","Delaware County",5,75,1842,870,972
050,39,041,"Ohio","Delaware County",5,76,1953,932,1021
050,39,041,"Ohio","Delaware County",5,77,1272,571,701
050,39,041,"Ohio","Delaware County",5,78,1075,475,600
050,39,041,"Ohio","Delaware County",5,79,1019,451,568
050,39,041,"Ohio","Delaware County",5,80,1061,470,591
050,39,041,"Ohio","Delaware County",5,81,892,400,492
050,39,041,"Ohio","Delaware County",5,82,754,330,424
050,39,041,"Ohio","Delaware County",5,83,691,299,392
050,39,041,"Ohio","Delaware County",5,84,615,257,358
050,39,041,"Ohio","Delaware County",5,85,3195,1239,1956
050,39,043,"Ohio","Erie County",1,0,769,390,379
050,39,043,"Ohio","Erie County",1,1,787,383,404
050,39,043,"Ohio","Erie County",1,2,781,391,390
050,39,043,"Ohio","Erie County",1,3,788,421,367
050,39,043,"Ohio","Erie County",1,4,787,404,383
050,39,043,"Ohio","Erie County",1,5,830,413,417
050,39,043,"Ohio","Erie County",1,6,830,419,411
050,39,043,"Ohio","Erie County",1,7,827,414,413
050,39,043,"Ohio","Erie County",1,8,807,401,406
050,39,043,"Ohio","Erie County",1,9,799,409,390
050,39,043,"Ohio","Erie County",1,10,845,439,406
050,39,043,"Ohio","Erie County",1,11,856,439,417
050,39,043,"Ohio","Erie County",1,12,887,446,441
050,39,043,"Ohio","Erie County",1,13,928,452,476
050,39,043,"Ohio","Erie County",1,14,914,466,448
050,39,043,"Ohio","Erie County",1,15,938,484,454
050,39,043,"Ohio","Erie County",1,16,985,522,463
050,39,043,"Ohio","Erie County",1,17,974,498,476
050,39,043,"Ohio","Erie County",1,18,836,445,391
050,39,043,"Ohio","Erie County",1,19,707,372,335
050,39,043,"Ohio","Erie County",1,20,737,376,361
050,39,043,"Ohio","Erie County",1,21,785,393,392
050,39,043,"Ohio","Erie County",1,22,897,443,454
050,39,043,"Ohio","Erie County",1,23,874,450,424
050,39,043,"Ohio","Erie County",1,24,886,472,414
050,39,043,"Ohio","Erie County",1,25,882,472,410
050,39,043,"Ohio","Erie County",1,26,880,452,428
050,39,043,"Ohio","Erie County",1,27,910,453,457
050,39,043,"Ohio","Erie County",1,28,900,451,449
050,39,043,"Ohio","Erie County",1,29,900,432,468
050,39,043,"Ohio","Erie County",1,30,895,450,445
050,39,043,"Ohio","Erie County",1,31,830,431,399
050,39,043,"Ohio","Erie County",1,32,828,432,396
050,39,043,"Ohio","Erie County",1,33,815,399,416
050,39,043,"Ohio","Erie County",1,34,838,397,441
050,39,043,"Ohio","Erie County",1,35,821,415,406
050,39,043,"Ohio","Erie County",1,36,832,410,422
050,39,043,"Ohio","Erie County",1,37,839,426,413
050,39,043,"Ohio","Erie County",1,38,817,399,418
050,39,043,"Ohio","Erie County",1,39,803,385,418
050,39,043,"Ohio","Erie County",1,40,843,431,412
050,39,043,"Ohio","Erie County",1,41,816,392,424
050,39,043,"Ohio","Erie County",1,42,794,362,432
050,39,043,"Ohio","Erie County",1,43,786,400,386
050,39,043,"Ohio","Erie County",1,44,755,381,374
050,39,043,"Ohio","Erie County",1,45,762,377,385
050,39,043,"Ohio","Erie County",1,46,780,397,383
050,39,043,"Ohio","Erie County",1,47,848,421,427
050,39,043,"Ohio","Erie County",1,48,969,483,486
050,39,043,"Ohio","Erie County",1,49,1017,507,510
050,39,043,"Ohio","Erie County",1,50,960,456,504
050,39,043,"Ohio","Erie County",1,51,974,474,500
050,39,043,"Ohio","Erie County",1,52,935,456,479
050,39,043,"Ohio","Erie County",1,53,1008,489,519
050,39,043,"Ohio","Erie County",1,54,945,469,476
050,39,043,"Ohio","Erie County",1,55,1089,536,553
050,39,043,"Ohio","Erie County",1,56,1073,526,547
050,39,043,"Ohio","Erie County",1,57,1102,552,550
050,39,043,"Ohio","Erie County",1,58,1195,570,625
050,39,043,"Ohio","Erie County",1,59,1194,581,613
050,39,043,"Ohio","Erie County",1,60,1165,556,609
050,39,043,"Ohio","Erie County",1,61,1200,569,631
050,39,043,"Ohio","Erie County",1,62,1245,601,644
050,39,043,"Ohio","Erie County",1,63,1188,584,604
050,39,043,"Ohio","Erie County",1,64,1190,578,612
050,39,043,"Ohio","Erie County",1,65,1184,569,615
050,39,043,"Ohio","Erie County",1,66,1128,546,582
050,39,043,"Ohio","Erie County",1,67,1063,501,562
050,39,043,"Ohio","Erie County",1,68,1046,510,536
050,39,043,"Ohio","Erie County",1,69,982,504,478
050,39,043,"Ohio","Erie County",1,70,951,456,495
050,39,043,"Ohio","Erie County",1,71,931,422,509
050,39,043,"Ohio","Erie County",1,72,997,451,546
050,39,043,"Ohio","Erie County",1,73,994,466,528
050,39,043,"Ohio","Erie County",1,74,643,310,333
050,39,043,"Ohio","Erie County",1,75,617,298,319
050,39,043,"Ohio","Erie County",1,76,665,314,351
050,39,043,"Ohio","Erie County",1,77,675,318,357
050,39,043,"Ohio","Erie County",1,78,560,261,299
050,39,043,"Ohio","Erie County",1,79,494,224,270
050,39,043,"Ohio","Erie County",1,80,456,216,240
050,39,043,"Ohio","Erie County",1,81,407,179,228
050,39,043,"Ohio","Erie County",1,82,395,176,219
050,39,043,"Ohio","Erie County",1,83,390,183,207
050,39,043,"Ohio","Erie County",1,84,345,159,186
050,39,043,"Ohio","Erie County",1,85,2019,803,1216
050,39,043,"Ohio","Erie County",2,0,751,385,366
050,39,043,"Ohio","Erie County",2,1,776,381,395
050,39,043,"Ohio","Erie County",2,2,782,388,394
050,39,043,"Ohio","Erie County",2,3,781,411,370
050,39,043,"Ohio","Erie County",2,4,787,406,381
050,39,043,"Ohio","Erie County",2,5,820,408,412
050,39,043,"Ohio","Erie County",2,6,834,419,415
050,39,043,"Ohio","Erie County",2,7,828,413,415
050,39,043,"Ohio","Erie County",2,8,808,401,407
050,39,043,"Ohio","Erie County",2,9,800,404,396
050,39,043,"Ohio","Erie County",2,10,833,432,401
050,39,043,"Ohio","Erie County",2,11,845,435,410
050,39,043,"Ohio","Erie County",2,12,882,444,438
050,39,043,"Ohio","Erie County",2,13,917,453,464
050,39,043,"Ohio","Erie County",2,14,919,463,456
050,39,043,"Ohio","Erie County",2,15,936,482,454
050,39,043,"Ohio","Erie County",2,16,979,517,462
050,39,043,"Ohio","Erie County",2,17,977,506,471
050,39,043,"Ohio","Erie County",2,18,838,446,392
050,39,043,"Ohio","Erie County",2,19,709,373,336
050,39,043,"Ohio","Erie County",2,20,748,381,367
050,39,043,"Ohio","Erie County",2,21,785,397,388
050,39,043,"Ohio","Erie County",2,22,876,435,441
050,39,043,"Ohio","Erie County",2,23,877,447,430
050,39,043,"Ohio","Erie County",2,24,875,463,412
050,39,043,"Ohio","Erie County",2,25,881,470,411
050,39,043,"Ohio","Erie County",2,26,879,454,425
050,39,043,"Ohio","Erie County",2,27,905,453,452
050,39,043,"Ohio","Erie County",2,28,901,450,451
050,39,043,"Ohio","Erie County",2,29,901,441,460
050,39,043,"Ohio","Erie County",2,30,902,451,451
050,39,043,"Ohio","Erie County",2,31,842,434,408
050,39,043,"Ohio","Erie County",2,32,825,430,395
050,39,043,"Ohio","Erie County",2,33,815,403,412
050,39,043,"Ohio","Erie County",2,34,830,395,435
050,39,043,"Ohio","Erie County",2,35,828,410,418
050,39,043,"Ohio","Erie County",2,36,827,410,417
050,39,043,"Ohio","Erie County",2,37,843,426,417
050,39,043,"Ohio","Erie County",2,38,825,406,419
050,39,043,"Ohio","Erie County",2,39,807,391,416
050,39,043,"Ohio","Erie County",2,40,832,418,414
050,39,043,"Ohio","Erie County",2,41,819,398,421
050,39,043,"Ohio","Erie County",2,42,794,366,428
050,39,043,"Ohio","Erie County",2,43,794,395,399
050,39,043,"Ohio","Erie County",2,44,753,380,373
050,39,043,"Ohio","Erie County",2,45,764,379,385
050,39,043,"Ohio","Erie County",2,46,774,389,385
050,39,043,"Ohio","Erie County",2,47,832,417,415
050,39,043,"Ohio","Erie County",2,48,937,468,469
050,39,043,"Ohio","Erie County",2,49,1011,504,507
050,39,043,"Ohio","Erie County",2,50,977,469,508
050,39,043,"Ohio","Erie County",2,51,969,468,501
050,39,043,"Ohio","Erie County",2,52,935,455,480
050,39,043,"Ohio","Erie County",2,53,990,481,509
050,39,043,"Ohio","Erie County",2,54,958,472,486
050,39,043,"Ohio","Erie County",2,55,1049,518,531
050,39,043,"Ohio","Erie County",2,56,1083,533,550
050,39,043,"Ohio","Erie County",2,57,1098,547,551
050,39,043,"Ohio","Erie County",2,58,1172,566,606
050,39,043,"Ohio","Erie County",2,59,1200,581,619
050,39,043,"Ohio","Erie County",2,60,1165,555,610
050,39,043,"Ohio","Erie County",2,61,1191,568,623
050,39,043,"Ohio","Erie County",2,62,1227,592,635
050,39,043,"Ohio","Erie County",2,63,1206,588,618
050,39,043,"Ohio","Erie County",2,64,1182,574,608
050,39,043,"Ohio","Erie County",2,65,1177,564,613
050,39,043,"Ohio","Erie County",2,66,1137,548,589
050,39,043,"Ohio","Erie County",2,67,1070,506,564
050,39,043,"Ohio","Erie County",2,68,1039,502,537
050,39,043,"Ohio","Erie County",2,69,1001,505,496
050,39,043,"Ohio","Erie County",2,70,952,462,490
050,39,043,"Ohio","Erie County",2,71,926,425,501
050,39,043,"Ohio","Erie County",2,72,954,431,523
050,39,043,"Ohio","Erie County",2,73,1035,480,555
050,39,043,"Ohio","Erie County",2,74,680,325,355
050,39,043,"Ohio","Erie County",2,75,615,294,321
050,39,043,"Ohio","Erie County",2,76,644,308,336
050,39,043,"Ohio","Erie County",2,77,679,318,361
050,39,043,"Ohio","Erie County",2,78,570,270,300
050,39,043,"Ohio","Erie County",2,79,502,229,273
050,39,043,"Ohio","Erie County",2,80,464,218,246
050,39,043,"Ohio","Erie County",2,81,406,180,226
050,39,043,"Ohio","Erie County",2,82,401,180,221
050,39,043,"Ohio","Erie County",2,83,386,176,210
050,39,043,"Ohio","Erie County",2,84,345,159,186
050,39,043,"Ohio","Erie County",2,85,2012,797,1215
050,39,043,"Ohio","Erie County",3,0,681,350,331
050,39,043,"Ohio","Erie County",3,1,763,405,358
050,39,043,"Ohio","Erie County",3,2,788,395,393
050,39,043,"Ohio","Erie County",3,3,773,386,387
050,39,043,"Ohio","Erie County",3,4,789,420,369
050,39,043,"Ohio","Erie County",3,5,799,423,376
050,39,043,"Ohio","Erie County",3,6,819,410,409
050,39,043,"Ohio","Erie County",3,7,835,417,418
050,39,043,"Ohio","Erie County",3,8,821,414,407
050,39,043,"Ohio","Erie County",3,9,790,404,386
050,39,043,"Ohio","Erie County",3,10,793,407,386
050,39,043,"Ohio","Erie County",3,11,812,426,386
050,39,043,"Ohio","Erie County",3,12,852,437,415
050,39,043,"Ohio","Erie County",3,13,889,446,443
050,39,043,"Ohio","Erie County",3,14,923,462,461
050,39,043,"Ohio","Erie County",3,15,911,454,457
050,39,043,"Ohio","Erie County",3,16,938,491,447
050,39,043,"Ohio","Erie County",3,17,958,494,464
050,39,043,"Ohio","Erie County",3,18,850,458,392
050,39,043,"Ohio","Erie County",3,19,686,358,328
050,39,043,"Ohio","Erie County",3,20,776,412,364
050,39,043,"Ohio","Erie County",3,21,822,411,411
050,39,043,"Ohio","Erie County",3,22,780,398,382
050,39,043,"Ohio","Erie County",3,23,907,463,444
050,39,043,"Ohio","Erie County",3,24,875,449,426
050,39,043,"Ohio","Erie County",3,25,840,448,392
050,39,043,"Ohio","Erie County",3,26,865,464,401
050,39,043,"Ohio","Erie County",3,27,867,453,414
050,39,043,"Ohio","Erie County",3,28,903,464,439
050,39,043,"Ohio","Erie County",3,29,899,446,453
050,39,043,"Ohio","Erie County",3,30,903,436,467
050,39,043,"Ohio","Erie County",3,31,888,437,451
050,39,043,"Ohio","Erie County",3,32,847,433,414
050,39,043,"Ohio","Erie County",3,33,810,431,379
050,39,043,"Ohio","Erie County",3,34,824,408,416
050,39,043,"Ohio","Erie County",3,35,825,391,434
050,39,043,"Ohio","Erie County",3,36,824,415,409
050,39,043,"Ohio","Erie County",3,37,828,413,415
050,39,043,"Ohio","Erie County",3,38,832,416,416
050,39,043,"Ohio","Erie County",3,39,836,407,429
050,39,043,"Ohio","Erie County",3,40,796,387,409
050,39,043,"Ohio","Erie County",3,41,846,428,418
050,39,043,"Ohio","Erie County",3,42,805,376,429
050,39,043,"Ohio","Erie County",3,43,811,384,427
050,39,043,"Ohio","Erie County",3,44,784,383,401
050,39,043,"Ohio","Erie County",3,45,739,366,373
050,39,043,"Ohio","Erie County",3,46,748,367,381
050,39,043,"Ohio","Erie County",3,47,781,401,380
050,39,043,"Ohio","Erie County",3,48,812,420,392
050,39,043,"Ohio","Erie County",3,49,935,465,470
050,39,043,"Ohio","Erie County",3,50,1005,491,514
050,39,043,"Ohio","Erie County",3,51,994,477,517
050,39,043,"Ohio","Erie County",3,52,962,453,509
050,39,043,"Ohio","Erie County",3,53,925,458,467
050,39,043,"Ohio","Erie County",3,54,974,466,508
050,39,043,"Ohio","Erie County",3,55,966,484,482
050,39,043,"Ohio","Erie County",3,56,1045,516,529
050,39,043,"Ohio","Erie County",3,57,1084,531,553
050,39,043,"Ohio","Erie County",3,58,1093,545,548
050,39,043,"Ohio","Erie County",3,59,1162,564,598
050,39,043,"Ohio","Erie County",3,60,1193,568,625
050,39,043,"Ohio","Erie County",3,61,1169,559,610
050,39,043,"Ohio","Erie County",3,62,1199,577,622
050,39,043,"Ohio","Erie County",3,63,1194,571,623
050,39,043,"Ohio","Erie County",3,64,1195,588,607
050,39,043,"Ohio","Erie County",3,65,1178,583,595
050,39,043,"Ohio","Erie County",3,66,1146,549,597
050,39,043,"Ohio","Erie County",3,67,1121,536,585
050,39,043,"Ohio","Erie County",3,68,1060,507,553
050,39,043,"Ohio","Erie County",3,69,1007,490,517
050,39,043,"Ohio","Erie County",3,70,967,483,484
050,39,043,"Ohio","Erie County",3,71,930,442,488
050,39,043,"Ohio","Erie County",3,72,887,408,479
050,39,043,"Ohio","Erie County",3,73,927,424,503
050,39,043,"Ohio","Erie County",3,74,992,461,531
050,39,043,"Ohio","Erie County",3,75,642,297,345
050,39,043,"Ohio","Erie County",3,76,604,291,313
050,39,043,"Ohio","Erie County",3,77,603,273,330
050,39,043,"Ohio","Erie County",3,78,649,313,336
050,39,043,"Ohio","Erie County",3,79,528,242,286
050,39,043,"Ohio","Erie County",3,80,481,219,262
050,39,043,"Ohio","Erie County",3,81,419,193,226
050,39,043,"Ohio","Erie County",3,82,402,187,215
050,39,043,"Ohio","Erie County",3,83,387,171,216
050,39,043,"Ohio","Erie County",3,84,336,152,184
050,39,043,"Ohio","Erie County",3,85,1982,788,1194
050,39,043,"Ohio","Erie County",4,0,650,317,333
050,39,043,"Ohio","Erie County",4,1,691,359,332
050,39,043,"Ohio","Erie County",4,2,758,407,351
050,39,043,"Ohio","Erie County",4,3,801,397,404
050,39,043,"Ohio","Erie County",4,4,775,389,386
050,39,043,"Ohio","Erie County",4,5,786,416,370
050,39,043,"Ohio","Erie County",4,6,801,418,383
050,39,043,"Ohio","Erie County",4,7,830,419,411
050,39,043,"Ohio","Erie County",4,8,819,409,410
050,39,043,"Ohio","Erie County",4,9,808,406,402
050,39,043,"Ohio","Erie County",4,10,817,417,400
050,39,043,"Ohio","Erie County",4,11,789,400,389
050,39,043,"Ohio","Erie County",4,12,822,426,396
050,39,043,"Ohio","Erie County",4,13,857,446,411
050,39,043,"Ohio","Erie County",4,14,863,434,429
050,39,043,"Ohio","Erie County",4,15,900,462,438
050,39,043,"Ohio","Erie County",4,16,905,454,451
050,39,043,"Ohio","Erie County",4,17,937,483,454
050,39,043,"Ohio","Erie County",4,18,839,448,391
050,39,043,"Ohio","Erie County",4,19,682,371,311
050,39,043,"Ohio","Erie County",4,20,725,367,358
050,39,043,"Ohio","Erie County",4,21,843,450,393
050,39,043,"Ohio","Erie County",4,22,851,406,445
050,39,043,"Ohio","Erie County",4,23,813,411,402
050,39,043,"Ohio","Erie County",4,24,873,437,436
050,39,043,"Ohio","Erie County",4,25,894,458,436
050,39,043,"Ohio","Erie County",4,26,827,453,374
050,39,043,"Ohio","Erie County",4,27,861,465,396
050,39,043,"Ohio","Erie County",4,28,896,458,438
050,39,043,"Ohio","Erie County",4,29,871,456,415
050,39,043,"Ohio","Erie County",4,30,880,435,445
050,39,043,"Ohio","Erie County",4,31,886,433,453
050,39,043,"Ohio","Erie County",4,32,866,411,455
050,39,043,"Ohio","Erie County",4,33,844,442,402
050,39,043,"Ohio","Erie County",4,34,820,442,378
050,39,043,"Ohio","Erie County",4,35,836,405,431
050,39,043,"Ohio","Erie County",4,36,831,395,436
050,39,043,"Ohio","Erie County",4,37,828,422,406
050,39,043,"Ohio","Erie County",4,38,844,422,422
050,39,043,"Ohio","Erie County",4,39,854,425,429
050,39,043,"Ohio","Erie County",4,40,825,405,420
050,39,043,"Ohio","Erie County",4,41,794,382,412
050,39,043,"Ohio","Erie County",4,42,852,428,424
050,39,043,"Ohio","Erie County",4,43,821,397,424
050,39,043,"Ohio","Erie County",4,44,798,387,411
050,39,043,"Ohio","Erie County",4,45,783,377,406
050,39,043,"Ohio","Erie County",4,46,726,350,376
050,39,043,"Ohio","Erie County",4,47,777,381,396
050,39,043,"Ohio","Erie County",4,48,791,403,388
050,39,043,"Ohio","Erie County",4,49,822,422,400
050,39,043,"Ohio","Erie County",4,50,931,475,456
050,39,043,"Ohio","Erie County",4,51,1019,510,509
050,39,043,"Ohio","Erie County",4,52,1003,475,528
050,39,043,"Ohio","Erie County",4,53,950,455,495
050,39,043,"Ohio","Erie County",4,54,924,453,471
050,39,043,"Ohio","Erie County",4,55,986,480,506
050,39,043,"Ohio","Erie County",4,56,949,474,475
050,39,043,"Ohio","Erie County",4,57,1034,517,517
050,39,043,"Ohio","Erie County",4,58,1075,532,543
050,39,043,"Ohio","Erie County",4,59,1074,531,543
050,39,043,"Ohio","Erie County",4,60,1148,545,603
050,39,043,"Ohio","Erie County",4,61,1173,559,614
050,39,043,"Ohio","Erie County",4,62,1167,557,610
050,39,043,"Ohio","Erie County",4,63,1193,567,626
050,39,043,"Ohio","Erie County",4,64,1197,575,622
050,39,043,"Ohio","Erie County",4,65,1191,587,604
050,39,043,"Ohio","Erie County",4,66,1148,562,586
050,39,043,"Ohio","Erie County",4,67,1117,529,588
050,39,043,"Ohio","Erie County",4,68,1098,522,576
050,39,043,"Ohio","Erie County",4,69,1033,490,543
050,39,043,"Ohio","Erie County",4,70,978,468,510
050,39,043,"Ohio","Erie County",4,71,950,467,483
050,39,043,"Ohio","Erie County",4,72,909,432,477
050,39,043,"Ohio","Erie County",4,73,860,396,464
050,39,043,"Ohio","Erie County",4,74,910,414,496
050,39,043,"Ohio","Erie County",4,75,972,447,525
050,39,043,"Ohio","Erie County",4,76,631,294,337
050,39,043,"Ohio","Erie County",4,77,575,264,311
050,39,043,"Ohio","Erie County",4,78,577,269,308
050,39,043,"Ohio","Erie County",4,79,602,285,317
050,39,043,"Ohio","Erie County",4,80,516,236,280
050,39,043,"Ohio","Erie County",4,81,447,194,253
050,39,043,"Ohio","Erie County",4,82,417,200,217
050,39,043,"Ohio","Erie County",4,83,393,178,215
050,39,043,"Ohio","Erie County",4,84,341,155,186
050,39,043,"Ohio","Erie County",4,85,1964,788,1176
050,39,043,"Ohio","Erie County",5,0,650,318,332
050,39,043,"Ohio","Erie County",5,1,668,308,360
050,39,043,"Ohio","Erie County",5,2,674,350,324
050,39,043,"Ohio","Erie County",5,3,752,406,346
050,39,043,"Ohio","Erie County",5,4,789,394,395
050,39,043,"Ohio","Erie County",5,5,788,395,393
050,39,043,"Ohio","Erie County",5,6,790,412,378
050,39,043,"Ohio","Erie County",5,7,814,413,401
050,39,043,"Ohio","Erie County",5,8,828,417,411
050,39,043,"Ohio","Erie County",5,9,820,420,400
050,39,043,"Ohio","Erie County",5,10,803,402,401
050,39,043,"Ohio","Erie County",5,11,806,412,394
050,39,043,"Ohio","Erie County",5,12,796,413,383
050,39,043,"Ohio","Erie County",5,13,807,413,394
050,39,043,"Ohio","Erie County",5,14,848,429,419
050,39,043,"Ohio","Erie County",5,15,875,441,434
050,39,043,"Ohio","Erie County",5,16,912,475,437
050,39,043,"Ohio","Erie County",5,17,904,454,450
050,39,043,"Ohio","Erie County",5,18,800,440,360
050,39,043,"Ohio","Erie County",5,19,683,358,325
050,39,043,"Ohio","Erie County",5,20,755,399,356
050,39,043,"Ohio","Erie County",5,21,771,389,382
050,39,043,"Ohio","Erie County",5,22,864,460,404
050,39,043,"Ohio","Erie County",5,23,850,424,426
050,39,043,"Ohio","Erie County",5,24,784,399,385
050,39,043,"Ohio","Erie County",5,25,837,425,412
050,39,043,"Ohio","Erie County",5,26,857,431,426
050,39,043,"Ohio","Erie County",5,27,841,447,394
050,39,043,"Ohio","Erie County",5,28,833,450,383
050,39,043,"Ohio","Erie County",5,29,888,457,431
050,39,043,"Ohio","Erie County",5,30,898,469,429
050,39,043,"Ohio","Erie County",5,31,854,423,431
050,39,043,"Ohio","Erie County",5,32,901,439,462
050,39,043,"Ohio","Erie County",5,33,876,425,451
050,39,043,"Ohio","Erie County",5,34,846,437,409
050,39,043,"Ohio","Erie County",5,35,828,439,389
050,39,043,"Ohio","Erie County",5,36,824,399,425
050,39,043,"Ohio","Erie County",5,37,853,415,438
050,39,043,"Ohio","Erie County",5,38,824,424,400
050,39,043,"Ohio","Erie County",5,39,848,421,427
050,39,043,"Ohio","Erie County",5,40,852,424,428
050,39,043,"Ohio","Erie County",5,41,816,405,411
050,39,043,"Ohio","Erie County",5,42,788,375,413
050,39,043,"Ohio","Erie County",5,43,877,450,427
050,39,043,"Ohio","Erie County",5,44,824,394,430
050,39,043,"Ohio","Erie County",5,45,784,374,410
050,39,043,"Ohio","Erie County",5,46,784,365,419
050,39,043,"Ohio","Erie County",5,47,733,358,375
050,39,043,"Ohio","Erie County",5,48,756,375,381
050,39,043,"Ohio","Erie County",5,49,801,405,396
050,39,043,"Ohio","Erie County",5,50,807,407,400
050,39,043,"Ohio","Erie County",5,51,927,468,459
050,39,043,"Ohio","Erie County",5,52,994,501,493
050,39,043,"Ohio","Erie County",5,53,991,469,522
050,39,043,"Ohio","Erie County",5,54,930,444,486
050,39,043,"Ohio","Erie County",5,55,937,465,472
050,39,043,"Ohio","Erie County",5,56,990,484,506
050,39,043,"Ohio","Erie County",5,57,948,475,473
050,39,043,"Ohio","Erie County",5,58,1036,515,521
050,39,043,"Ohio","Erie County",5,59,1061,519,542
050,39,043,"Ohio","Erie County",5,60,1049,514,535
050,39,043,"Ohio","Erie County",5,61,1166,559,607
050,39,043,"Ohio","Erie County",5,62,1163,546,617
050,39,043,"Ohio","Erie County",5,63,1141,538,603
050,39,043,"Ohio","Erie County",5,64,1206,576,630
050,39,043,"Ohio","Erie County",5,65,1193,577,616
050,39,043,"Ohio","Erie County",5,66,1164,570,594
050,39,043,"Ohio","Erie County",5,67,1136,552,584
050,39,043,"Ohio","Erie County",5,68,1103,520,583
050,39,043,"Ohio","Erie County",5,69,1073,508,565
050,39,043,"Ohio","Erie County",5,70,999,469,530
050,39,043,"Ohio","Erie County",5,71,951,446,505
050,39,043,"Ohio","Erie County",5,72,927,455,472
050,39,043,"Ohio","Erie County",5,73,890,430,460
050,39,043,"Ohio","Erie County",5,74,841,384,457
050,39,043,"Ohio","Erie County",5,75,868,386,482
050,39,043,"Ohio","Erie County",5,76,951,444,507
050,39,043,"Ohio","Erie County",5,77,606,266,340
050,39,043,"Ohio","Erie County",5,78,547,263,284
050,39,043,"Ohio","Erie County",5,79,532,242,290
050,39,043,"Ohio","Erie County",5,80,586,281,305
050,39,043,"Ohio","Erie County",5,81,480,214,266
050,39,043,"Ohio","Erie County",5,82,449,204,245
050,39,043,"Ohio","Erie County",5,83,408,194,214
050,39,043,"Ohio","Erie County",5,84,349,160,189
050,39,043,"Ohio","Erie County",5,85,1982,797,1185
050,39,045,"Ohio","Fairfield County",1,0,1683,860,823
050,39,045,"Ohio","Fairfield County",1,1,1783,885,898
050,39,045,"Ohio","Fairfield County",1,2,1935,941,994
050,39,045,"Ohio","Fairfield County",1,3,1916,975,941
050,39,045,"Ohio","Fairfield County",1,4,1961,996,965
050,39,045,"Ohio","Fairfield County",1,5,2073,1062,1011
050,39,045,"Ohio","Fairfield County",1,6,2115,1105,1010
050,39,045,"Ohio","Fairfield County",1,7,2111,1102,1009
050,39,045,"Ohio","Fairfield County",1,8,2068,1100,968
050,39,045,"Ohio","Fairfield County",1,9,2106,1121,985
050,39,045,"Ohio","Fairfield County",1,10,2193,1123,1070
050,39,045,"Ohio","Fairfield County",1,11,2290,1173,1117
050,39,045,"Ohio","Fairfield County",1,12,2326,1192,1134
050,39,045,"Ohio","Fairfield County",1,13,2339,1198,1141
050,39,045,"Ohio","Fairfield County",1,14,2366,1227,1139
050,39,045,"Ohio","Fairfield County",1,15,2280,1163,1117
050,39,045,"Ohio","Fairfield County",1,16,2296,1189,1107
050,39,045,"Ohio","Fairfield County",1,17,2361,1196,1165
050,39,045,"Ohio","Fairfield County",1,18,2002,1058,944
050,39,045,"Ohio","Fairfield County",1,19,1630,885,745
050,39,045,"Ohio","Fairfield County",1,20,1784,963,821
050,39,045,"Ohio","Fairfield County",1,21,1839,991,848
050,39,045,"Ohio","Fairfield County",1,22,1895,1008,887
050,39,045,"Ohio","Fairfield County",1,23,1878,1046,832
050,39,045,"Ohio","Fairfield County",1,24,1898,1058,840
050,39,045,"Ohio","Fairfield County",1,25,1848,979,869
050,39,045,"Ohio","Fairfield County",1,26,1816,950,866
050,39,045,"Ohio","Fairfield County",1,27,1803,950,853
050,39,045,"Ohio","Fairfield County",1,28,1834,973,861
050,39,045,"Ohio","Fairfield County",1,29,1904,968,936
050,39,045,"Ohio","Fairfield County",1,30,1914,948,966
050,39,045,"Ohio","Fairfield County",1,31,1907,970,937
050,39,045,"Ohio","Fairfield County",1,32,1956,972,984
050,39,045,"Ohio","Fairfield County",1,33,1983,956,1027
050,39,045,"Ohio","Fairfield County",1,34,2012,998,1014
050,39,045,"Ohio","Fairfield County",1,35,2028,1007,1021
050,39,045,"Ohio","Fairfield County",1,36,2022,970,1052
050,39,045,"Ohio","Fairfield County",1,37,2123,1028,1095
050,39,045,"Ohio","Fairfield County",1,38,2195,1076,1119
050,39,045,"Ohio","Fairfield County",1,39,2125,1058,1067
050,39,045,"Ohio","Fairfield County",1,40,2107,1047,1060
050,39,045,"Ohio","Fairfield County",1,41,2083,1029,1054
050,39,045,"Ohio","Fairfield County",1,42,2047,1028,1019
050,39,045,"Ohio","Fairfield County",1,43,1978,965,1013
050,39,045,"Ohio","Fairfield County",1,44,2007,1005,1002
050,39,045,"Ohio","Fairfield County",1,45,2027,1036,991
050,39,045,"Ohio","Fairfield County",1,46,1975,991,984
050,39,045,"Ohio","Fairfield County",1,47,2059,1061,998
050,39,045,"Ohio","Fairfield County",1,48,2218,1134,1084
050,39,045,"Ohio","Fairfield County",1,49,2354,1204,1150
050,39,045,"Ohio","Fairfield County",1,50,2228,1152,1076
050,39,045,"Ohio","Fairfield County",1,51,2205,1130,1075
050,39,045,"Ohio","Fairfield County",1,52,2103,1063,1040
050,39,045,"Ohio","Fairfield County",1,53,2086,1064,1022
050,39,045,"Ohio","Fairfield County",1,54,2119,1055,1064
050,39,045,"Ohio","Fairfield County",1,55,2238,1105,1133
050,39,045,"Ohio","Fairfield County",1,56,2210,1087,1123
050,39,045,"Ohio","Fairfield County",1,57,2239,1146,1093
050,39,045,"Ohio","Fairfield County",1,58,2251,1152,1099
050,39,045,"Ohio","Fairfield County",1,59,2163,1064,1099
050,39,045,"Ohio","Fairfield County",1,60,2076,1026,1050
050,39,045,"Ohio","Fairfield County",1,61,2055,1000,1055
050,39,045,"Ohio","Fairfield County",1,62,2055,1012,1043
050,39,045,"Ohio","Fairfield County",1,63,1940,949,991
050,39,045,"Ohio","Fairfield County",1,64,1835,892,943
050,39,045,"Ohio","Fairfield County",1,65,1848,858,990
050,39,045,"Ohio","Fairfield County",1,66,1740,824,916
050,39,045,"Ohio","Fairfield County",1,67,1716,843,873
050,39,045,"Ohio","Fairfield County",1,68,1641,773,868
050,39,045,"Ohio","Fairfield County",1,69,1527,714,813
050,39,045,"Ohio","Fairfield County",1,70,1471,693,778
050,39,045,"Ohio","Fairfield County",1,71,1439,668,771
050,39,045,"Ohio","Fairfield County",1,72,1480,699,781
050,39,045,"Ohio","Fairfield County",1,73,1502,708,794
050,39,045,"Ohio","Fairfield County",1,74,1015,450,565
050,39,045,"Ohio","Fairfield County",1,75,1012,446,566
050,39,045,"Ohio","Fairfield County",1,76,1017,456,561
050,39,045,"Ohio","Fairfield County",1,77,1041,466,575
050,39,045,"Ohio","Fairfield County",1,78,843,357,486
050,39,045,"Ohio","Fairfield County",1,79,769,348,421
050,39,045,"Ohio","Fairfield County",1,80,684,280,404
050,39,045,"Ohio","Fairfield County",1,81,641,271,370
050,39,045,"Ohio","Fairfield County",1,82,589,250,339
050,39,045,"Ohio","Fairfield County",1,83,525,221,304
050,39,045,"Ohio","Fairfield County",1,84,469,194,275
050,39,045,"Ohio","Fairfield County",1,85,2683,989,1694
050,39,045,"Ohio","Fairfield County",2,0,1685,852,833
050,39,045,"Ohio","Fairfield County",2,1,1775,884,891
050,39,045,"Ohio","Fairfield County",2,2,1917,935,982
050,39,045,"Ohio","Fairfield County",2,3,1932,973,959
050,39,045,"Ohio","Fairfield County",2,4,1982,1010,972
050,39,045,"Ohio","Fairfield County",2,5,2076,1062,1014
050,39,045,"Ohio","Fairfield County",2,6,2123,1107,1016
050,39,045,"Ohio","Fairfield County",2,7,2125,1109,1016
050,39,045,"Ohio","Fairfield County",2,8,2093,1107,986
050,39,045,"Ohio","Fairfield County",2,9,2107,1121,986
050,39,045,"Ohio","Fairfield County",2,10,2181,1125,1056
050,39,045,"Ohio","Fairfield County",2,11,2270,1162,1108
050,39,045,"Ohio","Fairfield County",2,12,2341,1196,1145
050,39,045,"Ohio","Fairfield County",2,13,2351,1205,1146
050,39,045,"Ohio","Fairfield County",2,14,2369,1224,1145
050,39,045,"Ohio","Fairfield County",2,15,2304,1182,1122
050,39,045,"Ohio","Fairfield County",2,16,2304,1186,1118
050,39,045,"Ohio","Fairfield County",2,17,2354,1197,1157
050,39,045,"Ohio","Fairfield County",2,18,1992,1051,941
050,39,045,"Ohio","Fairfield County",2,19,1655,895,760
050,39,045,"Ohio","Fairfield County",2,20,1807,977,830
050,39,045,"Ohio","Fairfield County",2,21,1846,994,852
050,39,045,"Ohio","Fairfield County",2,22,1893,1009,884
050,39,045,"Ohio","Fairfield County",2,23,1899,1045,854
050,39,045,"Ohio","Fairfield County",2,24,1894,1053,841
050,39,045,"Ohio","Fairfield County",2,25,1868,996,872
050,39,045,"Ohio","Fairfield County",2,26,1834,958,876
050,39,045,"Ohio","Fairfield County",2,27,1824,965,859
050,39,045,"Ohio","Fairfield County",2,28,1837,967,870
050,39,045,"Ohio","Fairfield County",2,29,1900,972,928
050,39,045,"Ohio","Fairfield County",2,30,1937,964,973
050,39,045,"Ohio","Fairfield County",2,31,1928,973,955
050,39,045,"Ohio","Fairfield County",2,32,1958,974,984
050,39,045,"Ohio","Fairfield County",2,33,1988,965,1023
050,39,045,"Ohio","Fairfield County",2,34,2024,995,1029
050,39,045,"Ohio","Fairfield County",2,35,2056,1022,1034
050,39,045,"Ohio","Fairfield County",2,36,2016,973,1043
050,39,045,"Ohio","Fairfield County",2,37,2122,1025,1097
050,39,045,"Ohio","Fairfield County",2,38,2195,1071,1124
050,39,045,"Ohio","Fairfield County",2,39,2146,1066,1080
050,39,045,"Ohio","Fairfield County",2,40,2139,1067,1072
050,39,045,"Ohio","Fairfield County",2,41,2097,1041,1056
050,39,045,"Ohio","Fairfield County",2,42,2051,1029,1022
050,39,045,"Ohio","Fairfield County",2,43,2020,993,1027
050,39,045,"Ohio","Fairfield County",2,44,1990,993,997
050,39,045,"Ohio","Fairfield County",2,45,2040,1038,1002
050,39,045,"Ohio","Fairfield County",2,46,1979,994,985
050,39,045,"Ohio","Fairfield County",2,47,2035,1041,994
050,39,045,"Ohio","Fairfield County",2,48,2174,1113,1061
050,39,045,"Ohio","Fairfield County",2,49,2329,1197,1132
050,39,045,"Ohio","Fairfield County",2,50,2268,1165,1103
050,39,045,"Ohio","Fairfield County",2,51,2203,1130,1073
050,39,045,"Ohio","Fairfield County",2,52,2118,1070,1048
050,39,045,"Ohio","Fairfield County",2,53,2087,1059,1028
050,39,045,"Ohio","Fairfield County",2,54,2105,1052,1053
050,39,045,"Ohio","Fairfield County",2,55,2200,1087,1113
050,39,045,"Ohio","Fairfield County",2,56,2219,1095,1124
050,39,045,"Ohio","Fairfield County",2,57,2231,1129,1102
050,39,045,"Ohio","Fairfield County",2,58,2237,1142,1095
050,39,045,"Ohio","Fairfield County",2,59,2191,1085,1106
050,39,045,"Ohio","Fairfield County",2,60,2089,1033,1056
050,39,045,"Ohio","Fairfield County",2,61,2055,1001,1054
050,39,045,"Ohio","Fairfield County",2,62,2043,1003,1040
050,39,045,"Ohio","Fairfield County",2,63,1978,968,1010
050,39,045,"Ohio","Fairfield County",2,64,1851,898,953
050,39,045,"Ohio","Fairfield County",2,65,1838,862,976
050,39,045,"Ohio","Fairfield County",2,66,1770,832,938
050,39,045,"Ohio","Fairfield County",2,67,1711,832,879
050,39,045,"Ohio","Fairfield County",2,68,1650,784,866
050,39,045,"Ohio","Fairfield County",2,69,1552,726,826
050,39,045,"Ohio","Fairfield County",2,70,1470,693,777
050,39,045,"Ohio","Fairfield County",2,71,1446,672,774
050,39,045,"Ohio","Fairfield County",2,72,1444,678,766
050,39,045,"Ohio","Fairfield County",2,73,1558,727,831
050,39,045,"Ohio","Fairfield County",2,74,1058,475,583
050,39,045,"Ohio","Fairfield County",2,75,1007,446,561
050,39,045,"Ohio","Fairfield County",2,76,992,445,547
050,39,045,"Ohio","Fairfield County",2,77,1046,464,582
050,39,045,"Ohio","Fairfield County",2,78,867,373,494
050,39,045,"Ohio","Fairfield County",2,79,775,345,430
050,39,045,"Ohio","Fairfield County",2,80,690,286,404
050,39,045,"Ohio","Fairfield County",2,81,638,268,370
050,39,045,"Ohio","Fairfield County",2,82,601,254,347
050,39,045,"Ohio","Fairfield County",2,83,528,220,308
050,39,045,"Ohio","Fairfield County",2,84,476,200,276
050,39,045,"Ohio","Fairfield County",2,85,2694,993,1701
050,39,045,"Ohio","Fairfield County",3,0,1651,859,792
050,39,045,"Ohio","Fairfield County",3,1,1755,890,865
050,39,045,"Ohio","Fairfield County",3,2,1868,964,904
050,39,045,"Ohio","Fairfield County",3,3,1955,939,1016
050,39,045,"Ohio","Fairfield County",3,4,2043,1031,1012
050,39,045,"Ohio","Fairfield County",3,5,2069,1063,1006
050,39,045,"Ohio","Fairfield County",3,6,2133,1079,1054
050,39,045,"Ohio","Fairfield County",3,7,2203,1137,1066
050,39,045,"Ohio","Fairfield County",3,8,2194,1143,1051
050,39,045,"Ohio","Fairfield County",3,9,2173,1152,1021
050,39,045,"Ohio","Fairfield County",3,10,2164,1146,1018
050,39,045,"Ohio","Fairfield County",3,11,2222,1155,1067
050,39,045,"Ohio","Fairfield County",3,12,2320,1201,1119
050,39,045,"Ohio","Fairfield County",3,13,2366,1210,1156
050,39,045,"Ohio","Fairfield County",3,14,2366,1226,1140
050,39,045,"Ohio","Fairfield County",3,15,2388,1224,1164
050,39,045,"Ohio","Fairfield County",3,16,2345,1213,1132
050,39,045,"Ohio","Fairfield County",3,17,2322,1188,1134
050,39,045,"Ohio","Fairfield County",3,18,2033,1079,954
050,39,045,"Ohio","Fairfield County",3,19,1685,923,762
050,39,045,"Ohio","Fairfield County",3,20,1799,976,823
050,39,045,"Ohio","Fairfield County",3,21,1907,1045,862
050,39,045,"Ohio","Fairfield County",3,22,1937,1034,903
050,39,045,"Ohio","Fairfield County",3,23,1945,1043,902
050,39,045,"Ohio","Fairfield County",3,24,1831,1013,818
050,39,045,"Ohio","Fairfield County",3,25,1793,983,810
050,39,045,"Ohio","Fairfield County",3,26,1844,977,867
050,39,045,"Ohio","Fairfield County",3,27,1850,956,894
050,39,045,"Ohio","Fairfield County",3,28,1859,973,886
050,39,045,"Ohio","Fairfield County",3,29,1863,978,885
050,39,045,"Ohio","Fairfield County",3,30,1951,1005,946
050,39,045,"Ohio","Fairfield County",3,31,2030,1018,1012
050,39,045,"Ohio","Fairfield County",3,32,1989,982,1007
050,39,045,"Ohio","Fairfield County",3,33,2011,994,1017
050,39,045,"Ohio","Fairfield County",3,34,2057,986,1071
050,39,045,"Ohio","Fairfield County",3,35,2096,1046,1050
050,39,045,"Ohio","Fairfield County",3,36,2121,1057,1064
050,39,045,"Ohio","Fairfield County",3,37,2071,1004,1067
050,39,045,"Ohio","Fairfield County",3,38,2182,1042,1140
050,39,045,"Ohio","Fairfield County",3,39,2211,1096,1115
050,39,045,"Ohio","Fairfield County",3,40,2204,1093,1111
050,39,045,"Ohio","Fairfield County",3,41,2184,1087,1097
050,39,045,"Ohio","Fairfield County",3,42,2113,1061,1052
050,39,045,"Ohio","Fairfield County",3,43,2095,1064,1031
050,39,045,"Ohio","Fairfield County",3,44,2077,1027,1050
050,39,045,"Ohio","Fairfield County",3,45,2024,1005,1019
050,39,045,"Ohio","Fairfield County",3,46,2082,1077,1005
050,39,045,"Ohio","Fairfield County",3,47,2023,1017,1006
050,39,045,"Ohio","Fairfield County",3,48,2042,1052,990
050,39,045,"Ohio","Fairfield County",3,49,2219,1143,1076
050,39,045,"Ohio","Fairfield County",3,50,2344,1202,1142
050,39,045,"Ohio","Fairfield County",3,51,2295,1183,1112
050,39,045,"Ohio","Fairfield County",3,52,2185,1114,1071
050,39,045,"Ohio","Fairfield County",3,53,2105,1074,1031
050,39,045,"Ohio","Fairfield County",3,54,2111,1073,1038
050,39,045,"Ohio","Fairfield County",3,55,2105,1052,1053
050,39,045,"Ohio","Fairfield County",3,56,2201,1089,1112
050,39,045,"Ohio","Fairfield County",3,57,2215,1094,1121
050,39,045,"Ohio","Fairfield County",3,58,2214,1130,1084
050,39,045,"Ohio","Fairfield County",3,59,2212,1120,1092
050,39,045,"Ohio","Fairfield County",3,60,2170,1088,1082
050,39,045,"Ohio","Fairfield County",3,61,2060,1034,1026
050,39,045,"Ohio","Fairfield County",3,62,2032,994,1038
050,39,045,"Ohio","Fairfield County",3,63,2005,987,1018
050,39,045,"Ohio","Fairfield County",3,64,1957,956,1001
050,39,045,"Ohio","Fairfield County",3,65,1828,887,941
050,39,045,"Ohio","Fairfield County",3,66,1797,845,952
050,39,045,"Ohio","Fairfield County",3,67,1716,795,921
050,39,045,"Ohio","Fairfield County",3,68,1679,807,872
050,39,045,"Ohio","Fairfield County",3,69,1615,758,857
050,39,045,"Ohio","Fairfield County",3,70,1519,701,818
050,39,045,"Ohio","Fairfield County",3,71,1430,668,762
050,39,045,"Ohio","Fairfield County",3,72,1399,647,752
050,39,045,"Ohio","Fairfield County",3,73,1412,667,745
050,39,045,"Ohio","Fairfield County",3,74,1498,688,810
050,39,045,"Ohio","Fairfield County",3,75,1012,459,553
050,39,045,"Ohio","Fairfield County",3,76,972,432,540
050,39,045,"Ohio","Fairfield County",3,77,967,421,546
050,39,045,"Ohio","Fairfield County",3,78,992,429,563
050,39,045,"Ohio","Fairfield County",3,79,816,357,459
050,39,045,"Ohio","Fairfield County",3,80,718,305,413
050,39,045,"Ohio","Fairfield County",3,81,656,282,374
050,39,045,"Ohio","Fairfield County",3,82,581,232,349
050,39,045,"Ohio","Fairfield County",3,83,544,226,318
050,39,045,"Ohio","Fairfield County",3,84,481,202,279
050,39,045,"Ohio","Fairfield County",3,85,2701,972,1729
050,39,045,"Ohio","Fairfield County",4,0,1734,906,828
050,39,045,"Ohio","Fairfield County",4,1,1787,952,835
050,39,045,"Ohio","Fairfield County",4,2,1847,959,888
050,39,045,"Ohio","Fairfield County",4,3,1931,995,936
050,39,045,"Ohio","Fairfield County",4,4,2081,1011,1070
050,39,045,"Ohio","Fairfield County",4,5,2121,1081,1040
050,39,045,"Ohio","Fairfield County",4,6,2147,1115,1032
050,39,045,"Ohio","Fairfield County",4,7,2211,1099,1112
050,39,045,"Ohio","Fairfield County",4,8,2267,1168,1099
050,39,045,"Ohio","Fairfield County",4,9,2240,1177,1063
050,39,045,"Ohio","Fairfield County",4,10,2238,1171,1067
050,39,045,"Ohio","Fairfield County",4,11,2193,1139,1054
050,39,045,"Ohio","Fairfield County",4,12,2269,1165,1104
050,39,045,"Ohio","Fairfield County",4,13,2343,1215,1128
050,39,045,"Ohio","Fairfield County",4,14,2436,1249,1187
050,39,045,"Ohio","Fairfield County",4,15,2387,1242,1145
050,39,045,"Ohio","Fairfield County",4,16,2431,1254,1177
050,39,045,"Ohio","Fairfield County",4,17,2331,1181,1150
050,39,045,"Ohio","Fairfield County",4,18,1973,1042,931
050,39,045,"Ohio","Fairfield County",4,19,1645,896,749
050,39,045,"Ohio","Fairfield County",4,20,1794,968,826
050,39,045,"Ohio","Fairfield County",4,21,1864,993,871
050,39,045,"Ohio","Fairfield County",4,22,1952,1031,921
050,39,045,"Ohio","Fairfield County",4,23,1965,1057,908
050,39,045,"Ohio","Fairfield County",4,24,1920,1071,849
050,39,045,"Ohio","Fairfield County",4,25,1820,1008,812
050,39,045,"Ohio","Fairfield County",4,26,1845,1010,835
050,39,045,"Ohio","Fairfield County",4,27,1885,1006,879
050,39,045,"Ohio","Fairfield County",4,28,1852,921,931
050,39,045,"Ohio","Fairfield County",4,29,1934,987,947
050,39,045,"Ohio","Fairfield County",4,30,1921,1010,911
050,39,045,"Ohio","Fairfield County",4,31,1963,1004,959
050,39,045,"Ohio","Fairfield County",4,32,2080,1040,1040
050,39,045,"Ohio","Fairfield County",4,33,2039,989,1050
050,39,045,"Ohio","Fairfield County",4,34,2085,1015,1070
050,39,045,"Ohio","Fairfield County",4,35,2122,1020,1102
050,39,045,"Ohio","Fairfield County",4,36,2167,1054,1113
050,39,045,"Ohio","Fairfield County",4,37,2204,1101,1103
050,39,045,"Ohio","Fairfield County",4,38,2109,1043,1066
050,39,045,"Ohio","Fairfield County",4,39,2209,1041,1168
050,39,045,"Ohio","Fairfield County",4,40,2269,1137,1132
050,39,045,"Ohio","Fairfield County",4,41,2249,1108,1141
050,39,045,"Ohio","Fairfield County",4,42,2221,1117,1104
050,39,045,"Ohio","Fairfield County",4,43,2144,1065,1079
050,39,045,"Ohio","Fairfield County",4,44,2129,1088,1041
050,39,045,"Ohio","Fairfield County",4,45,2100,1037,1063
050,39,045,"Ohio","Fairfield County",4,46,2054,1016,1038
050,39,045,"Ohio","Fairfield County",4,47,2104,1086,1018
050,39,045,"Ohio","Fairfield County",4,48,2029,1021,1008
050,39,045,"Ohio","Fairfield County",4,49,2052,1068,984
050,39,045,"Ohio","Fairfield County",4,50,2197,1135,1062
050,39,045,"Ohio","Fairfield County",4,51,2364,1222,1142
050,39,045,"Ohio","Fairfield County",4,52,2309,1188,1121
050,39,045,"Ohio","Fairfield County",4,53,2189,1113,1076
050,39,045,"Ohio","Fairfield County",4,54,2091,1062,1029
050,39,045,"Ohio","Fairfield County",4,55,2109,1070,1039
050,39,045,"Ohio","Fairfield County",4,56,2085,1030,1055
050,39,045,"Ohio","Fairfield County",4,57,2191,1090,1101
050,39,045,"Ohio","Fairfield County",4,58,2193,1080,1113
050,39,045,"Ohio","Fairfield County",4,59,2190,1117,1073
050,39,045,"Ohio","Fairfield County",4,60,2175,1092,1083
050,39,045,"Ohio","Fairfield County",4,61,2129,1067,1062
050,39,045,"Ohio","Fairfield County",4,62,2039,1023,1016
050,39,045,"Ohio","Fairfield County",4,63,1993,970,1023
050,39,045,"Ohio","Fairfield County",4,64,1999,979,1020
050,39,045,"Ohio","Fairfield County",4,65,1930,942,988
050,39,045,"Ohio","Fairfield County",4,66,1821,868,953
050,39,045,"Ohio","Fairfield County",4,67,1749,818,931
050,39,045,"Ohio","Fairfield County",4,68,1683,765,918
050,39,045,"Ohio","Fairfield County",4,69,1627,781,846
050,39,045,"Ohio","Fairfield County",4,70,1580,746,834
050,39,045,"Ohio","Fairfield County",4,71,1488,669,819
050,39,045,"Ohio","Fairfield County",4,72,1375,634,741
050,39,045,"Ohio","Fairfield County",4,73,1353,620,733
050,39,045,"Ohio","Fairfield County",4,74,1375,634,741
050,39,045,"Ohio","Fairfield County",4,75,1445,660,785
050,39,045,"Ohio","Fairfield County",4,76,965,448,517
050,39,045,"Ohio","Fairfield County",4,77,951,414,537
050,39,045,"Ohio","Fairfield County",4,78,909,386,523
050,39,045,"Ohio","Fairfield County",4,79,939,403,536
050,39,045,"Ohio","Fairfield County",4,80,759,330,429
050,39,045,"Ohio","Fairfield County",4,81,682,301,381
050,39,045,"Ohio","Fairfield County",4,82,611,255,356
050,39,045,"Ohio","Fairfield County",4,83,545,210,335
050,39,045,"Ohio","Fairfield County",4,84,497,217,280
050,39,045,"Ohio","Fairfield County",4,85,2726,969,1757
050,39,045,"Ohio","Fairfield County",5,0,1732,904,828
050,39,045,"Ohio","Fairfield County",5,1,1800,943,857
050,39,045,"Ohio","Fairfield County",5,2,1884,994,890
050,39,045,"Ohio","Fairfield County",5,3,1928,989,939
050,39,045,"Ohio","Fairfield County",5,4,2006,1033,973
050,39,045,"Ohio","Fairfield County",5,5,2162,1061,1101
050,39,045,"Ohio","Fairfield County",5,6,2230,1148,1082
050,39,045,"Ohio","Fairfield County",5,7,2232,1173,1059
050,39,045,"Ohio","Fairfield County",5,8,2247,1139,1108
050,39,045,"Ohio","Fairfield County",5,9,2307,1186,1121
050,39,045,"Ohio","Fairfield County",5,10,2291,1210,1081
050,39,045,"Ohio","Fairfield County",5,11,2282,1198,1084
050,39,045,"Ohio","Fairfield County",5,12,2220,1173,1047
050,39,045,"Ohio","Fairfield County",5,13,2302,1201,1101
050,39,045,"Ohio","Fairfield County",5,14,2410,1243,1167
050,39,045,"Ohio","Fairfield County",5,15,2441,1252,1189
050,39,045,"Ohio","Fairfield County",5,16,2430,1274,1156
050,39,045,"Ohio","Fairfield County",5,17,2459,1278,1181
050,39,045,"Ohio","Fairfield County",5,18,1960,1029,931
050,39,045,"Ohio","Fairfield County",5,19,1610,878,732
050,39,045,"Ohio","Fairfield County",5,20,1823,986,837
050,39,045,"Ohio","Fairfield County",5,21,1956,1041,915
050,39,045,"Ohio","Fairfield County",5,22,1951,1035,916
050,39,045,"Ohio","Fairfield County",5,23,2019,1065,954
050,39,045,"Ohio","Fairfield County",5,24,1984,1083,901
050,39,045,"Ohio","Fairfield County",5,25,1961,1103,858
050,39,045,"Ohio","Fairfield County",5,26,1802,992,810
050,39,045,"Ohio","Fairfield County",5,27,1904,1050,854
050,39,045,"Ohio","Fairfield County",5,28,1907,988,919
050,39,045,"Ohio","Fairfield County",5,29,1922,946,976
050,39,045,"Ohio","Fairfield County",5,30,1995,1008,987
050,39,045,"Ohio","Fairfield County",5,31,2009,1046,963
050,39,045,"Ohio","Fairfield County",5,32,2053,1058,995
050,39,045,"Ohio","Fairfield County",5,33,2169,1064,1105
050,39,045,"Ohio","Fairfield County",5,34,2118,1029,1089
050,39,045,"Ohio","Fairfield County",5,35,2168,1072,1096
050,39,045,"Ohio","Fairfield County",5,36,2154,1035,1119
050,39,045,"Ohio","Fairfield County",5,37,2220,1090,1130
050,39,045,"Ohio","Fairfield County",5,38,2237,1109,1128
050,39,045,"Ohio","Fairfield County",5,39,2156,1078,1078
050,39,045,"Ohio","Fairfield County",5,40,2259,1039,1220
050,39,045,"Ohio","Fairfield County",5,41,2305,1157,1148
050,39,045,"Ohio","Fairfield County",5,42,2292,1140,1152
050,39,045,"Ohio","Fairfield County",5,43,2262,1135,1127
050,39,045,"Ohio","Fairfield County",5,44,2162,1081,1081
050,39,045,"Ohio","Fairfield County",5,45,2139,1103,1036
050,39,045,"Ohio","Fairfield County",5,46,2103,1039,1064
050,39,045,"Ohio","Fairfield County",5,47,2082,1049,1033
050,39,045,"Ohio","Fairfield County",5,48,2107,1091,1016
050,39,045,"Ohio","Fairfield County",5,49,2060,1047,1013
050,39,045,"Ohio","Fairfield County",5,50,2043,1059,984
050,39,045,"Ohio","Fairfield County",5,51,2198,1153,1045
050,39,045,"Ohio","Fairfield County",5,52,2342,1193,1149
050,39,045,"Ohio","Fairfield County",5,53,2316,1176,1140
050,39,045,"Ohio","Fairfield County",5,54,2171,1103,1068
050,39,045,"Ohio","Fairfield County",5,55,2098,1072,1026
050,39,045,"Ohio","Fairfield County",5,56,2083,1057,1026
050,39,045,"Ohio","Fairfield County",5,57,2088,1050,1038
050,39,045,"Ohio","Fairfield County",5,58,2209,1099,1110
050,39,045,"Ohio","Fairfield County",5,59,2177,1050,1127
050,39,045,"Ohio","Fairfield County",5,60,2141,1078,1063
050,39,045,"Ohio","Fairfield County",5,61,2168,1084,1084
050,39,045,"Ohio","Fairfield County",5,62,2111,1050,1061
050,39,045,"Ohio","Fairfield County",5,63,2013,985,1028
050,39,045,"Ohio","Fairfield County",5,64,1990,971,1019
050,39,045,"Ohio","Fairfield County",5,65,1974,959,1015
050,39,045,"Ohio","Fairfield County",5,66,1946,948,998
050,39,045,"Ohio","Fairfield County",5,67,1786,851,935
050,39,045,"Ohio","Fairfield County",5,68,1730,794,936
050,39,045,"Ohio","Fairfield County",5,69,1635,733,902
050,39,045,"Ohio","Fairfield County",5,70,1608,770,838
050,39,045,"Ohio","Fairfield County",5,71,1564,735,829
050,39,045,"Ohio","Fairfield County",5,72,1444,658,786
050,39,045,"Ohio","Fairfield County",5,73,1349,617,732
050,39,045,"Ohio","Fairfield County",5,74,1311,590,721
050,39,045,"Ohio","Fairfield County",5,75,1351,618,733
050,39,045,"Ohio","Fairfield County",5,76,1391,645,746
050,39,045,"Ohio","Fairfield County",5,77,957,440,517
050,39,045,"Ohio","Fairfield County",5,78,907,385,522
050,39,045,"Ohio","Fairfield County",5,79,876,376,500
050,39,045,"Ohio","Fairfield County",5,80,903,380,523
050,39,045,"Ohio","Fairfield County",5,81,724,318,406
050,39,045,"Ohio","Fairfield County",5,82,644,275,369
050,39,045,"Ohio","Fairfield County",5,83,584,235,349
050,39,045,"Ohio","Fairfield County",5,84,510,202,308
050,39,045,"Ohio","Fairfield County",5,85,2806,996,1810
050,39,047,"Ohio","Fayette County",1,0,329,165,164
050,39,047,"Ohio","Fayette County",1,1,345,167,178
050,39,047,"Ohio","Fayette County",1,2,322,156,166
050,39,047,"Ohio","Fayette County",1,3,342,167,175
050,39,047,"Ohio","Fayette County",1,4,360,183,177
050,39,047,"Ohio","Fayette County",1,5,345,182,163
050,39,047,"Ohio","Fayette County",1,6,372,177,195
050,39,047,"Ohio","Fayette County",1,7,382,197,185
050,39,047,"Ohio","Fayette County",1,8,397,211,186
050,39,047,"Ohio","Fayette County",1,9,361,186,175
050,39,047,"Ohio","Fayette County",1,10,407,203,204
050,39,047,"Ohio","Fayette County",1,11,399,186,213
050,39,047,"Ohio","Fayette County",1,12,433,209,224
050,39,047,"Ohio","Fayette County",1,13,429,225,204
050,39,047,"Ohio","Fayette County",1,14,427,235,192
050,39,047,"Ohio","Fayette County",1,15,423,230,193
050,39,047,"Ohio","Fayette County",1,16,418,212,206
050,39,047,"Ohio","Fayette County",1,17,402,208,194
050,39,047,"Ohio","Fayette County",1,18,340,179,161
050,39,047,"Ohio","Fayette County",1,19,249,135,114
050,39,047,"Ohio","Fayette County",1,20,295,158,137
050,39,047,"Ohio","Fayette County",1,21,310,167,143
050,39,047,"Ohio","Fayette County",1,22,338,171,167
050,39,047,"Ohio","Fayette County",1,23,356,175,181
050,39,047,"Ohio","Fayette County",1,24,359,181,178
050,39,047,"Ohio","Fayette County",1,25,315,170,145
050,39,047,"Ohio","Fayette County",1,26,343,180,163
050,39,047,"Ohio","Fayette County",1,27,357,186,171
050,39,047,"Ohio","Fayette County",1,28,369,194,175
050,39,047,"Ohio","Fayette County",1,29,362,190,172
050,39,047,"Ohio","Fayette County",1,30,367,206,161
050,39,047,"Ohio","Fayette County",1,31,341,171,170
050,39,047,"Ohio","Fayette County",1,32,341,164,177
050,39,047,"Ohio","Fayette County",1,33,351,162,189
050,39,047,"Ohio","Fayette County",1,34,325,165,160
050,39,047,"Ohio","Fayette County",1,35,353,169,184
050,39,047,"Ohio","Fayette County",1,36,327,168,159
050,39,047,"Ohio","Fayette County",1,37,347,165,182
050,39,047,"Ohio","Fayette County",1,38,366,174,192
050,39,047,"Ohio","Fayette County",1,39,363,180,183
050,39,047,"Ohio","Fayette County",1,40,359,179,180
050,39,047,"Ohio","Fayette County",1,41,296,149,147
050,39,047,"Ohio","Fayette County",1,42,361,178,183
050,39,047,"Ohio","Fayette County",1,43,368,186,182
050,39,047,"Ohio","Fayette County",1,44,344,161,183
050,39,047,"Ohio","Fayette County",1,45,339,167,172
050,39,047,"Ohio","Fayette County",1,46,333,164,169
050,39,047,"Ohio","Fayette County",1,47,383,191,192
050,39,047,"Ohio","Fayette County",1,48,398,185,213
050,39,047,"Ohio","Fayette County",1,49,423,209,214
050,39,047,"Ohio","Fayette County",1,50,398,201,197
050,39,047,"Ohio","Fayette County",1,51,399,212,187
050,39,047,"Ohio","Fayette County",1,52,360,177,183
050,39,047,"Ohio","Fayette County",1,53,376,189,187
050,39,047,"Ohio","Fayette County",1,54,351,176,175
050,39,047,"Ohio","Fayette County",1,55,378,206,172
050,39,047,"Ohio","Fayette County",1,56,400,208,192
050,39,047,"Ohio","Fayette County",1,57,395,194,201
050,39,047,"Ohio","Fayette County",1,58,442,228,214
050,39,047,"Ohio","Fayette County",1,59,418,204,214
050,39,047,"Ohio","Fayette County",1,60,378,193,185
050,39,047,"Ohio","Fayette County",1,61,420,212,208
050,39,047,"Ohio","Fayette County",1,62,412,195,217
050,39,047,"Ohio","Fayette County",1,63,403,197,206
050,39,047,"Ohio","Fayette County",1,64,358,185,173
050,39,047,"Ohio","Fayette County",1,65,335,161,174
050,39,047,"Ohio","Fayette County",1,66,350,156,194
050,39,047,"Ohio","Fayette County",1,67,340,154,186
050,39,047,"Ohio","Fayette County",1,68,339,152,187
050,39,047,"Ohio","Fayette County",1,69,315,152,163
050,39,047,"Ohio","Fayette County",1,70,323,139,184
050,39,047,"Ohio","Fayette County",1,71,314,145,169
050,39,047,"Ohio","Fayette County",1,72,295,130,165
050,39,047,"Ohio","Fayette County",1,73,286,138,148
050,39,047,"Ohio","Fayette County",1,74,203,99,104
050,39,047,"Ohio","Fayette County",1,75,186,99,87
050,39,047,"Ohio","Fayette County",1,76,203,87,116
050,39,047,"Ohio","Fayette County",1,77,191,77,114
050,39,047,"Ohio","Fayette County",1,78,185,72,113
050,39,047,"Ohio","Fayette County",1,79,173,80,93
050,39,047,"Ohio","Fayette County",1,80,147,66,81
050,39,047,"Ohio","Fayette County",1,81,143,71,72
050,39,047,"Ohio","Fayette County",1,82,128,60,68
050,39,047,"Ohio","Fayette County",1,83,111,51,60
050,39,047,"Ohio","Fayette County",1,84,84,33,51
050,39,047,"Ohio","Fayette County",1,85,438,149,289
050,39,047,"Ohio","Fayette County",2,0,336,169,167
050,39,047,"Ohio","Fayette County",2,1,338,166,172
050,39,047,"Ohio","Fayette County",2,2,331,160,171
050,39,047,"Ohio","Fayette County",2,3,335,165,170
050,39,047,"Ohio","Fayette County",2,4,357,180,177
050,39,047,"Ohio","Fayette County",2,5,353,182,171
050,39,047,"Ohio","Fayette County",2,6,367,181,186
050,39,047,"Ohio","Fayette County",2,7,378,193,185
050,39,047,"Ohio","Fayette County",2,8,391,206,185
050,39,047,"Ohio","Fayette County",2,9,370,192,178
050,39,047,"Ohio","Fayette County",2,10,395,199,196
050,39,047,"Ohio","Fayette County",2,11,401,190,211
050,39,047,"Ohio","Fayette County",2,12,429,205,224
050,39,047,"Ohio","Fayette County",2,13,428,220,208
050,39,047,"Ohio","Fayette County",2,14,426,233,193
050,39,047,"Ohio","Fayette County",2,15,429,234,195
050,39,047,"Ohio","Fayette County",2,16,424,218,206
050,39,047,"Ohio","Fayette County",2,17,408,211,197
050,39,047,"Ohio","Fayette County",2,18,335,177,158
050,39,047,"Ohio","Fayette County",2,19,256,138,118
050,39,047,"Ohio","Fayette County",2,20,293,158,135
050,39,047,"Ohio","Fayette County",2,21,308,165,143
050,39,047,"Ohio","Fayette County",2,22,338,173,165
050,39,047,"Ohio","Fayette County",2,23,357,176,181
050,39,047,"Ohio","Fayette County",2,24,354,178,176
050,39,047,"Ohio","Fayette County",2,25,328,174,154
050,39,047,"Ohio","Fayette County",2,26,342,181,161
050,39,047,"Ohio","Fayette County",2,27,354,184,170
050,39,047,"Ohio","Fayette County",2,28,371,196,175
050,39,047,"Ohio","Fayette County",2,29,367,192,175
050,39,047,"Ohio","Fayette County",2,30,370,205,165
050,39,047,"Ohio","Fayette County",2,31,346,179,167
050,39,047,"Ohio","Fayette County",2,32,338,164,174
050,39,047,"Ohio","Fayette County",2,33,349,165,184
050,39,047,"Ohio","Fayette County",2,34,330,164,166
050,39,047,"Ohio","Fayette County",2,35,349,169,180
050,39,047,"Ohio","Fayette County",2,36,332,168,164
050,39,047,"Ohio","Fayette County",2,37,341,164,177
050,39,047,"Ohio","Fayette County",2,38,361,170,191
050,39,047,"Ohio","Fayette County",2,39,361,177,184
050,39,047,"Ohio","Fayette County",2,40,359,179,180
050,39,047,"Ohio","Fayette County",2,41,311,156,155
050,39,047,"Ohio","Fayette County",2,42,344,170,174
050,39,047,"Ohio","Fayette County",2,43,371,188,183
050,39,047,"Ohio","Fayette County",2,44,345,166,179
050,39,047,"Ohio","Fayette County",2,45,341,165,176
050,39,047,"Ohio","Fayette County",2,46,332,163,169
050,39,047,"Ohio","Fayette County",2,47,372,185,187
050,39,047,"Ohio","Fayette County",2,48,393,186,207
050,39,047,"Ohio","Fayette County",2,49,419,204,215
050,39,047,"Ohio","Fayette County",2,50,403,202,201
050,39,047,"Ohio","Fayette County",2,51,398,210,188
050,39,047,"Ohio","Fayette County",2,52,370,186,184
050,39,047,"Ohio","Fayette County",2,53,373,186,187
050,39,047,"Ohio","Fayette County",2,54,355,179,176
050,39,047,"Ohio","Fayette County",2,55,373,202,171
050,39,047,"Ohio","Fayette County",2,56,391,204,187
050,39,047,"Ohio","Fayette County",2,57,396,196,200
050,39,047,"Ohio","Fayette County",2,58,431,219,212
050,39,047,"Ohio","Fayette County",2,59,422,211,211
050,39,047,"Ohio","Fayette County",2,60,384,194,190
050,39,047,"Ohio","Fayette County",2,61,409,205,204
050,39,047,"Ohio","Fayette County",2,62,413,198,215
050,39,047,"Ohio","Fayette County",2,63,411,200,211
050,39,047,"Ohio","Fayette County",2,64,363,185,178
050,39,047,"Ohio","Fayette County",2,65,341,167,174
050,39,047,"Ohio","Fayette County",2,66,346,156,190
050,39,047,"Ohio","Fayette County",2,67,345,155,190
050,39,047,"Ohio","Fayette County",2,68,335,150,185
050,39,047,"Ohio","Fayette County",2,69,323,153,170
050,39,047,"Ohio","Fayette County",2,70,318,141,177
050,39,047,"Ohio","Fayette County",2,71,316,142,174
050,39,047,"Ohio","Fayette County",2,72,292,130,162
050,39,047,"Ohio","Fayette County",2,73,300,140,160
050,39,047,"Ohio","Fayette County",2,74,211,102,109
050,39,047,"Ohio","Fayette County",2,75,191,99,92
050,39,047,"Ohio","Fayette County",2,76,197,89,108
050,39,047,"Ohio","Fayette County",2,77,195,79,116
050,39,047,"Ohio","Fayette County",2,78,182,72,110
050,39,047,"Ohio","Fayette County",2,79,174,77,97
050,39,047,"Ohio","Fayette County",2,80,149,66,83
050,39,047,"Ohio","Fayette County",2,81,141,69,72
050,39,047,"Ohio","Fayette County",2,82,130,61,69
050,39,047,"Ohio","Fayette County",2,83,112,50,62
050,39,047,"Ohio","Fayette County",2,84,91,37,54
050,39,047,"Ohio","Fayette County",2,85,431,147,284
050,39,047,"Ohio","Fayette County",3,0,311,150,161
050,39,047,"Ohio","Fayette County",3,1,353,178,175
050,39,047,"Ohio","Fayette County",3,2,336,160,176
050,39,047,"Ohio","Fayette County",3,3,336,160,176
050,39,047,"Ohio","Fayette County",3,4,337,164,173
050,39,047,"Ohio","Fayette County",3,5,359,176,183
050,39,047,"Ohio","Fayette County",3,6,347,183,164
050,39,047,"Ohio","Fayette County",3,7,386,205,181
050,39,047,"Ohio","Fayette County",3,8,372,180,192
050,39,047,"Ohio","Fayette County",3,9,396,213,183
050,39,047,"Ohio","Fayette County",3,10,354,185,169
050,39,047,"Ohio","Fayette County",3,11,417,208,209
050,39,047,"Ohio","Fayette County",3,12,414,196,218
050,39,047,"Ohio","Fayette County",3,13,441,210,231
050,39,047,"Ohio","Fayette County",3,14,436,218,218
050,39,047,"Ohio","Fayette County",3,15,440,242,198
050,39,047,"Ohio","Fayette County",3,16,429,235,194
050,39,047,"Ohio","Fayette County",3,17,429,222,207
050,39,047,"Ohio","Fayette County",3,18,340,184,156
050,39,047,"Ohio","Fayette County",3,19,261,130,131
050,39,047,"Ohio","Fayette County",3,20,281,145,136
050,39,047,"Ohio","Fayette County",3,21,297,157,140
050,39,047,"Ohio","Fayette County",3,22,334,172,162
050,39,047,"Ohio","Fayette County",3,23,368,176,192
050,39,047,"Ohio","Fayette County",3,24,364,181,183
050,39,047,"Ohio","Fayette County",3,25,345,179,166
050,39,047,"Ohio","Fayette County",3,26,328,179,149
050,39,047,"Ohio","Fayette County",3,27,349,181,168
050,39,047,"Ohio","Fayette County",3,28,356,185,171
050,39,047,"Ohio","Fayette County",3,29,347,178,169
050,39,047,"Ohio","Fayette County",3,30,374,200,174
050,39,047,"Ohio","Fayette County",3,31,359,187,172
050,39,047,"Ohio","Fayette County",3,32,346,176,170
050,39,047,"Ohio","Fayette County",3,33,355,181,174
050,39,047,"Ohio","Fayette County",3,34,331,155,176
050,39,047,"Ohio","Fayette County",3,35,340,174,166
050,39,047,"Ohio","Fayette County",3,36,349,165,184
050,39,047,"Ohio","Fayette County",3,37,327,162,165
050,39,047,"Ohio","Fayette County",3,38,337,163,174
050,39,047,"Ohio","Fayette County",3,39,361,174,187
050,39,047,"Ohio","Fayette County",3,40,359,179,180
050,39,047,"Ohio","Fayette County",3,41,355,175,180
050,39,047,"Ohio","Fayette County",3,42,326,159,167
050,39,047,"Ohio","Fayette County",3,43,339,172,167
050,39,047,"Ohio","Fayette County",3,44,387,196,191
050,39,047,"Ohio","Fayette County",3,45,339,164,175
050,39,047,"Ohio","Fayette County",3,46,333,161,172
050,39,047,"Ohio","Fayette County",3,47,341,166,175
050,39,047,"Ohio","Fayette County",3,48,374,182,192
050,39,047,"Ohio","Fayette County",3,49,405,193,212
050,39,047,"Ohio","Fayette County",3,50,415,199,216
050,39,047,"Ohio","Fayette County",3,51,398,199,199
050,39,047,"Ohio","Fayette County",3,52,396,205,191
050,39,047,"Ohio","Fayette County",3,53,365,188,177
050,39,047,"Ohio","Fayette County",3,54,369,183,186
050,39,047,"Ohio","Fayette County",3,55,356,179,177
050,39,047,"Ohio","Fayette County",3,56,362,191,171
050,39,047,"Ohio","Fayette County",3,57,385,200,185
050,39,047,"Ohio","Fayette County",3,58,390,197,193
050,39,047,"Ohio","Fayette County",3,59,430,216,214
050,39,047,"Ohio","Fayette County",3,60,417,208,209
050,39,047,"Ohio","Fayette County",3,61,379,185,194
050,39,047,"Ohio","Fayette County",3,62,408,207,201
050,39,047,"Ohio","Fayette County",3,63,405,191,214
050,39,047,"Ohio","Fayette County",3,64,399,193,206
050,39,047,"Ohio","Fayette County",3,65,358,183,175
050,39,047,"Ohio","Fayette County",3,66,327,160,167
050,39,047,"Ohio","Fayette County",3,67,346,153,193
050,39,047,"Ohio","Fayette County",3,68,328,149,179
050,39,047,"Ohio","Fayette County",3,69,328,145,183
050,39,047,"Ohio","Fayette County",3,70,305,137,168
050,39,047,"Ohio","Fayette County",3,71,311,138,173
050,39,047,"Ohio","Fayette County",3,72,304,133,171
050,39,047,"Ohio","Fayette County",3,73,277,122,155
050,39,047,"Ohio","Fayette County",3,74,283,136,147
050,39,047,"Ohio","Fayette County",3,75,204,98,106
050,39,047,"Ohio","Fayette County",3,76,183,94,89
050,39,047,"Ohio","Fayette County",3,77,188,89,99
050,39,047,"Ohio","Fayette County",3,78,184,70,114
050,39,047,"Ohio","Fayette County",3,79,167,62,105
050,39,047,"Ohio","Fayette County",3,80,159,72,87
050,39,047,"Ohio","Fayette County",3,81,134,55,79
050,39,047,"Ohio","Fayette County",3,82,126,58,68
050,39,047,"Ohio","Fayette County",3,83,125,60,65
050,39,047,"Ohio","Fayette County",3,84,104,46,58
050,39,047,"Ohio","Fayette County",3,85,419,144,275
050,39,047,"Ohio","Fayette County",4,0,332,168,164
050,39,047,"Ohio","Fayette County",4,1,304,149,155
050,39,047,"Ohio","Fayette County",4,2,351,184,167
050,39,047,"Ohio","Fayette County",4,3,347,159,188
050,39,047,"Ohio","Fayette County",4,4,345,170,175
050,39,047,"Ohio","Fayette County",4,5,338,171,167
050,39,047,"Ohio","Fayette County",4,6,369,179,190
050,39,047,"Ohio","Fayette County",4,7,356,183,173
050,39,047,"Ohio","Fayette County",4,8,373,203,170
050,39,047,"Ohio","Fayette County",4,9,375,186,189
050,39,047,"Ohio","Fayette County",4,10,402,217,185
050,39,047,"Ohio","Fayette County",4,11,354,182,172
050,39,047,"Ohio","Fayette County",4,12,401,197,204
050,39,047,"Ohio","Fayette County",4,13,411,190,221
050,39,047,"Ohio","Fayette County",4,14,450,215,235
050,39,047,"Ohio","Fayette County",4,15,425,212,213
050,39,047,"Ohio","Fayette County",4,16,434,243,191
050,39,047,"Ohio","Fayette County",4,17,427,230,197
050,39,047,"Ohio","Fayette County",4,18,358,193,165
050,39,047,"Ohio","Fayette County",4,19,259,142,117
050,39,047,"Ohio","Fayette County",4,20,288,146,142
050,39,047,"Ohio","Fayette County",4,21,285,141,144
050,39,047,"Ohio","Fayette County",4,22,325,165,160
050,39,047,"Ohio","Fayette County",4,23,366,188,178
050,39,047,"Ohio","Fayette County",4,24,367,177,190
050,39,047,"Ohio","Fayette County",4,25,338,171,167
050,39,047,"Ohio","Fayette County",4,26,343,182,161
050,39,047,"Ohio","Fayette County",4,27,336,181,155
050,39,047,"Ohio","Fayette County",4,28,371,194,177
050,39,047,"Ohio","Fayette County",4,29,355,182,173
050,39,047,"Ohio","Fayette County",4,30,361,184,177
050,39,047,"Ohio","Fayette County",4,31,376,192,184
050,39,047,"Ohio","Fayette County",4,32,351,184,167
050,39,047,"Ohio","Fayette County",4,33,362,183,179
050,39,047,"Ohio","Fayette County",4,34,348,172,176
050,39,047,"Ohio","Fayette County",4,35,334,151,183
050,39,047,"Ohio","Fayette County",4,36,343,180,163
050,39,047,"Ohio","Fayette County",4,37,342,160,182
050,39,047,"Ohio","Fayette County",4,38,330,159,171
050,39,047,"Ohio","Fayette County",4,39,346,163,183
050,39,047,"Ohio","Fayette County",4,40,362,180,182
050,39,047,"Ohio","Fayette County",4,41,352,170,182
050,39,047,"Ohio","Fayette County",4,42,354,179,175
050,39,047,"Ohio","Fayette County",4,43,335,161,174
050,39,047,"Ohio","Fayette County",4,44,351,174,177
050,39,047,"Ohio","Fayette County",4,45,391,196,195
050,39,047,"Ohio","Fayette County",4,46,327,156,171
050,39,047,"Ohio","Fayette County",4,47,334,158,176
050,39,047,"Ohio","Fayette County",4,48,347,169,178
050,39,047,"Ohio","Fayette County",4,49,379,188,191
050,39,047,"Ohio","Fayette County",4,50,409,197,212
050,39,047,"Ohio","Fayette County",4,51,412,199,213
050,39,047,"Ohio","Fayette County",4,52,387,197,190
050,39,047,"Ohio","Fayette County",4,53,394,204,190
050,39,047,"Ohio","Fayette County",4,54,362,185,177
050,39,047,"Ohio","Fayette County",4,55,374,192,182
050,39,047,"Ohio","Fayette County",4,56,347,170,177
050,39,047,"Ohio","Fayette County",4,57,359,191,168
050,39,047,"Ohio","Fayette County",4,58,379,198,181
050,39,047,"Ohio","Fayette County",4,59,382,187,195
050,39,047,"Ohio","Fayette County",4,60,412,209,203
050,39,047,"Ohio","Fayette County",4,61,404,196,208
050,39,047,"Ohio","Fayette County",4,62,376,184,192
050,39,047,"Ohio","Fayette County",4,63,399,200,199
050,39,047,"Ohio","Fayette County",4,64,390,180,210
050,39,047,"Ohio","Fayette County",4,65,383,187,196
050,39,047,"Ohio","Fayette County",4,66,350,179,171
050,39,047,"Ohio","Fayette County",4,67,326,162,164
050,39,047,"Ohio","Fayette County",4,68,334,150,184
050,39,047,"Ohio","Fayette County",4,69,311,137,174
050,39,047,"Ohio","Fayette County",4,70,323,141,182
050,39,047,"Ohio","Fayette County",4,71,303,132,171
050,39,047,"Ohio","Fayette County",4,72,296,134,162
050,39,047,"Ohio","Fayette County",4,73,294,128,166
050,39,047,"Ohio","Fayette County",4,74,271,120,151
050,39,047,"Ohio","Fayette County",4,75,266,130,136
050,39,047,"Ohio","Fayette County",4,76,194,91,103
050,39,047,"Ohio","Fayette County",4,77,171,88,83
050,39,047,"Ohio","Fayette County",4,78,182,82,100
050,39,047,"Ohio","Fayette County",4,79,168,57,111
050,39,047,"Ohio","Fayette County",4,80,148,59,89
050,39,047,"Ohio","Fayette County",4,81,147,64,83
050,39,047,"Ohio","Fayette County",4,82,122,45,77
050,39,047,"Ohio","Fayette County",4,83,118,57,61
050,39,047,"Ohio","Fayette County",4,84,118,54,64
050,39,047,"Ohio","Fayette County",4,85,411,149,262
050,39,047,"Ohio","Fayette County",5,0,335,170,165
050,39,047,"Ohio","Fayette County",5,1,347,154,193
050,39,047,"Ohio","Fayette County",5,2,304,147,157
050,39,047,"Ohio","Fayette County",5,3,346,180,166
050,39,047,"Ohio","Fayette County",5,4,334,156,178
050,39,047,"Ohio","Fayette County",5,5,333,160,173
050,39,047,"Ohio","Fayette County",5,6,340,173,167
050,39,047,"Ohio","Fayette County",5,7,363,177,186
050,39,047,"Ohio","Fayette County",5,8,358,178,180
050,39,047,"Ohio","Fayette County",5,9,385,207,178
050,39,047,"Ohio","Fayette County",5,10,380,182,198
050,39,047,"Ohio","Fayette County",5,11,393,213,180
050,39,047,"Ohio","Fayette County",5,12,372,194,178
050,39,047,"Ohio","Fayette County",5,13,433,217,216
050,39,047,"Ohio","Fayette County",5,14,408,192,216
050,39,047,"Ohio","Fayette County",5,15,466,217,249
050,39,047,"Ohio","Fayette County",5,16,430,218,212
050,39,047,"Ohio","Fayette County",5,17,439,249,190
050,39,047,"Ohio","Fayette County",5,18,349,197,152
050,39,047,"Ohio","Fayette County",5,19,286,154,132
050,39,047,"Ohio","Fayette County",5,20,275,146,129
050,39,047,"Ohio","Fayette County",5,21,285,140,145
050,39,047,"Ohio","Fayette County",5,22,315,145,170
050,39,047,"Ohio","Fayette County",5,23,347,164,183
050,39,047,"Ohio","Fayette County",5,24,368,190,178
050,39,047,"Ohio","Fayette County",5,25,369,180,189
050,39,047,"Ohio","Fayette County",5,26,340,178,162
050,39,047,"Ohio","Fayette County",5,27,335,181,154
050,39,047,"Ohio","Fayette County",5,28,353,192,161
050,39,047,"Ohio","Fayette County",5,29,361,185,176
050,39,047,"Ohio","Fayette County",5,30,366,183,183
050,39,047,"Ohio","Fayette County",5,31,350,173,177
050,39,047,"Ohio","Fayette County",5,32,371,188,183
050,39,047,"Ohio","Fayette County",5,33,360,193,167
050,39,047,"Ohio","Fayette County",5,34,349,173,176
050,39,047,"Ohio","Fayette County",5,35,357,179,178
050,39,047,"Ohio","Fayette County",5,36,325,141,184
050,39,047,"Ohio","Fayette County",5,37,348,176,172
050,39,047,"Ohio","Fayette County",5,38,335,150,185
050,39,047,"Ohio","Fayette County",5,39,332,152,180
050,39,047,"Ohio","Fayette County",5,40,347,167,180
050,39,047,"Ohio","Fayette County",5,41,368,179,189
050,39,047,"Ohio","Fayette County",5,42,355,176,179
050,39,047,"Ohio","Fayette County",5,43,341,170,171
050,39,047,"Ohio","Fayette County",5,44,348,172,176
050,39,047,"Ohio","Fayette County",5,45,348,171,177
050,39,047,"Ohio","Fayette County",5,46,392,198,194
050,39,047,"Ohio","Fayette County",5,47,337,161,176
050,39,047,"Ohio","Fayette County",5,48,333,156,177
050,39,047,"Ohio","Fayette County",5,49,355,174,181
050,39,047,"Ohio","Fayette County",5,50,378,189,189
050,39,047,"Ohio","Fayette County",5,51,409,195,214
050,39,047,"Ohio","Fayette County",5,52,412,198,214
050,39,047,"Ohio","Fayette County",5,53,381,193,188
050,39,047,"Ohio","Fayette County",5,54,392,207,185
050,39,047,"Ohio","Fayette County",5,55,368,194,174
050,39,047,"Ohio","Fayette County",5,56,371,188,183
050,39,047,"Ohio","Fayette County",5,57,343,166,177
050,39,047,"Ohio","Fayette County",5,58,355,191,164
050,39,047,"Ohio","Fayette County",5,59,362,184,178
050,39,047,"Ohio","Fayette County",5,60,376,188,188
050,39,047,"Ohio","Fayette County",5,61,414,207,207
050,39,047,"Ohio","Fayette County",5,62,407,202,205
050,39,047,"Ohio","Fayette County",5,63,382,185,197
050,39,047,"Ohio","Fayette County",5,64,387,192,195
050,39,047,"Ohio","Fayette County",5,65,379,171,208
050,39,047,"Ohio","Fayette County",5,66,372,181,191
050,39,047,"Ohio","Fayette County",5,67,349,178,171
050,39,047,"Ohio","Fayette County",5,68,314,157,157
050,39,047,"Ohio","Fayette County",5,69,319,141,178
050,39,047,"Ohio","Fayette County",5,70,311,136,175
050,39,047,"Ohio","Fayette County",5,71,319,135,184
050,39,047,"Ohio","Fayette County",5,72,292,127,165
050,39,047,"Ohio","Fayette County",5,73,280,124,156
050,39,047,"Ohio","Fayette County",5,74,285,124,161
050,39,047,"Ohio","Fayette County",5,75,254,116,138
050,39,047,"Ohio","Fayette County",5,76,256,122,134
050,39,047,"Ohio","Fayette County",5,77,180,86,94
050,39,047,"Ohio","Fayette County",5,78,161,79,82
050,39,047,"Ohio","Fayette County",5,79,168,71,97
050,39,047,"Ohio","Fayette County",5,80,152,53,99
050,39,047,"Ohio","Fayette County",5,81,139,55,84
050,39,047,"Ohio","Fayette County",5,82,130,52,78
050,39,047,"Ohio","Fayette County",5,83,117,45,72
050,39,047,"Ohio","Fayette County",5,84,109,51,58
050,39,047,"Ohio","Fayette County",5,85,428,166,262
050,39,049,"Ohio","Franklin County",1,0,18100,9245,8855
050,39,049,"Ohio","Franklin County",1,1,17858,9111,8747
050,39,049,"Ohio","Franklin County",1,2,18158,9254,8904
050,39,049,"Ohio","Franklin County",1,3,18374,9397,8977
050,39,049,"Ohio","Franklin County",1,4,18298,9347,8951
050,39,049,"Ohio","Franklin County",1,5,18293,9239,9054
050,39,049,"Ohio","Franklin County",1,6,17829,9066,8763
050,39,049,"Ohio","Franklin County",1,7,17708,9051,8657
050,39,049,"Ohio","Franklin County",1,8,17196,8917,8279
050,39,049,"Ohio","Franklin County",1,9,16733,8598,8135
050,39,049,"Ohio","Franklin County",1,10,17168,8665,8503
050,39,049,"Ohio","Franklin County",1,11,17130,8631,8499
050,39,049,"Ohio","Franklin County",1,12,17269,8806,8463
050,39,049,"Ohio","Franklin County",1,13,17156,8733,8423
050,39,049,"Ohio","Franklin County",1,14,16477,8339,8138
050,39,049,"Ohio","Franklin County",1,15,16123,8149,7974
050,39,049,"Ohio","Franklin County",1,16,16010,8085,7925
050,39,049,"Ohio","Franklin County",1,17,15701,7923,7778
050,39,049,"Ohio","Franklin County",1,18,17403,8743,8660
050,39,049,"Ohio","Franklin County",1,19,20216,10325,9891
050,39,049,"Ohio","Franklin County",1,20,16834,8584,8250
050,39,049,"Ohio","Franklin County",1,21,15655,7775,7880
050,39,049,"Ohio","Franklin County",1,22,16706,8111,8595
050,39,049,"Ohio","Franklin County",1,23,19027,9283,9744
050,39,049,"Ohio","Franklin County",1,24,20999,10403,10596
050,39,049,"Ohio","Franklin County",1,25,22149,10831,11318
050,39,049,"Ohio","Franklin County",1,26,23099,11264,11835
050,39,049,"Ohio","Franklin County",1,27,23934,11938,11996
050,39,049,"Ohio","Franklin County",1,28,24202,12036,12166
050,39,049,"Ohio","Franklin County",1,29,25021,12494,12527
050,39,049,"Ohio","Franklin County",1,30,25495,12643,12852
050,39,049,"Ohio","Franklin County",1,31,24952,12390,12562
050,39,049,"Ohio","Franklin County",1,32,23705,11867,11838
050,39,049,"Ohio","Franklin County",1,33,22741,11500,11241
050,39,049,"Ohio","Franklin County",1,34,21853,11073,10780
050,39,049,"Ohio","Franklin County",1,35,20986,10563,10423
050,39,049,"Ohio","Franklin County",1,36,19951,10020,9931
050,39,049,"Ohio","Franklin County",1,37,19631,9813,9818
050,39,049,"Ohio","Franklin County",1,38,19356,9679,9677
050,39,049,"Ohio","Franklin County",1,39,19033,9583,9450
050,39,049,"Ohio","Franklin County",1,40,18302,9164,9138
050,39,049,"Ohio","Franklin County",1,41,17333,8727,8606
050,39,049,"Ohio","Franklin County",1,42,16773,8483,8290
050,39,049,"Ohio","Franklin County",1,43,16098,7989,8109
050,39,049,"Ohio","Franklin County",1,44,15527,7643,7884
050,39,049,"Ohio","Franklin County",1,45,15395,7651,7744
050,39,049,"Ohio","Franklin County",1,46,14945,7488,7457
050,39,049,"Ohio","Franklin County",1,47,15030,7494,7536
050,39,049,"Ohio","Franklin County",1,48,15953,7912,8041
050,39,049,"Ohio","Franklin County",1,49,16894,8365,8529
050,39,049,"Ohio","Franklin County",1,50,16169,8151,8018
050,39,049,"Ohio","Franklin County",1,51,15534,7799,7735
050,39,049,"Ohio","Franklin County",1,52,14944,7473,7471
050,39,049,"Ohio","Franklin County",1,53,14658,7391,7267
050,39,049,"Ohio","Franklin County",1,54,14515,7265,7250
050,39,049,"Ohio","Franklin County",1,55,15336,7570,7766
050,39,049,"Ohio","Franklin County",1,56,15625,7633,7992
050,39,049,"Ohio","Franklin County",1,57,15410,7520,7890
050,39,049,"Ohio","Franklin County",1,58,15534,7586,7948
050,39,049,"Ohio","Franklin County",1,59,15394,7492,7902
050,39,049,"Ohio","Franklin County",1,60,15206,7353,7853
050,39,049,"Ohio","Franklin County",1,61,14998,7139,7859
050,39,049,"Ohio","Franklin County",1,62,14674,6845,7829
050,39,049,"Ohio","Franklin County",1,63,14119,6668,7451
050,39,049,"Ohio","Franklin County",1,64,13353,6393,6960
050,39,049,"Ohio","Franklin County",1,65,12864,6087,6777
050,39,049,"Ohio","Franklin County",1,66,12009,5577,6432
050,39,049,"Ohio","Franklin County",1,67,11562,5345,6217
050,39,049,"Ohio","Franklin County",1,68,11184,5173,6011
050,39,049,"Ohio","Franklin County",1,69,10317,4613,5704
050,39,049,"Ohio","Franklin County",1,70,9851,4443,5408
050,39,049,"Ohio","Franklin County",1,71,9521,4286,5235
050,39,049,"Ohio","Franklin County",1,72,9256,4112,5144
050,39,049,"Ohio","Franklin County",1,73,8972,3979,4993
050,39,049,"Ohio","Franklin County",1,74,6133,2681,3452
050,39,049,"Ohio","Franklin County",1,75,5811,2489,3322
050,39,049,"Ohio","Franklin County",1,76,5628,2388,3240
050,39,049,"Ohio","Franklin County",1,77,5717,2382,3335
050,39,049,"Ohio","Franklin County",1,78,4931,2077,2854
050,39,049,"Ohio","Franklin County",1,79,4380,1825,2555
050,39,049,"Ohio","Franklin County",1,80,3991,1631,2360
050,39,049,"Ohio","Franklin County",1,81,3721,1482,2239
050,39,049,"Ohio","Franklin County",1,82,3316,1323,1993
050,39,049,"Ohio","Franklin County",1,83,2969,1149,1820
050,39,049,"Ohio","Franklin County",1,84,2814,1083,1731
050,39,049,"Ohio","Franklin County",1,85,16615,5715,10900
050,39,049,"Ohio","Franklin County",2,0,17885,9180,8705
050,39,049,"Ohio","Franklin County",2,1,17823,9102,8721
050,39,049,"Ohio","Franklin County",2,2,18060,9202,8858
050,39,049,"Ohio","Franklin County",2,3,18224,9320,8904
050,39,049,"Ohio","Franklin County",2,4,18278,9328,8950
050,39,049,"Ohio","Franklin County",2,5,18230,9229,9001
050,39,049,"Ohio","Franklin County",2,6,17923,9096,8827
050,39,049,"Ohio","Franklin County",2,7,17688,9032,8656
050,39,049,"Ohio","Franklin County",2,8,17231,8895,8336
050,39,049,"Ohio","Franklin County",2,9,16795,8655,8140
050,39,049,"Ohio","Franklin County",2,10,17005,8617,8388
050,39,049,"Ohio","Franklin County",2,11,17028,8581,8447
050,39,049,"Ohio","Franklin County",2,12,17268,8778,8490
050,39,049,"Ohio","Franklin County",2,13,17142,8732,8410
050,39,049,"Ohio","Franklin County",2,14,16603,8414,8189
050,39,049,"Ohio","Franklin County",2,15,16196,8184,8012
050,39,049,"Ohio","Franklin County",2,16,16034,8099,7935
050,39,049,"Ohio","Franklin County",2,17,15760,7948,7812
050,39,049,"Ohio","Franklin County",2,18,17367,8711,8656
050,39,049,"Ohio","Franklin County",2,19,20259,10342,9917
050,39,049,"Ohio","Franklin County",2,20,17079,8684,8395
050,39,049,"Ohio","Franklin County",2,21,15755,7846,7909
050,39,049,"Ohio","Franklin County",2,22,16855,8180,8675
050,39,049,"Ohio","Franklin County",2,23,18934,9222,9712
050,39,049,"Ohio","Franklin County",2,24,20765,10267,10498
050,39,049,"Ohio","Franklin County",2,25,22044,10828,11216
050,39,049,"Ohio","Franklin County",2,26,23016,11273,11743
050,39,049,"Ohio","Franklin County",2,27,23718,11787,11931
050,39,049,"Ohio","Franklin County",2,28,24135,12045,12090
050,39,049,"Ohio","Franklin County",2,29,24749,12340,12409
050,39,049,"Ohio","Franklin County",2,30,25393,12612,12781
050,39,049,"Ohio","Franklin County",2,31,24874,12345,12529
050,39,049,"Ohio","Franklin County",2,32,23848,11913,11935
050,39,049,"Ohio","Franklin County",2,33,22819,11521,11298
050,39,049,"Ohio","Franklin County",2,34,21965,11132,10833
050,39,049,"Ohio","Franklin County",2,35,21238,10716,10522
050,39,049,"Ohio","Franklin County",2,36,19999,10051,9948
050,39,049,"Ohio","Franklin County",2,37,19669,9839,9830
050,39,049,"Ohio","Franklin County",2,38,19432,9713,9719
050,39,049,"Ohio","Franklin County",2,39,18959,9520,9439
050,39,049,"Ohio","Franklin County",2,40,18550,9295,9255
050,39,049,"Ohio","Franklin County",2,41,17517,8794,8723
050,39,049,"Ohio","Franklin County",2,42,16770,8475,8295
050,39,049,"Ohio","Franklin County",2,43,16301,8131,8170
050,39,049,"Ohio","Franklin County",2,44,15493,7641,7852
050,39,049,"Ohio","Franklin County",2,45,15458,7659,7799
050,39,049,"Ohio","Franklin County",2,46,14964,7475,7489
050,39,049,"Ohio","Franklin County",2,47,14933,7446,7487
050,39,049,"Ohio","Franklin County",2,48,15691,7780,7911
050,39,049,"Ohio","Franklin County",2,49,16704,8272,8432
050,39,049,"Ohio","Franklin County",2,50,16360,8206,8154
050,39,049,"Ohio","Franklin County",2,51,15584,7831,7753
050,39,049,"Ohio","Franklin County",2,52,15035,7526,7509
050,39,049,"Ohio","Franklin County",2,53,14666,7368,7298
050,39,049,"Ohio","Franklin County",2,54,14469,7253,7216
050,39,049,"Ohio","Franklin County",2,55,15101,7472,7629
050,39,049,"Ohio","Franklin County",2,56,15523,7591,7932
050,39,049,"Ohio","Franklin County",2,57,15414,7522,7892
050,39,049,"Ohio","Franklin County",2,58,15433,7532,7901
050,39,049,"Ohio","Franklin County",2,59,15423,7498,7925
050,39,049,"Ohio","Franklin County",2,60,15152,7338,7814
050,39,049,"Ohio","Franklin County",2,61,14940,7130,7810
050,39,049,"Ohio","Franklin County",2,62,14658,6867,7791
050,39,049,"Ohio","Franklin County",2,63,14291,6717,7574
050,39,049,"Ohio","Franklin County",2,64,13429,6412,7017
050,39,049,"Ohio","Franklin County",2,65,12863,6089,6774
050,39,049,"Ohio","Franklin County",2,66,12164,5661,6503
050,39,049,"Ohio","Franklin County",2,67,11555,5333,6222
050,39,049,"Ohio","Franklin County",2,68,11145,5156,5989
050,39,049,"Ohio","Franklin County",2,69,10518,4724,5794
050,39,049,"Ohio","Franklin County",2,70,9864,4431,5433
050,39,049,"Ohio","Franklin County",2,71,9546,4293,5253
050,39,049,"Ohio","Franklin County",2,72,9131,4060,5071
050,39,049,"Ohio","Franklin County",2,73,9380,4168,5212
050,39,049,"Ohio","Franklin County",2,74,6393,2805,3588
050,39,049,"Ohio","Franklin County",2,75,5849,2506,3343
050,39,049,"Ohio","Franklin County",2,76,5574,2367,3207
050,39,049,"Ohio","Franklin County",2,77,5753,2398,3355
050,39,049,"Ohio","Franklin County",2,78,4977,2081,2896
050,39,049,"Ohio","Franklin County",2,79,4443,1855,2588
050,39,049,"Ohio","Franklin County",2,80,4044,1656,2388
050,39,049,"Ohio","Franklin County",2,81,3713,1486,2227
050,39,049,"Ohio","Franklin County",2,82,3339,1329,2010
050,39,049,"Ohio","Franklin County",2,83,2994,1173,1821
050,39,049,"Ohio","Franklin County",2,84,2782,1073,1709
050,39,049,"Ohio","Franklin County",2,85,16510,5689,10821
050,39,049,"Ohio","Franklin County",3,0,17121,8690,8431
050,39,049,"Ohio","Franklin County",3,1,17499,8963,8536
050,39,049,"Ohio","Franklin County",3,2,17434,8941,8493
050,39,049,"Ohio","Franklin County",3,3,17811,9146,8665
050,39,049,"Ohio","Franklin County",3,4,17870,9150,8720
050,39,049,"Ohio","Franklin County",3,5,17934,9136,8798
050,39,049,"Ohio","Franklin County",3,6,17932,9058,8874
050,39,049,"Ohio","Franklin County",3,7,17615,8945,8670
050,39,049,"Ohio","Franklin County",3,8,17450,8902,8548
050,39,049,"Ohio","Franklin County",3,9,17037,8799,8238
050,39,049,"Ohio","Franklin County",3,10,16656,8553,8103
050,39,049,"Ohio","Franklin County",3,11,16836,8523,8313
050,39,049,"Ohio","Franklin County",3,12,16936,8559,8377
050,39,049,"Ohio","Franklin County",3,13,17133,8714,8419
050,39,049,"Ohio","Franklin County",3,14,17036,8650,8386
050,39,049,"Ohio","Franklin County",3,15,16403,8336,8067
050,39,049,"Ohio","Franklin County",3,16,16072,8108,7964
050,39,049,"Ohio","Franklin County",3,17,15954,8086,7868
050,39,049,"Ohio","Franklin County",3,18,16240,8229,8011
050,39,049,"Ohio","Franklin County",3,19,17406,8867,8539
050,39,049,"Ohio","Franklin County",3,20,15889,8055,7834
050,39,049,"Ohio","Franklin County",3,21,15564,7801,7763
050,39,049,"Ohio","Franklin County",3,22,16358,7963,8395
050,39,049,"Ohio","Franklin County",3,23,18940,8996,9944
050,39,049,"Ohio","Franklin County",3,24,20585,10002,10583
050,39,049,"Ohio","Franklin County",3,25,21687,10712,10975
050,39,049,"Ohio","Franklin County",3,26,22406,11055,11351
050,39,049,"Ohio","Franklin County",3,27,23077,11338,11739
050,39,049,"Ohio","Franklin County",3,28,23402,11715,11687
050,39,049,"Ohio","Franklin County",3,29,23859,11972,11887
050,39,049,"Ohio","Franklin County",3,30,24385,12185,12200
050,39,049,"Ohio","Franklin County",3,31,24959,12430,12529
050,39,049,"Ohio","Franklin County",3,32,24250,12040,12210
050,39,049,"Ohio","Franklin County",3,33,23175,11574,11601
050,39,049,"Ohio","Franklin County",3,34,22282,11270,11012
050,39,049,"Ohio","Franklin County",3,35,21478,10890,10588
050,39,049,"Ohio","Franklin County",3,36,20697,10483,10214
050,39,049,"Ohio","Franklin County",3,37,19514,9809,9705
050,39,049,"Ohio","Franklin County",3,38,19300,9652,9648
050,39,049,"Ohio","Franklin County",3,39,19004,9444,9560
050,39,049,"Ohio","Franklin County",3,40,18612,9303,9309
050,39,049,"Ohio","Franklin County",3,41,18327,9203,9124
050,39,049,"Ohio","Franklin County",3,42,17195,8588,8607
050,39,049,"Ohio","Franklin County",3,43,16489,8331,8158
050,39,049,"Ohio","Franklin County",3,44,16092,7983,8109
050,39,049,"Ohio","Franklin County",3,45,15280,7527,7753
050,39,049,"Ohio","Franklin County",3,46,15282,7528,7754
050,39,049,"Ohio","Franklin County",3,47,14727,7378,7349
050,39,049,"Ohio","Franklin County",3,48,14766,7323,7443
050,39,049,"Ohio","Franklin County",3,49,15465,7705,7760
050,39,049,"Ohio","Franklin County",3,50,16521,8232,8289
050,39,049,"Ohio","Franklin County",3,51,16191,8105,8086
050,39,049,"Ohio","Franklin County",3,52,15348,7702,7646
050,39,049,"Ohio","Franklin County",3,53,14743,7386,7357
050,39,049,"Ohio","Franklin County",3,54,14406,7247,7159
050,39,049,"Ohio","Franklin County",3,55,14236,7128,7108
050,39,049,"Ohio","Franklin County",3,56,14817,7258,7559
050,39,049,"Ohio","Franklin County",3,57,15204,7442,7762
050,39,049,"Ohio","Franklin County",3,58,15112,7347,7765
050,39,049,"Ohio","Franklin County",3,59,15034,7326,7708
050,39,049,"Ohio","Franklin County",3,60,15035,7308,7727
050,39,049,"Ohio","Franklin County",3,61,14774,7097,7677
050,39,049,"Ohio","Franklin County",3,62,14665,6995,7670
050,39,049,"Ohio","Franklin County",3,63,14260,6636,7624
050,39,049,"Ohio","Franklin County",3,64,14044,6589,7455
050,39,049,"Ohio","Franklin County",3,65,13087,6208,6879
050,39,049,"Ohio","Franklin County",3,66,12489,5886,6603
050,39,049,"Ohio","Franklin County",3,67,11824,5462,6362
050,39,049,"Ohio","Franklin County",3,68,11265,5169,6096
050,39,049,"Ohio","Franklin County",3,69,10904,5008,5896
050,39,049,"Ohio","Franklin County",3,70,10156,4522,5634
050,39,049,"Ohio","Franklin County",3,71,9657,4308,5349
050,39,049,"Ohio","Franklin County",3,72,9258,4123,5135
050,39,049,"Ohio","Franklin County",3,73,8856,3944,4912
050,39,049,"Ohio","Franklin County",3,74,9109,4008,5101
050,39,049,"Ohio","Franklin County",3,75,6148,2669,3479
050,39,049,"Ohio","Franklin County",3,76,5601,2374,3227
050,39,049,"Ohio","Franklin County",3,77,5360,2261,3099
050,39,049,"Ohio","Franklin County",3,78,5466,2252,3214
050,39,049,"Ohio","Franklin County",3,79,4726,1966,2760
050,39,049,"Ohio","Franklin County",3,80,4224,1740,2484
050,39,049,"Ohio","Franklin County",3,81,3818,1519,2299
050,39,049,"Ohio","Franklin County",3,82,3425,1365,2060
050,39,049,"Ohio","Franklin County",3,83,3119,1231,1888
050,39,049,"Ohio","Franklin County",3,84,2718,1049,1669
050,39,049,"Ohio","Franklin County",3,85,16325,5650,10675
050,39,049,"Ohio","Franklin County",4,0,17382,8833,8549
050,39,049,"Ohio","Franklin County",4,1,16804,8496,8308
050,39,049,"Ohio","Franklin County",4,2,17030,8645,8385
050,39,049,"Ohio","Franklin County",4,3,17171,8819,8352
050,39,049,"Ohio","Franklin County",4,4,17682,9024,8658
050,39,049,"Ohio","Franklin County",4,5,17681,9045,8636
050,39,049,"Ohio","Franklin County",4,6,17724,9053,8671
050,39,049,"Ohio","Franklin County",4,7,17611,8864,8747
050,39,049,"Ohio","Franklin County",4,8,17414,8857,8557
050,39,049,"Ohio","Franklin County",4,9,17322,8810,8512
050,39,049,"Ohio","Franklin County",4,10,16882,8753,8129
050,39,049,"Ohio","Franklin County",4,11,16525,8501,8024
050,39,049,"Ohio","Franklin County",4,12,16768,8488,8280
050,39,049,"Ohio","Franklin County",4,13,16922,8568,8354
050,39,049,"Ohio","Franklin County",4,14,17083,8725,8358
050,39,049,"Ohio","Franklin County",4,15,16834,8542,8292
050,39,049,"Ohio","Franklin County",4,16,16416,8341,8075
050,39,049,"Ohio","Franklin County",4,17,16198,8170,8028
050,39,049,"Ohio","Franklin County",4,18,17266,8696,8570
050,39,049,"Ohio","Franklin County",4,19,19231,9780,9451
050,39,049,"Ohio","Franklin County",4,20,16527,8351,8176
050,39,049,"Ohio","Franklin County",4,21,16045,8053,7992
050,39,049,"Ohio","Franklin County",4,22,17023,8401,8622
050,39,049,"Ohio","Franklin County",4,23,18657,8989,9668
050,39,049,"Ohio","Franklin County",4,24,20688,9931,10757
050,39,049,"Ohio","Franklin County",4,25,21528,10538,10990
050,39,049,"Ohio","Franklin County",4,26,22104,10946,11158
050,39,049,"Ohio","Franklin County",4,27,22551,11136,11415
050,39,049,"Ohio","Franklin County",4,28,23026,11348,11678
050,39,049,"Ohio","Franklin County",4,29,23198,11684,11514
050,39,049,"Ohio","Franklin County",4,30,23403,11695,11708
050,39,049,"Ohio","Franklin County",4,31,23832,11930,11902
050,39,049,"Ohio","Franklin County",4,32,24457,12225,12232
050,39,049,"Ohio","Franklin County",4,33,23588,11727,11861
050,39,049,"Ohio","Franklin County",4,34,22696,11334,11362
050,39,049,"Ohio","Franklin County",4,35,21676,10961,10715
050,39,049,"Ohio","Franklin County",4,36,21125,10795,10330
050,39,049,"Ohio","Franklin County",4,37,20235,10232,10003
050,39,049,"Ohio","Franklin County",4,38,19200,9673,9527
050,39,049,"Ohio","Franklin County",4,39,18916,9406,9510
050,39,049,"Ohio","Franklin County",4,40,18631,9220,9411
050,39,049,"Ohio","Franklin County",4,41,18390,9230,9160
050,39,049,"Ohio","Franklin County",4,42,18003,9004,8999
050,39,049,"Ohio","Franklin County",4,43,16945,8497,8448
050,39,049,"Ohio","Franklin County",4,44,16332,8202,8130
050,39,049,"Ohio","Franklin County",4,45,15818,7848,7970
050,39,049,"Ohio","Franklin County",4,46,15125,7414,7711
050,39,049,"Ohio","Franklin County",4,47,15034,7426,7608
050,39,049,"Ohio","Franklin County",4,48,14534,7227,7307
050,39,049,"Ohio","Franklin County",4,49,14499,7193,7306
050,39,049,"Ohio","Franklin County",4,50,15367,7667,7700
050,39,049,"Ohio","Franklin County",4,51,16321,8097,8224
050,39,049,"Ohio","Franklin County",4,52,15896,7931,7965
050,39,049,"Ohio","Franklin County",4,53,15041,7539,7502
050,39,049,"Ohio","Franklin County",4,54,14527,7259,7268
050,39,049,"Ohio","Franklin County",4,55,14136,7086,7050
050,39,049,"Ohio","Franklin County",4,56,13993,6956,7037
050,39,049,"Ohio","Franklin County",4,57,14400,7071,7329
050,39,049,"Ohio","Franklin County",4,58,14871,7251,7620
050,39,049,"Ohio","Franklin County",4,59,14781,7154,7627
050,39,049,"Ohio","Franklin County",4,60,14694,7204,7490
050,39,049,"Ohio","Franklin County",4,61,14614,7060,7554
050,39,049,"Ohio","Franklin County",4,62,14415,6924,7491
050,39,049,"Ohio","Franklin County",4,63,14217,6756,7461
050,39,049,"Ohio","Franklin County",4,64,13859,6443,7416
050,39,049,"Ohio","Franklin County",4,65,13568,6348,7220
050,39,049,"Ohio","Franklin County",4,66,12625,5941,6684
050,39,049,"Ohio","Franklin County",4,67,12135,5713,6422
050,39,049,"Ohio","Franklin County",4,68,11491,5274,6217
050,39,049,"Ohio","Franklin County",4,69,10943,4997,5946
050,39,049,"Ohio","Franklin County",4,70,10561,4815,5746
050,39,049,"Ohio","Franklin County",4,71,9892,4389,5503
050,39,049,"Ohio","Franklin County",4,72,9395,4155,5240
050,39,049,"Ohio","Franklin County",4,73,9002,3984,5018
050,39,049,"Ohio","Franklin County",4,74,8541,3738,4803
050,39,049,"Ohio","Franklin County",4,75,8788,3837,4951
050,39,049,"Ohio","Franklin County",4,76,5924,2561,3363
050,39,049,"Ohio","Franklin County",4,77,5408,2270,3138
050,39,049,"Ohio","Franklin County",4,78,5110,2136,2974
050,39,049,"Ohio","Franklin County",4,79,5230,2155,3075
050,39,049,"Ohio","Franklin County",4,80,4471,1829,2642
050,39,049,"Ohio","Franklin County",4,81,3979,1591,2388
050,39,049,"Ohio","Franklin County",4,82,3508,1394,2114
050,39,049,"Ohio","Franklin County",4,83,3203,1260,1943
050,39,049,"Ohio","Franklin County",4,84,2868,1092,1776
050,39,049,"Ohio","Franklin County",4,85,16224,5604,10620
050,39,049,"Ohio","Franklin County",5,0,17444,8875,8569
050,39,049,"Ohio","Franklin County",5,1,17132,8749,8383
050,39,049,"Ohio","Franklin County",5,2,16454,8321,8133
050,39,049,"Ohio","Franklin County",5,3,16829,8593,8236
050,39,049,"Ohio","Franklin County",5,4,17100,8757,8343
050,39,049,"Ohio","Franklin County",5,5,17491,8923,8568
050,39,049,"Ohio","Franklin County",5,6,17465,8931,8534
050,39,049,"Ohio","Franklin County",5,7,17569,8898,8671
050,39,049,"Ohio","Franklin County",5,8,17499,8768,8731
050,39,049,"Ohio","Franklin County",5,9,17280,8778,8502
050,39,049,"Ohio","Franklin County",5,10,17233,8766,8467
050,39,049,"Ohio","Franklin County",5,11,16731,8669,8062
050,39,049,"Ohio","Franklin County",5,12,16452,8502,7950
050,39,049,"Ohio","Franklin County",5,13,16793,8534,8259
050,39,049,"Ohio","Franklin County",5,14,16875,8549,8326
050,39,049,"Ohio","Franklin County",5,15,17017,8623,8394
050,39,049,"Ohio","Franklin County",5,16,16807,8481,8326
050,39,049,"Ohio","Franklin County",5,17,16528,8372,8156
050,39,049,"Ohio","Franklin County",5,18,17430,8752,8678
050,39,049,"Ohio","Franklin County",5,19,19558,10019,9539
050,39,049,"Ohio","Franklin County",5,20,16626,8379,8247
050,39,049,"Ohio","Franklin County",5,21,15924,7966,7958
050,39,049,"Ohio","Franklin County",5,22,17055,8425,8630
050,39,049,"Ohio","Franklin County",5,23,19101,9361,9740
050,39,049,"Ohio","Franklin County",5,24,20372,9822,10550
050,39,049,"Ohio","Franklin County",5,25,21591,10374,11217
050,39,049,"Ohio","Franklin County",5,26,21876,10722,11154
050,39,049,"Ohio","Franklin County",5,27,22193,10918,11275
050,39,049,"Ohio","Franklin County",5,28,22408,11017,11391
050,39,049,"Ohio","Franklin County",5,29,22812,11331,11481
050,39,049,"Ohio","Franklin County",5,30,22977,11562,11415
050,39,049,"Ohio","Franklin County",5,31,23039,11547,11492
050,39,049,"Ohio","Franklin County",5,32,23568,11770,11798
050,39,049,"Ohio","Franklin County",5,33,23957,11967,11990
050,39,049,"Ohio","Franklin County",5,34,23130,11565,11565
050,39,049,"Ohio","Franklin County",5,35,22226,11149,11077
050,39,049,"Ohio","Franklin County",5,36,21279,10739,10540
050,39,049,"Ohio","Franklin County",5,37,20743,10587,10156
050,39,049,"Ohio","Franklin County",5,38,19905,10034,9871
050,39,049,"Ohio","Franklin County",5,39,18814,9420,9394
050,39,049,"Ohio","Franklin County",5,40,18637,9280,9357
050,39,049,"Ohio","Franklin County",5,41,18394,9116,9278
050,39,049,"Ohio","Franklin County",5,42,18045,9025,9020
050,39,049,"Ohio","Franklin County",5,43,17701,8858,8843
050,39,049,"Ohio","Franklin County",5,44,16804,8390,8414
050,39,049,"Ohio","Franklin County",5,45,16049,8048,8001
050,39,049,"Ohio","Franklin County",5,46,15643,7727,7916
050,39,049,"Ohio","Franklin County",5,47,15016,7344,7672
050,39,049,"Ohio","Franklin County",5,48,14831,7312,7519
050,39,049,"Ohio","Franklin County",5,49,14312,7109,7203
050,39,049,"Ohio","Franklin County",5,50,14383,7131,7252
050,39,049,"Ohio","Franklin County",5,51,15166,7588,7578
050,39,049,"Ohio","Franklin County",5,52,16124,7970,8154
050,39,049,"Ohio","Franklin County",5,53,15654,7785,7869
050,39,049,"Ohio","Franklin County",5,54,14957,7465,7492
050,39,049,"Ohio","Franklin County",5,55,14333,7114,7219
050,39,049,"Ohio","Franklin County",5,56,13896,6944,6952
050,39,049,"Ohio","Franklin County",5,57,13786,6858,6928
050,39,049,"Ohio","Franklin County",5,58,14156,6969,7187
050,39,049,"Ohio","Franklin County",5,59,14504,7058,7446
050,39,049,"Ohio","Franklin County",5,60,14565,7063,7502
050,39,049,"Ohio","Franklin County",5,61,14292,7008,7284
050,39,049,"Ohio","Franklin County",5,62,14322,6950,7372
050,39,049,"Ohio","Franklin County",5,63,14113,6754,7359
050,39,049,"Ohio","Franklin County",5,64,13884,6596,7288
050,39,049,"Ohio","Franklin County",5,65,13548,6255,7293
050,39,049,"Ohio","Franklin County",5,66,13204,6120,7084
050,39,049,"Ohio","Franklin County",5,67,12340,5795,6545
050,39,049,"Ohio","Franklin County",5,68,11861,5549,6312
050,39,049,"Ohio","Franklin County",5,69,11244,5136,6108
050,39,049,"Ohio","Franklin County",5,70,10646,4827,5819
050,39,049,"Ohio","Franklin County",5,71,10351,4695,5656
050,39,049,"Ohio","Franklin County",5,72,9669,4256,5413
050,39,049,"Ohio","Franklin County",5,73,9109,4030,5079
050,39,049,"Ohio","Franklin County",5,74,8751,3848,4903
050,39,049,"Ohio","Franklin County",5,75,8286,3600,4686
050,39,049,"Ohio","Franklin County",5,76,8532,3688,4844
050,39,049,"Ohio","Franklin County",5,77,5751,2469,3282
050,39,049,"Ohio","Franklin County",5,78,5169,2143,3026
050,39,049,"Ohio","Franklin County",5,79,4895,2050,2845
050,39,049,"Ohio","Franklin County",5,80,5025,2044,2981
050,39,049,"Ohio","Franklin County",5,81,4262,1713,2549
050,39,049,"Ohio","Franklin County",5,82,3717,1495,2222
050,39,049,"Ohio","Franklin County",5,83,3295,1294,2001
050,39,049,"Ohio","Franklin County",5,84,3000,1154,1846
050,39,049,"Ohio","Franklin County",5,85,16558,5717,10841
050,39,051,"Ohio","Fulton County",1,0,466,237,229
050,39,051,"Ohio","Fulton County",1,1,483,241,242
050,39,051,"Ohio","Fulton County",1,2,511,259,252
050,39,051,"Ohio","Fulton County",1,3,525,255,270
050,39,051,"Ohio","Fulton County",1,4,532,277,255
050,39,051,"Ohio","Fulton County",1,5,535,275,260
050,39,051,"Ohio","Fulton County",1,6,571,299,272
050,39,051,"Ohio","Fulton County",1,7,547,288,259
050,39,051,"Ohio","Fulton County",1,8,521,294,227
050,39,051,"Ohio","Fulton County",1,9,530,289,241
050,39,051,"Ohio","Fulton County",1,10,581,310,271
050,39,051,"Ohio","Fulton County",1,11,630,330,300
050,39,051,"Ohio","Fulton County",1,12,610,307,303
050,39,051,"Ohio","Fulton County",1,13,635,324,311
050,39,051,"Ohio","Fulton County",1,14,623,334,289
050,39,051,"Ohio","Fulton County",1,15,590,312,278
050,39,051,"Ohio","Fulton County",1,16,588,301,287
050,39,051,"Ohio","Fulton County",1,17,590,308,282
050,39,051,"Ohio","Fulton County",1,18,527,286,241
050,39,051,"Ohio","Fulton County",1,19,452,259,193
050,39,051,"Ohio","Fulton County",1,20,466,250,216
050,39,051,"Ohio","Fulton County",1,21,476,235,241
050,39,051,"Ohio","Fulton County",1,22,470,231,239
050,39,051,"Ohio","Fulton County",1,23,495,245,250
050,39,051,"Ohio","Fulton County",1,24,480,247,233
050,39,051,"Ohio","Fulton County",1,25,476,234,242
050,39,051,"Ohio","Fulton County",1,26,509,269,240
050,39,051,"Ohio","Fulton County",1,27,472,231,241
050,39,051,"Ohio","Fulton County",1,28,503,251,252
050,39,051,"Ohio","Fulton County",1,29,468,234,234
050,39,051,"Ohio","Fulton County",1,30,479,241,238
050,39,051,"Ohio","Fulton County",1,31,504,259,245
050,39,051,"Ohio","Fulton County",1,32,478,246,232
050,39,051,"Ohio","Fulton County",1,33,453,231,222
050,39,051,"Ohio","Fulton County",1,34,472,237,235
050,39,051,"Ohio","Fulton County",1,35,486,248,238
050,39,051,"Ohio","Fulton County",1,36,487,242,245
050,39,051,"Ohio","Fulton County",1,37,506,255,251
050,39,051,"Ohio","Fulton County",1,38,525,261,264
050,39,051,"Ohio","Fulton County",1,39,529,270,259
050,39,051,"Ohio","Fulton County",1,40,516,248,268
050,39,051,"Ohio","Fulton County",1,41,555,290,265
050,39,051,"Ohio","Fulton County",1,42,520,279,241
050,39,051,"Ohio","Fulton County",1,43,481,251,230
050,39,051,"Ohio","Fulton County",1,44,470,234,236
050,39,051,"Ohio","Fulton County",1,45,488,231,257
050,39,051,"Ohio","Fulton County",1,46,503,255,248
050,39,051,"Ohio","Fulton County",1,47,536,271,265
050,39,051,"Ohio","Fulton County",1,48,535,265,270
050,39,051,"Ohio","Fulton County",1,49,578,290,288
050,39,051,"Ohio","Fulton County",1,50,556,280,276
050,39,051,"Ohio","Fulton County",1,51,505,259,246
050,39,051,"Ohio","Fulton County",1,52,535,257,278
050,39,051,"Ohio","Fulton County",1,53,564,268,296
050,39,051,"Ohio","Fulton County",1,54,591,287,304
050,39,051,"Ohio","Fulton County",1,55,566,292,274
050,39,051,"Ohio","Fulton County",1,56,563,289,274
050,39,051,"Ohio","Fulton County",1,57,620,320,300
050,39,051,"Ohio","Fulton County",1,58,660,340,320
050,39,051,"Ohio","Fulton County",1,59,632,317,315
050,39,051,"Ohio","Fulton County",1,60,609,291,318
050,39,051,"Ohio","Fulton County",1,61,641,317,324
050,39,051,"Ohio","Fulton County",1,62,649,341,308
050,39,051,"Ohio","Fulton County",1,63,618,301,317
050,39,051,"Ohio","Fulton County",1,64,581,278,303
050,39,051,"Ohio","Fulton County",1,65,598,301,297
050,39,051,"Ohio","Fulton County",1,66,601,297,304
050,39,051,"Ohio","Fulton County",1,67,562,281,281
050,39,051,"Ohio","Fulton County",1,68,523,271,252
050,39,051,"Ohio","Fulton County",1,69,474,224,250
050,39,051,"Ohio","Fulton County",1,70,455,217,238
050,39,051,"Ohio","Fulton County",1,71,443,217,226
050,39,051,"Ohio","Fulton County",1,72,411,187,224
050,39,051,"Ohio","Fulton County",1,73,384,187,197
050,39,051,"Ohio","Fulton County",1,74,270,136,134
050,39,051,"Ohio","Fulton County",1,75,298,136,162
050,39,051,"Ohio","Fulton County",1,76,319,138,181
050,39,051,"Ohio","Fulton County",1,77,280,120,160
050,39,051,"Ohio","Fulton County",1,78,242,108,134
050,39,051,"Ohio","Fulton County",1,79,230,102,128
050,39,051,"Ohio","Fulton County",1,80,206,92,114
050,39,051,"Ohio","Fulton County",1,81,181,78,103
050,39,051,"Ohio","Fulton County",1,82,162,71,91
050,39,051,"Ohio","Fulton County",1,83,147,69,78
050,39,051,"Ohio","Fulton County",1,84,149,56,93
050,39,051,"Ohio","Fulton County",1,85,925,296,629
050,39,051,"Ohio","Fulton County",2,0,471,234,237
050,39,051,"Ohio","Fulton County",2,1,479,242,237
050,39,051,"Ohio","Fulton County",2,2,503,253,250
050,39,051,"Ohio","Fulton County",2,3,512,251,261
050,39,051,"Ohio","Fulton County",2,4,530,270,260
050,39,051,"Ohio","Fulton County",2,5,534,274,260
050,39,051,"Ohio","Fulton County",2,6,562,294,268
050,39,051,"Ohio","Fulton County",2,7,552,290,262
050,39,051,"Ohio","Fulton County",2,8,528,292,236
050,39,051,"Ohio","Fulton County",2,9,528,288,240
050,39,051,"Ohio","Fulton County",2,10,569,305,264
050,39,051,"Ohio","Fulton County",2,11,616,322,294
050,39,051,"Ohio","Fulton County",2,12,620,315,305
050,39,051,"Ohio","Fulton County",2,13,627,320,307
050,39,051,"Ohio","Fulton County",2,14,626,330,296
050,39,051,"Ohio","Fulton County",2,15,594,314,280
050,39,051,"Ohio","Fulton County",2,16,589,304,285
050,39,051,"Ohio","Fulton County",2,17,594,307,287
050,39,051,"Ohio","Fulton County",2,18,518,280,238
050,39,051,"Ohio","Fulton County",2,19,444,251,193
050,39,051,"Ohio","Fulton County",2,20,478,261,217
050,39,051,"Ohio","Fulton County",2,21,469,237,232
050,39,051,"Ohio","Fulton County",2,22,475,232,243
050,39,051,"Ohio","Fulton County",2,23,490,241,249
050,39,051,"Ohio","Fulton County",2,24,478,241,237
050,39,051,"Ohio","Fulton County",2,25,475,237,238
050,39,051,"Ohio","Fulton County",2,26,499,258,241
050,39,051,"Ohio","Fulton County",2,27,485,242,243
050,39,051,"Ohio","Fulton County",2,28,492,245,247
050,39,051,"Ohio","Fulton County",2,29,474,236,238
050,39,051,"Ohio","Fulton County",2,30,478,240,238
050,39,051,"Ohio","Fulton County",2,31,493,253,240
050,39,051,"Ohio","Fulton County",2,32,481,248,233
050,39,051,"Ohio","Fulton County",2,33,459,233,226
050,39,051,"Ohio","Fulton County",2,34,467,236,231
050,39,051,"Ohio","Fulton County",2,35,485,249,236
050,39,051,"Ohio","Fulton County",2,36,479,239,240
050,39,051,"Ohio","Fulton County",2,37,502,253,249
050,39,051,"Ohio","Fulton County",2,38,527,262,265
050,39,051,"Ohio","Fulton County",2,39,525,266,259
050,39,051,"Ohio","Fulton County",2,40,524,257,267
050,39,051,"Ohio","Fulton County",2,41,545,279,266
050,39,051,"Ohio","Fulton County",2,42,526,282,244
050,39,051,"Ohio","Fulton County",2,43,496,262,234
050,39,051,"Ohio","Fulton County",2,44,468,235,233
050,39,051,"Ohio","Fulton County",2,45,485,232,253
050,39,051,"Ohio","Fulton County",2,46,497,248,249
050,39,051,"Ohio","Fulton County",2,47,525,265,260
050,39,051,"Ohio","Fulton County",2,48,533,266,267
050,39,051,"Ohio","Fulton County",2,49,573,287,286
050,39,051,"Ohio","Fulton County",2,50,558,281,277
050,39,051,"Ohio","Fulton County",2,51,517,264,253
050,39,051,"Ohio","Fulton County",2,52,527,256,271
050,39,051,"Ohio","Fulton County",2,53,556,265,291
050,39,051,"Ohio","Fulton County",2,54,581,282,299
050,39,051,"Ohio","Fulton County",2,55,569,289,280
050,39,051,"Ohio","Fulton County",2,56,566,291,275
050,39,051,"Ohio","Fulton County",2,57,604,310,294
050,39,051,"Ohio","Fulton County",2,58,642,333,309
050,39,051,"Ohio","Fulton County",2,59,641,324,317
050,39,051,"Ohio","Fulton County",2,60,611,294,317
050,39,051,"Ohio","Fulton County",2,61,629,309,320
050,39,051,"Ohio","Fulton County",2,62,640,332,308
050,39,051,"Ohio","Fulton County",2,63,625,311,314
050,39,051,"Ohio","Fulton County",2,64,587,282,305
050,39,051,"Ohio","Fulton County",2,65,592,295,297
050,39,051,"Ohio","Fulton County",2,66,601,300,301
050,39,051,"Ohio","Fulton County",2,67,568,282,286
050,39,051,"Ohio","Fulton County",2,68,527,272,255
050,39,051,"Ohio","Fulton County",2,69,488,236,252
050,39,051,"Ohio","Fulton County",2,70,455,217,238
050,39,051,"Ohio","Fulton County",2,71,445,215,230
050,39,051,"Ohio","Fulton County",2,72,411,192,219
050,39,051,"Ohio","Fulton County",2,73,404,193,211
050,39,051,"Ohio","Fulton County",2,74,281,140,141
050,39,051,"Ohio","Fulton County",2,75,287,132,155
050,39,051,"Ohio","Fulton County",2,76,311,136,175
050,39,051,"Ohio","Fulton County",2,77,296,128,168
050,39,051,"Ohio","Fulton County",2,78,244,107,137
050,39,051,"Ohio","Fulton County",2,79,228,102,126
050,39,051,"Ohio","Fulton County",2,80,207,93,114
050,39,051,"Ohio","Fulton County",2,81,184,82,102
050,39,051,"Ohio","Fulton County",2,82,161,70,91
050,39,051,"Ohio","Fulton County",2,83,149,68,81
050,39,051,"Ohio","Fulton County",2,84,150,60,90
050,39,051,"Ohio","Fulton County",2,85,925,301,624
050,39,051,"Ohio","Fulton County",3,0,447,230,217
050,39,051,"Ohio","Fulton County",3,1,470,237,233
050,39,051,"Ohio","Fulton County",3,2,486,246,240
050,39,051,"Ohio","Fulton County",3,3,497,249,248
050,39,051,"Ohio","Fulton County",3,4,510,251,259
050,39,051,"Ohio","Fulton County",3,5,538,279,259
050,39,051,"Ohio","Fulton County",3,6,536,276,260
050,39,051,"Ohio","Fulton County",3,7,571,303,268
050,39,051,"Ohio","Fulton County",3,8,556,291,265
050,39,051,"Ohio","Fulton County",3,9,537,290,247
050,39,051,"Ohio","Fulton County",3,10,530,296,234
050,39,051,"Ohio","Fulton County",3,11,561,306,255
050,39,051,"Ohio","Fulton County",3,12,610,316,294
050,39,051,"Ohio","Fulton County",3,13,617,320,297
050,39,051,"Ohio","Fulton County",3,14,629,326,303
050,39,051,"Ohio","Fulton County",3,15,638,341,297
050,39,051,"Ohio","Fulton County",3,16,621,331,290
050,39,051,"Ohio","Fulton County",3,17,598,310,288
050,39,051,"Ohio","Fulton County",3,18,519,270,249
050,39,051,"Ohio","Fulton County",3,19,409,228,181
050,39,051,"Ohio","Fulton County",3,20,467,265,202
050,39,051,"Ohio","Fulton County",3,21,474,264,210
050,39,051,"Ohio","Fulton County",3,22,478,240,238
050,39,051,"Ohio","Fulton County",3,23,483,233,250
050,39,051,"Ohio","Fulton County",3,24,482,245,237
050,39,051,"Ohio","Fulton County",3,25,471,228,243
050,39,051,"Ohio","Fulton County",3,26,464,236,228
050,39,051,"Ohio","Fulton County",3,27,477,245,232
050,39,051,"Ohio","Fulton County",3,28,480,239,241
050,39,051,"Ohio","Fulton County",3,29,477,235,242
050,39,051,"Ohio","Fulton County",3,30,485,251,234
050,39,051,"Ohio","Fulton County",3,31,496,252,244
050,39,051,"Ohio","Fulton County",3,32,509,261,248
050,39,051,"Ohio","Fulton County",3,33,474,232,242
050,39,051,"Ohio","Fulton County",3,34,467,239,228
050,39,051,"Ohio","Fulton County",3,35,465,234,231
050,39,051,"Ohio","Fulton County",3,36,467,239,228
050,39,051,"Ohio","Fulton County",3,37,488,248,240
050,39,051,"Ohio","Fulton County",3,38,515,253,262
050,39,051,"Ohio","Fulton County",3,39,515,257,258
050,39,051,"Ohio","Fulton County",3,40,524,267,257
050,39,051,"Ohio","Fulton County",3,41,523,259,264
050,39,051,"Ohio","Fulton County",3,42,543,284,259
050,39,051,"Ohio","Fulton County",3,43,531,282,249
050,39,051,"Ohio","Fulton County",3,44,493,256,237
050,39,051,"Ohio","Fulton County",3,45,445,224,221
050,39,051,"Ohio","Fulton County",3,46,497,239,258
050,39,051,"Ohio","Fulton County",3,47,489,243,246
050,39,051,"Ohio","Fulton County",3,48,522,265,257
050,39,051,"Ohio","Fulton County",3,49,538,269,269
050,39,051,"Ohio","Fulton County",3,50,576,293,283
050,39,051,"Ohio","Fulton County",3,51,548,276,272
050,39,051,"Ohio","Fulton County",3,52,526,269,257
050,39,051,"Ohio","Fulton County",3,53,534,263,271
050,39,051,"Ohio","Fulton County",3,54,550,262,288
050,39,051,"Ohio","Fulton County",3,55,574,275,299
050,39,051,"Ohio","Fulton County",3,56,584,295,289
050,39,051,"Ohio","Fulton County",3,57,555,280,275
050,39,051,"Ohio","Fulton County",3,58,597,305,292
050,39,051,"Ohio","Fulton County",3,59,645,335,310
050,39,051,"Ohio","Fulton County",3,60,646,320,326
050,39,051,"Ohio","Fulton County",3,61,607,294,313
050,39,051,"Ohio","Fulton County",3,62,617,301,316
050,39,051,"Ohio","Fulton County",3,63,614,321,293
050,39,051,"Ohio","Fulton County",3,64,618,305,313
050,39,051,"Ohio","Fulton County",3,65,577,276,301
050,39,051,"Ohio","Fulton County",3,66,580,291,289
050,39,051,"Ohio","Fulton County",3,67,584,293,291
050,39,051,"Ohio","Fulton County",3,68,539,264,275
050,39,051,"Ohio","Fulton County",3,69,523,268,255
050,39,051,"Ohio","Fulton County",3,70,475,228,247
050,39,051,"Ohio","Fulton County",3,71,448,210,238
050,39,051,"Ohio","Fulton County",3,72,432,206,226
050,39,051,"Ohio","Fulton County",3,73,399,186,213
050,39,051,"Ohio","Fulton County",3,74,392,184,208
050,39,051,"Ohio","Fulton County",3,75,276,136,140
050,39,051,"Ohio","Fulton County",3,76,276,124,152
050,39,051,"Ohio","Fulton County",3,77,300,132,168
050,39,051,"Ohio","Fulton County",3,78,287,124,163
050,39,051,"Ohio","Fulton County",3,79,227,99,128
050,39,051,"Ohio","Fulton County",3,80,212,94,118
050,39,051,"Ohio","Fulton County",3,81,204,90,114
050,39,051,"Ohio","Fulton County",3,82,166,71,95
050,39,051,"Ohio","Fulton County",3,83,147,60,87
050,39,051,"Ohio","Fulton County",3,84,151,66,85
050,39,051,"Ohio","Fulton County",3,85,894,297,597
050,39,051,"Ohio","Fulton County",4,0,429,210,219
050,39,051,"Ohio","Fulton County",4,1,459,246,213
050,39,051,"Ohio","Fulton County",4,2,486,239,247
050,39,051,"Ohio","Fulton County",4,3,500,255,245
050,39,051,"Ohio","Fulton County",4,4,507,259,248
050,39,051,"Ohio","Fulton County",4,5,512,256,256
050,39,051,"Ohio","Fulton County",4,6,541,274,267
050,39,051,"Ohio","Fulton County",4,7,526,261,265
050,39,051,"Ohio","Fulton County",4,8,549,292,257
050,39,051,"Ohio","Fulton County",4,9,554,295,259
050,39,051,"Ohio","Fulton County",4,10,534,282,252
050,39,051,"Ohio","Fulton County",4,11,515,284,231
050,39,051,"Ohio","Fulton County",4,12,566,302,264
050,39,051,"Ohio","Fulton County",4,13,623,322,301
050,39,051,"Ohio","Fulton County",4,14,616,320,296
050,39,051,"Ohio","Fulton County",4,15,628,321,307
050,39,051,"Ohio","Fulton County",4,16,625,327,298
050,39,051,"Ohio","Fulton County",4,17,605,324,281
050,39,051,"Ohio","Fulton County",4,18,494,264,230
050,39,051,"Ohio","Fulton County",4,19,404,209,195
050,39,051,"Ohio","Fulton County",4,20,423,238,185
050,39,051,"Ohio","Fulton County",4,21,487,276,211
050,39,051,"Ohio","Fulton County",4,22,490,279,211
050,39,051,"Ohio","Fulton County",4,23,462,251,211
050,39,051,"Ohio","Fulton County",4,24,458,235,223
050,39,051,"Ohio","Fulton County",4,25,458,235,223
050,39,051,"Ohio","Fulton County",4,26,463,219,244
050,39,051,"Ohio","Fulton County",4,27,469,241,228
050,39,051,"Ohio","Fulton County",4,28,475,241,234
050,39,051,"Ohio","Fulton County",4,29,477,233,244
050,39,051,"Ohio","Fulton County",4,30,479,236,243
050,39,051,"Ohio","Fulton County",4,31,503,257,246
050,39,051,"Ohio","Fulton County",4,32,501,262,239
050,39,051,"Ohio","Fulton County",4,33,512,259,253
050,39,051,"Ohio","Fulton County",4,34,473,224,249
050,39,051,"Ohio","Fulton County",4,35,461,233,228
050,39,051,"Ohio","Fulton County",4,36,474,238,236
050,39,051,"Ohio","Fulton County",4,37,458,239,219
050,39,051,"Ohio","Fulton County",4,38,489,247,242
050,39,051,"Ohio","Fulton County",4,39,515,260,255
050,39,051,"Ohio","Fulton County",4,40,505,250,255
050,39,051,"Ohio","Fulton County",4,41,522,262,260
050,39,051,"Ohio","Fulton County",4,42,526,262,264
050,39,051,"Ohio","Fulton County",4,43,541,287,254
050,39,051,"Ohio","Fulton County",4,44,531,280,251
050,39,051,"Ohio","Fulton County",4,45,498,258,240
050,39,051,"Ohio","Fulton County",4,46,447,230,217
050,39,051,"Ohio","Fulton County",4,47,483,239,244
050,39,051,"Ohio","Fulton County",4,48,488,238,250
050,39,051,"Ohio","Fulton County",4,49,521,265,256
050,39,051,"Ohio","Fulton County",4,50,544,269,275
050,39,051,"Ohio","Fulton County",4,51,578,289,289
050,39,051,"Ohio","Fulton County",4,52,550,273,277
050,39,051,"Ohio","Fulton County",4,53,530,270,260
050,39,051,"Ohio","Fulton County",4,54,519,258,261
050,39,051,"Ohio","Fulton County",4,55,547,261,286
050,39,051,"Ohio","Fulton County",4,56,570,276,294
050,39,051,"Ohio","Fulton County",4,57,574,287,287
050,39,051,"Ohio","Fulton County",4,58,551,275,276
050,39,051,"Ohio","Fulton County",4,59,589,300,289
050,39,051,"Ohio","Fulton County",4,60,629,323,306
050,39,051,"Ohio","Fulton County",4,61,645,318,327
050,39,051,"Ohio","Fulton County",4,62,596,293,303
050,39,051,"Ohio","Fulton County",4,63,596,287,309
050,39,051,"Ohio","Fulton County",4,64,600,312,288
050,39,051,"Ohio","Fulton County",4,65,608,300,308
050,39,051,"Ohio","Fulton County",4,66,568,273,295
050,39,051,"Ohio","Fulton County",4,67,557,280,277
050,39,051,"Ohio","Fulton County",4,68,568,286,282
050,39,051,"Ohio","Fulton County",4,69,535,253,282
050,39,051,"Ohio","Fulton County",4,70,509,262,247
050,39,051,"Ohio","Fulton County",4,71,466,226,240
050,39,051,"Ohio","Fulton County",4,72,434,201,233
050,39,051,"Ohio","Fulton County",4,73,416,199,217
050,39,051,"Ohio","Fulton County",4,74,389,180,209
050,39,051,"Ohio","Fulton County",4,75,382,176,206
050,39,051,"Ohio","Fulton County",4,76,263,131,132
050,39,051,"Ohio","Fulton County",4,77,254,112,142
050,39,051,"Ohio","Fulton County",4,78,288,121,167
050,39,051,"Ohio","Fulton County",4,79,263,110,153
050,39,051,"Ohio","Fulton County",4,80,210,94,116
050,39,051,"Ohio","Fulton County",4,81,208,94,114
050,39,051,"Ohio","Fulton County",4,82,183,79,104
050,39,051,"Ohio","Fulton County",4,83,155,66,89
050,39,051,"Ohio","Fulton County",4,84,149,61,88
050,39,051,"Ohio","Fulton County",4,85,873,298,575
050,39,051,"Ohio","Fulton County",5,0,436,216,220
050,39,051,"Ohio","Fulton County",5,1,446,218,228
050,39,051,"Ohio","Fulton County",5,2,476,243,233
050,39,051,"Ohio","Fulton County",5,3,492,238,254
050,39,051,"Ohio","Fulton County",5,4,521,270,251
050,39,051,"Ohio","Fulton County",5,5,503,259,244
050,39,051,"Ohio","Fulton County",5,6,514,252,262
050,39,051,"Ohio","Fulton County",5,7,548,278,270
050,39,051,"Ohio","Fulton County",5,8,511,243,268
050,39,051,"Ohio","Fulton County",5,9,567,304,263
050,39,051,"Ohio","Fulton County",5,10,555,287,268
050,39,051,"Ohio","Fulton County",5,11,529,280,249
050,39,051,"Ohio","Fulton County",5,12,528,299,229
050,39,051,"Ohio","Fulton County",5,13,553,297,256
050,39,051,"Ohio","Fulton County",5,14,626,325,301
050,39,051,"Ohio","Fulton County",5,15,614,320,294
050,39,051,"Ohio","Fulton County",5,16,620,323,297
050,39,051,"Ohio","Fulton County",5,17,629,335,294
050,39,051,"Ohio","Fulton County",5,18,510,278,232
050,39,051,"Ohio","Fulton County",5,19,391,214,177
050,39,051,"Ohio","Fulton County",5,20,420,213,207
050,39,051,"Ohio","Fulton County",5,21,440,246,194
050,39,051,"Ohio","Fulton County",5,22,511,285,226
050,39,051,"Ohio","Fulton County",5,23,507,283,224
050,39,051,"Ohio","Fulton County",5,24,454,252,202
050,39,051,"Ohio","Fulton County",5,25,441,228,213
050,39,051,"Ohio","Fulton County",5,26,450,226,224
050,39,051,"Ohio","Fulton County",5,27,478,232,246
050,39,051,"Ohio","Fulton County",5,28,460,241,219
050,39,051,"Ohio","Fulton County",5,29,479,235,244
050,39,051,"Ohio","Fulton County",5,30,479,235,244
050,39,051,"Ohio","Fulton County",5,31,476,238,238
050,39,051,"Ohio","Fulton County",5,32,501,257,244
050,39,051,"Ohio","Fulton County",5,33,491,257,234
050,39,051,"Ohio","Fulton County",5,34,523,258,265
050,39,051,"Ohio","Fulton County",5,35,462,221,241
050,39,051,"Ohio","Fulton County",5,36,458,228,230
050,39,051,"Ohio","Fulton County",5,37,474,239,235
050,39,051,"Ohio","Fulton County",5,38,462,236,226
050,39,051,"Ohio","Fulton County",5,39,488,242,246
050,39,051,"Ohio","Fulton County",5,40,519,267,252
050,39,051,"Ohio","Fulton County",5,41,507,247,260
050,39,051,"Ohio","Fulton County",5,42,532,274,258
050,39,051,"Ohio","Fulton County",5,43,530,267,263
050,39,051,"Ohio","Fulton County",5,44,550,292,258
050,39,051,"Ohio","Fulton County",5,45,536,283,253
050,39,051,"Ohio","Fulton County",5,46,502,262,240
050,39,051,"Ohio","Fulton County",5,47,442,226,216
050,39,051,"Ohio","Fulton County",5,48,488,244,244
050,39,051,"Ohio","Fulton County",5,49,492,244,248
050,39,051,"Ohio","Fulton County",5,50,525,271,254
050,39,051,"Ohio","Fulton County",5,51,548,269,279
050,39,051,"Ohio","Fulton County",5,52,575,286,289
050,39,051,"Ohio","Fulton County",5,53,554,274,280
050,39,051,"Ohio","Fulton County",5,54,524,270,254
050,39,051,"Ohio","Fulton County",5,55,505,252,253
050,39,051,"Ohio","Fulton County",5,56,543,262,281
050,39,051,"Ohio","Fulton County",5,57,574,271,303
050,39,051,"Ohio","Fulton County",5,58,569,289,280
050,39,051,"Ohio","Fulton County",5,59,550,276,274
050,39,051,"Ohio","Fulton County",5,60,584,288,296
050,39,051,"Ohio","Fulton County",5,61,613,322,291
050,39,051,"Ohio","Fulton County",5,62,632,309,323
050,39,051,"Ohio","Fulton County",5,63,579,286,293
050,39,051,"Ohio","Fulton County",5,64,580,277,303
050,39,051,"Ohio","Fulton County",5,65,600,307,293
050,39,051,"Ohio","Fulton County",5,66,594,293,301
050,39,051,"Ohio","Fulton County",5,67,551,267,284
050,39,051,"Ohio","Fulton County",5,68,531,267,264
050,39,051,"Ohio","Fulton County",5,69,557,271,286
050,39,051,"Ohio","Fulton County",5,70,511,247,264
050,39,051,"Ohio","Fulton County",5,71,497,255,242
050,39,051,"Ohio","Fulton County",5,72,461,220,241
050,39,051,"Ohio","Fulton County",5,73,408,190,218
050,39,051,"Ohio","Fulton County",5,74,396,187,209
050,39,051,"Ohio","Fulton County",5,75,374,172,202
050,39,051,"Ohio","Fulton County",5,76,369,173,196
050,39,051,"Ohio","Fulton County",5,77,248,126,122
050,39,051,"Ohio","Fulton County",5,78,244,104,140
050,39,051,"Ohio","Fulton County",5,79,262,108,154
050,39,051,"Ohio","Fulton County",5,80,244,99,145
050,39,051,"Ohio","Fulton County",5,81,202,90,112
050,39,051,"Ohio","Fulton County",5,82,179,79,100
050,39,051,"Ohio","Fulton County",5,83,171,73,98
050,39,051,"Ohio","Fulton County",5,84,153,64,89
050,39,051,"Ohio","Fulton County",5,85,879,307,572
050,39,053,"Ohio","Gallia County",1,0,347,180,167
050,39,053,"Ohio","Gallia County",1,1,352,180,172
050,39,053,"Ohio","Gallia County",1,2,357,175,182
050,39,053,"Ohio","Gallia County",1,3,346,181,165
050,39,053,"Ohio","Gallia County",1,4,380,194,186
050,39,053,"Ohio","Gallia County",1,5,375,194,181
050,39,053,"Ohio","Gallia County",1,6,402,204,198
050,39,053,"Ohio","Gallia County",1,7,372,190,182
050,39,053,"Ohio","Gallia County",1,8,387,199,188
050,39,053,"Ohio","Gallia County",1,9,359,188,171
050,39,053,"Ohio","Gallia County",1,10,391,209,182
050,39,053,"Ohio","Gallia County",1,11,399,217,182
050,39,053,"Ohio","Gallia County",1,12,400,216,184
050,39,053,"Ohio","Gallia County",1,13,394,205,189
050,39,053,"Ohio","Gallia County",1,14,400,205,195
050,39,053,"Ohio","Gallia County",1,15,392,215,177
050,39,053,"Ohio","Gallia County",1,16,412,201,211
050,39,053,"Ohio","Gallia County",1,17,387,192,195
050,39,053,"Ohio","Gallia County",1,18,341,182,159
050,39,053,"Ohio","Gallia County",1,19,330,178,152
050,39,053,"Ohio","Gallia County",1,20,317,172,145
050,39,053,"Ohio","Gallia County",1,21,336,188,148
050,39,053,"Ohio","Gallia County",1,22,331,172,159
050,39,053,"Ohio","Gallia County",1,23,343,179,164
050,39,053,"Ohio","Gallia County",1,24,327,180,147
050,39,053,"Ohio","Gallia County",1,25,341,191,150
050,39,053,"Ohio","Gallia County",1,26,350,173,177
050,39,053,"Ohio","Gallia County",1,27,337,159,178
050,39,053,"Ohio","Gallia County",1,28,321,158,163
050,39,053,"Ohio","Gallia County",1,29,339,163,176
050,39,053,"Ohio","Gallia County",1,30,355,179,176
050,39,053,"Ohio","Gallia County",1,31,316,152,164
050,39,053,"Ohio","Gallia County",1,32,324,162,162
050,39,053,"Ohio","Gallia County",1,33,334,180,154
050,39,053,"Ohio","Gallia County",1,34,347,179,168
050,39,053,"Ohio","Gallia County",1,35,338,166,172
050,39,053,"Ohio","Gallia County",1,36,353,179,174
050,39,053,"Ohio","Gallia County",1,37,339,164,175
050,39,053,"Ohio","Gallia County",1,38,352,182,170
050,39,053,"Ohio","Gallia County",1,39,336,166,170
050,39,053,"Ohio","Gallia County",1,40,333,172,161
050,39,053,"Ohio","Gallia County",1,41,331,172,159
050,39,053,"Ohio","Gallia County",1,42,344,166,178
050,39,053,"Ohio","Gallia County",1,43,331,169,162
050,39,053,"Ohio","Gallia County",1,44,325,154,171
050,39,053,"Ohio","Gallia County",1,45,332,164,168
050,39,053,"Ohio","Gallia County",1,46,326,154,172
050,39,053,"Ohio","Gallia County",1,47,355,172,183
050,39,053,"Ohio","Gallia County",1,48,395,213,182
050,39,053,"Ohio","Gallia County",1,49,397,206,191
050,39,053,"Ohio","Gallia County",1,50,371,186,185
050,39,053,"Ohio","Gallia County",1,51,351,178,173
050,39,053,"Ohio","Gallia County",1,52,310,160,150
050,39,053,"Ohio","Gallia County",1,53,336,165,171
050,39,053,"Ohio","Gallia County",1,54,377,185,192
050,39,053,"Ohio","Gallia County",1,55,395,189,206
050,39,053,"Ohio","Gallia County",1,56,386,198,188
050,39,053,"Ohio","Gallia County",1,57,417,211,206
050,39,053,"Ohio","Gallia County",1,58,422,202,220
050,39,053,"Ohio","Gallia County",1,59,444,207,237
050,39,053,"Ohio","Gallia County",1,60,427,208,219
050,39,053,"Ohio","Gallia County",1,61,434,205,229
050,39,053,"Ohio","Gallia County",1,62,449,218,231
050,39,053,"Ohio","Gallia County",1,63,447,217,230
050,39,053,"Ohio","Gallia County",1,64,438,205,233
050,39,053,"Ohio","Gallia County",1,65,375,183,192
050,39,053,"Ohio","Gallia County",1,66,354,185,169
050,39,053,"Ohio","Gallia County",1,67,371,193,178
050,39,053,"Ohio","Gallia County",1,68,365,171,194
050,39,053,"Ohio","Gallia County",1,69,330,159,171
050,39,053,"Ohio","Gallia County",1,70,314,163,151
050,39,053,"Ohio","Gallia County",1,71,317,150,167
050,39,053,"Ohio","Gallia County",1,72,297,128,169
050,39,053,"Ohio","Gallia County",1,73,285,135,150
050,39,053,"Ohio","Gallia County",1,74,206,99,107
050,39,053,"Ohio","Gallia County",1,75,209,94,115
050,39,053,"Ohio","Gallia County",1,76,220,91,129
050,39,053,"Ohio","Gallia County",1,77,232,96,136
050,39,053,"Ohio","Gallia County",1,78,198,93,105
050,39,053,"Ohio","Gallia County",1,79,170,79,91
050,39,053,"Ohio","Gallia County",1,80,170,85,85
050,39,053,"Ohio","Gallia County",1,81,152,78,74
050,39,053,"Ohio","Gallia County",1,82,128,57,71
050,39,053,"Ohio","Gallia County",1,83,134,59,75
050,39,053,"Ohio","Gallia County",1,84,115,46,69
050,39,053,"Ohio","Gallia County",1,85,542,188,354
050,39,053,"Ohio","Gallia County",2,0,369,194,175
050,39,053,"Ohio","Gallia County",2,1,351,181,170
050,39,053,"Ohio","Gallia County",2,2,359,178,181
050,39,053,"Ohio","Gallia County",2,3,348,180,168
050,39,053,"Ohio","Gallia County",2,4,374,191,183
050,39,053,"Ohio","Gallia County",2,5,377,195,182
050,39,053,"Ohio","Gallia County",2,6,397,202,195
050,39,053,"Ohio","Gallia County",2,7,380,194,186
050,39,053,"Ohio","Gallia County",2,8,384,197,187
050,39,053,"Ohio","Gallia County",2,9,365,192,173
050,39,053,"Ohio","Gallia County",2,10,380,203,177
050,39,053,"Ohio","Gallia County",2,11,394,214,180
050,39,053,"Ohio","Gallia County",2,12,403,218,185
050,39,053,"Ohio","Gallia County",2,13,396,207,189
050,39,053,"Ohio","Gallia County",2,14,399,206,193
050,39,053,"Ohio","Gallia County",2,15,393,212,181
050,39,053,"Ohio","Gallia County",2,16,407,203,204
050,39,053,"Ohio","Gallia County",2,17,392,193,199
050,39,053,"Ohio","Gallia County",2,18,340,179,161
050,39,053,"Ohio","Gallia County",2,19,327,175,152
050,39,053,"Ohio","Gallia County",2,20,322,172,150
050,39,053,"Ohio","Gallia County",2,21,334,186,148
050,39,053,"Ohio","Gallia County",2,22,333,177,156
050,39,053,"Ohio","Gallia County",2,23,338,175,163
050,39,053,"Ohio","Gallia County",2,24,332,180,152
050,39,053,"Ohio","Gallia County",2,25,339,187,152
050,39,053,"Ohio","Gallia County",2,26,349,178,171
050,39,053,"Ohio","Gallia County",2,27,341,163,178
050,39,053,"Ohio","Gallia County",2,28,327,159,168
050,39,053,"Ohio","Gallia County",2,29,337,162,175
050,39,053,"Ohio","Gallia County",2,30,356,179,177
050,39,053,"Ohio","Gallia County",2,31,327,160,167
050,39,053,"Ohio","Gallia County",2,32,319,158,161
050,39,053,"Ohio","Gallia County",2,33,332,175,157
050,39,053,"Ohio","Gallia County",2,34,344,180,164
050,39,053,"Ohio","Gallia County",2,35,343,170,173
050,39,053,"Ohio","Gallia County",2,36,347,174,173
050,39,053,"Ohio","Gallia County",2,37,345,170,175
050,39,053,"Ohio","Gallia County",2,38,352,181,171
050,39,053,"Ohio","Gallia County",2,39,336,168,168
050,39,053,"Ohio","Gallia County",2,40,336,171,165
050,39,053,"Ohio","Gallia County",2,41,330,171,159
050,39,053,"Ohio","Gallia County",2,42,338,166,172
050,39,053,"Ohio","Gallia County",2,43,338,171,167
050,39,053,"Ohio","Gallia County",2,44,321,155,166
050,39,053,"Ohio","Gallia County",2,45,331,162,169
050,39,053,"Ohio","Gallia County",2,46,325,155,170
050,39,053,"Ohio","Gallia County",2,47,343,166,177
050,39,053,"Ohio","Gallia County",2,48,383,204,179
050,39,053,"Ohio","Gallia County",2,49,398,209,189
050,39,053,"Ohio","Gallia County",2,50,375,188,187
050,39,053,"Ohio","Gallia County",2,51,351,178,173
050,39,053,"Ohio","Gallia County",2,52,316,163,153
050,39,053,"Ohio","Gallia County",2,53,332,165,167
050,39,053,"Ohio","Gallia County",2,54,366,180,186
050,39,053,"Ohio","Gallia County",2,55,389,187,202
050,39,053,"Ohio","Gallia County",2,56,392,198,194
050,39,053,"Ohio","Gallia County",2,57,409,207,202
050,39,053,"Ohio","Gallia County",2,58,419,203,216
050,39,053,"Ohio","Gallia County",2,59,441,207,234
050,39,053,"Ohio","Gallia County",2,60,431,207,224
050,39,053,"Ohio","Gallia County",2,61,431,206,225
050,39,053,"Ohio","Gallia County",2,62,440,211,229
050,39,053,"Ohio","Gallia County",2,63,448,218,230
050,39,053,"Ohio","Gallia County",2,64,436,205,231
050,39,053,"Ohio","Gallia County",2,65,391,188,203
050,39,053,"Ohio","Gallia County",2,66,357,183,174
050,39,053,"Ohio","Gallia County",2,67,365,192,173
050,39,053,"Ohio","Gallia County",2,68,360,173,187
050,39,053,"Ohio","Gallia County",2,69,339,164,175
050,39,053,"Ohio","Gallia County",2,70,315,161,154
050,39,053,"Ohio","Gallia County",2,71,318,154,164
050,39,053,"Ohio","Gallia County",2,72,296,133,163
050,39,053,"Ohio","Gallia County",2,73,303,140,163
050,39,053,"Ohio","Gallia County",2,74,207,98,109
050,39,053,"Ohio","Gallia County",2,75,208,95,113
050,39,053,"Ohio","Gallia County",2,76,212,91,121
050,39,053,"Ohio","Gallia County",2,77,232,96,136
050,39,053,"Ohio","Gallia County",2,78,201,91,110
050,39,053,"Ohio","Gallia County",2,79,173,79,94
050,39,053,"Ohio","Gallia County",2,80,168,83,85
050,39,053,"Ohio","Gallia County",2,81,155,80,75
050,39,053,"Ohio","Gallia County",2,82,135,63,72
050,39,053,"Ohio","Gallia County",2,83,127,54,73
050,39,053,"Ohio","Gallia County",2,84,118,48,70
050,39,053,"Ohio","Gallia County",2,85,546,192,354
050,39,053,"Ohio","Gallia County",3,0,370,202,168
050,39,053,"Ohio","Gallia County",3,1,373,189,184
050,39,053,"Ohio","Gallia County",3,2,346,177,169
050,39,053,"Ohio","Gallia County",3,3,355,173,182
050,39,053,"Ohio","Gallia County",3,4,347,181,166
050,39,053,"Ohio","Gallia County",3,5,367,183,184
050,39,053,"Ohio","Gallia County",3,6,374,193,181
050,39,053,"Ohio","Gallia County",3,7,402,206,196
050,39,053,"Ohio","Gallia County",3,8,378,198,180
050,39,053,"Ohio","Gallia County",3,9,391,200,191
050,39,053,"Ohio","Gallia County",3,10,377,197,180
050,39,053,"Ohio","Gallia County",3,11,379,203,176
050,39,053,"Ohio","Gallia County",3,12,399,217,182
050,39,053,"Ohio","Gallia County",3,13,404,217,187
050,39,053,"Ohio","Gallia County",3,14,388,200,188
050,39,053,"Ohio","Gallia County",3,15,397,203,194
050,39,053,"Ohio","Gallia County",3,16,399,217,182
050,39,053,"Ohio","Gallia County",3,17,417,208,209
050,39,053,"Ohio","Gallia County",3,18,359,187,172
050,39,053,"Ohio","Gallia County",3,19,307,160,147
050,39,053,"Ohio","Gallia County",3,20,328,170,158
050,39,053,"Ohio","Gallia County",3,21,345,181,164
050,39,053,"Ohio","Gallia County",3,22,339,186,153
050,39,053,"Ohio","Gallia County",3,23,329,178,151
050,39,053,"Ohio","Gallia County",3,24,343,185,158
050,39,053,"Ohio","Gallia County",3,25,311,165,146
050,39,053,"Ohio","Gallia County",3,26,335,189,146
050,39,053,"Ohio","Gallia County",3,27,339,167,172
050,39,053,"Ohio","Gallia County",3,28,340,156,184
050,39,053,"Ohio","Gallia County",3,29,320,156,164
050,39,053,"Ohio","Gallia County",3,30,359,183,176
050,39,053,"Ohio","Gallia County",3,31,354,177,177
050,39,053,"Ohio","Gallia County",3,32,326,162,164
050,39,053,"Ohio","Gallia County",3,33,327,165,162
050,39,053,"Ohio","Gallia County",3,34,331,180,151
050,39,053,"Ohio","Gallia County",3,35,337,173,164
050,39,053,"Ohio","Gallia County",3,36,337,169,168
050,39,053,"Ohio","Gallia County",3,37,355,178,177
050,39,053,"Ohio","Gallia County",3,38,348,173,175
050,39,053,"Ohio","Gallia County",3,39,337,165,172
050,39,053,"Ohio","Gallia County",3,40,334,169,165
050,39,053,"Ohio","Gallia County",3,41,350,177,173
050,39,053,"Ohio","Gallia County",3,42,331,168,163
050,39,053,"Ohio","Gallia County",3,43,331,166,165
050,39,053,"Ohio","Gallia County",3,44,345,169,176
050,39,053,"Ohio","Gallia County",3,45,320,158,162
050,39,053,"Ohio","Gallia County",3,46,330,165,165
050,39,053,"Ohio","Gallia County",3,47,328,153,175
050,39,053,"Ohio","Gallia County",3,48,341,165,176
050,39,053,"Ohio","Gallia County",3,49,391,204,187
050,39,053,"Ohio","Gallia County",3,50,395,207,188
050,39,053,"Ohio","Gallia County",3,51,382,197,185
050,39,053,"Ohio","Gallia County",3,52,340,174,166
050,39,053,"Ohio","Gallia County",3,53,315,163,152
050,39,053,"Ohio","Gallia County",3,54,329,164,165
050,39,053,"Ohio","Gallia County",3,55,365,179,186
050,39,053,"Ohio","Gallia County",3,56,383,186,197
050,39,053,"Ohio","Gallia County",3,57,388,192,196
050,39,053,"Ohio","Gallia County",3,58,406,206,200
050,39,053,"Ohio","Gallia County",3,59,421,203,218
050,39,053,"Ohio","Gallia County",3,60,431,201,230
050,39,053,"Ohio","Gallia County",3,61,427,205,222
050,39,053,"Ohio","Gallia County",3,62,424,203,221
050,39,053,"Ohio","Gallia County",3,63,429,204,225
050,39,053,"Ohio","Gallia County",3,64,447,218,229
050,39,053,"Ohio","Gallia County",3,65,430,203,227
050,39,053,"Ohio","Gallia County",3,66,379,181,198
050,39,053,"Ohio","Gallia County",3,67,361,185,176
050,39,053,"Ohio","Gallia County",3,68,362,188,174
050,39,053,"Ohio","Gallia County",3,69,358,170,188
050,39,053,"Ohio","Gallia County",3,70,329,156,173
050,39,053,"Ohio","Gallia County",3,71,298,150,148
050,39,053,"Ohio","Gallia County",3,72,315,152,163
050,39,053,"Ohio","Gallia County",3,73,274,123,151
050,39,053,"Ohio","Gallia County",3,74,290,131,159
050,39,053,"Ohio","Gallia County",3,75,198,90,108
050,39,053,"Ohio","Gallia County",3,76,197,87,110
050,39,053,"Ohio","Gallia County",3,77,192,80,112
050,39,053,"Ohio","Gallia County",3,78,222,88,134
050,39,053,"Ohio","Gallia County",3,79,188,85,103
050,39,053,"Ohio","Gallia County",3,80,164,75,89
050,39,053,"Ohio","Gallia County",3,81,162,80,82
050,39,053,"Ohio","Gallia County",3,82,143,77,66
050,39,053,"Ohio","Gallia County",3,83,129,58,71
050,39,053,"Ohio","Gallia County",3,84,120,45,75
050,39,053,"Ohio","Gallia County",3,85,561,195,366
050,39,053,"Ohio","Gallia County",4,0,329,169,160
050,39,053,"Ohio","Gallia County",4,1,351,190,161
050,39,053,"Ohio","Gallia County",4,2,377,196,181
050,39,053,"Ohio","Gallia County",4,3,351,179,172
050,39,053,"Ohio","Gallia County",4,4,360,183,177
050,39,053,"Ohio","Gallia County",4,5,352,177,175
050,39,053,"Ohio","Gallia County",4,6,367,186,181
050,39,053,"Ohio","Gallia County",4,7,376,195,181
050,39,053,"Ohio","Gallia County",4,8,399,204,195
050,39,053,"Ohio","Gallia County",4,9,380,195,185
050,39,053,"Ohio","Gallia County",4,10,382,195,187
050,39,053,"Ohio","Gallia County",4,11,381,195,186
050,39,053,"Ohio","Gallia County",4,12,379,197,182
050,39,053,"Ohio","Gallia County",4,13,399,219,180
050,39,053,"Ohio","Gallia County",4,14,413,223,190
050,39,053,"Ohio","Gallia County",4,15,390,205,185
050,39,053,"Ohio","Gallia County",4,16,398,208,190
050,39,053,"Ohio","Gallia County",4,17,402,223,179
050,39,053,"Ohio","Gallia County",4,18,356,184,172
050,39,053,"Ohio","Gallia County",4,19,307,166,141
050,39,053,"Ohio","Gallia County",4,20,299,146,153
050,39,053,"Ohio","Gallia County",4,21,329,177,152
050,39,053,"Ohio","Gallia County",4,22,347,183,164
050,39,053,"Ohio","Gallia County",4,23,343,195,148
050,39,053,"Ohio","Gallia County",4,24,326,180,146
050,39,053,"Ohio","Gallia County",4,25,316,165,151
050,39,053,"Ohio","Gallia County",4,26,327,172,155
050,39,053,"Ohio","Gallia County",4,27,328,185,143
050,39,053,"Ohio","Gallia County",4,28,334,166,168
050,39,053,"Ohio","Gallia County",4,29,332,152,180
050,39,053,"Ohio","Gallia County",4,30,323,160,163
050,39,053,"Ohio","Gallia County",4,31,353,179,174
050,39,053,"Ohio","Gallia County",4,32,348,165,183
050,39,053,"Ohio","Gallia County",4,33,321,165,156
050,39,053,"Ohio","Gallia County",4,34,330,169,161
050,39,053,"Ohio","Gallia County",4,35,332,176,156
050,39,053,"Ohio","Gallia County",4,36,320,160,160
050,39,053,"Ohio","Gallia County",4,37,336,174,162
050,39,053,"Ohio","Gallia County",4,38,362,185,177
050,39,053,"Ohio","Gallia County",4,39,337,164,173
050,39,053,"Ohio","Gallia County",4,40,329,164,165
050,39,053,"Ohio","Gallia County",4,41,332,174,158
050,39,053,"Ohio","Gallia County",4,42,340,169,171
050,39,053,"Ohio","Gallia County",4,43,335,170,165
050,39,053,"Ohio","Gallia County",4,44,327,164,163
050,39,053,"Ohio","Gallia County",4,45,350,174,176
050,39,053,"Ohio","Gallia County",4,46,321,159,162
050,39,053,"Ohio","Gallia County",4,47,323,157,166
050,39,053,"Ohio","Gallia County",4,48,332,159,173
050,39,053,"Ohio","Gallia County",4,49,345,168,177
050,39,053,"Ohio","Gallia County",4,50,393,200,193
050,39,053,"Ohio","Gallia County",4,51,387,206,181
050,39,053,"Ohio","Gallia County",4,52,372,184,188
050,39,053,"Ohio","Gallia County",4,53,345,174,171
050,39,053,"Ohio","Gallia County",4,54,331,169,162
050,39,053,"Ohio","Gallia County",4,55,317,154,163
050,39,053,"Ohio","Gallia County",4,56,357,176,181
050,39,053,"Ohio","Gallia County",4,57,371,179,192
050,39,053,"Ohio","Gallia County",4,58,392,196,196
050,39,053,"Ohio","Gallia County",4,59,405,205,200
050,39,053,"Ohio","Gallia County",4,60,409,196,213
050,39,053,"Ohio","Gallia County",4,61,437,210,227
050,39,053,"Ohio","Gallia County",4,62,420,201,219
050,39,053,"Ohio","Gallia County",4,63,418,201,217
050,39,053,"Ohio","Gallia County",4,64,432,200,232
050,39,053,"Ohio","Gallia County",4,65,440,216,224
050,39,053,"Ohio","Gallia County",4,66,423,194,229
050,39,053,"Ohio","Gallia County",4,67,382,185,197
050,39,053,"Ohio","Gallia County",4,68,352,181,171
050,39,053,"Ohio","Gallia County",4,69,356,186,170
050,39,053,"Ohio","Gallia County",4,70,344,159,185
050,39,053,"Ohio","Gallia County",4,71,321,150,171
050,39,053,"Ohio","Gallia County",4,72,292,150,142
050,39,053,"Ohio","Gallia County",4,73,299,147,152
050,39,053,"Ohio","Gallia County",4,74,265,118,147
050,39,053,"Ohio","Gallia County",4,75,282,127,155
050,39,053,"Ohio","Gallia County",4,76,185,83,102
050,39,053,"Ohio","Gallia County",4,77,194,85,109
050,39,053,"Ohio","Gallia County",4,78,180,73,107
050,39,053,"Ohio","Gallia County",4,79,208,82,126
050,39,053,"Ohio","Gallia County",4,80,166,75,91
050,39,053,"Ohio","Gallia County",4,81,153,67,86
050,39,053,"Ohio","Gallia County",4,82,149,78,71
050,39,053,"Ohio","Gallia County",4,83,134,68,66
050,39,053,"Ohio","Gallia County",4,84,121,50,71
050,39,053,"Ohio","Gallia County",4,85,572,202,370
050,39,053,"Ohio","Gallia County",5,0,315,160,155
050,39,053,"Ohio","Gallia County",5,1,353,175,178
050,39,053,"Ohio","Gallia County",5,2,359,198,161
050,39,053,"Ohio","Gallia County",5,3,394,208,186
050,39,053,"Ohio","Gallia County",5,4,353,185,168
050,39,053,"Ohio","Gallia County",5,5,352,174,178
050,39,053,"Ohio","Gallia County",5,6,350,176,174
050,39,053,"Ohio","Gallia County",5,7,366,183,183
050,39,053,"Ohio","Gallia County",5,8,385,197,188
050,39,053,"Ohio","Gallia County",5,9,404,208,196
050,39,053,"Ohio","Gallia County",5,10,372,188,184
050,39,053,"Ohio","Gallia County",5,11,381,196,185
050,39,053,"Ohio","Gallia County",5,12,386,199,187
050,39,053,"Ohio","Gallia County",5,13,382,203,179
050,39,053,"Ohio","Gallia County",5,14,393,214,179
050,39,053,"Ohio","Gallia County",5,15,421,228,193
050,39,053,"Ohio","Gallia County",5,16,395,205,190
050,39,053,"Ohio","Gallia County",5,17,396,200,196
050,39,053,"Ohio","Gallia County",5,18,346,200,146
050,39,053,"Ohio","Gallia County",5,19,313,167,146
050,39,053,"Ohio","Gallia County",5,20,308,158,150
050,39,053,"Ohio","Gallia County",5,21,324,165,159
050,39,053,"Ohio","Gallia County",5,22,345,185,160
050,39,053,"Ohio","Gallia County",5,23,345,183,162
050,39,053,"Ohio","Gallia County",5,24,357,200,157
050,39,053,"Ohio","Gallia County",5,25,325,175,150
050,39,053,"Ohio","Gallia County",5,26,326,173,153
050,39,053,"Ohio","Gallia County",5,27,311,166,145
050,39,053,"Ohio","Gallia County",5,28,344,194,150
050,39,053,"Ohio","Gallia County",5,29,331,164,167
050,39,053,"Ohio","Gallia County",5,30,332,156,176
050,39,053,"Ohio","Gallia County",5,31,321,160,161
050,39,053,"Ohio","Gallia County",5,32,351,182,169
050,39,053,"Ohio","Gallia County",5,33,338,159,179
050,39,053,"Ohio","Gallia County",5,34,330,172,158
050,39,053,"Ohio","Gallia County",5,35,315,159,156
050,39,053,"Ohio","Gallia County",5,36,329,177,152
050,39,053,"Ohio","Gallia County",5,37,327,162,165
050,39,053,"Ohio","Gallia County",5,38,336,178,158
050,39,053,"Ohio","Gallia County",5,39,362,186,176
050,39,053,"Ohio","Gallia County",5,40,341,166,175
050,39,053,"Ohio","Gallia County",5,41,328,163,165
050,39,053,"Ohio","Gallia County",5,42,342,173,169
050,39,053,"Ohio","Gallia County",5,43,335,166,169
050,39,053,"Ohio","Gallia County",5,44,328,170,158
050,39,053,"Ohio","Gallia County",5,45,341,175,166
050,39,053,"Ohio","Gallia County",5,46,354,181,173
050,39,053,"Ohio","Gallia County",5,47,310,148,162
050,39,053,"Ohio","Gallia County",5,48,325,157,168
050,39,053,"Ohio","Gallia County",5,49,333,159,174
050,39,053,"Ohio","Gallia County",5,50,349,165,184
050,39,053,"Ohio","Gallia County",5,51,375,195,180
050,39,053,"Ohio","Gallia County",5,52,378,203,175
050,39,053,"Ohio","Gallia County",5,53,371,185,186
050,39,053,"Ohio","Gallia County",5,54,351,180,171
050,39,053,"Ohio","Gallia County",5,55,319,164,155
050,39,053,"Ohio","Gallia County",5,56,312,152,160
050,39,053,"Ohio","Gallia County",5,57,344,170,174
050,39,053,"Ohio","Gallia County",5,58,374,179,195
050,39,053,"Ohio","Gallia County",5,59,395,197,198
050,39,053,"Ohio","Gallia County",5,60,391,198,193
050,39,053,"Ohio","Gallia County",5,61,412,201,211
050,39,053,"Ohio","Gallia County",5,62,439,211,228
050,39,053,"Ohio","Gallia County",5,63,408,200,208
050,39,053,"Ohio","Gallia County",5,64,423,199,224
050,39,053,"Ohio","Gallia County",5,65,427,198,229
050,39,053,"Ohio","Gallia County",5,66,424,204,220
050,39,053,"Ohio","Gallia County",5,67,424,193,231
050,39,053,"Ohio","Gallia County",5,68,373,183,190
050,39,053,"Ohio","Gallia County",5,69,346,178,168
050,39,053,"Ohio","Gallia County",5,70,344,178,166
050,39,053,"Ohio","Gallia County",5,71,334,154,180
050,39,053,"Ohio","Gallia County",5,72,305,150,155
050,39,053,"Ohio","Gallia County",5,73,275,142,133
050,39,053,"Ohio","Gallia County",5,74,291,140,151
050,39,053,"Ohio","Gallia County",5,75,248,107,141
050,39,053,"Ohio","Gallia County",5,76,265,118,147
050,39,053,"Ohio","Gallia County",5,77,178,79,99
050,39,053,"Ohio","Gallia County",5,78,180,79,101
050,39,053,"Ohio","Gallia County",5,79,171,67,104
050,39,053,"Ohio","Gallia County",5,80,185,69,116
050,39,053,"Ohio","Gallia County",5,81,159,67,92
050,39,053,"Ohio","Gallia County",5,82,138,66,72
050,39,053,"Ohio","Gallia County",5,83,144,73,71
050,39,053,"Ohio","Gallia County",5,84,127,61,66
050,39,053,"Ohio","Gallia County",5,85,597,220,377
050,39,055,"Ohio","Geauga County",1,0,935,482,453
050,39,055,"Ohio","Geauga County",1,1,991,517,474
050,39,055,"Ohio","Geauga County",1,2,976,510,466
050,39,055,"Ohio","Geauga County",1,3,1021,518,503
050,39,055,"Ohio","Geauga County",1,4,1060,556,504
050,39,055,"Ohio","Geauga County",1,5,1129,551,578
050,39,055,"Ohio","Geauga County",1,6,1110,568,542
050,39,055,"Ohio","Geauga County",1,7,1143,600,543
050,39,055,"Ohio","Geauga County",1,8,1186,597,589
050,39,055,"Ohio","Geauga County",1,9,1192,594,598
050,39,055,"Ohio","Geauga County",1,10,1160,574,586
050,39,055,"Ohio","Geauga County",1,11,1237,648,589
050,39,055,"Ohio","Geauga County",1,12,1302,693,609
050,39,055,"Ohio","Geauga County",1,13,1342,690,652
050,39,055,"Ohio","Geauga County",1,14,1433,730,703
050,39,055,"Ohio","Geauga County",1,15,1439,736,703
050,39,055,"Ohio","Geauga County",1,16,1489,757,732
050,39,055,"Ohio","Geauga County",1,17,1529,777,752
050,39,055,"Ohio","Geauga County",1,18,1262,679,583
050,39,055,"Ohio","Geauga County",1,19,999,528,471
050,39,055,"Ohio","Geauga County",1,20,1068,558,510
050,39,055,"Ohio","Geauga County",1,21,1078,572,506
050,39,055,"Ohio","Geauga County",1,22,1155,608,547
050,39,055,"Ohio","Geauga County",1,23,1068,559,509
050,39,055,"Ohio","Geauga County",1,24,1030,565,465
050,39,055,"Ohio","Geauga County",1,25,921,475,446
050,39,055,"Ohio","Geauga County",1,26,885,462,423
050,39,055,"Ohio","Geauga County",1,27,901,466,435
050,39,055,"Ohio","Geauga County",1,28,832,448,384
050,39,055,"Ohio","Geauga County",1,29,797,425,372
050,39,055,"Ohio","Geauga County",1,30,834,424,410
050,39,055,"Ohio","Geauga County",1,31,823,419,404
050,39,055,"Ohio","Geauga County",1,32,784,382,402
050,39,055,"Ohio","Geauga County",1,33,826,435,391
050,39,055,"Ohio","Geauga County",1,34,855,457,398
050,39,055,"Ohio","Geauga County",1,35,860,428,432
050,39,055,"Ohio","Geauga County",1,36,942,444,498
050,39,055,"Ohio","Geauga County",1,37,978,494,484
050,39,055,"Ohio","Geauga County",1,38,1026,519,507
050,39,055,"Ohio","Geauga County",1,39,1099,530,569
050,39,055,"Ohio","Geauga County",1,40,1044,520,524
050,39,055,"Ohio","Geauga County",1,41,1011,507,504
050,39,055,"Ohio","Geauga County",1,42,1012,514,498
050,39,055,"Ohio","Geauga County",1,43,968,506,462
050,39,055,"Ohio","Geauga County",1,44,1069,539,530
050,39,055,"Ohio","Geauga County",1,45,1132,576,556
050,39,055,"Ohio","Geauga County",1,46,1064,551,513
050,39,055,"Ohio","Geauga County",1,47,1068,539,529
050,39,055,"Ohio","Geauga County",1,48,1200,593,607
050,39,055,"Ohio","Geauga County",1,49,1318,662,656
050,39,055,"Ohio","Geauga County",1,50,1297,650,647
050,39,055,"Ohio","Geauga County",1,51,1389,690,699
050,39,055,"Ohio","Geauga County",1,52,1381,713,668
050,39,055,"Ohio","Geauga County",1,53,1426,735,691
050,39,055,"Ohio","Geauga County",1,54,1436,725,711
050,39,055,"Ohio","Geauga County",1,55,1440,703,737
050,39,055,"Ohio","Geauga County",1,56,1463,737,726
050,39,055,"Ohio","Geauga County",1,57,1476,745,731
050,39,055,"Ohio","Geauga County",1,58,1492,744,748
050,39,055,"Ohio","Geauga County",1,59,1473,715,758
050,39,055,"Ohio","Geauga County",1,60,1513,751,762
050,39,055,"Ohio","Geauga County",1,61,1571,772,799
050,39,055,"Ohio","Geauga County",1,62,1573,793,780
050,39,055,"Ohio","Geauga County",1,63,1470,755,715
050,39,055,"Ohio","Geauga County",1,64,1404,714,690
050,39,055,"Ohio","Geauga County",1,65,1378,720,658
050,39,055,"Ohio","Geauga County",1,66,1326,683,643
050,39,055,"Ohio","Geauga County",1,67,1282,622,660
050,39,055,"Ohio","Geauga County",1,68,1283,648,635
050,39,055,"Ohio","Geauga County",1,69,1158,589,569
050,39,055,"Ohio","Geauga County",1,70,1132,558,574
050,39,055,"Ohio","Geauga County",1,71,1085,526,559
050,39,055,"Ohio","Geauga County",1,72,1091,537,554
050,39,055,"Ohio","Geauga County",1,73,1097,536,561
050,39,055,"Ohio","Geauga County",1,74,800,380,420
050,39,055,"Ohio","Geauga County",1,75,791,367,424
050,39,055,"Ohio","Geauga County",1,76,793,384,409
050,39,055,"Ohio","Geauga County",1,77,816,396,420
050,39,055,"Ohio","Geauga County",1,78,693,314,379
050,39,055,"Ohio","Geauga County",1,79,618,266,352
050,39,055,"Ohio","Geauga County",1,80,545,246,299
050,39,055,"Ohio","Geauga County",1,81,512,227,285
050,39,055,"Ohio","Geauga County",1,82,450,199,251
050,39,055,"Ohio","Geauga County",1,83,394,163,231
050,39,055,"Ohio","Geauga County",1,84,379,166,213
050,39,055,"Ohio","Geauga County",1,85,2423,840,1583
050,39,055,"Ohio","Geauga County",2,0,955,496,459
050,39,055,"Ohio","Geauga County",2,1,977,509,468
050,39,055,"Ohio","Geauga County",2,2,989,515,474
050,39,055,"Ohio","Geauga County",2,3,1018,522,496
050,39,055,"Ohio","Geauga County",2,4,1065,551,514
050,39,055,"Ohio","Geauga County",2,5,1116,552,564
050,39,055,"Ohio","Geauga County",2,6,1121,568,553
050,39,055,"Ohio","Geauga County",2,7,1140,596,544
050,39,055,"Ohio","Geauga County",2,8,1174,598,576
050,39,055,"Ohio","Geauga County",2,9,1194,596,598
050,39,055,"Ohio","Geauga County",2,10,1172,581,591
050,39,055,"Ohio","Geauga County",2,11,1215,628,587
050,39,055,"Ohio","Geauga County",2,12,1293,685,608
050,39,055,"Ohio","Geauga County",2,13,1331,691,640
050,39,055,"Ohio","Geauga County",2,14,1410,720,690
050,39,055,"Ohio","Geauga County",2,15,1439,736,703
050,39,055,"Ohio","Geauga County",2,16,1484,757,727
050,39,055,"Ohio","Geauga County",2,17,1522,777,745
050,39,055,"Ohio","Geauga County",2,18,1259,672,587
050,39,055,"Ohio","Geauga County",2,19,1004,533,471
050,39,055,"Ohio","Geauga County",2,20,1077,564,513
050,39,055,"Ohio","Geauga County",2,21,1084,572,512
050,39,055,"Ohio","Geauga County",2,22,1125,593,532
050,39,055,"Ohio","Geauga County",2,23,1071,560,511
050,39,055,"Ohio","Geauga County",2,24,1017,552,465
050,39,055,"Ohio","Geauga County",2,25,933,488,445
050,39,055,"Ohio","Geauga County",2,26,889,464,425
050,39,055,"Ohio","Geauga County",2,27,895,466,429
050,39,055,"Ohio","Geauga County",2,28,855,458,397
050,39,055,"Ohio","Geauga County",2,29,813,431,382
050,39,055,"Ohio","Geauga County",2,30,835,426,409
050,39,055,"Ohio","Geauga County",2,31,828,423,405
050,39,055,"Ohio","Geauga County",2,32,794,391,403
050,39,055,"Ohio","Geauga County",2,33,822,426,396
050,39,055,"Ohio","Geauga County",2,34,853,454,399
050,39,055,"Ohio","Geauga County",2,35,876,444,432
050,39,055,"Ohio","Geauga County",2,36,922,440,482
050,39,055,"Ohio","Geauga County",2,37,974,485,489
050,39,055,"Ohio","Geauga County",2,38,1022,517,505
050,39,055,"Ohio","Geauga County",2,39,1079,526,553
050,39,055,"Ohio","Geauga County",2,40,1069,530,539
050,39,055,"Ohio","Geauga County",2,41,1026,513,513
050,39,055,"Ohio","Geauga County",2,42,1013,513,500
050,39,055,"Ohio","Geauga County",2,43,986,511,475
050,39,055,"Ohio","Geauga County",2,44,1034,526,508
050,39,055,"Ohio","Geauga County",2,45,1128,572,556
050,39,055,"Ohio","Geauga County",2,46,1080,557,523
050,39,055,"Ohio","Geauga County",2,47,1065,541,524
050,39,055,"Ohio","Geauga County",2,48,1172,582,590
050,39,055,"Ohio","Geauga County",2,49,1292,649,643
050,39,055,"Ohio","Geauga County",2,50,1303,654,649
050,39,055,"Ohio","Geauga County",2,51,1363,678,685
050,39,055,"Ohio","Geauga County",2,52,1375,704,671
050,39,055,"Ohio","Geauga County",2,53,1412,729,683
050,39,055,"Ohio","Geauga County",2,54,1427,725,702
050,39,055,"Ohio","Geauga County",2,55,1434,705,729
050,39,055,"Ohio","Geauga County",2,56,1462,732,730
050,39,055,"Ohio","Geauga County",2,57,1471,741,730
050,39,055,"Ohio","Geauga County",2,58,1484,744,740
050,39,055,"Ohio","Geauga County",2,59,1481,723,758
050,39,055,"Ohio","Geauga County",2,60,1497,738,759
050,39,055,"Ohio","Geauga County",2,61,1547,761,786
050,39,055,"Ohio","Geauga County",2,62,1562,782,780
050,39,055,"Ohio","Geauga County",2,63,1505,769,736
050,39,055,"Ohio","Geauga County",2,64,1410,720,690
050,39,055,"Ohio","Geauga County",2,65,1380,715,665
050,39,055,"Ohio","Geauga County",2,66,1336,689,647
050,39,055,"Ohio","Geauga County",2,67,1281,631,650
050,39,055,"Ohio","Geauga County",2,68,1266,634,632
050,39,055,"Ohio","Geauga County",2,69,1195,605,590
050,39,055,"Ohio","Geauga County",2,70,1129,560,569
050,39,055,"Ohio","Geauga County",2,71,1093,532,561
050,39,055,"Ohio","Geauga County",2,72,1066,522,544
050,39,055,"Ohio","Geauga County",2,73,1136,557,579
050,39,055,"Ohio","Geauga County",2,74,811,387,424
050,39,055,"Ohio","Geauga County",2,75,788,368,420
050,39,055,"Ohio","Geauga County",2,76,777,369,408
050,39,055,"Ohio","Geauga County",2,77,821,398,423
050,39,055,"Ohio","Geauga County",2,78,706,326,380
050,39,055,"Ohio","Geauga County",2,79,631,276,355
050,39,055,"Ohio","Geauga County",2,80,555,246,309
050,39,055,"Ohio","Geauga County",2,81,517,228,289
050,39,055,"Ohio","Geauga County",2,82,455,202,253
050,39,055,"Ohio","Geauga County",2,83,404,168,236
050,39,055,"Ohio","Geauga County",2,84,378,162,216
050,39,055,"Ohio","Geauga County",2,85,2422,839,1583
050,39,055,"Ohio","Geauga County",3,0,940,478,462
050,39,055,"Ohio","Geauga County",3,1,1021,540,481
050,39,055,"Ohio","Geauga County",3,2,1039,542,497
050,39,055,"Ohio","Geauga County",3,3,1038,540,498
050,39,055,"Ohio","Geauga County",3,4,1069,536,533
050,39,055,"Ohio","Geauga County",3,5,1093,549,544
050,39,055,"Ohio","Geauga County",3,6,1143,580,563
050,39,055,"Ohio","Geauga County",3,7,1151,573,578
050,39,055,"Ohio","Geauga County",3,8,1167,617,550
050,39,055,"Ohio","Geauga County",3,9,1198,616,582
050,39,055,"Ohio","Geauga County",3,10,1202,596,606
050,39,055,"Ohio","Geauga County",3,11,1213,604,609
050,39,055,"Ohio","Geauga County",3,12,1213,629,584
050,39,055,"Ohio","Geauga County",3,13,1297,687,610
050,39,055,"Ohio","Geauga County",3,14,1352,699,653
050,39,055,"Ohio","Geauga County",3,15,1416,718,698
050,39,055,"Ohio","Geauga County",3,16,1448,743,705
050,39,055,"Ohio","Geauga County",3,17,1481,759,722
050,39,055,"Ohio","Geauga County",3,18,1267,671,596
050,39,055,"Ohio","Geauga County",3,19,970,510,460
050,39,055,"Ohio","Geauga County",3,20,1060,559,501
050,39,055,"Ohio","Geauga County",3,21,1137,590,547
050,39,055,"Ohio","Geauga County",3,22,1132,590,542
050,39,055,"Ohio","Geauga County",3,23,1062,575,487
050,39,055,"Ohio","Geauga County",3,24,1003,527,476
050,39,055,"Ohio","Geauga County",3,25,959,516,443
050,39,055,"Ohio","Geauga County",3,26,901,496,405
050,39,055,"Ohio","Geauga County",3,27,903,478,425
050,39,055,"Ohio","Geauga County",3,28,891,459,432
050,39,055,"Ohio","Geauga County",3,29,854,447,407
050,39,055,"Ohio","Geauga County",3,30,856,434,422
050,39,055,"Ohio","Geauga County",3,31,886,450,436
050,39,055,"Ohio","Geauga County",3,32,856,441,415
050,39,055,"Ohio","Geauga County",3,33,842,430,412
050,39,055,"Ohio","Geauga County",3,34,876,445,431
050,39,055,"Ohio","Geauga County",3,35,900,482,418
050,39,055,"Ohio","Geauga County",3,36,915,455,460
050,39,055,"Ohio","Geauga County",3,37,969,483,486
050,39,055,"Ohio","Geauga County",3,38,1024,522,502
050,39,055,"Ohio","Geauga County",3,39,1038,530,508
050,39,055,"Ohio","Geauga County",3,40,1094,546,548
050,39,055,"Ohio","Geauga County",3,41,1079,524,555
050,39,055,"Ohio","Geauga County",3,42,1069,538,531
050,39,055,"Ohio","Geauga County",3,43,1039,527,512
050,39,055,"Ohio","Geauga County",3,44,1019,534,485
050,39,055,"Ohio","Geauga County",3,45,1054,539,515
050,39,055,"Ohio","Geauga County",3,46,1150,586,564
050,39,055,"Ohio","Geauga County",3,47,1078,551,527
050,39,055,"Ohio","Geauga County",3,48,1071,541,530
050,39,055,"Ohio","Geauga County",3,49,1173,584,589
050,39,055,"Ohio","Geauga County",3,50,1320,661,659
050,39,055,"Ohio","Geauga County",3,51,1302,659,643
050,39,055,"Ohio","Geauga County",3,52,1338,668,670
050,39,055,"Ohio","Geauga County",3,53,1390,712,678
050,39,055,"Ohio","Geauga County",3,54,1418,728,690
050,39,055,"Ohio","Geauga County",3,55,1411,725,686
050,39,055,"Ohio","Geauga County",3,56,1429,710,719
050,39,055,"Ohio","Geauga County",3,57,1465,726,739
050,39,055,"Ohio","Geauga County",3,58,1451,733,718
050,39,055,"Ohio","Geauga County",3,59,1466,734,732
050,39,055,"Ohio","Geauga County",3,60,1471,713,758
050,39,055,"Ohio","Geauga County",3,61,1478,733,745
050,39,055,"Ohio","Geauga County",3,62,1513,743,770
050,39,055,"Ohio","Geauga County",3,63,1537,773,764
050,39,055,"Ohio","Geauga County",3,64,1476,762,714
050,39,055,"Ohio","Geauga County",3,65,1378,702,676
050,39,055,"Ohio","Geauga County",3,66,1353,708,645
050,39,055,"Ohio","Geauga County",3,67,1334,682,652
050,39,055,"Ohio","Geauga County",3,68,1253,624,629
050,39,055,"Ohio","Geauga County",3,69,1239,611,628
050,39,055,"Ohio","Geauga County",3,70,1185,601,584
050,39,055,"Ohio","Geauga County",3,71,1098,545,553
050,39,055,"Ohio","Geauga County",3,72,1068,518,550
050,39,055,"Ohio","Geauga County",3,73,1035,505,530
050,39,055,"Ohio","Geauga County",3,74,1121,542,579
050,39,055,"Ohio","Geauga County",3,75,779,373,406
050,39,055,"Ohio","Geauga County",3,76,760,353,407
050,39,055,"Ohio","Geauga County",3,77,752,359,393
050,39,055,"Ohio","Geauga County",3,78,803,386,417
050,39,055,"Ohio","Geauga County",3,79,682,316,366
050,39,055,"Ohio","Geauga County",3,80,604,264,340
050,39,055,"Ohio","Geauga County",3,81,536,223,313
050,39,055,"Ohio","Geauga County",3,82,467,211,256
050,39,055,"Ohio","Geauga County",3,83,447,188,259
050,39,055,"Ohio","Geauga County",3,84,366,143,223
050,39,055,"Ohio","Geauga County",3,85,2375,833,1542
050,39,055,"Ohio","Geauga County",4,0,919,472,447
050,39,055,"Ohio","Geauga County",4,1,958,487,471
050,39,055,"Ohio","Geauga County",4,2,1079,573,506
050,39,055,"Ohio","Geauga County",4,3,1088,569,519
050,39,055,"Ohio","Geauga County",4,4,1045,544,501
050,39,055,"Ohio","Geauga County",4,5,1082,539,543
050,39,055,"Ohio","Geauga County",4,6,1112,549,563
050,39,055,"Ohio","Geauga County",4,7,1172,596,576
050,39,055,"Ohio","Geauga County",4,8,1173,584,589
050,39,055,"Ohio","Geauga County",4,9,1192,629,563
050,39,055,"Ohio","Geauga County",4,10,1224,632,592
050,39,055,"Ohio","Geauga County",4,11,1221,605,616
050,39,055,"Ohio","Geauga County",4,12,1214,598,616
050,39,055,"Ohio","Geauga County",4,13,1228,636,592
050,39,055,"Ohio","Geauga County",4,14,1317,687,630
050,39,055,"Ohio","Geauga County",4,15,1367,714,653
050,39,055,"Ohio","Geauga County",4,16,1415,716,699
050,39,055,"Ohio","Geauga County",4,17,1425,735,690
050,39,055,"Ohio","Geauga County",4,18,1214,638,576
050,39,055,"Ohio","Geauga County",4,19,939,491,448
050,39,055,"Ohio","Geauga County",4,20,1028,554,474
050,39,055,"Ohio","Geauga County",4,21,1097,559,538
050,39,055,"Ohio","Geauga County",4,22,1172,621,551
050,39,055,"Ohio","Geauga County",4,23,1093,579,514
050,39,055,"Ohio","Geauga County",4,24,942,514,428
050,39,055,"Ohio","Geauga County",4,25,943,493,450
050,39,055,"Ohio","Geauga County",4,26,898,497,401
050,39,055,"Ohio","Geauga County",4,27,843,465,378
050,39,055,"Ohio","Geauga County",4,28,855,447,408
050,39,055,"Ohio","Geauga County",4,29,919,464,455
050,39,055,"Ohio","Geauga County",4,30,866,443,423
050,39,055,"Ohio","Geauga County",4,31,866,438,428
050,39,055,"Ohio","Geauga County",4,32,927,473,454
050,39,055,"Ohio","Geauga County",4,33,926,475,451
050,39,055,"Ohio","Geauga County",4,34,869,436,433
050,39,055,"Ohio","Geauga County",4,35,918,468,450
050,39,055,"Ohio","Geauga County",4,36,937,495,442
050,39,055,"Ohio","Geauga County",4,37,944,470,474
050,39,055,"Ohio","Geauga County",4,38,1023,531,492
050,39,055,"Ohio","Geauga County",4,39,1069,540,529
050,39,055,"Ohio","Geauga County",4,40,1065,538,527
050,39,055,"Ohio","Geauga County",4,41,1110,555,555
050,39,055,"Ohio","Geauga County",4,42,1081,523,558
050,39,055,"Ohio","Geauga County",4,43,1099,556,543
050,39,055,"Ohio","Geauga County",4,44,1049,541,508
050,39,055,"Ohio","Geauga County",4,45,1019,531,488
050,39,055,"Ohio","Geauga County",4,46,1069,543,526
050,39,055,"Ohio","Geauga County",4,47,1131,576,555
050,39,055,"Ohio","Geauga County",4,48,1083,556,527
050,39,055,"Ohio","Geauga County",4,49,1081,545,536
050,39,055,"Ohio","Geauga County",4,50,1176,589,587
050,39,055,"Ohio","Geauga County",4,51,1303,647,656
050,39,055,"Ohio","Geauga County",4,52,1289,653,636
050,39,055,"Ohio","Geauga County",4,53,1338,669,669
050,39,055,"Ohio","Geauga County",4,54,1376,701,675
050,39,055,"Ohio","Geauga County",4,55,1394,714,680
050,39,055,"Ohio","Geauga County",4,56,1404,724,680
050,39,055,"Ohio","Geauga County",4,57,1416,705,711
050,39,055,"Ohio","Geauga County",4,58,1456,717,739
050,39,055,"Ohio","Geauga County",4,59,1433,717,716
050,39,055,"Ohio","Geauga County",4,60,1448,732,716
050,39,055,"Ohio","Geauga County",4,61,1439,701,738
050,39,055,"Ohio","Geauga County",4,62,1477,717,760
050,39,055,"Ohio","Geauga County",4,63,1484,727,757
050,39,055,"Ohio","Geauga County",4,64,1495,762,733
050,39,055,"Ohio","Geauga County",4,65,1459,748,711
050,39,055,"Ohio","Geauga County",4,66,1349,691,658
050,39,055,"Ohio","Geauga County",4,67,1339,697,642
050,39,055,"Ohio","Geauga County",4,68,1329,681,648
050,39,055,"Ohio","Geauga County",4,69,1240,607,633
050,39,055,"Ohio","Geauga County",4,70,1218,602,616
050,39,055,"Ohio","Geauga County",4,71,1153,585,568
050,39,055,"Ohio","Geauga County",4,72,1065,530,535
050,39,055,"Ohio","Geauga County",4,73,1035,499,536
050,39,055,"Ohio","Geauga County",4,74,1029,501,528
050,39,055,"Ohio","Geauga County",4,75,1080,510,570
050,39,055,"Ohio","Geauga County",4,76,744,349,395
050,39,055,"Ohio","Geauga County",4,77,725,337,388
050,39,055,"Ohio","Geauga County",4,78,729,346,383
050,39,055,"Ohio","Geauga County",4,79,781,376,405
050,39,055,"Ohio","Geauga County",4,80,650,305,345
050,39,055,"Ohio","Geauga County",4,81,587,243,344
050,39,055,"Ohio","Geauga County",4,82,490,210,280
050,39,055,"Ohio","Geauga County",4,83,460,199,261
050,39,055,"Ohio","Geauga County",4,84,420,172,248
050,39,055,"Ohio","Geauga County",4,85,2375,824,1551
050,39,055,"Ohio","Geauga County",5,0,912,467,445
050,39,055,"Ohio","Geauga County",5,1,956,477,479
050,39,055,"Ohio","Geauga County",5,2,973,513,460
050,39,055,"Ohio","Geauga County",5,3,1086,575,511
050,39,055,"Ohio","Geauga County",5,4,1120,587,533
050,39,055,"Ohio","Geauga County",5,5,1065,562,503
050,39,055,"Ohio","Geauga County",5,6,1094,546,548
050,39,055,"Ohio","Geauga County",5,7,1135,558,577
050,39,055,"Ohio","Geauga County",5,8,1190,603,587
050,39,055,"Ohio","Geauga County",5,9,1180,585,595
050,39,055,"Ohio","Geauga County",5,10,1221,638,583
050,39,055,"Ohio","Geauga County",5,11,1240,640,600
050,39,055,"Ohio","Geauga County",5,12,1214,598,616
050,39,055,"Ohio","Geauga County",5,13,1241,618,623
050,39,055,"Ohio","Geauga County",5,14,1243,643,600
050,39,055,"Ohio","Geauga County",5,15,1301,673,628
050,39,055,"Ohio","Geauga County",5,16,1373,710,663
050,39,055,"Ohio","Geauga County",5,17,1420,722,698
050,39,055,"Ohio","Geauga County",5,18,1193,640,553
050,39,055,"Ohio","Geauga County",5,19,928,492,436
050,39,055,"Ohio","Geauga County",5,20,1033,547,486
050,39,055,"Ohio","Geauga County",5,21,1089,573,516
050,39,055,"Ohio","Geauga County",5,22,1129,578,551
050,39,055,"Ohio","Geauga County",5,23,1095,567,528
050,39,055,"Ohio","Geauga County",5,24,976,555,421
050,39,055,"Ohio","Geauga County",5,25,888,489,399
050,39,055,"Ohio","Geauga County",5,26,911,489,422
050,39,055,"Ohio","Geauga County",5,27,886,493,393
050,39,055,"Ohio","Geauga County",5,28,837,447,390
050,39,055,"Ohio","Geauga County",5,29,864,441,423
050,39,055,"Ohio","Geauga County",5,30,951,482,469
050,39,055,"Ohio","Geauga County",5,31,864,438,426
050,39,055,"Ohio","Geauga County",5,32,889,448,441
050,39,055,"Ohio","Geauga County",5,33,961,499,462
050,39,055,"Ohio","Geauga County",5,34,958,479,479
050,39,055,"Ohio","Geauga County",5,35,885,448,437
050,39,055,"Ohio","Geauga County",5,36,938,468,470
050,39,055,"Ohio","Geauga County",5,37,979,526,453
050,39,055,"Ohio","Geauga County",5,38,1001,506,495
050,39,055,"Ohio","Geauga County",5,39,1057,550,507
050,39,055,"Ohio","Geauga County",5,40,1084,552,532
050,39,055,"Ohio","Geauga County",5,41,1077,545,532
050,39,055,"Ohio","Geauga County",5,42,1119,557,562
050,39,055,"Ohio","Geauga County",5,43,1073,516,557
050,39,055,"Ohio","Geauga County",5,44,1098,558,540
050,39,055,"Ohio","Geauga County",5,45,1056,536,520
050,39,055,"Ohio","Geauga County",5,46,1029,541,488
050,39,055,"Ohio","Geauga County",5,47,1061,541,520
050,39,055,"Ohio","Geauga County",5,48,1129,575,554
050,39,055,"Ohio","Geauga County",5,49,1089,562,527
050,39,055,"Ohio","Geauga County",5,50,1059,532,527
050,39,055,"Ohio","Geauga County",5,51,1182,592,590
050,39,055,"Ohio","Geauga County",5,52,1283,641,642
050,39,055,"Ohio","Geauga County",5,53,1281,649,632
050,39,055,"Ohio","Geauga County",5,54,1327,667,660
050,39,055,"Ohio","Geauga County",5,55,1367,695,672
050,39,055,"Ohio","Geauga County",5,56,1390,715,675
050,39,055,"Ohio","Geauga County",5,57,1415,720,695
050,39,055,"Ohio","Geauga County",5,58,1404,696,708
050,39,055,"Ohio","Geauga County",5,59,1444,701,743
050,39,055,"Ohio","Geauga County",5,60,1435,719,716
050,39,055,"Ohio","Geauga County",5,61,1448,735,713
050,39,055,"Ohio","Geauga County",5,62,1418,689,729
050,39,055,"Ohio","Geauga County",5,63,1463,716,747
050,39,055,"Ohio","Geauga County",5,64,1473,726,747
050,39,055,"Ohio","Geauga County",5,65,1467,748,719
050,39,055,"Ohio","Geauga County",5,66,1447,740,707
050,39,055,"Ohio","Geauga County",5,67,1356,683,673
050,39,055,"Ohio","Geauga County",5,68,1339,701,638
050,39,055,"Ohio","Geauga County",5,69,1315,671,644
050,39,055,"Ohio","Geauga County",5,70,1230,608,622
050,39,055,"Ohio","Geauga County",5,71,1184,576,608
050,39,055,"Ohio","Geauga County",5,72,1132,576,556
050,39,055,"Ohio","Geauga County",5,73,1025,509,516
050,39,055,"Ohio","Geauga County",5,74,1018,489,529
050,39,055,"Ohio","Geauga County",5,75,991,477,514
050,39,055,"Ohio","Geauga County",5,76,1045,491,554
050,39,055,"Ohio","Geauga County",5,77,716,330,386
050,39,055,"Ohio","Geauga County",5,78,706,330,376
050,39,055,"Ohio","Geauga County",5,79,699,334,365
050,39,055,"Ohio","Geauga County",5,80,733,359,374
050,39,055,"Ohio","Geauga County",5,81,623,280,343
050,39,055,"Ohio","Geauga County",5,82,543,230,313
050,39,055,"Ohio","Geauga County",5,83,481,202,279
050,39,055,"Ohio","Geauga County",5,84,426,179,247
050,39,055,"Ohio","Geauga County",5,85,2451,849,1602
050,39,057,"Ohio","Greene County",1,0,1667,859,808
050,39,057,"Ohio","Greene County",1,1,1779,918,861
050,39,057,"Ohio","Greene County",1,2,1833,916,917
050,39,057,"Ohio","Greene County",1,3,1905,977,928
050,39,057,"Ohio","Greene County",1,4,2051,1050,1001
050,39,057,"Ohio","Greene County",1,5,2003,1026,977
050,39,057,"Ohio","Greene County",1,6,2000,1045,955
050,39,057,"Ohio","Greene County",1,7,1970,1006,964
050,39,057,"Ohio","Greene County",1,8,1958,1009,949
050,39,057,"Ohio","Greene County",1,9,1882,988,894
050,39,057,"Ohio","Greene County",1,10,1967,1053,914
050,39,057,"Ohio","Greene County",1,11,1997,1044,953
050,39,057,"Ohio","Greene County",1,12,2001,1049,952
050,39,057,"Ohio","Greene County",1,13,1984,1030,954
050,39,057,"Ohio","Greene County",1,14,1939,1000,939
050,39,057,"Ohio","Greene County",1,15,2033,1047,986
050,39,057,"Ohio","Greene County",1,16,2033,1008,1025
050,39,057,"Ohio","Greene County",1,17,2037,1029,1008
050,39,057,"Ohio","Greene County",1,18,2699,1318,1381
050,39,057,"Ohio","Greene County",1,19,3368,1593,1775
050,39,057,"Ohio","Greene County",1,20,3072,1506,1566
050,39,057,"Ohio","Greene County",1,21,2813,1432,1381
050,39,057,"Ohio","Greene County",1,22,2488,1255,1233
050,39,057,"Ohio","Greene County",1,23,2359,1210,1149
050,39,057,"Ohio","Greene County",1,24,2340,1174,1166
050,39,057,"Ohio","Greene County",1,25,2327,1264,1063
050,39,057,"Ohio","Greene County",1,26,2291,1205,1086
050,39,057,"Ohio","Greene County",1,27,2203,1099,1104
050,39,057,"Ohio","Greene County",1,28,2192,1093,1099
050,39,057,"Ohio","Greene County",1,29,2234,1185,1049
050,39,057,"Ohio","Greene County",1,30,2214,1119,1095
050,39,057,"Ohio","Greene County",1,31,2179,1088,1091
050,39,057,"Ohio","Greene County",1,32,2141,1086,1055
050,39,057,"Ohio","Greene County",1,33,2156,1104,1052
050,39,057,"Ohio","Greene County",1,34,2194,1128,1066
050,39,057,"Ohio","Greene County",1,35,2137,1102,1035
050,39,057,"Ohio","Greene County",1,36,2087,1044,1043
050,39,057,"Ohio","Greene County",1,37,2142,1087,1055
050,39,057,"Ohio","Greene County",1,38,2164,1098,1066
050,39,057,"Ohio","Greene County",1,39,2073,1060,1013
050,39,057,"Ohio","Greene County",1,40,1988,1022,966
050,39,057,"Ohio","Greene County",1,41,1978,993,985
050,39,057,"Ohio","Greene County",1,42,1813,921,892
050,39,057,"Ohio","Greene County",1,43,1755,865,890
050,39,057,"Ohio","Greene County",1,44,1712,864,848
050,39,057,"Ohio","Greene County",1,45,1756,894,862
050,39,057,"Ohio","Greene County",1,46,1714,860,854
050,39,057,"Ohio","Greene County",1,47,1809,882,927
050,39,057,"Ohio","Greene County",1,48,1907,926,981
050,39,057,"Ohio","Greene County",1,49,2054,1004,1050
050,39,057,"Ohio","Greene County",1,50,2003,996,1007
050,39,057,"Ohio","Greene County",1,51,1976,955,1021
050,39,057,"Ohio","Greene County",1,52,1937,938,999
050,39,057,"Ohio","Greene County",1,53,2071,1009,1062
050,39,057,"Ohio","Greene County",1,54,2072,1007,1065
050,39,057,"Ohio","Greene County",1,55,2221,1119,1102
050,39,057,"Ohio","Greene County",1,56,2286,1126,1160
050,39,057,"Ohio","Greene County",1,57,2279,1126,1153
050,39,057,"Ohio","Greene County",1,58,2385,1206,1179
050,39,057,"Ohio","Greene County",1,59,2397,1206,1191
050,39,057,"Ohio","Greene County",1,60,2279,1135,1144
050,39,057,"Ohio","Greene County",1,61,2308,1141,1167
050,39,057,"Ohio","Greene County",1,62,2320,1111,1209
050,39,057,"Ohio","Greene County",1,63,2258,1092,1166
050,39,057,"Ohio","Greene County",1,64,2227,1089,1138
050,39,057,"Ohio","Greene County",1,65,2092,1006,1086
050,39,057,"Ohio","Greene County",1,66,1999,962,1037
050,39,057,"Ohio","Greene County",1,67,1964,976,988
050,39,057,"Ohio","Greene County",1,68,1888,927,961
050,39,057,"Ohio","Greene County",1,69,1735,814,921
050,39,057,"Ohio","Greene County",1,70,1756,826,930
050,39,057,"Ohio","Greene County",1,71,1708,832,876
050,39,057,"Ohio","Greene County",1,72,1698,817,881
050,39,057,"Ohio","Greene County",1,73,1692,826,866
050,39,057,"Ohio","Greene County",1,74,1160,541,619
050,39,057,"Ohio","Greene County",1,75,1094,509,585
050,39,057,"Ohio","Greene County",1,76,1080,511,569
050,39,057,"Ohio","Greene County",1,77,1100,512,588
050,39,057,"Ohio","Greene County",1,78,946,431,515
050,39,057,"Ohio","Greene County",1,79,836,377,459
050,39,057,"Ohio","Greene County",1,80,761,317,444
050,39,057,"Ohio","Greene County",1,81,759,328,431
050,39,057,"Ohio","Greene County",1,82,664,280,384
050,39,057,"Ohio","Greene County",1,83,603,244,359
050,39,057,"Ohio","Greene County",1,84,607,265,342
050,39,057,"Ohio","Greene County",1,85,3410,1216,2194
050,39,057,"Ohio","Greene County",2,0,1697,878,819
050,39,057,"Ohio","Greene County",2,1,1760,909,851
050,39,057,"Ohio","Greene County",2,2,1830,922,908
050,39,057,"Ohio","Greene County",2,3,1895,961,934
050,39,057,"Ohio","Greene County",2,4,2031,1038,993
050,39,057,"Ohio","Greene County",2,5,2019,1036,983
050,39,057,"Ohio","Greene County",2,6,2011,1048,963
050,39,057,"Ohio","Greene County",2,7,1979,1017,962
050,39,057,"Ohio","Greene County",2,8,1953,1004,949
050,39,057,"Ohio","Greene County",2,9,1905,999,906
050,39,057,"Ohio","Greene County",2,10,1939,1033,906
050,39,057,"Ohio","Greene County",2,11,1975,1038,937
050,39,057,"Ohio","Greene County",2,12,2012,1055,957
050,39,057,"Ohio","Greene County",2,13,1986,1034,952
050,39,057,"Ohio","Greene County",2,14,1949,1008,941
050,39,057,"Ohio","Greene County",2,15,2011,1032,979
050,39,057,"Ohio","Greene County",2,16,2037,1019,1018
050,39,057,"Ohio","Greene County",2,17,2051,1031,1020
050,39,057,"Ohio","Greene County",2,18,2697,1313,1384
050,39,057,"Ohio","Greene County",2,19,3366,1589,1777
050,39,057,"Ohio","Greene County",2,20,3085,1515,1570
050,39,057,"Ohio","Greene County",2,21,2813,1432,1381
050,39,057,"Ohio","Greene County",2,22,2498,1262,1236
050,39,057,"Ohio","Greene County",2,23,2350,1204,1146
050,39,057,"Ohio","Greene County",2,24,2330,1186,1144
050,39,057,"Ohio","Greene County",2,25,2297,1230,1067
050,39,057,"Ohio","Greene County",2,26,2291,1219,1072
050,39,057,"Ohio","Greene County",2,27,2208,1119,1089
050,39,057,"Ohio","Greene County",2,28,2191,1101,1090
050,39,057,"Ohio","Greene County",2,29,2224,1162,1062
050,39,057,"Ohio","Greene County",2,30,2229,1137,1092
050,39,057,"Ohio","Greene County",2,31,2188,1096,1092
050,39,057,"Ohio","Greene County",2,32,2146,1085,1061
050,39,057,"Ohio","Greene County",2,33,2153,1103,1050
050,39,057,"Ohio","Greene County",2,34,2196,1133,1063
050,39,057,"Ohio","Greene County",2,35,2173,1119,1054
050,39,057,"Ohio","Greene County",2,36,2085,1050,1035
050,39,057,"Ohio","Greene County",2,37,2133,1080,1053
050,39,057,"Ohio","Greene County",2,38,2160,1094,1066
050,39,057,"Ohio","Greene County",2,39,2090,1068,1022
050,39,057,"Ohio","Greene County",2,40,2022,1039,983
050,39,057,"Ohio","Greene County",2,41,1969,990,979
050,39,057,"Ohio","Greene County",2,42,1844,933,911
050,39,057,"Ohio","Greene County",2,43,1785,888,897
050,39,057,"Ohio","Greene County",2,44,1706,856,850
050,39,057,"Ohio","Greene County",2,45,1755,894,861
050,39,057,"Ohio","Greene County",2,46,1721,867,854
050,39,057,"Ohio","Greene County",2,47,1775,868,907
050,39,057,"Ohio","Greene County",2,48,1884,917,967
050,39,057,"Ohio","Greene County",2,49,2033,994,1039
050,39,057,"Ohio","Greene County",2,50,2016,998,1018
050,39,057,"Ohio","Greene County",2,51,1968,957,1011
050,39,057,"Ohio","Greene County",2,52,1936,938,998
050,39,057,"Ohio","Greene County",2,53,2032,991,1041
050,39,057,"Ohio","Greene County",2,54,2071,1006,1065
050,39,057,"Ohio","Greene County",2,55,2185,1092,1093
050,39,057,"Ohio","Greene County",2,56,2268,1126,1142
050,39,057,"Ohio","Greene County",2,57,2285,1133,1152
050,39,057,"Ohio","Greene County",2,58,2355,1185,1170
050,39,057,"Ohio","Greene County",2,59,2400,1209,1191
050,39,057,"Ohio","Greene County",2,60,2298,1145,1153
050,39,057,"Ohio","Greene County",2,61,2292,1134,1158
050,39,057,"Ohio","Greene County",2,62,2304,1113,1191
050,39,057,"Ohio","Greene County",2,63,2284,1100,1184
050,39,057,"Ohio","Greene County",2,64,2206,1074,1132
050,39,057,"Ohio","Greene County",2,65,2119,1023,1096
050,39,057,"Ohio","Greene County",2,66,2017,968,1049
050,39,057,"Ohio","Greene County",2,67,1971,973,998
050,39,057,"Ohio","Greene County",2,68,1886,930,956
050,39,057,"Ohio","Greene County",2,69,1777,840,937
050,39,057,"Ohio","Greene County",2,70,1741,818,923
050,39,057,"Ohio","Greene County",2,71,1709,825,884
050,39,057,"Ohio","Greene County",2,72,1664,799,865
050,39,057,"Ohio","Greene County",2,73,1769,858,911
050,39,057,"Ohio","Greene County",2,74,1205,570,635
050,39,057,"Ohio","Greene County",2,75,1106,516,590
050,39,057,"Ohio","Greene County",2,76,1063,496,567
050,39,057,"Ohio","Greene County",2,77,1122,524,598
050,39,057,"Ohio","Greene County",2,78,955,438,517
050,39,057,"Ohio","Greene County",2,79,849,381,468
050,39,057,"Ohio","Greene County",2,80,769,327,442
050,39,057,"Ohio","Greene County",2,81,749,317,432
050,39,057,"Ohio","Greene County",2,82,673,281,392
050,39,057,"Ohio","Greene County",2,83,614,251,363
050,39,057,"Ohio","Greene County",2,84,600,257,343
050,39,057,"Ohio","Greene County",2,85,3436,1238,2198
050,39,057,"Ohio","Greene County",3,0,1621,860,761
050,39,057,"Ohio","Greene County",3,1,1750,935,815
050,39,057,"Ohio","Greene County",3,2,1795,933,862
050,39,057,"Ohio","Greene County",3,3,1837,925,912
050,39,057,"Ohio","Greene County",3,4,1911,989,922
050,39,057,"Ohio","Greene County",3,5,2060,1052,1008
050,39,057,"Ohio","Greene County",3,6,2012,1028,984
050,39,057,"Ohio","Greene County",3,7,2026,1054,972
050,39,057,"Ohio","Greene County",3,8,2002,1017,985
050,39,057,"Ohio","Greene County",3,9,1972,999,973
050,39,057,"Ohio","Greene County",3,10,1917,1008,909
050,39,057,"Ohio","Greene County",3,11,1982,1034,948
050,39,057,"Ohio","Greene County",3,12,1990,1049,941
050,39,057,"Ohio","Greene County",3,13,2029,1054,975
050,39,057,"Ohio","Greene County",3,14,1969,1050,919
050,39,057,"Ohio","Greene County",3,15,1972,1026,946
050,39,057,"Ohio","Greene County",3,16,2041,1042,999
050,39,057,"Ohio","Greene County",3,17,2078,1037,1041
050,39,057,"Ohio","Greene County",3,18,2683,1303,1380
050,39,057,"Ohio","Greene County",3,19,3209,1509,1700
050,39,057,"Ohio","Greene County",3,20,3002,1483,1519
050,39,057,"Ohio","Greene County",3,21,2696,1378,1318
050,39,057,"Ohio","Greene County",3,22,2493,1231,1262
050,39,057,"Ohio","Greene County",3,23,2395,1244,1151
050,39,057,"Ohio","Greene County",3,24,2327,1215,1112
050,39,057,"Ohio","Greene County",3,25,2242,1154,1088
050,39,057,"Ohio","Greene County",3,26,2300,1242,1058
050,39,057,"Ohio","Greene County",3,27,2233,1184,1049
050,39,057,"Ohio","Greene County",3,28,2191,1117,1074
050,39,057,"Ohio","Greene County",3,29,2191,1116,1075
050,39,057,"Ohio","Greene County",3,30,2225,1153,1072
050,39,057,"Ohio","Greene County",3,31,2247,1133,1114
050,39,057,"Ohio","Greene County",3,32,2180,1100,1080
050,39,057,"Ohio","Greene County",3,33,2165,1118,1047
050,39,057,"Ohio","Greene County",3,34,2136,1084,1052
050,39,057,"Ohio","Greene County",3,35,2216,1129,1087
050,39,057,"Ohio","Greene County",3,36,2146,1098,1048
050,39,057,"Ohio","Greene County",3,37,2076,1070,1006
050,39,057,"Ohio","Greene County",3,38,2130,1076,1054
050,39,057,"Ohio","Greene County",3,39,2204,1125,1079
050,39,057,"Ohio","Greene County",3,40,2139,1085,1054
050,39,057,"Ohio","Greene County",3,41,2058,1063,995
050,39,057,"Ohio","Greene County",3,42,1963,981,982
050,39,057,"Ohio","Greene County",3,43,1845,925,920
050,39,057,"Ohio","Greene County",3,44,1798,903,895
050,39,057,"Ohio","Greene County",3,45,1710,844,866
050,39,057,"Ohio","Greene County",3,46,1750,899,851
050,39,057,"Ohio","Greene County",3,47,1712,860,852
050,39,057,"Ohio","Greene County",3,48,1768,855,913
050,39,057,"Ohio","Greene County",3,49,1857,898,959
050,39,057,"Ohio","Greene County",3,50,2045,1001,1044
050,39,057,"Ohio","Greene County",3,51,2023,994,1029
050,39,057,"Ohio","Greene County",3,52,1957,947,1010
050,39,057,"Ohio","Greene County",3,53,1931,952,979
050,39,057,"Ohio","Greene County",3,54,2052,1006,1046
050,39,057,"Ohio","Greene County",3,55,2058,1008,1050
050,39,057,"Ohio","Greene County",3,56,2179,1086,1093
050,39,057,"Ohio","Greene County",3,57,2252,1119,1133
050,39,057,"Ohio","Greene County",3,58,2269,1125,1144
050,39,057,"Ohio","Greene County",3,59,2338,1179,1159
050,39,057,"Ohio","Greene County",3,60,2366,1176,1190
050,39,057,"Ohio","Greene County",3,61,2272,1132,1140
050,39,057,"Ohio","Greene County",3,62,2238,1099,1139
050,39,057,"Ohio","Greene County",3,63,2253,1093,1160
050,39,057,"Ohio","Greene County",3,64,2251,1076,1175
050,39,057,"Ohio","Greene County",3,65,2185,1052,1133
050,39,057,"Ohio","Greene County",3,66,2079,980,1099
050,39,057,"Ohio","Greene County",3,67,2008,952,1056
050,39,057,"Ohio","Greene County",3,68,1936,966,970
050,39,057,"Ohio","Greene County",3,69,1838,898,940
050,39,057,"Ohio","Greene County",3,70,1762,838,924
050,39,057,"Ohio","Greene County",3,71,1694,799,895
050,39,057,"Ohio","Greene County",3,72,1664,804,860
050,39,057,"Ohio","Greene County",3,73,1614,776,838
050,39,057,"Ohio","Greene County",3,74,1717,813,904
050,39,057,"Ohio","Greene County",3,75,1168,547,621
050,39,057,"Ohio","Greene County",3,76,1056,490,566
050,39,057,"Ohio","Greene County",3,77,1028,469,559
050,39,057,"Ohio","Greene County",3,78,1085,494,591
050,39,057,"Ohio","Greene County",3,79,889,402,487
050,39,057,"Ohio","Greene County",3,80,799,357,442
050,39,057,"Ohio","Greene County",3,81,725,290,435
050,39,057,"Ohio","Greene County",3,82,672,282,390
050,39,057,"Ohio","Greene County",3,83,641,266,375
050,39,057,"Ohio","Greene County",3,84,557,216,341
050,39,057,"Ohio","Greene County",3,85,3384,1229,2155
050,39,057,"Ohio","Greene County",4,0,1636,823,813
050,39,057,"Ohio","Greene County",4,1,1609,860,749
050,39,057,"Ohio","Greene County",4,2,1794,946,848
050,39,057,"Ohio","Greene County",4,3,1815,938,877
050,39,057,"Ohio","Greene County",4,4,1855,929,926
050,39,057,"Ohio","Greene County",4,5,1942,1014,928
050,39,057,"Ohio","Greene County",4,6,2105,1058,1047
050,39,057,"Ohio","Greene County",4,7,2037,1036,1001
050,39,057,"Ohio","Greene County",4,8,2021,1051,970
050,39,057,"Ohio","Greene County",4,9,2017,1006,1011
050,39,057,"Ohio","Greene County",4,10,2001,1021,980
050,39,057,"Ohio","Greene County",4,11,1926,1010,916
050,39,057,"Ohio","Greene County",4,12,2006,1058,948
050,39,057,"Ohio","Greene County",4,13,1993,1051,942
050,39,057,"Ohio","Greene County",4,14,2062,1083,979
050,39,057,"Ohio","Greene County",4,15,2009,1080,929
050,39,057,"Ohio","Greene County",4,16,1940,991,949
050,39,057,"Ohio","Greene County",4,17,2099,1064,1035
050,39,057,"Ohio","Greene County",4,18,2704,1303,1401
050,39,057,"Ohio","Greene County",4,19,3246,1533,1713
050,39,057,"Ohio","Greene County",4,20,2887,1424,1463
050,39,057,"Ohio","Greene County",4,21,2720,1392,1328
050,39,057,"Ohio","Greene County",4,22,2517,1240,1277
050,39,057,"Ohio","Greene County",4,23,2483,1238,1245
050,39,057,"Ohio","Greene County",4,24,2380,1265,1115
050,39,057,"Ohio","Greene County",4,25,2226,1154,1072
050,39,057,"Ohio","Greene County",4,26,2219,1150,1069
050,39,057,"Ohio","Greene County",4,27,2261,1194,1067
050,39,057,"Ohio","Greene County",4,28,2244,1184,1060
050,39,057,"Ohio","Greene County",4,29,2226,1164,1062
050,39,057,"Ohio","Greene County",4,30,2236,1127,1109
050,39,057,"Ohio","Greene County",4,31,2215,1137,1078
050,39,057,"Ohio","Greene County",4,32,2232,1123,1109
050,39,057,"Ohio","Greene County",4,33,2173,1093,1080
050,39,057,"Ohio","Greene County",4,34,2195,1133,1062
050,39,057,"Ohio","Greene County",4,35,2139,1075,1064
050,39,057,"Ohio","Greene County",4,36,2205,1118,1087
050,39,057,"Ohio","Greene County",4,37,2155,1104,1051
050,39,057,"Ohio","Greene County",4,38,2109,1086,1023
050,39,057,"Ohio","Greene County",4,39,2160,1090,1070
050,39,057,"Ohio","Greene County",4,40,2184,1108,1076
050,39,057,"Ohio","Greene County",4,41,2135,1076,1059
050,39,057,"Ohio","Greene County",4,42,2084,1085,999
050,39,057,"Ohio","Greene County",4,43,1968,1001,967
050,39,057,"Ohio","Greene County",4,44,1834,920,914
050,39,057,"Ohio","Greene County",4,45,1815,905,910
050,39,057,"Ohio","Greene County",4,46,1705,835,870
050,39,057,"Ohio","Greene County",4,47,1736,881,855
050,39,057,"Ohio","Greene County",4,48,1708,872,836
050,39,057,"Ohio","Greene County",4,49,1771,869,902
050,39,057,"Ohio","Greene County",4,50,1860,884,976
050,39,057,"Ohio","Greene County",4,51,2021,991,1030
050,39,057,"Ohio","Greene County",4,52,2030,1013,1017
050,39,057,"Ohio","Greene County",4,53,1957,961,996
050,39,057,"Ohio","Greene County",4,54,1923,932,991
050,39,057,"Ohio","Greene County",4,55,2042,1009,1033
050,39,057,"Ohio","Greene County",4,56,2059,996,1063
050,39,057,"Ohio","Greene County",4,57,2170,1072,1098
050,39,057,"Ohio","Greene County",4,58,2225,1093,1132
050,39,057,"Ohio","Greene County",4,59,2259,1137,1122
050,39,057,"Ohio","Greene County",4,60,2262,1124,1138
050,39,057,"Ohio","Greene County",4,61,2375,1179,1196
050,39,057,"Ohio","Greene County",4,62,2259,1124,1135
050,39,057,"Ohio","Greene County",4,63,2215,1073,1142
050,39,057,"Ohio","Greene County",4,64,2217,1080,1137
050,39,057,"Ohio","Greene County",4,65,2217,1060,1157
050,39,057,"Ohio","Greene County",4,66,2168,1033,1135
050,39,057,"Ohio","Greene County",4,67,2059,969,1090
050,39,057,"Ohio","Greene County",4,68,1985,939,1046
050,39,057,"Ohio","Greene County",4,69,1912,948,964
050,39,057,"Ohio","Greene County",4,70,1823,882,941
050,39,057,"Ohio","Greene County",4,71,1736,827,909
050,39,057,"Ohio","Greene County",4,72,1663,781,882
050,39,057,"Ohio","Greene County",4,73,1629,781,848
050,39,057,"Ohio","Greene County",4,74,1560,729,831
050,39,057,"Ohio","Greene County",4,75,1660,785,875
050,39,057,"Ohio","Greene County",4,76,1120,524,596
050,39,057,"Ohio","Greene County",4,77,1040,470,570
050,39,057,"Ohio","Greene County",4,78,978,436,542
050,39,057,"Ohio","Greene County",4,79,1023,456,567
050,39,057,"Ohio","Greene County",4,80,844,379,465
050,39,057,"Ohio","Greene County",4,81,764,324,440
050,39,057,"Ohio","Greene County",4,82,661,260,401
050,39,057,"Ohio","Greene County",4,83,631,258,373
050,39,057,"Ohio","Greene County",4,84,594,236,358
050,39,057,"Ohio","Greene County",4,85,3347,1196,2151
050,39,057,"Ohio","Greene County",5,0,1643,827,816
050,39,057,"Ohio","Greene County",5,1,1718,849,869
050,39,057,"Ohio","Greene County",5,2,1629,869,760
050,39,057,"Ohio","Greene County",5,3,1844,971,873
050,39,057,"Ohio","Greene County",5,4,1796,920,876
050,39,057,"Ohio","Greene County",5,5,1831,931,900
050,39,057,"Ohio","Greene County",5,6,1960,1023,937
050,39,057,"Ohio","Greene County",5,7,2094,1090,1004
050,39,057,"Ohio","Greene County",5,8,2020,1032,988
050,39,057,"Ohio","Greene County",5,9,1981,1030,951
050,39,057,"Ohio","Greene County",5,10,1987,1006,981
050,39,057,"Ohio","Greene County",5,11,2027,1035,992
050,39,057,"Ohio","Greene County",5,12,1951,1022,929
050,39,057,"Ohio","Greene County",5,13,2017,1068,949
050,39,057,"Ohio","Greene County",5,14,1996,1056,940
050,39,057,"Ohio","Greene County",5,15,2090,1080,1010
050,39,057,"Ohio","Greene County",5,16,2011,1073,938
050,39,057,"Ohio","Greene County",5,17,2025,1053,972
050,39,057,"Ohio","Greene County",5,18,2699,1322,1377
050,39,057,"Ohio","Greene County",5,19,3246,1513,1733
050,39,057,"Ohio","Greene County",5,20,2963,1473,1490
050,39,057,"Ohio","Greene County",5,21,2655,1331,1324
050,39,057,"Ohio","Greene County",5,22,2466,1240,1226
050,39,057,"Ohio","Greene County",5,23,2394,1190,1204
050,39,057,"Ohio","Greene County",5,24,2514,1276,1238
050,39,057,"Ohio","Greene County",5,25,2332,1229,1103
050,39,057,"Ohio","Greene County",5,26,2265,1195,1070
050,39,057,"Ohio","Greene County",5,27,2201,1129,1072
050,39,057,"Ohio","Greene County",5,28,2229,1173,1056
050,39,057,"Ohio","Greene County",5,29,2216,1148,1068
050,39,057,"Ohio","Greene County",5,30,2206,1162,1044
050,39,057,"Ohio","Greene County",5,31,2204,1133,1071
050,39,057,"Ohio","Greene County",5,32,2187,1127,1060
050,39,057,"Ohio","Greene County",5,33,2224,1114,1110
050,39,057,"Ohio","Greene County",5,34,2180,1100,1080
050,39,057,"Ohio","Greene County",5,35,2167,1134,1033
050,39,057,"Ohio","Greene County",5,36,2134,1071,1063
050,39,057,"Ohio","Greene County",5,37,2183,1099,1084
050,39,057,"Ohio","Greene County",5,38,2159,1099,1060
050,39,057,"Ohio","Greene County",5,39,2076,1059,1017
050,39,057,"Ohio","Greene County",5,40,2180,1102,1078
050,39,057,"Ohio","Greene County",5,41,2180,1100,1080
050,39,057,"Ohio","Greene County",5,42,2146,1097,1049
050,39,057,"Ohio","Greene County",5,43,2094,1079,1015
050,39,057,"Ohio","Greene County",5,44,1971,996,975
050,39,057,"Ohio","Greene County",5,45,1861,926,935
050,39,057,"Ohio","Greene County",5,46,1830,925,905
050,39,057,"Ohio","Greene County",5,47,1701,826,875
050,39,057,"Ohio","Greene County",5,48,1730,888,842
050,39,057,"Ohio","Greene County",5,49,1697,842,855
050,39,057,"Ohio","Greene County",5,50,1819,901,918
050,39,057,"Ohio","Greene County",5,51,1886,893,993
050,39,057,"Ohio","Greene County",5,52,2018,1009,1009
050,39,057,"Ohio","Greene County",5,53,2038,1025,1013
050,39,057,"Ohio","Greene County",5,54,1934,957,977
050,39,057,"Ohio","Greene County",5,55,1900,912,988
050,39,057,"Ohio","Greene County",5,56,2033,1004,1029
050,39,057,"Ohio","Greene County",5,57,2072,1000,1072
050,39,057,"Ohio","Greene County",5,58,2162,1080,1082
050,39,057,"Ohio","Greene County",5,59,2234,1094,1140
050,39,057,"Ohio","Greene County",5,60,2222,1111,1111
050,39,057,"Ohio","Greene County",5,61,2235,1113,1122
050,39,057,"Ohio","Greene County",5,62,2361,1170,1191
050,39,057,"Ohio","Greene County",5,63,2239,1107,1132
050,39,057,"Ohio","Greene County",5,64,2200,1062,1138
050,39,057,"Ohio","Greene County",5,65,2200,1079,1121
050,39,057,"Ohio","Greene County",5,66,2185,1029,1156
050,39,057,"Ohio","Greene County",5,67,2156,1024,1132
050,39,057,"Ohio","Greene County",5,68,2025,947,1078
050,39,057,"Ohio","Greene County",5,69,1951,923,1028
050,39,057,"Ohio","Greene County",5,70,1882,934,948
050,39,057,"Ohio","Greene County",5,71,1789,863,926
050,39,057,"Ohio","Greene County",5,72,1711,806,905
050,39,057,"Ohio","Greene County",5,73,1646,771,875
050,39,057,"Ohio","Greene County",5,74,1594,744,850
050,39,057,"Ohio","Greene County",5,75,1522,718,804
050,39,057,"Ohio","Greene County",5,76,1618,764,854
050,39,057,"Ohio","Greene County",5,77,1093,509,584
050,39,057,"Ohio","Greene County",5,78,1005,452,553
050,39,057,"Ohio","Greene County",5,79,928,406,522
050,39,057,"Ohio","Greene County",5,80,966,428,538
050,39,057,"Ohio","Greene County",5,81,815,352,463
050,39,057,"Ohio","Greene County",5,82,697,291,406
050,39,057,"Ohio","Greene County",5,83,627,242,385
050,39,057,"Ohio","Greene County",5,84,596,234,362
050,39,057,"Ohio","Greene County",5,85,3422,1221,2201
050,39,059,"Ohio","Guernsey County",1,0,429,222,207
050,39,059,"Ohio","Guernsey County",1,1,431,223,208
050,39,059,"Ohio","Guernsey County",1,2,415,214,201
050,39,059,"Ohio","Guernsey County",1,3,461,244,217
050,39,059,"Ohio","Guernsey County",1,4,476,237,239
050,39,059,"Ohio","Guernsey County",1,5,452,238,214
050,39,059,"Ohio","Guernsey County",1,6,454,234,220
050,39,059,"Ohio","Guernsey County",1,7,469,252,217
050,39,059,"Ohio","Guernsey County",1,8,484,262,222
050,39,059,"Ohio","Guernsey County",1,9,452,223,229
050,39,059,"Ohio","Guernsey County",1,10,476,243,233
050,39,059,"Ohio","Guernsey County",1,11,502,259,243
050,39,059,"Ohio","Guernsey County",1,12,501,255,246
050,39,059,"Ohio","Guernsey County",1,13,491,248,243
050,39,059,"Ohio","Guernsey County",1,14,510,259,251
050,39,059,"Ohio","Guernsey County",1,15,526,275,251
050,39,059,"Ohio","Guernsey County",1,16,525,276,249
050,39,059,"Ohio","Guernsey County",1,17,513,259,254
050,39,059,"Ohio","Guernsey County",1,18,427,234,193
050,39,059,"Ohio","Guernsey County",1,19,344,183,161
050,39,059,"Ohio","Guernsey County",1,20,382,196,186
050,39,059,"Ohio","Guernsey County",1,21,393,208,185
050,39,059,"Ohio","Guernsey County",1,22,426,211,215
050,39,059,"Ohio","Guernsey County",1,23,447,225,222
050,39,059,"Ohio","Guernsey County",1,24,463,239,224
050,39,059,"Ohio","Guernsey County",1,25,485,264,221
050,39,059,"Ohio","Guernsey County",1,26,467,248,219
050,39,059,"Ohio","Guernsey County",1,27,470,243,227
050,39,059,"Ohio","Guernsey County",1,28,471,239,232
050,39,059,"Ohio","Guernsey County",1,29,451,219,232
050,39,059,"Ohio","Guernsey County",1,30,488,237,251
050,39,059,"Ohio","Guernsey County",1,31,480,258,222
050,39,059,"Ohio","Guernsey County",1,32,435,233,202
050,39,059,"Ohio","Guernsey County",1,33,430,224,206
050,39,059,"Ohio","Guernsey County",1,34,430,224,206
050,39,059,"Ohio","Guernsey County",1,35,420,227,193
050,39,059,"Ohio","Guernsey County",1,36,428,224,204
050,39,059,"Ohio","Guernsey County",1,37,438,209,229
050,39,059,"Ohio","Guernsey County",1,38,456,223,233
050,39,059,"Ohio","Guernsey County",1,39,424,212,212
050,39,059,"Ohio","Guernsey County",1,40,445,238,207
050,39,059,"Ohio","Guernsey County",1,41,439,236,203
050,39,059,"Ohio","Guernsey County",1,42,418,213,205
050,39,059,"Ohio","Guernsey County",1,43,408,213,195
050,39,059,"Ohio","Guernsey County",1,44,405,208,197
050,39,059,"Ohio","Guernsey County",1,45,410,201,209
050,39,059,"Ohio","Guernsey County",1,46,402,191,211
050,39,059,"Ohio","Guernsey County",1,47,467,232,235
050,39,059,"Ohio","Guernsey County",1,48,519,272,247
050,39,059,"Ohio","Guernsey County",1,49,552,278,274
050,39,059,"Ohio","Guernsey County",1,50,501,246,255
050,39,059,"Ohio","Guernsey County",1,51,502,256,246
050,39,059,"Ohio","Guernsey County",1,52,491,251,240
050,39,059,"Ohio","Guernsey County",1,53,516,260,256
050,39,059,"Ohio","Guernsey County",1,54,513,261,252
050,39,059,"Ohio","Guernsey County",1,55,535,286,249
050,39,059,"Ohio","Guernsey County",1,56,564,295,269
050,39,059,"Ohio","Guernsey County",1,57,543,265,278
050,39,059,"Ohio","Guernsey County",1,58,594,289,305
050,39,059,"Ohio","Guernsey County",1,59,596,300,296
050,39,059,"Ohio","Guernsey County",1,60,566,286,280
050,39,059,"Ohio","Guernsey County",1,61,572,284,288
050,39,059,"Ohio","Guernsey County",1,62,584,284,300
050,39,059,"Ohio","Guernsey County",1,63,544,250,294
050,39,059,"Ohio","Guernsey County",1,64,553,270,283
050,39,059,"Ohio","Guernsey County",1,65,552,269,283
050,39,059,"Ohio","Guernsey County",1,66,519,248,271
050,39,059,"Ohio","Guernsey County",1,67,491,236,255
050,39,059,"Ohio","Guernsey County",1,68,489,230,259
050,39,059,"Ohio","Guernsey County",1,69,462,229,233
050,39,059,"Ohio","Guernsey County",1,70,466,242,224
050,39,059,"Ohio","Guernsey County",1,71,439,221,218
050,39,059,"Ohio","Guernsey County",1,72,427,213,214
050,39,059,"Ohio","Guernsey County",1,73,425,200,225
050,39,059,"Ohio","Guernsey County",1,74,302,157,145
050,39,059,"Ohio","Guernsey County",1,75,276,135,141
050,39,059,"Ohio","Guernsey County",1,76,284,125,159
050,39,059,"Ohio","Guernsey County",1,77,306,144,162
050,39,059,"Ohio","Guernsey County",1,78,257,115,142
050,39,059,"Ohio","Guernsey County",1,79,234,110,124
050,39,059,"Ohio","Guernsey County",1,80,200,94,106
050,39,059,"Ohio","Guernsey County",1,81,200,94,106
050,39,059,"Ohio","Guernsey County",1,82,183,76,107
050,39,059,"Ohio","Guernsey County",1,83,176,77,99
050,39,059,"Ohio","Guernsey County",1,84,136,55,81
050,39,059,"Ohio","Guernsey County",1,85,757,286,471
050,39,059,"Ohio","Guernsey County",2,0,430,218,212
050,39,059,"Ohio","Guernsey County",2,1,421,217,204
050,39,059,"Ohio","Guernsey County",2,2,415,213,202
050,39,059,"Ohio","Guernsey County",2,3,450,235,215
050,39,059,"Ohio","Guernsey County",2,4,473,239,234
050,39,059,"Ohio","Guernsey County",2,5,458,238,220
050,39,059,"Ohio","Guernsey County",2,6,456,236,220
050,39,059,"Ohio","Guernsey County",2,7,467,250,217
050,39,059,"Ohio","Guernsey County",2,8,477,257,220
050,39,059,"Ohio","Guernsey County",2,9,463,236,227
050,39,059,"Ohio","Guernsey County",2,10,469,238,231
050,39,059,"Ohio","Guernsey County",2,11,494,254,240
050,39,059,"Ohio","Guernsey County",2,12,505,258,247
050,39,059,"Ohio","Guernsey County",2,13,491,247,244
050,39,059,"Ohio","Guernsey County",2,14,507,257,250
050,39,059,"Ohio","Guernsey County",2,15,523,270,253
050,39,059,"Ohio","Guernsey County",2,16,527,278,249
050,39,059,"Ohio","Guernsey County",2,17,517,263,254
050,39,059,"Ohio","Guernsey County",2,18,429,233,196
050,39,059,"Ohio","Guernsey County",2,19,348,185,163
050,39,059,"Ohio","Guernsey County",2,20,384,197,187
050,39,059,"Ohio","Guernsey County",2,21,397,208,189
050,39,059,"Ohio","Guernsey County",2,22,428,214,214
050,39,059,"Ohio","Guernsey County",2,23,443,222,221
050,39,059,"Ohio","Guernsey County",2,24,459,234,225
050,39,059,"Ohio","Guernsey County",2,25,482,259,223
050,39,059,"Ohio","Guernsey County",2,26,472,253,219
050,39,059,"Ohio","Guernsey County",2,27,468,244,224
050,39,059,"Ohio","Guernsey County",2,28,469,240,229
050,39,059,"Ohio","Guernsey County",2,29,454,224,230
050,39,059,"Ohio","Guernsey County",2,30,485,235,250
050,39,059,"Ohio","Guernsey County",2,31,481,253,228
050,39,059,"Ohio","Guernsey County",2,32,444,237,207
050,39,059,"Ohio","Guernsey County",2,33,431,227,204
050,39,059,"Ohio","Guernsey County",2,34,429,223,206
050,39,059,"Ohio","Guernsey County",2,35,430,231,199
050,39,059,"Ohio","Guernsey County",2,36,423,220,203
050,39,059,"Ohio","Guernsey County",2,37,439,214,225
050,39,059,"Ohio","Guernsey County",2,38,454,221,233
050,39,059,"Ohio","Guernsey County",2,39,431,215,216
050,39,059,"Ohio","Guernsey County",2,40,443,233,210
050,39,059,"Ohio","Guernsey County",2,41,438,234,204
050,39,059,"Ohio","Guernsey County",2,42,419,214,205
050,39,059,"Ohio","Guernsey County",2,43,413,215,198
050,39,059,"Ohio","Guernsey County",2,44,399,207,192
050,39,059,"Ohio","Guernsey County",2,45,411,203,208
050,39,059,"Ohio","Guernsey County",2,46,405,195,210
050,39,059,"Ohio","Guernsey County",2,47,446,219,227
050,39,059,"Ohio","Guernsey County",2,48,507,263,244
050,39,059,"Ohio","Guernsey County",2,49,547,277,270
050,39,059,"Ohio","Guernsey County",2,50,515,255,260
050,39,059,"Ohio","Guernsey County",2,51,499,253,246
050,39,059,"Ohio","Guernsey County",2,52,492,250,242
050,39,059,"Ohio","Guernsey County",2,53,510,258,252
050,39,059,"Ohio","Guernsey County",2,54,512,260,252
050,39,059,"Ohio","Guernsey County",2,55,531,281,250
050,39,059,"Ohio","Guernsey County",2,56,556,292,264
050,39,059,"Ohio","Guernsey County",2,57,551,273,278
050,39,059,"Ohio","Guernsey County",2,58,579,282,297
050,39,059,"Ohio","Guernsey County",2,59,594,295,299
050,39,059,"Ohio","Guernsey County",2,60,569,287,282
050,39,059,"Ohio","Guernsey County",2,61,572,286,286
050,39,059,"Ohio","Guernsey County",2,62,580,285,295
050,39,059,"Ohio","Guernsey County",2,63,559,261,298
050,39,059,"Ohio","Guernsey County",2,64,548,263,285
050,39,059,"Ohio","Guernsey County",2,65,547,266,281
050,39,059,"Ohio","Guernsey County",2,66,527,253,274
050,39,059,"Ohio","Guernsey County",2,67,496,239,257
050,39,059,"Ohio","Guernsey County",2,68,481,227,254
050,39,059,"Ohio","Guernsey County",2,69,470,230,240
050,39,059,"Ohio","Guernsey County",2,70,458,237,221
050,39,059,"Ohio","Guernsey County",2,71,447,228,219
050,39,059,"Ohio","Guernsey County",2,72,414,210,204
050,39,059,"Ohio","Guernsey County",2,73,446,214,232
050,39,059,"Ohio","Guernsey County",2,74,304,151,153
050,39,059,"Ohio","Guernsey County",2,75,276,137,139
050,39,059,"Ohio","Guernsey County",2,76,277,125,152
050,39,059,"Ohio","Guernsey County",2,77,303,139,164
050,39,059,"Ohio","Guernsey County",2,78,263,119,144
050,39,059,"Ohio","Guernsey County",2,79,237,111,126
050,39,059,"Ohio","Guernsey County",2,80,204,98,106
050,39,059,"Ohio","Guernsey County",2,81,193,93,100
050,39,059,"Ohio","Guernsey County",2,82,185,79,106
050,39,059,"Ohio","Guernsey County",2,83,174,74,100
050,39,059,"Ohio","Guernsey County",2,84,142,59,83
050,39,059,"Ohio","Guernsey County",2,85,761,285,476
050,39,059,"Ohio","Guernsey County",3,0,419,213,206
050,39,059,"Ohio","Guernsey County",3,1,428,210,218
050,39,059,"Ohio","Guernsey County",3,2,421,214,207
050,39,059,"Ohio","Guernsey County",3,3,430,216,214
050,39,059,"Ohio","Guernsey County",3,4,441,224,217
050,39,059,"Ohio","Guernsey County",3,5,461,237,224
050,39,059,"Ohio","Guernsey County",3,6,474,244,230
050,39,059,"Ohio","Guernsey County",3,7,450,229,221
050,39,059,"Ohio","Guernsey County",3,8,474,250,224
050,39,059,"Ohio","Guernsey County",3,9,478,256,222
050,39,059,"Ohio","Guernsey County",3,10,459,233,226
050,39,059,"Ohio","Guernsey County",3,11,474,239,235
050,39,059,"Ohio","Guernsey County",3,12,498,253,245
050,39,059,"Ohio","Guernsey County",3,13,502,248,254
050,39,059,"Ohio","Guernsey County",3,14,498,251,247
050,39,059,"Ohio","Guernsey County",3,15,507,257,250
050,39,059,"Ohio","Guernsey County",3,16,526,272,254
050,39,059,"Ohio","Guernsey County",3,17,533,277,256
050,39,059,"Ohio","Guernsey County",3,18,422,226,196
050,39,059,"Ohio","Guernsey County",3,19,333,176,157
050,39,059,"Ohio","Guernsey County",3,20,371,200,171
050,39,059,"Ohio","Guernsey County",3,21,394,205,189
050,39,059,"Ohio","Guernsey County",3,22,418,221,197
050,39,059,"Ohio","Guernsey County",3,23,430,215,215
050,39,059,"Ohio","Guernsey County",3,24,447,232,215
050,39,059,"Ohio","Guernsey County",3,25,474,240,234
050,39,059,"Ohio","Guernsey County",3,26,491,265,226
050,39,059,"Ohio","Guernsey County",3,27,476,247,229
050,39,059,"Ohio","Guernsey County",3,28,470,237,233
050,39,059,"Ohio","Guernsey County",3,29,469,240,229
050,39,059,"Ohio","Guernsey County",3,30,490,238,252
050,39,059,"Ohio","Guernsey County",3,31,477,239,238
050,39,059,"Ohio","Guernsey County",3,32,487,254,233
050,39,059,"Ohio","Guernsey County",3,33,451,250,201
050,39,059,"Ohio","Guernsey County",3,34,432,221,211
050,39,059,"Ohio","Guernsey County",3,35,430,223,207
050,39,059,"Ohio","Guernsey County",3,36,419,214,205
050,39,059,"Ohio","Guernsey County",3,37,426,224,202
050,39,059,"Ohio","Guernsey County",3,38,437,214,223
050,39,059,"Ohio","Guernsey County",3,39,463,231,232
050,39,059,"Ohio","Guernsey County",3,40,434,206,228
050,39,059,"Ohio","Guernsey County",3,41,455,236,219
050,39,059,"Ohio","Guernsey County",3,42,440,234,206
050,39,059,"Ohio","Guernsey County",3,43,411,215,196
050,39,059,"Ohio","Guernsey County",3,44,407,220,187
050,39,059,"Ohio","Guernsey County",3,45,395,202,193
050,39,059,"Ohio","Guernsey County",3,46,403,203,200
050,39,059,"Ohio","Guernsey County",3,47,394,186,208
050,39,059,"Ohio","Guernsey County",3,48,447,221,226
050,39,059,"Ohio","Guernsey County",3,49,511,260,251
050,39,059,"Ohio","Guernsey County",3,50,554,283,271
050,39,059,"Ohio","Guernsey County",3,51,514,259,255
050,39,059,"Ohio","Guernsey County",3,52,509,258,251
050,39,059,"Ohio","Guernsey County",3,53,493,253,240
050,39,059,"Ohio","Guernsey County",3,54,508,257,251
050,39,059,"Ohio","Guernsey County",3,55,506,262,244
050,39,059,"Ohio","Guernsey County",3,56,516,272,244
050,39,059,"Ohio","Guernsey County",3,57,560,294,266
050,39,059,"Ohio","Guernsey County",3,58,545,270,275
050,39,059,"Ohio","Guernsey County",3,59,578,274,304
050,39,059,"Ohio","Guernsey County",3,60,574,284,290
050,39,059,"Ohio","Guernsey County",3,61,555,277,278
050,39,059,"Ohio","Guernsey County",3,62,564,276,288
050,39,059,"Ohio","Guernsey County",3,63,570,276,294
050,39,059,"Ohio","Guernsey County",3,64,558,257,301
050,39,059,"Ohio","Guernsey County",3,65,542,256,286
050,39,059,"Ohio","Guernsey County",3,66,536,261,275
050,39,059,"Ohio","Guernsey County",3,67,518,249,269
050,39,059,"Ohio","Guernsey County",3,68,478,228,250
050,39,059,"Ohio","Guernsey County",3,69,475,220,255
050,39,059,"Ohio","Guernsey County",3,70,456,221,235
050,39,059,"Ohio","Guernsey County",3,71,453,236,217
050,39,059,"Ohio","Guernsey County",3,72,437,222,215
050,39,059,"Ohio","Guernsey County",3,73,399,203,196
050,39,059,"Ohio","Guernsey County",3,74,427,201,226
050,39,059,"Ohio","Guernsey County",3,75,295,145,150
050,39,059,"Ohio","Guernsey County",3,76,262,126,136
050,39,059,"Ohio","Guernsey County",3,77,252,114,138
050,39,059,"Ohio","Guernsey County",3,78,284,128,156
050,39,059,"Ohio","Guernsey County",3,79,254,111,143
050,39,059,"Ohio","Guernsey County",3,80,213,103,110
050,39,059,"Ohio","Guernsey County",3,81,189,90,99
050,39,059,"Ohio","Guernsey County",3,82,167,78,89
050,39,059,"Ohio","Guernsey County",3,83,175,73,102
050,39,059,"Ohio","Guernsey County",3,84,153,70,83
050,39,059,"Ohio","Guernsey County",3,85,741,265,476
050,39,059,"Ohio","Guernsey County",4,0,407,205,202
050,39,059,"Ohio","Guernsey County",4,1,444,220,224
050,39,059,"Ohio","Guernsey County",4,2,417,207,210
050,39,059,"Ohio","Guernsey County",4,3,431,221,210
050,39,059,"Ohio","Guernsey County",4,4,438,225,213
050,39,059,"Ohio","Guernsey County",4,5,451,226,225
050,39,059,"Ohio","Guernsey County",4,6,475,238,237
050,39,059,"Ohio","Guernsey County",4,7,467,237,230
050,39,059,"Ohio","Guernsey County",4,8,455,229,226
050,39,059,"Ohio","Guernsey County",4,9,482,255,227
050,39,059,"Ohio","Guernsey County",4,10,469,258,211
050,39,059,"Ohio","Guernsey County",4,11,458,237,221
050,39,059,"Ohio","Guernsey County",4,12,468,233,235
050,39,059,"Ohio","Guernsey County",4,13,501,259,242
050,39,059,"Ohio","Guernsey County",4,14,503,255,248
050,39,059,"Ohio","Guernsey County",4,15,499,250,249
050,39,059,"Ohio","Guernsey County",4,16,508,254,254
050,39,059,"Ohio","Guernsey County",4,17,531,269,262
050,39,059,"Ohio","Guernsey County",4,18,434,237,197
050,39,059,"Ohio","Guernsey County",4,19,322,169,153
050,39,059,"Ohio","Guernsey County",4,20,356,183,173
050,39,059,"Ohio","Guernsey County",4,21,390,212,178
050,39,059,"Ohio","Guernsey County",4,22,404,194,210
050,39,059,"Ohio","Guernsey County",4,23,433,227,206
050,39,059,"Ohio","Guernsey County",4,24,453,226,227
050,39,059,"Ohio","Guernsey County",4,25,467,250,217
050,39,059,"Ohio","Guernsey County",4,26,479,235,244
050,39,059,"Ohio","Guernsey County",4,27,494,271,223
050,39,059,"Ohio","Guernsey County",4,28,460,234,226
050,39,059,"Ohio","Guernsey County",4,29,474,236,238
050,39,059,"Ohio","Guernsey County",4,30,461,237,224
050,39,059,"Ohio","Guernsey County",4,31,475,224,251
050,39,059,"Ohio","Guernsey County",4,32,483,237,246
050,39,059,"Ohio","Guernsey County",4,33,518,268,250
050,39,059,"Ohio","Guernsey County",4,34,454,242,212
050,39,059,"Ohio","Guernsey County",4,35,451,238,213
050,39,059,"Ohio","Guernsey County",4,36,421,216,205
050,39,059,"Ohio","Guernsey County",4,37,409,206,203
050,39,059,"Ohio","Guernsey County",4,38,424,221,203
050,39,059,"Ohio","Guernsey County",4,39,442,215,227
050,39,059,"Ohio","Guernsey County",4,40,462,230,232
050,39,059,"Ohio","Guernsey County",4,41,443,211,232
050,39,059,"Ohio","Guernsey County",4,42,442,229,213
050,39,059,"Ohio","Guernsey County",4,43,433,234,199
050,39,059,"Ohio","Guernsey County",4,44,404,213,191
050,39,059,"Ohio","Guernsey County",4,45,399,212,187
050,39,059,"Ohio","Guernsey County",4,46,404,207,197
050,39,059,"Ohio","Guernsey County",4,47,394,196,198
050,39,059,"Ohio","Guernsey County",4,48,392,187,205
050,39,059,"Ohio","Guernsey County",4,49,443,214,229
050,39,059,"Ohio","Guernsey County",4,50,505,258,247
050,39,059,"Ohio","Guernsey County",4,51,556,278,278
050,39,059,"Ohio","Guernsey County",4,52,514,259,255
050,39,059,"Ohio","Guernsey County",4,53,509,262,247
050,39,059,"Ohio","Guernsey County",4,54,482,248,234
050,39,059,"Ohio","Guernsey County",4,55,500,253,247
050,39,059,"Ohio","Guernsey County",4,56,499,250,249
050,39,059,"Ohio","Guernsey County",4,57,518,272,246
050,39,059,"Ohio","Guernsey County",4,58,551,294,257
050,39,059,"Ohio","Guernsey County",4,59,532,253,279
050,39,059,"Ohio","Guernsey County",4,60,565,272,293
050,39,059,"Ohio","Guernsey County",4,61,572,280,292
050,39,059,"Ohio","Guernsey County",4,62,551,266,285
050,39,059,"Ohio","Guernsey County",4,63,556,271,285
050,39,059,"Ohio","Guernsey County",4,64,567,276,291
050,39,059,"Ohio","Guernsey County",4,65,541,247,294
050,39,059,"Ohio","Guernsey County",4,66,537,250,287
050,39,059,"Ohio","Guernsey County",4,67,522,255,267
050,39,059,"Ohio","Guernsey County",4,68,501,243,258
050,39,059,"Ohio","Guernsey County",4,69,477,225,252
050,39,059,"Ohio","Guernsey County",4,70,459,210,249
050,39,059,"Ohio","Guernsey County",4,71,451,220,231
050,39,059,"Ohio","Guernsey County",4,72,434,224,210
050,39,059,"Ohio","Guernsey County",4,73,412,210,202
050,39,059,"Ohio","Guernsey County",4,74,384,198,186
050,39,059,"Ohio","Guernsey County",4,75,409,194,215
050,39,059,"Ohio","Guernsey County",4,76,277,128,149
050,39,059,"Ohio","Guernsey County",4,77,234,111,123
050,39,059,"Ohio","Guernsey County",4,78,228,99,129
050,39,059,"Ohio","Guernsey County",4,79,277,122,155
050,39,059,"Ohio","Guernsey County",4,80,231,107,124
050,39,059,"Ohio","Guernsey County",4,81,194,95,99
050,39,059,"Ohio","Guernsey County",4,82,169,81,88
050,39,059,"Ohio","Guernsey County",4,83,155,73,82
050,39,059,"Ohio","Guernsey County",4,84,152,64,88
050,39,059,"Ohio","Guernsey County",4,85,715,252,463
050,39,059,"Ohio","Guernsey County",5,0,404,201,203
050,39,059,"Ohio","Guernsey County",5,1,412,211,201
050,39,059,"Ohio","Guernsey County",5,2,457,229,228
050,39,059,"Ohio","Guernsey County",5,3,431,208,223
050,39,059,"Ohio","Guernsey County",5,4,431,214,217
050,39,059,"Ohio","Guernsey County",5,5,433,215,218
050,39,059,"Ohio","Guernsey County",5,6,453,230,223
050,39,059,"Ohio","Guernsey County",5,7,487,231,256
050,39,059,"Ohio","Guernsey County",5,8,481,242,239
050,39,059,"Ohio","Guernsey County",5,9,465,234,231
050,39,059,"Ohio","Guernsey County",5,10,496,259,237
050,39,059,"Ohio","Guernsey County",5,11,494,276,218
050,39,059,"Ohio","Guernsey County",5,12,469,238,231
050,39,059,"Ohio","Guernsey County",5,13,477,245,232
050,39,059,"Ohio","Guernsey County",5,14,511,259,252
050,39,059,"Ohio","Guernsey County",5,15,503,251,252
050,39,059,"Ohio","Guernsey County",5,16,503,247,256
050,39,059,"Ohio","Guernsey County",5,17,514,257,257
050,39,059,"Ohio","Guernsey County",5,18,440,230,210
050,39,059,"Ohio","Guernsey County",5,19,327,179,148
050,39,059,"Ohio","Guernsey County",5,20,363,191,172
050,39,059,"Ohio","Guernsey County",5,21,382,200,182
050,39,059,"Ohio","Guernsey County",5,22,422,226,196
050,39,059,"Ohio","Guernsey County",5,23,424,208,216
050,39,059,"Ohio","Guernsey County",5,24,442,228,214
050,39,059,"Ohio","Guernsey County",5,25,465,234,231
050,39,059,"Ohio","Guernsey County",5,26,472,250,222
050,39,059,"Ohio","Guernsey County",5,27,473,235,238
050,39,059,"Ohio","Guernsey County",5,28,500,274,226
050,39,059,"Ohio","Guernsey County",5,29,459,239,220
050,39,059,"Ohio","Guernsey County",5,30,486,245,241
050,39,059,"Ohio","Guernsey County",5,31,460,240,220
050,39,059,"Ohio","Guernsey County",5,32,485,231,254
050,39,059,"Ohio","Guernsey County",5,33,492,244,248
050,39,059,"Ohio","Guernsey County",5,34,513,261,252
050,39,059,"Ohio","Guernsey County",5,35,464,251,213
050,39,059,"Ohio","Guernsey County",5,36,453,235,218
050,39,059,"Ohio","Guernsey County",5,37,426,217,209
050,39,059,"Ohio","Guernsey County",5,38,417,212,205
050,39,059,"Ohio","Guernsey County",5,39,431,225,206
050,39,059,"Ohio","Guernsey County",5,40,442,215,227
050,39,059,"Ohio","Guernsey County",5,41,460,230,230
050,39,059,"Ohio","Guernsey County",5,42,432,203,229
050,39,059,"Ohio","Guernsey County",5,43,441,230,211
050,39,059,"Ohio","Guernsey County",5,44,426,233,193
050,39,059,"Ohio","Guernsey County",5,45,409,214,195
050,39,059,"Ohio","Guernsey County",5,46,398,213,185
050,39,059,"Ohio","Guernsey County",5,47,399,202,197
050,39,059,"Ohio","Guernsey County",5,48,399,205,194
050,39,059,"Ohio","Guernsey County",5,49,404,187,217
050,39,059,"Ohio","Guernsey County",5,50,446,216,230
050,39,059,"Ohio","Guernsey County",5,51,511,253,258
050,39,059,"Ohio","Guernsey County",5,52,567,281,286
050,39,059,"Ohio","Guernsey County",5,53,511,263,248
050,39,059,"Ohio","Guernsey County",5,54,497,256,241
050,39,059,"Ohio","Guernsey County",5,55,477,246,231
050,39,059,"Ohio","Guernsey County",5,56,499,250,249
050,39,059,"Ohio","Guernsey County",5,57,502,249,253
050,39,059,"Ohio","Guernsey County",5,58,517,273,244
050,39,059,"Ohio","Guernsey County",5,59,548,285,263
050,39,059,"Ohio","Guernsey County",5,60,524,252,272
050,39,059,"Ohio","Guernsey County",5,61,559,268,291
050,39,059,"Ohio","Guernsey County",5,62,563,275,288
050,39,059,"Ohio","Guernsey County",5,63,545,266,279
050,39,059,"Ohio","Guernsey County",5,64,562,279,283
050,39,059,"Ohio","Guernsey County",5,65,568,275,293
050,39,059,"Ohio","Guernsey County",5,66,537,244,293
050,39,059,"Ohio","Guernsey County",5,67,517,239,278
050,39,059,"Ohio","Guernsey County",5,68,501,246,255
050,39,059,"Ohio","Guernsey County",5,69,494,240,254
050,39,059,"Ohio","Guernsey County",5,70,461,216,245
050,39,059,"Ohio","Guernsey County",5,71,453,206,247
050,39,059,"Ohio","Guernsey County",5,72,433,208,225
050,39,059,"Ohio","Guernsey County",5,73,408,211,197
050,39,059,"Ohio","Guernsey County",5,74,393,200,193
050,39,059,"Ohio","Guernsey County",5,75,360,184,176
050,39,059,"Ohio","Guernsey County",5,76,392,176,216
050,39,059,"Ohio","Guernsey County",5,77,257,120,137
050,39,059,"Ohio","Guernsey County",5,78,217,99,118
050,39,059,"Ohio","Guernsey County",5,79,222,97,125
050,39,059,"Ohio","Guernsey County",5,80,250,116,134
050,39,059,"Ohio","Guernsey County",5,81,206,95,111
050,39,059,"Ohio","Guernsey County",5,82,175,87,88
050,39,059,"Ohio","Guernsey County",5,83,153,73,80
050,39,059,"Ohio","Guernsey County",5,84,129,64,65
050,39,059,"Ohio","Guernsey County",5,85,708,240,468
050,39,061,"Ohio","Hamilton County",1,0,10716,5463,5253
050,39,061,"Ohio","Hamilton County",1,1,10655,5398,5257
050,39,061,"Ohio","Hamilton County",1,2,10689,5428,5261
050,39,061,"Ohio","Hamilton County",1,3,10684,5443,5241
050,39,061,"Ohio","Hamilton County",1,4,10829,5541,5288
050,39,061,"Ohio","Hamilton County",1,5,10823,5557,5266
050,39,061,"Ohio","Hamilton County",1,6,10769,5482,5287
050,39,061,"Ohio","Hamilton County",1,7,10736,5449,5287
050,39,061,"Ohio","Hamilton County",1,8,10685,5481,5204
050,39,061,"Ohio","Hamilton County",1,9,10609,5537,5072
050,39,061,"Ohio","Hamilton County",1,10,10658,5420,5238
050,39,061,"Ohio","Hamilton County",1,11,10925,5504,5421
050,39,061,"Ohio","Hamilton County",1,12,11272,5708,5564
050,39,061,"Ohio","Hamilton County",1,13,11217,5680,5537
050,39,061,"Ohio","Hamilton County",1,14,10758,5450,5308
050,39,061,"Ohio","Hamilton County",1,15,10482,5268,5214
050,39,061,"Ohio","Hamilton County",1,16,10688,5388,5300
050,39,061,"Ohio","Hamilton County",1,17,10447,5382,5065
050,39,061,"Ohio","Hamilton County",1,18,10858,5458,5400
050,39,061,"Ohio","Hamilton County",1,19,11964,6285,5679
050,39,061,"Ohio","Hamilton County",1,20,10106,5206,4900
050,39,061,"Ohio","Hamilton County",1,21,9774,4989,4785
050,39,061,"Ohio","Hamilton County",1,22,10142,5025,5117
050,39,061,"Ohio","Hamilton County",1,23,10850,5359,5491
050,39,061,"Ohio","Hamilton County",1,24,11608,5726,5882
050,39,061,"Ohio","Hamilton County",1,25,11998,5894,6104
050,39,061,"Ohio","Hamilton County",1,26,12322,6166,6156
050,39,061,"Ohio","Hamilton County",1,27,12651,6314,6337
050,39,061,"Ohio","Hamilton County",1,28,12841,6351,6490
050,39,061,"Ohio","Hamilton County",1,29,13070,6395,6675
050,39,061,"Ohio","Hamilton County",1,30,13278,6534,6744
050,39,061,"Ohio","Hamilton County",1,31,12968,6377,6591
050,39,061,"Ohio","Hamilton County",1,32,12339,6058,6281
050,39,061,"Ohio","Hamilton County",1,33,11959,5878,6081
050,39,061,"Ohio","Hamilton County",1,34,11855,5816,6039
050,39,061,"Ohio","Hamilton County",1,35,11474,5587,5887
050,39,061,"Ohio","Hamilton County",1,36,11116,5387,5729
050,39,061,"Ohio","Hamilton County",1,37,11060,5380,5680
050,39,061,"Ohio","Hamilton County",1,38,10766,5238,5528
050,39,061,"Ohio","Hamilton County",1,39,10552,5170,5382
050,39,061,"Ohio","Hamilton County",1,40,10386,5110,5276
050,39,061,"Ohio","Hamilton County",1,41,9963,4933,5030
050,39,061,"Ohio","Hamilton County",1,42,9450,4592,4858
050,39,061,"Ohio","Hamilton County",1,43,8952,4355,4597
050,39,061,"Ohio","Hamilton County",1,44,8735,4304,4431
050,39,061,"Ohio","Hamilton County",1,45,8896,4324,4572
050,39,061,"Ohio","Hamilton County",1,46,8549,4148,4401
050,39,061,"Ohio","Hamilton County",1,47,8713,4273,4440
050,39,061,"Ohio","Hamilton County",1,48,9459,4643,4816
050,39,061,"Ohio","Hamilton County",1,49,10137,4931,5206
050,39,061,"Ohio","Hamilton County",1,50,10056,4921,5135
050,39,061,"Ohio","Hamilton County",1,51,9680,4723,4957
050,39,061,"Ohio","Hamilton County",1,52,9491,4610,4881
050,39,061,"Ohio","Hamilton County",1,53,9582,4577,5005
050,39,061,"Ohio","Hamilton County",1,54,10023,4845,5178
050,39,061,"Ohio","Hamilton County",1,55,10781,5218,5563
050,39,061,"Ohio","Hamilton County",1,56,10930,5378,5552
050,39,061,"Ohio","Hamilton County",1,57,10851,5217,5634
050,39,061,"Ohio","Hamilton County",1,58,11089,5383,5706
050,39,061,"Ohio","Hamilton County",1,59,11068,5326,5742
050,39,061,"Ohio","Hamilton County",1,60,11071,5365,5706
050,39,061,"Ohio","Hamilton County",1,61,10984,5250,5734
050,39,061,"Ohio","Hamilton County",1,62,11077,5286,5791
050,39,061,"Ohio","Hamilton County",1,63,10726,5099,5627
050,39,061,"Ohio","Hamilton County",1,64,10344,4865,5479
050,39,061,"Ohio","Hamilton County",1,65,10034,4747,5287
050,39,061,"Ohio","Hamilton County",1,66,9473,4447,5026
050,39,061,"Ohio","Hamilton County",1,67,8948,4138,4810
050,39,061,"Ohio","Hamilton County",1,68,8610,3999,4611
050,39,061,"Ohio","Hamilton County",1,69,7913,3686,4227
050,39,061,"Ohio","Hamilton County",1,70,7494,3474,4020
050,39,061,"Ohio","Hamilton County",1,71,7218,3304,3914
050,39,061,"Ohio","Hamilton County",1,72,7124,3231,3893
050,39,061,"Ohio","Hamilton County",1,73,6917,3148,3769
050,39,061,"Ohio","Hamilton County",1,74,4650,2056,2594
050,39,061,"Ohio","Hamilton County",1,75,4503,2004,2499
050,39,061,"Ohio","Hamilton County",1,76,4563,1991,2572
050,39,061,"Ohio","Hamilton County",1,77,4685,2005,2680
050,39,061,"Ohio","Hamilton County",1,78,4107,1764,2343
050,39,061,"Ohio","Hamilton County",1,79,3554,1453,2101
050,39,061,"Ohio","Hamilton County",1,80,3249,1320,1929
050,39,061,"Ohio","Hamilton County",1,81,3168,1299,1869
050,39,061,"Ohio","Hamilton County",1,82,3060,1215,1845
050,39,061,"Ohio","Hamilton County",1,83,2679,1037,1642
050,39,061,"Ohio","Hamilton County",1,84,2461,931,1530
050,39,061,"Ohio","Hamilton County",1,85,16032,5278,10754
050,39,061,"Ohio","Hamilton County",2,0,10593,5367,5226
050,39,061,"Ohio","Hamilton County",2,1,10638,5400,5238
050,39,061,"Ohio","Hamilton County",2,2,10682,5420,5262
050,39,061,"Ohio","Hamilton County",2,3,10653,5423,5230
050,39,061,"Ohio","Hamilton County",2,4,10787,5507,5280
050,39,061,"Ohio","Hamilton County",2,5,10814,5541,5273
050,39,061,"Ohio","Hamilton County",2,6,10787,5499,5288
050,39,061,"Ohio","Hamilton County",2,7,10717,5447,5270
050,39,061,"Ohio","Hamilton County",2,8,10650,5450,5200
050,39,061,"Ohio","Hamilton County",2,9,10596,5508,5088
050,39,061,"Ohio","Hamilton County",2,10,10619,5434,5185
050,39,061,"Ohio","Hamilton County",2,11,10792,5450,5342
050,39,061,"Ohio","Hamilton County",2,12,11223,5674,5549
050,39,061,"Ohio","Hamilton County",2,13,11207,5685,5522
050,39,061,"Ohio","Hamilton County",2,14,10854,5501,5353
050,39,061,"Ohio","Hamilton County",2,15,10543,5308,5235
050,39,061,"Ohio","Hamilton County",2,16,10645,5363,5282
050,39,061,"Ohio","Hamilton County",2,17,10512,5382,5130
050,39,061,"Ohio","Hamilton County",2,18,10835,5469,5366
050,39,061,"Ohio","Hamilton County",2,19,11950,6263,5687
050,39,061,"Ohio","Hamilton County",2,20,10225,5251,4974
050,39,061,"Ohio","Hamilton County",2,21,9813,4995,4818
050,39,061,"Ohio","Hamilton County",2,22,10186,5060,5126
050,39,061,"Ohio","Hamilton County",2,23,10853,5363,5490
050,39,061,"Ohio","Hamilton County",2,24,11506,5671,5835
050,39,061,"Ohio","Hamilton County",2,25,11952,5884,6068
050,39,061,"Ohio","Hamilton County",2,26,12298,6131,6167
050,39,061,"Ohio","Hamilton County",2,27,12570,6285,6285
050,39,061,"Ohio","Hamilton County",2,28,12782,6350,6432
050,39,061,"Ohio","Hamilton County",2,29,13001,6374,6627
050,39,061,"Ohio","Hamilton County",2,30,13239,6491,6748
050,39,061,"Ohio","Hamilton County",2,31,12954,6374,6580
050,39,061,"Ohio","Hamilton County",2,32,12418,6106,6312
050,39,061,"Ohio","Hamilton County",2,33,12019,5905,6114
050,39,061,"Ohio","Hamilton County",2,34,11845,5816,6029
050,39,061,"Ohio","Hamilton County",2,35,11623,5675,5948
050,39,061,"Ohio","Hamilton County",2,36,11097,5379,5718
050,39,061,"Ohio","Hamilton County",2,37,11057,5369,5688
050,39,061,"Ohio","Hamilton County",2,38,10845,5273,5572
050,39,061,"Ohio","Hamilton County",2,39,10545,5158,5387
050,39,061,"Ohio","Hamilton County",2,40,10476,5154,5322
050,39,061,"Ohio","Hamilton County",2,41,10036,4957,5079
050,39,061,"Ohio","Hamilton County",2,42,9503,4637,4866
050,39,061,"Ohio","Hamilton County",2,43,9122,4433,4689
050,39,061,"Ohio","Hamilton County",2,44,8688,4264,4424
050,39,061,"Ohio","Hamilton County",2,45,8879,4334,4545
050,39,061,"Ohio","Hamilton County",2,46,8591,4174,4417
050,39,061,"Ohio","Hamilton County",2,47,8627,4216,4411
050,39,061,"Ohio","Hamilton County",2,48,9271,4545,4726
050,39,061,"Ohio","Hamilton County",2,49,9989,4866,5123
050,39,061,"Ohio","Hamilton County",2,50,10072,4932,5140
050,39,061,"Ohio","Hamilton County",2,51,9690,4728,4962
050,39,061,"Ohio","Hamilton County",2,52,9503,4609,4894
050,39,061,"Ohio","Hamilton County",2,53,9550,4582,4968
050,39,061,"Ohio","Hamilton County",2,54,9878,4768,5110
050,39,061,"Ohio","Hamilton County",2,55,10551,5103,5448
050,39,061,"Ohio","Hamilton County",2,56,10896,5335,5561
050,39,061,"Ohio","Hamilton County",2,57,10838,5243,5595
050,39,061,"Ohio","Hamilton County",2,58,10980,5315,5665
050,39,061,"Ohio","Hamilton County",2,59,11067,5329,5738
050,39,061,"Ohio","Hamilton County",2,60,11011,5334,5677
050,39,061,"Ohio","Hamilton County",2,61,10925,5237,5688
050,39,061,"Ohio","Hamilton County",2,62,10967,5237,5730
050,39,061,"Ohio","Hamilton County",2,63,10856,5162,5694
050,39,061,"Ohio","Hamilton County",2,64,10319,4853,5466
050,39,061,"Ohio","Hamilton County",2,65,10036,4743,5293
050,39,061,"Ohio","Hamilton County",2,66,9574,4492,5082
050,39,061,"Ohio","Hamilton County",2,67,9000,4176,4824
050,39,061,"Ohio","Hamilton County",2,68,8582,3969,4613
050,39,061,"Ohio","Hamilton County",2,69,8082,3758,4324
050,39,061,"Ohio","Hamilton County",2,70,7529,3490,4039
050,39,061,"Ohio","Hamilton County",2,71,7250,3328,3922
050,39,061,"Ohio","Hamilton County",2,72,7004,3175,3829
050,39,061,"Ohio","Hamilton County",2,73,7220,3288,3932
050,39,061,"Ohio","Hamilton County",2,74,4889,2169,2720
050,39,061,"Ohio","Hamilton County",2,75,4509,2006,2503
050,39,061,"Ohio","Hamilton County",2,76,4468,1941,2527
050,39,061,"Ohio","Hamilton County",2,77,4697,2016,2681
050,39,061,"Ohio","Hamilton County",2,78,4139,1779,2360
050,39,061,"Ohio","Hamilton County",2,79,3637,1499,2138
050,39,061,"Ohio","Hamilton County",2,80,3281,1331,1950
050,39,061,"Ohio","Hamilton County",2,81,3136,1277,1859
050,39,061,"Ohio","Hamilton County",2,82,3038,1209,1829
050,39,061,"Ohio","Hamilton County",2,83,2717,1047,1670
050,39,061,"Ohio","Hamilton County",2,84,2456,936,1520
050,39,061,"Ohio","Hamilton County",2,85,15923,5228,10695
050,39,061,"Ohio","Hamilton County",3,0,10173,5200,4973
050,39,061,"Ohio","Hamilton County",3,1,10378,5280,5098
050,39,061,"Ohio","Hamilton County",3,2,10495,5333,5162
050,39,061,"Ohio","Hamilton County",3,3,10530,5331,5199
050,39,061,"Ohio","Hamilton County",3,4,10564,5399,5165
050,39,061,"Ohio","Hamilton County",3,5,10667,5419,5248
050,39,061,"Ohio","Hamilton County",3,6,10690,5474,5216
050,39,061,"Ohio","Hamilton County",3,7,10700,5454,5246
050,39,061,"Ohio","Hamilton County",3,8,10662,5395,5267
050,39,061,"Ohio","Hamilton County",3,9,10604,5410,5194
050,39,061,"Ohio","Hamilton County",3,10,10515,5502,5013
050,39,061,"Ohio","Hamilton County",3,11,10530,5386,5144
050,39,061,"Ohio","Hamilton County",3,12,10751,5427,5324
050,39,061,"Ohio","Hamilton County",3,13,11148,5635,5513
050,39,061,"Ohio","Hamilton County",3,14,11172,5666,5506
050,39,061,"Ohio","Hamilton County",3,15,10791,5447,5344
050,39,061,"Ohio","Hamilton County",3,16,10490,5311,5179
050,39,061,"Ohio","Hamilton County",3,17,10629,5369,5260
050,39,061,"Ohio","Hamilton County",3,18,10995,5602,5393
050,39,061,"Ohio","Hamilton County",3,19,11668,6123,5545
050,39,061,"Ohio","Hamilton County",3,20,10131,5150,4981
050,39,061,"Ohio","Hamilton County",3,21,9962,5051,4911
050,39,061,"Ohio","Hamilton County",3,22,10167,5089,5078
050,39,061,"Ohio","Hamilton County",3,23,10971,5373,5598
050,39,061,"Ohio","Hamilton County",3,24,11468,5672,5796
050,39,061,"Ohio","Hamilton County",3,25,11800,5764,6036
050,39,061,"Ohio","Hamilton County",3,26,12148,6059,6089
050,39,061,"Ohio","Hamilton County",3,27,12437,6244,6193
050,39,061,"Ohio","Hamilton County",3,28,12438,6203,6235
050,39,061,"Ohio","Hamilton County",3,29,12657,6230,6427
050,39,061,"Ohio","Hamilton County",3,30,12892,6295,6597
050,39,061,"Ohio","Hamilton County",3,31,12934,6361,6573
050,39,061,"Ohio","Hamilton County",3,32,12793,6338,6455
050,39,061,"Ohio","Hamilton County",3,33,12218,5980,6238
050,39,061,"Ohio","Hamilton County",3,34,11794,5785,6009
050,39,061,"Ohio","Hamilton County",3,35,11731,5762,5969
050,39,061,"Ohio","Hamilton County",3,36,11431,5597,5834
050,39,061,"Ohio","Hamilton County",3,37,10897,5296,5601
050,39,061,"Ohio","Hamilton County",3,38,10892,5302,5590
050,39,061,"Ohio","Hamilton County",3,39,10704,5187,5517
050,39,061,"Ohio","Hamilton County",3,40,10383,5067,5316
050,39,061,"Ohio","Hamilton County",3,41,10359,5081,5278
050,39,061,"Ohio","Hamilton County",3,42,9916,4893,5023
050,39,061,"Ohio","Hamilton County",3,43,9416,4587,4829
050,39,061,"Ohio","Hamilton County",3,44,9050,4361,4689
050,39,061,"Ohio","Hamilton County",3,45,8614,4235,4379
050,39,061,"Ohio","Hamilton County",3,46,8813,4301,4512
050,39,061,"Ohio","Hamilton County",3,47,8500,4110,4390
050,39,061,"Ohio","Hamilton County",3,48,8514,4176,4338
050,39,061,"Ohio","Hamilton County",3,49,9100,4437,4663
050,39,061,"Ohio","Hamilton County",3,50,9923,4849,5074
050,39,061,"Ohio","Hamilton County",3,51,9916,4835,5081
050,39,061,"Ohio","Hamilton County",3,52,9542,4668,4874
050,39,061,"Ohio","Hamilton County",3,53,9421,4584,4837
050,39,061,"Ohio","Hamilton County",3,54,9461,4543,4918
050,39,061,"Ohio","Hamilton County",3,55,9710,4668,5042
050,39,061,"Ohio","Hamilton County",3,56,10448,5056,5392
050,39,061,"Ohio","Hamilton County",3,57,10734,5246,5488
050,39,061,"Ohio","Hamilton County",3,58,10693,5187,5506
050,39,061,"Ohio","Hamilton County",3,59,10812,5205,5607
050,39,061,"Ohio","Hamilton County",3,60,10857,5235,5622
050,39,061,"Ohio","Hamilton County",3,61,10738,5176,5562
050,39,061,"Ohio","Hamilton County",3,62,10676,5076,5600
050,39,061,"Ohio","Hamilton County",3,63,10726,5126,5600
050,39,061,"Ohio","Hamilton County",3,64,10550,4980,5570
050,39,061,"Ohio","Hamilton County",3,65,10019,4707,5312
050,39,061,"Ohio","Hamilton County",3,66,9797,4586,5211
050,39,061,"Ohio","Hamilton County",3,67,9335,4375,4960
050,39,061,"Ohio","Hamilton County",3,68,8711,4023,4688
050,39,061,"Ohio","Hamilton County",3,69,8376,3859,4517
050,39,061,"Ohio","Hamilton County",3,70,7807,3572,4235
050,39,061,"Ohio","Hamilton County",3,71,7315,3386,3929
050,39,061,"Ohio","Hamilton County",3,72,7024,3168,3856
050,39,061,"Ohio","Hamilton County",3,73,6737,3035,3702
050,39,061,"Ohio","Hamilton County",3,74,7015,3169,3846
050,39,061,"Ohio","Hamilton County",3,75,4663,2063,2600
050,39,061,"Ohio","Hamilton County",3,76,4317,1891,2426
050,39,061,"Ohio","Hamilton County",3,77,4297,1863,2434
050,39,061,"Ohio","Hamilton County",3,78,4465,1898,2567
050,39,061,"Ohio","Hamilton County",3,79,3914,1625,2289
050,39,061,"Ohio","Hamilton County",3,80,3439,1391,2048
050,39,061,"Ohio","Hamilton County",3,81,3125,1250,1875
050,39,061,"Ohio","Hamilton County",3,82,2892,1161,1731
050,39,061,"Ohio","Hamilton County",3,83,2822,1092,1730
050,39,061,"Ohio","Hamilton County",3,84,2469,968,1501
050,39,061,"Ohio","Hamilton County",3,85,15402,5038,10364
050,39,061,"Ohio","Hamilton County",4,0,10222,5175,5047
050,39,061,"Ohio","Hamilton County",4,1,9942,5102,4840
050,39,061,"Ohio","Hamilton County",4,2,10279,5218,5061
050,39,061,"Ohio","Hamilton County",4,3,10270,5227,5043
050,39,061,"Ohio","Hamilton County",4,4,10426,5295,5131
050,39,061,"Ohio","Hamilton County",4,5,10363,5273,5090
050,39,061,"Ohio","Hamilton County",4,6,10568,5366,5202
050,39,061,"Ohio","Hamilton County",4,7,10546,5397,5149
050,39,061,"Ohio","Hamilton County",4,8,10651,5433,5218
050,39,061,"Ohio","Hamilton County",4,9,10612,5417,5195
050,39,061,"Ohio","Hamilton County",4,10,10454,5310,5144
050,39,061,"Ohio","Hamilton County",4,11,10421,5444,4977
050,39,061,"Ohio","Hamilton County",4,12,10421,5346,5075
050,39,061,"Ohio","Hamilton County",4,13,10676,5368,5308
050,39,061,"Ohio","Hamilton County",4,14,11071,5615,5456
050,39,061,"Ohio","Hamilton County",4,15,11108,5636,5472
050,39,061,"Ohio","Hamilton County",4,16,10746,5422,5324
050,39,061,"Ohio","Hamilton County",4,17,10455,5295,5160
050,39,061,"Ohio","Hamilton County",4,18,11281,5658,5623
050,39,061,"Ohio","Hamilton County",4,19,12387,6580,5807
050,39,061,"Ohio","Hamilton County",4,20,10040,5153,4887
050,39,061,"Ohio","Hamilton County",4,21,9940,4954,4986
050,39,061,"Ohio","Hamilton County",4,22,10398,5200,5198
050,39,061,"Ohio","Hamilton County",4,23,10886,5453,5433
050,39,061,"Ohio","Hamilton County",4,24,11454,5664,5790
050,39,061,"Ohio","Hamilton County",4,25,11740,5848,5892
050,39,061,"Ohio","Hamilton County",4,26,11991,5918,6073
050,39,061,"Ohio","Hamilton County",4,27,12151,6079,6072
050,39,061,"Ohio","Hamilton County",4,28,12270,6167,6103
050,39,061,"Ohio","Hamilton County",4,29,12330,6149,6181
050,39,061,"Ohio","Hamilton County",4,30,12409,6068,6341
050,39,061,"Ohio","Hamilton County",4,31,12622,6172,6450
050,39,061,"Ohio","Hamilton County",4,32,12816,6330,6486
050,39,061,"Ohio","Hamilton County",4,33,12533,6130,6403
050,39,061,"Ohio","Hamilton County",4,34,12008,5872,6136
050,39,061,"Ohio","Hamilton County",4,35,11642,5676,5966
050,39,061,"Ohio","Hamilton County",4,36,11508,5682,5826
050,39,061,"Ohio","Hamilton County",4,37,11262,5494,5768
050,39,061,"Ohio","Hamilton County",4,38,10697,5191,5506
050,39,061,"Ohio","Hamilton County",4,39,10725,5204,5521
050,39,061,"Ohio","Hamilton County",4,40,10571,5138,5433
050,39,061,"Ohio","Hamilton County",4,41,10276,5002,5274
050,39,061,"Ohio","Hamilton County",4,42,10273,5022,5251
050,39,061,"Ohio","Hamilton County",4,43,9819,4816,5003
050,39,061,"Ohio","Hamilton County",4,44,9350,4537,4813
050,39,061,"Ohio","Hamilton County",4,45,8967,4322,4645
050,39,061,"Ohio","Hamilton County",4,46,8571,4222,4349
050,39,061,"Ohio","Hamilton County",4,47,8708,4247,4461
050,39,061,"Ohio","Hamilton County",4,48,8408,4086,4322
050,39,061,"Ohio","Hamilton County",4,49,8375,4077,4298
050,39,061,"Ohio","Hamilton County",4,50,9054,4439,4615
050,39,061,"Ohio","Hamilton County",4,51,9736,4749,4987
050,39,061,"Ohio","Hamilton County",4,52,9762,4740,5022
050,39,061,"Ohio","Hamilton County",4,53,9396,4593,4803
050,39,061,"Ohio","Hamilton County",4,54,9278,4501,4777
050,39,061,"Ohio","Hamilton County",4,55,9313,4461,4852
050,39,061,"Ohio","Hamilton County",4,56,9553,4583,4970
050,39,061,"Ohio","Hamilton County",4,57,10233,4924,5309
050,39,061,"Ohio","Hamilton County",4,58,10582,5166,5416
050,39,061,"Ohio","Hamilton County",4,59,10503,5095,5408
050,39,061,"Ohio","Hamilton County",4,60,10587,5129,5458
050,39,061,"Ohio","Hamilton County",4,61,10629,5085,5544
050,39,061,"Ohio","Hamilton County",4,62,10479,5028,5451
050,39,061,"Ohio","Hamilton County",4,63,10471,4971,5500
050,39,061,"Ohio","Hamilton County",4,64,10418,4953,5465
050,39,061,"Ohio","Hamilton County",4,65,10245,4850,5395
050,39,061,"Ohio","Hamilton County",4,66,9757,4536,5221
050,39,061,"Ohio","Hamilton County",4,67,9533,4460,5073
050,39,061,"Ohio","Hamilton County",4,68,9055,4217,4838
050,39,061,"Ohio","Hamilton County",4,69,8446,3867,4579
050,39,061,"Ohio","Hamilton County",4,70,8123,3723,4400
050,39,061,"Ohio","Hamilton County",4,71,7598,3466,4132
050,39,061,"Ohio","Hamilton County",4,72,7054,3217,3837
050,39,061,"Ohio","Hamilton County",4,73,6705,2997,3708
050,39,061,"Ohio","Hamilton County",4,74,6543,2927,3616
050,39,061,"Ohio","Hamilton County",4,75,6761,3046,3715
050,39,061,"Ohio","Hamilton County",4,76,4467,1934,2533
050,39,061,"Ohio","Hamilton County",4,77,4150,1801,2349
050,39,061,"Ohio","Hamilton County",4,78,4062,1748,2314
050,39,061,"Ohio","Hamilton County",4,79,4255,1747,2508
050,39,061,"Ohio","Hamilton County",4,80,3722,1532,2190
050,39,061,"Ohio","Hamilton County",4,81,3301,1313,1988
050,39,061,"Ohio","Hamilton County",4,82,2895,1137,1758
050,39,061,"Ohio","Hamilton County",4,83,2687,1057,1630
050,39,061,"Ohio","Hamilton County",4,84,2609,1011,1598
050,39,061,"Ohio","Hamilton County",4,85,15120,5000,10120
050,39,061,"Ohio","Hamilton County",5,0,10230,5192,5038
050,39,061,"Ohio","Hamilton County",5,1,10228,5184,5044
050,39,061,"Ohio","Hamilton County",5,2,9911,5122,4789
050,39,061,"Ohio","Hamilton County",5,3,10157,5176,4981
050,39,061,"Ohio","Hamilton County",5,4,10284,5213,5071
050,39,061,"Ohio","Hamilton County",5,5,10400,5270,5130
050,39,061,"Ohio","Hamilton County",5,6,10350,5264,5086
050,39,061,"Ohio","Hamilton County",5,7,10539,5357,5182
050,39,061,"Ohio","Hamilton County",5,8,10626,5439,5187
050,39,061,"Ohio","Hamilton County",5,9,10605,5430,5175
050,39,061,"Ohio","Hamilton County",5,10,10609,5390,5219
050,39,061,"Ohio","Hamilton County",5,11,10421,5257,5164
050,39,061,"Ohio","Hamilton County",5,12,10353,5407,4946
050,39,061,"Ohio","Hamilton County",5,13,10410,5327,5083
050,39,061,"Ohio","Hamilton County",5,14,10742,5421,5321
050,39,061,"Ohio","Hamilton County",5,15,11048,5605,5443
050,39,061,"Ohio","Hamilton County",5,16,11127,5642,5485
050,39,061,"Ohio","Hamilton County",5,17,10728,5424,5304
050,39,061,"Ohio","Hamilton County",5,18,11383,5698,5685
050,39,061,"Ohio","Hamilton County",5,19,12967,6805,6162
050,39,061,"Ohio","Hamilton County",5,20,10290,5313,4977
050,39,061,"Ohio","Hamilton County",5,21,9733,4913,4820
050,39,061,"Ohio","Hamilton County",5,22,10366,5070,5296
050,39,061,"Ohio","Hamilton County",5,23,11310,5637,5673
050,39,061,"Ohio","Hamilton County",5,24,11475,5819,5656
050,39,061,"Ohio","Hamilton County",5,25,11677,5751,5926
050,39,061,"Ohio","Hamilton County",5,26,11852,5913,5939
050,39,061,"Ohio","Hamilton County",5,27,12043,5984,6059
050,39,061,"Ohio","Hamilton County",5,28,12186,6128,6058
050,39,061,"Ohio","Hamilton County",5,29,12133,6075,6058
050,39,061,"Ohio","Hamilton County",5,30,12374,6163,6211
050,39,061,"Ohio","Hamilton County",5,31,12402,6080,6322
050,39,061,"Ohio","Hamilton County",5,32,12645,6234,6411
050,39,061,"Ohio","Hamilton County",5,33,12627,6180,6447
050,39,061,"Ohio","Hamilton County",5,34,12429,6112,6317
050,39,061,"Ohio","Hamilton County",5,35,11887,5742,6145
050,39,061,"Ohio","Hamilton County",5,36,11535,5624,5911
050,39,061,"Ohio","Hamilton County",5,37,11374,5638,5736
050,39,061,"Ohio","Hamilton County",5,38,11139,5456,5683
050,39,061,"Ohio","Hamilton County",5,39,10619,5160,5459
050,39,061,"Ohio","Hamilton County",5,40,10612,5157,5455
050,39,061,"Ohio","Hamilton County",5,41,10486,5064,5422
050,39,061,"Ohio","Hamilton County",5,42,10300,5014,5286
050,39,061,"Ohio","Hamilton County",5,43,10230,5007,5223
050,39,061,"Ohio","Hamilton County",5,44,9761,4788,4973
050,39,061,"Ohio","Hamilton County",5,45,9247,4502,4745
050,39,061,"Ohio","Hamilton County",5,46,8932,4313,4619
050,39,061,"Ohio","Hamilton County",5,47,8515,4193,4322
050,39,061,"Ohio","Hamilton County",5,48,8632,4212,4420
050,39,061,"Ohio","Hamilton County",5,49,8301,4006,4295
050,39,061,"Ohio","Hamilton County",5,50,8367,4104,4263
050,39,061,"Ohio","Hamilton County",5,51,8941,4354,4587
050,39,061,"Ohio","Hamilton County",5,52,9637,4684,4953
050,39,061,"Ohio","Hamilton County",5,53,9663,4703,4960
050,39,061,"Ohio","Hamilton County",5,54,9215,4507,4708
050,39,061,"Ohio","Hamilton County",5,55,9162,4431,4731
050,39,061,"Ohio","Hamilton County",5,56,9187,4405,4782
050,39,061,"Ohio","Hamilton County",5,57,9342,4485,4857
050,39,061,"Ohio","Hamilton County",5,58,10118,4870,5248
050,39,061,"Ohio","Hamilton County",5,59,10416,5065,5351
050,39,061,"Ohio","Hamilton County",5,60,10334,5008,5326
050,39,061,"Ohio","Hamilton County",5,61,10419,4995,5424
050,39,061,"Ohio","Hamilton County",5,62,10485,4995,5490
050,39,061,"Ohio","Hamilton County",5,63,10303,4962,5341
050,39,061,"Ohio","Hamilton County",5,64,10242,4847,5395
050,39,061,"Ohio","Hamilton County",5,65,10177,4832,5345
050,39,061,"Ohio","Hamilton County",5,66,10015,4725,5290
050,39,061,"Ohio","Hamilton County",5,67,9562,4441,5121
050,39,061,"Ohio","Hamilton County",5,68,9318,4328,4990
050,39,061,"Ohio","Hamilton County",5,69,8862,4110,4752
050,39,061,"Ohio","Hamilton County",5,70,8231,3727,4504
050,39,061,"Ohio","Hamilton County",5,71,7935,3631,4304
050,39,061,"Ohio","Hamilton County",5,72,7380,3333,4047
050,39,061,"Ohio","Hamilton County",5,73,6823,3110,3713
050,39,061,"Ohio","Hamilton County",5,74,6544,2911,3633
050,39,061,"Ohio","Hamilton County",5,75,6337,2840,3497
050,39,061,"Ohio","Hamilton County",5,76,6529,2906,3623
050,39,061,"Ohio","Hamilton County",5,77,4354,1866,2488
050,39,061,"Ohio","Hamilton County",5,78,3940,1718,2222
050,39,061,"Ohio","Hamilton County",5,79,3877,1623,2254
050,39,061,"Ohio","Hamilton County",5,80,4050,1648,2402
050,39,061,"Ohio","Hamilton County",5,81,3565,1448,2117
050,39,061,"Ohio","Hamilton County",5,82,3081,1204,1877
050,39,061,"Ohio","Hamilton County",5,83,2709,1039,1670
050,39,061,"Ohio","Hamilton County",5,84,2491,989,1502
050,39,061,"Ohio","Hamilton County",5,85,15217,5071,10146
050,39,063,"Ohio","Hancock County",1,0,831,421,410
050,39,063,"Ohio","Hancock County",1,1,842,409,433
050,39,063,"Ohio","Hancock County",1,2,863,444,419
050,39,063,"Ohio","Hancock County",1,3,906,476,430
050,39,063,"Ohio","Hancock County",1,4,865,451,414
050,39,063,"Ohio","Hancock County",1,5,920,463,457
050,39,063,"Ohio","Hancock County",1,6,923,453,470
050,39,063,"Ohio","Hancock County",1,7,922,472,450
050,39,063,"Ohio","Hancock County",1,8,884,453,431
050,39,063,"Ohio","Hancock County",1,9,898,441,457
050,39,063,"Ohio","Hancock County",1,10,907,458,449
050,39,063,"Ohio","Hancock County",1,11,963,484,479
050,39,063,"Ohio","Hancock County",1,12,964,521,443
050,39,063,"Ohio","Hancock County",1,13,991,521,470
050,39,063,"Ohio","Hancock County",1,14,968,494,474
050,39,063,"Ohio","Hancock County",1,15,919,461,458
050,39,063,"Ohio","Hancock County",1,16,996,505,491
050,39,063,"Ohio","Hancock County",1,17,1004,528,476
050,39,063,"Ohio","Hancock County",1,18,1020,503,517
050,39,063,"Ohio","Hancock County",1,19,1175,540,635
050,39,063,"Ohio","Hancock County",1,20,980,462,518
050,39,063,"Ohio","Hancock County",1,21,896,428,468
050,39,063,"Ohio","Hancock County",1,22,885,456,429
050,39,063,"Ohio","Hancock County",1,23,951,497,454
050,39,063,"Ohio","Hancock County",1,24,920,471,449
050,39,063,"Ohio","Hancock County",1,25,916,475,441
050,39,063,"Ohio","Hancock County",1,26,952,499,453
050,39,063,"Ohio","Hancock County",1,27,1013,534,479
050,39,063,"Ohio","Hancock County",1,28,1044,542,502
050,39,063,"Ohio","Hancock County",1,29,1024,539,485
050,39,063,"Ohio","Hancock County",1,30,1046,498,548
050,39,063,"Ohio","Hancock County",1,31,1031,526,505
050,39,063,"Ohio","Hancock County",1,32,956,497,459
050,39,063,"Ohio","Hancock County",1,33,942,485,457
050,39,063,"Ohio","Hancock County",1,34,992,514,478
050,39,063,"Ohio","Hancock County",1,35,971,513,458
050,39,063,"Ohio","Hancock County",1,36,935,505,430
050,39,063,"Ohio","Hancock County",1,37,910,479,431
050,39,063,"Ohio","Hancock County",1,38,899,464,435
050,39,063,"Ohio","Hancock County",1,39,894,457,437
050,39,063,"Ohio","Hancock County",1,40,908,454,454
050,39,063,"Ohio","Hancock County",1,41,895,458,437
050,39,063,"Ohio","Hancock County",1,42,822,408,414
050,39,063,"Ohio","Hancock County",1,43,824,411,413
050,39,063,"Ohio","Hancock County",1,44,835,418,417
050,39,063,"Ohio","Hancock County",1,45,848,407,441
050,39,063,"Ohio","Hancock County",1,46,865,433,432
050,39,063,"Ohio","Hancock County",1,47,856,438,418
050,39,063,"Ohio","Hancock County",1,48,926,463,463
050,39,063,"Ohio","Hancock County",1,49,1005,532,473
050,39,063,"Ohio","Hancock County",1,50,940,481,459
050,39,063,"Ohio","Hancock County",1,51,943,482,461
050,39,063,"Ohio","Hancock County",1,52,895,466,429
050,39,063,"Ohio","Hancock County",1,53,902,474,428
050,39,063,"Ohio","Hancock County",1,54,1002,526,476
050,39,063,"Ohio","Hancock County",1,55,1018,523,495
050,39,063,"Ohio","Hancock County",1,56,1020,525,495
050,39,063,"Ohio","Hancock County",1,57,1062,529,533
050,39,063,"Ohio","Hancock County",1,58,1064,522,542
050,39,063,"Ohio","Hancock County",1,59,1070,525,545
050,39,063,"Ohio","Hancock County",1,60,1080,532,548
050,39,063,"Ohio","Hancock County",1,61,1059,525,534
050,39,063,"Ohio","Hancock County",1,62,1013,509,504
050,39,063,"Ohio","Hancock County",1,63,972,502,470
050,39,063,"Ohio","Hancock County",1,64,986,472,514
050,39,063,"Ohio","Hancock County",1,65,977,472,505
050,39,063,"Ohio","Hancock County",1,66,849,420,429
050,39,063,"Ohio","Hancock County",1,67,846,420,426
050,39,063,"Ohio","Hancock County",1,68,817,390,427
050,39,063,"Ohio","Hancock County",1,69,756,362,394
050,39,063,"Ohio","Hancock County",1,70,754,350,404
050,39,063,"Ohio","Hancock County",1,71,751,338,413
050,39,063,"Ohio","Hancock County",1,72,733,334,399
050,39,063,"Ohio","Hancock County",1,73,765,365,400
050,39,063,"Ohio","Hancock County",1,74,527,257,270
050,39,063,"Ohio","Hancock County",1,75,536,262,274
050,39,063,"Ohio","Hancock County",1,76,498,225,273
050,39,063,"Ohio","Hancock County",1,77,474,209,265
050,39,063,"Ohio","Hancock County",1,78,423,184,239
050,39,063,"Ohio","Hancock County",1,79,386,162,224
050,39,063,"Ohio","Hancock County",1,80,342,145,197
050,39,063,"Ohio","Hancock County",1,81,348,142,206
050,39,063,"Ohio","Hancock County",1,82,347,145,202
050,39,063,"Ohio","Hancock County",1,83,284,111,173
050,39,063,"Ohio","Hancock County",1,84,257,107,150
050,39,063,"Ohio","Hancock County",1,85,1522,501,1021
050,39,063,"Ohio","Hancock County",2,0,846,432,414
050,39,063,"Ohio","Hancock County",2,1,834,410,424
050,39,063,"Ohio","Hancock County",2,2,862,438,424
050,39,063,"Ohio","Hancock County",2,3,888,467,421
050,39,063,"Ohio","Hancock County",2,4,875,458,417
050,39,063,"Ohio","Hancock County",2,5,905,461,444
050,39,063,"Ohio","Hancock County",2,6,923,458,465
050,39,063,"Ohio","Hancock County",2,7,921,469,452
050,39,063,"Ohio","Hancock County",2,8,888,455,433
050,39,063,"Ohio","Hancock County",2,9,891,443,448
050,39,063,"Ohio","Hancock County",2,10,904,452,452
050,39,063,"Ohio","Hancock County",2,11,943,476,467
050,39,063,"Ohio","Hancock County",2,12,965,514,451
050,39,063,"Ohio","Hancock County",2,13,989,527,462
050,39,063,"Ohio","Hancock County",2,14,976,502,474
050,39,063,"Ohio","Hancock County",2,15,929,471,458
050,39,063,"Ohio","Hancock County",2,16,975,492,483
050,39,063,"Ohio","Hancock County",2,17,998,520,478
050,39,063,"Ohio","Hancock County",2,18,1021,501,520
050,39,063,"Ohio","Hancock County",2,19,1159,531,628
050,39,063,"Ohio","Hancock County",2,20,997,471,526
050,39,063,"Ohio","Hancock County",2,21,893,432,461
050,39,063,"Ohio","Hancock County",2,22,889,451,438
050,39,063,"Ohio","Hancock County",2,23,949,493,456
050,39,063,"Ohio","Hancock County",2,24,932,482,450
050,39,063,"Ohio","Hancock County",2,25,920,478,442
050,39,063,"Ohio","Hancock County",2,26,949,499,450
050,39,063,"Ohio","Hancock County",2,27,997,523,474
050,39,063,"Ohio","Hancock County",2,28,1029,539,490
050,39,063,"Ohio","Hancock County",2,29,1029,538,491
050,39,063,"Ohio","Hancock County",2,30,1046,509,537
050,39,063,"Ohio","Hancock County",2,31,1030,518,512
050,39,063,"Ohio","Hancock County",2,32,976,506,470
050,39,063,"Ohio","Hancock County",2,33,951,491,460
050,39,063,"Ohio","Hancock County",2,34,977,507,470
050,39,063,"Ohio","Hancock County",2,35,974,512,462
050,39,063,"Ohio","Hancock County",2,36,937,502,435
050,39,063,"Ohio","Hancock County",2,37,918,486,432
050,39,063,"Ohio","Hancock County",2,38,900,467,433
050,39,063,"Ohio","Hancock County",2,39,891,457,434
050,39,063,"Ohio","Hancock County",2,40,911,460,451
050,39,063,"Ohio","Hancock County",2,41,897,455,442
050,39,063,"Ohio","Hancock County",2,42,835,417,418
050,39,063,"Ohio","Hancock County",2,43,832,416,416
050,39,063,"Ohio","Hancock County",2,44,823,410,413
050,39,063,"Ohio","Hancock County",2,45,847,409,438
050,39,063,"Ohio","Hancock County",2,46,860,426,434
050,39,063,"Ohio","Hancock County",2,47,854,433,421
050,39,063,"Ohio","Hancock County",2,48,910,456,454
050,39,063,"Ohio","Hancock County",2,49,987,516,471
050,39,063,"Ohio","Hancock County",2,50,954,493,461
050,39,063,"Ohio","Hancock County",2,51,935,477,458
050,39,063,"Ohio","Hancock County",2,52,905,472,433
050,39,063,"Ohio","Hancock County",2,53,902,471,431
050,39,063,"Ohio","Hancock County",2,54,975,512,463
050,39,063,"Ohio","Hancock County",2,55,1016,527,489
050,39,063,"Ohio","Hancock County",2,56,1022,525,497
050,39,063,"Ohio","Hancock County",2,57,1050,527,523
050,39,063,"Ohio","Hancock County",2,58,1058,520,538
050,39,063,"Ohio","Hancock County",2,59,1072,526,546
050,39,063,"Ohio","Hancock County",2,60,1077,531,546
050,39,063,"Ohio","Hancock County",2,61,1057,521,536
050,39,063,"Ohio","Hancock County",2,62,1018,510,508
050,39,063,"Ohio","Hancock County",2,63,988,507,481
050,39,063,"Ohio","Hancock County",2,64,972,475,497
050,39,063,"Ohio","Hancock County",2,65,977,469,508
050,39,063,"Ohio","Hancock County",2,66,878,431,447
050,39,063,"Ohio","Hancock County",2,67,838,414,424
050,39,063,"Ohio","Hancock County",2,68,808,391,417
050,39,063,"Ohio","Hancock County",2,69,777,372,405
050,39,063,"Ohio","Hancock County",2,70,749,352,397
050,39,063,"Ohio","Hancock County",2,71,750,340,410
050,39,063,"Ohio","Hancock County",2,72,724,328,396
050,39,063,"Ohio","Hancock County",2,73,791,371,420
050,39,063,"Ohio","Hancock County",2,74,549,264,285
050,39,063,"Ohio","Hancock County",2,75,537,261,276
050,39,063,"Ohio","Hancock County",2,76,502,230,272
050,39,063,"Ohio","Hancock County",2,77,486,213,273
050,39,063,"Ohio","Hancock County",2,78,421,182,239
050,39,063,"Ohio","Hancock County",2,79,389,163,226
050,39,063,"Ohio","Hancock County",2,80,348,143,205
050,39,063,"Ohio","Hancock County",2,81,338,140,198
050,39,063,"Ohio","Hancock County",2,82,348,147,201
050,39,063,"Ohio","Hancock County",2,83,292,116,176
050,39,063,"Ohio","Hancock County",2,84,263,106,157
050,39,063,"Ohio","Hancock County",2,85,1530,507,1023
050,39,063,"Ohio","Hancock County",3,0,851,439,412
050,39,063,"Ohio","Hancock County",3,1,871,446,425
050,39,063,"Ohio","Hancock County",3,2,836,410,426
050,39,063,"Ohio","Hancock County",3,3,864,441,423
050,39,063,"Ohio","Hancock County",3,4,882,473,409
050,39,063,"Ohio","Hancock County",3,5,896,476,420
050,39,063,"Ohio","Hancock County",3,6,901,452,449
050,39,063,"Ohio","Hancock County",3,7,923,442,481
050,39,063,"Ohio","Hancock County",3,8,912,467,445
050,39,063,"Ohio","Hancock County",3,9,893,459,434
050,39,063,"Ohio","Hancock County",3,10,879,429,450
050,39,063,"Ohio","Hancock County",3,11,912,453,459
050,39,063,"Ohio","Hancock County",3,12,917,464,453
050,39,063,"Ohio","Hancock County",3,13,960,507,453
050,39,063,"Ohio","Hancock County",3,14,984,518,466
050,39,063,"Ohio","Hancock County",3,15,950,482,468
050,39,063,"Ohio","Hancock County",3,16,921,464,457
050,39,063,"Ohio","Hancock County",3,17,979,487,492
050,39,063,"Ohio","Hancock County",3,18,1029,500,529
050,39,063,"Ohio","Hancock County",3,19,1119,521,598
050,39,063,"Ohio","Hancock County",3,20,998,489,509
050,39,063,"Ohio","Hancock County",3,21,906,450,456
050,39,063,"Ohio","Hancock County",3,22,915,446,469
050,39,063,"Ohio","Hancock County",3,23,963,493,470
050,39,063,"Ohio","Hancock County",3,24,983,508,475
050,39,063,"Ohio","Hancock County",3,25,953,514,439
050,39,063,"Ohio","Hancock County",3,26,935,470,465
050,39,063,"Ohio","Hancock County",3,27,980,510,470
050,39,063,"Ohio","Hancock County",3,28,987,512,475
050,39,063,"Ohio","Hancock County",3,29,1012,531,481
050,39,063,"Ohio","Hancock County",3,30,1004,524,480
050,39,063,"Ohio","Hancock County",3,31,1046,521,525
050,39,063,"Ohio","Hancock County",3,32,1012,504,508
050,39,063,"Ohio","Hancock County",3,33,985,507,478
050,39,063,"Ohio","Hancock County",3,34,954,501,453
050,39,063,"Ohio","Hancock County",3,35,951,481,470
050,39,063,"Ohio","Hancock County",3,36,972,511,461
050,39,063,"Ohio","Hancock County",3,37,952,519,433
050,39,063,"Ohio","Hancock County",3,38,898,473,425
050,39,063,"Ohio","Hancock County",3,39,908,467,441
050,39,063,"Ohio","Hancock County",3,40,890,470,420
050,39,063,"Ohio","Hancock County",3,41,909,461,448
050,39,063,"Ohio","Hancock County",3,42,894,440,454
050,39,063,"Ohio","Hancock County",3,43,820,413,407
050,39,063,"Ohio","Hancock County",3,44,839,424,415
050,39,063,"Ohio","Hancock County",3,45,841,424,417
050,39,063,"Ohio","Hancock County",3,46,862,419,443
050,39,063,"Ohio","Hancock County",3,47,862,417,445
050,39,063,"Ohio","Hancock County",3,48,874,451,423
050,39,063,"Ohio","Hancock County",3,49,886,449,437
050,39,063,"Ohio","Hancock County",3,50,978,502,476
050,39,063,"Ohio","Hancock County",3,51,965,497,468
050,39,063,"Ohio","Hancock County",3,52,929,478,451
050,39,063,"Ohio","Hancock County",3,53,893,461,432
050,39,063,"Ohio","Hancock County",3,54,875,452,423
050,39,063,"Ohio","Hancock County",3,55,952,503,449
050,39,063,"Ohio","Hancock County",3,56,994,515,479
050,39,063,"Ohio","Hancock County",3,57,999,507,492
050,39,063,"Ohio","Hancock County",3,58,1037,524,513
050,39,063,"Ohio","Hancock County",3,59,1045,511,534
050,39,063,"Ohio","Hancock County",3,60,1058,524,534
050,39,063,"Ohio","Hancock County",3,61,1062,519,543
050,39,063,"Ohio","Hancock County",3,62,1043,516,527
050,39,063,"Ohio","Hancock County",3,63,992,495,497
050,39,063,"Ohio","Hancock County",3,64,978,503,475
050,39,063,"Ohio","Hancock County",3,65,958,464,494
050,39,063,"Ohio","Hancock County",3,66,962,464,498
050,39,063,"Ohio","Hancock County",3,67,870,431,439
050,39,063,"Ohio","Hancock County",3,68,830,402,428
050,39,063,"Ohio","Hancock County",3,69,790,383,407
050,39,063,"Ohio","Hancock County",3,70,755,358,397
050,39,063,"Ohio","Hancock County",3,71,729,338,391
050,39,063,"Ohio","Hancock County",3,72,743,339,404
050,39,063,"Ohio","Hancock County",3,73,680,307,373
050,39,063,"Ohio","Hancock County",3,74,772,354,418
050,39,063,"Ohio","Hancock County",3,75,517,244,273
050,39,063,"Ohio","Hancock County",3,76,495,232,263
050,39,063,"Ohio","Hancock County",3,77,472,222,250
050,39,063,"Ohio","Hancock County",3,78,463,191,272
050,39,063,"Ohio","Hancock County",3,79,387,174,213
050,39,063,"Ohio","Hancock County",3,80,354,142,212
050,39,063,"Ohio","Hancock County",3,81,315,125,190
050,39,063,"Ohio","Hancock County",3,82,322,136,186
050,39,063,"Ohio","Hancock County",3,83,311,124,187
050,39,063,"Ohio","Hancock County",3,84,275,108,167
050,39,063,"Ohio","Hancock County",3,85,1494,494,1000
050,39,063,"Ohio","Hancock County",4,0,835,422,413
050,39,063,"Ohio","Hancock County",4,1,857,449,408
050,39,063,"Ohio","Hancock County",4,2,880,463,417
050,39,063,"Ohio","Hancock County",4,3,821,409,412
050,39,063,"Ohio","Hancock County",4,4,859,425,434
050,39,063,"Ohio","Hancock County",4,5,899,483,416
050,39,063,"Ohio","Hancock County",4,6,884,464,420
050,39,063,"Ohio","Hancock County",4,7,913,450,463
050,39,063,"Ohio","Hancock County",4,8,909,444,465
050,39,063,"Ohio","Hancock County",4,9,933,472,461
050,39,063,"Ohio","Hancock County",4,10,906,467,439
050,39,063,"Ohio","Hancock County",4,11,886,433,453
050,39,063,"Ohio","Hancock County",4,12,873,435,438
050,39,063,"Ohio","Hancock County",4,13,920,459,461
050,39,063,"Ohio","Hancock County",4,14,964,506,458
050,39,063,"Ohio","Hancock County",4,15,986,527,459
050,39,063,"Ohio","Hancock County",4,16,971,493,478
050,39,063,"Ohio","Hancock County",4,17,939,477,462
050,39,063,"Ohio","Hancock County",4,18,1029,467,562
050,39,063,"Ohio","Hancock County",4,19,1183,525,658
050,39,063,"Ohio","Hancock County",4,20,990,493,497
050,39,063,"Ohio","Hancock County",4,21,934,485,449
050,39,063,"Ohio","Hancock County",4,22,908,463,445
050,39,063,"Ohio","Hancock County",4,23,958,464,494
050,39,063,"Ohio","Hancock County",4,24,929,490,439
050,39,063,"Ohio","Hancock County",4,25,944,493,451
050,39,063,"Ohio","Hancock County",4,26,913,478,435
050,39,063,"Ohio","Hancock County",4,27,896,461,435
050,39,063,"Ohio","Hancock County",4,28,1001,526,475
050,39,063,"Ohio","Hancock County",4,29,995,528,467
050,39,063,"Ohio","Hancock County",4,30,989,509,480
050,39,063,"Ohio","Hancock County",4,31,986,520,466
050,39,063,"Ohio","Hancock County",4,32,1067,534,533
050,39,063,"Ohio","Hancock County",4,33,1025,507,518
050,39,063,"Ohio","Hancock County",4,34,983,498,485
050,39,063,"Ohio","Hancock County",4,35,916,477,439
050,39,063,"Ohio","Hancock County",4,36,951,480,471
050,39,063,"Ohio","Hancock County",4,37,999,528,471
050,39,063,"Ohio","Hancock County",4,38,971,528,443
050,39,063,"Ohio","Hancock County",4,39,903,472,431
050,39,063,"Ohio","Hancock County",4,40,897,466,431
050,39,063,"Ohio","Hancock County",4,41,876,461,415
050,39,063,"Ohio","Hancock County",4,42,913,461,452
050,39,063,"Ohio","Hancock County",4,43,887,441,446
050,39,063,"Ohio","Hancock County",4,44,804,401,403
050,39,063,"Ohio","Hancock County",4,45,835,420,415
050,39,063,"Ohio","Hancock County",4,46,852,421,431
050,39,063,"Ohio","Hancock County",4,47,860,410,450
050,39,063,"Ohio","Hancock County",4,48,883,434,449
050,39,063,"Ohio","Hancock County",4,49,886,450,436
050,39,063,"Ohio","Hancock County",4,50,900,451,449
050,39,063,"Ohio","Hancock County",4,51,973,502,471
050,39,063,"Ohio","Hancock County",4,52,966,503,463
050,39,063,"Ohio","Hancock County",4,53,934,479,455
050,39,063,"Ohio","Hancock County",4,54,886,459,427
050,39,063,"Ohio","Hancock County",4,55,862,452,410
050,39,063,"Ohio","Hancock County",4,56,935,498,437
050,39,063,"Ohio","Hancock County",4,57,984,505,479
050,39,063,"Ohio","Hancock County",4,58,984,503,481
050,39,063,"Ohio","Hancock County",4,59,1023,507,516
050,39,063,"Ohio","Hancock County",4,60,1041,515,526
050,39,063,"Ohio","Hancock County",4,61,1052,513,539
050,39,063,"Ohio","Hancock County",4,62,1042,502,540
050,39,063,"Ohio","Hancock County",4,63,1028,507,521
050,39,063,"Ohio","Hancock County",4,64,979,485,494
050,39,063,"Ohio","Hancock County",4,65,964,491,473
050,39,063,"Ohio","Hancock County",4,66,938,451,487
050,39,063,"Ohio","Hancock County",4,67,948,456,492
050,39,063,"Ohio","Hancock County",4,68,856,426,430
050,39,063,"Ohio","Hancock County",4,69,812,386,426
050,39,063,"Ohio","Hancock County",4,70,773,374,399
050,39,063,"Ohio","Hancock County",4,71,733,347,386
050,39,063,"Ohio","Hancock County",4,72,720,331,389
050,39,063,"Ohio","Hancock County",4,73,713,329,384
050,39,063,"Ohio","Hancock County",4,74,655,290,365
050,39,063,"Ohio","Hancock County",4,75,743,334,409
050,39,063,"Ohio","Hancock County",4,76,485,222,263
050,39,063,"Ohio","Hancock County",4,77,468,227,241
050,39,063,"Ohio","Hancock County",4,78,459,208,251
050,39,063,"Ohio","Hancock County",4,79,432,181,251
050,39,063,"Ohio","Hancock County",4,80,369,160,209
050,39,063,"Ohio","Hancock County",4,81,337,133,204
050,39,063,"Ohio","Hancock County",4,82,302,128,174
050,39,063,"Ohio","Hancock County",4,83,295,118,177
050,39,063,"Ohio","Hancock County",4,84,287,115,172
050,39,063,"Ohio","Hancock County",4,85,1498,503,995
050,39,063,"Ohio","Hancock County",5,0,836,425,411
050,39,063,"Ohio","Hancock County",5,1,827,422,405
050,39,063,"Ohio","Hancock County",5,2,865,453,412
050,39,063,"Ohio","Hancock County",5,3,893,470,423
050,39,063,"Ohio","Hancock County",5,4,827,411,416
050,39,063,"Ohio","Hancock County",5,5,858,429,429
050,39,063,"Ohio","Hancock County",5,6,902,475,427
050,39,063,"Ohio","Hancock County",5,7,902,465,437
050,39,063,"Ohio","Hancock County",5,8,910,462,448
050,39,063,"Ohio","Hancock County",5,9,912,448,464
050,39,063,"Ohio","Hancock County",5,10,939,483,456
050,39,063,"Ohio","Hancock County",5,11,902,465,437
050,39,063,"Ohio","Hancock County",5,12,860,415,445
050,39,063,"Ohio","Hancock County",5,13,872,436,436
050,39,063,"Ohio","Hancock County",5,14,916,458,458
050,39,063,"Ohio","Hancock County",5,15,963,506,457
050,39,063,"Ohio","Hancock County",5,16,982,524,458
050,39,063,"Ohio","Hancock County",5,17,984,509,475
050,39,063,"Ohio","Hancock County",5,18,1004,468,536
050,39,063,"Ohio","Hancock County",5,19,1221,515,706
050,39,063,"Ohio","Hancock County",5,20,1036,481,555
050,39,063,"Ohio","Hancock County",5,21,899,472,427
050,39,063,"Ohio","Hancock County",5,22,919,482,437
050,39,063,"Ohio","Hancock County",5,23,955,481,474
050,39,063,"Ohio","Hancock County",5,24,1006,484,522
050,39,063,"Ohio","Hancock County",5,25,885,464,421
050,39,063,"Ohio","Hancock County",5,26,915,469,446
050,39,063,"Ohio","Hancock County",5,27,914,481,433
050,39,063,"Ohio","Hancock County",5,28,899,476,423
050,39,063,"Ohio","Hancock County",5,29,995,515,480
050,39,063,"Ohio","Hancock County",5,30,989,521,468
050,39,063,"Ohio","Hancock County",5,31,962,489,473
050,39,063,"Ohio","Hancock County",5,32,976,513,463
050,39,063,"Ohio","Hancock County",5,33,1070,543,527
050,39,063,"Ohio","Hancock County",5,34,998,490,508
050,39,063,"Ohio","Hancock County",5,35,996,509,487
050,39,063,"Ohio","Hancock County",5,36,926,485,441
050,39,063,"Ohio","Hancock County",5,37,965,494,471
050,39,063,"Ohio","Hancock County",5,38,988,531,457
050,39,063,"Ohio","Hancock County",5,39,938,502,436
050,39,063,"Ohio","Hancock County",5,40,900,476,424
050,39,063,"Ohio","Hancock County",5,41,878,456,422
050,39,063,"Ohio","Hancock County",5,42,905,470,435
050,39,063,"Ohio","Hancock County",5,43,909,460,449
050,39,063,"Ohio","Hancock County",5,44,883,435,448
050,39,063,"Ohio","Hancock County",5,45,813,411,402
050,39,063,"Ohio","Hancock County",5,46,825,411,414
050,39,063,"Ohio","Hancock County",5,47,841,409,432
050,39,063,"Ohio","Hancock County",5,48,869,413,456
050,39,063,"Ohio","Hancock County",5,49,872,420,452
050,39,063,"Ohio","Hancock County",5,50,866,437,429
050,39,063,"Ohio","Hancock County",5,51,886,439,447
050,39,063,"Ohio","Hancock County",5,52,978,515,463
050,39,063,"Ohio","Hancock County",5,53,942,486,456
050,39,063,"Ohio","Hancock County",5,54,923,474,449
050,39,063,"Ohio","Hancock County",5,55,874,455,419
050,39,063,"Ohio","Hancock County",5,56,852,443,409
050,39,063,"Ohio","Hancock County",5,57,918,482,436
050,39,063,"Ohio","Hancock County",5,58,974,500,474
050,39,063,"Ohio","Hancock County",5,59,972,493,479
050,39,063,"Ohio","Hancock County",5,60,1014,497,517
050,39,063,"Ohio","Hancock County",5,61,1020,504,516
050,39,063,"Ohio","Hancock County",5,62,1044,503,541
050,39,063,"Ohio","Hancock County",5,63,1027,487,540
050,39,063,"Ohio","Hancock County",5,64,1008,492,516
050,39,063,"Ohio","Hancock County",5,65,963,470,493
050,39,063,"Ohio","Hancock County",5,66,946,482,464
050,39,063,"Ohio","Hancock County",5,67,922,440,482
050,39,063,"Ohio","Hancock County",5,68,935,451,484
050,39,063,"Ohio","Hancock County",5,69,841,416,425
050,39,063,"Ohio","Hancock County",5,70,786,369,417
050,39,063,"Ohio","Hancock County",5,71,740,357,383
050,39,063,"Ohio","Hancock County",5,72,719,344,375
050,39,063,"Ohio","Hancock County",5,73,692,316,376
050,39,063,"Ohio","Hancock County",5,74,697,317,380
050,39,063,"Ohio","Hancock County",5,75,633,269,364
050,39,063,"Ohio","Hancock County",5,76,703,310,393
050,39,063,"Ohio","Hancock County",5,77,466,221,245
050,39,063,"Ohio","Hancock County",5,78,465,215,250
050,39,063,"Ohio","Hancock County",5,79,428,202,226
050,39,063,"Ohio","Hancock County",5,80,412,167,245
050,39,063,"Ohio","Hancock County",5,81,349,147,202
050,39,063,"Ohio","Hancock County",5,82,309,124,185
050,39,063,"Ohio","Hancock County",5,83,273,109,164
050,39,063,"Ohio","Hancock County",5,84,269,109,160
050,39,063,"Ohio","Hancock County",5,85,1557,538,1019
050,39,065,"Ohio","Hardin County",1,0,364,184,180
050,39,065,"Ohio","Hardin County",1,1,383,195,188
050,39,065,"Ohio","Hardin County",1,2,368,190,178
050,39,065,"Ohio","Hardin County",1,3,373,192,181
050,39,065,"Ohio","Hardin County",1,4,368,190,178
050,39,065,"Ohio","Hardin County",1,5,381,181,200
050,39,065,"Ohio","Hardin County",1,6,419,202,217
050,39,065,"Ohio","Hardin County",1,7,399,213,186
050,39,065,"Ohio","Hardin County",1,8,383,206,177
050,39,065,"Ohio","Hardin County",1,9,383,199,184
050,39,065,"Ohio","Hardin County",1,10,423,218,205
050,39,065,"Ohio","Hardin County",1,11,438,237,201
050,39,065,"Ohio","Hardin County",1,12,432,235,197
050,39,065,"Ohio","Hardin County",1,13,405,215,190
050,39,065,"Ohio","Hardin County",1,14,420,229,191
050,39,065,"Ohio","Hardin County",1,15,408,216,192
050,39,065,"Ohio","Hardin County",1,16,436,226,210
050,39,065,"Ohio","Hardin County",1,17,440,231,209
050,39,065,"Ohio","Hardin County",1,18,539,271,268
050,39,065,"Ohio","Hardin County",1,19,826,412,414
050,39,065,"Ohio","Hardin County",1,20,873,426,447
050,39,065,"Ohio","Hardin County",1,21,787,363,424
050,39,065,"Ohio","Hardin County",1,22,692,332,360
050,39,065,"Ohio","Hardin County",1,23,524,257,267
050,39,065,"Ohio","Hardin County",1,24,426,235,191
050,39,065,"Ohio","Hardin County",1,25,354,186,168
050,39,065,"Ohio","Hardin County",1,26,335,183,152
050,39,065,"Ohio","Hardin County",1,27,333,181,152
050,39,065,"Ohio","Hardin County",1,28,334,186,148
050,39,065,"Ohio","Hardin County",1,29,337,177,160
050,39,065,"Ohio","Hardin County",1,30,310,164,146
050,39,065,"Ohio","Hardin County",1,31,274,136,138
050,39,065,"Ohio","Hardin County",1,32,257,135,122
050,39,065,"Ohio","Hardin County",1,33,284,137,147
050,39,065,"Ohio","Hardin County",1,34,324,152,172
050,39,065,"Ohio","Hardin County",1,35,333,177,156
050,39,065,"Ohio","Hardin County",1,36,340,173,167
050,39,065,"Ohio","Hardin County",1,37,322,153,169
050,39,065,"Ohio","Hardin County",1,38,310,156,154
050,39,065,"Ohio","Hardin County",1,39,348,173,175
050,39,065,"Ohio","Hardin County",1,40,350,174,176
050,39,065,"Ohio","Hardin County",1,41,316,153,163
050,39,065,"Ohio","Hardin County",1,42,352,177,175
050,39,065,"Ohio","Hardin County",1,43,338,180,158
050,39,065,"Ohio","Hardin County",1,44,321,169,152
050,39,065,"Ohio","Hardin County",1,45,337,172,165
050,39,065,"Ohio","Hardin County",1,46,335,174,161
050,39,065,"Ohio","Hardin County",1,47,347,174,173
050,39,065,"Ohio","Hardin County",1,48,379,198,181
050,39,065,"Ohio","Hardin County",1,49,378,188,190
050,39,065,"Ohio","Hardin County",1,50,377,189,188
050,39,065,"Ohio","Hardin County",1,51,351,177,174
050,39,065,"Ohio","Hardin County",1,52,348,176,172
050,39,065,"Ohio","Hardin County",1,53,346,176,170
050,39,065,"Ohio","Hardin County",1,54,360,181,179
050,39,065,"Ohio","Hardin County",1,55,375,182,193
050,39,065,"Ohio","Hardin County",1,56,389,203,186
050,39,065,"Ohio","Hardin County",1,57,392,195,197
050,39,065,"Ohio","Hardin County",1,58,413,212,201
050,39,065,"Ohio","Hardin County",1,59,401,213,188
050,39,065,"Ohio","Hardin County",1,60,392,195,197
050,39,065,"Ohio","Hardin County",1,61,377,189,188
050,39,065,"Ohio","Hardin County",1,62,399,219,180
050,39,065,"Ohio","Hardin County",1,63,379,201,178
050,39,065,"Ohio","Hardin County",1,64,363,177,186
050,39,065,"Ohio","Hardin County",1,65,355,163,192
050,39,065,"Ohio","Hardin County",1,66,325,164,161
050,39,065,"Ohio","Hardin County",1,67,329,158,171
050,39,065,"Ohio","Hardin County",1,68,325,156,169
050,39,065,"Ohio","Hardin County",1,69,285,139,146
050,39,065,"Ohio","Hardin County",1,70,276,128,148
050,39,065,"Ohio","Hardin County",1,71,269,127,142
050,39,065,"Ohio","Hardin County",1,72,275,126,149
050,39,065,"Ohio","Hardin County",1,73,290,132,158
050,39,065,"Ohio","Hardin County",1,74,199,91,108
050,39,065,"Ohio","Hardin County",1,75,188,87,101
050,39,065,"Ohio","Hardin County",1,76,186,87,99
050,39,065,"Ohio","Hardin County",1,77,189,99,90
050,39,065,"Ohio","Hardin County",1,78,167,82,85
050,39,065,"Ohio","Hardin County",1,79,148,59,89
050,39,065,"Ohio","Hardin County",1,80,138,54,84
050,39,065,"Ohio","Hardin County",1,81,136,63,73
050,39,065,"Ohio","Hardin County",1,82,118,50,68
050,39,065,"Ohio","Hardin County",1,83,114,49,65
050,39,065,"Ohio","Hardin County",1,84,90,35,55
050,39,065,"Ohio","Hardin County",1,85,488,186,302
050,39,065,"Ohio","Hardin County",2,0,385,187,198
050,39,065,"Ohio","Hardin County",2,1,377,192,185
050,39,065,"Ohio","Hardin County",2,2,375,192,183
050,39,065,"Ohio","Hardin County",2,3,373,192,181
050,39,065,"Ohio","Hardin County",2,4,371,190,181
050,39,065,"Ohio","Hardin County",2,5,384,185,199
050,39,065,"Ohio","Hardin County",2,6,412,197,215
050,39,065,"Ohio","Hardin County",2,7,408,213,195
050,39,065,"Ohio","Hardin County",2,8,386,209,177
050,39,065,"Ohio","Hardin County",2,9,384,199,185
050,39,065,"Ohio","Hardin County",2,10,413,214,199
050,39,065,"Ohio","Hardin County",2,11,433,232,201
050,39,065,"Ohio","Hardin County",2,12,433,235,198
050,39,065,"Ohio","Hardin County",2,13,412,221,191
050,39,065,"Ohio","Hardin County",2,14,415,225,190
050,39,065,"Ohio","Hardin County",2,15,413,220,193
050,39,065,"Ohio","Hardin County",2,16,434,225,209
050,39,065,"Ohio","Hardin County",2,17,438,229,209
050,39,065,"Ohio","Hardin County",2,18,534,268,266
050,39,065,"Ohio","Hardin County",2,19,830,416,414
050,39,065,"Ohio","Hardin County",2,20,887,432,455
050,39,065,"Ohio","Hardin County",2,21,788,365,423
050,39,065,"Ohio","Hardin County",2,22,696,332,364
050,39,065,"Ohio","Hardin County",2,23,524,255,269
050,39,065,"Ohio","Hardin County",2,24,419,233,186
050,39,065,"Ohio","Hardin County",2,25,361,186,175
050,39,065,"Ohio","Hardin County",2,26,336,182,154
050,39,065,"Ohio","Hardin County",2,27,330,180,150
050,39,065,"Ohio","Hardin County",2,28,335,186,149
050,39,065,"Ohio","Hardin County",2,29,341,180,161
050,39,065,"Ohio","Hardin County",2,30,320,168,152
050,39,065,"Ohio","Hardin County",2,31,283,143,140
050,39,065,"Ohio","Hardin County",2,32,264,137,127
050,39,065,"Ohio","Hardin County",2,33,278,136,142
050,39,065,"Ohio","Hardin County",2,34,313,147,166
050,39,065,"Ohio","Hardin County",2,35,335,174,161
050,39,065,"Ohio","Hardin County",2,36,335,173,162
050,39,065,"Ohio","Hardin County",2,37,327,158,169
050,39,065,"Ohio","Hardin County",2,38,315,157,158
050,39,065,"Ohio","Hardin County",2,39,339,168,171
050,39,065,"Ohio","Hardin County",2,40,353,175,178
050,39,065,"Ohio","Hardin County",2,41,322,157,165
050,39,065,"Ohio","Hardin County",2,42,342,171,171
050,39,065,"Ohio","Hardin County",2,43,343,179,164
050,39,065,"Ohio","Hardin County",2,44,320,169,151
050,39,065,"Ohio","Hardin County",2,45,337,174,163
050,39,065,"Ohio","Hardin County",2,46,333,173,160
050,39,065,"Ohio","Hardin County",2,47,346,175,171
050,39,065,"Ohio","Hardin County",2,48,370,194,176
050,39,065,"Ohio","Hardin County",2,49,382,192,190
050,39,065,"Ohio","Hardin County",2,50,380,189,191
050,39,065,"Ohio","Hardin County",2,51,357,178,179
050,39,065,"Ohio","Hardin County",2,52,348,177,171
050,39,065,"Ohio","Hardin County",2,53,346,177,169
050,39,065,"Ohio","Hardin County",2,54,353,177,176
050,39,065,"Ohio","Hardin County",2,55,373,182,191
050,39,065,"Ohio","Hardin County",2,56,387,199,188
050,39,065,"Ohio","Hardin County",2,57,391,197,194
050,39,065,"Ohio","Hardin County",2,58,407,207,200
050,39,065,"Ohio","Hardin County",2,59,406,214,192
050,39,065,"Ohio","Hardin County",2,60,393,198,195
050,39,065,"Ohio","Hardin County",2,61,372,189,183
050,39,065,"Ohio","Hardin County",2,62,392,213,179
050,39,065,"Ohio","Hardin County",2,63,388,207,181
050,39,065,"Ohio","Hardin County",2,64,362,181,181
050,39,065,"Ohio","Hardin County",2,65,355,165,190
050,39,065,"Ohio","Hardin County",2,66,332,163,169
050,39,065,"Ohio","Hardin County",2,67,321,156,165
050,39,065,"Ohio","Hardin County",2,68,319,154,165
050,39,065,"Ohio","Hardin County",2,69,297,145,152
050,39,065,"Ohio","Hardin County",2,70,277,130,147
050,39,065,"Ohio","Hardin County",2,71,269,127,142
050,39,065,"Ohio","Hardin County",2,72,267,123,144
050,39,065,"Ohio","Hardin County",2,73,299,136,163
050,39,065,"Ohio","Hardin County",2,74,205,93,112
050,39,065,"Ohio","Hardin County",2,75,192,89,103
050,39,065,"Ohio","Hardin County",2,76,182,84,98
050,39,065,"Ohio","Hardin County",2,77,191,97,94
050,39,065,"Ohio","Hardin County",2,78,164,80,84
050,39,065,"Ohio","Hardin County",2,79,147,60,87
050,39,065,"Ohio","Hardin County",2,80,136,54,82
050,39,065,"Ohio","Hardin County",2,81,133,59,74
050,39,065,"Ohio","Hardin County",2,82,120,51,69
050,39,065,"Ohio","Hardin County",2,83,111,47,64
050,39,065,"Ohio","Hardin County",2,84,92,37,55
050,39,065,"Ohio","Hardin County",2,85,479,185,294
050,39,065,"Ohio","Hardin County",3,0,363,195,168
050,39,065,"Ohio","Hardin County",3,1,377,173,204
050,39,065,"Ohio","Hardin County",3,2,378,177,201
050,39,065,"Ohio","Hardin County",3,3,366,186,180
050,39,065,"Ohio","Hardin County",3,4,378,193,185
050,39,065,"Ohio","Hardin County",3,5,376,196,180
050,39,065,"Ohio","Hardin County",3,6,387,190,197
050,39,065,"Ohio","Hardin County",3,7,417,200,217
050,39,065,"Ohio","Hardin County",3,8,413,211,202
050,39,065,"Ohio","Hardin County",3,9,394,207,187
050,39,065,"Ohio","Hardin County",3,10,382,197,185
050,39,065,"Ohio","Hardin County",3,11,421,217,204
050,39,065,"Ohio","Hardin County",3,12,432,229,203
050,39,065,"Ohio","Hardin County",3,13,425,226,199
050,39,065,"Ohio","Hardin County",3,14,415,223,192
050,39,065,"Ohio","Hardin County",3,15,400,219,181
050,39,065,"Ohio","Hardin County",3,16,412,220,192
050,39,065,"Ohio","Hardin County",3,17,443,231,212
050,39,065,"Ohio","Hardin County",3,18,512,259,253
050,39,065,"Ohio","Hardin County",3,19,780,400,380
050,39,065,"Ohio","Hardin County",3,20,865,423,442
050,39,065,"Ohio","Hardin County",3,21,762,361,401
050,39,065,"Ohio","Hardin County",3,22,689,327,362
050,39,065,"Ohio","Hardin County",3,23,519,251,268
050,39,065,"Ohio","Hardin County",3,24,388,223,165
050,39,065,"Ohio","Hardin County",3,25,394,198,196
050,39,065,"Ohio","Hardin County",3,26,343,172,171
050,39,065,"Ohio","Hardin County",3,27,323,176,147
050,39,065,"Ohio","Hardin County",3,28,329,172,157
050,39,065,"Ohio","Hardin County",3,29,357,197,160
050,39,065,"Ohio","Hardin County",3,30,321,166,155
050,39,065,"Ohio","Hardin County",3,31,332,171,161
050,39,065,"Ohio","Hardin County",3,32,287,144,143
050,39,065,"Ohio","Hardin County",3,33,272,149,123
050,39,065,"Ohio","Hardin County",3,34,276,142,134
050,39,065,"Ohio","Hardin County",3,35,313,147,166
050,39,065,"Ohio","Hardin County",3,36,336,172,164
050,39,065,"Ohio","Hardin County",3,37,340,175,165
050,39,065,"Ohio","Hardin County",3,38,332,163,169
050,39,065,"Ohio","Hardin County",3,39,321,153,168
050,39,065,"Ohio","Hardin County",3,40,335,167,168
050,39,065,"Ohio","Hardin County",3,41,344,168,176
050,39,065,"Ohio","Hardin County",3,42,321,164,157
050,39,065,"Ohio","Hardin County",3,43,340,171,169
050,39,065,"Ohio","Hardin County",3,44,343,176,167
050,39,065,"Ohio","Hardin County",3,45,322,170,152
050,39,065,"Ohio","Hardin County",3,46,339,175,164
050,39,065,"Ohio","Hardin County",3,47,337,177,160
050,39,065,"Ohio","Hardin County",3,48,358,182,176
050,39,065,"Ohio","Hardin County",3,49,364,185,179
050,39,065,"Ohio","Hardin County",3,50,383,197,186
050,39,065,"Ohio","Hardin County",3,51,373,186,187
050,39,065,"Ohio","Hardin County",3,52,355,177,178
050,39,065,"Ohio","Hardin County",3,53,347,171,176
050,39,065,"Ohio","Hardin County",3,54,342,176,166
050,39,065,"Ohio","Hardin County",3,55,345,176,169
050,39,065,"Ohio","Hardin County",3,56,367,176,191
050,39,065,"Ohio","Hardin County",3,57,386,202,184
050,39,065,"Ohio","Hardin County",3,58,382,188,194
050,39,065,"Ohio","Hardin County",3,59,398,207,191
050,39,065,"Ohio","Hardin County",3,60,402,209,193
050,39,065,"Ohio","Hardin County",3,61,372,187,185
050,39,065,"Ohio","Hardin County",3,62,360,176,184
050,39,065,"Ohio","Hardin County",3,63,388,213,175
050,39,065,"Ohio","Hardin County",3,64,378,202,176
050,39,065,"Ohio","Hardin County",3,65,360,175,185
050,39,065,"Ohio","Hardin County",3,66,345,162,183
050,39,065,"Ohio","Hardin County",3,67,317,151,166
050,39,065,"Ohio","Hardin County",3,68,317,153,164
050,39,065,"Ohio","Hardin County",3,69,316,153,163
050,39,065,"Ohio","Hardin County",3,70,281,135,146
050,39,065,"Ohio","Hardin County",3,71,261,123,138
050,39,065,"Ohio","Hardin County",3,72,260,118,142
050,39,065,"Ohio","Hardin County",3,73,249,116,133
050,39,065,"Ohio","Hardin County",3,74,289,129,160
050,39,065,"Ohio","Hardin County",3,75,197,89,108
050,39,065,"Ohio","Hardin County",3,76,180,81,99
050,39,065,"Ohio","Hardin County",3,77,165,79,86
050,39,065,"Ohio","Hardin County",3,78,175,86,89
050,39,065,"Ohio","Hardin County",3,79,154,73,81
050,39,065,"Ohio","Hardin County",3,80,131,51,80
050,39,065,"Ohio","Hardin County",3,81,123,48,75
050,39,065,"Ohio","Hardin County",3,82,116,49,67
050,39,065,"Ohio","Hardin County",3,83,106,46,60
050,39,065,"Ohio","Hardin County",3,84,98,45,53
050,39,065,"Ohio","Hardin County",3,85,457,164,293
050,39,065,"Ohio","Hardin County",4,0,363,182,181
050,39,065,"Ohio","Hardin County",4,1,363,201,162
050,39,065,"Ohio","Hardin County",4,2,377,179,198
050,39,065,"Ohio","Hardin County",4,3,376,189,187
050,39,065,"Ohio","Hardin County",4,4,366,190,176
050,39,065,"Ohio","Hardin County",4,5,396,196,200
050,39,065,"Ohio","Hardin County",4,6,376,197,179
050,39,065,"Ohio","Hardin County",4,7,392,194,198
050,39,065,"Ohio","Hardin County",4,8,413,197,216
050,39,065,"Ohio","Hardin County",4,9,404,218,186
050,39,065,"Ohio","Hardin County",4,10,393,214,179
050,39,065,"Ohio","Hardin County",4,11,381,195,186
050,39,065,"Ohio","Hardin County",4,12,408,214,194
050,39,065,"Ohio","Hardin County",4,13,431,224,207
050,39,065,"Ohio","Hardin County",4,14,429,225,204
050,39,065,"Ohio","Hardin County",4,15,419,230,189
050,39,065,"Ohio","Hardin County",4,16,398,217,181
050,39,065,"Ohio","Hardin County",4,17,426,228,198
050,39,065,"Ohio","Hardin County",4,18,533,263,270
050,39,065,"Ohio","Hardin County",4,19,796,406,390
050,39,065,"Ohio","Hardin County",4,20,876,438,438
050,39,065,"Ohio","Hardin County",4,21,801,373,428
050,39,065,"Ohio","Hardin County",4,22,709,334,375
050,39,065,"Ohio","Hardin County",4,23,518,253,265
050,39,065,"Ohio","Hardin County",4,24,394,229,165
050,39,065,"Ohio","Hardin County",4,25,339,177,162
050,39,065,"Ohio","Hardin County",4,26,384,204,180
050,39,065,"Ohio","Hardin County",4,27,329,164,165
050,39,065,"Ohio","Hardin County",4,28,317,162,155
050,39,065,"Ohio","Hardin County",4,29,324,165,159
050,39,065,"Ohio","Hardin County",4,30,366,199,167
050,39,065,"Ohio","Hardin County",4,31,318,158,160
050,39,065,"Ohio","Hardin County",4,32,335,168,167
050,39,065,"Ohio","Hardin County",4,33,284,144,140
050,39,065,"Ohio","Hardin County",4,34,282,150,132
050,39,065,"Ohio","Hardin County",4,35,287,143,144
050,39,065,"Ohio","Hardin County",4,36,314,155,159
050,39,065,"Ohio","Hardin County",4,37,334,167,167
050,39,065,"Ohio","Hardin County",4,38,347,174,173
050,39,065,"Ohio","Hardin County",4,39,320,157,163
050,39,065,"Ohio","Hardin County",4,40,327,160,167
050,39,065,"Ohio","Hardin County",4,41,335,171,164
050,39,065,"Ohio","Hardin County",4,42,342,167,175
050,39,065,"Ohio","Hardin County",4,43,317,162,155
050,39,065,"Ohio","Hardin County",4,44,347,177,170
050,39,065,"Ohio","Hardin County",4,45,336,173,163
050,39,065,"Ohio","Hardin County",4,46,322,172,150
050,39,065,"Ohio","Hardin County",4,47,337,176,161
050,39,065,"Ohio","Hardin County",4,48,337,173,164
050,39,065,"Ohio","Hardin County",4,49,355,179,176
050,39,065,"Ohio","Hardin County",4,50,367,182,185
050,39,065,"Ohio","Hardin County",4,51,381,194,187
050,39,065,"Ohio","Hardin County",4,52,373,193,180
050,39,065,"Ohio","Hardin County",4,53,355,178,177
050,39,065,"Ohio","Hardin County",4,54,351,173,178
050,39,065,"Ohio","Hardin County",4,55,338,174,164
050,39,065,"Ohio","Hardin County",4,56,348,180,168
050,39,065,"Ohio","Hardin County",4,57,359,171,188
050,39,065,"Ohio","Hardin County",4,58,380,200,180
050,39,065,"Ohio","Hardin County",4,59,374,185,189
050,39,065,"Ohio","Hardin County",4,60,393,200,193
050,39,065,"Ohio","Hardin County",4,61,393,205,188
050,39,065,"Ohio","Hardin County",4,62,354,178,176
050,39,065,"Ohio","Hardin County",4,63,355,176,179
050,39,065,"Ohio","Hardin County",4,64,368,200,168
050,39,065,"Ohio","Hardin County",4,65,364,193,171
050,39,065,"Ohio","Hardin County",4,66,342,162,180
050,39,065,"Ohio","Hardin County",4,67,334,154,180
050,39,065,"Ohio","Hardin County",4,68,308,143,165
050,39,065,"Ohio","Hardin County",4,69,310,148,162
050,39,065,"Ohio","Hardin County",4,70,299,145,154
050,39,065,"Ohio","Hardin County",4,71,274,133,141
050,39,065,"Ohio","Hardin County",4,72,252,118,134
050,39,065,"Ohio","Hardin County",4,73,246,112,134
050,39,065,"Ohio","Hardin County",4,74,231,104,127
050,39,065,"Ohio","Hardin County",4,75,279,121,158
050,39,065,"Ohio","Hardin County",4,76,183,80,103
050,39,065,"Ohio","Hardin County",4,77,172,80,92
050,39,065,"Ohio","Hardin County",4,78,153,70,83
050,39,065,"Ohio","Hardin County",4,79,166,80,86
050,39,065,"Ohio","Hardin County",4,80,137,67,70
050,39,065,"Ohio","Hardin County",4,81,123,46,77
050,39,065,"Ohio","Hardin County",4,82,112,41,71
050,39,065,"Ohio","Hardin County",4,83,108,45,63
050,39,065,"Ohio","Hardin County",4,84,91,41,50
050,39,065,"Ohio","Hardin County",4,85,445,155,290
050,39,065,"Ohio","Hardin County",5,0,361,183,178
050,39,065,"Ohio","Hardin County",5,1,353,176,177
050,39,065,"Ohio","Hardin County",5,2,366,200,166
050,39,065,"Ohio","Hardin County",5,3,378,179,199
050,39,065,"Ohio","Hardin County",5,4,364,189,175
050,39,065,"Ohio","Hardin County",5,5,364,181,183
050,39,065,"Ohio","Hardin County",5,6,386,196,190
050,39,065,"Ohio","Hardin County",5,7,375,194,181
050,39,065,"Ohio","Hardin County",5,8,395,193,202
050,39,065,"Ohio","Hardin County",5,9,427,207,220
050,39,065,"Ohio","Hardin County",5,10,417,220,197
050,39,065,"Ohio","Hardin County",5,11,391,211,180
050,39,065,"Ohio","Hardin County",5,12,382,192,190
050,39,065,"Ohio","Hardin County",5,13,428,225,203
050,39,065,"Ohio","Hardin County",5,14,439,231,208
050,39,065,"Ohio","Hardin County",5,15,430,230,200
050,39,065,"Ohio","Hardin County",5,16,422,222,200
050,39,065,"Ohio","Hardin County",5,17,408,219,189
050,39,065,"Ohio","Hardin County",5,18,517,266,251
050,39,065,"Ohio","Hardin County",5,19,828,420,408
050,39,065,"Ohio","Hardin County",5,20,899,439,460
050,39,065,"Ohio","Hardin County",5,21,787,376,411
050,39,065,"Ohio","Hardin County",5,22,728,349,379
050,39,065,"Ohio","Hardin County",5,23,539,267,272
050,39,065,"Ohio","Hardin County",5,24,383,214,169
050,39,065,"Ohio","Hardin County",5,25,355,180,175
050,39,065,"Ohio","Hardin County",5,26,309,162,147
050,39,065,"Ohio","Hardin County",5,27,360,190,170
050,39,065,"Ohio","Hardin County",5,28,321,162,159
050,39,065,"Ohio","Hardin County",5,29,323,167,156
050,39,065,"Ohio","Hardin County",5,30,313,155,158
050,39,065,"Ohio","Hardin County",5,31,369,205,164
050,39,065,"Ohio","Hardin County",5,32,341,168,173
050,39,065,"Ohio","Hardin County",5,33,327,168,159
050,39,065,"Ohio","Hardin County",5,34,280,139,141
050,39,065,"Ohio","Hardin County",5,35,285,149,136
050,39,065,"Ohio","Hardin County",5,36,291,144,147
050,39,065,"Ohio","Hardin County",5,37,317,153,164
050,39,065,"Ohio","Hardin County",5,38,336,173,163
050,39,065,"Ohio","Hardin County",5,39,347,171,176
050,39,065,"Ohio","Hardin County",5,40,315,153,162
050,39,065,"Ohio","Hardin County",5,41,333,164,169
050,39,065,"Ohio","Hardin County",5,42,344,173,171
050,39,065,"Ohio","Hardin County",5,43,338,168,170
050,39,065,"Ohio","Hardin County",5,44,315,158,157
050,39,065,"Ohio","Hardin County",5,45,348,176,172
050,39,065,"Ohio","Hardin County",5,46,335,174,161
050,39,065,"Ohio","Hardin County",5,47,320,168,152
050,39,065,"Ohio","Hardin County",5,48,335,174,161
050,39,065,"Ohio","Hardin County",5,49,337,174,163
050,39,065,"Ohio","Hardin County",5,50,354,176,178
050,39,065,"Ohio","Hardin County",5,51,362,179,183
050,39,065,"Ohio","Hardin County",5,52,378,196,182
050,39,065,"Ohio","Hardin County",5,53,368,190,178
050,39,065,"Ohio","Hardin County",5,54,350,176,174
050,39,065,"Ohio","Hardin County",5,55,345,166,179
050,39,065,"Ohio","Hardin County",5,56,336,175,161
050,39,065,"Ohio","Hardin County",5,57,346,181,165
050,39,065,"Ohio","Hardin County",5,58,361,171,190
050,39,065,"Ohio","Hardin County",5,59,374,197,177
050,39,065,"Ohio","Hardin County",5,60,371,180,191
050,39,065,"Ohio","Hardin County",5,61,386,196,190
050,39,065,"Ohio","Hardin County",5,62,383,199,184
050,39,065,"Ohio","Hardin County",5,63,358,180,178
050,39,065,"Ohio","Hardin County",5,64,338,164,174
050,39,065,"Ohio","Hardin County",5,65,362,193,169
050,39,065,"Ohio","Hardin County",5,66,358,189,169
050,39,065,"Ohio","Hardin County",5,67,332,158,174
050,39,065,"Ohio","Hardin County",5,68,332,151,181
050,39,065,"Ohio","Hardin County",5,69,307,141,166
050,39,065,"Ohio","Hardin County",5,70,295,138,157
050,39,065,"Ohio","Hardin County",5,71,292,143,149
050,39,065,"Ohio","Hardin County",5,72,265,126,139
050,39,065,"Ohio","Hardin County",5,73,241,113,128
050,39,065,"Ohio","Hardin County",5,74,238,104,134
050,39,065,"Ohio","Hardin County",5,75,223,98,125
050,39,065,"Ohio","Hardin County",5,76,259,109,150
050,39,065,"Ohio","Hardin County",5,77,173,76,97
050,39,065,"Ohio","Hardin County",5,78,150,67,83
050,39,065,"Ohio","Hardin County",5,79,148,65,83
050,39,065,"Ohio","Hardin County",5,80,154,76,78
050,39,065,"Ohio","Hardin County",5,81,126,60,66
050,39,065,"Ohio","Hardin County",5,82,112,39,73
050,39,065,"Ohio","Hardin County",5,83,101,38,63
050,39,065,"Ohio","Hardin County",5,84,94,41,53
050,39,065,"Ohio","Hardin County",5,85,435,151,284
050,39,067,"Ohio","Harrison County",1,0,130,69,61
050,39,067,"Ohio","Harrison County",1,1,133,74,59
050,39,067,"Ohio","Harrison County",1,2,142,77,65
050,39,067,"Ohio","Harrison County",1,3,147,73,74
050,39,067,"Ohio","Harrison County",1,4,151,83,68
050,39,067,"Ohio","Harrison County",1,5,162,82,80
050,39,067,"Ohio","Harrison County",1,6,164,82,82
050,39,067,"Ohio","Harrison County",1,7,153,79,74
050,39,067,"Ohio","Harrison County",1,8,148,78,70
050,39,067,"Ohio","Harrison County",1,9,160,82,78
050,39,067,"Ohio","Harrison County",1,10,174,86,88
050,39,067,"Ohio","Harrison County",1,11,176,86,90
050,39,067,"Ohio","Harrison County",1,12,198,100,98
050,39,067,"Ohio","Harrison County",1,13,187,98,89
050,39,067,"Ohio","Harrison County",1,14,181,89,92
050,39,067,"Ohio","Harrison County",1,15,185,96,89
050,39,067,"Ohio","Harrison County",1,16,186,87,99
050,39,067,"Ohio","Harrison County",1,17,209,106,103
050,39,067,"Ohio","Harrison County",1,18,170,93,77
050,39,067,"Ohio","Harrison County",1,19,129,71,58
050,39,067,"Ohio","Harrison County",1,20,129,69,60
050,39,067,"Ohio","Harrison County",1,21,141,70,71
050,39,067,"Ohio","Harrison County",1,22,142,76,66
050,39,067,"Ohio","Harrison County",1,23,130,74,56
050,39,067,"Ohio","Harrison County",1,24,141,75,66
050,39,067,"Ohio","Harrison County",1,25,143,72,71
050,39,067,"Ohio","Harrison County",1,26,147,74,73
050,39,067,"Ohio","Harrison County",1,27,157,72,85
050,39,067,"Ohio","Harrison County",1,28,166,86,80
050,39,067,"Ohio","Harrison County",1,29,167,91,76
050,39,067,"Ohio","Harrison County",1,30,160,79,81
050,39,067,"Ohio","Harrison County",1,31,152,80,72
050,39,067,"Ohio","Harrison County",1,32,139,70,69
050,39,067,"Ohio","Harrison County",1,33,143,73,70
050,39,067,"Ohio","Harrison County",1,34,144,73,71
050,39,067,"Ohio","Harrison County",1,35,150,75,75
050,39,067,"Ohio","Harrison County",1,36,153,76,77
050,39,067,"Ohio","Harrison County",1,37,146,69,77
050,39,067,"Ohio","Harrison County",1,38,154,70,84
050,39,067,"Ohio","Harrison County",1,39,174,80,94
050,39,067,"Ohio","Harrison County",1,40,167,82,85
050,39,067,"Ohio","Harrison County",1,41,166,85,81
050,39,067,"Ohio","Harrison County",1,42,159,77,82
050,39,067,"Ohio","Harrison County",1,43,163,70,93
050,39,067,"Ohio","Harrison County",1,44,147,73,74
050,39,067,"Ohio","Harrison County",1,45,147,77,70
050,39,067,"Ohio","Harrison County",1,46,163,81,82
050,39,067,"Ohio","Harrison County",1,47,186,94,92
050,39,067,"Ohio","Harrison County",1,48,198,106,92
050,39,067,"Ohio","Harrison County",1,49,199,101,98
050,39,067,"Ohio","Harrison County",1,50,187,104,83
050,39,067,"Ohio","Harrison County",1,51,183,101,82
050,39,067,"Ohio","Harrison County",1,52,185,94,91
050,39,067,"Ohio","Harrison County",1,53,191,101,90
050,39,067,"Ohio","Harrison County",1,54,217,108,109
050,39,067,"Ohio","Harrison County",1,55,227,104,123
050,39,067,"Ohio","Harrison County",1,56,237,119,118
050,39,067,"Ohio","Harrison County",1,57,226,115,111
050,39,067,"Ohio","Harrison County",1,58,229,103,126
050,39,067,"Ohio","Harrison County",1,59,219,103,116
050,39,067,"Ohio","Harrison County",1,60,262,133,129
050,39,067,"Ohio","Harrison County",1,61,265,142,123
050,39,067,"Ohio","Harrison County",1,62,255,131,124
050,39,067,"Ohio","Harrison County",1,63,251,137,114
050,39,067,"Ohio","Harrison County",1,64,240,121,119
050,39,067,"Ohio","Harrison County",1,65,250,125,125
050,39,067,"Ohio","Harrison County",1,66,233,120,113
050,39,067,"Ohio","Harrison County",1,67,223,118,105
050,39,067,"Ohio","Harrison County",1,68,209,107,102
050,39,067,"Ohio","Harrison County",1,69,182,93,89
050,39,067,"Ohio","Harrison County",1,70,179,89,90
050,39,067,"Ohio","Harrison County",1,71,163,78,85
050,39,067,"Ohio","Harrison County",1,72,174,83,91
050,39,067,"Ohio","Harrison County",1,73,173,86,87
050,39,067,"Ohio","Harrison County",1,74,111,50,61
050,39,067,"Ohio","Harrison County",1,75,102,43,59
050,39,067,"Ohio","Harrison County",1,76,125,58,67
050,39,067,"Ohio","Harrison County",1,77,135,70,65
050,39,067,"Ohio","Harrison County",1,78,98,46,52
050,39,067,"Ohio","Harrison County",1,79,99,40,59
050,39,067,"Ohio","Harrison County",1,80,91,42,49
050,39,067,"Ohio","Harrison County",1,81,76,44,32
050,39,067,"Ohio","Harrison County",1,82,73,35,38
050,39,067,"Ohio","Harrison County",1,83,58,28,30
050,39,067,"Ohio","Harrison County",1,84,54,20,34
050,39,067,"Ohio","Harrison County",1,85,345,112,233
050,39,067,"Ohio","Harrison County",2,0,141,70,71
050,39,067,"Ohio","Harrison County",2,1,133,72,61
050,39,067,"Ohio","Harrison County",2,2,140,75,65
050,39,067,"Ohio","Harrison County",2,3,143,74,69
050,39,067,"Ohio","Harrison County",2,4,152,83,69
050,39,067,"Ohio","Harrison County",2,5,161,84,77
050,39,067,"Ohio","Harrison County",2,6,165,84,81
050,39,067,"Ohio","Harrison County",2,7,155,79,76
050,39,067,"Ohio","Harrison County",2,8,150,79,71
050,39,067,"Ohio","Harrison County",2,9,158,83,75
050,39,067,"Ohio","Harrison County",2,10,170,85,85
050,39,067,"Ohio","Harrison County",2,11,175,86,89
050,39,067,"Ohio","Harrison County",2,12,195,99,96
050,39,067,"Ohio","Harrison County",2,13,189,98,91
050,39,067,"Ohio","Harrison County",2,14,183,92,91
050,39,067,"Ohio","Harrison County",2,15,182,92,90
050,39,067,"Ohio","Harrison County",2,16,187,89,98
050,39,067,"Ohio","Harrison County",2,17,203,101,102
050,39,067,"Ohio","Harrison County",2,18,168,91,77
050,39,067,"Ohio","Harrison County",2,19,131,71,60
050,39,067,"Ohio","Harrison County",2,20,135,73,62
050,39,067,"Ohio","Harrison County",2,21,139,70,69
050,39,067,"Ohio","Harrison County",2,22,143,76,67
050,39,067,"Ohio","Harrison County",2,23,135,76,59
050,39,067,"Ohio","Harrison County",2,24,140,74,66
050,39,067,"Ohio","Harrison County",2,25,143,72,71
050,39,067,"Ohio","Harrison County",2,26,148,74,74
050,39,067,"Ohio","Harrison County",2,27,155,74,81
050,39,067,"Ohio","Harrison County",2,28,165,84,81
050,39,067,"Ohio","Harrison County",2,29,168,90,78
050,39,067,"Ohio","Harrison County",2,30,165,84,81
050,39,067,"Ohio","Harrison County",2,31,153,80,73
050,39,067,"Ohio","Harrison County",2,32,142,73,69
050,39,067,"Ohio","Harrison County",2,33,141,73,68
050,39,067,"Ohio","Harrison County",2,34,143,73,70
050,39,067,"Ohio","Harrison County",2,35,150,75,75
050,39,067,"Ohio","Harrison County",2,36,155,77,78
050,39,067,"Ohio","Harrison County",2,37,148,71,77
050,39,067,"Ohio","Harrison County",2,38,153,70,83
050,39,067,"Ohio","Harrison County",2,39,169,77,92
050,39,067,"Ohio","Harrison County",2,40,173,84,89
050,39,067,"Ohio","Harrison County",2,41,167,85,82
050,39,067,"Ohio","Harrison County",2,42,162,80,82
050,39,067,"Ohio","Harrison County",2,43,163,72,91
050,39,067,"Ohio","Harrison County",2,44,148,71,77
050,39,067,"Ohio","Harrison County",2,45,149,77,72
050,39,067,"Ohio","Harrison County",2,46,160,80,80
050,39,067,"Ohio","Harrison County",2,47,179,91,88
050,39,067,"Ohio","Harrison County",2,48,193,102,91
050,39,067,"Ohio","Harrison County",2,49,200,103,97
050,39,067,"Ohio","Harrison County",2,50,191,104,87
050,39,067,"Ohio","Harrison County",2,51,182,101,81
050,39,067,"Ohio","Harrison County",2,52,181,94,87
050,39,067,"Ohio","Harrison County",2,53,190,100,90
050,39,067,"Ohio","Harrison County",2,54,209,106,103
050,39,067,"Ohio","Harrison County",2,55,225,105,120
050,39,067,"Ohio","Harrison County",2,56,236,117,119
050,39,067,"Ohio","Harrison County",2,57,230,116,114
050,39,067,"Ohio","Harrison County",2,58,225,104,121
050,39,067,"Ohio","Harrison County",2,59,223,104,119
050,39,067,"Ohio","Harrison County",2,60,250,124,126
050,39,067,"Ohio","Harrison County",2,61,263,139,124
050,39,067,"Ohio","Harrison County",2,62,255,133,122
050,39,067,"Ohio","Harrison County",2,63,254,136,118
050,39,067,"Ohio","Harrison County",2,64,242,124,118
050,39,067,"Ohio","Harrison County",2,65,247,123,124
050,39,067,"Ohio","Harrison County",2,66,239,123,116
050,39,067,"Ohio","Harrison County",2,67,224,117,107
050,39,067,"Ohio","Harrison County",2,68,209,109,100
050,39,067,"Ohio","Harrison County",2,69,189,96,93
050,39,067,"Ohio","Harrison County",2,70,178,90,88
050,39,067,"Ohio","Harrison County",2,71,167,81,86
050,39,067,"Ohio","Harrison County",2,72,164,78,86
050,39,067,"Ohio","Harrison County",2,73,180,90,90
050,39,067,"Ohio","Harrison County",2,74,117,55,62
050,39,067,"Ohio","Harrison County",2,75,103,43,60
050,39,067,"Ohio","Harrison County",2,76,118,54,64
050,39,067,"Ohio","Harrison County",2,77,134,67,67
050,39,067,"Ohio","Harrison County",2,78,101,49,52
050,39,067,"Ohio","Harrison County",2,79,96,40,56
050,39,067,"Ohio","Harrison County",2,80,90,41,49
050,39,067,"Ohio","Harrison County",2,81,79,43,36
050,39,067,"Ohio","Harrison County",2,82,72,36,36
050,39,067,"Ohio","Harrison County",2,83,59,28,31
050,39,067,"Ohio","Harrison County",2,84,55,22,33
050,39,067,"Ohio","Harrison County",2,85,349,113,236
050,39,067,"Ohio","Harrison County",3,0,164,94,70
050,39,067,"Ohio","Harrison County",3,1,133,74,59
050,39,067,"Ohio","Harrison County",3,2,131,71,60
050,39,067,"Ohio","Harrison County",3,3,145,81,64
050,39,067,"Ohio","Harrison County",3,4,146,76,70
050,39,067,"Ohio","Harrison County",3,5,164,87,77
050,39,067,"Ohio","Harrison County",3,6,173,89,84
050,39,067,"Ohio","Harrison County",3,7,166,83,83
050,39,067,"Ohio","Harrison County",3,8,162,82,80
050,39,067,"Ohio","Harrison County",3,9,162,81,81
050,39,067,"Ohio","Harrison County",3,10,161,86,75
050,39,067,"Ohio","Harrison County",3,11,181,91,90
050,39,067,"Ohio","Harrison County",3,12,183,90,93
050,39,067,"Ohio","Harrison County",3,13,200,100,100
050,39,067,"Ohio","Harrison County",3,14,185,99,86
050,39,067,"Ohio","Harrison County",3,15,188,92,96
050,39,067,"Ohio","Harrison County",3,16,194,95,99
050,39,067,"Ohio","Harrison County",3,17,193,94,99
050,39,067,"Ohio","Harrison County",3,18,177,91,86
050,39,067,"Ohio","Harrison County",3,19,125,69,56
050,39,067,"Ohio","Harrison County",3,20,132,71,61
050,39,067,"Ohio","Harrison County",3,21,139,76,63
050,39,067,"Ohio","Harrison County",3,22,147,69,78
050,39,067,"Ohio","Harrison County",3,23,149,82,67
050,39,067,"Ohio","Harrison County",3,24,137,78,59
050,39,067,"Ohio","Harrison County",3,25,133,74,59
050,39,067,"Ohio","Harrison County",3,26,143,74,69
050,39,067,"Ohio","Harrison County",3,27,139,66,73
050,39,067,"Ohio","Harrison County",3,28,147,62,85
050,39,067,"Ohio","Harrison County",3,29,164,80,84
050,39,067,"Ohio","Harrison County",3,30,170,97,73
050,39,067,"Ohio","Harrison County",3,31,179,89,90
050,39,067,"Ohio","Harrison County",3,32,156,82,74
050,39,067,"Ohio","Harrison County",3,33,156,83,73
050,39,067,"Ohio","Harrison County",3,34,146,71,75
050,39,067,"Ohio","Harrison County",3,35,146,72,74
050,39,067,"Ohio","Harrison County",3,36,155,77,78
050,39,067,"Ohio","Harrison County",3,37,155,74,81
050,39,067,"Ohio","Harrison County",3,38,146,67,79
050,39,067,"Ohio","Harrison County",3,39,148,65,83
050,39,067,"Ohio","Harrison County",3,40,181,84,97
050,39,067,"Ohio","Harrison County",3,41,174,83,91
050,39,067,"Ohio","Harrison County",3,42,165,85,80
050,39,067,"Ohio","Harrison County",3,43,164,80,84
050,39,067,"Ohio","Harrison County",3,44,154,64,90
050,39,067,"Ohio","Harrison County",3,45,151,74,77
050,39,067,"Ohio","Harrison County",3,46,150,76,74
050,39,067,"Ohio","Harrison County",3,47,162,79,83
050,39,067,"Ohio","Harrison County",3,48,178,88,90
050,39,067,"Ohio","Harrison County",3,49,196,97,99
050,39,067,"Ohio","Harrison County",3,50,201,109,92
050,39,067,"Ohio","Harrison County",3,51,190,107,83
050,39,067,"Ohio","Harrison County",3,52,174,94,80
050,39,067,"Ohio","Harrison County",3,53,176,86,90
050,39,067,"Ohio","Harrison County",3,54,190,100,90
050,39,067,"Ohio","Harrison County",3,55,197,101,96
050,39,067,"Ohio","Harrison County",3,56,217,103,114
050,39,067,"Ohio","Harrison County",3,57,232,115,117
050,39,067,"Ohio","Harrison County",3,58,225,112,113
050,39,067,"Ohio","Harrison County",3,59,233,106,127
050,39,067,"Ohio","Harrison County",3,60,218,99,119
050,39,067,"Ohio","Harrison County",3,61,249,128,121
050,39,067,"Ohio","Harrison County",3,62,254,134,120
050,39,067,"Ohio","Harrison County",3,63,249,132,117
050,39,067,"Ohio","Harrison County",3,64,259,138,121
050,39,067,"Ohio","Harrison County",3,65,233,121,112
050,39,067,"Ohio","Harrison County",3,66,244,128,116
050,39,067,"Ohio","Harrison County",3,67,234,115,119
050,39,067,"Ohio","Harrison County",3,68,218,113,105
050,39,067,"Ohio","Harrison County",3,69,200,105,95
050,39,067,"Ohio","Harrison County",3,70,190,96,94
050,39,067,"Ohio","Harrison County",3,71,172,89,83
050,39,067,"Ohio","Harrison County",3,72,166,78,88
050,39,067,"Ohio","Harrison County",3,73,150,75,75
050,39,067,"Ohio","Harrison County",3,74,173,87,86
050,39,067,"Ohio","Harrison County",3,75,109,49,60
050,39,067,"Ohio","Harrison County",3,76,94,38,56
050,39,067,"Ohio","Harrison County",3,77,116,52,64
050,39,067,"Ohio","Harrison County",3,78,122,61,61
050,39,067,"Ohio","Harrison County",3,79,91,42,49
050,39,067,"Ohio","Harrison County",3,80,86,34,52
050,39,067,"Ohio","Harrison County",3,81,78,34,44
050,39,067,"Ohio","Harrison County",3,82,72,39,33
050,39,067,"Ohio","Harrison County",3,83,66,33,33
050,39,067,"Ohio","Harrison County",3,84,54,26,28
050,39,067,"Ohio","Harrison County",3,85,331,106,225
050,39,067,"Ohio","Harrison County",4,0,148,81,67
050,39,067,"Ohio","Harrison County",4,1,165,96,69
050,39,067,"Ohio","Harrison County",4,2,139,80,59
050,39,067,"Ohio","Harrison County",4,3,132,73,59
050,39,067,"Ohio","Harrison County",4,4,147,77,70
050,39,067,"Ohio","Harrison County",4,5,147,73,74
050,39,067,"Ohio","Harrison County",4,6,157,78,79
050,39,067,"Ohio","Harrison County",4,7,171,90,81
050,39,067,"Ohio","Harrison County",4,8,166,87,79
050,39,067,"Ohio","Harrison County",4,9,161,83,78
050,39,067,"Ohio","Harrison County",4,10,160,87,73
050,39,067,"Ohio","Harrison County",4,11,163,80,83
050,39,067,"Ohio","Harrison County",4,12,184,94,90
050,39,067,"Ohio","Harrison County",4,13,178,90,88
050,39,067,"Ohio","Harrison County",4,14,204,103,101
050,39,067,"Ohio","Harrison County",4,15,188,98,90
050,39,067,"Ohio","Harrison County",4,16,190,95,95
050,39,067,"Ohio","Harrison County",4,17,194,94,100
050,39,067,"Ohio","Harrison County",4,18,156,77,79
050,39,067,"Ohio","Harrison County",4,19,129,64,65
050,39,067,"Ohio","Harrison County",4,20,127,72,55
050,39,067,"Ohio","Harrison County",4,21,136,75,61
050,39,067,"Ohio","Harrison County",4,22,149,81,68
050,39,067,"Ohio","Harrison County",4,23,159,75,84
050,39,067,"Ohio","Harrison County",4,24,147,78,69
050,39,067,"Ohio","Harrison County",4,25,130,74,56
050,39,067,"Ohio","Harrison County",4,26,136,79,57
050,39,067,"Ohio","Harrison County",4,27,148,80,68
050,39,067,"Ohio","Harrison County",4,28,143,63,80
050,39,067,"Ohio","Harrison County",4,29,154,67,87
050,39,067,"Ohio","Harrison County",4,30,177,88,89
050,39,067,"Ohio","Harrison County",4,31,178,102,76
050,39,067,"Ohio","Harrison County",4,32,190,95,95
050,39,067,"Ohio","Harrison County",4,33,153,79,74
050,39,067,"Ohio","Harrison County",4,34,152,84,68
050,39,067,"Ohio","Harrison County",4,35,145,69,76
050,39,067,"Ohio","Harrison County",4,36,153,77,76
050,39,067,"Ohio","Harrison County",4,37,153,76,77
050,39,067,"Ohio","Harrison County",4,38,155,76,79
050,39,067,"Ohio","Harrison County",4,39,147,63,84
050,39,067,"Ohio","Harrison County",4,40,157,68,89
050,39,067,"Ohio","Harrison County",4,41,185,84,101
050,39,067,"Ohio","Harrison County",4,42,171,82,89
050,39,067,"Ohio","Harrison County",4,43,168,88,80
050,39,067,"Ohio","Harrison County",4,44,164,79,85
050,39,067,"Ohio","Harrison County",4,45,161,74,87
050,39,067,"Ohio","Harrison County",4,46,147,70,77
050,39,067,"Ohio","Harrison County",4,47,152,78,74
050,39,067,"Ohio","Harrison County",4,48,163,80,83
050,39,067,"Ohio","Harrison County",4,49,180,85,95
050,39,067,"Ohio","Harrison County",4,50,194,98,96
050,39,067,"Ohio","Harrison County",4,51,203,111,92
050,39,067,"Ohio","Harrison County",4,52,181,100,81
050,39,067,"Ohio","Harrison County",4,53,179,101,78
050,39,067,"Ohio","Harrison County",4,54,180,88,92
050,39,067,"Ohio","Harrison County",4,55,193,101,92
050,39,067,"Ohio","Harrison County",4,56,196,99,97
050,39,067,"Ohio","Harrison County",4,57,213,98,115
050,39,067,"Ohio","Harrison County",4,58,225,111,114
050,39,067,"Ohio","Harrison County",4,59,218,108,110
050,39,067,"Ohio","Harrison County",4,60,233,107,126
050,39,067,"Ohio","Harrison County",4,61,217,99,118
050,39,067,"Ohio","Harrison County",4,62,240,123,117
050,39,067,"Ohio","Harrison County",4,63,250,132,118
050,39,067,"Ohio","Harrison County",4,64,242,126,116
050,39,067,"Ohio","Harrison County",4,65,249,131,118
050,39,067,"Ohio","Harrison County",4,66,233,126,107
050,39,067,"Ohio","Harrison County",4,67,238,125,113
050,39,067,"Ohio","Harrison County",4,68,219,108,111
050,39,067,"Ohio","Harrison County",4,69,207,105,102
050,39,067,"Ohio","Harrison County",4,70,196,103,93
050,39,067,"Ohio","Harrison County",4,71,183,88,95
050,39,067,"Ohio","Harrison County",4,72,169,89,80
050,39,067,"Ohio","Harrison County",4,73,149,72,77
050,39,067,"Ohio","Harrison County",4,74,141,73,68
050,39,067,"Ohio","Harrison County",4,75,160,76,84
050,39,067,"Ohio","Harrison County",4,76,103,44,59
050,39,067,"Ohio","Harrison County",4,77,90,38,52
050,39,067,"Ohio","Harrison County",4,78,105,44,61
050,39,067,"Ohio","Harrison County",4,79,113,54,59
050,39,067,"Ohio","Harrison County",4,80,84,37,47
050,39,067,"Ohio","Harrison County",4,81,76,27,49
050,39,067,"Ohio","Harrison County",4,82,73,30,43
050,39,067,"Ohio","Harrison County",4,83,63,34,29
050,39,067,"Ohio","Harrison County",4,84,58,26,32
050,39,067,"Ohio","Harrison County",4,85,319,102,217
050,39,067,"Ohio","Harrison County",5,0,135,72,63
050,39,067,"Ohio","Harrison County",5,1,143,77,66
050,39,067,"Ohio","Harrison County",5,2,160,93,67
050,39,067,"Ohio","Harrison County",5,3,146,79,67
050,39,067,"Ohio","Harrison County",5,4,124,69,55
050,39,067,"Ohio","Harrison County",5,5,148,84,64
050,39,067,"Ohio","Harrison County",5,6,147,74,73
050,39,067,"Ohio","Harrison County",5,7,147,77,70
050,39,067,"Ohio","Harrison County",5,8,182,97,85
050,39,067,"Ohio","Harrison County",5,9,165,81,84
050,39,067,"Ohio","Harrison County",5,10,164,88,76
050,39,067,"Ohio","Harrison County",5,11,161,83,78
050,39,067,"Ohio","Harrison County",5,12,167,86,81
050,39,067,"Ohio","Harrison County",5,13,182,93,89
050,39,067,"Ohio","Harrison County",5,14,183,91,92
050,39,067,"Ohio","Harrison County",5,15,196,99,97
050,39,067,"Ohio","Harrison County",5,16,184,95,89
050,39,067,"Ohio","Harrison County",5,17,179,90,89
050,39,067,"Ohio","Harrison County",5,18,157,80,77
050,39,067,"Ohio","Harrison County",5,19,112,55,57
050,39,067,"Ohio","Harrison County",5,20,135,68,67
050,39,067,"Ohio","Harrison County",5,21,135,77,58
050,39,067,"Ohio","Harrison County",5,22,148,81,67
050,39,067,"Ohio","Harrison County",5,23,149,82,67
050,39,067,"Ohio","Harrison County",5,24,160,79,81
050,39,067,"Ohio","Harrison County",5,25,151,81,70
050,39,067,"Ohio","Harrison County",5,26,128,76,52
050,39,067,"Ohio","Harrison County",5,27,127,66,61
050,39,067,"Ohio","Harrison County",5,28,142,74,68
050,39,067,"Ohio","Harrison County",5,29,143,63,80
050,39,067,"Ohio","Harrison County",5,30,143,60,83
050,39,067,"Ohio","Harrison County",5,31,178,87,91
050,39,067,"Ohio","Harrison County",5,32,182,104,78
050,39,067,"Ohio","Harrison County",5,33,194,100,94
050,39,067,"Ohio","Harrison County",5,34,153,79,74
050,39,067,"Ohio","Harrison County",5,35,144,79,65
050,39,067,"Ohio","Harrison County",5,36,145,67,78
050,39,067,"Ohio","Harrison County",5,37,158,81,77
050,39,067,"Ohio","Harrison County",5,38,149,77,72
050,39,067,"Ohio","Harrison County",5,39,160,80,80
050,39,067,"Ohio","Harrison County",5,40,144,60,84
050,39,067,"Ohio","Harrison County",5,41,153,66,87
050,39,067,"Ohio","Harrison County",5,42,175,79,96
050,39,067,"Ohio","Harrison County",5,43,170,78,92
050,39,067,"Ohio","Harrison County",5,44,165,85,80
050,39,067,"Ohio","Harrison County",5,45,162,79,83
050,39,067,"Ohio","Harrison County",5,46,159,71,88
050,39,067,"Ohio","Harrison County",5,47,146,73,73
050,39,067,"Ohio","Harrison County",5,48,144,71,73
050,39,067,"Ohio","Harrison County",5,49,170,81,89
050,39,067,"Ohio","Harrison County",5,50,174,83,91
050,39,067,"Ohio","Harrison County",5,51,195,103,92
050,39,067,"Ohio","Harrison County",5,52,202,109,93
050,39,067,"Ohio","Harrison County",5,53,184,98,86
050,39,067,"Ohio","Harrison County",5,54,181,100,81
050,39,067,"Ohio","Harrison County",5,55,194,99,95
050,39,067,"Ohio","Harrison County",5,56,195,103,92
050,39,067,"Ohio","Harrison County",5,57,195,95,100
050,39,067,"Ohio","Harrison County",5,58,211,95,116
050,39,067,"Ohio","Harrison County",5,59,222,111,111
050,39,067,"Ohio","Harrison County",5,60,209,102,107
050,39,067,"Ohio","Harrison County",5,61,233,107,126
050,39,067,"Ohio","Harrison County",5,62,211,96,115
050,39,067,"Ohio","Harrison County",5,63,238,124,114
050,39,067,"Ohio","Harrison County",5,64,244,130,114
050,39,067,"Ohio","Harrison County",5,65,238,124,114
050,39,067,"Ohio","Harrison County",5,66,251,132,119
050,39,067,"Ohio","Harrison County",5,67,238,125,113
050,39,067,"Ohio","Harrison County",5,68,229,119,110
050,39,067,"Ohio","Harrison County",5,69,210,104,106
050,39,067,"Ohio","Harrison County",5,70,201,101,100
050,39,067,"Ohio","Harrison County",5,71,195,101,94
050,39,067,"Ohio","Harrison County",5,72,186,87,99
050,39,067,"Ohio","Harrison County",5,73,158,85,73
050,39,067,"Ohio","Harrison County",5,74,139,69,70
050,39,067,"Ohio","Harrison County",5,75,130,64,66
050,39,067,"Ohio","Harrison County",5,76,151,69,82
050,39,067,"Ohio","Harrison County",5,77,99,43,56
050,39,067,"Ohio","Harrison County",5,78,79,31,48
050,39,067,"Ohio","Harrison County",5,79,94,37,57
050,39,067,"Ohio","Harrison County",5,80,101,48,53
050,39,067,"Ohio","Harrison County",5,81,76,32,44
050,39,067,"Ohio","Harrison County",5,82,71,23,48
050,39,067,"Ohio","Harrison County",5,83,62,26,36
050,39,067,"Ohio","Harrison County",5,84,53,29,24
050,39,067,"Ohio","Harrison County",5,85,316,99,217
050,39,069,"Ohio","Henry County",1,0,305,152,153
050,39,069,"Ohio","Henry County",1,1,318,148,170
050,39,069,"Ohio","Henry County",1,2,341,166,175
050,39,069,"Ohio","Henry County",1,3,333,165,168
050,39,069,"Ohio","Henry County",1,4,327,181,146
050,39,069,"Ohio","Henry County",1,5,331,175,156
050,39,069,"Ohio","Henry County",1,6,326,158,168
050,39,069,"Ohio","Henry County",1,7,369,167,202
050,39,069,"Ohio","Henry County",1,8,360,185,175
050,39,069,"Ohio","Henry County",1,9,359,176,183
050,39,069,"Ohio","Henry County",1,10,372,190,182
050,39,069,"Ohio","Henry County",1,11,392,200,192
050,39,069,"Ohio","Henry County",1,12,391,201,190
050,39,069,"Ohio","Henry County",1,13,410,224,186
050,39,069,"Ohio","Henry County",1,14,399,201,198
050,39,069,"Ohio","Henry County",1,15,401,208,193
050,39,069,"Ohio","Henry County",1,16,380,194,186
050,39,069,"Ohio","Henry County",1,17,404,208,196
050,39,069,"Ohio","Henry County",1,18,338,176,162
050,39,069,"Ohio","Henry County",1,19,268,144,124
050,39,069,"Ohio","Henry County",1,20,279,148,131
050,39,069,"Ohio","Henry County",1,21,289,151,138
050,39,069,"Ohio","Henry County",1,22,312,165,147
050,39,069,"Ohio","Henry County",1,23,306,158,148
050,39,069,"Ohio","Henry County",1,24,278,150,128
050,39,069,"Ohio","Henry County",1,25,280,145,135
050,39,069,"Ohio","Henry County",1,26,292,148,144
050,39,069,"Ohio","Henry County",1,27,320,158,162
050,39,069,"Ohio","Henry County",1,28,338,175,163
050,39,069,"Ohio","Henry County",1,29,344,178,166
050,39,069,"Ohio","Henry County",1,30,322,163,159
050,39,069,"Ohio","Henry County",1,31,311,159,152
050,39,069,"Ohio","Henry County",1,32,287,140,147
050,39,069,"Ohio","Henry County",1,33,313,155,158
050,39,069,"Ohio","Henry County",1,34,341,156,185
050,39,069,"Ohio","Henry County",1,35,329,153,176
050,39,069,"Ohio","Henry County",1,36,300,142,158
050,39,069,"Ohio","Henry County",1,37,319,150,169
050,39,069,"Ohio","Henry County",1,38,331,162,169
050,39,069,"Ohio","Henry County",1,39,354,176,178
050,39,069,"Ohio","Henry County",1,40,356,183,173
050,39,069,"Ohio","Henry County",1,41,341,180,161
050,39,069,"Ohio","Henry County",1,42,340,177,163
050,39,069,"Ohio","Henry County",1,43,307,156,151
050,39,069,"Ohio","Henry County",1,44,316,164,152
050,39,069,"Ohio","Henry County",1,45,339,156,183
050,39,069,"Ohio","Henry County",1,46,333,170,163
050,39,069,"Ohio","Henry County",1,47,310,165,145
050,39,069,"Ohio","Henry County",1,48,342,175,167
050,39,069,"Ohio","Henry County",1,49,369,189,180
050,39,069,"Ohio","Henry County",1,50,350,189,161
050,39,069,"Ohio","Henry County",1,51,345,185,160
050,39,069,"Ohio","Henry County",1,52,353,180,173
050,39,069,"Ohio","Henry County",1,53,350,160,190
050,39,069,"Ohio","Henry County",1,54,354,178,176
050,39,069,"Ohio","Henry County",1,55,374,191,183
050,39,069,"Ohio","Henry County",1,56,386,196,190
050,39,069,"Ohio","Henry County",1,57,399,196,203
050,39,069,"Ohio","Henry County",1,58,399,197,202
050,39,069,"Ohio","Henry County",1,59,424,220,204
050,39,069,"Ohio","Henry County",1,60,418,221,197
050,39,069,"Ohio","Henry County",1,61,372,183,189
050,39,069,"Ohio","Henry County",1,62,423,214,209
050,39,069,"Ohio","Henry County",1,63,420,228,192
050,39,069,"Ohio","Henry County",1,64,409,218,191
050,39,069,"Ohio","Henry County",1,65,389,193,196
050,39,069,"Ohio","Henry County",1,66,346,159,187
050,39,069,"Ohio","Henry County",1,67,342,156,186
050,39,069,"Ohio","Henry County",1,68,328,161,167
050,39,069,"Ohio","Henry County",1,69,304,156,148
050,39,069,"Ohio","Henry County",1,70,282,141,141
050,39,069,"Ohio","Henry County",1,71,277,139,138
050,39,069,"Ohio","Henry County",1,72,267,124,143
050,39,069,"Ohio","Henry County",1,73,268,130,138
050,39,069,"Ohio","Henry County",1,74,182,90,92
050,39,069,"Ohio","Henry County",1,75,180,86,94
050,39,069,"Ohio","Henry County",1,76,191,88,103
050,39,069,"Ohio","Henry County",1,77,188,85,103
050,39,069,"Ohio","Henry County",1,78,154,63,91
050,39,069,"Ohio","Henry County",1,79,151,66,85
050,39,069,"Ohio","Henry County",1,80,159,68,91
050,39,069,"Ohio","Henry County",1,81,136,63,73
050,39,069,"Ohio","Henry County",1,82,134,64,70
050,39,069,"Ohio","Henry County",1,83,111,52,59
050,39,069,"Ohio","Henry County",1,84,113,44,69
050,39,069,"Ohio","Henry County",1,85,663,242,421
050,39,069,"Ohio","Henry County",2,0,316,156,160
050,39,069,"Ohio","Henry County",2,1,317,151,166
050,39,069,"Ohio","Henry County",2,2,332,161,171
050,39,069,"Ohio","Henry County",2,3,335,168,167
050,39,069,"Ohio","Henry County",2,4,333,182,151
050,39,069,"Ohio","Henry County",2,5,329,176,153
050,39,069,"Ohio","Henry County",2,6,332,163,169
050,39,069,"Ohio","Henry County",2,7,358,164,194
050,39,069,"Ohio","Henry County",2,8,360,179,181
050,39,069,"Ohio","Henry County",2,9,360,180,180
050,39,069,"Ohio","Henry County",2,10,368,186,182
050,39,069,"Ohio","Henry County",2,11,386,196,190
050,39,069,"Ohio","Henry County",2,12,396,204,192
050,39,069,"Ohio","Henry County",2,13,405,218,187
050,39,069,"Ohio","Henry County",2,14,405,208,197
050,39,069,"Ohio","Henry County",2,15,400,207,193
050,39,069,"Ohio","Henry County",2,16,389,199,190
050,39,069,"Ohio","Henry County",2,17,399,205,194
050,39,069,"Ohio","Henry County",2,18,336,177,159
050,39,069,"Ohio","Henry County",2,19,268,142,126
050,39,069,"Ohio","Henry County",2,20,283,150,133
050,39,069,"Ohio","Henry County",2,21,286,149,137
050,39,069,"Ohio","Henry County",2,22,305,158,147
050,39,069,"Ohio","Henry County",2,23,306,158,148
050,39,069,"Ohio","Henry County",2,24,284,152,132
050,39,069,"Ohio","Henry County",2,25,277,145,132
050,39,069,"Ohio","Henry County",2,26,293,149,144
050,39,069,"Ohio","Henry County",2,27,316,157,159
050,39,069,"Ohio","Henry County",2,28,338,174,164
050,39,069,"Ohio","Henry County",2,29,344,177,167
050,39,069,"Ohio","Henry County",2,30,331,169,162
050,39,069,"Ohio","Henry County",2,31,316,161,155
050,39,069,"Ohio","Henry County",2,32,294,146,148
050,39,069,"Ohio","Henry County",2,33,308,151,157
050,39,069,"Ohio","Henry County",2,34,335,156,179
050,39,069,"Ohio","Henry County",2,35,333,153,180
050,39,069,"Ohio","Henry County",2,36,305,142,163
050,39,069,"Ohio","Henry County",2,37,318,149,169
050,39,069,"Ohio","Henry County",2,38,330,160,170
050,39,069,"Ohio","Henry County",2,39,350,174,176
050,39,069,"Ohio","Henry County",2,40,355,180,175
050,39,069,"Ohio","Henry County",2,41,343,179,164
050,39,069,"Ohio","Henry County",2,42,335,174,161
050,39,069,"Ohio","Henry County",2,43,318,163,155
050,39,069,"Ohio","Henry County",2,44,312,161,151
050,39,069,"Ohio","Henry County",2,45,335,159,176
050,39,069,"Ohio","Henry County",2,46,333,166,167
050,39,069,"Ohio","Henry County",2,47,315,165,150
050,39,069,"Ohio","Henry County",2,48,331,171,160
050,39,069,"Ohio","Henry County",2,49,364,187,177
050,39,069,"Ohio","Henry County",2,50,356,190,166
050,39,069,"Ohio","Henry County",2,51,345,185,160
050,39,069,"Ohio","Henry County",2,52,351,180,171
050,39,069,"Ohio","Henry County",2,53,353,165,188
050,39,069,"Ohio","Henry County",2,54,353,174,179
050,39,069,"Ohio","Henry County",2,55,369,188,181
050,39,069,"Ohio","Henry County",2,56,385,196,189
050,39,069,"Ohio","Henry County",2,57,396,196,200
050,39,069,"Ohio","Henry County",2,58,398,197,201
050,39,069,"Ohio","Henry County",2,59,418,215,203
050,39,069,"Ohio","Henry County",2,60,418,219,199
050,39,069,"Ohio","Henry County",2,61,379,190,189
050,39,069,"Ohio","Henry County",2,62,410,207,203
050,39,069,"Ohio","Henry County",2,63,423,225,198
050,39,069,"Ohio","Henry County",2,64,408,218,190
050,39,069,"Ohio","Henry County",2,65,391,196,195
050,39,069,"Ohio","Henry County",2,66,357,166,191
050,39,069,"Ohio","Henry County",2,67,340,156,184
050,39,069,"Ohio","Henry County",2,68,326,157,169
050,39,069,"Ohio","Henry County",2,69,309,157,152
050,39,069,"Ohio","Henry County",2,70,283,143,140
050,39,069,"Ohio","Henry County",2,71,277,138,139
050,39,069,"Ohio","Henry County",2,72,264,125,139
050,39,069,"Ohio","Henry County",2,73,282,136,146
050,39,069,"Ohio","Henry County",2,74,190,93,97
050,39,069,"Ohio","Henry County",2,75,180,87,93
050,39,069,"Ohio","Henry County",2,76,186,86,100
050,39,069,"Ohio","Henry County",2,77,191,86,105
050,39,069,"Ohio","Henry County",2,78,156,64,92
050,39,069,"Ohio","Henry County",2,79,148,64,84
050,39,069,"Ohio","Henry County",2,80,156,66,90
050,39,069,"Ohio","Henry County",2,81,137,62,75
050,39,069,"Ohio","Henry County",2,82,130,60,70
050,39,069,"Ohio","Henry County",2,83,112,53,59
050,39,069,"Ohio","Henry County",2,84,115,46,69
050,39,069,"Ohio","Henry County",2,85,659,239,420
050,39,069,"Ohio","Henry County",3,0,292,145,147
050,39,069,"Ohio","Henry County",3,1,323,157,166
050,39,069,"Ohio","Henry County",3,2,313,151,162
050,39,069,"Ohio","Henry County",3,3,342,167,175
050,39,069,"Ohio","Henry County",3,4,339,171,168
050,39,069,"Ohio","Henry County",3,5,335,185,150
050,39,069,"Ohio","Henry County",3,6,329,174,155
050,39,069,"Ohio","Henry County",3,7,323,158,165
050,39,069,"Ohio","Henry County",3,8,355,170,185
050,39,069,"Ohio","Henry County",3,9,366,186,180
050,39,069,"Ohio","Henry County",3,10,350,181,169
050,39,069,"Ohio","Henry County",3,11,367,173,194
050,39,069,"Ohio","Henry County",3,12,388,198,190
050,39,069,"Ohio","Henry County",3,13,398,210,188
050,39,069,"Ohio","Henry County",3,14,400,209,191
050,39,069,"Ohio","Henry County",3,15,415,219,196
050,39,069,"Ohio","Henry County",3,16,394,200,194
050,39,069,"Ohio","Henry County",3,17,388,194,194
050,39,069,"Ohio","Henry County",3,18,319,167,152
050,39,069,"Ohio","Henry County",3,19,261,139,122
050,39,069,"Ohio","Henry County",3,20,305,157,148
050,39,069,"Ohio","Henry County",3,21,295,157,138
050,39,069,"Ohio","Henry County",3,22,301,155,146
050,39,069,"Ohio","Henry County",3,23,297,162,135
050,39,069,"Ohio","Henry County",3,24,303,155,148
050,39,069,"Ohio","Henry County",3,25,273,149,124
050,39,069,"Ohio","Henry County",3,26,298,163,135
050,39,069,"Ohio","Henry County",3,27,292,147,145
050,39,069,"Ohio","Henry County",3,28,323,162,161
050,39,069,"Ohio","Henry County",3,29,339,171,168
050,39,069,"Ohio","Henry County",3,30,362,191,171
050,39,069,"Ohio","Henry County",3,31,336,174,162
050,39,069,"Ohio","Henry County",3,32,316,162,154
050,39,069,"Ohio","Henry County",3,33,296,151,145
050,39,069,"Ohio","Henry County",3,34,307,147,160
050,39,069,"Ohio","Henry County",3,35,341,156,185
050,39,069,"Ohio","Henry County",3,36,331,155,176
050,39,069,"Ohio","Henry County",3,37,304,145,159
050,39,069,"Ohio","Henry County",3,38,323,158,165
050,39,069,"Ohio","Henry County",3,39,340,160,180
050,39,069,"Ohio","Henry County",3,40,346,171,175
050,39,069,"Ohio","Henry County",3,41,362,182,180
050,39,069,"Ohio","Henry County",3,42,349,176,173
050,39,069,"Ohio","Henry County",3,43,340,178,162
050,39,069,"Ohio","Henry County",3,44,312,162,150
050,39,069,"Ohio","Henry County",3,45,313,165,148
050,39,069,"Ohio","Henry County",3,46,337,162,175
050,39,069,"Ohio","Henry County",3,47,335,167,168
050,39,069,"Ohio","Henry County",3,48,308,164,144
050,39,069,"Ohio","Henry County",3,49,328,169,159
050,39,069,"Ohio","Henry County",3,50,365,190,175
050,39,069,"Ohio","Henry County",3,51,355,192,163
050,39,069,"Ohio","Henry County",3,52,338,182,156
050,39,069,"Ohio","Henry County",3,53,346,175,171
050,39,069,"Ohio","Henry County",3,54,345,165,180
050,39,069,"Ohio","Henry County",3,55,350,178,172
050,39,069,"Ohio","Henry County",3,56,364,180,184
050,39,069,"Ohio","Henry County",3,57,374,186,188
050,39,069,"Ohio","Henry County",3,58,389,194,195
050,39,069,"Ohio","Henry County",3,59,399,195,204
050,39,069,"Ohio","Henry County",3,60,411,211,200
050,39,069,"Ohio","Henry County",3,61,412,216,196
050,39,069,"Ohio","Henry County",3,62,380,189,191
050,39,069,"Ohio","Henry County",3,63,403,200,203
050,39,069,"Ohio","Henry County",3,64,432,229,203
050,39,069,"Ohio","Henry County",3,65,409,217,192
050,39,069,"Ohio","Henry County",3,66,380,189,191
050,39,069,"Ohio","Henry County",3,67,348,165,183
050,39,069,"Ohio","Henry County",3,68,336,152,184
050,39,069,"Ohio","Henry County",3,69,310,150,160
050,39,069,"Ohio","Henry County",3,70,304,152,152
050,39,069,"Ohio","Henry County",3,71,279,139,140
050,39,069,"Ohio","Henry County",3,72,271,133,138
050,39,069,"Ohio","Henry County",3,73,261,126,135
050,39,069,"Ohio","Henry County",3,74,265,126,139
050,39,069,"Ohio","Henry County",3,75,188,90,98
050,39,069,"Ohio","Henry County",3,76,171,82,89
050,39,069,"Ohio","Henry County",3,77,173,82,91
050,39,069,"Ohio","Henry County",3,78,178,78,100
050,39,069,"Ohio","Henry County",3,79,147,62,85
050,39,069,"Ohio","Henry County",3,80,143,57,86
050,39,069,"Ohio","Henry County",3,81,143,57,86
050,39,069,"Ohio","Henry County",3,82,124,54,70
050,39,069,"Ohio","Henry County",3,83,110,48,62
050,39,069,"Ohio","Henry County",3,84,116,49,67
050,39,069,"Ohio","Henry County",3,85,632,221,411
050,39,069,"Ohio","Henry County",4,0,298,145,153
050,39,069,"Ohio","Henry County",4,1,289,152,137
050,39,069,"Ohio","Henry County",4,2,324,161,163
050,39,069,"Ohio","Henry County",4,3,320,153,167
050,39,069,"Ohio","Henry County",4,4,348,173,175
050,39,069,"Ohio","Henry County",4,5,335,170,165
050,39,069,"Ohio","Henry County",4,6,345,193,152
050,39,069,"Ohio","Henry County",4,7,323,171,152
050,39,069,"Ohio","Henry County",4,8,329,160,169
050,39,069,"Ohio","Henry County",4,9,365,176,189
050,39,069,"Ohio","Henry County",4,10,367,186,181
050,39,069,"Ohio","Henry County",4,11,359,183,176
050,39,069,"Ohio","Henry County",4,12,363,177,186
050,39,069,"Ohio","Henry County",4,13,397,206,191
050,39,069,"Ohio","Henry County",4,14,397,211,186
050,39,069,"Ohio","Henry County",4,15,411,217,194
050,39,069,"Ohio","Henry County",4,16,418,219,199
050,39,069,"Ohio","Henry County",4,17,399,205,194
050,39,069,"Ohio","Henry County",4,18,330,177,153
050,39,069,"Ohio","Henry County",4,19,254,135,119
050,39,069,"Ohio","Henry County",4,20,278,139,139
050,39,069,"Ohio","Henry County",4,21,310,159,151
050,39,069,"Ohio","Henry County",4,22,301,160,141
050,39,069,"Ohio","Henry County",4,23,303,160,143
050,39,069,"Ohio","Henry County",4,24,287,151,136
050,39,069,"Ohio","Henry County",4,25,298,158,140
050,39,069,"Ohio","Henry County",4,26,279,153,126
050,39,069,"Ohio","Henry County",4,27,298,162,136
050,39,069,"Ohio","Henry County",4,28,298,153,145
050,39,069,"Ohio","Henry County",4,29,325,162,163
050,39,069,"Ohio","Henry County",4,30,338,172,166
050,39,069,"Ohio","Henry County",4,31,358,183,175
050,39,069,"Ohio","Henry County",4,32,331,169,162
050,39,069,"Ohio","Henry County",4,33,322,171,151
050,39,069,"Ohio","Henry County",4,34,307,161,146
050,39,069,"Ohio","Henry County",4,35,309,153,156
050,39,069,"Ohio","Henry County",4,36,335,152,183
050,39,069,"Ohio","Henry County",4,37,326,151,175
050,39,069,"Ohio","Henry County",4,38,301,144,157
050,39,069,"Ohio","Henry County",4,39,328,161,167
050,39,069,"Ohio","Henry County",4,40,345,158,187
050,39,069,"Ohio","Henry County",4,41,346,168,178
050,39,069,"Ohio","Henry County",4,42,372,184,188
050,39,069,"Ohio","Henry County",4,43,346,180,166
050,39,069,"Ohio","Henry County",4,44,342,175,167
050,39,069,"Ohio","Henry County",4,45,323,162,161
050,39,069,"Ohio","Henry County",4,46,312,164,148
050,39,069,"Ohio","Henry County",4,47,342,163,179
050,39,069,"Ohio","Henry County",4,48,332,173,159
050,39,069,"Ohio","Henry County",4,49,313,165,148
050,39,069,"Ohio","Henry County",4,50,323,169,154
050,39,069,"Ohio","Henry County",4,51,366,191,175
050,39,069,"Ohio","Henry County",4,52,359,196,163
050,39,069,"Ohio","Henry County",4,53,330,177,153
050,39,069,"Ohio","Henry County",4,54,350,177,173
050,39,069,"Ohio","Henry County",4,55,350,169,181
050,39,069,"Ohio","Henry County",4,56,347,175,172
050,39,069,"Ohio","Henry County",4,57,361,174,187
050,39,069,"Ohio","Henry County",4,58,370,186,184
050,39,069,"Ohio","Henry County",4,59,392,197,195
050,39,069,"Ohio","Henry County",4,60,394,192,202
050,39,069,"Ohio","Henry County",4,61,404,207,197
050,39,069,"Ohio","Henry County",4,62,413,214,199
050,39,069,"Ohio","Henry County",4,63,375,186,189
050,39,069,"Ohio","Henry County",4,64,399,200,199
050,39,069,"Ohio","Henry County",4,65,422,221,201
050,39,069,"Ohio","Henry County",4,66,403,213,190
050,39,069,"Ohio","Henry County",4,67,368,185,183
050,39,069,"Ohio","Henry County",4,68,336,158,178
050,39,069,"Ohio","Henry County",4,69,321,142,179
050,39,069,"Ohio","Henry County",4,70,295,138,157
050,39,069,"Ohio","Henry County",4,71,302,153,149
050,39,069,"Ohio","Henry County",4,72,271,136,135
050,39,069,"Ohio","Henry County",4,73,268,130,138
050,39,069,"Ohio","Henry County",4,74,252,119,133
050,39,069,"Ohio","Henry County",4,75,260,122,138
050,39,069,"Ohio","Henry County",4,76,181,87,94
050,39,069,"Ohio","Henry County",4,77,164,80,84
050,39,069,"Ohio","Henry County",4,78,163,76,87
050,39,069,"Ohio","Henry County",4,79,171,75,96
050,39,069,"Ohio","Henry County",4,80,145,59,86
050,39,069,"Ohio","Henry County",4,81,132,52,80
050,39,069,"Ohio","Henry County",4,82,122,48,74
050,39,069,"Ohio","Henry County",4,83,106,47,59
050,39,069,"Ohio","Henry County",4,84,112,44,68
050,39,069,"Ohio","Henry County",4,85,623,219,404
050,39,069,"Ohio","Henry County",5,0,302,147,155
050,39,069,"Ohio","Henry County",5,1,295,140,155
050,39,069,"Ohio","Henry County",5,2,303,159,144
050,39,069,"Ohio","Henry County",5,3,328,164,164
050,39,069,"Ohio","Henry County",5,4,314,147,167
050,39,069,"Ohio","Henry County",5,5,361,185,176
050,39,069,"Ohio","Henry County",5,6,342,174,168
050,39,069,"Ohio","Henry County",5,7,351,193,158
050,39,069,"Ohio","Henry County",5,8,332,170,162
050,39,069,"Ohio","Henry County",5,9,331,161,170
050,39,069,"Ohio","Henry County",5,10,370,182,188
050,39,069,"Ohio","Henry County",5,11,369,196,173
050,39,069,"Ohio","Henry County",5,12,356,180,176
050,39,069,"Ohio","Henry County",5,13,363,175,188
050,39,069,"Ohio","Henry County",5,14,385,197,188
050,39,069,"Ohio","Henry County",5,15,400,210,190
050,39,069,"Ohio","Henry County",5,16,408,213,195
050,39,069,"Ohio","Henry County",5,17,418,217,201
050,39,069,"Ohio","Henry County",5,18,321,168,153
050,39,069,"Ohio","Henry County",5,19,256,130,126
050,39,069,"Ohio","Henry County",5,20,276,137,139
050,39,069,"Ohio","Henry County",5,21,297,156,141
050,39,069,"Ohio","Henry County",5,22,330,170,160
050,39,069,"Ohio","Henry County",5,23,300,166,134
050,39,069,"Ohio","Henry County",5,24,305,159,146
050,39,069,"Ohio","Henry County",5,25,288,147,141
050,39,069,"Ohio","Henry County",5,26,304,170,134
050,39,069,"Ohio","Henry County",5,27,283,153,130
050,39,069,"Ohio","Henry County",5,28,305,165,140
050,39,069,"Ohio","Henry County",5,29,307,156,151
050,39,069,"Ohio","Henry County",5,30,332,169,163
050,39,069,"Ohio","Henry County",5,31,325,161,164
050,39,069,"Ohio","Henry County",5,32,357,184,173
050,39,069,"Ohio","Henry County",5,33,333,166,167
050,39,069,"Ohio","Henry County",5,34,334,181,153
050,39,069,"Ohio","Henry County",5,35,326,172,154
050,39,069,"Ohio","Henry County",5,36,314,156,158
050,39,069,"Ohio","Henry County",5,37,338,156,182
050,39,069,"Ohio","Henry County",5,38,327,151,176
050,39,069,"Ohio","Henry County",5,39,300,149,151
050,39,069,"Ohio","Henry County",5,40,326,165,161
050,39,069,"Ohio","Henry County",5,41,345,159,186
050,39,069,"Ohio","Henry County",5,42,347,166,181
050,39,069,"Ohio","Henry County",5,43,359,176,183
050,39,069,"Ohio","Henry County",5,44,344,177,167
050,39,069,"Ohio","Henry County",5,45,339,174,165
050,39,069,"Ohio","Henry County",5,46,317,160,157
050,39,069,"Ohio","Henry County",5,47,323,166,157
050,39,069,"Ohio","Henry County",5,48,339,166,173
050,39,069,"Ohio","Henry County",5,49,334,174,160
050,39,069,"Ohio","Henry County",5,50,321,168,153
050,39,069,"Ohio","Henry County",5,51,323,170,153
050,39,069,"Ohio","Henry County",5,52,367,195,172
050,39,069,"Ohio","Henry County",5,53,352,189,163
050,39,069,"Ohio","Henry County",5,54,325,172,153
050,39,069,"Ohio","Henry County",5,55,339,172,167
050,39,069,"Ohio","Henry County",5,56,351,168,183
050,39,069,"Ohio","Henry County",5,57,340,165,175
050,39,069,"Ohio","Henry County",5,58,356,172,184
050,39,069,"Ohio","Henry County",5,59,367,187,180
050,39,069,"Ohio","Henry County",5,60,385,193,192
050,39,069,"Ohio","Henry County",5,61,383,190,193
050,39,069,"Ohio","Henry County",5,62,405,206,199
050,39,069,"Ohio","Henry County",5,63,415,213,202
050,39,069,"Ohio","Henry County",5,64,383,187,196
050,39,069,"Ohio","Henry County",5,65,394,198,196
050,39,069,"Ohio","Henry County",5,66,406,215,191
050,39,069,"Ohio","Henry County",5,67,385,204,181
050,39,069,"Ohio","Henry County",5,68,365,179,186
050,39,069,"Ohio","Henry County",5,69,334,157,177
050,39,069,"Ohio","Henry County",5,70,309,135,174
050,39,069,"Ohio","Henry County",5,71,296,141,155
050,39,069,"Ohio","Henry County",5,72,294,149,145
050,39,069,"Ohio","Henry County",5,73,266,134,132
050,39,069,"Ohio","Henry County",5,74,259,129,130
050,39,069,"Ohio","Henry County",5,75,251,117,134
050,39,069,"Ohio","Henry County",5,76,252,117,135
050,39,069,"Ohio","Henry County",5,77,170,83,87
050,39,069,"Ohio","Henry County",5,78,157,74,83
050,39,069,"Ohio","Henry County",5,79,153,73,80
050,39,069,"Ohio","Henry County",5,80,166,66,100
050,39,069,"Ohio","Henry County",5,81,132,54,78
050,39,069,"Ohio","Henry County",5,82,116,45,71
050,39,069,"Ohio","Henry County",5,83,107,40,67
050,39,069,"Ohio","Henry County",5,84,109,42,67
050,39,069,"Ohio","Henry County",5,85,628,221,407
050,39,071,"Ohio","Highland County",1,0,543,279,264
050,39,071,"Ohio","Highland County",1,1,555,282,273
050,39,071,"Ohio","Highland County",1,2,561,289,272
050,39,071,"Ohio","Highland County",1,3,540,270,270
050,39,071,"Ohio","Highland County",1,4,555,271,284
050,39,071,"Ohio","Highland County",1,5,542,259,283
050,39,071,"Ohio","Highland County",1,6,555,299,256
050,39,071,"Ohio","Highland County",1,7,561,283,278
050,39,071,"Ohio","Highland County",1,8,529,272,257
050,39,071,"Ohio","Highland County",1,9,560,310,250
050,39,071,"Ohio","Highland County",1,10,565,275,290
050,39,071,"Ohio","Highland County",1,11,572,289,283
050,39,071,"Ohio","Highland County",1,12,598,289,309
050,39,071,"Ohio","Highland County",1,13,639,323,316
050,39,071,"Ohio","Highland County",1,14,617,298,319
050,39,071,"Ohio","Highland County",1,15,601,300,301
050,39,071,"Ohio","Highland County",1,16,633,320,313
050,39,071,"Ohio","Highland County",1,17,634,337,297
050,39,071,"Ohio","Highland County",1,18,536,295,241
050,39,071,"Ohio","Highland County",1,19,410,215,195
050,39,071,"Ohio","Highland County",1,20,432,208,224
050,39,071,"Ohio","Highland County",1,21,456,217,239
050,39,071,"Ohio","Highland County",1,22,461,250,211
050,39,071,"Ohio","Highland County",1,23,478,260,218
050,39,071,"Ohio","Highland County",1,24,482,228,254
050,39,071,"Ohio","Highland County",1,25,475,236,239
050,39,071,"Ohio","Highland County",1,26,481,254,227
050,39,071,"Ohio","Highland County",1,27,504,250,254
050,39,071,"Ohio","Highland County",1,28,503,250,253
050,39,071,"Ohio","Highland County",1,29,533,258,275
050,39,071,"Ohio","Highland County",1,30,518,254,264
050,39,071,"Ohio","Highland County",1,31,458,235,223
050,39,071,"Ohio","Highland County",1,32,496,231,265
050,39,071,"Ohio","Highland County",1,33,464,231,233
050,39,071,"Ohio","Highland County",1,34,476,246,230
050,39,071,"Ohio","Highland County",1,35,463,245,218
050,39,071,"Ohio","Highland County",1,36,466,234,232
050,39,071,"Ohio","Highland County",1,37,500,239,261
050,39,071,"Ohio","Highland County",1,38,533,267,266
050,39,071,"Ohio","Highland County",1,39,539,278,261
050,39,071,"Ohio","Highland County",1,40,542,273,269
050,39,071,"Ohio","Highland County",1,41,513,261,252
050,39,071,"Ohio","Highland County",1,42,524,267,257
050,39,071,"Ohio","Highland County",1,43,511,243,268
050,39,071,"Ohio","Highland County",1,44,489,246,243
050,39,071,"Ohio","Highland County",1,45,477,251,226
050,39,071,"Ohio","Highland County",1,46,530,271,259
050,39,071,"Ohio","Highland County",1,47,535,263,272
050,39,071,"Ohio","Highland County",1,48,566,281,285
050,39,071,"Ohio","Highland County",1,49,617,313,304
050,39,071,"Ohio","Highland County",1,50,595,298,297
050,39,071,"Ohio","Highland County",1,51,577,298,279
050,39,071,"Ohio","Highland County",1,52,585,306,279
050,39,071,"Ohio","Highland County",1,53,576,285,291
050,39,071,"Ohio","Highland County",1,54,560,280,280
050,39,071,"Ohio","Highland County",1,55,574,290,284
050,39,071,"Ohio","Highland County",1,56,615,299,316
050,39,071,"Ohio","Highland County",1,57,606,298,308
050,39,071,"Ohio","Highland County",1,58,601,297,304
050,39,071,"Ohio","Highland County",1,59,570,274,296
050,39,071,"Ohio","Highland County",1,60,619,291,328
050,39,071,"Ohio","Highland County",1,61,625,317,308
050,39,071,"Ohio","Highland County",1,62,642,325,317
050,39,071,"Ohio","Highland County",1,63,623,317,306
050,39,071,"Ohio","Highland County",1,64,589,286,303
050,39,071,"Ohio","Highland County",1,65,566,264,302
050,39,071,"Ohio","Highland County",1,66,545,273,272
050,39,071,"Ohio","Highland County",1,67,523,253,270
050,39,071,"Ohio","Highland County",1,68,480,228,252
050,39,071,"Ohio","Highland County",1,69,473,227,246
050,39,071,"Ohio","Highland County",1,70,499,238,261
050,39,071,"Ohio","Highland County",1,71,473,220,253
050,39,071,"Ohio","Highland County",1,72,455,212,243
050,39,071,"Ohio","Highland County",1,73,448,209,239
050,39,071,"Ohio","Highland County",1,74,317,149,168
050,39,071,"Ohio","Highland County",1,75,316,148,168
050,39,071,"Ohio","Highland County",1,76,308,138,170
050,39,071,"Ohio","Highland County",1,77,316,152,164
050,39,071,"Ohio","Highland County",1,78,269,130,139
050,39,071,"Ohio","Highland County",1,79,236,104,132
050,39,071,"Ohio","Highland County",1,80,210,97,113
050,39,071,"Ohio","Highland County",1,81,200,91,109
050,39,071,"Ohio","Highland County",1,82,201,89,112
050,39,071,"Ohio","Highland County",1,83,168,68,100
050,39,071,"Ohio","Highland County",1,84,152,66,86
050,39,071,"Ohio","Highland County",1,85,873,323,550
050,39,071,"Ohio","Highland County",2,0,535,274,261
050,39,071,"Ohio","Highland County",2,1,551,280,271
050,39,071,"Ohio","Highland County",2,2,558,287,271
050,39,071,"Ohio","Highland County",2,3,546,275,271
050,39,071,"Ohio","Highland County",2,4,558,272,286
050,39,071,"Ohio","Highland County",2,5,548,264,284
050,39,071,"Ohio","Highland County",2,6,557,290,267
050,39,071,"Ohio","Highland County",2,7,561,286,275
050,39,071,"Ohio","Highland County",2,8,536,273,263
050,39,071,"Ohio","Highland County",2,9,551,300,251
050,39,071,"Ohio","Highland County",2,10,563,284,279
050,39,071,"Ohio","Highland County",2,11,570,284,286
050,39,071,"Ohio","Highland County",2,12,598,292,306
050,39,071,"Ohio","Highland County",2,13,630,315,315
050,39,071,"Ohio","Highland County",2,14,623,304,319
050,39,071,"Ohio","Highland County",2,15,609,303,306
050,39,071,"Ohio","Highland County",2,16,627,317,310
050,39,071,"Ohio","Highland County",2,17,632,331,301
050,39,071,"Ohio","Highland County",2,18,532,293,239
050,39,071,"Ohio","Highland County",2,19,415,221,194
050,39,071,"Ohio","Highland County",2,20,442,214,228
050,39,071,"Ohio","Highland County",2,21,454,218,236
050,39,071,"Ohio","Highland County",2,22,466,245,221
050,39,071,"Ohio","Highland County",2,23,479,259,220
050,39,071,"Ohio","Highland County",2,24,481,238,243
050,39,071,"Ohio","Highland County",2,25,480,236,244
050,39,071,"Ohio","Highland County",2,26,482,250,232
050,39,071,"Ohio","Highland County",2,27,497,250,247
050,39,071,"Ohio","Highland County",2,28,505,251,254
050,39,071,"Ohio","Highland County",2,29,523,255,268
050,39,071,"Ohio","Highland County",2,30,524,255,269
050,39,071,"Ohio","Highland County",2,31,477,241,236
050,39,071,"Ohio","Highland County",2,32,487,232,255
050,39,071,"Ohio","Highland County",2,33,474,233,241
050,39,071,"Ohio","Highland County",2,34,475,246,229
050,39,071,"Ohio","Highland County",2,35,468,244,224
050,39,071,"Ohio","Highland County",2,36,463,235,228
050,39,071,"Ohio","Highland County",2,37,495,241,254
050,39,071,"Ohio","Highland County",2,38,528,263,265
050,39,071,"Ohio","Highland County",2,39,536,273,263
050,39,071,"Ohio","Highland County",2,40,549,280,269
050,39,071,"Ohio","Highland County",2,41,523,264,259
050,39,071,"Ohio","Highland County",2,42,519,264,255
050,39,071,"Ohio","Highland County",2,43,523,253,270
050,39,071,"Ohio","Highland County",2,44,486,243,243
050,39,071,"Ohio","Highland County",2,45,483,251,232
050,39,071,"Ohio","Highland County",2,46,514,263,251
050,39,071,"Ohio","Highland County",2,47,531,262,269
050,39,071,"Ohio","Highland County",2,48,559,277,282
050,39,071,"Ohio","Highland County",2,49,606,308,298
050,39,071,"Ohio","Highland County",2,50,604,303,301
050,39,071,"Ohio","Highland County",2,51,583,300,283
050,39,071,"Ohio","Highland County",2,52,582,303,279
050,39,071,"Ohio","Highland County",2,53,578,290,288
050,39,071,"Ohio","Highland County",2,54,563,280,283
050,39,071,"Ohio","Highland County",2,55,569,284,285
050,39,071,"Ohio","Highland County",2,56,609,299,310
050,39,071,"Ohio","Highland County",2,57,612,302,310
050,39,071,"Ohio","Highland County",2,58,601,298,303
050,39,071,"Ohio","Highland County",2,59,580,280,300
050,39,071,"Ohio","Highland County",2,60,606,289,317
050,39,071,"Ohio","Highland County",2,61,619,308,311
050,39,071,"Ohio","Highland County",2,62,638,322,316
050,39,071,"Ohio","Highland County",2,63,633,321,312
050,39,071,"Ohio","Highland County",2,64,589,288,301
050,39,071,"Ohio","Highland County",2,65,569,267,302
050,39,071,"Ohio","Highland County",2,66,548,268,280
050,39,071,"Ohio","Highland County",2,67,523,254,269
050,39,071,"Ohio","Highland County",2,68,487,232,255
050,39,071,"Ohio","Highland County",2,69,474,228,246
050,39,071,"Ohio","Highland County",2,70,491,233,258
050,39,071,"Ohio","Highland County",2,71,475,221,254
050,39,071,"Ohio","Highland County",2,72,448,210,238
050,39,071,"Ohio","Highland County",2,73,472,219,253
050,39,071,"Ohio","Highland County",2,74,326,151,175
050,39,071,"Ohio","Highland County",2,75,317,148,169
050,39,071,"Ohio","Highland County",2,76,307,140,167
050,39,071,"Ohio","Highland County",2,77,318,149,169
050,39,071,"Ohio","Highland County",2,78,271,130,141
050,39,071,"Ohio","Highland County",2,79,240,108,132
050,39,071,"Ohio","Highland County",2,80,213,98,115
050,39,071,"Ohio","Highland County",2,81,195,87,108
050,39,071,"Ohio","Highland County",2,82,200,87,113
050,39,071,"Ohio","Highland County",2,83,169,71,98
050,39,071,"Ohio","Highland County",2,84,149,65,84
050,39,071,"Ohio","Highland County",2,85,872,320,552
050,39,071,"Ohio","Highland County",3,0,505,280,225
050,39,071,"Ohio","Highland County",3,1,552,269,283
050,39,071,"Ohio","Highland County",3,2,562,283,279
050,39,071,"Ohio","Highland County",3,3,580,287,293
050,39,071,"Ohio","Highland County",3,4,555,277,278
050,39,071,"Ohio","Highland County",3,5,567,276,291
050,39,071,"Ohio","Highland County",3,6,544,268,276
050,39,071,"Ohio","Highland County",3,7,576,304,272
050,39,071,"Ohio","Highland County",3,8,576,293,283
050,39,071,"Ohio","Highland County",3,9,541,276,265
050,39,071,"Ohio","Highland County",3,10,569,315,254
050,39,071,"Ohio","Highland County",3,11,562,285,277
050,39,071,"Ohio","Highland County",3,12,578,298,280
050,39,071,"Ohio","Highland County",3,13,587,294,293
050,39,071,"Ohio","Highland County",3,14,625,312,313
050,39,071,"Ohio","Highland County",3,15,631,309,322
050,39,071,"Ohio","Highland County",3,16,607,303,304
050,39,071,"Ohio","Highland County",3,17,617,311,306
050,39,071,"Ohio","Highland County",3,18,537,306,231
050,39,071,"Ohio","Highland County",3,19,422,241,181
050,39,071,"Ohio","Highland County",3,20,443,236,207
050,39,071,"Ohio","Highland County",3,21,450,222,228
050,39,071,"Ohio","Highland County",3,22,476,228,248
050,39,071,"Ohio","Highland County",3,23,480,254,226
050,39,071,"Ohio","Highland County",3,24,463,256,207
050,39,071,"Ohio","Highland County",3,25,483,233,250
050,39,071,"Ohio","Highland County",3,26,487,240,247
050,39,071,"Ohio","Highland County",3,27,497,256,241
050,39,071,"Ohio","Highland County",3,28,505,257,248
050,39,071,"Ohio","Highland County",3,29,500,248,252
050,39,071,"Ohio","Highland County",3,30,513,246,267
050,39,071,"Ohio","Highland County",3,31,527,262,265
050,39,071,"Ohio","Highland County",3,32,481,241,240
050,39,071,"Ohio","Highland County",3,33,490,232,258
050,39,071,"Ohio","Highland County",3,34,483,235,248
050,39,071,"Ohio","Highland County",3,35,486,247,239
050,39,071,"Ohio","Highland County",3,36,472,240,232
050,39,071,"Ohio","Highland County",3,37,468,244,224
050,39,071,"Ohio","Highland County",3,38,502,249,253
050,39,071,"Ohio","Highland County",3,39,520,260,260
050,39,071,"Ohio","Highland County",3,40,544,283,261
050,39,071,"Ohio","Highland County",3,41,564,288,276
050,39,071,"Ohio","Highland County",3,42,516,258,258
050,39,071,"Ohio","Highland County",3,43,521,262,259
050,39,071,"Ohio","Highland County",3,44,514,255,259
050,39,071,"Ohio","Highland County",3,45,485,241,244
050,39,071,"Ohio","Highland County",3,46,481,249,232
050,39,071,"Ohio","Highland County",3,47,505,258,247
050,39,071,"Ohio","Highland County",3,48,536,265,271
050,39,071,"Ohio","Highland County",3,49,560,278,282
050,39,071,"Ohio","Highland County",3,50,612,304,308
050,39,071,"Ohio","Highland County",3,51,611,309,302
050,39,071,"Ohio","Highland County",3,52,583,295,288
050,39,071,"Ohio","Highland County",3,53,583,306,277
050,39,071,"Ohio","Highland County",3,54,579,291,288
050,39,071,"Ohio","Highland County",3,55,564,279,285
050,39,071,"Ohio","Highland County",3,56,559,275,284
050,39,071,"Ohio","Highland County",3,57,602,298,304
050,39,071,"Ohio","Highland County",3,58,596,291,305
050,39,071,"Ohio","Highland County",3,59,595,295,300
050,39,071,"Ohio","Highland County",3,60,578,278,300
050,39,071,"Ohio","Highland County",3,61,599,283,316
050,39,071,"Ohio","Highland County",3,62,630,312,318
050,39,071,"Ohio","Highland County",3,63,646,327,319
050,39,071,"Ohio","Highland County",3,64,635,326,309
050,39,071,"Ohio","Highland County",3,65,576,279,297
050,39,071,"Ohio","Highland County",3,66,545,256,289
050,39,071,"Ohio","Highland County",3,67,535,263,272
050,39,071,"Ohio","Highland County",3,68,512,246,266
050,39,071,"Ohio","Highland County",3,69,466,221,245
050,39,071,"Ohio","Highland County",3,70,466,220,246
050,39,071,"Ohio","Highland County",3,71,481,226,255
050,39,071,"Ohio","Highland County",3,72,466,215,251
050,39,071,"Ohio","Highland County",3,73,437,200,237
050,39,071,"Ohio","Highland County",3,74,456,206,250
050,39,071,"Ohio","Highland County",3,75,315,148,167
050,39,071,"Ohio","Highland County",3,76,300,139,161
050,39,071,"Ohio","Highland County",3,77,289,131,158
050,39,071,"Ohio","Highland County",3,78,306,141,165
050,39,071,"Ohio","Highland County",3,79,251,118,133
050,39,071,"Ohio","Highland County",3,80,219,107,112
050,39,071,"Ohio","Highland County",3,81,203,92,111
050,39,071,"Ohio","Highland County",3,82,193,83,110
050,39,071,"Ohio","Highland County",3,83,180,80,100
050,39,071,"Ohio","Highland County",3,84,157,68,89
050,39,071,"Ohio","Highland County",3,85,874,322,552
050,39,071,"Ohio","Highland County",4,0,551,304,247
050,39,071,"Ohio","Highland County",4,1,517,285,232
050,39,071,"Ohio","Highland County",4,2,565,274,291
050,39,071,"Ohio","Highland County",4,3,570,293,277
050,39,071,"Ohio","Highland County",4,4,575,283,292
050,39,071,"Ohio","Highland County",4,5,553,274,279
050,39,071,"Ohio","Highland County",4,6,576,283,293
050,39,071,"Ohio","Highland County",4,7,539,260,279
050,39,071,"Ohio","Highland County",4,8,581,306,275
050,39,071,"Ohio","Highland County",4,9,565,288,277
050,39,071,"Ohio","Highland County",4,10,566,284,282
050,39,071,"Ohio","Highland County",4,11,567,312,255
050,39,071,"Ohio","Highland County",4,12,565,281,284
050,39,071,"Ohio","Highland County",4,13,585,306,279
050,39,071,"Ohio","Highland County",4,14,591,299,292
050,39,071,"Ohio","Highland County",4,15,630,317,313
050,39,071,"Ohio","Highland County",4,16,622,300,322
050,39,071,"Ohio","Highland County",4,17,627,317,310
050,39,071,"Ohio","Highland County",4,18,506,258,248
050,39,071,"Ohio","Highland County",4,19,390,213,177
050,39,071,"Ohio","Highland County",4,20,440,245,195
050,39,071,"Ohio","Highland County",4,21,468,245,223
050,39,071,"Ohio","Highland County",4,22,459,224,235
050,39,071,"Ohio","Highland County",4,23,503,247,256
050,39,071,"Ohio","Highland County",4,24,501,255,246
050,39,071,"Ohio","Highland County",4,25,483,267,216
050,39,071,"Ohio","Highland County",4,26,496,244,252
050,39,071,"Ohio","Highland County",4,27,479,242,237
050,39,071,"Ohio","Highland County",4,28,496,252,244
050,39,071,"Ohio","Highland County",4,29,511,259,252
050,39,071,"Ohio","Highland County",4,30,499,254,245
050,39,071,"Ohio","Highland County",4,31,531,252,279
050,39,071,"Ohio","Highland County",4,32,527,255,272
050,39,071,"Ohio","Highland County",4,33,493,246,247
050,39,071,"Ohio","Highland County",4,34,494,235,259
050,39,071,"Ohio","Highland County",4,35,478,244,234
050,39,071,"Ohio","Highland County",4,36,483,247,236
050,39,071,"Ohio","Highland County",4,37,474,241,233
050,39,071,"Ohio","Highland County",4,38,467,241,226
050,39,071,"Ohio","Highland County",4,39,486,234,252
050,39,071,"Ohio","Highland County",4,40,531,265,266
050,39,071,"Ohio","Highland County",4,41,560,291,269
050,39,071,"Ohio","Highland County",4,42,578,295,283
050,39,071,"Ohio","Highland County",4,43,519,263,256
050,39,071,"Ohio","Highland County",4,44,512,256,256
050,39,071,"Ohio","Highland County",4,45,512,252,260
050,39,071,"Ohio","Highland County",4,46,473,231,242
050,39,071,"Ohio","Highland County",4,47,488,255,233
050,39,071,"Ohio","Highland County",4,48,506,255,251
050,39,071,"Ohio","Highland County",4,49,533,264,269
050,39,071,"Ohio","Highland County",4,50,555,274,281
050,39,071,"Ohio","Highland County",4,51,610,308,302
050,39,071,"Ohio","Highland County",4,52,609,305,304
050,39,071,"Ohio","Highland County",4,53,574,297,277
050,39,071,"Ohio","Highland County",4,54,574,301,273
050,39,071,"Ohio","Highland County",4,55,573,284,289
050,39,071,"Ohio","Highland County",4,56,566,281,285
050,39,071,"Ohio","Highland County",4,57,557,274,283
050,39,071,"Ohio","Highland County",4,58,605,302,303
050,39,071,"Ohio","Highland County",4,59,593,289,304
050,39,071,"Ohio","Highland County",4,60,587,294,293
050,39,071,"Ohio","Highland County",4,61,575,276,299
050,39,071,"Ohio","Highland County",4,62,578,271,307
050,39,071,"Ohio","Highland County",4,63,620,306,314
050,39,071,"Ohio","Highland County",4,64,639,323,316
050,39,071,"Ohio","Highland County",4,65,617,320,297
050,39,071,"Ohio","Highland County",4,66,557,269,288
050,39,071,"Ohio","Highland County",4,67,530,251,279
050,39,071,"Ohio","Highland County",4,68,527,253,274
050,39,071,"Ohio","Highland County",4,69,503,249,254
050,39,071,"Ohio","Highland County",4,70,458,210,248
050,39,071,"Ohio","Highland County",4,71,455,215,240
050,39,071,"Ohio","Highland County",4,72,465,222,243
050,39,071,"Ohio","Highland County",4,73,456,210,246
050,39,071,"Ohio","Highland County",4,74,418,185,233
050,39,071,"Ohio","Highland County",4,75,436,198,238
050,39,071,"Ohio","Highland County",4,76,301,139,162
050,39,071,"Ohio","Highland County",4,77,282,127,155
050,39,071,"Ohio","Highland County",4,78,270,121,149
050,39,071,"Ohio","Highland County",4,79,285,132,153
050,39,071,"Ohio","Highland County",4,80,228,109,119
050,39,071,"Ohio","Highland County",4,81,206,98,108
050,39,071,"Ohio","Highland County",4,82,194,83,111
050,39,071,"Ohio","Highland County",4,83,168,74,94
050,39,071,"Ohio","Highland County",4,84,164,72,92
050,39,071,"Ohio","Highland County",4,85,870,320,550
050,39,071,"Ohio","Highland County",5,0,551,302,249
050,39,071,"Ohio","Highland County",5,1,555,316,239
050,39,071,"Ohio","Highland County",5,2,524,287,237
050,39,071,"Ohio","Highland County",5,3,559,266,293
050,39,071,"Ohio","Highland County",5,4,584,304,280
050,39,071,"Ohio","Highland County",5,5,589,288,301
050,39,071,"Ohio","Highland County",5,6,560,267,293
050,39,071,"Ohio","Highland County",5,7,575,280,295
050,39,071,"Ohio","Highland County",5,8,541,263,278
050,39,071,"Ohio","Highland County",5,9,572,311,261
050,39,071,"Ohio","Highland County",5,10,584,300,284
050,39,071,"Ohio","Highland County",5,11,558,273,285
050,39,071,"Ohio","Highland County",5,12,574,320,254
050,39,071,"Ohio","Highland County",5,13,568,278,290
050,39,071,"Ohio","Highland County",5,14,594,312,282
050,39,071,"Ohio","Highland County",5,15,616,320,296
050,39,071,"Ohio","Highland County",5,16,641,319,322
050,39,071,"Ohio","Highland County",5,17,630,301,329
050,39,071,"Ohio","Highland County",5,18,515,271,244
050,39,071,"Ohio","Highland County",5,19,393,204,189
050,39,071,"Ohio","Highland County",5,20,429,240,189
050,39,071,"Ohio","Highland County",5,21,463,246,217
050,39,071,"Ohio","Highland County",5,22,491,252,239
050,39,071,"Ohio","Highland County",5,23,497,247,250
050,39,071,"Ohio","Highland County",5,24,534,257,277
050,39,071,"Ohio","Highland County",5,25,488,246,242
050,39,071,"Ohio","Highland County",5,26,493,265,228
050,39,071,"Ohio","Highland County",5,27,498,245,253
050,39,071,"Ohio","Highland County",5,28,480,238,242
050,39,071,"Ohio","Highland County",5,29,499,253,246
050,39,071,"Ohio","Highland County",5,30,513,266,247
050,39,071,"Ohio","Highland County",5,31,504,251,253
050,39,071,"Ohio","Highland County",5,32,531,255,276
050,39,071,"Ohio","Highland County",5,33,552,267,285
050,39,071,"Ohio","Highland County",5,34,516,248,268
050,39,071,"Ohio","Highland County",5,35,490,236,254
050,39,071,"Ohio","Highland County",5,36,487,252,235
050,39,071,"Ohio","Highland County",5,37,491,247,244
050,39,071,"Ohio","Highland County",5,38,491,258,233
050,39,071,"Ohio","Highland County",5,39,458,239,219
050,39,071,"Ohio","Highland County",5,40,491,233,258
050,39,071,"Ohio","Highland County",5,41,523,264,259
050,39,071,"Ohio","Highland County",5,42,549,287,262
050,39,071,"Ohio","Highland County",5,43,579,295,284
050,39,071,"Ohio","Highland County",5,44,533,271,262
050,39,071,"Ohio","Highland County",5,45,509,253,256
050,39,071,"Ohio","Highland County",5,46,519,249,270
050,39,071,"Ohio","Highland County",5,47,488,248,240
050,39,071,"Ohio","Highland County",5,48,490,253,237
050,39,071,"Ohio","Highland County",5,49,513,264,249
050,39,071,"Ohio","Highland County",5,50,534,255,279
050,39,071,"Ohio","Highland County",5,51,565,286,279
050,39,071,"Ohio","Highland County",5,52,604,309,295
050,39,071,"Ohio","Highland County",5,53,609,305,304
050,39,071,"Ohio","Highland County",5,54,572,292,280
050,39,071,"Ohio","Highland County",5,55,567,298,269
050,39,071,"Ohio","Highland County",5,56,564,278,286
050,39,071,"Ohio","Highland County",5,57,565,284,281
050,39,071,"Ohio","Highland County",5,58,550,272,278
050,39,071,"Ohio","Highland County",5,59,600,304,296
050,39,071,"Ohio","Highland County",5,60,586,289,297
050,39,071,"Ohio","Highland County",5,61,592,294,298
050,39,071,"Ohio","Highland County",5,62,565,269,296
050,39,071,"Ohio","Highland County",5,63,572,271,301
050,39,071,"Ohio","Highland County",5,64,607,298,309
050,39,071,"Ohio","Highland County",5,65,636,320,316
050,39,071,"Ohio","Highland County",5,66,601,317,284
050,39,071,"Ohio","Highland County",5,67,548,264,284
050,39,071,"Ohio","Highland County",5,68,518,240,278
050,39,071,"Ohio","Highland County",5,69,509,250,259
050,39,071,"Ohio","Highland County",5,70,490,233,257
050,39,071,"Ohio","Highland County",5,71,443,204,239
050,39,071,"Ohio","Highland County",5,72,443,214,229
050,39,071,"Ohio","Highland County",5,73,451,209,242
050,39,071,"Ohio","Highland County",5,74,444,201,243
050,39,071,"Ohio","Highland County",5,75,401,174,227
050,39,071,"Ohio","Highland County",5,76,418,189,229
050,39,071,"Ohio","Highland County",5,77,286,127,159
050,39,071,"Ohio","Highland County",5,78,265,121,144
050,39,071,"Ohio","Highland County",5,79,245,112,133
050,39,071,"Ohio","Highland County",5,80,253,118,135
050,39,071,"Ohio","Highland County",5,81,213,99,114
050,39,071,"Ohio","Highland County",5,82,205,93,112
050,39,071,"Ohio","Highland County",5,83,169,73,96
050,39,071,"Ohio","Highland County",5,84,153,66,87
050,39,071,"Ohio","Highland County",5,85,889,327,562
050,39,073,"Ohio","Hocking County",1,0,288,148,140
050,39,073,"Ohio","Hocking County",1,1,289,150,139
050,39,073,"Ohio","Hocking County",1,2,300,141,159
050,39,073,"Ohio","Hocking County",1,3,316,161,155
050,39,073,"Ohio","Hocking County",1,4,331,173,158
050,39,073,"Ohio","Hocking County",1,5,311,153,158
050,39,073,"Ohio","Hocking County",1,6,345,166,179
050,39,073,"Ohio","Hocking County",1,7,364,193,171
050,39,073,"Ohio","Hocking County",1,8,346,170,176
050,39,073,"Ohio","Hocking County",1,9,330,168,162
050,39,073,"Ohio","Hocking County",1,10,359,170,189
050,39,073,"Ohio","Hocking County",1,11,375,201,174
050,39,073,"Ohio","Hocking County",1,12,369,197,172
050,39,073,"Ohio","Hocking County",1,13,381,197,184
050,39,073,"Ohio","Hocking County",1,14,352,177,175
050,39,073,"Ohio","Hocking County",1,15,359,184,175
050,39,073,"Ohio","Hocking County",1,16,361,174,187
050,39,073,"Ohio","Hocking County",1,17,392,189,203
050,39,073,"Ohio","Hocking County",1,18,341,175,166
050,39,073,"Ohio","Hocking County",1,19,270,143,127
050,39,073,"Ohio","Hocking County",1,20,275,146,129
050,39,073,"Ohio","Hocking County",1,21,269,145,124
050,39,073,"Ohio","Hocking County",1,22,289,147,142
050,39,073,"Ohio","Hocking County",1,23,301,152,149
050,39,073,"Ohio","Hocking County",1,24,313,157,156
050,39,073,"Ohio","Hocking County",1,25,300,147,153
050,39,073,"Ohio","Hocking County",1,26,293,141,152
050,39,073,"Ohio","Hocking County",1,27,313,155,158
050,39,073,"Ohio","Hocking County",1,28,340,164,176
050,39,073,"Ohio","Hocking County",1,29,342,173,169
050,39,073,"Ohio","Hocking County",1,30,343,163,180
050,39,073,"Ohio","Hocking County",1,31,320,165,155
050,39,073,"Ohio","Hocking County",1,32,298,148,150
050,39,073,"Ohio","Hocking County",1,33,293,156,137
050,39,073,"Ohio","Hocking County",1,34,306,164,142
050,39,073,"Ohio","Hocking County",1,35,301,161,140
050,39,073,"Ohio","Hocking County",1,36,298,142,156
050,39,073,"Ohio","Hocking County",1,37,311,153,158
050,39,073,"Ohio","Hocking County",1,38,322,156,166
050,39,073,"Ohio","Hocking County",1,39,356,179,177
050,39,073,"Ohio","Hocking County",1,40,352,186,166
050,39,073,"Ohio","Hocking County",1,41,334,170,164
050,39,073,"Ohio","Hocking County",1,42,328,159,169
050,39,073,"Ohio","Hocking County",1,43,327,151,176
050,39,073,"Ohio","Hocking County",1,44,317,149,168
050,39,073,"Ohio","Hocking County",1,45,357,179,178
050,39,073,"Ohio","Hocking County",1,46,341,175,166
050,39,073,"Ohio","Hocking County",1,47,336,170,166
050,39,073,"Ohio","Hocking County",1,48,391,207,184
050,39,073,"Ohio","Hocking County",1,49,417,226,191
050,39,073,"Ohio","Hocking County",1,50,409,200,209
050,39,073,"Ohio","Hocking County",1,51,364,187,177
050,39,073,"Ohio","Hocking County",1,52,362,196,166
050,39,073,"Ohio","Hocking County",1,53,393,192,201
050,39,073,"Ohio","Hocking County",1,54,400,195,205
050,39,073,"Ohio","Hocking County",1,55,396,193,203
050,39,073,"Ohio","Hocking County",1,56,424,205,219
050,39,073,"Ohio","Hocking County",1,57,418,204,214
050,39,073,"Ohio","Hocking County",1,58,486,242,244
050,39,073,"Ohio","Hocking County",1,59,458,238,220
050,39,073,"Ohio","Hocking County",1,60,399,191,208
050,39,073,"Ohio","Hocking County",1,61,420,205,215
050,39,073,"Ohio","Hocking County",1,62,432,217,215
050,39,073,"Ohio","Hocking County",1,63,439,218,221
050,39,073,"Ohio","Hocking County",1,64,416,214,202
050,39,073,"Ohio","Hocking County",1,65,384,203,181
050,39,073,"Ohio","Hocking County",1,66,348,163,185
050,39,073,"Ohio","Hocking County",1,67,344,164,180
050,39,073,"Ohio","Hocking County",1,68,363,183,180
050,39,073,"Ohio","Hocking County",1,69,310,156,154
050,39,073,"Ohio","Hocking County",1,70,309,154,155
050,39,073,"Ohio","Hocking County",1,71,330,160,170
050,39,073,"Ohio","Hocking County",1,72,327,154,173
050,39,073,"Ohio","Hocking County",1,73,315,143,172
050,39,073,"Ohio","Hocking County",1,74,211,97,114
050,39,073,"Ohio","Hocking County",1,75,206,103,103
050,39,073,"Ohio","Hocking County",1,76,197,97,100
050,39,073,"Ohio","Hocking County",1,77,209,101,108
050,39,073,"Ohio","Hocking County",1,78,193,91,102
050,39,073,"Ohio","Hocking County",1,79,175,94,81
050,39,073,"Ohio","Hocking County",1,80,157,71,86
050,39,073,"Ohio","Hocking County",1,81,142,62,80
050,39,073,"Ohio","Hocking County",1,82,152,71,81
050,39,073,"Ohio","Hocking County",1,83,125,47,78
050,39,073,"Ohio","Hocking County",1,84,117,52,65
050,39,073,"Ohio","Hocking County",1,85,461,178,283
050,39,073,"Ohio","Hocking County",2,0,292,156,136
050,39,073,"Ohio","Hocking County",2,1,287,147,140
050,39,073,"Ohio","Hocking County",2,2,299,145,154
050,39,073,"Ohio","Hocking County",2,3,312,156,156
050,39,073,"Ohio","Hocking County",2,4,332,171,161
050,39,073,"Ohio","Hocking County",2,5,318,158,160
050,39,073,"Ohio","Hocking County",2,6,338,164,174
050,39,073,"Ohio","Hocking County",2,7,359,185,174
050,39,073,"Ohio","Hocking County",2,8,349,174,175
050,39,073,"Ohio","Hocking County",2,9,336,168,168
050,39,073,"Ohio","Hocking County",2,10,349,168,181
050,39,073,"Ohio","Hocking County",2,11,369,193,176
050,39,073,"Ohio","Hocking County",2,12,373,201,172
050,39,073,"Ohio","Hocking County",2,13,376,196,180
050,39,073,"Ohio","Hocking County",2,14,358,181,177
050,39,073,"Ohio","Hocking County",2,15,354,180,174
050,39,073,"Ohio","Hocking County",2,16,362,178,184
050,39,073,"Ohio","Hocking County",2,17,387,187,200
050,39,073,"Ohio","Hocking County",2,18,334,170,164
050,39,073,"Ohio","Hocking County",2,19,268,140,128
050,39,073,"Ohio","Hocking County",2,20,276,147,129
050,39,073,"Ohio","Hocking County",2,21,274,148,126
050,39,073,"Ohio","Hocking County",2,22,284,145,139
050,39,073,"Ohio","Hocking County",2,23,304,152,152
050,39,073,"Ohio","Hocking County",2,24,311,155,156
050,39,073,"Ohio","Hocking County",2,25,304,149,155
050,39,073,"Ohio","Hocking County",2,26,297,144,153
050,39,073,"Ohio","Hocking County",2,27,309,153,156
050,39,073,"Ohio","Hocking County",2,28,332,162,170
050,39,073,"Ohio","Hocking County",2,29,338,168,170
050,39,073,"Ohio","Hocking County",2,30,345,165,180
050,39,073,"Ohio","Hocking County",2,31,324,166,158
050,39,073,"Ohio","Hocking County",2,32,305,153,152
050,39,073,"Ohio","Hocking County",2,33,295,155,140
050,39,073,"Ohio","Hocking County",2,34,302,161,141
050,39,073,"Ohio","Hocking County",2,35,305,162,143
050,39,073,"Ohio","Hocking County",2,36,298,147,151
050,39,073,"Ohio","Hocking County",2,37,308,151,157
050,39,073,"Ohio","Hocking County",2,38,320,155,165
050,39,073,"Ohio","Hocking County",2,39,349,175,174
050,39,073,"Ohio","Hocking County",2,40,358,186,172
050,39,073,"Ohio","Hocking County",2,41,337,173,164
050,39,073,"Ohio","Hocking County",2,42,327,161,166
050,39,073,"Ohio","Hocking County",2,43,331,155,176
050,39,073,"Ohio","Hocking County",2,44,317,149,168
050,39,073,"Ohio","Hocking County",2,45,349,172,177
050,39,073,"Ohio","Hocking County",2,46,345,175,170
050,39,073,"Ohio","Hocking County",2,47,336,170,166
050,39,073,"Ohio","Hocking County",2,48,376,198,178
050,39,073,"Ohio","Hocking County",2,49,414,222,192
050,39,073,"Ohio","Hocking County",2,50,410,206,204
050,39,073,"Ohio","Hocking County",2,51,374,190,184
050,39,073,"Ohio","Hocking County",2,52,362,194,168
050,39,073,"Ohio","Hocking County",2,53,388,195,193
050,39,073,"Ohio","Hocking County",2,54,397,193,204
050,39,073,"Ohio","Hocking County",2,55,399,193,206
050,39,073,"Ohio","Hocking County",2,56,417,202,215
050,39,073,"Ohio","Hocking County",2,57,421,206,215
050,39,073,"Ohio","Hocking County",2,58,468,231,237
050,39,073,"Ohio","Hocking County",2,59,466,237,229
050,39,073,"Ohio","Hocking County",2,60,411,203,208
050,39,073,"Ohio","Hocking County",2,61,415,201,214
050,39,073,"Ohio","Hocking County",2,62,428,213,215
050,39,073,"Ohio","Hocking County",2,63,437,218,219
050,39,073,"Ohio","Hocking County",2,64,416,212,204
050,39,073,"Ohio","Hocking County",2,65,392,206,186
050,39,073,"Ohio","Hocking County",2,66,356,172,184
050,39,073,"Ohio","Hocking County",2,67,340,162,178
050,39,073,"Ohio","Hocking County",2,68,352,174,178
050,39,073,"Ohio","Hocking County",2,69,322,161,161
050,39,073,"Ohio","Hocking County",2,70,309,154,155
050,39,073,"Ohio","Hocking County",2,71,325,158,167
050,39,073,"Ohio","Hocking County",2,72,318,151,167
050,39,073,"Ohio","Hocking County",2,73,334,152,182
050,39,073,"Ohio","Hocking County",2,74,219,100,119
050,39,073,"Ohio","Hocking County",2,75,207,101,106
050,39,073,"Ohio","Hocking County",2,76,196,98,98
050,39,073,"Ohio","Hocking County",2,77,208,101,107
050,39,073,"Ohio","Hocking County",2,78,192,92,100
050,39,073,"Ohio","Hocking County",2,79,177,91,86
050,39,073,"Ohio","Hocking County",2,80,161,77,84
050,39,073,"Ohio","Hocking County",2,81,141,63,78
050,39,073,"Ohio","Hocking County",2,82,150,70,80
050,39,073,"Ohio","Hocking County",2,83,129,51,78
050,39,073,"Ohio","Hocking County",2,84,114,50,64
050,39,073,"Ohio","Hocking County",2,85,467,183,284
050,39,073,"Ohio","Hocking County",3,0,266,141,125
050,39,073,"Ohio","Hocking County",3,1,296,163,133
050,39,073,"Ohio","Hocking County",3,2,309,168,141
050,39,073,"Ohio","Hocking County",3,3,292,143,149
050,39,073,"Ohio","Hocking County",3,4,314,161,153
050,39,073,"Ohio","Hocking County",3,5,327,170,157
050,39,073,"Ohio","Hocking County",3,6,324,164,160
050,39,073,"Ohio","Hocking County",3,7,343,162,181
050,39,073,"Ohio","Hocking County",3,8,373,188,185
050,39,073,"Ohio","Hocking County",3,9,366,183,183
050,39,073,"Ohio","Hocking County",3,10,335,178,157
050,39,073,"Ohio","Hocking County",3,11,355,179,176
050,39,073,"Ohio","Hocking County",3,12,366,194,172
050,39,073,"Ohio","Hocking County",3,13,376,202,174
050,39,073,"Ohio","Hocking County",3,14,392,198,194
050,39,073,"Ohio","Hocking County",3,15,357,186,171
050,39,073,"Ohio","Hocking County",3,16,356,184,172
050,39,073,"Ohio","Hocking County",3,17,365,183,182
050,39,073,"Ohio","Hocking County",3,18,322,158,164
050,39,073,"Ohio","Hocking County",3,19,265,140,125
050,39,073,"Ohio","Hocking County",3,20,286,150,136
050,39,073,"Ohio","Hocking County",3,21,282,155,127
050,39,073,"Ohio","Hocking County",3,22,299,157,142
050,39,073,"Ohio","Hocking County",3,23,298,145,153
050,39,073,"Ohio","Hocking County",3,24,301,148,153
050,39,073,"Ohio","Hocking County",3,25,317,160,157
050,39,073,"Ohio","Hocking County",3,26,322,153,169
050,39,073,"Ohio","Hocking County",3,27,308,153,155
050,39,073,"Ohio","Hocking County",3,28,300,149,151
050,39,073,"Ohio","Hocking County",3,29,344,164,180
050,39,073,"Ohio","Hocking County",3,30,341,174,167
050,39,073,"Ohio","Hocking County",3,31,339,156,183
050,39,073,"Ohio","Hocking County",3,32,336,169,167
050,39,073,"Ohio","Hocking County",3,33,317,163,154
050,39,073,"Ohio","Hocking County",3,34,305,162,143
050,39,073,"Ohio","Hocking County",3,35,306,162,144
050,39,073,"Ohio","Hocking County",3,36,317,172,145
050,39,073,"Ohio","Hocking County",3,37,297,148,149
050,39,073,"Ohio","Hocking County",3,38,305,147,158
050,39,073,"Ohio","Hocking County",3,39,328,162,166
050,39,073,"Ohio","Hocking County",3,40,346,168,178
050,39,073,"Ohio","Hocking County",3,41,356,181,175
050,39,073,"Ohio","Hocking County",3,42,346,178,168
050,39,073,"Ohio","Hocking County",3,43,320,163,157
050,39,073,"Ohio","Hocking County",3,44,336,156,180
050,39,073,"Ohio","Hocking County",3,45,314,141,173
050,39,073,"Ohio","Hocking County",3,46,353,174,179
050,39,073,"Ohio","Hocking County",3,47,353,173,180
050,39,073,"Ohio","Hocking County",3,48,338,179,159
050,39,073,"Ohio","Hocking County",3,49,375,198,177
050,39,073,"Ohio","Hocking County",3,50,424,228,196
050,39,073,"Ohio","Hocking County",3,51,423,215,208
050,39,073,"Ohio","Hocking County",3,52,367,183,184
050,39,073,"Ohio","Hocking County",3,53,374,194,180
050,39,073,"Ohio","Hocking County",3,54,383,191,192
050,39,073,"Ohio","Hocking County",3,55,389,196,193
050,39,073,"Ohio","Hocking County",3,56,396,188,208
050,39,073,"Ohio","Hocking County",3,57,412,202,210
050,39,073,"Ohio","Hocking County",3,58,420,208,212
050,39,073,"Ohio","Hocking County",3,59,463,227,236
050,39,073,"Ohio","Hocking County",3,60,453,232,221
050,39,073,"Ohio","Hocking County",3,61,406,197,209
050,39,073,"Ohio","Hocking County",3,62,425,204,221
050,39,073,"Ohio","Hocking County",3,63,430,216,214
050,39,073,"Ohio","Hocking County",3,64,433,214,219
050,39,073,"Ohio","Hocking County",3,65,406,212,194
050,39,073,"Ohio","Hocking County",3,66,379,200,179
050,39,073,"Ohio","Hocking County",3,67,349,168,181
050,39,073,"Ohio","Hocking County",3,68,328,155,173
050,39,073,"Ohio","Hocking County",3,69,342,169,173
050,39,073,"Ohio","Hocking County",3,70,317,159,158
050,39,073,"Ohio","Hocking County",3,71,305,153,152
050,39,073,"Ohio","Hocking County",3,72,315,156,159
050,39,073,"Ohio","Hocking County",3,73,304,150,154
050,39,073,"Ohio","Hocking County",3,74,328,147,181
050,39,073,"Ohio","Hocking County",3,75,207,91,116
050,39,073,"Ohio","Hocking County",3,76,199,97,102
050,39,073,"Ohio","Hocking County",3,77,189,90,99
050,39,073,"Ohio","Hocking County",3,78,193,88,105
050,39,073,"Ohio","Hocking County",3,79,184,86,98
050,39,073,"Ohio","Hocking County",3,80,171,88,83
050,39,073,"Ohio","Hocking County",3,81,146,69,77
050,39,073,"Ohio","Hocking County",3,82,129,61,68
050,39,073,"Ohio","Hocking County",3,83,134,60,74
050,39,073,"Ohio","Hocking County",3,84,117,48,69
050,39,073,"Ohio","Hocking County",3,85,477,184,293
050,39,073,"Ohio","Hocking County",4,0,272,137,135
050,39,073,"Ohio","Hocking County",4,1,256,140,116
050,39,073,"Ohio","Hocking County",4,2,301,167,134
050,39,073,"Ohio","Hocking County",4,3,310,173,137
050,39,073,"Ohio","Hocking County",4,4,289,142,147
050,39,073,"Ohio","Hocking County",4,5,333,175,158
050,39,073,"Ohio","Hocking County",4,6,336,170,166
050,39,073,"Ohio","Hocking County",4,7,339,169,170
050,39,073,"Ohio","Hocking County",4,8,344,159,185
050,39,073,"Ohio","Hocking County",4,9,365,184,181
050,39,073,"Ohio","Hocking County",4,10,358,177,181
050,39,073,"Ohio","Hocking County",4,11,335,178,157
050,39,073,"Ohio","Hocking County",4,12,363,178,185
050,39,073,"Ohio","Hocking County",4,13,359,192,167
050,39,073,"Ohio","Hocking County",4,14,369,195,174
050,39,073,"Ohio","Hocking County",4,15,393,195,198
050,39,073,"Ohio","Hocking County",4,16,352,183,169
050,39,073,"Ohio","Hocking County",4,17,362,185,177
050,39,073,"Ohio","Hocking County",4,18,308,165,143
050,39,073,"Ohio","Hocking County",4,19,243,122,121
050,39,073,"Ohio","Hocking County",4,20,282,147,135
050,39,073,"Ohio","Hocking County",4,21,286,149,137
050,39,073,"Ohio","Hocking County",4,22,291,159,132
050,39,073,"Ohio","Hocking County",4,23,312,156,156
050,39,073,"Ohio","Hocking County",4,24,294,149,145
050,39,073,"Ohio","Hocking County",4,25,315,154,161
050,39,073,"Ohio","Hocking County",4,26,324,161,163
050,39,073,"Ohio","Hocking County",4,27,324,150,174
050,39,073,"Ohio","Hocking County",4,28,301,152,149
050,39,073,"Ohio","Hocking County",4,29,284,143,141
050,39,073,"Ohio","Hocking County",4,30,329,153,176
050,39,073,"Ohio","Hocking County",4,31,332,173,159
050,39,073,"Ohio","Hocking County",4,32,332,153,179
050,39,073,"Ohio","Hocking County",4,33,334,162,172
050,39,073,"Ohio","Hocking County",4,34,320,159,161
050,39,073,"Ohio","Hocking County",4,35,298,160,138
050,39,073,"Ohio","Hocking County",4,36,305,166,139
050,39,073,"Ohio","Hocking County",4,37,319,173,146
050,39,073,"Ohio","Hocking County",4,38,310,153,157
050,39,073,"Ohio","Hocking County",4,39,297,141,156
050,39,073,"Ohio","Hocking County",4,40,325,158,167
050,39,073,"Ohio","Hocking County",4,41,351,167,184
050,39,073,"Ohio","Hocking County",4,42,356,179,177
050,39,073,"Ohio","Hocking County",4,43,345,179,166
050,39,073,"Ohio","Hocking County",4,44,323,159,164
050,39,073,"Ohio","Hocking County",4,45,331,154,177
050,39,073,"Ohio","Hocking County",4,46,313,140,173
050,39,073,"Ohio","Hocking County",4,47,351,169,182
050,39,073,"Ohio","Hocking County",4,48,344,170,174
050,39,073,"Ohio","Hocking County",4,49,329,174,155
050,39,073,"Ohio","Hocking County",4,50,384,206,178
050,39,073,"Ohio","Hocking County",4,51,427,230,197
050,39,073,"Ohio","Hocking County",4,52,421,210,211
050,39,073,"Ohio","Hocking County",4,53,367,184,183
050,39,073,"Ohio","Hocking County",4,54,365,186,179
050,39,073,"Ohio","Hocking County",4,55,371,181,190
050,39,073,"Ohio","Hocking County",4,56,386,199,187
050,39,073,"Ohio","Hocking County",4,57,389,182,207
050,39,073,"Ohio","Hocking County",4,58,409,206,203
050,39,073,"Ohio","Hocking County",4,59,411,204,207
050,39,073,"Ohio","Hocking County",4,60,464,228,236
050,39,073,"Ohio","Hocking County",4,61,440,224,216
050,39,073,"Ohio","Hocking County",4,62,386,185,201
050,39,073,"Ohio","Hocking County",4,63,417,205,212
050,39,073,"Ohio","Hocking County",4,64,410,204,206
050,39,073,"Ohio","Hocking County",4,65,422,210,212
050,39,073,"Ohio","Hocking County",4,66,395,204,191
050,39,073,"Ohio","Hocking County",4,67,368,194,174
050,39,073,"Ohio","Hocking County",4,68,340,164,176
050,39,073,"Ohio","Hocking County",4,69,318,150,168
050,39,073,"Ohio","Hocking County",4,70,334,169,165
050,39,073,"Ohio","Hocking County",4,71,303,148,155
050,39,073,"Ohio","Hocking County",4,72,293,147,146
050,39,073,"Ohio","Hocking County",4,73,302,151,151
050,39,073,"Ohio","Hocking County",4,74,295,147,148
050,39,073,"Ohio","Hocking County",4,75,309,136,173
050,39,073,"Ohio","Hocking County",4,76,195,85,110
050,39,073,"Ohio","Hocking County",4,77,185,87,98
050,39,073,"Ohio","Hocking County",4,78,176,79,97
050,39,073,"Ohio","Hocking County",4,79,182,82,100
050,39,073,"Ohio","Hocking County",4,80,171,76,95
050,39,073,"Ohio","Hocking County",4,81,156,83,73
050,39,073,"Ohio","Hocking County",4,82,142,71,71
050,39,073,"Ohio","Hocking County",4,83,115,51,64
050,39,073,"Ohio","Hocking County",4,84,122,58,64
050,39,073,"Ohio","Hocking County",4,85,504,197,307
050,39,073,"Ohio","Hocking County",5,0,272,136,136
050,39,073,"Ohio","Hocking County",5,1,274,137,137
050,39,073,"Ohio","Hocking County",5,2,266,147,119
050,39,073,"Ohio","Hocking County",5,3,297,159,138
050,39,073,"Ohio","Hocking County",5,4,305,164,141
050,39,073,"Ohio","Hocking County",5,5,285,142,143
050,39,073,"Ohio","Hocking County",5,6,314,158,156
050,39,073,"Ohio","Hocking County",5,7,332,168,164
050,39,073,"Ohio","Hocking County",5,8,338,177,161
050,39,073,"Ohio","Hocking County",5,9,343,156,187
050,39,073,"Ohio","Hocking County",5,10,362,188,174
050,39,073,"Ohio","Hocking County",5,11,363,183,180
050,39,073,"Ohio","Hocking County",5,12,330,175,155
050,39,073,"Ohio","Hocking County",5,13,365,174,191
050,39,073,"Ohio","Hocking County",5,14,352,190,162
050,39,073,"Ohio","Hocking County",5,15,365,192,173
050,39,073,"Ohio","Hocking County",5,16,395,198,197
050,39,073,"Ohio","Hocking County",5,17,345,179,166
050,39,073,"Ohio","Hocking County",5,18,298,157,141
050,39,073,"Ohio","Hocking County",5,19,226,120,106
050,39,073,"Ohio","Hocking County",5,20,256,126,130
050,39,073,"Ohio","Hocking County",5,21,293,152,141
050,39,073,"Ohio","Hocking County",5,22,297,144,153
050,39,073,"Ohio","Hocking County",5,23,296,161,135
050,39,073,"Ohio","Hocking County",5,24,308,155,153
050,39,073,"Ohio","Hocking County",5,25,292,152,140
050,39,073,"Ohio","Hocking County",5,26,319,162,157
050,39,073,"Ohio","Hocking County",5,27,317,161,156
050,39,073,"Ohio","Hocking County",5,28,323,150,173
050,39,073,"Ohio","Hocking County",5,29,308,162,146
050,39,073,"Ohio","Hocking County",5,30,264,131,133
050,39,073,"Ohio","Hocking County",5,31,324,152,172
050,39,073,"Ohio","Hocking County",5,32,322,163,159
050,39,073,"Ohio","Hocking County",5,33,335,158,177
050,39,073,"Ohio","Hocking County",5,34,326,157,169
050,39,073,"Ohio","Hocking County",5,35,308,150,158
050,39,073,"Ohio","Hocking County",5,36,294,152,142
050,39,073,"Ohio","Hocking County",5,37,310,169,141
050,39,073,"Ohio","Hocking County",5,38,311,175,136
050,39,073,"Ohio","Hocking County",5,39,315,153,162
050,39,073,"Ohio","Hocking County",5,40,297,144,153
050,39,073,"Ohio","Hocking County",5,41,327,164,163
050,39,073,"Ohio","Hocking County",5,42,346,167,179
050,39,073,"Ohio","Hocking County",5,43,355,180,175
050,39,073,"Ohio","Hocking County",5,44,342,173,169
050,39,073,"Ohio","Hocking County",5,45,321,162,159
050,39,073,"Ohio","Hocking County",5,46,326,151,175
050,39,073,"Ohio","Hocking County",5,47,312,144,168
050,39,073,"Ohio","Hocking County",5,48,354,169,185
050,39,073,"Ohio","Hocking County",5,49,336,168,168
050,39,073,"Ohio","Hocking County",5,50,323,171,152
050,39,073,"Ohio","Hocking County",5,51,397,203,194
050,39,073,"Ohio","Hocking County",5,52,424,227,197
050,39,073,"Ohio","Hocking County",5,53,424,210,214
050,39,073,"Ohio","Hocking County",5,54,353,174,179
050,39,073,"Ohio","Hocking County",5,55,362,183,179
050,39,073,"Ohio","Hocking County",5,56,375,185,190
050,39,073,"Ohio","Hocking County",5,57,380,192,188
050,39,073,"Ohio","Hocking County",5,58,385,187,198
050,39,073,"Ohio","Hocking County",5,59,409,205,204
050,39,073,"Ohio","Hocking County",5,60,409,207,202
050,39,073,"Ohio","Hocking County",5,61,442,216,226
050,39,073,"Ohio","Hocking County",5,62,435,218,217
050,39,073,"Ohio","Hocking County",5,63,384,186,198
050,39,073,"Ohio","Hocking County",5,64,410,200,210
050,39,073,"Ohio","Hocking County",5,65,405,205,200
050,39,073,"Ohio","Hocking County",5,66,416,208,208
050,39,073,"Ohio","Hocking County",5,67,389,202,187
050,39,073,"Ohio","Hocking County",5,68,359,192,167
050,39,073,"Ohio","Hocking County",5,69,328,162,166
050,39,073,"Ohio","Hocking County",5,70,312,143,169
050,39,073,"Ohio","Hocking County",5,71,330,165,165
050,39,073,"Ohio","Hocking County",5,72,292,142,150
050,39,073,"Ohio","Hocking County",5,73,276,140,136
050,39,073,"Ohio","Hocking County",5,74,291,146,145
050,39,073,"Ohio","Hocking County",5,75,278,137,141
050,39,073,"Ohio","Hocking County",5,76,300,132,168
050,39,073,"Ohio","Hocking County",5,77,183,77,106
050,39,073,"Ohio","Hocking County",5,78,175,82,93
050,39,073,"Ohio","Hocking County",5,79,172,76,96
050,39,073,"Ohio","Hocking County",5,80,175,78,97
050,39,073,"Ohio","Hocking County",5,81,154,66,88
050,39,073,"Ohio","Hocking County",5,82,156,85,71
050,39,073,"Ohio","Hocking County",5,83,125,60,65
050,39,073,"Ohio","Hocking County",5,84,104,48,56
050,39,073,"Ohio","Hocking County",5,85,547,223,324
050,39,075,"Ohio","Holmes County",1,0,796,407,389
050,39,075,"Ohio","Holmes County",1,1,741,370,371
050,39,075,"Ohio","Holmes County",1,2,701,367,334
050,39,075,"Ohio","Holmes County",1,3,699,379,320
050,39,075,"Ohio","Holmes County",1,4,689,360,329
050,39,075,"Ohio","Holmes County",1,5,713,386,327
050,39,075,"Ohio","Holmes County",1,6,725,394,331
050,39,075,"Ohio","Holmes County",1,7,723,373,350
050,39,075,"Ohio","Holmes County",1,8,737,387,350
050,39,075,"Ohio","Holmes County",1,9,733,375,358
050,39,075,"Ohio","Holmes County",1,10,775,380,395
050,39,075,"Ohio","Holmes County",1,11,797,404,393
050,39,075,"Ohio","Holmes County",1,12,776,390,386
050,39,075,"Ohio","Holmes County",1,13,798,413,385
050,39,075,"Ohio","Holmes County",1,14,783,394,389
050,39,075,"Ohio","Holmes County",1,15,806,399,407
050,39,075,"Ohio","Holmes County",1,16,864,427,437
050,39,075,"Ohio","Holmes County",1,17,831,422,409
050,39,075,"Ohio","Holmes County",1,18,674,347,327
050,39,075,"Ohio","Holmes County",1,19,553,284,269
050,39,075,"Ohio","Holmes County",1,20,588,304,284
050,39,075,"Ohio","Holmes County",1,21,607,314,293
050,39,075,"Ohio","Holmes County",1,22,638,327,311
050,39,075,"Ohio","Holmes County",1,23,661,341,320
050,39,075,"Ohio","Holmes County",1,24,628,326,302
050,39,075,"Ohio","Holmes County",1,25,610,309,301
050,39,075,"Ohio","Holmes County",1,26,617,325,292
050,39,075,"Ohio","Holmes County",1,27,589,307,282
050,39,075,"Ohio","Holmes County",1,28,567,281,286
050,39,075,"Ohio","Holmes County",1,29,585,296,289
050,39,075,"Ohio","Holmes County",1,30,587,306,281
050,39,075,"Ohio","Holmes County",1,31,555,290,265
050,39,075,"Ohio","Holmes County",1,32,537,283,254
050,39,075,"Ohio","Holmes County",1,33,499,254,245
050,39,075,"Ohio","Holmes County",1,34,488,239,249
050,39,075,"Ohio","Holmes County",1,35,496,229,267
050,39,075,"Ohio","Holmes County",1,36,493,237,256
050,39,075,"Ohio","Holmes County",1,37,483,239,244
050,39,075,"Ohio","Holmes County",1,38,487,253,234
050,39,075,"Ohio","Holmes County",1,39,486,254,232
050,39,075,"Ohio","Holmes County",1,40,488,246,242
050,39,075,"Ohio","Holmes County",1,41,488,251,237
050,39,075,"Ohio","Holmes County",1,42,494,255,239
050,39,075,"Ohio","Holmes County",1,43,478,234,244
050,39,075,"Ohio","Holmes County",1,44,485,236,249
050,39,075,"Ohio","Holmes County",1,45,467,238,229
050,39,075,"Ohio","Holmes County",1,46,453,227,226
050,39,075,"Ohio","Holmes County",1,47,456,227,229
050,39,075,"Ohio","Holmes County",1,48,466,225,241
050,39,075,"Ohio","Holmes County",1,49,480,236,244
050,39,075,"Ohio","Holmes County",1,50,468,240,228
050,39,075,"Ohio","Holmes County",1,51,475,247,228
050,39,075,"Ohio","Holmes County",1,52,472,258,214
050,39,075,"Ohio","Holmes County",1,53,454,233,221
050,39,075,"Ohio","Holmes County",1,54,441,220,221
050,39,075,"Ohio","Holmes County",1,55,454,220,234
050,39,075,"Ohio","Holmes County",1,56,483,249,234
050,39,075,"Ohio","Holmes County",1,57,505,253,252
050,39,075,"Ohio","Holmes County",1,58,534,280,254
050,39,075,"Ohio","Holmes County",1,59,530,281,249
050,39,075,"Ohio","Holmes County",1,60,494,255,239
050,39,075,"Ohio","Holmes County",1,61,479,250,229
050,39,075,"Ohio","Holmes County",1,62,481,244,237
050,39,075,"Ohio","Holmes County",1,63,481,239,242
050,39,075,"Ohio","Holmes County",1,64,455,239,216
050,39,075,"Ohio","Holmes County",1,65,439,208,231
050,39,075,"Ohio","Holmes County",1,66,402,203,199
050,39,075,"Ohio","Holmes County",1,67,417,215,202
050,39,075,"Ohio","Holmes County",1,68,405,199,206
050,39,075,"Ohio","Holmes County",1,69,347,165,182
050,39,075,"Ohio","Holmes County",1,70,349,162,187
050,39,075,"Ohio","Holmes County",1,71,339,155,184
050,39,075,"Ohio","Holmes County",1,72,322,140,182
050,39,075,"Ohio","Holmes County",1,73,315,146,169
050,39,075,"Ohio","Holmes County",1,74,242,120,122
050,39,075,"Ohio","Holmes County",1,75,213,112,101
050,39,075,"Ohio","Holmes County",1,76,235,118,117
050,39,075,"Ohio","Holmes County",1,77,218,102,116
050,39,075,"Ohio","Holmes County",1,78,206,95,111
050,39,075,"Ohio","Holmes County",1,79,176,77,99
050,39,075,"Ohio","Holmes County",1,80,165,80,85
050,39,075,"Ohio","Holmes County",1,81,151,71,80
050,39,075,"Ohio","Holmes County",1,82,151,68,83
050,39,075,"Ohio","Holmes County",1,83,125,51,74
050,39,075,"Ohio","Holmes County",1,84,137,59,78
050,39,075,"Ohio","Holmes County",1,85,784,273,511
050,39,075,"Ohio","Holmes County",2,0,807,405,402
050,39,075,"Ohio","Holmes County",2,1,747,377,370
050,39,075,"Ohio","Holmes County",2,2,705,367,338
050,39,075,"Ohio","Holmes County",2,3,691,372,319
050,39,075,"Ohio","Holmes County",2,4,691,364,327
050,39,075,"Ohio","Holmes County",2,5,706,380,326
050,39,075,"Ohio","Holmes County",2,6,723,392,331
050,39,075,"Ohio","Holmes County",2,7,722,377,345
050,39,075,"Ohio","Holmes County",2,8,732,383,349
050,39,075,"Ohio","Holmes County",2,9,735,378,357
050,39,075,"Ohio","Holmes County",2,10,764,378,386
050,39,075,"Ohio","Holmes County",2,11,786,394,392
050,39,075,"Ohio","Holmes County",2,12,781,392,389
050,39,075,"Ohio","Holmes County",2,13,791,407,384
050,39,075,"Ohio","Holmes County",2,14,789,400,389
050,39,075,"Ohio","Holmes County",2,15,803,399,404
050,39,075,"Ohio","Holmes County",2,16,850,420,430
050,39,075,"Ohio","Holmes County",2,17,839,422,417
050,39,075,"Ohio","Holmes County",2,18,675,348,327
050,39,075,"Ohio","Holmes County",2,19,546,279,267
050,39,075,"Ohio","Holmes County",2,20,597,308,289
050,39,075,"Ohio","Holmes County",2,21,609,314,295
050,39,075,"Ohio","Holmes County",2,22,641,329,312
050,39,075,"Ohio","Holmes County",2,23,660,340,320
050,39,075,"Ohio","Holmes County",2,24,636,330,306
050,39,075,"Ohio","Holmes County",2,25,612,314,298
050,39,075,"Ohio","Holmes County",2,26,612,321,291
050,39,075,"Ohio","Holmes County",2,27,592,308,284
050,39,075,"Ohio","Holmes County",2,28,571,286,285
050,39,075,"Ohio","Holmes County",2,29,576,288,288
050,39,075,"Ohio","Holmes County",2,30,585,303,282
050,39,075,"Ohio","Holmes County",2,31,560,292,268
050,39,075,"Ohio","Holmes County",2,32,537,282,255
050,39,075,"Ohio","Holmes County",2,33,508,262,246
050,39,075,"Ohio","Holmes County",2,34,489,242,247
050,39,075,"Ohio","Holmes County",2,35,495,231,264
050,39,075,"Ohio","Holmes County",2,36,489,233,256
050,39,075,"Ohio","Holmes County",2,37,485,238,247
050,39,075,"Ohio","Holmes County",2,38,489,252,237
050,39,075,"Ohio","Holmes County",2,39,487,255,232
050,39,075,"Ohio","Holmes County",2,40,491,249,242
050,39,075,"Ohio","Holmes County",2,41,486,249,237
050,39,075,"Ohio","Holmes County",2,42,486,251,235
050,39,075,"Ohio","Holmes County",2,43,483,240,243
050,39,075,"Ohio","Holmes County",2,44,475,231,244
050,39,075,"Ohio","Holmes County",2,45,475,240,235
050,39,075,"Ohio","Holmes County",2,46,451,226,225
050,39,075,"Ohio","Holmes County",2,47,451,225,226
050,39,075,"Ohio","Holmes County",2,48,465,227,238
050,39,075,"Ohio","Holmes County",2,49,478,234,244
050,39,075,"Ohio","Holmes County",2,50,474,241,233
050,39,075,"Ohio","Holmes County",2,51,471,246,225
050,39,075,"Ohio","Holmes County",2,52,472,255,217
050,39,075,"Ohio","Holmes County",2,53,457,237,220
050,39,075,"Ohio","Holmes County",2,54,442,223,219
050,39,075,"Ohio","Holmes County",2,55,449,219,230
050,39,075,"Ohio","Holmes County",2,56,475,243,232
050,39,075,"Ohio","Holmes County",2,57,498,251,247
050,39,075,"Ohio","Holmes County",2,58,528,273,255
050,39,075,"Ohio","Holmes County",2,59,534,282,252
050,39,075,"Ohio","Holmes County",2,60,501,259,242
050,39,075,"Ohio","Holmes County",2,61,481,250,231
050,39,075,"Ohio","Holmes County",2,62,480,246,234
050,39,075,"Ohio","Holmes County",2,63,483,241,242
050,39,075,"Ohio","Holmes County",2,64,459,239,220
050,39,075,"Ohio","Holmes County",2,65,438,213,225
050,39,075,"Ohio","Holmes County",2,66,411,204,207
050,39,075,"Ohio","Holmes County",2,67,414,213,201
050,39,075,"Ohio","Holmes County",2,68,401,199,202
050,39,075,"Ohio","Holmes County",2,69,362,173,189
050,39,075,"Ohio","Holmes County",2,70,346,161,185
050,39,075,"Ohio","Holmes County",2,71,338,154,184
050,39,075,"Ohio","Holmes County",2,72,318,142,176
050,39,075,"Ohio","Holmes County",2,73,333,152,181
050,39,075,"Ohio","Holmes County",2,74,241,118,123
050,39,075,"Ohio","Holmes County",2,75,221,114,107
050,39,075,"Ohio","Holmes County",2,76,228,114,114
050,39,075,"Ohio","Holmes County",2,77,228,109,119
050,39,075,"Ohio","Holmes County",2,78,202,94,108
050,39,075,"Ohio","Holmes County",2,79,181,80,101
050,39,075,"Ohio","Holmes County",2,80,165,78,87
050,39,075,"Ohio","Holmes County",2,81,148,70,78
050,39,075,"Ohio","Holmes County",2,82,151,67,84
050,39,075,"Ohio","Holmes County",2,83,130,53,77
050,39,075,"Ohio","Holmes County",2,84,126,53,73
050,39,075,"Ohio","Holmes County",2,85,787,275,512
050,39,075,"Ohio","Holmes County",3,0,804,407,397
050,39,075,"Ohio","Holmes County",3,1,790,393,397
050,39,075,"Ohio","Holmes County",3,2,735,373,362
050,39,075,"Ohio","Holmes County",3,3,704,363,341
050,39,075,"Ohio","Holmes County",3,4,699,372,327
050,39,075,"Ohio","Holmes County",3,5,688,364,324
050,39,075,"Ohio","Holmes County",3,6,703,377,326
050,39,075,"Ohio","Holmes County",3,7,715,391,324
050,39,075,"Ohio","Holmes County",3,8,715,372,343
050,39,075,"Ohio","Holmes County",3,9,740,383,357
050,39,075,"Ohio","Holmes County",3,10,733,381,352
050,39,075,"Ohio","Holmes County",3,11,765,376,389
050,39,075,"Ohio","Holmes County",3,12,793,404,389
050,39,075,"Ohio","Holmes County",3,13,773,389,384
050,39,075,"Ohio","Holmes County",3,14,785,404,381
050,39,075,"Ohio","Holmes County",3,15,785,400,385
050,39,075,"Ohio","Holmes County",3,16,790,390,400
050,39,075,"Ohio","Holmes County",3,17,848,420,428
050,39,075,"Ohio","Holmes County",3,18,696,364,332
050,39,075,"Ohio","Holmes County",3,19,534,272,262
050,39,075,"Ohio","Holmes County",3,20,590,302,288
050,39,075,"Ohio","Holmes County",3,21,639,321,318
050,39,075,"Ohio","Holmes County",3,22,642,333,309
050,39,075,"Ohio","Holmes County",3,23,656,347,309
050,39,075,"Ohio","Holmes County",3,24,639,330,309
050,39,075,"Ohio","Holmes County",3,25,605,308,297
050,39,075,"Ohio","Holmes County",3,26,597,311,286
050,39,075,"Ohio","Holmes County",3,27,601,315,286
050,39,075,"Ohio","Holmes County",3,28,579,302,277
050,39,075,"Ohio","Holmes County",3,29,552,281,271
050,39,075,"Ohio","Holmes County",3,30,581,282,299
050,39,075,"Ohio","Holmes County",3,31,581,298,283
050,39,075,"Ohio","Holmes County",3,32,569,301,268
050,39,075,"Ohio","Holmes County",3,33,536,285,251
050,39,075,"Ohio","Holmes County",3,34,497,254,243
050,39,075,"Ohio","Holmes County",3,35,487,241,246
050,39,075,"Ohio","Holmes County",3,36,501,239,262
050,39,075,"Ohio","Holmes County",3,37,486,231,255
050,39,075,"Ohio","Holmes County",3,38,478,234,244
050,39,075,"Ohio","Holmes County",3,39,495,258,237
050,39,075,"Ohio","Holmes County",3,40,475,250,225
050,39,075,"Ohio","Holmes County",3,41,486,249,237
050,39,075,"Ohio","Holmes County",3,42,485,250,235
050,39,075,"Ohio","Holmes County",3,43,488,254,234
050,39,075,"Ohio","Holmes County",3,44,478,235,243
050,39,075,"Ohio","Holmes County",3,45,475,233,242
050,39,075,"Ohio","Holmes County",3,46,482,243,239
050,39,075,"Ohio","Holmes County",3,47,452,227,225
050,39,075,"Ohio","Holmes County",3,48,456,229,227
050,39,075,"Ohio","Holmes County",3,49,456,229,227
050,39,075,"Ohio","Holmes County",3,50,481,236,245
050,39,075,"Ohio","Holmes County",3,51,477,248,229
050,39,075,"Ohio","Holmes County",3,52,473,245,228
050,39,075,"Ohio","Holmes County",3,53,470,248,222
050,39,075,"Ohio","Holmes County",3,54,455,242,213
050,39,075,"Ohio","Holmes County",3,55,444,219,225
050,39,075,"Ohio","Holmes County",3,56,453,225,228
050,39,075,"Ohio","Holmes County",3,57,466,238,228
050,39,075,"Ohio","Holmes County",3,58,504,246,258
050,39,075,"Ohio","Holmes County",3,59,530,272,258
050,39,075,"Ohio","Holmes County",3,60,528,280,248
050,39,075,"Ohio","Holmes County",3,61,492,255,237
050,39,075,"Ohio","Holmes County",3,62,475,250,225
050,39,075,"Ohio","Holmes County",3,63,476,240,236
050,39,075,"Ohio","Holmes County",3,64,485,252,233
050,39,075,"Ohio","Holmes County",3,65,438,226,212
050,39,075,"Ohio","Holmes County",3,66,430,207,223
050,39,075,"Ohio","Holmes County",3,67,403,199,204
050,39,075,"Ohio","Holmes County",3,68,404,212,192
050,39,075,"Ohio","Holmes County",3,69,390,186,204
050,39,075,"Ohio","Holmes County",3,70,364,168,196
050,39,075,"Ohio","Holmes County",3,71,326,150,176
050,39,075,"Ohio","Holmes County",3,72,326,152,174
050,39,075,"Ohio","Holmes County",3,73,314,138,176
050,39,075,"Ohio","Holmes County",3,74,323,146,177
050,39,075,"Ohio","Holmes County",3,75,229,113,116
050,39,075,"Ohio","Holmes County",3,76,221,112,109
050,39,075,"Ohio","Holmes County",3,77,225,111,114
050,39,075,"Ohio","Holmes County",3,78,218,102,116
050,39,075,"Ohio","Holmes County",3,79,196,87,109
050,39,075,"Ohio","Holmes County",3,80,175,75,100
050,39,075,"Ohio","Holmes County",3,81,149,70,79
050,39,075,"Ohio","Holmes County",3,82,147,68,79
050,39,075,"Ohio","Holmes County",3,83,147,64,83
050,39,075,"Ohio","Holmes County",3,84,112,44,68
050,39,075,"Ohio","Holmes County",3,85,764,268,496
050,39,075,"Ohio","Holmes County",4,0,811,422,389
050,39,075,"Ohio","Holmes County",4,1,786,406,380
050,39,075,"Ohio","Holmes County",4,2,769,387,382
050,39,075,"Ohio","Holmes County",4,3,733,368,365
050,39,075,"Ohio","Holmes County",4,4,698,361,337
050,39,075,"Ohio","Holmes County",4,5,689,362,327
050,39,075,"Ohio","Holmes County",4,6,687,364,323
050,39,075,"Ohio","Holmes County",4,7,703,379,324
050,39,075,"Ohio","Holmes County",4,8,716,390,326
050,39,075,"Ohio","Holmes County",4,9,701,364,337
050,39,075,"Ohio","Holmes County",4,10,737,380,357
050,39,075,"Ohio","Holmes County",4,11,728,374,354
050,39,075,"Ohio","Holmes County",4,12,757,373,384
050,39,075,"Ohio","Holmes County",4,13,778,390,388
050,39,075,"Ohio","Holmes County",4,14,775,389,386
050,39,075,"Ohio","Holmes County",4,15,787,406,381
050,39,075,"Ohio","Holmes County",4,16,786,396,390
050,39,075,"Ohio","Holmes County",4,17,786,387,399
050,39,075,"Ohio","Holmes County",4,18,700,365,335
050,39,075,"Ohio","Holmes County",4,19,519,274,245
050,39,075,"Ohio","Holmes County",4,20,573,286,287
050,39,075,"Ohio","Holmes County",4,21,615,313,302
050,39,075,"Ohio","Holmes County",4,22,688,337,351
050,39,075,"Ohio","Holmes County",4,23,653,339,314
050,39,075,"Ohio","Holmes County",4,24,666,343,323
050,39,075,"Ohio","Holmes County",4,25,638,329,309
050,39,075,"Ohio","Holmes County",4,26,589,303,286
050,39,075,"Ohio","Holmes County",4,27,593,306,287
050,39,075,"Ohio","Holmes County",4,28,584,308,276
050,39,075,"Ohio","Holmes County",4,29,569,291,278
050,39,075,"Ohio","Holmes County",4,30,535,273,262
050,39,075,"Ohio","Holmes County",4,31,564,275,289
050,39,075,"Ohio","Holmes County",4,32,583,300,283
050,39,075,"Ohio","Holmes County",4,33,563,300,263
050,39,075,"Ohio","Holmes County",4,34,526,281,245
050,39,075,"Ohio","Holmes County",4,35,484,243,241
050,39,075,"Ohio","Holmes County",4,36,487,240,247
050,39,075,"Ohio","Holmes County",4,37,500,241,259
050,39,075,"Ohio","Holmes County",4,38,483,233,250
050,39,075,"Ohio","Holmes County",4,39,471,234,237
050,39,075,"Ohio","Holmes County",4,40,489,251,238
050,39,075,"Ohio","Holmes County",4,41,481,254,227
050,39,075,"Ohio","Holmes County",4,42,489,248,241
050,39,075,"Ohio","Holmes County",4,43,489,252,237
050,39,075,"Ohio","Holmes County",4,44,494,263,231
050,39,075,"Ohio","Holmes County",4,45,483,234,249
050,39,075,"Ohio","Holmes County",4,46,475,234,241
050,39,075,"Ohio","Holmes County",4,47,467,240,227
050,39,075,"Ohio","Holmes County",4,48,452,229,223
050,39,075,"Ohio","Holmes County",4,49,455,230,225
050,39,075,"Ohio","Holmes County",4,50,462,227,235
050,39,075,"Ohio","Holmes County",4,51,485,243,242
050,39,075,"Ohio","Holmes County",4,52,487,253,234
050,39,075,"Ohio","Holmes County",4,53,466,237,229
050,39,075,"Ohio","Holmes County",4,54,458,248,210
050,39,075,"Ohio","Holmes County",4,55,456,242,214
050,39,075,"Ohio","Holmes County",4,56,445,225,220
050,39,075,"Ohio","Holmes County",4,57,445,221,224
050,39,075,"Ohio","Holmes County",4,58,471,235,236
050,39,075,"Ohio","Holmes County",4,59,505,248,257
050,39,075,"Ohio","Holmes County",4,60,526,265,261
050,39,075,"Ohio","Holmes County",4,61,529,281,248
050,39,075,"Ohio","Holmes County",4,62,496,258,238
050,39,075,"Ohio","Holmes County",4,63,473,245,228
050,39,075,"Ohio","Holmes County",4,64,460,238,222
050,39,075,"Ohio","Holmes County",4,65,470,235,235
050,39,075,"Ohio","Holmes County",4,66,435,223,212
050,39,075,"Ohio","Holmes County",4,67,423,204,219
050,39,075,"Ohio","Holmes County",4,68,389,195,194
050,39,075,"Ohio","Holmes County",4,69,395,201,194
050,39,075,"Ohio","Holmes County",4,70,388,183,205
050,39,075,"Ohio","Holmes County",4,71,349,158,191
050,39,075,"Ohio","Holmes County",4,72,316,145,171
050,39,075,"Ohio","Holmes County",4,73,319,147,172
050,39,075,"Ohio","Holmes County",4,74,298,128,170
050,39,075,"Ohio","Holmes County",4,75,306,136,170
050,39,075,"Ohio","Holmes County",4,76,218,105,113
050,39,075,"Ohio","Holmes County",4,77,213,107,106
050,39,075,"Ohio","Holmes County",4,78,210,105,105
050,39,075,"Ohio","Holmes County",4,79,206,93,113
050,39,075,"Ohio","Holmes County",4,80,183,80,103
050,39,075,"Ohio","Holmes County",4,81,155,61,94
050,39,075,"Ohio","Holmes County",4,82,142,63,79
050,39,075,"Ohio","Holmes County",4,83,139,62,77
050,39,075,"Ohio","Holmes County",4,84,122,53,69
050,39,075,"Ohio","Holmes County",4,85,751,257,494
050,39,075,"Ohio","Holmes County",5,0,778,414,364
050,39,075,"Ohio","Holmes County",5,1,777,405,372
050,39,075,"Ohio","Holmes County",5,2,785,401,384
050,39,075,"Ohio","Holmes County",5,3,768,385,383
050,39,075,"Ohio","Holmes County",5,4,736,363,373
050,39,075,"Ohio","Holmes County",5,5,691,357,334
050,39,075,"Ohio","Holmes County",5,6,686,361,325
050,39,075,"Ohio","Holmes County",5,7,685,364,321
050,39,075,"Ohio","Holmes County",5,8,702,373,329
050,39,075,"Ohio","Holmes County",5,9,722,395,327
050,39,075,"Ohio","Holmes County",5,10,693,358,335
050,39,075,"Ohio","Holmes County",5,11,736,377,359
050,39,075,"Ohio","Holmes County",5,12,730,371,359
050,39,075,"Ohio","Holmes County",5,13,755,368,387
050,39,075,"Ohio","Holmes County",5,14,782,389,393
050,39,075,"Ohio","Holmes County",5,15,762,380,382
050,39,075,"Ohio","Holmes County",5,16,777,396,381
050,39,075,"Ohio","Holmes County",5,17,784,396,388
050,39,075,"Ohio","Holmes County",5,18,637,329,308
050,39,075,"Ohio","Holmes County",5,19,527,273,254
050,39,075,"Ohio","Holmes County",5,20,564,291,273
050,39,075,"Ohio","Holmes County",5,21,608,305,303
050,39,075,"Ohio","Holmes County",5,22,632,322,310
050,39,075,"Ohio","Holmes County",5,23,726,361,365
050,39,075,"Ohio","Holmes County",5,24,668,344,324
050,39,075,"Ohio","Holmes County",5,25,649,336,313
050,39,075,"Ohio","Holmes County",5,26,640,325,315
050,39,075,"Ohio","Holmes County",5,27,578,294,284
050,39,075,"Ohio","Holmes County",5,28,574,290,284
050,39,075,"Ohio","Holmes County",5,29,561,298,263
050,39,075,"Ohio","Holmes County",5,30,559,291,268
050,39,075,"Ohio","Holmes County",5,31,535,275,260
050,39,075,"Ohio","Holmes County",5,32,554,275,279
050,39,075,"Ohio","Holmes County",5,33,578,295,283
050,39,075,"Ohio","Holmes County",5,34,559,289,270
050,39,075,"Ohio","Holmes County",5,35,519,274,245
050,39,075,"Ohio","Holmes County",5,36,491,246,245
050,39,075,"Ohio","Holmes County",5,37,489,241,248
050,39,075,"Ohio","Holmes County",5,38,494,237,257
050,39,075,"Ohio","Holmes County",5,39,483,234,249
050,39,075,"Ohio","Holmes County",5,40,477,235,242
050,39,075,"Ohio","Holmes County",5,41,491,249,242
050,39,075,"Ohio","Holmes County",5,42,483,257,226
050,39,075,"Ohio","Holmes County",5,43,488,252,236
050,39,075,"Ohio","Holmes County",5,44,482,248,234
050,39,075,"Ohio","Holmes County",5,45,491,264,227
050,39,075,"Ohio","Holmes County",5,46,477,229,248
050,39,075,"Ohio","Holmes County",5,47,474,234,240
050,39,075,"Ohio","Holmes County",5,48,455,234,221
050,39,075,"Ohio","Holmes County",5,49,450,225,225
050,39,075,"Ohio","Holmes County",5,50,456,231,225
050,39,075,"Ohio","Holmes County",5,51,458,229,229
050,39,075,"Ohio","Holmes County",5,52,486,244,242
050,39,075,"Ohio","Holmes County",5,53,478,244,234
050,39,075,"Ohio","Holmes County",5,54,455,240,215
050,39,075,"Ohio","Holmes County",5,55,448,242,206
050,39,075,"Ohio","Holmes County",5,56,452,245,207
050,39,075,"Ohio","Holmes County",5,57,432,218,214
050,39,075,"Ohio","Holmes County",5,58,446,219,227
050,39,075,"Ohio","Holmes County",5,59,466,234,232
050,39,075,"Ohio","Holmes County",5,60,502,241,261
050,39,075,"Ohio","Holmes County",5,61,524,266,258
050,39,075,"Ohio","Holmes County",5,62,523,281,242
050,39,075,"Ohio","Holmes County",5,63,483,245,238
050,39,075,"Ohio","Holmes County",5,64,464,248,216
050,39,075,"Ohio","Holmes County",5,65,452,229,223
050,39,075,"Ohio","Holmes County",5,66,463,236,227
050,39,075,"Ohio","Holmes County",5,67,430,221,209
050,39,075,"Ohio","Holmes County",5,68,406,201,205
050,39,075,"Ohio","Holmes County",5,69,375,183,192
050,39,075,"Ohio","Holmes County",5,70,396,199,197
050,39,075,"Ohio","Holmes County",5,71,369,169,200
050,39,075,"Ohio","Holmes County",5,72,335,154,181
050,39,075,"Ohio","Holmes County",5,73,315,142,173
050,39,075,"Ohio","Holmes County",5,74,316,142,174
050,39,075,"Ohio","Holmes County",5,75,286,124,162
050,39,075,"Ohio","Holmes County",5,76,290,125,165
050,39,075,"Ohio","Holmes County",5,77,217,101,116
050,39,075,"Ohio","Holmes County",5,78,204,100,104
050,39,075,"Ohio","Holmes County",5,79,207,100,107
050,39,075,"Ohio","Holmes County",5,80,184,85,99
050,39,075,"Ohio","Holmes County",5,81,160,64,96
050,39,075,"Ohio","Holmes County",5,82,152,59,93
050,39,075,"Ohio","Holmes County",5,83,132,56,76
050,39,075,"Ohio","Holmes County",5,84,122,55,67
050,39,075,"Ohio","Holmes County",5,85,760,262,498
050,39,077,"Ohio","Huron County",1,0,688,351,337
050,39,077,"Ohio","Huron County",1,1,693,345,348
050,39,077,"Ohio","Huron County",1,2,721,377,344
050,39,077,"Ohio","Huron County",1,3,773,417,356
050,39,077,"Ohio","Huron County",1,4,766,387,379
050,39,077,"Ohio","Huron County",1,5,754,380,374
050,39,077,"Ohio","Huron County",1,6,780,408,372
050,39,077,"Ohio","Huron County",1,7,743,398,345
050,39,077,"Ohio","Huron County",1,8,721,371,350
050,39,077,"Ohio","Huron County",1,9,717,357,360
050,39,077,"Ohio","Huron County",1,10,790,416,374
050,39,077,"Ohio","Huron County",1,11,857,441,416
050,39,077,"Ohio","Huron County",1,12,900,459,441
050,39,077,"Ohio","Huron County",1,13,850,441,409
050,39,077,"Ohio","Huron County",1,14,848,441,407
050,39,077,"Ohio","Huron County",1,15,870,442,428
050,39,077,"Ohio","Huron County",1,16,859,436,423
050,39,077,"Ohio","Huron County",1,17,847,448,399
050,39,077,"Ohio","Huron County",1,18,721,386,335
050,39,077,"Ohio","Huron County",1,19,579,294,285
050,39,077,"Ohio","Huron County",1,20,617,312,305
050,39,077,"Ohio","Huron County",1,21,626,317,309
050,39,077,"Ohio","Huron County",1,22,648,331,317
050,39,077,"Ohio","Huron County",1,23,707,364,343
050,39,077,"Ohio","Huron County",1,24,697,363,334
050,39,077,"Ohio","Huron County",1,25,717,379,338
050,39,077,"Ohio","Huron County",1,26,700,364,336
050,39,077,"Ohio","Huron County",1,27,720,383,337
050,39,077,"Ohio","Huron County",1,28,728,372,356
050,39,077,"Ohio","Huron County",1,29,682,347,335
050,39,077,"Ohio","Huron County",1,30,715,374,341
050,39,077,"Ohio","Huron County",1,31,701,353,348
050,39,077,"Ohio","Huron County",1,32,650,336,314
050,39,077,"Ohio","Huron County",1,33,694,367,327
050,39,077,"Ohio","Huron County",1,34,670,340,330
050,39,077,"Ohio","Huron County",1,35,656,327,329
050,39,077,"Ohio","Huron County",1,36,685,336,349
050,39,077,"Ohio","Huron County",1,37,683,344,339
050,39,077,"Ohio","Huron County",1,38,680,349,331
050,39,077,"Ohio","Huron County",1,39,723,370,353
050,39,077,"Ohio","Huron County",1,40,707,344,363
050,39,077,"Ohio","Huron County",1,41,688,334,354
050,39,077,"Ohio","Huron County",1,42,694,343,351
050,39,077,"Ohio","Huron County",1,43,655,323,332
050,39,077,"Ohio","Huron County",1,44,661,337,324
050,39,077,"Ohio","Huron County",1,45,657,342,315
050,39,077,"Ohio","Huron County",1,46,664,347,317
050,39,077,"Ohio","Huron County",1,47,741,387,354
050,39,077,"Ohio","Huron County",1,48,749,386,363
050,39,077,"Ohio","Huron County",1,49,778,411,367
050,39,077,"Ohio","Huron County",1,50,782,398,384
050,39,077,"Ohio","Huron County",1,51,719,369,350
050,39,077,"Ohio","Huron County",1,52,740,359,381
050,39,077,"Ohio","Huron County",1,53,776,386,390
050,39,077,"Ohio","Huron County",1,54,795,376,419
050,39,077,"Ohio","Huron County",1,55,827,411,416
050,39,077,"Ohio","Huron County",1,56,830,422,408
050,39,077,"Ohio","Huron County",1,57,867,424,443
050,39,077,"Ohio","Huron County",1,58,851,420,431
050,39,077,"Ohio","Huron County",1,59,835,412,423
050,39,077,"Ohio","Huron County",1,60,822,393,429
050,39,077,"Ohio","Huron County",1,61,832,407,425
050,39,077,"Ohio","Huron County",1,62,840,401,439
050,39,077,"Ohio","Huron County",1,63,802,388,414
050,39,077,"Ohio","Huron County",1,64,799,392,407
050,39,077,"Ohio","Huron County",1,65,751,346,405
050,39,077,"Ohio","Huron County",1,66,723,359,364
050,39,077,"Ohio","Huron County",1,67,678,335,343
050,39,077,"Ohio","Huron County",1,68,697,333,364
050,39,077,"Ohio","Huron County",1,69,659,316,343
050,39,077,"Ohio","Huron County",1,70,598,269,329
050,39,077,"Ohio","Huron County",1,71,603,287,316
050,39,077,"Ohio","Huron County",1,72,599,303,296
050,39,077,"Ohio","Huron County",1,73,583,288,295
050,39,077,"Ohio","Huron County",1,74,389,182,207
050,39,077,"Ohio","Huron County",1,75,401,179,222
050,39,077,"Ohio","Huron County",1,76,392,168,224
050,39,077,"Ohio","Huron County",1,77,382,175,207
050,39,077,"Ohio","Huron County",1,78,326,139,187
050,39,077,"Ohio","Huron County",1,79,306,124,182
050,39,077,"Ohio","Huron County",1,80,279,126,153
050,39,077,"Ohio","Huron County",1,81,244,107,137
050,39,077,"Ohio","Huron County",1,82,211,89,122
050,39,077,"Ohio","Huron County",1,83,205,81,124
050,39,077,"Ohio","Huron County",1,84,186,69,117
050,39,077,"Ohio","Huron County",1,85,1072,399,673
050,39,077,"Ohio","Huron County",2,0,668,337,331
050,39,077,"Ohio","Huron County",2,1,685,343,342
050,39,077,"Ohio","Huron County",2,2,712,368,344
050,39,077,"Ohio","Huron County",2,3,758,406,352
050,39,077,"Ohio","Huron County",2,4,770,395,375
050,39,077,"Ohio","Huron County",2,5,758,385,373
050,39,077,"Ohio","Huron County",2,6,772,404,368
050,39,077,"Ohio","Huron County",2,7,754,403,351
050,39,077,"Ohio","Huron County",2,8,726,378,348
050,39,077,"Ohio","Huron County",2,9,718,363,355
050,39,077,"Ohio","Huron County",2,10,775,404,371
050,39,077,"Ohio","Huron County",2,11,842,436,406
050,39,077,"Ohio","Huron County",2,12,897,457,440
050,39,077,"Ohio","Huron County",2,13,862,444,418
050,39,077,"Ohio","Huron County",2,14,847,437,410
050,39,077,"Ohio","Huron County",2,15,861,439,422
050,39,077,"Ohio","Huron County",2,16,861,437,424
050,39,077,"Ohio","Huron County",2,17,845,442,403
050,39,077,"Ohio","Huron County",2,18,714,384,330
050,39,077,"Ohio","Huron County",2,19,578,297,281
050,39,077,"Ohio","Huron County",2,20,622,313,309
050,39,077,"Ohio","Huron County",2,21,625,314,311
050,39,077,"Ohio","Huron County",2,22,645,328,317
050,39,077,"Ohio","Huron County",2,23,699,359,340
050,39,077,"Ohio","Huron County",2,24,695,363,332
050,39,077,"Ohio","Huron County",2,25,711,374,337
050,39,077,"Ohio","Huron County",2,26,711,375,336
050,39,077,"Ohio","Huron County",2,27,711,377,334
050,39,077,"Ohio","Huron County",2,28,726,375,351
050,39,077,"Ohio","Huron County",2,29,690,351,339
050,39,077,"Ohio","Huron County",2,30,712,370,342
050,39,077,"Ohio","Huron County",2,31,701,357,344
050,39,077,"Ohio","Huron County",2,32,662,340,322
050,39,077,"Ohio","Huron County",2,33,681,358,323
050,39,077,"Ohio","Huron County",2,34,675,345,330
050,39,077,"Ohio","Huron County",2,35,664,332,332
050,39,077,"Ohio","Huron County",2,36,671,329,342
050,39,077,"Ohio","Huron County",2,37,685,342,343
050,39,077,"Ohio","Huron County",2,38,688,350,338
050,39,077,"Ohio","Huron County",2,39,709,364,345
050,39,077,"Ohio","Huron County",2,40,713,351,362
050,39,077,"Ohio","Huron County",2,41,691,337,354
050,39,077,"Ohio","Huron County",2,42,688,338,350
050,39,077,"Ohio","Huron County",2,43,670,330,340
050,39,077,"Ohio","Huron County",2,44,657,332,325
050,39,077,"Ohio","Huron County",2,45,663,344,319
050,39,077,"Ohio","Huron County",2,46,656,342,314
050,39,077,"Ohio","Huron County",2,47,718,374,344
050,39,077,"Ohio","Huron County",2,48,745,385,360
050,39,077,"Ohio","Huron County",2,49,772,406,366
050,39,077,"Ohio","Huron County",2,50,782,402,380
050,39,077,"Ohio","Huron County",2,51,727,372,355
050,39,077,"Ohio","Huron County",2,52,731,359,372
050,39,077,"Ohio","Huron County",2,53,768,378,390
050,39,077,"Ohio","Huron County",2,54,786,376,410
050,39,077,"Ohio","Huron County",2,55,814,399,415
050,39,077,"Ohio","Huron County",2,56,834,422,412
050,39,077,"Ohio","Huron County",2,57,857,423,434
050,39,077,"Ohio","Huron County",2,58,851,420,431
050,39,077,"Ohio","Huron County",2,59,843,415,428
050,39,077,"Ohio","Huron County",2,60,816,393,423
050,39,077,"Ohio","Huron County",2,61,826,400,426
050,39,077,"Ohio","Huron County",2,62,839,403,436
050,39,077,"Ohio","Huron County",2,63,817,391,426
050,39,077,"Ohio","Huron County",2,64,788,386,402
050,39,077,"Ohio","Huron County",2,65,759,356,403
050,39,077,"Ohio","Huron County",2,66,729,357,372
050,39,077,"Ohio","Huron County",2,67,684,339,345
050,39,077,"Ohio","Huron County",2,68,683,331,352
050,39,077,"Ohio","Huron County",2,69,670,321,349
050,39,077,"Ohio","Huron County",2,70,611,279,332
050,39,077,"Ohio","Huron County",2,71,598,278,320
050,39,077,"Ohio","Huron County",2,72,586,291,295
050,39,077,"Ohio","Huron County",2,73,612,303,309
050,39,077,"Ohio","Huron County",2,74,409,195,214
050,39,077,"Ohio","Huron County",2,75,392,177,215
050,39,077,"Ohio","Huron County",2,76,389,167,222
050,39,077,"Ohio","Huron County",2,77,392,178,214
050,39,077,"Ohio","Huron County",2,78,324,140,184
050,39,077,"Ohio","Huron County",2,79,308,125,183
050,39,077,"Ohio","Huron County",2,80,281,123,158
050,39,077,"Ohio","Huron County",2,81,247,108,139
050,39,077,"Ohio","Huron County",2,82,219,94,125
050,39,077,"Ohio","Huron County",2,83,203,83,120
050,39,077,"Ohio","Huron County",2,84,188,69,119
050,39,077,"Ohio","Huron County",2,85,1073,401,672
050,39,077,"Ohio","Huron County",3,0,609,314,295
050,39,077,"Ohio","Huron County",3,1,661,336,325
050,39,077,"Ohio","Huron County",3,2,693,363,330
050,39,077,"Ohio","Huron County",3,3,705,369,336
050,39,077,"Ohio","Huron County",3,4,763,399,364
050,39,077,"Ohio","Huron County",3,5,763,372,391
050,39,077,"Ohio","Huron County",3,6,753,383,370
050,39,077,"Ohio","Huron County",3,7,755,396,359
050,39,077,"Ohio","Huron County",3,8,755,412,343
050,39,077,"Ohio","Huron County",3,9,733,372,361
050,39,077,"Ohio","Huron County",3,10,718,369,349
050,39,077,"Ohio","Huron County",3,11,787,411,376
050,39,077,"Ohio","Huron County",3,12,839,439,400
050,39,077,"Ohio","Huron County",3,13,903,457,446
050,39,077,"Ohio","Huron County",3,14,851,442,409
050,39,077,"Ohio","Huron County",3,15,856,445,411
050,39,077,"Ohio","Huron County",3,16,897,460,437
050,39,077,"Ohio","Huron County",3,17,861,437,424
050,39,077,"Ohio","Huron County",3,18,736,398,338
050,39,077,"Ohio","Huron County",3,19,582,302,280
050,39,077,"Ohio","Huron County",3,20,626,328,298
050,39,077,"Ohio","Huron County",3,21,664,329,335
050,39,077,"Ohio","Huron County",3,22,674,335,339
050,39,077,"Ohio","Huron County",3,23,673,349,324
050,39,077,"Ohio","Huron County",3,24,692,358,334
050,39,077,"Ohio","Huron County",3,25,694,357,337
050,39,077,"Ohio","Huron County",3,26,704,371,333
050,39,077,"Ohio","Huron County",3,27,726,386,340
050,39,077,"Ohio","Huron County",3,28,720,380,340
050,39,077,"Ohio","Huron County",3,29,743,398,345
050,39,077,"Ohio","Huron County",3,30,672,339,333
050,39,077,"Ohio","Huron County",3,31,693,364,329
050,39,077,"Ohio","Huron County",3,32,703,359,344
050,39,077,"Ohio","Huron County",3,33,655,333,322
050,39,077,"Ohio","Huron County",3,34,698,369,329
050,39,077,"Ohio","Huron County",3,35,682,353,329
050,39,077,"Ohio","Huron County",3,36,666,330,336
050,39,077,"Ohio","Huron County",3,37,674,340,334
050,39,077,"Ohio","Huron County",3,38,691,342,349
050,39,077,"Ohio","Huron County",3,39,707,365,342
050,39,077,"Ohio","Huron County",3,40,700,353,347
050,39,077,"Ohio","Huron County",3,41,711,348,363
050,39,077,"Ohio","Huron County",3,42,714,349,365
050,39,077,"Ohio","Huron County",3,43,691,341,350
050,39,077,"Ohio","Huron County",3,44,681,339,342
050,39,077,"Ohio","Huron County",3,45,660,330,330
050,39,077,"Ohio","Huron County",3,46,651,341,310
050,39,077,"Ohio","Huron County",3,47,659,340,319
050,39,077,"Ohio","Huron County",3,48,721,373,348
050,39,077,"Ohio","Huron County",3,49,739,381,358
050,39,077,"Ohio","Huron County",3,50,788,423,365
050,39,077,"Ohio","Huron County",3,51,771,395,376
050,39,077,"Ohio","Huron County",3,52,722,369,353
050,39,077,"Ohio","Huron County",3,53,742,364,378
050,39,077,"Ohio","Huron County",3,54,777,382,395
050,39,077,"Ohio","Huron County",3,55,789,379,410
050,39,077,"Ohio","Huron County",3,56,805,399,406
050,39,077,"Ohio","Huron County",3,57,828,419,409
050,39,077,"Ohio","Huron County",3,58,849,420,429
050,39,077,"Ohio","Huron County",3,59,838,411,427
050,39,077,"Ohio","Huron County",3,60,823,401,422
050,39,077,"Ohio","Huron County",3,61,796,391,405
050,39,077,"Ohio","Huron County",3,62,806,382,424
050,39,077,"Ohio","Huron County",3,63,835,406,429
050,39,077,"Ohio","Huron County",3,64,793,380,413
050,39,077,"Ohio","Huron County",3,65,780,384,396
050,39,077,"Ohio","Huron County",3,66,733,340,393
050,39,077,"Ohio","Huron County",3,67,712,346,366
050,39,077,"Ohio","Huron County",3,68,669,329,340
050,39,077,"Ohio","Huron County",3,69,654,318,336
050,39,077,"Ohio","Huron County",3,70,662,313,349
050,39,077,"Ohio","Huron County",3,71,589,267,322
050,39,077,"Ohio","Huron County",3,72,586,269,317
050,39,077,"Ohio","Huron County",3,73,557,271,286
050,39,077,"Ohio","Huron County",3,74,589,288,301
050,39,077,"Ohio","Huron County",3,75,401,189,212
050,39,077,"Ohio","Huron County",3,76,380,175,205
050,39,077,"Ohio","Huron County",3,77,372,162,210
050,39,077,"Ohio","Huron County",3,78,367,159,208
050,39,077,"Ohio","Huron County",3,79,310,125,185
050,39,077,"Ohio","Huron County",3,80,293,113,180
050,39,077,"Ohio","Huron County",3,81,260,115,145
050,39,077,"Ohio","Huron County",3,82,240,101,139
050,39,077,"Ohio","Huron County",3,83,195,85,110
050,39,077,"Ohio","Huron County",3,84,172,61,111
050,39,077,"Ohio","Huron County",3,85,1025,384,641
050,39,077,"Ohio","Huron County",4,0,648,345,303
050,39,077,"Ohio","Huron County",4,1,597,296,301
050,39,077,"Ohio","Huron County",4,2,663,336,327
050,39,077,"Ohio","Huron County",4,3,689,351,338
050,39,077,"Ohio","Huron County",4,4,715,373,342
050,39,077,"Ohio","Huron County",4,5,756,403,353
050,39,077,"Ohio","Huron County",4,6,772,393,379
050,39,077,"Ohio","Huron County",4,7,767,389,378
050,39,077,"Ohio","Huron County",4,8,768,401,367
050,39,077,"Ohio","Huron County",4,9,764,422,342
050,39,077,"Ohio","Huron County",4,10,727,374,353
050,39,077,"Ohio","Huron County",4,11,726,375,351
050,39,077,"Ohio","Huron County",4,12,791,408,383
050,39,077,"Ohio","Huron County",4,13,851,443,408
050,39,077,"Ohio","Huron County",4,14,922,475,447
050,39,077,"Ohio","Huron County",4,15,867,448,419
050,39,077,"Ohio","Huron County",4,16,868,442,426
050,39,077,"Ohio","Huron County",4,17,881,454,427
050,39,077,"Ohio","Huron County",4,18,736,384,352
050,39,077,"Ohio","Huron County",4,19,561,309,252
050,39,077,"Ohio","Huron County",4,20,617,317,300
050,39,077,"Ohio","Huron County",4,21,635,336,299
050,39,077,"Ohio","Huron County",4,22,694,337,357
050,39,077,"Ohio","Huron County",4,23,671,337,334
050,39,077,"Ohio","Huron County",4,24,682,366,316
050,39,077,"Ohio","Huron County",4,25,673,348,325
050,39,077,"Ohio","Huron County",4,26,681,347,334
050,39,077,"Ohio","Huron County",4,27,683,356,327
050,39,077,"Ohio","Huron County",4,28,719,377,342
050,39,077,"Ohio","Huron County",4,29,698,372,326
050,39,077,"Ohio","Huron County",4,30,750,404,346
050,39,077,"Ohio","Huron County",4,31,696,347,349
050,39,077,"Ohio","Huron County",4,32,703,369,334
050,39,077,"Ohio","Huron County",4,33,693,352,341
050,39,077,"Ohio","Huron County",4,34,677,339,338
050,39,077,"Ohio","Huron County",4,35,699,375,324
050,39,077,"Ohio","Huron County",4,36,679,350,329
050,39,077,"Ohio","Huron County",4,37,673,335,338
050,39,077,"Ohio","Huron County",4,38,672,329,343
050,39,077,"Ohio","Huron County",4,39,690,345,345
050,39,077,"Ohio","Huron County",4,40,706,363,343
050,39,077,"Ohio","Huron County",4,41,712,364,348
050,39,077,"Ohio","Huron County",4,42,718,351,367
050,39,077,"Ohio","Huron County",4,43,700,337,363
050,39,077,"Ohio","Huron County",4,44,698,346,352
050,39,077,"Ohio","Huron County",4,45,685,339,346
050,39,077,"Ohio","Huron County",4,46,646,318,328
050,39,077,"Ohio","Huron County",4,47,648,337,311
050,39,077,"Ohio","Huron County",4,48,652,336,316
050,39,077,"Ohio","Huron County",4,49,715,372,343
050,39,077,"Ohio","Huron County",4,50,749,391,358
050,39,077,"Ohio","Huron County",4,51,786,424,362
050,39,077,"Ohio","Huron County",4,52,760,393,367
050,39,077,"Ohio","Huron County",4,53,720,367,353
050,39,077,"Ohio","Huron County",4,54,725,355,370
050,39,077,"Ohio","Huron County",4,55,762,377,385
050,39,077,"Ohio","Huron County",4,56,798,381,417
050,39,077,"Ohio","Huron County",4,57,793,389,404
050,39,077,"Ohio","Huron County",4,58,838,420,418
050,39,077,"Ohio","Huron County",4,59,854,420,434
050,39,077,"Ohio","Huron County",4,60,834,412,422
050,39,077,"Ohio","Huron County",4,61,806,396,410
050,39,077,"Ohio","Huron County",4,62,780,383,397
050,39,077,"Ohio","Huron County",4,63,806,379,427
050,39,077,"Ohio","Huron County",4,64,812,398,414
050,39,077,"Ohio","Huron County",4,65,773,375,398
050,39,077,"Ohio","Huron County",4,66,766,379,387
050,39,077,"Ohio","Huron County",4,67,715,323,392
050,39,077,"Ohio","Huron County",4,68,708,341,367
050,39,077,"Ohio","Huron County",4,69,642,312,330
050,39,077,"Ohio","Huron County",4,70,635,299,336
050,39,077,"Ohio","Huron County",4,71,644,305,339
050,39,077,"Ohio","Huron County",4,72,579,261,318
050,39,077,"Ohio","Huron County",4,73,554,253,301
050,39,077,"Ohio","Huron County",4,74,538,261,277
050,39,077,"Ohio","Huron County",4,75,565,275,290
050,39,077,"Ohio","Huron County",4,76,383,185,198
050,39,077,"Ohio","Huron County",4,77,367,168,199
050,39,077,"Ohio","Huron County",4,78,342,145,197
050,39,077,"Ohio","Huron County",4,79,350,145,205
050,39,077,"Ohio","Huron County",4,80,287,111,176
050,39,077,"Ohio","Huron County",4,81,260,104,156
050,39,077,"Ohio","Huron County",4,82,251,107,144
050,39,077,"Ohio","Huron County",4,83,213,89,124
050,39,077,"Ohio","Huron County",4,84,178,76,102
050,39,077,"Ohio","Huron County",4,85,1012,374,638
050,39,077,"Ohio","Huron County",5,0,648,344,304
050,39,077,"Ohio","Huron County",5,1,644,336,308
050,39,077,"Ohio","Huron County",5,2,618,296,322
050,39,077,"Ohio","Huron County",5,3,680,342,338
050,39,077,"Ohio","Huron County",5,4,692,347,345
050,39,077,"Ohio","Huron County",5,5,712,366,346
050,39,077,"Ohio","Huron County",5,6,743,402,341
050,39,077,"Ohio","Huron County",5,7,761,394,367
050,39,077,"Ohio","Huron County",5,8,780,393,387
050,39,077,"Ohio","Huron County",5,9,773,401,372
050,39,077,"Ohio","Huron County",5,10,752,404,348
050,39,077,"Ohio","Huron County",5,11,735,373,362
050,39,077,"Ohio","Huron County",5,12,733,375,358
050,39,077,"Ohio","Huron County",5,13,795,407,388
050,39,077,"Ohio","Huron County",5,14,864,460,404
050,39,077,"Ohio","Huron County",5,15,919,474,445
050,39,077,"Ohio","Huron County",5,16,859,447,412
050,39,077,"Ohio","Huron County",5,17,880,453,427
050,39,077,"Ohio","Huron County",5,18,751,398,353
050,39,077,"Ohio","Huron County",5,19,577,297,280
050,39,077,"Ohio","Huron County",5,20,619,335,284
050,39,077,"Ohio","Huron County",5,21,666,344,322
050,39,077,"Ohio","Huron County",5,22,674,350,324
050,39,077,"Ohio","Huron County",5,23,717,350,367
050,39,077,"Ohio","Huron County",5,24,710,349,361
050,39,077,"Ohio","Huron County",5,25,684,359,325
050,39,077,"Ohio","Huron County",5,26,669,353,316
050,39,077,"Ohio","Huron County",5,27,681,356,325
050,39,077,"Ohio","Huron County",5,28,678,356,322
050,39,077,"Ohio","Huron County",5,29,714,367,347
050,39,077,"Ohio","Huron County",5,30,706,373,333
050,39,077,"Ohio","Huron County",5,31,738,389,349
050,39,077,"Ohio","Huron County",5,32,686,347,339
050,39,077,"Ohio","Huron County",5,33,711,380,331
050,39,077,"Ohio","Huron County",5,34,709,367,342
050,39,077,"Ohio","Huron County",5,35,673,343,330
050,39,077,"Ohio","Huron County",5,36,694,373,321
050,39,077,"Ohio","Huron County",5,37,676,347,329
050,39,077,"Ohio","Huron County",5,38,670,328,342
050,39,077,"Ohio","Huron County",5,39,677,331,346
050,39,077,"Ohio","Huron County",5,40,684,338,346
050,39,077,"Ohio","Huron County",5,41,717,368,349
050,39,077,"Ohio","Huron County",5,42,732,368,364
050,39,077,"Ohio","Huron County",5,43,711,344,367
050,39,077,"Ohio","Huron County",5,44,695,342,353
050,39,077,"Ohio","Huron County",5,45,703,343,360
050,39,077,"Ohio","Huron County",5,46,690,342,348
050,39,077,"Ohio","Huron County",5,47,636,311,325
050,39,077,"Ohio","Huron County",5,48,648,345,303
050,39,077,"Ohio","Huron County",5,49,658,334,324
050,39,077,"Ohio","Huron County",5,50,718,375,343
050,39,077,"Ohio","Huron County",5,51,746,394,352
050,39,077,"Ohio","Huron County",5,52,772,414,358
050,39,077,"Ohio","Huron County",5,53,750,383,367
050,39,077,"Ohio","Huron County",5,54,706,357,349
050,39,077,"Ohio","Huron County",5,55,711,342,369
050,39,077,"Ohio","Huron County",5,56,770,377,393
050,39,077,"Ohio","Huron County",5,57,782,372,410
050,39,077,"Ohio","Huron County",5,58,788,387,401
050,39,077,"Ohio","Huron County",5,59,828,418,410
050,39,077,"Ohio","Huron County",5,60,854,415,439
050,39,077,"Ohio","Huron County",5,61,820,406,414
050,39,077,"Ohio","Huron County",5,62,782,381,401
050,39,077,"Ohio","Huron County",5,63,776,378,398
050,39,077,"Ohio","Huron County",5,64,779,366,413
050,39,077,"Ohio","Huron County",5,65,793,390,403
050,39,077,"Ohio","Huron County",5,66,762,368,394
050,39,077,"Ohio","Huron County",5,67,761,374,387
050,39,077,"Ohio","Huron County",5,68,702,315,387
050,39,077,"Ohio","Huron County",5,69,682,328,354
050,39,077,"Ohio","Huron County",5,70,625,298,327
050,39,077,"Ohio","Huron County",5,71,625,290,335
050,39,077,"Ohio","Huron County",5,72,637,300,337
050,39,077,"Ohio","Huron County",5,73,558,247,311
050,39,077,"Ohio","Huron County",5,74,536,245,291
050,39,077,"Ohio","Huron County",5,75,513,250,263
050,39,077,"Ohio","Huron County",5,76,554,271,283
050,39,077,"Ohio","Huron County",5,77,371,182,189
050,39,077,"Ohio","Huron County",5,78,340,151,189
050,39,077,"Ohio","Huron County",5,79,325,130,195
050,39,077,"Ohio","Huron County",5,80,332,136,196
050,39,077,"Ohio","Huron County",5,81,264,104,160
050,39,077,"Ohio","Huron County",5,82,246,92,154
050,39,077,"Ohio","Huron County",5,83,231,100,131
050,39,077,"Ohio","Huron County",5,84,194,79,115
050,39,077,"Ohio","Huron County",5,85,1024,391,633
050,39,079,"Ohio","Jackson County",1,0,375,191,184
050,39,079,"Ohio","Jackson County",1,1,404,206,198
050,39,079,"Ohio","Jackson County",1,2,438,227,211
050,39,079,"Ohio","Jackson County",1,3,416,216,200
050,39,079,"Ohio","Jackson County",1,4,432,217,215
050,39,079,"Ohio","Jackson County",1,5,411,200,211
050,39,079,"Ohio","Jackson County",1,6,450,238,212
050,39,079,"Ohio","Jackson County",1,7,465,241,224
050,39,079,"Ohio","Jackson County",1,8,407,201,206
050,39,079,"Ohio","Jackson County",1,9,395,205,190
050,39,079,"Ohio","Jackson County",1,10,443,236,207
050,39,079,"Ohio","Jackson County",1,11,458,237,221
050,39,079,"Ohio","Jackson County",1,12,452,236,216
050,39,079,"Ohio","Jackson County",1,13,465,239,226
050,39,079,"Ohio","Jackson County",1,14,477,228,249
050,39,079,"Ohio","Jackson County",1,15,466,238,228
050,39,079,"Ohio","Jackson County",1,16,484,251,233
050,39,079,"Ohio","Jackson County",1,17,447,249,198
050,39,079,"Ohio","Jackson County",1,18,377,219,158
050,39,079,"Ohio","Jackson County",1,19,312,176,136
050,39,079,"Ohio","Jackson County",1,20,334,176,158
050,39,079,"Ohio","Jackson County",1,21,353,183,170
050,39,079,"Ohio","Jackson County",1,22,351,180,171
050,39,079,"Ohio","Jackson County",1,23,350,163,187
050,39,079,"Ohio","Jackson County",1,24,360,176,184
050,39,079,"Ohio","Jackson County",1,25,379,186,193
050,39,079,"Ohio","Jackson County",1,26,383,189,194
050,39,079,"Ohio","Jackson County",1,27,380,195,185
050,39,079,"Ohio","Jackson County",1,28,402,199,203
050,39,079,"Ohio","Jackson County",1,29,407,201,206
050,39,079,"Ohio","Jackson County",1,30,427,208,219
050,39,079,"Ohio","Jackson County",1,31,418,221,197
050,39,079,"Ohio","Jackson County",1,32,395,206,189
050,39,079,"Ohio","Jackson County",1,33,378,199,179
050,39,079,"Ohio","Jackson County",1,34,417,215,202
050,39,079,"Ohio","Jackson County",1,35,424,227,197
050,39,079,"Ohio","Jackson County",1,36,400,194,206
050,39,079,"Ohio","Jackson County",1,37,386,189,197
050,39,079,"Ohio","Jackson County",1,38,379,176,203
050,39,079,"Ohio","Jackson County",1,39,406,193,213
050,39,079,"Ohio","Jackson County",1,40,426,213,213
050,39,079,"Ohio","Jackson County",1,41,421,213,208
050,39,079,"Ohio","Jackson County",1,42,400,197,203
050,39,079,"Ohio","Jackson County",1,43,398,191,207
050,39,079,"Ohio","Jackson County",1,44,392,199,193
050,39,079,"Ohio","Jackson County",1,45,405,218,187
050,39,079,"Ohio","Jackson County",1,46,408,201,207
050,39,079,"Ohio","Jackson County",1,47,405,200,205
050,39,079,"Ohio","Jackson County",1,48,427,212,215
050,39,079,"Ohio","Jackson County",1,49,443,227,216
050,39,079,"Ohio","Jackson County",1,50,427,222,205
050,39,079,"Ohio","Jackson County",1,51,441,220,221
050,39,079,"Ohio","Jackson County",1,52,412,207,205
050,39,079,"Ohio","Jackson County",1,53,431,218,213
050,39,079,"Ohio","Jackson County",1,54,433,230,203
050,39,079,"Ohio","Jackson County",1,55,438,224,214
050,39,079,"Ohio","Jackson County",1,56,437,215,222
050,39,079,"Ohio","Jackson County",1,57,438,221,217
050,39,079,"Ohio","Jackson County",1,58,442,217,225
050,39,079,"Ohio","Jackson County",1,59,424,215,209
050,39,079,"Ohio","Jackson County",1,60,443,225,218
050,39,079,"Ohio","Jackson County",1,61,451,209,242
050,39,079,"Ohio","Jackson County",1,62,459,216,243
050,39,079,"Ohio","Jackson County",1,63,420,196,224
050,39,079,"Ohio","Jackson County",1,64,453,223,230
050,39,079,"Ohio","Jackson County",1,65,422,208,214
050,39,079,"Ohio","Jackson County",1,66,426,201,225
050,39,079,"Ohio","Jackson County",1,67,393,181,212
050,39,079,"Ohio","Jackson County",1,68,384,184,200
050,39,079,"Ohio","Jackson County",1,69,362,183,179
050,39,079,"Ohio","Jackson County",1,70,356,172,184
050,39,079,"Ohio","Jackson County",1,71,336,156,180
050,39,079,"Ohio","Jackson County",1,72,319,134,185
050,39,079,"Ohio","Jackson County",1,73,341,158,183
050,39,079,"Ohio","Jackson County",1,74,235,105,130
050,39,079,"Ohio","Jackson County",1,75,226,97,129
050,39,079,"Ohio","Jackson County",1,76,208,90,118
050,39,079,"Ohio","Jackson County",1,77,207,100,107
050,39,079,"Ohio","Jackson County",1,78,184,80,104
050,39,079,"Ohio","Jackson County",1,79,164,68,96
050,39,079,"Ohio","Jackson County",1,80,145,56,89
050,39,079,"Ohio","Jackson County",1,81,122,51,71
050,39,079,"Ohio","Jackson County",1,82,129,57,72
050,39,079,"Ohio","Jackson County",1,83,114,44,70
050,39,079,"Ohio","Jackson County",1,84,101,43,58
050,39,079,"Ohio","Jackson County",1,85,495,156,339
050,39,079,"Ohio","Jackson County",2,0,362,189,173
050,39,079,"Ohio","Jackson County",2,1,394,202,192
050,39,079,"Ohio","Jackson County",2,2,427,219,208
050,39,079,"Ohio","Jackson County",2,3,418,217,201
050,39,079,"Ohio","Jackson County",2,4,429,218,211
050,39,079,"Ohio","Jackson County",2,5,417,204,213
050,39,079,"Ohio","Jackson County",2,6,443,229,214
050,39,079,"Ohio","Jackson County",2,7,459,238,221
050,39,079,"Ohio","Jackson County",2,8,420,211,209
050,39,079,"Ohio","Jackson County",2,9,401,207,194
050,39,079,"Ohio","Jackson County",2,10,434,229,205
050,39,079,"Ohio","Jackson County",2,11,455,238,217
050,39,079,"Ohio","Jackson County",2,12,460,240,220
050,39,079,"Ohio","Jackson County",2,13,463,238,225
050,39,079,"Ohio","Jackson County",2,14,478,234,244
050,39,079,"Ohio","Jackson County",2,15,474,239,235
050,39,079,"Ohio","Jackson County",2,16,482,250,232
050,39,079,"Ohio","Jackson County",2,17,456,250,206
050,39,079,"Ohio","Jackson County",2,18,373,216,157
050,39,079,"Ohio","Jackson County",2,19,309,177,132
050,39,079,"Ohio","Jackson County",2,20,341,183,158
050,39,079,"Ohio","Jackson County",2,21,351,183,168
050,39,079,"Ohio","Jackson County",2,22,357,183,174
050,39,079,"Ohio","Jackson County",2,23,353,169,184
050,39,079,"Ohio","Jackson County",2,24,360,174,186
050,39,079,"Ohio","Jackson County",2,25,375,185,190
050,39,079,"Ohio","Jackson County",2,26,384,192,192
050,39,079,"Ohio","Jackson County",2,27,380,193,187
050,39,079,"Ohio","Jackson County",2,28,396,198,198
050,39,079,"Ohio","Jackson County",2,29,405,200,205
050,39,079,"Ohio","Jackson County",2,30,421,204,217
050,39,079,"Ohio","Jackson County",2,31,418,216,202
050,39,079,"Ohio","Jackson County",2,32,400,209,191
050,39,079,"Ohio","Jackson County",2,33,383,201,182
050,39,079,"Ohio","Jackson County",2,34,409,212,197
050,39,079,"Ohio","Jackson County",2,35,426,225,201
050,39,079,"Ohio","Jackson County",2,36,404,201,203
050,39,079,"Ohio","Jackson County",2,37,390,191,199
050,39,079,"Ohio","Jackson County",2,38,386,181,205
050,39,079,"Ohio","Jackson County",2,39,400,188,212
050,39,079,"Ohio","Jackson County",2,40,427,211,216
050,39,079,"Ohio","Jackson County",2,41,424,215,209
050,39,079,"Ohio","Jackson County",2,42,402,199,203
050,39,079,"Ohio","Jackson County",2,43,403,194,209
050,39,079,"Ohio","Jackson County",2,44,389,195,194
050,39,079,"Ohio","Jackson County",2,45,405,214,191
050,39,079,"Ohio","Jackson County",2,46,407,204,203
050,39,079,"Ohio","Jackson County",2,47,406,200,206
050,39,079,"Ohio","Jackson County",2,48,421,209,212
050,39,079,"Ohio","Jackson County",2,49,441,225,216
050,39,079,"Ohio","Jackson County",2,50,430,223,207
050,39,079,"Ohio","Jackson County",2,51,437,222,215
050,39,079,"Ohio","Jackson County",2,52,417,210,207
050,39,079,"Ohio","Jackson County",2,53,431,218,213
050,39,079,"Ohio","Jackson County",2,54,435,229,206
050,39,079,"Ohio","Jackson County",2,55,434,224,210
050,39,079,"Ohio","Jackson County",2,56,436,216,220
050,39,079,"Ohio","Jackson County",2,57,440,219,221
050,39,079,"Ohio","Jackson County",2,58,441,218,223
050,39,079,"Ohio","Jackson County",2,59,427,215,212
050,39,079,"Ohio","Jackson County",2,60,439,223,216
050,39,079,"Ohio","Jackson County",2,61,449,212,237
050,39,079,"Ohio","Jackson County",2,62,455,213,242
050,39,079,"Ohio","Jackson County",2,63,433,203,230
050,39,079,"Ohio","Jackson County",2,64,438,213,225
050,39,079,"Ohio","Jackson County",2,65,423,210,213
050,39,079,"Ohio","Jackson County",2,66,428,204,224
050,39,079,"Ohio","Jackson County",2,67,398,185,213
050,39,079,"Ohio","Jackson County",2,68,383,182,201
050,39,079,"Ohio","Jackson County",2,69,368,184,184
050,39,079,"Ohio","Jackson County",2,70,354,173,181
050,39,079,"Ohio","Jackson County",2,71,341,158,183
050,39,079,"Ohio","Jackson County",2,72,313,138,175
050,39,079,"Ohio","Jackson County",2,73,351,159,192
050,39,079,"Ohio","Jackson County",2,74,245,110,135
050,39,079,"Ohio","Jackson County",2,75,225,98,127
050,39,079,"Ohio","Jackson County",2,76,206,90,116
050,39,079,"Ohio","Jackson County",2,77,207,98,109
050,39,079,"Ohio","Jackson County",2,78,186,84,102
050,39,079,"Ohio","Jackson County",2,79,169,71,98
050,39,079,"Ohio","Jackson County",2,80,149,58,91
050,39,079,"Ohio","Jackson County",2,81,121,48,73
050,39,079,"Ohio","Jackson County",2,82,123,54,69
050,39,079,"Ohio","Jackson County",2,83,115,45,70
050,39,079,"Ohio","Jackson County",2,84,101,42,59
050,39,079,"Ohio","Jackson County",2,85,496,155,341
050,39,079,"Ohio","Jackson County",3,0,383,186,197
050,39,079,"Ohio","Jackson County",3,1,354,190,164
050,39,079,"Ohio","Jackson County",3,2,405,206,199
050,39,079,"Ohio","Jackson County",3,3,432,223,209
050,39,079,"Ohio","Jackson County",3,4,428,227,201
050,39,079,"Ohio","Jackson County",3,5,436,224,212
050,39,079,"Ohio","Jackson County",3,6,414,206,208
050,39,079,"Ohio","Jackson County",3,7,448,235,213
050,39,079,"Ohio","Jackson County",3,8,464,240,224
050,39,079,"Ohio","Jackson County",3,9,408,204,204
050,39,079,"Ohio","Jackson County",3,10,400,208,192
050,39,079,"Ohio","Jackson County",3,11,419,221,198
050,39,079,"Ohio","Jackson County",3,12,440,232,208
050,39,079,"Ohio","Jackson County",3,13,450,240,210
050,39,079,"Ohio","Jackson County",3,14,474,242,232
050,39,079,"Ohio","Jackson County",3,15,479,235,244
050,39,079,"Ohio","Jackson County",3,16,472,235,237
050,39,079,"Ohio","Jackson County",3,17,467,240,227
050,39,079,"Ohio","Jackson County",3,18,386,214,172
050,39,079,"Ohio","Jackson County",3,19,300,171,129
050,39,079,"Ohio","Jackson County",3,20,340,198,142
050,39,079,"Ohio","Jackson County",3,21,361,186,175
050,39,079,"Ohio","Jackson County",3,22,345,170,175
050,39,079,"Ohio","Jackson County",3,23,387,202,185
050,39,079,"Ohio","Jackson County",3,24,360,174,186
050,39,079,"Ohio","Jackson County",3,25,383,178,205
050,39,079,"Ohio","Jackson County",3,26,394,203,191
050,39,079,"Ohio","Jackson County",3,27,385,196,189
050,39,079,"Ohio","Jackson County",3,28,372,192,180
050,39,079,"Ohio","Jackson County",3,29,413,210,203
050,39,079,"Ohio","Jackson County",3,30,405,199,206
050,39,079,"Ohio","Jackson County",3,31,431,212,219
050,39,079,"Ohio","Jackson County",3,32,432,222,210
050,39,079,"Ohio","Jackson County",3,33,385,200,185
050,39,079,"Ohio","Jackson County",3,34,385,199,186
050,39,079,"Ohio","Jackson County",3,35,413,216,197
050,39,079,"Ohio","Jackson County",3,36,414,226,188
050,39,079,"Ohio","Jackson County",3,37,396,194,202
050,39,079,"Ohio","Jackson County",3,38,386,191,195
050,39,079,"Ohio","Jackson County",3,39,382,180,202
050,39,079,"Ohio","Jackson County",3,40,388,181,207
050,39,079,"Ohio","Jackson County",3,41,423,207,216
050,39,079,"Ohio","Jackson County",3,42,431,215,216
050,39,079,"Ohio","Jackson County",3,43,395,197,198
050,39,079,"Ohio","Jackson County",3,44,390,190,200
050,39,079,"Ohio","Jackson County",3,45,385,187,198
050,39,079,"Ohio","Jackson County",3,46,406,221,185
050,39,079,"Ohio","Jackson County",3,47,403,205,198
050,39,079,"Ohio","Jackson County",3,48,404,201,203
050,39,079,"Ohio","Jackson County",3,49,415,212,203
050,39,079,"Ohio","Jackson County",3,50,443,228,215
050,39,079,"Ohio","Jackson County",3,51,430,220,210
050,39,079,"Ohio","Jackson County",3,52,437,221,216
050,39,079,"Ohio","Jackson County",3,53,416,209,207
050,39,079,"Ohio","Jackson County",3,54,426,214,212
050,39,079,"Ohio","Jackson County",3,55,422,217,205
050,39,079,"Ohio","Jackson County",3,56,434,221,213
050,39,079,"Ohio","Jackson County",3,57,436,215,221
050,39,079,"Ohio","Jackson County",3,58,427,211,216
050,39,079,"Ohio","Jackson County",3,59,437,210,227
050,39,079,"Ohio","Jackson County",3,60,437,215,222
050,39,079,"Ohio","Jackson County",3,61,439,217,222
050,39,079,"Ohio","Jackson County",3,62,439,203,236
050,39,079,"Ohio","Jackson County",3,63,448,212,236
050,39,079,"Ohio","Jackson County",3,64,432,202,230
050,39,079,"Ohio","Jackson County",3,65,431,208,223
050,39,079,"Ohio","Jackson County",3,66,409,202,207
050,39,079,"Ohio","Jackson County",3,67,418,201,217
050,39,079,"Ohio","Jackson County",3,68,385,174,211
050,39,079,"Ohio","Jackson County",3,69,368,173,195
050,39,079,"Ohio","Jackson County",3,70,351,176,175
050,39,079,"Ohio","Jackson County",3,71,340,158,182
050,39,079,"Ohio","Jackson County",3,72,326,150,176
050,39,079,"Ohio","Jackson County",3,73,294,131,163
050,39,079,"Ohio","Jackson County",3,74,336,142,194
050,39,079,"Ohio","Jackson County",3,75,222,102,120
050,39,079,"Ohio","Jackson County",3,76,217,96,121
050,39,079,"Ohio","Jackson County",3,77,189,83,106
050,39,079,"Ohio","Jackson County",3,78,201,94,107
050,39,079,"Ohio","Jackson County",3,79,173,80,93
050,39,079,"Ohio","Jackson County",3,80,153,62,91
050,39,079,"Ohio","Jackson County",3,81,134,55,79
050,39,079,"Ohio","Jackson County",3,82,118,45,73
050,39,079,"Ohio","Jackson County",3,83,111,45,66
050,39,079,"Ohio","Jackson County",3,84,106,44,62
050,39,079,"Ohio","Jackson County",3,85,486,167,319
050,39,079,"Ohio","Jackson County",4,0,381,191,190
050,39,079,"Ohio","Jackson County",4,1,392,204,188
050,39,079,"Ohio","Jackson County",4,2,357,183,174
050,39,079,"Ohio","Jackson County",4,3,413,209,204
050,39,079,"Ohio","Jackson County",4,4,439,230,209
050,39,079,"Ohio","Jackson County",4,5,438,229,209
050,39,079,"Ohio","Jackson County",4,6,446,231,215
050,39,079,"Ohio","Jackson County",4,7,417,206,211
050,39,079,"Ohio","Jackson County",4,8,444,237,207
050,39,079,"Ohio","Jackson County",4,9,463,244,219
050,39,079,"Ohio","Jackson County",4,10,414,208,206
050,39,079,"Ohio","Jackson County",4,11,397,209,188
050,39,079,"Ohio","Jackson County",4,12,432,236,196
050,39,079,"Ohio","Jackson County",4,13,454,242,212
050,39,079,"Ohio","Jackson County",4,14,456,241,215
050,39,079,"Ohio","Jackson County",4,15,475,246,229
050,39,079,"Ohio","Jackson County",4,16,501,245,256
050,39,079,"Ohio","Jackson County",4,17,476,234,242
050,39,079,"Ohio","Jackson County",4,18,399,213,186
050,39,079,"Ohio","Jackson County",4,19,297,171,126
050,39,079,"Ohio","Jackson County",4,20,308,176,132
050,39,079,"Ohio","Jackson County",4,21,332,187,145
050,39,079,"Ohio","Jackson County",4,22,375,186,189
050,39,079,"Ohio","Jackson County",4,23,372,184,188
050,39,079,"Ohio","Jackson County",4,24,394,212,182
050,39,079,"Ohio","Jackson County",4,25,336,161,175
050,39,079,"Ohio","Jackson County",4,26,387,188,199
050,39,079,"Ohio","Jackson County",4,27,391,197,194
050,39,079,"Ohio","Jackson County",4,28,393,201,192
050,39,079,"Ohio","Jackson County",4,29,394,206,188
050,39,079,"Ohio","Jackson County",4,30,405,201,204
050,39,079,"Ohio","Jackson County",4,31,424,210,214
050,39,079,"Ohio","Jackson County",4,32,441,219,222
050,39,079,"Ohio","Jackson County",4,33,435,222,213
050,39,079,"Ohio","Jackson County",4,34,400,205,195
050,39,079,"Ohio","Jackson County",4,35,381,194,187
050,39,079,"Ohio","Jackson County",4,36,411,219,192
050,39,079,"Ohio","Jackson County",4,37,424,228,196
050,39,079,"Ohio","Jackson County",4,38,400,202,198
050,39,079,"Ohio","Jackson County",4,39,379,185,194
050,39,079,"Ohio","Jackson County",4,40,398,188,210
050,39,079,"Ohio","Jackson County",4,41,385,182,203
050,39,079,"Ohio","Jackson County",4,42,424,203,221
050,39,079,"Ohio","Jackson County",4,43,424,211,213
050,39,079,"Ohio","Jackson County",4,44,396,203,193
050,39,079,"Ohio","Jackson County",4,45,388,181,207
050,39,079,"Ohio","Jackson County",4,46,385,188,197
050,39,079,"Ohio","Jackson County",4,47,414,229,185
050,39,079,"Ohio","Jackson County",4,48,391,201,190
050,39,079,"Ohio","Jackson County",4,49,412,205,207
050,39,079,"Ohio","Jackson County",4,50,405,204,201
050,39,079,"Ohio","Jackson County",4,51,458,241,217
050,39,079,"Ohio","Jackson County",4,52,431,220,211
050,39,079,"Ohio","Jackson County",4,53,444,218,226
050,39,079,"Ohio","Jackson County",4,54,414,208,206
050,39,079,"Ohio","Jackson County",4,55,428,210,218
050,39,079,"Ohio","Jackson County",4,56,423,216,207
050,39,079,"Ohio","Jackson County",4,57,436,219,217
050,39,079,"Ohio","Jackson County",4,58,428,211,217
050,39,079,"Ohio","Jackson County",4,59,422,207,215
050,39,079,"Ohio","Jackson County",4,60,425,203,222
050,39,079,"Ohio","Jackson County",4,61,436,212,224
050,39,079,"Ohio","Jackson County",4,62,438,217,221
050,39,079,"Ohio","Jackson County",4,63,430,198,232
050,39,079,"Ohio","Jackson County",4,64,456,215,241
050,39,079,"Ohio","Jackson County",4,65,418,196,222
050,39,079,"Ohio","Jackson County",4,66,424,207,217
050,39,079,"Ohio","Jackson County",4,67,401,194,207
050,39,079,"Ohio","Jackson County",4,68,411,194,217
050,39,079,"Ohio","Jackson County",4,69,372,163,209
050,39,079,"Ohio","Jackson County",4,70,356,168,188
050,39,079,"Ohio","Jackson County",4,71,337,164,173
050,39,079,"Ohio","Jackson County",4,72,326,153,173
050,39,079,"Ohio","Jackson County",4,73,310,141,169
050,39,079,"Ohio","Jackson County",4,74,283,124,159
050,39,079,"Ohio","Jackson County",4,75,321,135,186
050,39,079,"Ohio","Jackson County",4,76,208,97,111
050,39,079,"Ohio","Jackson County",4,77,205,89,116
050,39,079,"Ohio","Jackson County",4,78,179,75,104
050,39,079,"Ohio","Jackson County",4,79,185,86,99
050,39,079,"Ohio","Jackson County",4,80,163,75,88
050,39,079,"Ohio","Jackson County",4,81,129,56,73
050,39,079,"Ohio","Jackson County",4,82,126,51,75
050,39,079,"Ohio","Jackson County",4,83,106,37,69
050,39,079,"Ohio","Jackson County",4,84,101,43,58
050,39,079,"Ohio","Jackson County",4,85,486,174,312
050,39,079,"Ohio","Jackson County",5,0,376,188,188
050,39,079,"Ohio","Jackson County",5,1,384,192,192
050,39,079,"Ohio","Jackson County",5,2,396,213,183
050,39,079,"Ohio","Jackson County",5,3,358,186,172
050,39,079,"Ohio","Jackson County",5,4,414,207,207
050,39,079,"Ohio","Jackson County",5,5,435,221,214
050,39,079,"Ohio","Jackson County",5,6,437,228,209
050,39,079,"Ohio","Jackson County",5,7,448,229,219
050,39,079,"Ohio","Jackson County",5,8,432,209,223
050,39,079,"Ohio","Jackson County",5,9,453,246,207
050,39,079,"Ohio","Jackson County",5,10,471,249,222
050,39,079,"Ohio","Jackson County",5,11,438,215,223
050,39,079,"Ohio","Jackson County",5,12,392,215,177
050,39,079,"Ohio","Jackson County",5,13,431,241,190
050,39,079,"Ohio","Jackson County",5,14,454,242,212
050,39,079,"Ohio","Jackson County",5,15,444,234,210
050,39,079,"Ohio","Jackson County",5,16,474,242,232
050,39,079,"Ohio","Jackson County",5,17,502,247,255
050,39,079,"Ohio","Jackson County",5,18,398,208,190
050,39,079,"Ohio","Jackson County",5,19,308,162,146
050,39,079,"Ohio","Jackson County",5,20,328,183,145
050,39,079,"Ohio","Jackson County",5,21,330,185,145
050,39,079,"Ohio","Jackson County",5,22,361,191,170
050,39,079,"Ohio","Jackson County",5,23,408,206,202
050,39,079,"Ohio","Jackson County",5,24,382,193,189
050,39,079,"Ohio","Jackson County",5,25,414,211,203
050,39,079,"Ohio","Jackson County",5,26,322,155,167
050,39,079,"Ohio","Jackson County",5,27,376,180,196
050,39,079,"Ohio","Jackson County",5,28,389,198,191
050,39,079,"Ohio","Jackson County",5,29,397,201,196
050,39,079,"Ohio","Jackson County",5,30,391,194,197
050,39,079,"Ohio","Jackson County",5,31,421,214,207
050,39,079,"Ohio","Jackson County",5,32,417,210,207
050,39,079,"Ohio","Jackson County",5,33,435,218,217
050,39,079,"Ohio","Jackson County",5,34,429,215,214
050,39,079,"Ohio","Jackson County",5,35,406,214,192
050,39,079,"Ohio","Jackson County",5,36,380,189,191
050,39,079,"Ohio","Jackson County",5,37,403,207,196
050,39,079,"Ohio","Jackson County",5,38,422,220,202
050,39,079,"Ohio","Jackson County",5,39,387,197,190
050,39,079,"Ohio","Jackson County",5,40,387,187,200
050,39,079,"Ohio","Jackson County",5,41,422,204,218
050,39,079,"Ohio","Jackson County",5,42,391,179,212
050,39,079,"Ohio","Jackson County",5,43,424,204,220
050,39,079,"Ohio","Jackson County",5,44,419,204,215
050,39,079,"Ohio","Jackson County",5,45,396,202,194
050,39,079,"Ohio","Jackson County",5,46,386,175,211
050,39,079,"Ohio","Jackson County",5,47,378,182,196
050,39,079,"Ohio","Jackson County",5,48,404,227,177
050,39,079,"Ohio","Jackson County",5,49,401,209,192
050,39,079,"Ohio","Jackson County",5,50,418,210,208
050,39,079,"Ohio","Jackson County",5,51,404,204,200
050,39,079,"Ohio","Jackson County",5,52,453,237,216
050,39,079,"Ohio","Jackson County",5,53,425,219,206
050,39,079,"Ohio","Jackson County",5,54,447,218,229
050,39,079,"Ohio","Jackson County",5,55,410,201,209
050,39,079,"Ohio","Jackson County",5,56,425,209,216
050,39,079,"Ohio","Jackson County",5,57,423,214,209
050,39,079,"Ohio","Jackson County",5,58,430,217,213
050,39,079,"Ohio","Jackson County",5,59,420,204,216
050,39,079,"Ohio","Jackson County",5,60,423,205,218
050,39,079,"Ohio","Jackson County",5,61,430,203,227
050,39,079,"Ohio","Jackson County",5,62,435,210,225
050,39,079,"Ohio","Jackson County",5,63,433,219,214
050,39,079,"Ohio","Jackson County",5,64,435,199,236
050,39,079,"Ohio","Jackson County",5,65,438,211,227
050,39,079,"Ohio","Jackson County",5,66,410,191,219
050,39,079,"Ohio","Jackson County",5,67,410,199,211
050,39,079,"Ohio","Jackson County",5,68,394,189,205
050,39,079,"Ohio","Jackson County",5,69,396,185,211
050,39,079,"Ohio","Jackson County",5,70,357,158,199
050,39,079,"Ohio","Jackson County",5,71,342,157,185
050,39,079,"Ohio","Jackson County",5,72,320,157,163
050,39,079,"Ohio","Jackson County",5,73,318,149,169
050,39,079,"Ohio","Jackson County",5,74,305,133,172
050,39,079,"Ohio","Jackson County",5,75,268,119,149
050,39,079,"Ohio","Jackson County",5,76,298,127,171
050,39,079,"Ohio","Jackson County",5,77,196,93,103
050,39,079,"Ohio","Jackson County",5,78,197,82,115
050,39,079,"Ohio","Jackson County",5,79,162,64,98
050,39,079,"Ohio","Jackson County",5,80,167,75,92
050,39,079,"Ohio","Jackson County",5,81,139,67,72
050,39,079,"Ohio","Jackson County",5,82,124,52,72
050,39,079,"Ohio","Jackson County",5,83,112,43,69
050,39,079,"Ohio","Jackson County",5,84,98,36,62
050,39,079,"Ohio","Jackson County",5,85,493,184,309
050,39,081,"Ohio","Jefferson County",1,0,653,336,317
050,39,081,"Ohio","Jefferson County",1,1,657,338,319
050,39,081,"Ohio","Jefferson County",1,2,680,356,324
050,39,081,"Ohio","Jefferson County",1,3,670,343,327
050,39,081,"Ohio","Jefferson County",1,4,669,342,327
050,39,081,"Ohio","Jefferson County",1,5,700,376,324
050,39,081,"Ohio","Jefferson County",1,6,675,351,324
050,39,081,"Ohio","Jefferson County",1,7,670,349,321
050,39,081,"Ohio","Jefferson County",1,8,675,352,323
050,39,081,"Ohio","Jefferson County",1,9,656,339,317
050,39,081,"Ohio","Jefferson County",1,10,712,370,342
050,39,081,"Ohio","Jefferson County",1,11,746,378,368
050,39,081,"Ohio","Jefferson County",1,12,772,404,368
050,39,081,"Ohio","Jefferson County",1,13,763,390,373
050,39,081,"Ohio","Jefferson County",1,14,767,382,385
050,39,081,"Ohio","Jefferson County",1,15,752,386,366
050,39,081,"Ohio","Jefferson County",1,16,799,404,395
050,39,081,"Ohio","Jefferson County",1,17,751,389,362
050,39,081,"Ohio","Jefferson County",1,18,877,409,468
050,39,081,"Ohio","Jefferson County",1,19,901,417,484
050,39,081,"Ohio","Jefferson County",1,20,925,450,475
050,39,081,"Ohio","Jefferson County",1,21,951,455,496
050,39,081,"Ohio","Jefferson County",1,22,858,425,433
050,39,081,"Ohio","Jefferson County",1,23,771,399,372
050,39,081,"Ohio","Jefferson County",1,24,746,369,377
050,39,081,"Ohio","Jefferson County",1,25,728,371,357
050,39,081,"Ohio","Jefferson County",1,26,747,390,357
050,39,081,"Ohio","Jefferson County",1,27,715,346,369
050,39,081,"Ohio","Jefferson County",1,28,773,377,396
050,39,081,"Ohio","Jefferson County",1,29,803,402,401
050,39,081,"Ohio","Jefferson County",1,30,799,387,412
050,39,081,"Ohio","Jefferson County",1,31,789,411,378
050,39,081,"Ohio","Jefferson County",1,32,718,372,346
050,39,081,"Ohio","Jefferson County",1,33,658,326,332
050,39,081,"Ohio","Jefferson County",1,34,641,316,325
050,39,081,"Ohio","Jefferson County",1,35,655,333,322
050,39,081,"Ohio","Jefferson County",1,36,639,326,313
050,39,081,"Ohio","Jefferson County",1,37,664,333,331
050,39,081,"Ohio","Jefferson County",1,38,689,377,312
050,39,081,"Ohio","Jefferson County",1,39,721,366,355
050,39,081,"Ohio","Jefferson County",1,40,705,351,354
050,39,081,"Ohio","Jefferson County",1,41,677,348,329
050,39,081,"Ohio","Jefferson County",1,42,693,359,334
050,39,081,"Ohio","Jefferson County",1,43,692,347,345
050,39,081,"Ohio","Jefferson County",1,44,684,332,352
050,39,081,"Ohio","Jefferson County",1,45,694,331,363
050,39,081,"Ohio","Jefferson County",1,46,733,356,377
050,39,081,"Ohio","Jefferson County",1,47,782,392,390
050,39,081,"Ohio","Jefferson County",1,48,867,423,444
050,39,081,"Ohio","Jefferson County",1,49,918,481,437
050,39,081,"Ohio","Jefferson County",1,50,823,412,411
050,39,081,"Ohio","Jefferson County",1,51,782,401,381
050,39,081,"Ohio","Jefferson County",1,52,807,426,381
050,39,081,"Ohio","Jefferson County",1,53,815,410,405
050,39,081,"Ohio","Jefferson County",1,54,837,410,427
050,39,081,"Ohio","Jefferson County",1,55,912,441,471
050,39,081,"Ohio","Jefferson County",1,56,928,444,484
050,39,081,"Ohio","Jefferson County",1,57,976,467,509
050,39,081,"Ohio","Jefferson County",1,58,980,476,504
050,39,081,"Ohio","Jefferson County",1,59,1009,503,506
050,39,081,"Ohio","Jefferson County",1,60,1009,508,501
050,39,081,"Ohio","Jefferson County",1,61,1039,508,531
050,39,081,"Ohio","Jefferson County",1,62,1091,532,559
050,39,081,"Ohio","Jefferson County",1,63,1059,526,533
050,39,081,"Ohio","Jefferson County",1,64,1011,494,517
050,39,081,"Ohio","Jefferson County",1,65,982,481,501
050,39,081,"Ohio","Jefferson County",1,66,1002,489,513
050,39,081,"Ohio","Jefferson County",1,67,953,468,485
050,39,081,"Ohio","Jefferson County",1,68,933,455,478
050,39,081,"Ohio","Jefferson County",1,69,843,400,443
050,39,081,"Ohio","Jefferson County",1,70,826,403,423
050,39,081,"Ohio","Jefferson County",1,71,785,383,402
050,39,081,"Ohio","Jefferson County",1,72,805,373,432
050,39,081,"Ohio","Jefferson County",1,73,809,375,434
050,39,081,"Ohio","Jefferson County",1,74,551,260,291
050,39,081,"Ohio","Jefferson County",1,75,504,240,264
050,39,081,"Ohio","Jefferson County",1,76,508,234,274
050,39,081,"Ohio","Jefferson County",1,77,505,230,275
050,39,081,"Ohio","Jefferson County",1,78,453,185,268
050,39,081,"Ohio","Jefferson County",1,79,429,185,244
050,39,081,"Ohio","Jefferson County",1,80,392,158,234
050,39,081,"Ohio","Jefferson County",1,81,412,190,222
050,39,081,"Ohio","Jefferson County",1,82,382,160,222
050,39,081,"Ohio","Jefferson County",1,83,311,122,189
050,39,081,"Ohio","Jefferson County",1,84,275,110,165
050,39,081,"Ohio","Jefferson County",1,85,1530,520,1010
050,39,081,"Ohio","Jefferson County",2,0,655,334,321
050,39,081,"Ohio","Jefferson County",2,1,657,337,320
050,39,081,"Ohio","Jefferson County",2,2,680,354,326
050,39,081,"Ohio","Jefferson County",2,3,672,346,326
050,39,081,"Ohio","Jefferson County",2,4,673,343,330
050,39,081,"Ohio","Jefferson County",2,5,693,367,326
050,39,081,"Ohio","Jefferson County",2,6,682,358,324
050,39,081,"Ohio","Jefferson County",2,7,671,350,321
050,39,081,"Ohio","Jefferson County",2,8,671,349,322
050,39,081,"Ohio","Jefferson County",2,9,666,345,321
050,39,081,"Ohio","Jefferson County",2,10,704,367,337
050,39,081,"Ohio","Jefferson County",2,11,734,373,361
050,39,081,"Ohio","Jefferson County",2,12,767,400,367
050,39,081,"Ohio","Jefferson County",2,13,759,391,368
050,39,081,"Ohio","Jefferson County",2,14,768,386,382
050,39,081,"Ohio","Jefferson County",2,15,761,388,373
050,39,081,"Ohio","Jefferson County",2,16,789,401,388
050,39,081,"Ohio","Jefferson County",2,17,766,395,371
050,39,081,"Ohio","Jefferson County",2,18,869,405,464
050,39,081,"Ohio","Jefferson County",2,19,898,416,482
050,39,081,"Ohio","Jefferson County",2,20,933,450,483
050,39,081,"Ohio","Jefferson County",2,21,951,456,495
050,39,081,"Ohio","Jefferson County",2,22,859,429,430
050,39,081,"Ohio","Jefferson County",2,23,763,393,370
050,39,081,"Ohio","Jefferson County",2,24,749,373,376
050,39,081,"Ohio","Jefferson County",2,25,731,371,360
050,39,081,"Ohio","Jefferson County",2,26,744,384,360
050,39,081,"Ohio","Jefferson County",2,27,722,355,367
050,39,081,"Ohio","Jefferson County",2,28,762,372,390
050,39,081,"Ohio","Jefferson County",2,29,798,398,400
050,39,081,"Ohio","Jefferson County",2,30,807,394,413
050,39,081,"Ohio","Jefferson County",2,31,791,406,385
050,39,081,"Ohio","Jefferson County",2,32,729,376,353
050,39,081,"Ohio","Jefferson County",2,33,673,336,337
050,39,081,"Ohio","Jefferson County",2,34,645,319,326
050,39,081,"Ohio","Jefferson County",2,35,653,330,323
050,39,081,"Ohio","Jefferson County",2,36,639,327,312
050,39,081,"Ohio","Jefferson County",2,37,661,334,327
050,39,081,"Ohio","Jefferson County",2,38,683,365,318
050,39,081,"Ohio","Jefferson County",2,39,712,368,344
050,39,081,"Ohio","Jefferson County",2,40,710,356,354
050,39,081,"Ohio","Jefferson County",2,41,683,350,333
050,39,081,"Ohio","Jefferson County",2,42,682,354,328
050,39,081,"Ohio","Jefferson County",2,43,695,352,343
050,39,081,"Ohio","Jefferson County",2,44,676,332,344
050,39,081,"Ohio","Jefferson County",2,45,698,334,364
050,39,081,"Ohio","Jefferson County",2,46,720,349,371
050,39,081,"Ohio","Jefferson County",2,47,764,380,384
050,39,081,"Ohio","Jefferson County",2,48,847,417,430
050,39,081,"Ohio","Jefferson County",2,49,910,467,443
050,39,081,"Ohio","Jefferson County",2,50,848,432,416
050,39,081,"Ohio","Jefferson County",2,51,785,398,387
050,39,081,"Ohio","Jefferson County",2,52,795,416,379
050,39,081,"Ohio","Jefferson County",2,53,812,413,399
050,39,081,"Ohio","Jefferson County",2,54,828,409,419
050,39,081,"Ohio","Jefferson County",2,55,892,432,460
050,39,081,"Ohio","Jefferson County",2,56,927,446,481
050,39,081,"Ohio","Jefferson County",2,57,966,461,505
050,39,081,"Ohio","Jefferson County",2,58,979,474,505
050,39,081,"Ohio","Jefferson County",2,59,1005,498,507
050,39,081,"Ohio","Jefferson County",2,60,1001,502,499
050,39,081,"Ohio","Jefferson County",2,61,1026,504,522
050,39,081,"Ohio","Jefferson County",2,62,1072,522,550
050,39,081,"Ohio","Jefferson County",2,63,1075,533,542
050,39,081,"Ohio","Jefferson County",2,64,1002,491,511
050,39,081,"Ohio","Jefferson County",2,65,986,482,504
050,39,081,"Ohio","Jefferson County",2,66,994,486,508
050,39,081,"Ohio","Jefferson County",2,67,957,470,487
050,39,081,"Ohio","Jefferson County",2,68,922,450,472
050,39,081,"Ohio","Jefferson County",2,69,868,414,454
050,39,081,"Ohio","Jefferson County",2,70,822,398,424
050,39,081,"Ohio","Jefferson County",2,71,789,385,404
050,39,081,"Ohio","Jefferson County",2,72,784,367,417
050,39,081,"Ohio","Jefferson County",2,73,841,387,454
050,39,081,"Ohio","Jefferson County",2,74,567,265,302
050,39,081,"Ohio","Jefferson County",2,75,511,240,271
050,39,081,"Ohio","Jefferson County",2,76,501,229,272
050,39,081,"Ohio","Jefferson County",2,77,512,233,279
050,39,081,"Ohio","Jefferson County",2,78,449,191,258
050,39,081,"Ohio","Jefferson County",2,79,423,180,243
050,39,081,"Ohio","Jefferson County",2,80,396,164,232
050,39,081,"Ohio","Jefferson County",2,81,402,178,224
050,39,081,"Ohio","Jefferson County",2,82,390,167,223
050,39,081,"Ohio","Jefferson County",2,83,317,130,187
050,39,081,"Ohio","Jefferson County",2,84,275,109,166
050,39,081,"Ohio","Jefferson County",2,85,1534,528,1006
050,39,081,"Ohio","Jefferson County",3,0,631,332,299
050,39,081,"Ohio","Jefferson County",3,1,649,315,334
050,39,081,"Ohio","Jefferson County",3,2,659,338,321
050,39,081,"Ohio","Jefferson County",3,3,669,351,318
050,39,081,"Ohio","Jefferson County",3,4,669,348,321
050,39,081,"Ohio","Jefferson County",3,5,684,348,336
050,39,081,"Ohio","Jefferson County",3,6,704,369,335
050,39,081,"Ohio","Jefferson County",3,7,681,360,321
050,39,081,"Ohio","Jefferson County",3,8,680,345,335
050,39,081,"Ohio","Jefferson County",3,9,675,353,322
050,39,081,"Ohio","Jefferson County",3,10,663,345,318
050,39,081,"Ohio","Jefferson County",3,11,716,364,352
050,39,081,"Ohio","Jefferson County",3,12,732,377,355
050,39,081,"Ohio","Jefferson County",3,13,793,412,381
050,39,081,"Ohio","Jefferson County",3,14,774,398,376
050,39,081,"Ohio","Jefferson County",3,15,778,387,391
050,39,081,"Ohio","Jefferson County",3,16,762,391,371
050,39,081,"Ohio","Jefferson County",3,17,790,399,391
050,39,081,"Ohio","Jefferson County",3,18,911,410,501
050,39,081,"Ohio","Jefferson County",3,19,957,434,523
050,39,081,"Ohio","Jefferson County",3,20,992,462,530
050,39,081,"Ohio","Jefferson County",3,21,997,475,522
050,39,081,"Ohio","Jefferson County",3,22,890,455,435
050,39,081,"Ohio","Jefferson County",3,23,750,399,351
050,39,081,"Ohio","Jefferson County",3,24,738,372,366
050,39,081,"Ohio","Jefferson County",3,25,734,365,369
050,39,081,"Ohio","Jefferson County",3,26,745,381,364
050,39,081,"Ohio","Jefferson County",3,27,731,368,363
050,39,081,"Ohio","Jefferson County",3,28,721,357,364
050,39,081,"Ohio","Jefferson County",3,29,737,363,374
050,39,081,"Ohio","Jefferson County",3,30,803,404,399
050,39,081,"Ohio","Jefferson County",3,31,828,407,421
050,39,081,"Ohio","Jefferson County",3,32,771,389,382
050,39,081,"Ohio","Jefferson County",3,33,722,362,360
050,39,081,"Ohio","Jefferson County",3,34,686,345,341
050,39,081,"Ohio","Jefferson County",3,35,644,323,321
050,39,081,"Ohio","Jefferson County",3,36,655,329,326
050,39,081,"Ohio","Jefferson County",3,37,644,333,311
050,39,081,"Ohio","Jefferson County",3,38,669,345,324
050,39,081,"Ohio","Jefferson County",3,39,689,366,323
050,39,081,"Ohio","Jefferson County",3,40,702,359,343
050,39,081,"Ohio","Jefferson County",3,41,723,367,356
050,39,081,"Ohio","Jefferson County",3,42,682,339,343
050,39,081,"Ohio","Jefferson County",3,43,702,366,336
050,39,081,"Ohio","Jefferson County",3,44,685,342,343
050,39,081,"Ohio","Jefferson County",3,45,668,330,338
050,39,081,"Ohio","Jefferson County",3,46,714,340,374
050,39,081,"Ohio","Jefferson County",3,47,707,341,366
050,39,081,"Ohio","Jefferson County",3,48,772,380,392
050,39,081,"Ohio","Jefferson County",3,49,841,413,428
050,39,081,"Ohio","Jefferson County",3,50,921,480,441
050,39,081,"Ohio","Jefferson County",3,51,842,424,418
050,39,081,"Ohio","Jefferson County",3,52,798,403,395
050,39,081,"Ohio","Jefferson County",3,53,793,424,369
050,39,081,"Ohio","Jefferson County",3,54,792,395,397
050,39,081,"Ohio","Jefferson County",3,55,815,402,413
050,39,081,"Ohio","Jefferson County",3,56,879,420,459
050,39,081,"Ohio","Jefferson County",3,57,912,441,471
050,39,081,"Ohio","Jefferson County",3,58,966,458,508
050,39,081,"Ohio","Jefferson County",3,59,963,466,497
050,39,081,"Ohio","Jefferson County",3,60,980,482,498
050,39,081,"Ohio","Jefferson County",3,61,989,495,494
050,39,081,"Ohio","Jefferson County",3,62,1014,493,521
050,39,081,"Ohio","Jefferson County",3,63,1063,515,548
050,39,081,"Ohio","Jefferson County",3,64,1059,515,544
050,39,081,"Ohio","Jefferson County",3,65,968,468,500
050,39,081,"Ohio","Jefferson County",3,66,963,466,497
050,39,081,"Ohio","Jefferson County",3,67,971,476,495
050,39,081,"Ohio","Jefferson County",3,68,935,451,484
050,39,081,"Ohio","Jefferson County",3,69,905,441,464
050,39,081,"Ohio","Jefferson County",3,70,834,391,443
050,39,081,"Ohio","Jefferson County",3,71,789,385,404
050,39,081,"Ohio","Jefferson County",3,72,769,373,396
050,39,081,"Ohio","Jefferson County",3,73,751,344,407
050,39,081,"Ohio","Jefferson County",3,74,804,369,435
050,39,081,"Ohio","Jefferson County",3,75,549,256,293
050,39,081,"Ohio","Jefferson County",3,76,491,221,270
050,39,081,"Ohio","Jefferson County",3,77,473,216,257
050,39,081,"Ohio","Jefferson County",3,78,477,218,259
050,39,081,"Ohio","Jefferson County",3,79,434,191,243
050,39,081,"Ohio","Jefferson County",3,80,386,158,228
050,39,081,"Ohio","Jefferson County",3,81,373,147,226
050,39,081,"Ohio","Jefferson County",3,82,378,157,221
050,39,081,"Ohio","Jefferson County",3,83,341,146,195
050,39,081,"Ohio","Jefferson County",3,84,293,119,174
050,39,081,"Ohio","Jefferson County",3,85,1496,533,963
050,39,081,"Ohio","Jefferson County",4,0,613,322,291
050,39,081,"Ohio","Jefferson County",4,1,635,331,304
050,39,081,"Ohio","Jefferson County",4,2,658,324,334
050,39,081,"Ohio","Jefferson County",4,3,645,333,312
050,39,081,"Ohio","Jefferson County",4,4,661,354,307
050,39,081,"Ohio","Jefferson County",4,5,672,348,324
050,39,081,"Ohio","Jefferson County",4,6,669,348,321
050,39,081,"Ohio","Jefferson County",4,7,713,366,347
050,39,081,"Ohio","Jefferson County",4,8,676,354,322
050,39,081,"Ohio","Jefferson County",4,9,704,358,346
050,39,081,"Ohio","Jefferson County",4,10,690,360,330
050,39,081,"Ohio","Jefferson County",4,11,667,342,325
050,39,081,"Ohio","Jefferson County",4,12,703,347,356
050,39,081,"Ohio","Jefferson County",4,13,726,367,359
050,39,081,"Ohio","Jefferson County",4,14,797,423,374
050,39,081,"Ohio","Jefferson County",4,15,785,404,381
050,39,081,"Ohio","Jefferson County",4,16,767,381,386
050,39,081,"Ohio","Jefferson County",4,17,765,383,382
050,39,081,"Ohio","Jefferson County",4,18,892,410,482
050,39,081,"Ohio","Jefferson County",4,19,911,417,494
050,39,081,"Ohio","Jefferson County",4,20,925,434,491
050,39,081,"Ohio","Jefferson County",4,21,951,438,513
050,39,081,"Ohio","Jefferson County",4,22,876,450,426
050,39,081,"Ohio","Jefferson County",4,23,763,410,353
050,39,081,"Ohio","Jefferson County",4,24,753,380,373
050,39,081,"Ohio","Jefferson County",4,25,714,357,357
050,39,081,"Ohio","Jefferson County",4,26,752,383,369
050,39,081,"Ohio","Jefferson County",4,27,741,377,364
050,39,081,"Ohio","Jefferson County",4,28,728,369,359
050,39,081,"Ohio","Jefferson County",4,29,713,350,363
050,39,081,"Ohio","Jefferson County",4,30,735,366,369
050,39,081,"Ohio","Jefferson County",4,31,815,415,400
050,39,081,"Ohio","Jefferson County",4,32,809,393,416
050,39,081,"Ohio","Jefferson County",4,33,757,377,380
050,39,081,"Ohio","Jefferson County",4,34,724,370,354
050,39,081,"Ohio","Jefferson County",4,35,684,336,348
050,39,081,"Ohio","Jefferson County",4,36,647,324,323
050,39,081,"Ohio","Jefferson County",4,37,668,336,332
050,39,081,"Ohio","Jefferson County",4,38,648,332,316
050,39,081,"Ohio","Jefferson County",4,39,681,351,330
050,39,081,"Ohio","Jefferson County",4,40,679,366,313
050,39,081,"Ohio","Jefferson County",4,41,686,356,330
050,39,081,"Ohio","Jefferson County",4,42,714,365,349
050,39,081,"Ohio","Jefferson County",4,43,677,335,342
050,39,081,"Ohio","Jefferson County",4,44,704,361,343
050,39,081,"Ohio","Jefferson County",4,45,688,339,349
050,39,081,"Ohio","Jefferson County",4,46,675,334,341
050,39,081,"Ohio","Jefferson County",4,47,702,339,363
050,39,081,"Ohio","Jefferson County",4,48,701,337,364
050,39,081,"Ohio","Jefferson County",4,49,754,371,383
050,39,081,"Ohio","Jefferson County",4,50,849,420,429
050,39,081,"Ohio","Jefferson County",4,51,913,473,440
050,39,081,"Ohio","Jefferson County",4,52,837,422,415
050,39,081,"Ohio","Jefferson County",4,53,783,395,388
050,39,081,"Ohio","Jefferson County",4,54,792,418,374
050,39,081,"Ohio","Jefferson County",4,55,790,392,398
050,39,081,"Ohio","Jefferson County",4,56,802,393,409
050,39,081,"Ohio","Jefferson County",4,57,861,416,445
050,39,081,"Ohio","Jefferson County",4,58,892,432,460
050,39,081,"Ohio","Jefferson County",4,59,958,457,501
050,39,081,"Ohio","Jefferson County",4,60,938,450,488
050,39,081,"Ohio","Jefferson County",4,61,961,476,485
050,39,081,"Ohio","Jefferson County",4,62,970,486,484
050,39,081,"Ohio","Jefferson County",4,63,988,475,513
050,39,081,"Ohio","Jefferson County",4,64,1039,498,541
050,39,081,"Ohio","Jefferson County",4,65,1030,500,530
050,39,081,"Ohio","Jefferson County",4,66,930,454,476
050,39,081,"Ohio","Jefferson County",4,67,928,446,482
050,39,081,"Ohio","Jefferson County",4,68,944,460,484
050,39,081,"Ohio","Jefferson County",4,69,906,435,471
050,39,081,"Ohio","Jefferson County",4,70,877,422,455
050,39,081,"Ohio","Jefferson County",4,71,797,373,424
050,39,081,"Ohio","Jefferson County",4,72,761,367,394
050,39,081,"Ohio","Jefferson County",4,73,744,359,385
050,39,081,"Ohio","Jefferson County",4,74,708,316,392
050,39,081,"Ohio","Jefferson County",4,75,776,357,419
050,39,081,"Ohio","Jefferson County",4,76,534,240,294
050,39,081,"Ohio","Jefferson County",4,77,463,207,256
050,39,081,"Ohio","Jefferson County",4,78,437,200,237
050,39,081,"Ohio","Jefferson County",4,79,445,204,241
050,39,081,"Ohio","Jefferson County",4,80,396,166,230
050,39,081,"Ohio","Jefferson County",4,81,364,144,220
050,39,081,"Ohio","Jefferson County",4,82,347,129,218
050,39,081,"Ohio","Jefferson County",4,83,330,139,191
050,39,081,"Ohio","Jefferson County",4,84,302,126,176
050,39,081,"Ohio","Jefferson County",4,85,1468,541,927
050,39,081,"Ohio","Jefferson County",5,0,524,284,240
050,39,081,"Ohio","Jefferson County",5,1,641,326,315
050,39,081,"Ohio","Jefferson County",5,2,635,335,300
050,39,081,"Ohio","Jefferson County",5,3,672,334,338
050,39,081,"Ohio","Jefferson County",5,4,664,345,319
050,39,081,"Ohio","Jefferson County",5,5,660,355,305
050,39,081,"Ohio","Jefferson County",5,6,692,358,334
050,39,081,"Ohio","Jefferson County",5,7,673,349,324
050,39,081,"Ohio","Jefferson County",5,8,712,372,340
050,39,081,"Ohio","Jefferson County",5,9,689,359,330
050,39,081,"Ohio","Jefferson County",5,10,727,373,354
050,39,081,"Ohio","Jefferson County",5,11,696,369,327
050,39,081,"Ohio","Jefferson County",5,12,662,340,322
050,39,081,"Ohio","Jefferson County",5,13,703,343,360
050,39,081,"Ohio","Jefferson County",5,14,735,376,359
050,39,081,"Ohio","Jefferson County",5,15,801,423,378
050,39,081,"Ohio","Jefferson County",5,16,782,401,381
050,39,081,"Ohio","Jefferson County",5,17,794,400,394
050,39,081,"Ohio","Jefferson County",5,18,895,394,501
050,39,081,"Ohio","Jefferson County",5,19,947,432,515
050,39,081,"Ohio","Jefferson County",5,20,957,448,509
050,39,081,"Ohio","Jefferson County",5,21,961,444,517
050,39,081,"Ohio","Jefferson County",5,22,893,438,455
050,39,081,"Ohio","Jefferson County",5,23,791,430,361
050,39,081,"Ohio","Jefferson County",5,24,748,405,343
050,39,081,"Ohio","Jefferson County",5,25,739,380,359
050,39,081,"Ohio","Jefferson County",5,26,711,375,336
050,39,081,"Ohio","Jefferson County",5,27,732,371,361
050,39,081,"Ohio","Jefferson County",5,28,747,372,375
050,39,081,"Ohio","Jefferson County",5,29,713,363,350
050,39,081,"Ohio","Jefferson County",5,30,696,339,357
050,39,081,"Ohio","Jefferson County",5,31,757,386,371
050,39,081,"Ohio","Jefferson County",5,32,781,394,387
050,39,081,"Ohio","Jefferson County",5,33,799,385,414
050,39,081,"Ohio","Jefferson County",5,34,763,379,384
050,39,081,"Ohio","Jefferson County",5,35,726,365,361
050,39,081,"Ohio","Jefferson County",5,36,701,346,355
050,39,081,"Ohio","Jefferson County",5,37,649,325,324
050,39,081,"Ohio","Jefferson County",5,38,664,337,327
050,39,081,"Ohio","Jefferson County",5,39,642,330,312
050,39,081,"Ohio","Jefferson County",5,40,667,347,320
050,39,081,"Ohio","Jefferson County",5,41,696,374,322
050,39,081,"Ohio","Jefferson County",5,42,712,377,335
050,39,081,"Ohio","Jefferson County",5,43,718,366,352
050,39,081,"Ohio","Jefferson County",5,44,671,332,339
050,39,081,"Ohio","Jefferson County",5,45,706,359,347
050,39,081,"Ohio","Jefferson County",5,46,698,344,354
050,39,081,"Ohio","Jefferson County",5,47,681,337,344
050,39,081,"Ohio","Jefferson County",5,48,691,332,359
050,39,081,"Ohio","Jefferson County",5,49,702,342,360
050,39,081,"Ohio","Jefferson County",5,50,756,376,380
050,39,081,"Ohio","Jefferson County",5,51,838,411,427
050,39,081,"Ohio","Jefferson County",5,52,919,475,444
050,39,081,"Ohio","Jefferson County",5,53,831,419,412
050,39,081,"Ohio","Jefferson County",5,54,767,382,385
050,39,081,"Ohio","Jefferson County",5,55,775,406,369
050,39,081,"Ohio","Jefferson County",5,56,777,389,388
050,39,081,"Ohio","Jefferson County",5,57,783,391,392
050,39,081,"Ohio","Jefferson County",5,58,844,407,437
050,39,081,"Ohio","Jefferson County",5,59,894,432,462
050,39,081,"Ohio","Jefferson County",5,60,945,450,495
050,39,081,"Ohio","Jefferson County",5,61,939,452,487
050,39,081,"Ohio","Jefferson County",5,62,943,463,480
050,39,081,"Ohio","Jefferson County",5,63,965,481,484
050,39,081,"Ohio","Jefferson County",5,64,962,450,512
050,39,081,"Ohio","Jefferson County",5,65,1008,477,531
050,39,081,"Ohio","Jefferson County",5,66,1009,493,516
050,39,081,"Ohio","Jefferson County",5,67,911,441,470
050,39,081,"Ohio","Jefferson County",5,68,913,436,477
050,39,081,"Ohio","Jefferson County",5,69,923,448,475
050,39,081,"Ohio","Jefferson County",5,70,877,412,465
050,39,081,"Ohio","Jefferson County",5,71,838,399,439
050,39,081,"Ohio","Jefferson County",5,72,763,352,411
050,39,081,"Ohio","Jefferson County",5,73,736,352,384
050,39,081,"Ohio","Jefferson County",5,74,703,338,365
050,39,081,"Ohio","Jefferson County",5,75,675,300,375
050,39,081,"Ohio","Jefferson County",5,76,760,341,419
050,39,081,"Ohio","Jefferson County",5,77,504,227,277
050,39,081,"Ohio","Jefferson County",5,78,437,196,241
050,39,081,"Ohio","Jefferson County",5,79,413,192,221
050,39,081,"Ohio","Jefferson County",5,80,404,179,225
050,39,081,"Ohio","Jefferson County",5,81,375,154,221
050,39,081,"Ohio","Jefferson County",5,82,332,124,208
050,39,081,"Ohio","Jefferson County",5,83,300,111,189
050,39,081,"Ohio","Jefferson County",5,84,302,125,177
050,39,081,"Ohio","Jefferson County",5,85,1489,571,918
050,39,083,"Ohio","Knox County",1,0,729,373,356
050,39,083,"Ohio","Knox County",1,1,743,395,348
050,39,083,"Ohio","Knox County",1,2,773,379,394
050,39,083,"Ohio","Knox County",1,3,774,390,384
050,39,083,"Ohio","Knox County",1,4,792,398,394
050,39,083,"Ohio","Knox County",1,5,777,372,405
050,39,083,"Ohio","Knox County",1,6,752,381,371
050,39,083,"Ohio","Knox County",1,7,773,394,379
050,39,083,"Ohio","Knox County",1,8,754,384,370
050,39,083,"Ohio","Knox County",1,9,749,392,357
050,39,083,"Ohio","Knox County",1,10,852,446,406
050,39,083,"Ohio","Knox County",1,11,864,452,412
050,39,083,"Ohio","Knox County",1,12,895,462,433
050,39,083,"Ohio","Knox County",1,13,889,462,427
050,39,083,"Ohio","Knox County",1,14,855,439,416
050,39,083,"Ohio","Knox County",1,15,833,423,410
050,39,083,"Ohio","Knox County",1,16,855,434,421
050,39,083,"Ohio","Knox County",1,17,846,432,414
050,39,083,"Ohio","Knox County",1,18,1014,489,525
050,39,083,"Ohio","Knox County",1,19,1276,615,661
050,39,083,"Ohio","Knox County",1,20,1250,589,661
050,39,083,"Ohio","Knox County",1,21,1177,589,588
050,39,083,"Ohio","Knox County",1,22,1047,533,514
050,39,083,"Ohio","Knox County",1,23,687,345,342
050,39,083,"Ohio","Knox County",1,24,666,322,344
050,39,083,"Ohio","Knox County",1,25,646,328,318
050,39,083,"Ohio","Knox County",1,26,650,324,326
050,39,083,"Ohio","Knox County",1,27,682,352,330
050,39,083,"Ohio","Knox County",1,28,703,362,341
050,39,083,"Ohio","Knox County",1,29,690,364,326
050,39,083,"Ohio","Knox County",1,30,705,338,367
050,39,083,"Ohio","Knox County",1,31,704,329,375
050,39,083,"Ohio","Knox County",1,32,673,326,347
050,39,083,"Ohio","Knox County",1,33,651,315,336
050,39,083,"Ohio","Knox County",1,34,706,337,369
050,39,083,"Ohio","Knox County",1,35,714,357,357
050,39,083,"Ohio","Knox County",1,36,658,319,339
050,39,083,"Ohio","Knox County",1,37,696,340,356
050,39,083,"Ohio","Knox County",1,38,719,374,345
050,39,083,"Ohio","Knox County",1,39,698,357,341
050,39,083,"Ohio","Knox County",1,40,702,356,346
050,39,083,"Ohio","Knox County",1,41,672,342,330
050,39,083,"Ohio","Knox County",1,42,717,350,367
050,39,083,"Ohio","Knox County",1,43,700,370,330
050,39,083,"Ohio","Knox County",1,44,641,332,309
050,39,083,"Ohio","Knox County",1,45,642,326,316
050,39,083,"Ohio","Knox County",1,46,646,329,317
050,39,083,"Ohio","Knox County",1,47,672,337,335
050,39,083,"Ohio","Knox County",1,48,734,364,370
050,39,083,"Ohio","Knox County",1,49,789,403,386
050,39,083,"Ohio","Knox County",1,50,745,382,363
050,39,083,"Ohio","Knox County",1,51,746,383,363
050,39,083,"Ohio","Knox County",1,52,694,358,336
050,39,083,"Ohio","Knox County",1,53,753,369,384
050,39,083,"Ohio","Knox County",1,54,813,416,397
050,39,083,"Ohio","Knox County",1,55,809,402,407
050,39,083,"Ohio","Knox County",1,56,824,416,408
050,39,083,"Ohio","Knox County",1,57,814,401,413
050,39,083,"Ohio","Knox County",1,58,833,423,410
050,39,083,"Ohio","Knox County",1,59,901,438,463
050,39,083,"Ohio","Knox County",1,60,918,435,483
050,39,083,"Ohio","Knox County",1,61,897,437,460
050,39,083,"Ohio","Knox County",1,62,915,441,474
050,39,083,"Ohio","Knox County",1,63,878,432,446
050,39,083,"Ohio","Knox County",1,64,863,425,438
050,39,083,"Ohio","Knox County",1,65,829,400,429
050,39,083,"Ohio","Knox County",1,66,779,353,426
050,39,083,"Ohio","Knox County",1,67,757,361,396
050,39,083,"Ohio","Knox County",1,68,777,377,400
050,39,083,"Ohio","Knox County",1,69,670,333,337
050,39,083,"Ohio","Knox County",1,70,655,310,345
050,39,083,"Ohio","Knox County",1,71,640,302,338
050,39,083,"Ohio","Knox County",1,72,669,322,347
050,39,083,"Ohio","Knox County",1,73,646,313,333
050,39,083,"Ohio","Knox County",1,74,426,201,225
050,39,083,"Ohio","Knox County",1,75,436,206,230
050,39,083,"Ohio","Knox County",1,76,423,202,221
050,39,083,"Ohio","Knox County",1,77,448,210,238
050,39,083,"Ohio","Knox County",1,78,403,189,214
050,39,083,"Ohio","Knox County",1,79,343,161,182
050,39,083,"Ohio","Knox County",1,80,297,134,163
050,39,083,"Ohio","Knox County",1,81,282,124,158
050,39,083,"Ohio","Knox County",1,82,267,110,157
050,39,083,"Ohio","Knox County",1,83,254,101,153
050,39,083,"Ohio","Knox County",1,84,189,75,114
050,39,083,"Ohio","Knox County",1,85,1296,468,828
050,39,083,"Ohio","Knox County",2,0,735,405,330
050,39,083,"Ohio","Knox County",2,1,740,390,350
050,39,083,"Ohio","Knox County",2,2,769,385,384
050,39,083,"Ohio","Knox County",2,3,772,388,384
050,39,083,"Ohio","Knox County",2,4,796,399,397
050,39,083,"Ohio","Knox County",2,5,786,382,404
050,39,083,"Ohio","Knox County",2,6,763,381,382
050,39,083,"Ohio","Knox County",2,7,770,393,377
050,39,083,"Ohio","Knox County",2,8,759,386,373
050,39,083,"Ohio","Knox County",2,9,752,392,360
050,39,083,"Ohio","Knox County",2,10,830,434,396
050,39,083,"Ohio","Knox County",2,11,861,450,411
050,39,083,"Ohio","Knox County",2,12,897,464,433
050,39,083,"Ohio","Knox County",2,13,891,462,429
050,39,083,"Ohio","Knox County",2,14,867,443,424
050,39,083,"Ohio","Knox County",2,15,842,429,413
050,39,083,"Ohio","Knox County",2,16,855,434,421
050,39,083,"Ohio","Knox County",2,17,849,433,416
050,39,083,"Ohio","Knox County",2,18,1002,486,516
050,39,083,"Ohio","Knox County",2,19,1277,611,666
050,39,083,"Ohio","Knox County",2,20,1252,590,662
050,39,083,"Ohio","Knox County",2,21,1186,592,594
050,39,083,"Ohio","Knox County",2,22,1041,530,511
050,39,083,"Ohio","Knox County",2,23,703,357,346
050,39,083,"Ohio","Knox County",2,24,658,319,339
050,39,083,"Ohio","Knox County",2,25,653,329,324
050,39,083,"Ohio","Knox County",2,26,652,329,323
050,39,083,"Ohio","Knox County",2,27,674,343,331
050,39,083,"Ohio","Knox County",2,28,696,359,337
050,39,083,"Ohio","Knox County",2,29,693,364,329
050,39,083,"Ohio","Knox County",2,30,705,348,357
050,39,083,"Ohio","Knox County",2,31,702,331,371
050,39,083,"Ohio","Knox County",2,32,685,330,355
050,39,083,"Ohio","Knox County",2,33,659,320,339
050,39,083,"Ohio","Knox County",2,34,698,336,362
050,39,083,"Ohio","Knox County",2,35,719,354,365
050,39,083,"Ohio","Knox County",2,36,669,326,343
050,39,083,"Ohio","Knox County",2,37,686,335,351
050,39,083,"Ohio","Knox County",2,38,717,367,350
050,39,083,"Ohio","Knox County",2,39,705,363,342
050,39,083,"Ohio","Knox County",2,40,703,359,344
050,39,083,"Ohio","Knox County",2,41,675,342,333
050,39,083,"Ohio","Knox County",2,42,705,348,357
050,39,083,"Ohio","Knox County",2,43,711,369,342
050,39,083,"Ohio","Knox County",2,44,649,337,312
050,39,083,"Ohio","Knox County",2,45,644,329,315
050,39,083,"Ohio","Knox County",2,46,644,329,315
050,39,083,"Ohio","Knox County",2,47,660,330,330
050,39,083,"Ohio","Knox County",2,48,717,357,360
050,39,083,"Ohio","Knox County",2,49,777,395,382
050,39,083,"Ohio","Knox County",2,50,756,388,368
050,39,083,"Ohio","Knox County",2,51,739,379,360
050,39,083,"Ohio","Knox County",2,52,703,363,340
050,39,083,"Ohio","Knox County",2,53,741,366,375
050,39,083,"Ohio","Knox County",2,54,793,403,390
050,39,083,"Ohio","Knox County",2,55,810,405,405
050,39,083,"Ohio","Knox County",2,56,825,414,411
050,39,083,"Ohio","Knox County",2,57,819,408,411
050,39,083,"Ohio","Knox County",2,58,830,419,411
050,39,083,"Ohio","Knox County",2,59,894,438,456
050,39,083,"Ohio","Knox County",2,60,907,433,474
050,39,083,"Ohio","Knox County",2,61,896,435,461
050,39,083,"Ohio","Knox County",2,62,905,436,469
050,39,083,"Ohio","Knox County",2,63,894,438,456
050,39,083,"Ohio","Knox County",2,64,862,424,438
050,39,083,"Ohio","Knox County",2,65,839,406,433
050,39,083,"Ohio","Knox County",2,66,788,364,424
050,39,083,"Ohio","Knox County",2,67,759,358,401
050,39,083,"Ohio","Knox County",2,68,764,371,393
050,39,083,"Ohio","Knox County",2,69,700,345,355
050,39,083,"Ohio","Knox County",2,70,659,315,344
050,39,083,"Ohio","Knox County",2,71,645,303,342
050,39,083,"Ohio","Knox County",2,72,650,312,338
050,39,083,"Ohio","Knox County",2,73,683,329,354
050,39,083,"Ohio","Knox County",2,74,449,210,239
050,39,083,"Ohio","Knox County",2,75,434,207,227
050,39,083,"Ohio","Knox County",2,76,419,199,220
050,39,083,"Ohio","Knox County",2,77,446,207,239
050,39,083,"Ohio","Knox County",2,78,399,188,211
050,39,083,"Ohio","Knox County",2,79,351,166,185
050,39,083,"Ohio","Knox County",2,80,304,140,164
050,39,083,"Ohio","Knox County",2,81,277,125,152
050,39,083,"Ohio","Knox County",2,82,268,110,158
050,39,083,"Ohio","Knox County",2,83,252,97,155
050,39,083,"Ohio","Knox County",2,84,195,78,117
050,39,083,"Ohio","Knox County",2,85,1297,467,830
050,39,083,"Ohio","Knox County",3,0,730,385,345
050,39,083,"Ohio","Knox County",3,1,765,417,348
050,39,083,"Ohio","Knox County",3,2,725,375,350
050,39,083,"Ohio","Knox County",3,3,783,404,379
050,39,083,"Ohio","Knox County",3,4,771,387,384
050,39,083,"Ohio","Knox County",3,5,803,409,394
050,39,083,"Ohio","Knox County",3,6,794,392,402
050,39,083,"Ohio","Knox County",3,7,763,385,378
050,39,083,"Ohio","Knox County",3,8,772,400,372
050,39,083,"Ohio","Knox County",3,9,758,388,370
050,39,083,"Ohio","Knox County",3,10,755,400,355
050,39,083,"Ohio","Knox County",3,11,834,435,399
050,39,083,"Ohio","Knox County",3,12,878,455,423
050,39,083,"Ohio","Knox County",3,13,900,467,433
050,39,083,"Ohio","Knox County",3,14,906,460,446
050,39,083,"Ohio","Knox County",3,15,864,448,416
050,39,083,"Ohio","Knox County",3,16,852,444,408
050,39,083,"Ohio","Knox County",3,17,851,432,419
050,39,083,"Ohio","Knox County",3,18,938,476,462
050,39,083,"Ohio","Knox County",3,19,1141,551,590
050,39,083,"Ohio","Knox County",3,20,1116,532,584
050,39,083,"Ohio","Knox County",3,21,1101,550,551
050,39,083,"Ohio","Knox County",3,22,995,501,494
050,39,083,"Ohio","Knox County",3,23,711,391,320
050,39,083,"Ohio","Knox County",3,24,660,326,334
050,39,083,"Ohio","Knox County",3,25,669,325,344
050,39,083,"Ohio","Knox County",3,26,648,339,309
050,39,083,"Ohio","Knox County",3,27,661,326,335
050,39,083,"Ohio","Knox County",3,28,655,333,322
050,39,083,"Ohio","Knox County",3,29,705,366,339
050,39,083,"Ohio","Knox County",3,30,711,373,338
050,39,083,"Ohio","Knox County",3,31,728,355,373
050,39,083,"Ohio","Knox County",3,32,712,337,375
050,39,083,"Ohio","Knox County",3,33,692,343,349
050,39,083,"Ohio","Knox County",3,34,657,320,337
050,39,083,"Ohio","Knox County",3,35,715,348,367
050,39,083,"Ohio","Knox County",3,36,738,367,371
050,39,083,"Ohio","Knox County",3,37,670,318,352
050,39,083,"Ohio","Knox County",3,38,696,341,355
050,39,083,"Ohio","Knox County",3,39,705,357,348
050,39,083,"Ohio","Knox County",3,40,700,360,340
050,39,083,"Ohio","Knox County",3,41,715,369,346
050,39,083,"Ohio","Knox County",3,42,679,338,341
050,39,083,"Ohio","Knox County",3,43,719,356,363
050,39,083,"Ohio","Knox County",3,44,714,367,347
050,39,083,"Ohio","Knox County",3,45,647,340,307
050,39,083,"Ohio","Knox County",3,46,651,333,318
050,39,083,"Ohio","Knox County",3,47,655,331,324
050,39,083,"Ohio","Knox County",3,48,649,324,325
050,39,083,"Ohio","Knox County",3,49,705,357,348
050,39,083,"Ohio","Knox County",3,50,788,397,391
050,39,083,"Ohio","Knox County",3,51,763,393,370
050,39,083,"Ohio","Knox County",3,52,748,381,367
050,39,083,"Ohio","Knox County",3,53,702,358,344
050,39,083,"Ohio","Knox County",3,54,747,367,380
050,39,083,"Ohio","Knox County",3,55,800,403,397
050,39,083,"Ohio","Knox County",3,56,808,405,403
050,39,083,"Ohio","Knox County",3,57,822,409,413
050,39,083,"Ohio","Knox County",3,58,821,411,410
050,39,083,"Ohio","Knox County",3,59,833,405,428
050,39,083,"Ohio","Knox County",3,60,886,433,453
050,39,083,"Ohio","Knox County",3,61,899,429,470
050,39,083,"Ohio","Knox County",3,62,887,430,457
050,39,083,"Ohio","Knox County",3,63,919,438,481
050,39,083,"Ohio","Knox County",3,64,884,434,450
050,39,083,"Ohio","Knox County",3,65,861,418,443
050,39,083,"Ohio","Knox County",3,66,824,399,425
050,39,083,"Ohio","Knox County",3,67,784,367,417
050,39,083,"Ohio","Knox County",3,68,756,362,394
050,39,083,"Ohio","Knox County",3,69,740,358,382
050,39,083,"Ohio","Knox County",3,70,695,346,349
050,39,083,"Ohio","Knox County",3,71,636,298,338
050,39,083,"Ohio","Knox County",3,72,633,293,340
050,39,083,"Ohio","Knox County",3,73,629,302,327
050,39,083,"Ohio","Knox County",3,74,671,313,358
050,39,083,"Ohio","Knox County",3,75,424,205,219
050,39,083,"Ohio","Knox County",3,76,417,199,218
050,39,083,"Ohio","Knox County",3,77,407,191,216
050,39,083,"Ohio","Knox County",3,78,430,199,231
050,39,083,"Ohio","Knox County",3,79,381,174,207
050,39,083,"Ohio","Knox County",3,80,325,150,175
050,39,083,"Ohio","Knox County",3,81,276,129,147
050,39,083,"Ohio","Knox County",3,82,258,107,151
050,39,083,"Ohio","Knox County",3,83,260,106,154
050,39,083,"Ohio","Knox County",3,84,207,84,123
050,39,083,"Ohio","Knox County",3,85,1260,445,815
050,39,083,"Ohio","Knox County",4,0,754,395,359
050,39,083,"Ohio","Knox County",4,1,741,392,349
050,39,083,"Ohio","Knox County",4,2,746,392,354
050,39,083,"Ohio","Knox County",4,3,723,373,350
050,39,083,"Ohio","Knox County",4,4,798,405,393
050,39,083,"Ohio","Knox County",4,5,773,397,376
050,39,083,"Ohio","Knox County",4,6,803,399,404
050,39,083,"Ohio","Knox County",4,7,789,393,396
050,39,083,"Ohio","Knox County",4,8,773,386,387
050,39,083,"Ohio","Knox County",4,9,765,407,358
050,39,083,"Ohio","Knox County",4,10,763,391,372
050,39,083,"Ohio","Knox County",4,11,755,397,358
050,39,083,"Ohio","Knox County",4,12,837,436,401
050,39,083,"Ohio","Knox County",4,13,865,453,412
050,39,083,"Ohio","Knox County",4,14,920,478,442
050,39,083,"Ohio","Knox County",4,15,893,454,439
050,39,083,"Ohio","Knox County",4,16,857,446,411
050,39,083,"Ohio","Knox County",4,17,869,452,417
050,39,083,"Ohio","Knox County",4,18,998,486,512
050,39,083,"Ohio","Knox County",4,19,1245,600,645
050,39,083,"Ohio","Knox County",4,20,1235,584,651
050,39,083,"Ohio","Knox County",4,21,1177,591,586
050,39,083,"Ohio","Knox County",4,22,1090,544,546
050,39,083,"Ohio","Knox County",4,23,724,379,345
050,39,083,"Ohio","Knox County",4,24,667,358,309
050,39,083,"Ohio","Knox County",4,25,661,324,337
050,39,083,"Ohio","Knox County",4,26,659,319,340
050,39,083,"Ohio","Knox County",4,27,643,320,323
050,39,083,"Ohio","Knox County",4,28,662,346,316
050,39,083,"Ohio","Knox County",4,29,684,343,341
050,39,083,"Ohio","Knox County",4,30,730,388,342
050,39,083,"Ohio","Knox County",4,31,711,366,345
050,39,083,"Ohio","Knox County",4,32,718,347,371
050,39,083,"Ohio","Knox County",4,33,728,349,379
050,39,083,"Ohio","Knox County",4,34,682,335,347
050,39,083,"Ohio","Knox County",4,35,683,336,347
050,39,083,"Ohio","Knox County",4,36,716,352,364
050,39,083,"Ohio","Knox County",4,37,733,360,373
050,39,083,"Ohio","Knox County",4,38,663,320,343
050,39,083,"Ohio","Knox County",4,39,709,342,367
050,39,083,"Ohio","Knox County",4,40,722,368,354
050,39,083,"Ohio","Knox County",4,41,709,365,344
050,39,083,"Ohio","Knox County",4,42,729,376,353
050,39,083,"Ohio","Knox County",4,43,685,345,340
050,39,083,"Ohio","Knox County",4,44,713,358,355
050,39,083,"Ohio","Knox County",4,45,725,376,349
050,39,083,"Ohio","Knox County",4,46,655,342,313
050,39,083,"Ohio","Knox County",4,47,638,330,308
050,39,083,"Ohio","Knox County",4,48,656,331,325
050,39,083,"Ohio","Knox County",4,49,658,322,336
050,39,083,"Ohio","Knox County",4,50,708,361,347
050,39,083,"Ohio","Knox County",4,51,791,394,397
050,39,083,"Ohio","Knox County",4,52,767,395,372
050,39,083,"Ohio","Knox County",4,53,743,379,364
050,39,083,"Ohio","Knox County",4,54,696,361,335
050,39,083,"Ohio","Knox County",4,55,759,375,384
050,39,083,"Ohio","Knox County",4,56,795,407,388
050,39,083,"Ohio","Knox County",4,57,802,398,404
050,39,083,"Ohio","Knox County",4,58,825,410,415
050,39,083,"Ohio","Knox County",4,59,845,410,435
050,39,083,"Ohio","Knox County",4,60,835,409,426
050,39,083,"Ohio","Knox County",4,61,874,422,452
050,39,083,"Ohio","Knox County",4,62,903,433,470
050,39,083,"Ohio","Knox County",4,63,888,429,459
050,39,083,"Ohio","Knox County",4,64,922,439,483
050,39,083,"Ohio","Knox County",4,65,893,437,456
050,39,083,"Ohio","Knox County",4,66,866,416,450
050,39,083,"Ohio","Knox County",4,67,802,389,413
050,39,083,"Ohio","Knox County",4,68,768,366,402
050,39,083,"Ohio","Knox County",4,69,733,345,388
050,39,083,"Ohio","Knox County",4,70,737,356,381
050,39,083,"Ohio","Knox County",4,71,675,336,339
050,39,083,"Ohio","Knox County",4,72,629,294,335
050,39,083,"Ohio","Knox County",4,73,629,292,337
050,39,083,"Ohio","Knox County",4,74,617,289,328
050,39,083,"Ohio","Knox County",4,75,637,306,331
050,39,083,"Ohio","Knox County",4,76,407,198,209
050,39,083,"Ohio","Knox County",4,77,401,186,215
050,39,083,"Ohio","Knox County",4,78,403,187,216
050,39,083,"Ohio","Knox County",4,79,402,184,218
050,39,083,"Ohio","Knox County",4,80,347,155,192
050,39,083,"Ohio","Knox County",4,81,305,143,162
050,39,083,"Ohio","Knox County",4,82,252,110,142
050,39,083,"Ohio","Knox County",4,83,249,103,146
050,39,083,"Ohio","Knox County",4,84,219,91,128
050,39,083,"Ohio","Knox County",4,85,1240,435,805
050,39,083,"Ohio","Knox County",5,0,756,394,362
050,39,083,"Ohio","Knox County",5,1,748,395,353
050,39,083,"Ohio","Knox County",5,2,757,397,360
050,39,083,"Ohio","Knox County",5,3,752,407,345
050,39,083,"Ohio","Knox County",5,4,732,376,356
050,39,083,"Ohio","Knox County",5,5,826,428,398
050,39,083,"Ohio","Knox County",5,6,771,387,384
050,39,083,"Ohio","Knox County",5,7,793,388,405
050,39,083,"Ohio","Knox County",5,8,797,391,406
050,39,083,"Ohio","Knox County",5,9,782,394,388
050,39,083,"Ohio","Knox County",5,10,764,409,355
050,39,083,"Ohio","Knox County",5,11,769,393,376
050,39,083,"Ohio","Knox County",5,12,776,404,372
050,39,083,"Ohio","Knox County",5,13,818,427,391
050,39,083,"Ohio","Knox County",5,14,869,453,416
050,39,083,"Ohio","Knox County",5,15,908,471,437
050,39,083,"Ohio","Knox County",5,16,904,460,444
050,39,083,"Ohio","Knox County",5,17,873,447,426
050,39,083,"Ohio","Knox County",5,18,998,495,503
050,39,083,"Ohio","Knox County",5,19,1231,588,643
050,39,083,"Ohio","Knox County",5,20,1192,571,621
050,39,083,"Ohio","Knox County",5,21,1165,576,589
050,39,083,"Ohio","Knox County",5,22,1035,514,521
050,39,083,"Ohio","Knox County",5,23,754,386,368
050,39,083,"Ohio","Knox County",5,24,687,361,326
050,39,083,"Ohio","Knox County",5,25,681,367,314
050,39,083,"Ohio","Knox County",5,26,648,313,335
050,39,083,"Ohio","Knox County",5,27,647,319,328
050,39,083,"Ohio","Knox County",5,28,640,328,312
050,39,083,"Ohio","Knox County",5,29,674,346,328
050,39,083,"Ohio","Knox County",5,30,675,330,345
050,39,083,"Ohio","Knox County",5,31,727,385,342
050,39,083,"Ohio","Knox County",5,32,717,369,348
050,39,083,"Ohio","Knox County",5,33,734,371,363
050,39,083,"Ohio","Knox County",5,34,732,345,387
050,39,083,"Ohio","Knox County",5,35,703,349,354
050,39,083,"Ohio","Knox County",5,36,695,347,348
050,39,083,"Ohio","Knox County",5,37,712,343,369
050,39,083,"Ohio","Knox County",5,38,739,375,364
050,39,083,"Ohio","Knox County",5,39,673,328,345
050,39,083,"Ohio","Knox County",5,40,703,331,372
050,39,083,"Ohio","Knox County",5,41,723,375,348
050,39,083,"Ohio","Knox County",5,42,712,363,349
050,39,083,"Ohio","Knox County",5,43,731,370,361
050,39,083,"Ohio","Knox County",5,44,686,348,338
050,39,083,"Ohio","Knox County",5,45,715,362,353
050,39,083,"Ohio","Knox County",5,46,728,385,343
050,39,083,"Ohio","Knox County",5,47,650,335,315
050,39,083,"Ohio","Knox County",5,48,623,319,304
050,39,083,"Ohio","Knox County",5,49,652,327,325
050,39,083,"Ohio","Knox County",5,50,658,331,327
050,39,083,"Ohio","Knox County",5,51,713,360,353
050,39,083,"Ohio","Knox County",5,52,791,397,394
050,39,083,"Ohio","Knox County",5,53,768,391,377
050,39,083,"Ohio","Knox County",5,54,752,387,365
050,39,083,"Ohio","Knox County",5,55,703,363,340
050,39,083,"Ohio","Knox County",5,56,757,373,384
050,39,083,"Ohio","Knox County",5,57,789,404,385
050,39,083,"Ohio","Knox County",5,58,816,412,404
050,39,083,"Ohio","Knox County",5,59,844,411,433
050,39,083,"Ohio","Knox County",5,60,837,403,434
050,39,083,"Ohio","Knox County",5,61,826,401,425
050,39,083,"Ohio","Knox County",5,62,882,423,459
050,39,083,"Ohio","Knox County",5,63,893,431,462
050,39,083,"Ohio","Knox County",5,64,879,425,454
050,39,083,"Ohio","Knox County",5,65,905,426,479
050,39,083,"Ohio","Knox County",5,66,888,433,455
050,39,083,"Ohio","Knox County",5,67,862,414,448
050,39,083,"Ohio","Knox County",5,68,807,393,414
050,39,083,"Ohio","Knox County",5,69,762,362,400
050,39,083,"Ohio","Knox County",5,70,720,337,383
050,39,083,"Ohio","Knox County",5,71,728,349,379
050,39,083,"Ohio","Knox County",5,72,674,333,341
050,39,083,"Ohio","Knox County",5,73,621,293,328
050,39,083,"Ohio","Knox County",5,74,617,277,340
050,39,083,"Ohio","Knox County",5,75,595,290,305
050,39,083,"Ohio","Knox County",5,76,618,296,322
050,39,083,"Ohio","Knox County",5,77,389,185,204
050,39,083,"Ohio","Knox County",5,78,392,179,213
050,39,083,"Ohio","Knox County",5,79,381,171,210
050,39,083,"Ohio","Knox County",5,80,363,166,197
050,39,083,"Ohio","Knox County",5,81,320,147,173
050,39,083,"Ohio","Knox County",5,82,290,128,162
050,39,083,"Ohio","Knox County",5,83,247,103,144
050,39,083,"Ohio","Knox County",5,84,209,91,118
050,39,083,"Ohio","Knox County",5,85,1247,445,802
050,39,085,"Ohio","Lake County",1,0,2196,1121,1075
050,39,085,"Ohio","Lake County",1,1,2246,1159,1087
050,39,085,"Ohio","Lake County",1,2,2227,1151,1076
050,39,085,"Ohio","Lake County",1,3,2272,1180,1092
050,39,085,"Ohio","Lake County",1,4,2378,1232,1146
050,39,085,"Ohio","Lake County",1,5,2395,1227,1168
050,39,085,"Ohio","Lake County",1,6,2374,1233,1141
050,39,085,"Ohio","Lake County",1,7,2404,1258,1146
050,39,085,"Ohio","Lake County",1,8,2414,1265,1149
050,39,085,"Ohio","Lake County",1,9,2498,1286,1212
050,39,085,"Ohio","Lake County",1,10,2576,1320,1256
050,39,085,"Ohio","Lake County",1,11,2698,1383,1315
050,39,085,"Ohio","Lake County",1,12,2823,1444,1379
050,39,085,"Ohio","Lake County",1,13,2950,1487,1463
050,39,085,"Ohio","Lake County",1,14,2929,1471,1458
050,39,085,"Ohio","Lake County",1,15,2953,1496,1457
050,39,085,"Ohio","Lake County",1,16,3012,1522,1490
050,39,085,"Ohio","Lake County",1,17,3014,1551,1463
050,39,085,"Ohio","Lake County",1,18,2672,1398,1274
050,39,085,"Ohio","Lake County",1,19,2262,1196,1066
050,39,085,"Ohio","Lake County",1,20,2298,1197,1101
050,39,085,"Ohio","Lake County",1,21,2396,1210,1186
050,39,085,"Ohio","Lake County",1,22,2556,1310,1246
050,39,085,"Ohio","Lake County",1,23,2681,1369,1312
050,39,085,"Ohio","Lake County",1,24,2709,1384,1325
050,39,085,"Ohio","Lake County",1,25,2731,1384,1347
050,39,085,"Ohio","Lake County",1,26,2796,1422,1374
050,39,085,"Ohio","Lake County",1,27,2926,1488,1438
050,39,085,"Ohio","Lake County",1,28,2937,1470,1467
050,39,085,"Ohio","Lake County",1,29,2912,1444,1468
050,39,085,"Ohio","Lake County",1,30,2886,1484,1402
050,39,085,"Ohio","Lake County",1,31,2831,1438,1393
050,39,085,"Ohio","Lake County",1,32,2703,1348,1355
050,39,085,"Ohio","Lake County",1,33,2714,1347,1367
050,39,085,"Ohio","Lake County",1,34,2822,1447,1375
050,39,085,"Ohio","Lake County",1,35,2782,1425,1357
050,39,085,"Ohio","Lake County",1,36,2709,1378,1331
050,39,085,"Ohio","Lake County",1,37,2733,1409,1324
050,39,085,"Ohio","Lake County",1,38,2777,1404,1373
050,39,085,"Ohio","Lake County",1,39,2796,1418,1378
050,39,085,"Ohio","Lake County",1,40,2823,1445,1378
050,39,085,"Ohio","Lake County",1,41,2644,1368,1276
050,39,085,"Ohio","Lake County",1,42,2552,1245,1307
050,39,085,"Ohio","Lake County",1,43,2560,1283,1277
050,39,085,"Ohio","Lake County",1,44,2607,1291,1316
050,39,085,"Ohio","Lake County",1,45,2600,1307,1293
050,39,085,"Ohio","Lake County",1,46,2605,1283,1322
050,39,085,"Ohio","Lake County",1,47,2737,1377,1360
050,39,085,"Ohio","Lake County",1,48,3058,1557,1501
050,39,085,"Ohio","Lake County",1,49,3302,1673,1629
050,39,085,"Ohio","Lake County",1,50,3190,1583,1607
050,39,085,"Ohio","Lake County",1,51,3060,1484,1576
050,39,085,"Ohio","Lake County",1,52,3059,1524,1535
050,39,085,"Ohio","Lake County",1,53,3192,1609,1583
050,39,085,"Ohio","Lake County",1,54,3201,1602,1599
050,39,085,"Ohio","Lake County",1,55,3378,1675,1703
050,39,085,"Ohio","Lake County",1,56,3468,1742,1726
050,39,085,"Ohio","Lake County",1,57,3513,1688,1825
050,39,085,"Ohio","Lake County",1,58,3619,1709,1910
050,39,085,"Ohio","Lake County",1,59,3712,1814,1898
050,39,085,"Ohio","Lake County",1,60,3673,1797,1876
050,39,085,"Ohio","Lake County",1,61,3751,1842,1909
050,39,085,"Ohio","Lake County",1,62,3814,1856,1958
050,39,085,"Ohio","Lake County",1,63,3660,1801,1859
050,39,085,"Ohio","Lake County",1,64,3488,1676,1812
050,39,085,"Ohio","Lake County",1,65,3361,1602,1759
050,39,085,"Ohio","Lake County",1,66,3155,1529,1626
050,39,085,"Ohio","Lake County",1,67,3064,1510,1554
050,39,085,"Ohio","Lake County",1,68,3006,1454,1552
050,39,085,"Ohio","Lake County",1,69,2777,1298,1479
050,39,085,"Ohio","Lake County",1,70,2603,1223,1380
050,39,085,"Ohio","Lake County",1,71,2551,1185,1366
050,39,085,"Ohio","Lake County",1,72,2689,1235,1454
050,39,085,"Ohio","Lake County",1,73,2758,1269,1489
050,39,085,"Ohio","Lake County",1,74,1840,834,1006
050,39,085,"Ohio","Lake County",1,75,1755,778,977
050,39,085,"Ohio","Lake County",1,76,1806,782,1024
050,39,085,"Ohio","Lake County",1,77,1894,841,1053
050,39,085,"Ohio","Lake County",1,78,1655,747,908
050,39,085,"Ohio","Lake County",1,79,1432,612,820
050,39,085,"Ohio","Lake County",1,80,1256,514,742
050,39,085,"Ohio","Lake County",1,81,1168,489,679
050,39,085,"Ohio","Lake County",1,82,1086,421,665
050,39,085,"Ohio","Lake County",1,83,1008,383,625
050,39,085,"Ohio","Lake County",1,84,889,331,558
050,39,085,"Ohio","Lake County",1,85,5514,1838,3676
050,39,085,"Ohio","Lake County",2,0,2150,1109,1041
050,39,085,"Ohio","Lake County",2,1,2226,1148,1078
050,39,085,"Ohio","Lake County",2,2,2236,1154,1082
050,39,085,"Ohio","Lake County",2,3,2259,1172,1087
050,39,085,"Ohio","Lake County",2,4,2364,1225,1139
050,39,085,"Ohio","Lake County",2,5,2388,1229,1159
050,39,085,"Ohio","Lake County",2,6,2381,1239,1142
050,39,085,"Ohio","Lake County",2,7,2396,1254,1142
050,39,085,"Ohio","Lake County",2,8,2409,1260,1149
050,39,085,"Ohio","Lake County",2,9,2477,1281,1196
050,39,085,"Ohio","Lake County",2,10,2549,1309,1240
050,39,085,"Ohio","Lake County",2,11,2663,1367,1296
050,39,085,"Ohio","Lake County",2,12,2811,1441,1370
050,39,085,"Ohio","Lake County",2,13,2915,1474,1441
050,39,085,"Ohio","Lake County",2,14,2933,1473,1460
050,39,085,"Ohio","Lake County",2,15,2948,1490,1458
050,39,085,"Ohio","Lake County",2,16,3002,1520,1482
050,39,085,"Ohio","Lake County",2,17,3016,1542,1474
050,39,085,"Ohio","Lake County",2,18,2656,1390,1266
050,39,085,"Ohio","Lake County",2,19,2269,1195,1074
050,39,085,"Ohio","Lake County",2,20,2334,1213,1121
050,39,085,"Ohio","Lake County",2,21,2409,1222,1187
050,39,085,"Ohio","Lake County",2,22,2543,1302,1241
050,39,085,"Ohio","Lake County",2,23,2677,1369,1308
050,39,085,"Ohio","Lake County",2,24,2710,1387,1323
050,39,085,"Ohio","Lake County",2,25,2735,1388,1347
050,39,085,"Ohio","Lake County",2,26,2796,1424,1372
050,39,085,"Ohio","Lake County",2,27,2896,1474,1422
050,39,085,"Ohio","Lake County",2,28,2951,1484,1467
050,39,085,"Ohio","Lake County",2,29,2927,1456,1471
050,39,085,"Ohio","Lake County",2,30,2928,1494,1434
050,39,085,"Ohio","Lake County",2,31,2839,1452,1387
050,39,085,"Ohio","Lake County",2,32,2730,1370,1360
050,39,085,"Ohio","Lake County",2,33,2709,1348,1361
050,39,085,"Ohio","Lake County",2,34,2794,1420,1374
050,39,085,"Ohio","Lake County",2,35,2811,1442,1369
050,39,085,"Ohio","Lake County",2,36,2709,1382,1327
050,39,085,"Ohio","Lake County",2,37,2732,1403,1329
050,39,085,"Ohio","Lake County",2,38,2775,1408,1367
050,39,085,"Ohio","Lake County",2,39,2787,1413,1374
050,39,085,"Ohio","Lake County",2,40,2832,1449,1383
050,39,085,"Ohio","Lake County",2,41,2681,1384,1297
050,39,085,"Ohio","Lake County",2,42,2559,1266,1293
050,39,085,"Ohio","Lake County",2,43,2580,1285,1295
050,39,085,"Ohio","Lake County",2,44,2576,1280,1296
050,39,085,"Ohio","Lake County",2,45,2620,1310,1310
050,39,085,"Ohio","Lake County",2,46,2597,1286,1311
050,39,085,"Ohio","Lake County",2,47,2701,1355,1346
050,39,085,"Ohio","Lake County",2,48,2981,1513,1468
050,39,085,"Ohio","Lake County",2,49,3261,1657,1604
050,39,085,"Ohio","Lake County",2,50,3215,1601,1614
050,39,085,"Ohio","Lake County",2,51,3086,1505,1581
050,39,085,"Ohio","Lake County",2,52,3052,1511,1541
050,39,085,"Ohio","Lake County",2,53,3156,1586,1570
050,39,085,"Ohio","Lake County",2,54,3197,1604,1593
050,39,085,"Ohio","Lake County",2,55,3334,1653,1681
050,39,085,"Ohio","Lake County",2,56,3454,1731,1723
050,39,085,"Ohio","Lake County",2,57,3506,1703,1803
050,39,085,"Ohio","Lake County",2,58,3584,1696,1888
050,39,085,"Ohio","Lake County",2,59,3703,1796,1907
050,39,085,"Ohio","Lake County",2,60,3655,1787,1868
050,39,085,"Ohio","Lake County",2,61,3711,1818,1893
050,39,085,"Ohio","Lake County",2,62,3779,1839,1940
050,39,085,"Ohio","Lake County",2,63,3718,1822,1896
050,39,085,"Ohio","Lake County",2,64,3499,1690,1809
050,39,085,"Ohio","Lake County",2,65,3374,1608,1766
050,39,085,"Ohio","Lake County",2,66,3205,1544,1661
050,39,085,"Ohio","Lake County",2,67,3071,1503,1568
050,39,085,"Ohio","Lake County",2,68,2993,1451,1542
050,39,085,"Ohio","Lake County",2,69,2845,1340,1505
050,39,085,"Ohio","Lake County",2,70,2620,1227,1393
050,39,085,"Ohio","Lake County",2,71,2553,1187,1366
050,39,085,"Ohio","Lake County",2,72,2604,1196,1408
050,39,085,"Ohio","Lake County",2,73,2868,1312,1556
050,39,085,"Ohio","Lake County",2,74,1935,880,1055
050,39,085,"Ohio","Lake County",2,75,1771,789,982
050,39,085,"Ohio","Lake County",2,76,1764,769,995
050,39,085,"Ohio","Lake County",2,77,1901,838,1063
050,39,085,"Ohio","Lake County",2,78,1667,749,918
050,39,085,"Ohio","Lake County",2,79,1469,639,830
050,39,085,"Ohio","Lake County",2,80,1285,536,749
050,39,085,"Ohio","Lake County",2,81,1175,493,682
050,39,085,"Ohio","Lake County",2,82,1093,431,662
050,39,085,"Ohio","Lake County",2,83,1014,383,631
050,39,085,"Ohio","Lake County",2,84,910,340,570
050,39,085,"Ohio","Lake County",2,85,5522,1837,3685
050,39,085,"Ohio","Lake County",3,0,2071,1129,942
050,39,085,"Ohio","Lake County",3,1,2231,1141,1090
050,39,085,"Ohio","Lake County",3,2,2240,1148,1092
050,39,085,"Ohio","Lake County",3,3,2264,1176,1088
050,39,085,"Ohio","Lake County",3,4,2261,1188,1073
050,39,085,"Ohio","Lake County",3,5,2346,1220,1126
050,39,085,"Ohio","Lake County",3,6,2391,1231,1160
050,39,085,"Ohio","Lake County",3,7,2393,1228,1165
050,39,085,"Ohio","Lake County",3,8,2403,1254,1149
050,39,085,"Ohio","Lake County",3,9,2425,1270,1155
050,39,085,"Ohio","Lake County",3,10,2485,1282,1203
050,39,085,"Ohio","Lake County",3,11,2551,1315,1236
050,39,085,"Ohio","Lake County",3,12,2657,1353,1304
050,39,085,"Ohio","Lake County",3,13,2812,1432,1380
050,39,085,"Ohio","Lake County",3,14,2911,1477,1434
050,39,085,"Ohio","Lake County",3,15,2935,1477,1458
050,39,085,"Ohio","Lake County",3,16,2956,1498,1458
050,39,085,"Ohio","Lake County",3,17,3021,1546,1475
050,39,085,"Ohio","Lake County",3,18,2624,1372,1252
050,39,085,"Ohio","Lake County",3,19,2216,1168,1048
050,39,085,"Ohio","Lake County",3,20,2346,1213,1133
050,39,085,"Ohio","Lake County",3,21,2436,1246,1190
050,39,085,"Ohio","Lake County",3,22,2548,1277,1271
050,39,085,"Ohio","Lake County",3,23,2698,1367,1331
050,39,085,"Ohio","Lake County",3,24,2705,1374,1331
050,39,085,"Ohio","Lake County",3,25,2735,1386,1349
050,39,085,"Ohio","Lake County",3,26,2781,1413,1368
050,39,085,"Ohio","Lake County",3,27,2824,1424,1400
050,39,085,"Ohio","Lake County",3,28,2908,1475,1433
050,39,085,"Ohio","Lake County",3,29,2983,1511,1472
050,39,085,"Ohio","Lake County",3,30,2980,1496,1484
050,39,085,"Ohio","Lake County",3,31,2984,1532,1452
050,39,085,"Ohio","Lake County",3,32,2929,1488,1441
050,39,085,"Ohio","Lake County",3,33,2745,1371,1374
050,39,085,"Ohio","Lake County",3,34,2723,1350,1373
050,39,085,"Ohio","Lake County",3,35,2800,1427,1373
050,39,085,"Ohio","Lake County",3,36,2829,1452,1377
050,39,085,"Ohio","Lake County",3,37,2723,1373,1350
050,39,085,"Ohio","Lake County",3,38,2721,1395,1326
050,39,085,"Ohio","Lake County",3,39,2802,1427,1375
050,39,085,"Ohio","Lake County",3,40,2779,1407,1372
050,39,085,"Ohio","Lake County",3,41,2829,1448,1381
050,39,085,"Ohio","Lake County",3,42,2657,1362,1295
050,39,085,"Ohio","Lake County",3,43,2574,1291,1283
050,39,085,"Ohio","Lake County",3,44,2573,1281,1292
050,39,085,"Ohio","Lake County",3,45,2559,1274,1285
050,39,085,"Ohio","Lake County",3,46,2596,1303,1293
050,39,085,"Ohio","Lake County",3,47,2617,1294,1323
050,39,085,"Ohio","Lake County",3,48,2715,1362,1353
050,39,085,"Ohio","Lake County",3,49,2995,1521,1474
050,39,085,"Ohio","Lake County",3,50,3216,1632,1584
050,39,085,"Ohio","Lake County",3,51,3232,1609,1623
050,39,085,"Ohio","Lake County",3,52,3078,1501,1577
050,39,085,"Ohio","Lake County",3,53,3064,1509,1555
050,39,085,"Ohio","Lake County",3,54,3149,1577,1572
050,39,085,"Ohio","Lake County",3,55,3193,1594,1599
050,39,085,"Ohio","Lake County",3,56,3316,1634,1682
050,39,085,"Ohio","Lake County",3,57,3453,1721,1732
050,39,085,"Ohio","Lake County",3,58,3472,1681,1791
050,39,085,"Ohio","Lake County",3,59,3562,1701,1861
050,39,085,"Ohio","Lake County",3,60,3675,1769,1906
050,39,085,"Ohio","Lake County",3,61,3607,1754,1853
050,39,085,"Ohio","Lake County",3,62,3658,1785,1873
050,39,085,"Ohio","Lake County",3,63,3747,1810,1937
050,39,085,"Ohio","Lake County",3,64,3704,1818,1886
050,39,085,"Ohio","Lake County",3,65,3437,1651,1786
050,39,085,"Ohio","Lake County",3,66,3367,1603,1764
050,39,085,"Ohio","Lake County",3,67,3151,1519,1632
050,39,085,"Ohio","Lake County",3,68,3036,1483,1553
050,39,085,"Ohio","Lake County",3,69,2955,1423,1532
050,39,085,"Ohio","Lake County",3,70,2801,1315,1486
050,39,085,"Ohio","Lake County",3,71,2575,1205,1370
050,39,085,"Ohio","Lake County",3,72,2517,1158,1359
050,39,085,"Ohio","Lake County",3,73,2533,1141,1392
050,39,085,"Ohio","Lake County",3,74,2806,1269,1537
050,39,085,"Ohio","Lake County",3,75,1870,844,1026
050,39,085,"Ohio","Lake County",3,76,1705,762,943
050,39,085,"Ohio","Lake County",3,77,1687,727,960
050,39,085,"Ohio","Lake County",3,78,1843,809,1034
050,39,085,"Ohio","Lake County",3,79,1552,675,877
050,39,085,"Ohio","Lake County",3,80,1395,600,795
050,39,085,"Ohio","Lake County",3,81,1216,494,722
050,39,085,"Ohio","Lake County",3,82,1083,448,635
050,39,085,"Ohio","Lake County",3,83,1007,374,633
050,39,085,"Ohio","Lake County",3,84,906,329,577
050,39,085,"Ohio","Lake County",3,85,5367,1796,3571
050,39,085,"Ohio","Lake County",4,0,2056,1098,958
050,39,085,"Ohio","Lake County",4,1,2118,1125,993
050,39,085,"Ohio","Lake County",4,2,2210,1117,1093
050,39,085,"Ohio","Lake County",4,3,2255,1144,1111
050,39,085,"Ohio","Lake County",4,4,2280,1177,1103
050,39,085,"Ohio","Lake County",4,5,2276,1187,1089
050,39,085,"Ohio","Lake County",4,6,2395,1253,1142
050,39,085,"Ohio","Lake County",4,7,2439,1252,1187
050,39,085,"Ohio","Lake County",4,8,2406,1243,1163
050,39,085,"Ohio","Lake County",4,9,2406,1243,1163
050,39,085,"Ohio","Lake County",4,10,2441,1282,1159
050,39,085,"Ohio","Lake County",4,11,2517,1299,1218
050,39,085,"Ohio","Lake County",4,12,2574,1315,1259
050,39,085,"Ohio","Lake County",4,13,2671,1370,1301
050,39,085,"Ohio","Lake County",4,14,2842,1450,1392
050,39,085,"Ohio","Lake County",4,15,2915,1476,1439
050,39,085,"Ohio","Lake County",4,16,2930,1474,1456
050,39,085,"Ohio","Lake County",4,17,2968,1503,1465
050,39,085,"Ohio","Lake County",4,18,2624,1381,1243
050,39,085,"Ohio","Lake County",4,19,2136,1117,1019
050,39,085,"Ohio","Lake County",4,20,2259,1175,1084
050,39,085,"Ohio","Lake County",4,21,2473,1253,1220
050,39,085,"Ohio","Lake County",4,22,2528,1292,1236
050,39,085,"Ohio","Lake County",4,23,2612,1316,1296
050,39,085,"Ohio","Lake County",4,24,2711,1370,1341
050,39,085,"Ohio","Lake County",4,25,2755,1406,1349
050,39,085,"Ohio","Lake County",4,26,2750,1410,1340
050,39,085,"Ohio","Lake County",4,27,2843,1447,1396
050,39,085,"Ohio","Lake County",4,28,2849,1435,1414
050,39,085,"Ohio","Lake County",4,29,2894,1456,1438
050,39,085,"Ohio","Lake County",4,30,2997,1537,1460
050,39,085,"Ohio","Lake County",4,31,2981,1503,1478
050,39,085,"Ohio","Lake County",4,32,2966,1521,1445
050,39,085,"Ohio","Lake County",4,33,2922,1470,1452
050,39,085,"Ohio","Lake County",4,34,2797,1400,1397
050,39,085,"Ohio","Lake County",4,35,2708,1346,1362
050,39,085,"Ohio","Lake County",4,36,2800,1419,1381
050,39,085,"Ohio","Lake County",4,37,2807,1445,1362
050,39,085,"Ohio","Lake County",4,38,2711,1350,1361
050,39,085,"Ohio","Lake County",4,39,2738,1398,1340
050,39,085,"Ohio","Lake County",4,40,2823,1442,1381
050,39,085,"Ohio","Lake County",4,41,2786,1390,1396
050,39,085,"Ohio","Lake County",4,42,2837,1438,1399
050,39,085,"Ohio","Lake County",4,43,2673,1368,1305
050,39,085,"Ohio","Lake County",4,44,2580,1297,1283
050,39,085,"Ohio","Lake County",4,45,2609,1295,1314
050,39,085,"Ohio","Lake County",4,46,2604,1307,1297
050,39,085,"Ohio","Lake County",4,47,2583,1295,1288
050,39,085,"Ohio","Lake County",4,48,2604,1286,1318
050,39,085,"Ohio","Lake County",4,49,2723,1362,1361
050,39,085,"Ohio","Lake County",4,50,2981,1501,1480
050,39,085,"Ohio","Lake County",4,51,3194,1623,1571
050,39,085,"Ohio","Lake County",4,52,3237,1610,1627
050,39,085,"Ohio","Lake County",4,53,3059,1489,1570
050,39,085,"Ohio","Lake County",4,54,3067,1511,1556
050,39,085,"Ohio","Lake County",4,55,3130,1569,1561
050,39,085,"Ohio","Lake County",4,56,3150,1574,1576
050,39,085,"Ohio","Lake County",4,57,3312,1634,1678
050,39,085,"Ohio","Lake County",4,58,3453,1713,1740
050,39,085,"Ohio","Lake County",4,59,3449,1664,1785
050,39,085,"Ohio","Lake County",4,60,3517,1672,1845
050,39,085,"Ohio","Lake County",4,61,3627,1734,1893
050,39,085,"Ohio","Lake County",4,62,3580,1725,1855
050,39,085,"Ohio","Lake County",4,63,3618,1751,1867
050,39,085,"Ohio","Lake County",4,64,3734,1789,1945
050,39,085,"Ohio","Lake County",4,65,3660,1775,1885
050,39,085,"Ohio","Lake County",4,66,3417,1656,1761
050,39,085,"Ohio","Lake County",4,67,3299,1563,1736
050,39,085,"Ohio","Lake County",4,68,3134,1502,1632
050,39,085,"Ohio","Lake County",4,69,2969,1445,1524
050,39,085,"Ohio","Lake County",4,70,2891,1394,1497
050,39,085,"Ohio","Lake County",4,71,2754,1285,1469
050,39,085,"Ohio","Lake County",4,72,2520,1168,1352
050,39,085,"Ohio","Lake County",4,73,2451,1110,1341
050,39,085,"Ohio","Lake County",4,74,2481,1122,1359
050,39,085,"Ohio","Lake County",4,75,2736,1227,1509
050,39,085,"Ohio","Lake County",4,76,1801,809,992
050,39,085,"Ohio","Lake County",4,77,1633,719,914
050,39,085,"Ohio","Lake County",4,78,1615,679,936
050,39,085,"Ohio","Lake County",4,79,1764,761,1003
050,39,085,"Ohio","Lake County",4,80,1492,640,852
050,39,085,"Ohio","Lake County",4,81,1328,559,769
050,39,085,"Ohio","Lake County",4,82,1127,444,683
050,39,085,"Ohio","Lake County",4,83,1009,405,604
050,39,085,"Ohio","Lake County",4,84,910,340,570
050,39,085,"Ohio","Lake County",4,85,5255,1722,3533
050,39,085,"Ohio","Lake County",5,0,2055,1097,958
050,39,085,"Ohio","Lake County",5,1,2077,1128,949
050,39,085,"Ohio","Lake County",5,2,2125,1115,1010
050,39,085,"Ohio","Lake County",5,3,2215,1121,1094
050,39,085,"Ohio","Lake County",5,4,2277,1157,1120
050,39,085,"Ohio","Lake County",5,5,2276,1168,1108
050,39,085,"Ohio","Lake County",5,6,2292,1212,1080
050,39,085,"Ohio","Lake County",5,7,2417,1264,1153
050,39,085,"Ohio","Lake County",5,8,2452,1250,1202
050,39,085,"Ohio","Lake County",5,9,2420,1252,1168
050,39,085,"Ohio","Lake County",5,10,2411,1255,1156
050,39,085,"Ohio","Lake County",5,11,2494,1295,1199
050,39,085,"Ohio","Lake County",5,12,2518,1301,1217
050,39,085,"Ohio","Lake County",5,13,2588,1335,1253
050,39,085,"Ohio","Lake County",5,14,2684,1390,1294
050,39,085,"Ohio","Lake County",5,15,2855,1455,1400
050,39,085,"Ohio","Lake County",5,16,2909,1485,1424
050,39,085,"Ohio","Lake County",5,17,2961,1502,1459
050,39,085,"Ohio","Lake County",5,18,2547,1335,1212
050,39,085,"Ohio","Lake County",5,19,2161,1134,1027
050,39,085,"Ohio","Lake County",5,20,2235,1154,1081
050,39,085,"Ohio","Lake County",5,21,2401,1232,1169
050,39,085,"Ohio","Lake County",5,22,2596,1320,1276
050,39,085,"Ohio","Lake County",5,23,2630,1335,1295
050,39,085,"Ohio","Lake County",5,24,2659,1321,1338
050,39,085,"Ohio","Lake County",5,25,2765,1424,1341
050,39,085,"Ohio","Lake County",5,26,2792,1391,1401
050,39,085,"Ohio","Lake County",5,27,2752,1417,1335
050,39,085,"Ohio","Lake County",5,28,2821,1429,1392
050,39,085,"Ohio","Lake County",5,29,2854,1443,1411
050,39,085,"Ohio","Lake County",5,30,2968,1497,1471
050,39,085,"Ohio","Lake County",5,31,2987,1529,1458
050,39,085,"Ohio","Lake County",5,32,3017,1519,1498
050,39,085,"Ohio","Lake County",5,33,3004,1525,1479
050,39,085,"Ohio","Lake County",5,34,2947,1488,1459
050,39,085,"Ohio","Lake County",5,35,2823,1411,1412
050,39,085,"Ohio","Lake County",5,36,2714,1362,1352
050,39,085,"Ohio","Lake County",5,37,2787,1402,1385
050,39,085,"Ohio","Lake County",5,38,2787,1427,1360
050,39,085,"Ohio","Lake County",5,39,2736,1366,1370
050,39,085,"Ohio","Lake County",5,40,2767,1419,1348
050,39,085,"Ohio","Lake County",5,41,2848,1458,1390
050,39,085,"Ohio","Lake County",5,42,2774,1378,1396
050,39,085,"Ohio","Lake County",5,43,2851,1447,1404
050,39,085,"Ohio","Lake County",5,44,2691,1376,1315
050,39,085,"Ohio","Lake County",5,45,2603,1311,1292
050,39,085,"Ohio","Lake County",5,46,2614,1307,1307
050,39,085,"Ohio","Lake County",5,47,2585,1301,1284
050,39,085,"Ohio","Lake County",5,48,2594,1291,1303
050,39,085,"Ohio","Lake County",5,49,2599,1301,1298
050,39,085,"Ohio","Lake County",5,50,2696,1343,1353
050,39,085,"Ohio","Lake County",5,51,2974,1493,1481
050,39,085,"Ohio","Lake County",5,52,3198,1632,1566
050,39,085,"Ohio","Lake County",5,53,3235,1602,1633
050,39,085,"Ohio","Lake County",5,54,3074,1509,1565
050,39,085,"Ohio","Lake County",5,55,3049,1500,1549
050,39,085,"Ohio","Lake County",5,56,3093,1547,1546
050,39,085,"Ohio","Lake County",5,57,3136,1568,1568
050,39,085,"Ohio","Lake County",5,58,3313,1625,1688
050,39,085,"Ohio","Lake County",5,59,3432,1703,1729
050,39,085,"Ohio","Lake County",5,60,3420,1642,1778
050,39,085,"Ohio","Lake County",5,61,3523,1668,1855
050,39,085,"Ohio","Lake County",5,62,3584,1708,1876
050,39,085,"Ohio","Lake County",5,63,3537,1701,1836
050,39,085,"Ohio","Lake County",5,64,3563,1730,1833
050,39,085,"Ohio","Lake County",5,65,3709,1753,1956
050,39,085,"Ohio","Lake County",5,66,3604,1759,1845
050,39,085,"Ohio","Lake County",5,67,3365,1626,1739
050,39,085,"Ohio","Lake County",5,68,3269,1541,1728
050,39,085,"Ohio","Lake County",5,69,3076,1472,1604
050,39,085,"Ohio","Lake County",5,70,2913,1412,1501
050,39,085,"Ohio","Lake County",5,71,2832,1355,1477
050,39,085,"Ohio","Lake County",5,72,2711,1256,1455
050,39,085,"Ohio","Lake County",5,73,2472,1128,1344
050,39,085,"Ohio","Lake County",5,74,2396,1084,1312
050,39,085,"Ohio","Lake County",5,75,2414,1080,1334
050,39,085,"Ohio","Lake County",5,76,2653,1186,1467
050,39,085,"Ohio","Lake County",5,77,1758,782,976
050,39,085,"Ohio","Lake County",5,78,1587,685,902
050,39,085,"Ohio","Lake County",5,79,1550,636,914
050,39,085,"Ohio","Lake County",5,80,1696,724,972
050,39,085,"Ohio","Lake County",5,81,1429,598,831
050,39,085,"Ohio","Lake County",5,82,1242,514,728
050,39,085,"Ohio","Lake County",5,83,1052,402,650
050,39,085,"Ohio","Lake County",5,84,921,367,554
050,39,085,"Ohio","Lake County",5,85,5229,1704,3525
050,39,087,"Ohio","Lawrence County",1,0,593,305,288
050,39,087,"Ohio","Lawrence County",1,1,597,310,287
050,39,087,"Ohio","Lawrence County",1,2,619,313,306
050,39,087,"Ohio","Lawrence County",1,3,624,341,283
050,39,087,"Ohio","Lawrence County",1,4,673,367,306
050,39,087,"Ohio","Lawrence County",1,5,704,364,340
050,39,087,"Ohio","Lawrence County",1,6,703,353,350
050,39,087,"Ohio","Lawrence County",1,7,706,358,348
050,39,087,"Ohio","Lawrence County",1,8,707,345,362
050,39,087,"Ohio","Lawrence County",1,9,682,349,333
050,39,087,"Ohio","Lawrence County",1,10,701,358,343
050,39,087,"Ohio","Lawrence County",1,11,742,383,359
050,39,087,"Ohio","Lawrence County",1,12,767,376,391
050,39,087,"Ohio","Lawrence County",1,13,790,390,400
050,39,087,"Ohio","Lawrence County",1,14,794,410,384
050,39,087,"Ohio","Lawrence County",1,15,781,406,375
050,39,087,"Ohio","Lawrence County",1,16,781,409,372
050,39,087,"Ohio","Lawrence County",1,17,778,409,369
050,39,087,"Ohio","Lawrence County",1,18,641,354,287
050,39,087,"Ohio","Lawrence County",1,19,522,284,238
050,39,087,"Ohio","Lawrence County",1,20,546,288,258
050,39,087,"Ohio","Lawrence County",1,21,574,292,282
050,39,087,"Ohio","Lawrence County",1,22,644,319,325
050,39,087,"Ohio","Lawrence County",1,23,649,330,319
050,39,087,"Ohio","Lawrence County",1,24,670,332,338
050,39,087,"Ohio","Lawrence County",1,25,683,321,362
050,39,087,"Ohio","Lawrence County",1,26,666,343,323
050,39,087,"Ohio","Lawrence County",1,27,715,360,355
050,39,087,"Ohio","Lawrence County",1,28,731,371,360
050,39,087,"Ohio","Lawrence County",1,29,732,356,376
050,39,087,"Ohio","Lawrence County",1,30,726,378,348
050,39,087,"Ohio","Lawrence County",1,31,708,348,360
050,39,087,"Ohio","Lawrence County",1,32,670,334,336
050,39,087,"Ohio","Lawrence County",1,33,642,298,344
050,39,087,"Ohio","Lawrence County",1,34,673,322,351
050,39,087,"Ohio","Lawrence County",1,35,684,338,346
050,39,087,"Ohio","Lawrence County",1,36,690,341,349
050,39,087,"Ohio","Lawrence County",1,37,711,330,381
050,39,087,"Ohio","Lawrence County",1,38,714,342,372
050,39,087,"Ohio","Lawrence County",1,39,756,365,391
050,39,087,"Ohio","Lawrence County",1,40,745,352,393
050,39,087,"Ohio","Lawrence County",1,41,733,357,376
050,39,087,"Ohio","Lawrence County",1,42,728,363,365
050,39,087,"Ohio","Lawrence County",1,43,690,349,341
050,39,087,"Ohio","Lawrence County",1,44,701,355,346
050,39,087,"Ohio","Lawrence County",1,45,707,355,352
050,39,087,"Ohio","Lawrence County",1,46,721,366,355
050,39,087,"Ohio","Lawrence County",1,47,744,382,362
050,39,087,"Ohio","Lawrence County",1,48,806,385,421
050,39,087,"Ohio","Lawrence County",1,49,888,422,466
050,39,087,"Ohio","Lawrence County",1,50,814,403,411
050,39,087,"Ohio","Lawrence County",1,51,820,428,392
050,39,087,"Ohio","Lawrence County",1,52,799,406,393
050,39,087,"Ohio","Lawrence County",1,53,798,403,395
050,39,087,"Ohio","Lawrence County",1,54,825,415,410
050,39,087,"Ohio","Lawrence County",1,55,833,393,440
050,39,087,"Ohio","Lawrence County",1,56,814,389,425
050,39,087,"Ohio","Lawrence County",1,57,785,369,416
050,39,087,"Ohio","Lawrence County",1,58,800,389,411
050,39,087,"Ohio","Lawrence County",1,59,845,420,425
050,39,087,"Ohio","Lawrence County",1,60,821,418,403
050,39,087,"Ohio","Lawrence County",1,61,869,429,440
050,39,087,"Ohio","Lawrence County",1,62,862,422,440
050,39,087,"Ohio","Lawrence County",1,63,808,382,426
050,39,087,"Ohio","Lawrence County",1,64,778,370,408
050,39,087,"Ohio","Lawrence County",1,65,798,368,430
050,39,087,"Ohio","Lawrence County",1,66,702,326,376
050,39,087,"Ohio","Lawrence County",1,67,680,344,336
050,39,087,"Ohio","Lawrence County",1,68,700,334,366
050,39,087,"Ohio","Lawrence County",1,69,653,290,363
050,39,087,"Ohio","Lawrence County",1,70,644,311,333
050,39,087,"Ohio","Lawrence County",1,71,660,314,346
050,39,087,"Ohio","Lawrence County",1,72,667,299,368
050,39,087,"Ohio","Lawrence County",1,73,623,288,335
050,39,087,"Ohio","Lawrence County",1,74,432,193,239
050,39,087,"Ohio","Lawrence County",1,75,459,207,252
050,39,087,"Ohio","Lawrence County",1,76,445,199,246
050,39,087,"Ohio","Lawrence County",1,77,462,212,250
050,39,087,"Ohio","Lawrence County",1,78,387,171,216
050,39,087,"Ohio","Lawrence County",1,79,359,157,202
050,39,087,"Ohio","Lawrence County",1,80,331,134,197
050,39,087,"Ohio","Lawrence County",1,81,287,126,161
050,39,087,"Ohio","Lawrence County",1,82,266,115,151
050,39,087,"Ohio","Lawrence County",1,83,223,92,131
050,39,087,"Ohio","Lawrence County",1,84,226,94,132
050,39,087,"Ohio","Lawrence County",1,85,1005,382,623
050,39,087,"Ohio","Lawrence County",2,0,623,323,300
050,39,087,"Ohio","Lawrence County",2,1,591,306,285
050,39,087,"Ohio","Lawrence County",2,2,615,313,302
050,39,087,"Ohio","Lawrence County",2,3,619,332,287
050,39,087,"Ohio","Lawrence County",2,4,664,360,304
050,39,087,"Ohio","Lawrence County",2,5,696,366,330
050,39,087,"Ohio","Lawrence County",2,6,704,356,348
050,39,087,"Ohio","Lawrence County",2,7,706,357,349
050,39,087,"Ohio","Lawrence County",2,8,707,348,359
050,39,087,"Ohio","Lawrence County",2,9,687,347,340
050,39,087,"Ohio","Lawrence County",2,10,695,355,340
050,39,087,"Ohio","Lawrence County",2,11,729,373,356
050,39,087,"Ohio","Lawrence County",2,12,761,378,383
050,39,087,"Ohio","Lawrence County",2,13,780,386,394
050,39,087,"Ohio","Lawrence County",2,14,794,406,388
050,39,087,"Ohio","Lawrence County",2,15,785,409,376
050,39,087,"Ohio","Lawrence County",2,16,781,407,374
050,39,087,"Ohio","Lawrence County",2,17,780,412,368
050,39,087,"Ohio","Lawrence County",2,18,641,352,289
050,39,087,"Ohio","Lawrence County",2,19,519,284,235
050,39,087,"Ohio","Lawrence County",2,20,556,294,262
050,39,087,"Ohio","Lawrence County",2,21,576,292,284
050,39,087,"Ohio","Lawrence County",2,22,635,316,319
050,39,087,"Ohio","Lawrence County",2,23,651,328,323
050,39,087,"Ohio","Lawrence County",2,24,662,328,334
050,39,087,"Ohio","Lawrence County",2,25,678,325,353
050,39,087,"Ohio","Lawrence County",2,26,673,339,334
050,39,087,"Ohio","Lawrence County",2,27,706,357,349
050,39,087,"Ohio","Lawrence County",2,28,727,369,358
050,39,087,"Ohio","Lawrence County",2,29,728,359,369
050,39,087,"Ohio","Lawrence County",2,30,726,372,354
050,39,087,"Ohio","Lawrence County",2,31,708,352,356
050,39,087,"Ohio","Lawrence County",2,32,677,334,343
050,39,087,"Ohio","Lawrence County",2,33,647,305,342
050,39,087,"Ohio","Lawrence County",2,34,669,319,350
050,39,087,"Ohio","Lawrence County",2,35,684,336,348
050,39,087,"Ohio","Lawrence County",2,36,685,336,349
050,39,087,"Ohio","Lawrence County",2,37,709,333,376
050,39,087,"Ohio","Lawrence County",2,38,715,340,375
050,39,087,"Ohio","Lawrence County",2,39,741,356,385
050,39,087,"Ohio","Lawrence County",2,40,753,356,397
050,39,087,"Ohio","Lawrence County",2,41,735,354,381
050,39,087,"Ohio","Lawrence County",2,42,724,361,363
050,39,087,"Ohio","Lawrence County",2,43,707,357,350
050,39,087,"Ohio","Lawrence County",2,44,687,348,339
050,39,087,"Ohio","Lawrence County",2,45,711,358,353
050,39,087,"Ohio","Lawrence County",2,46,719,366,353
050,39,087,"Ohio","Lawrence County",2,47,736,378,358
050,39,087,"Ohio","Lawrence County",2,48,788,382,406
050,39,087,"Ohio","Lawrence County",2,49,870,412,458
050,39,087,"Ohio","Lawrence County",2,50,831,407,424
050,39,087,"Ohio","Lawrence County",2,51,815,420,395
050,39,087,"Ohio","Lawrence County",2,52,796,408,388
050,39,087,"Ohio","Lawrence County",2,53,794,399,395
050,39,087,"Ohio","Lawrence County",2,54,816,409,407
050,39,087,"Ohio","Lawrence County",2,55,829,398,431
050,39,087,"Ohio","Lawrence County",2,56,818,389,429
050,39,087,"Ohio","Lawrence County",2,57,788,372,416
050,39,087,"Ohio","Lawrence County",2,58,790,380,410
050,39,087,"Ohio","Lawrence County",2,59,831,412,419
050,39,087,"Ohio","Lawrence County",2,60,818,415,403
050,39,087,"Ohio","Lawrence County",2,61,849,422,427
050,39,087,"Ohio","Lawrence County",2,62,858,421,437
050,39,087,"Ohio","Lawrence County",2,63,831,396,435
050,39,087,"Ohio","Lawrence County",2,64,777,367,410
050,39,087,"Ohio","Lawrence County",2,65,792,368,424
050,39,087,"Ohio","Lawrence County",2,66,725,339,386
050,39,087,"Ohio","Lawrence County",2,67,678,336,342
050,39,087,"Ohio","Lawrence County",2,68,684,329,355
050,39,087,"Ohio","Lawrence County",2,69,665,299,366
050,39,087,"Ohio","Lawrence County",2,70,635,300,335
050,39,087,"Ohio","Lawrence County",2,71,651,310,341
050,39,087,"Ohio","Lawrence County",2,72,654,297,357
050,39,087,"Ohio","Lawrence County",2,73,658,301,357
050,39,087,"Ohio","Lawrence County",2,74,444,201,243
050,39,087,"Ohio","Lawrence County",2,75,448,200,248
050,39,087,"Ohio","Lawrence County",2,76,438,196,242
050,39,087,"Ohio","Lawrence County",2,77,466,213,253
050,39,087,"Ohio","Lawrence County",2,78,394,176,218
050,39,087,"Ohio","Lawrence County",2,79,353,154,199
050,39,087,"Ohio","Lawrence County",2,80,336,137,199
050,39,087,"Ohio","Lawrence County",2,81,285,123,162
050,39,087,"Ohio","Lawrence County",2,82,266,113,153
050,39,087,"Ohio","Lawrence County",2,83,228,97,131
050,39,087,"Ohio","Lawrence County",2,84,222,90,132
050,39,087,"Ohio","Lawrence County",2,85,1014,386,628
050,39,087,"Ohio","Lawrence County",3,0,624,319,305
050,39,087,"Ohio","Lawrence County",3,1,616,315,301
050,39,087,"Ohio","Lawrence County",3,2,583,307,276
050,39,087,"Ohio","Lawrence County",3,3,598,309,289
050,39,087,"Ohio","Lawrence County",3,4,627,334,293
050,39,087,"Ohio","Lawrence County",3,5,673,361,312
050,39,087,"Ohio","Lawrence County",3,6,698,371,327
050,39,087,"Ohio","Lawrence County",3,7,697,351,346
050,39,087,"Ohio","Lawrence County",3,8,692,351,341
050,39,087,"Ohio","Lawrence County",3,9,706,344,362
050,39,087,"Ohio","Lawrence County",3,10,675,347,328
050,39,087,"Ohio","Lawrence County",3,11,686,349,337
050,39,087,"Ohio","Lawrence County",3,12,737,367,370
050,39,087,"Ohio","Lawrence County",3,13,759,383,376
050,39,087,"Ohio","Lawrence County",3,14,787,393,394
050,39,087,"Ohio","Lawrence County",3,15,789,392,397
050,39,087,"Ohio","Lawrence County",3,16,784,401,383
050,39,087,"Ohio","Lawrence County",3,17,780,422,358
050,39,087,"Ohio","Lawrence County",3,18,649,355,294
050,39,087,"Ohio","Lawrence County",3,19,486,261,225
050,39,087,"Ohio","Lawrence County",3,20,565,309,256
050,39,087,"Ohio","Lawrence County",3,21,568,297,271
050,39,087,"Ohio","Lawrence County",3,22,626,308,318
050,39,087,"Ohio","Lawrence County",3,23,642,324,318
050,39,087,"Ohio","Lawrence County",3,24,651,337,314
050,39,087,"Ohio","Lawrence County",3,25,677,336,341
050,39,087,"Ohio","Lawrence County",3,26,688,336,352
050,39,087,"Ohio","Lawrence County",3,27,690,342,348
050,39,087,"Ohio","Lawrence County",3,28,685,357,328
050,39,087,"Ohio","Lawrence County",3,29,710,366,344
050,39,087,"Ohio","Lawrence County",3,30,712,354,358
050,39,087,"Ohio","Lawrence County",3,31,716,361,355
050,39,087,"Ohio","Lawrence County",3,32,703,346,357
050,39,087,"Ohio","Lawrence County",3,33,684,339,345
050,39,087,"Ohio","Lawrence County",3,34,661,314,347
050,39,087,"Ohio","Lawrence County",3,35,668,308,360
050,39,087,"Ohio","Lawrence County",3,36,680,338,342
050,39,087,"Ohio","Lawrence County",3,37,677,333,344
050,39,087,"Ohio","Lawrence County",3,38,697,328,369
050,39,087,"Ohio","Lawrence County",3,39,690,340,350
050,39,087,"Ohio","Lawrence County",3,40,729,350,379
050,39,087,"Ohio","Lawrence County",3,41,728,341,387
050,39,087,"Ohio","Lawrence County",3,42,747,362,385
050,39,087,"Ohio","Lawrence County",3,43,733,363,370
050,39,087,"Ohio","Lawrence County",3,44,682,342,340
050,39,087,"Ohio","Lawrence County",3,45,675,333,342
050,39,087,"Ohio","Lawrence County",3,46,694,350,344
050,39,087,"Ohio","Lawrence County",3,47,728,376,352
050,39,087,"Ohio","Lawrence County",3,48,724,359,365
050,39,087,"Ohio","Lawrence County",3,49,774,379,395
050,39,087,"Ohio","Lawrence County",3,50,843,404,439
050,39,087,"Ohio","Lawrence County",3,51,837,406,431
050,39,087,"Ohio","Lawrence County",3,52,796,414,382
050,39,087,"Ohio","Lawrence County",3,53,789,403,386
050,39,087,"Ohio","Lawrence County",3,54,805,403,402
050,39,087,"Ohio","Lawrence County",3,55,804,401,403
050,39,087,"Ohio","Lawrence County",3,56,814,390,424
050,39,087,"Ohio","Lawrence County",3,57,817,387,430
050,39,087,"Ohio","Lawrence County",3,58,770,367,403
050,39,087,"Ohio","Lawrence County",3,59,768,366,402
050,39,087,"Ohio","Lawrence County",3,60,819,408,411
050,39,087,"Ohio","Lawrence County",3,61,800,398,402
050,39,087,"Ohio","Lawrence County",3,62,833,414,419
050,39,087,"Ohio","Lawrence County",3,63,842,408,434
050,39,087,"Ohio","Lawrence County",3,64,802,377,425
050,39,087,"Ohio","Lawrence County",3,65,755,357,398
050,39,087,"Ohio","Lawrence County",3,66,777,358,419
050,39,087,"Ohio","Lawrence County",3,67,697,322,375
050,39,087,"Ohio","Lawrence County",3,68,655,323,332
050,39,087,"Ohio","Lawrence County",3,69,678,324,354
050,39,087,"Ohio","Lawrence County",3,70,628,276,352
050,39,087,"Ohio","Lawrence County",3,71,616,290,326
050,39,087,"Ohio","Lawrence County",3,72,620,297,323
050,39,087,"Ohio","Lawrence County",3,73,621,281,340
050,39,087,"Ohio","Lawrence County",3,74,617,283,334
050,39,087,"Ohio","Lawrence County",3,75,418,184,234
050,39,087,"Ohio","Lawrence County",3,76,424,192,232
050,39,087,"Ohio","Lawrence County",3,77,411,180,231
050,39,087,"Ohio","Lawrence County",3,78,435,194,241
050,39,087,"Ohio","Lawrence County",3,79,362,157,205
050,39,087,"Ohio","Lawrence County",3,80,319,133,186
050,39,087,"Ohio","Lawrence County",3,81,295,115,180
050,39,087,"Ohio","Lawrence County",3,82,252,106,146
050,39,087,"Ohio","Lawrence County",3,83,232,99,133
050,39,087,"Ohio","Lawrence County",3,84,207,85,122
050,39,087,"Ohio","Lawrence County",3,85,1000,383,617
050,39,087,"Ohio","Lawrence County",4,0,565,273,292
050,39,087,"Ohio","Lawrence County",4,1,601,302,299
050,39,087,"Ohio","Lawrence County",4,2,605,308,297
050,39,087,"Ohio","Lawrence County",4,3,574,301,273
050,39,087,"Ohio","Lawrence County",4,4,594,304,290
050,39,087,"Ohio","Lawrence County",4,5,605,324,281
050,39,087,"Ohio","Lawrence County",4,6,659,356,303
050,39,087,"Ohio","Lawrence County",4,7,698,373,325
050,39,087,"Ohio","Lawrence County",4,8,696,351,345
050,39,087,"Ohio","Lawrence County",4,9,704,359,345
050,39,087,"Ohio","Lawrence County",4,10,694,339,355
050,39,087,"Ohio","Lawrence County",4,11,663,338,325
050,39,087,"Ohio","Lawrence County",4,12,694,346,348
050,39,087,"Ohio","Lawrence County",4,13,733,374,359
050,39,087,"Ohio","Lawrence County",4,14,767,383,384
050,39,087,"Ohio","Lawrence County",4,15,786,400,386
050,39,087,"Ohio","Lawrence County",4,16,787,388,399
050,39,087,"Ohio","Lawrence County",4,17,793,417,376
050,39,087,"Ohio","Lawrence County",4,18,637,358,279
050,39,087,"Ohio","Lawrence County",4,19,495,273,222
050,39,087,"Ohio","Lawrence County",4,20,514,272,242
050,39,087,"Ohio","Lawrence County",4,21,575,304,271
050,39,087,"Ohio","Lawrence County",4,22,600,313,287
050,39,087,"Ohio","Lawrence County",4,23,640,314,326
050,39,087,"Ohio","Lawrence County",4,24,656,319,337
050,39,087,"Ohio","Lawrence County",4,25,650,336,314
050,39,087,"Ohio","Lawrence County",4,26,647,329,318
050,39,087,"Ohio","Lawrence County",4,27,681,333,348
050,39,087,"Ohio","Lawrence County",4,28,671,330,341
050,39,087,"Ohio","Lawrence County",4,29,692,356,336
050,39,087,"Ohio","Lawrence County",4,30,696,358,338
050,39,087,"Ohio","Lawrence County",4,31,726,356,370
050,39,087,"Ohio","Lawrence County",4,32,703,360,343
050,39,087,"Ohio","Lawrence County",4,33,707,344,363
050,39,087,"Ohio","Lawrence County",4,34,695,354,341
050,39,087,"Ohio","Lawrence County",4,35,651,310,341
050,39,087,"Ohio","Lawrence County",4,36,660,310,350
050,39,087,"Ohio","Lawrence County",4,37,663,333,330
050,39,087,"Ohio","Lawrence County",4,38,659,323,336
050,39,087,"Ohio","Lawrence County",4,39,680,315,365
050,39,087,"Ohio","Lawrence County",4,40,690,337,353
050,39,087,"Ohio","Lawrence County",4,41,731,344,387
050,39,087,"Ohio","Lawrence County",4,42,723,333,390
050,39,087,"Ohio","Lawrence County",4,43,745,371,374
050,39,087,"Ohio","Lawrence County",4,44,719,352,367
050,39,087,"Ohio","Lawrence County",4,45,657,314,343
050,39,087,"Ohio","Lawrence County",4,46,663,323,340
050,39,087,"Ohio","Lawrence County",4,47,702,364,338
050,39,087,"Ohio","Lawrence County",4,48,714,359,355
050,39,087,"Ohio","Lawrence County",4,49,725,359,366
050,39,087,"Ohio","Lawrence County",4,50,758,375,383
050,39,087,"Ohio","Lawrence County",4,51,845,407,438
050,39,087,"Ohio","Lawrence County",4,52,835,407,428
050,39,087,"Ohio","Lawrence County",4,53,791,412,379
050,39,087,"Ohio","Lawrence County",4,54,790,399,391
050,39,087,"Ohio","Lawrence County",4,55,798,405,393
050,39,087,"Ohio","Lawrence County",4,56,795,394,401
050,39,087,"Ohio","Lawrence County",4,57,812,387,425
050,39,087,"Ohio","Lawrence County",4,58,807,386,421
050,39,087,"Ohio","Lawrence County",4,59,758,356,402
050,39,087,"Ohio","Lawrence County",4,60,744,359,385
050,39,087,"Ohio","Lawrence County",4,61,799,403,396
050,39,087,"Ohio","Lawrence County",4,62,773,383,390
050,39,087,"Ohio","Lawrence County",4,63,812,396,416
050,39,087,"Ohio","Lawrence County",4,64,831,398,433
050,39,087,"Ohio","Lawrence County",4,65,758,349,409
050,39,087,"Ohio","Lawrence County",4,66,738,344,394
050,39,087,"Ohio","Lawrence County",4,67,754,350,404
050,39,087,"Ohio","Lawrence County",4,68,672,307,365
050,39,087,"Ohio","Lawrence County",4,69,642,311,331
050,39,087,"Ohio","Lawrence County",4,70,645,314,331
050,39,087,"Ohio","Lawrence County",4,71,607,269,338
050,39,087,"Ohio","Lawrence County",4,72,596,277,319
050,39,087,"Ohio","Lawrence County",4,73,582,280,302
050,39,087,"Ohio","Lawrence County",4,74,585,263,322
050,39,087,"Ohio","Lawrence County",4,75,582,259,323
050,39,087,"Ohio","Lawrence County",4,76,401,175,226
050,39,087,"Ohio","Lawrence County",4,77,396,178,218
050,39,087,"Ohio","Lawrence County",4,78,379,167,212
050,39,087,"Ohio","Lawrence County",4,79,401,173,228
050,39,087,"Ohio","Lawrence County",4,80,334,138,196
050,39,087,"Ohio","Lawrence County",4,81,284,121,163
050,39,087,"Ohio","Lawrence County",4,82,269,106,163
050,39,087,"Ohio","Lawrence County",4,83,227,98,129
050,39,087,"Ohio","Lawrence County",4,84,214,86,128
050,39,087,"Ohio","Lawrence County",4,85,973,369,604
050,39,087,"Ohio","Lawrence County",5,0,514,243,271
050,39,087,"Ohio","Lawrence County",5,1,555,270,285
050,39,087,"Ohio","Lawrence County",5,2,585,290,295
050,39,087,"Ohio","Lawrence County",5,3,588,297,291
050,39,087,"Ohio","Lawrence County",5,4,573,295,278
050,39,087,"Ohio","Lawrence County",5,5,616,321,295
050,39,087,"Ohio","Lawrence County",5,6,620,326,294
050,39,087,"Ohio","Lawrence County",5,7,659,352,307
050,39,087,"Ohio","Lawrence County",5,8,703,371,332
050,39,087,"Ohio","Lawrence County",5,9,704,357,347
050,39,087,"Ohio","Lawrence County",5,10,704,359,345
050,39,087,"Ohio","Lawrence County",5,11,697,343,354
050,39,087,"Ohio","Lawrence County",5,12,680,346,334
050,39,087,"Ohio","Lawrence County",5,13,697,355,342
050,39,087,"Ohio","Lawrence County",5,14,741,380,361
050,39,087,"Ohio","Lawrence County",5,15,766,384,382
050,39,087,"Ohio","Lawrence County",5,16,788,391,397
050,39,087,"Ohio","Lawrence County",5,17,792,399,393
050,39,087,"Ohio","Lawrence County",5,18,648,346,302
050,39,087,"Ohio","Lawrence County",5,19,497,275,222
050,39,087,"Ohio","Lawrence County",5,20,550,298,252
050,39,087,"Ohio","Lawrence County",5,21,542,280,262
050,39,087,"Ohio","Lawrence County",5,22,614,320,294
050,39,087,"Ohio","Lawrence County",5,23,623,322,301
050,39,087,"Ohio","Lawrence County",5,24,657,321,336
050,39,087,"Ohio","Lawrence County",5,25,661,318,343
050,39,087,"Ohio","Lawrence County",5,26,639,330,309
050,39,087,"Ohio","Lawrence County",5,27,663,338,325
050,39,087,"Ohio","Lawrence County",5,28,666,328,338
050,39,087,"Ohio","Lawrence County",5,29,643,306,337
050,39,087,"Ohio","Lawrence County",5,30,697,366,331
050,39,087,"Ohio","Lawrence County",5,31,686,349,337
050,39,087,"Ohio","Lawrence County",5,32,731,356,375
050,39,087,"Ohio","Lawrence County",5,33,707,354,353
050,39,087,"Ohio","Lawrence County",5,34,734,366,368
050,39,087,"Ohio","Lawrence County",5,35,694,344,350
050,39,087,"Ohio","Lawrence County",5,36,643,305,338
050,39,087,"Ohio","Lawrence County",5,37,646,303,343
050,39,087,"Ohio","Lawrence County",5,38,663,331,332
050,39,087,"Ohio","Lawrence County",5,39,665,321,344
050,39,087,"Ohio","Lawrence County",5,40,671,313,358
050,39,087,"Ohio","Lawrence County",5,41,696,338,358
050,39,087,"Ohio","Lawrence County",5,42,734,350,384
050,39,087,"Ohio","Lawrence County",5,43,718,330,388
050,39,087,"Ohio","Lawrence County",5,44,741,369,372
050,39,087,"Ohio","Lawrence County",5,45,736,356,380
050,39,087,"Ohio","Lawrence County",5,46,659,316,343
050,39,087,"Ohio","Lawrence County",5,47,665,328,337
050,39,087,"Ohio","Lawrence County",5,48,687,354,333
050,39,087,"Ohio","Lawrence County",5,49,714,360,354
050,39,087,"Ohio","Lawrence County",5,50,700,350,350
050,39,087,"Ohio","Lawrence County",5,51,763,369,394
050,39,087,"Ohio","Lawrence County",5,52,831,403,428
050,39,087,"Ohio","Lawrence County",5,53,838,398,440
050,39,087,"Ohio","Lawrence County",5,54,796,409,387
050,39,087,"Ohio","Lawrence County",5,55,784,397,387
050,39,087,"Ohio","Lawrence County",5,56,788,397,391
050,39,087,"Ohio","Lawrence County",5,57,789,389,400
050,39,087,"Ohio","Lawrence County",5,58,796,380,416
050,39,087,"Ohio","Lawrence County",5,59,790,377,413
050,39,087,"Ohio","Lawrence County",5,60,746,355,391
050,39,087,"Ohio","Lawrence County",5,61,727,353,374
050,39,087,"Ohio","Lawrence County",5,62,782,390,392
050,39,087,"Ohio","Lawrence County",5,63,761,375,386
050,39,087,"Ohio","Lawrence County",5,64,792,381,411
050,39,087,"Ohio","Lawrence County",5,65,806,379,427
050,39,087,"Ohio","Lawrence County",5,66,744,338,406
050,39,087,"Ohio","Lawrence County",5,67,706,328,378
050,39,087,"Ohio","Lawrence County",5,68,730,338,392
050,39,087,"Ohio","Lawrence County",5,69,654,296,358
050,39,087,"Ohio","Lawrence County",5,70,617,298,319
050,39,087,"Ohio","Lawrence County",5,71,626,306,320
050,39,087,"Ohio","Lawrence County",5,72,585,254,331
050,39,087,"Ohio","Lawrence County",5,73,563,260,303
050,39,087,"Ohio","Lawrence County",5,74,555,265,290
050,39,087,"Ohio","Lawrence County",5,75,560,245,315
050,39,087,"Ohio","Lawrence County",5,76,561,249,312
050,39,087,"Ohio","Lawrence County",5,77,386,166,220
050,39,087,"Ohio","Lawrence County",5,78,363,163,200
050,39,087,"Ohio","Lawrence County",5,79,343,145,198
050,39,087,"Ohio","Lawrence County",5,80,371,153,218
050,39,087,"Ohio","Lawrence County",5,81,297,128,169
050,39,087,"Ohio","Lawrence County",5,82,259,112,147
050,39,087,"Ohio","Lawrence County",5,83,247,99,148
050,39,087,"Ohio","Lawrence County",5,84,215,88,127
050,39,087,"Ohio","Lawrence County",5,85,975,369,606
050,39,089,"Ohio","Licking County",1,0,1970,999,971
050,39,089,"Ohio","Licking County",1,1,2038,1018,1020
050,39,089,"Ohio","Licking County",1,2,2103,1061,1042
050,39,089,"Ohio","Licking County",1,3,2175,1120,1055
050,39,089,"Ohio","Licking County",1,4,2293,1169,1124
050,39,089,"Ohio","Licking County",1,5,2296,1206,1090
050,39,089,"Ohio","Licking County",1,6,2270,1185,1085
050,39,089,"Ohio","Licking County",1,7,2285,1153,1132
050,39,089,"Ohio","Licking County",1,8,2269,1172,1097
050,39,089,"Ohio","Licking County",1,9,2324,1228,1096
050,39,089,"Ohio","Licking County",1,10,2363,1206,1157
050,39,089,"Ohio","Licking County",1,11,2420,1257,1163
050,39,089,"Ohio","Licking County",1,12,2444,1289,1155
050,39,089,"Ohio","Licking County",1,13,2502,1289,1213
050,39,089,"Ohio","Licking County",1,14,2476,1260,1216
050,39,089,"Ohio","Licking County",1,15,2346,1188,1158
050,39,089,"Ohio","Licking County",1,16,2408,1253,1155
050,39,089,"Ohio","Licking County",1,17,2444,1276,1168
050,39,089,"Ohio","Licking County",1,18,2427,1255,1172
050,39,089,"Ohio","Licking County",1,19,2406,1239,1167
050,39,089,"Ohio","Licking County",1,20,2321,1175,1146
050,39,089,"Ohio","Licking County",1,21,2361,1157,1204
050,39,089,"Ohio","Licking County",1,22,2273,1123,1150
050,39,089,"Ohio","Licking County",1,23,1959,1017,942
050,39,089,"Ohio","Licking County",1,24,1948,1010,938
050,39,089,"Ohio","Licking County",1,25,1975,1019,956
050,39,089,"Ohio","Licking County",1,26,1940,1005,935
050,39,089,"Ohio","Licking County",1,27,1968,988,980
050,39,089,"Ohio","Licking County",1,28,2147,1064,1083
050,39,089,"Ohio","Licking County",1,29,2144,1040,1104
050,39,089,"Ohio","Licking County",1,30,2134,1036,1098
050,39,089,"Ohio","Licking County",1,31,2135,1046,1089
050,39,089,"Ohio","Licking County",1,32,2149,1065,1084
050,39,089,"Ohio","Licking County",1,33,2200,1050,1150
050,39,089,"Ohio","Licking County",1,34,2303,1095,1208
050,39,089,"Ohio","Licking County",1,35,2303,1101,1202
050,39,089,"Ohio","Licking County",1,36,2255,1118,1137
050,39,089,"Ohio","Licking County",1,37,2285,1113,1172
050,39,089,"Ohio","Licking County",1,38,2349,1193,1156
050,39,089,"Ohio","Licking County",1,39,2325,1165,1160
050,39,089,"Ohio","Licking County",1,40,2235,1132,1103
050,39,089,"Ohio","Licking County",1,41,2171,1092,1079
050,39,089,"Ohio","Licking County",1,42,2189,1099,1090
050,39,089,"Ohio","Licking County",1,43,2121,1045,1076
050,39,089,"Ohio","Licking County",1,44,2025,1009,1016
050,39,089,"Ohio","Licking County",1,45,2089,1055,1034
050,39,089,"Ohio","Licking County",1,46,2136,1104,1032
050,39,089,"Ohio","Licking County",1,47,2145,1071,1074
050,39,089,"Ohio","Licking County",1,48,2357,1153,1204
050,39,089,"Ohio","Licking County",1,49,2563,1294,1269
050,39,089,"Ohio","Licking County",1,50,2507,1252,1255
050,39,089,"Ohio","Licking County",1,51,2371,1183,1188
050,39,089,"Ohio","Licking County",1,52,2306,1153,1153
050,39,089,"Ohio","Licking County",1,53,2410,1192,1218
050,39,089,"Ohio","Licking County",1,54,2427,1216,1211
050,39,089,"Ohio","Licking County",1,55,2541,1261,1280
050,39,089,"Ohio","Licking County",1,56,2602,1303,1299
050,39,089,"Ohio","Licking County",1,57,2602,1288,1314
050,39,089,"Ohio","Licking County",1,58,2628,1334,1294
050,39,089,"Ohio","Licking County",1,59,2597,1319,1278
050,39,089,"Ohio","Licking County",1,60,2514,1262,1252
050,39,089,"Ohio","Licking County",1,61,2551,1266,1285
050,39,089,"Ohio","Licking County",1,62,2509,1231,1278
050,39,089,"Ohio","Licking County",1,63,2365,1177,1188
050,39,089,"Ohio","Licking County",1,64,2284,1098,1186
050,39,089,"Ohio","Licking County",1,65,2164,1033,1131
050,39,089,"Ohio","Licking County",1,66,2063,1001,1062
050,39,089,"Ohio","Licking County",1,67,2004,964,1040
050,39,089,"Ohio","Licking County",1,68,1902,923,979
050,39,089,"Ohio","Licking County",1,69,1721,819,902
050,39,089,"Ohio","Licking County",1,70,1742,827,915
050,39,089,"Ohio","Licking County",1,71,1733,809,924
050,39,089,"Ohio","Licking County",1,72,1745,802,943
050,39,089,"Ohio","Licking County",1,73,1778,850,928
050,39,089,"Ohio","Licking County",1,74,1170,533,637
050,39,089,"Ohio","Licking County",1,75,1137,516,621
050,39,089,"Ohio","Licking County",1,76,1216,547,669
050,39,089,"Ohio","Licking County",1,77,1204,529,675
050,39,089,"Ohio","Licking County",1,78,994,441,553
050,39,089,"Ohio","Licking County",1,79,894,393,501
050,39,089,"Ohio","Licking County",1,80,820,354,466
050,39,089,"Ohio","Licking County",1,81,763,320,443
050,39,089,"Ohio","Licking County",1,82,658,276,382
050,39,089,"Ohio","Licking County",1,83,569,248,321
050,39,089,"Ohio","Licking County",1,84,529,217,312
050,39,089,"Ohio","Licking County",1,85,2729,986,1743
050,39,089,"Ohio","Licking County",2,0,1958,976,982
050,39,089,"Ohio","Licking County",2,1,2025,1013,1012
050,39,089,"Ohio","Licking County",2,2,2098,1056,1042
050,39,089,"Ohio","Licking County",2,3,2158,1104,1054
050,39,089,"Ohio","Licking County",2,4,2284,1164,1120
050,39,089,"Ohio","Licking County",2,5,2312,1208,1104
050,39,089,"Ohio","Licking County",2,6,2285,1195,1090
050,39,089,"Ohio","Licking County",2,7,2280,1159,1121
050,39,089,"Ohio","Licking County",2,8,2270,1166,1104
050,39,089,"Ohio","Licking County",2,9,2309,1213,1096
050,39,089,"Ohio","Licking County",2,10,2356,1212,1144
050,39,089,"Ohio","Licking County",2,11,2400,1244,1156
050,39,089,"Ohio","Licking County",2,12,2459,1293,1166
050,39,089,"Ohio","Licking County",2,13,2487,1290,1197
050,39,089,"Ohio","Licking County",2,14,2479,1266,1213
050,39,089,"Ohio","Licking County",2,15,2379,1208,1171
050,39,089,"Ohio","Licking County",2,16,2396,1239,1157
050,39,089,"Ohio","Licking County",2,17,2433,1271,1162
050,39,089,"Ohio","Licking County",2,18,2421,1251,1170
050,39,089,"Ohio","Licking County",2,19,2399,1238,1161
050,39,089,"Ohio","Licking County",2,20,2352,1193,1159
050,39,089,"Ohio","Licking County",2,21,2355,1159,1196
050,39,089,"Ohio","Licking County",2,22,2261,1115,1146
050,39,089,"Ohio","Licking County",2,23,1983,1020,963
050,39,089,"Ohio","Licking County",2,24,1964,1021,943
050,39,089,"Ohio","Licking County",2,25,1972,1022,950
050,39,089,"Ohio","Licking County",2,26,1951,1006,945
050,39,089,"Ohio","Licking County",2,27,1982,999,983
050,39,089,"Ohio","Licking County",2,28,2119,1055,1064
050,39,089,"Ohio","Licking County",2,29,2146,1052,1094
050,39,089,"Ohio","Licking County",2,30,2157,1044,1113
050,39,089,"Ohio","Licking County",2,31,2143,1049,1094
050,39,089,"Ohio","Licking County",2,32,2156,1067,1089
050,39,089,"Ohio","Licking County",2,33,2200,1063,1137
050,39,089,"Ohio","Licking County",2,34,2292,1090,1202
050,39,089,"Ohio","Licking County",2,35,2325,1109,1216
050,39,089,"Ohio","Licking County",2,36,2263,1112,1151
050,39,089,"Ohio","Licking County",2,37,2299,1122,1177
050,39,089,"Ohio","Licking County",2,38,2352,1187,1165
050,39,089,"Ohio","Licking County",2,39,2325,1170,1155
050,39,089,"Ohio","Licking County",2,40,2271,1147,1124
050,39,089,"Ohio","Licking County",2,41,2193,1106,1087
050,39,089,"Ohio","Licking County",2,42,2184,1096,1088
050,39,089,"Ohio","Licking County",2,43,2159,1068,1091
050,39,089,"Ohio","Licking County",2,44,2026,1007,1019
050,39,089,"Ohio","Licking County",2,45,2086,1051,1035
050,39,089,"Ohio","Licking County",2,46,2121,1092,1029
050,39,089,"Ohio","Licking County",2,47,2140,1076,1064
050,39,089,"Ohio","Licking County",2,48,2302,1134,1168
050,39,089,"Ohio","Licking County",2,49,2523,1270,1253
050,39,089,"Ohio","Licking County",2,50,2523,1264,1259
050,39,089,"Ohio","Licking County",2,51,2403,1203,1200
050,39,089,"Ohio","Licking County",2,52,2314,1155,1159
050,39,089,"Ohio","Licking County",2,53,2397,1188,1209
050,39,089,"Ohio","Licking County",2,54,2410,1205,1205
050,39,089,"Ohio","Licking County",2,55,2510,1248,1262
050,39,089,"Ohio","Licking County",2,56,2590,1295,1295
050,39,089,"Ohio","Licking County",2,57,2609,1298,1311
050,39,089,"Ohio","Licking County",2,58,2606,1313,1293
050,39,089,"Ohio","Licking County",2,59,2617,1332,1285
050,39,089,"Ohio","Licking County",2,60,2521,1269,1252
050,39,089,"Ohio","Licking County",2,61,2528,1260,1268
050,39,089,"Ohio","Licking County",2,62,2507,1234,1273
050,39,089,"Ohio","Licking County",2,63,2410,1194,1216
050,39,089,"Ohio","Licking County",2,64,2285,1106,1179
050,39,089,"Ohio","Licking County",2,65,2193,1047,1146
050,39,089,"Ohio","Licking County",2,66,2092,1007,1085
050,39,089,"Ohio","Licking County",2,67,2010,969,1041
050,39,089,"Ohio","Licking County",2,68,1909,922,987
050,39,089,"Ohio","Licking County",2,69,1769,847,922
050,39,089,"Ohio","Licking County",2,70,1728,821,907
050,39,089,"Ohio","Licking County",2,71,1736,811,925
050,39,089,"Ohio","Licking County",2,72,1707,786,921
050,39,089,"Ohio","Licking County",2,73,1849,877,972
050,39,089,"Ohio","Licking County",2,74,1230,565,665
050,39,089,"Ohio","Licking County",2,75,1140,524,616
050,39,089,"Ohio","Licking County",2,76,1173,528,645
050,39,089,"Ohio","Licking County",2,77,1231,546,685
050,39,089,"Ohio","Licking County",2,78,1010,444,566
050,39,089,"Ohio","Licking County",2,79,894,395,499
050,39,089,"Ohio","Licking County",2,80,826,356,470
050,39,089,"Ohio","Licking County",2,81,762,320,442
050,39,089,"Ohio","Licking County",2,82,673,278,395
050,39,089,"Ohio","Licking County",2,83,572,246,326
050,39,089,"Ohio","Licking County",2,84,528,222,306
050,39,089,"Ohio","Licking County",2,85,2732,997,1735
050,39,089,"Ohio","Licking County",3,0,1854,990,864
050,39,089,"Ohio","Licking County",3,1,2086,1032,1054
050,39,089,"Ohio","Licking County",3,2,2115,1064,1051
050,39,089,"Ohio","Licking County",3,3,2168,1113,1055
050,39,089,"Ohio","Licking County",3,4,2219,1129,1090
050,39,089,"Ohio","Licking County",3,5,2351,1185,1166
050,39,089,"Ohio","Licking County",3,6,2402,1259,1143
050,39,089,"Ohio","Licking County",3,7,2318,1201,1117
050,39,089,"Ohio","Licking County",3,8,2359,1214,1145
050,39,089,"Ohio","Licking County",3,9,2301,1182,1119
050,39,089,"Ohio","Licking County",3,10,2315,1208,1107
050,39,089,"Ohio","Licking County",3,11,2395,1249,1146
050,39,089,"Ohio","Licking County",3,12,2386,1222,1164
050,39,089,"Ohio","Licking County",3,13,2485,1303,1182
050,39,089,"Ohio","Licking County",3,14,2480,1283,1197
050,39,089,"Ohio","Licking County",3,15,2489,1281,1208
050,39,089,"Ohio","Licking County",3,16,2378,1199,1179
050,39,089,"Ohio","Licking County",3,17,2377,1216,1161
050,39,089,"Ohio","Licking County",3,18,2383,1215,1168
050,39,089,"Ohio","Licking County",3,19,2208,1162,1046
050,39,089,"Ohio","Licking County",3,20,2291,1187,1104
050,39,089,"Ohio","Licking County",3,21,2258,1135,1123
050,39,089,"Ohio","Licking County",3,22,2175,1072,1103
050,39,089,"Ohio","Licking County",3,23,1992,1021,971
050,39,089,"Ohio","Licking County",3,24,1984,1022,962
050,39,089,"Ohio","Licking County",3,25,2044,1067,977
050,39,089,"Ohio","Licking County",3,26,2018,1045,973
050,39,089,"Ohio","Licking County",3,27,2033,1023,1010
050,39,089,"Ohio","Licking County",3,28,2045,1020,1025
050,39,089,"Ohio","Licking County",3,29,2189,1078,1111
050,39,089,"Ohio","Licking County",3,30,2227,1095,1132
050,39,089,"Ohio","Licking County",3,31,2230,1080,1150
050,39,089,"Ohio","Licking County",3,32,2228,1097,1131
050,39,089,"Ohio","Licking County",3,33,2222,1102,1120
050,39,089,"Ohio","Licking County",3,34,2287,1104,1183
050,39,089,"Ohio","Licking County",3,35,2361,1095,1266
050,39,089,"Ohio","Licking County",3,36,2364,1119,1245
050,39,089,"Ohio","Licking County",3,37,2315,1138,1177
050,39,089,"Ohio","Licking County",3,38,2325,1154,1171
050,39,089,"Ohio","Licking County",3,39,2368,1202,1166
050,39,089,"Ohio","Licking County",3,40,2372,1198,1174
050,39,089,"Ohio","Licking County",3,41,2284,1161,1123
050,39,089,"Ohio","Licking County",3,42,2200,1114,1086
050,39,089,"Ohio","Licking County",3,43,2212,1103,1109
050,39,089,"Ohio","Licking County",3,44,2175,1089,1086
050,39,089,"Ohio","Licking County",3,45,2002,991,1011
050,39,089,"Ohio","Licking County",3,46,2097,1059,1038
050,39,089,"Ohio","Licking County",3,47,2142,1102,1040
050,39,089,"Ohio","Licking County",3,48,2117,1062,1055
050,39,089,"Ohio","Licking County",3,49,2294,1128,1166
050,39,089,"Ohio","Licking County",3,50,2548,1290,1258
050,39,089,"Ohio","Licking County",3,51,2538,1288,1250
050,39,089,"Ohio","Licking County",3,52,2388,1194,1194
050,39,089,"Ohio","Licking County",3,53,2337,1143,1194
050,39,089,"Ohio","Licking County",3,54,2392,1188,1204
050,39,089,"Ohio","Licking County",3,55,2387,1182,1205
050,39,089,"Ohio","Licking County",3,56,2502,1261,1241
050,39,089,"Ohio","Licking County",3,57,2602,1295,1307
050,39,089,"Ohio","Licking County",3,58,2584,1268,1316
050,39,089,"Ohio","Licking County",3,59,2617,1311,1306
050,39,089,"Ohio","Licking County",3,60,2595,1317,1278
050,39,089,"Ohio","Licking County",3,61,2523,1281,1242
050,39,089,"Ohio","Licking County",3,62,2513,1249,1264
050,39,089,"Ohio","Licking County",3,63,2481,1225,1256
050,39,089,"Ohio","Licking County",3,64,2383,1177,1206
050,39,089,"Ohio","Licking County",3,65,2255,1071,1184
050,39,089,"Ohio","Licking County",3,66,2155,1013,1142
050,39,089,"Ohio","Licking County",3,67,2070,985,1085
050,39,089,"Ohio","Licking County",3,68,1975,959,1016
050,39,089,"Ohio","Licking County",3,69,1878,902,976
050,39,089,"Ohio","Licking County",3,70,1743,827,916
050,39,089,"Ohio","Licking County",3,71,1674,791,883
050,39,089,"Ohio","Licking County",3,72,1688,784,904
050,39,089,"Ohio","Licking County",3,73,1673,763,910
050,39,089,"Ohio","Licking County",3,74,1818,855,963
050,39,089,"Ohio","Licking County",3,75,1205,547,658
050,39,089,"Ohio","Licking County",3,76,1089,502,587
050,39,089,"Ohio","Licking County",3,77,1149,507,642
050,39,089,"Ohio","Licking County",3,78,1175,510,665
050,39,089,"Ohio","Licking County",3,79,967,426,541
050,39,089,"Ohio","Licking County",3,80,838,369,469
050,39,089,"Ohio","Licking County",3,81,771,319,452
050,39,089,"Ohio","Licking County",3,82,700,298,402
050,39,089,"Ohio","Licking County",3,83,625,256,369
050,39,089,"Ohio","Licking County",3,84,518,220,298
050,39,089,"Ohio","Licking County",3,85,2745,1017,1728
050,39,089,"Ohio","Licking County",4,0,1914,1008,906
050,39,089,"Ohio","Licking County",4,1,1895,1010,885
050,39,089,"Ohio","Licking County",4,2,2126,1059,1067
050,39,089,"Ohio","Licking County",4,3,2193,1109,1084
050,39,089,"Ohio","Licking County",4,4,2172,1124,1048
050,39,089,"Ohio","Licking County",4,5,2235,1131,1104
050,39,089,"Ohio","Licking County",4,6,2409,1226,1183
050,39,089,"Ohio","Licking County",4,7,2441,1284,1157
050,39,089,"Ohio","Licking County",4,8,2360,1232,1128
050,39,089,"Ohio","Licking County",4,9,2382,1206,1176
050,39,089,"Ohio","Licking County",4,10,2347,1205,1142
050,39,089,"Ohio","Licking County",4,11,2335,1212,1123
050,39,089,"Ohio","Licking County",4,12,2376,1225,1151
050,39,089,"Ohio","Licking County",4,13,2443,1262,1181
050,39,089,"Ohio","Licking County",4,14,2524,1312,1212
050,39,089,"Ohio","Licking County",4,15,2532,1301,1231
050,39,089,"Ohio","Licking County",4,16,2511,1277,1234
050,39,089,"Ohio","Licking County",4,17,2403,1224,1179
050,39,089,"Ohio","Licking County",4,18,2352,1194,1158
050,39,089,"Ohio","Licking County",4,19,2307,1202,1105
050,39,089,"Ohio","Licking County",4,20,2320,1216,1104
050,39,089,"Ohio","Licking County",4,21,2352,1212,1140
050,39,089,"Ohio","Licking County",4,22,2266,1144,1122
050,39,089,"Ohio","Licking County",4,23,1996,997,999
050,39,089,"Ohio","Licking County",4,24,2019,1025,994
050,39,089,"Ohio","Licking County",4,25,1932,989,943
050,39,089,"Ohio","Licking County",4,26,2068,1065,1003
050,39,089,"Ohio","Licking County",4,27,2105,1079,1026
050,39,089,"Ohio","Licking County",4,28,2094,1039,1055
050,39,089,"Ohio","Licking County",4,29,2107,1063,1044
050,39,089,"Ohio","Licking County",4,30,2238,1119,1119
050,39,089,"Ohio","Licking County",4,31,2318,1135,1183
050,39,089,"Ohio","Licking County",4,32,2305,1122,1183
050,39,089,"Ohio","Licking County",4,33,2297,1130,1167
050,39,089,"Ohio","Licking County",4,34,2302,1147,1155
050,39,089,"Ohio","Licking County",4,35,2349,1110,1239
050,39,089,"Ohio","Licking County",4,36,2387,1107,1280
050,39,089,"Ohio","Licking County",4,37,2419,1149,1270
050,39,089,"Ohio","Licking County",4,38,2363,1183,1180
050,39,089,"Ohio","Licking County",4,39,2359,1181,1178
050,39,089,"Ohio","Licking County",4,40,2410,1205,1205
050,39,089,"Ohio","Licking County",4,41,2370,1198,1172
050,39,089,"Ohio","Licking County",4,42,2338,1196,1142
050,39,089,"Ohio","Licking County",4,43,2199,1109,1090
050,39,089,"Ohio","Licking County",4,44,2236,1127,1109
050,39,089,"Ohio","Licking County",4,45,2189,1093,1096
050,39,089,"Ohio","Licking County",4,46,2041,1001,1040
050,39,089,"Ohio","Licking County",4,47,2146,1082,1064
050,39,089,"Ohio","Licking County",4,48,2140,1094,1046
050,39,089,"Ohio","Licking County",4,49,2105,1067,1038
050,39,089,"Ohio","Licking County",4,50,2310,1136,1174
050,39,089,"Ohio","Licking County",4,51,2555,1297,1258
050,39,089,"Ohio","Licking County",4,52,2510,1264,1246
050,39,089,"Ohio","Licking County",4,53,2405,1204,1201
050,39,089,"Ohio","Licking County",4,54,2328,1139,1189
050,39,089,"Ohio","Licking County",4,55,2365,1172,1193
050,39,089,"Ohio","Licking County",4,56,2370,1173,1197
050,39,089,"Ohio","Licking County",4,57,2500,1269,1231
050,39,089,"Ohio","Licking County",4,58,2559,1261,1298
050,39,089,"Ohio","Licking County",4,59,2575,1267,1308
050,39,089,"Ohio","Licking County",4,60,2585,1295,1290
050,39,089,"Ohio","Licking County",4,61,2586,1324,1262
050,39,089,"Ohio","Licking County",4,62,2508,1251,1257
050,39,089,"Ohio","Licking County",4,63,2483,1238,1245
050,39,089,"Ohio","Licking County",4,64,2443,1208,1235
050,39,089,"Ohio","Licking County",4,65,2355,1151,1204
050,39,089,"Ohio","Licking County",4,66,2225,1045,1180
050,39,089,"Ohio","Licking County",4,67,2111,978,1133
050,39,089,"Ohio","Licking County",4,68,2028,964,1064
050,39,089,"Ohio","Licking County",4,69,1917,922,995
050,39,089,"Ohio","Licking County",4,70,1840,863,977
050,39,089,"Ohio","Licking County",4,71,1705,808,897
050,39,089,"Ohio","Licking County",4,72,1639,755,884
050,39,089,"Ohio","Licking County",4,73,1655,765,890
050,39,089,"Ohio","Licking County",4,74,1637,725,912
050,39,089,"Ohio","Licking County",4,75,1767,824,943
050,39,089,"Ohio","Licking County",4,76,1168,526,642
050,39,089,"Ohio","Licking County",4,77,1059,482,577
050,39,089,"Ohio","Licking County",4,78,1107,487,620
050,39,089,"Ohio","Licking County",4,79,1127,486,641
050,39,089,"Ohio","Licking County",4,80,916,400,516
050,39,089,"Ohio","Licking County",4,81,783,337,446
050,39,089,"Ohio","Licking County",4,82,716,292,424
050,39,089,"Ohio","Licking County",4,83,651,273,378
050,39,089,"Ohio","Licking County",4,84,557,221,336
050,39,089,"Ohio","Licking County",4,85,2693,1013,1680
050,39,089,"Ohio","Licking County",5,0,1887,995,892
050,39,089,"Ohio","Licking County",5,1,1957,1025,932
050,39,089,"Ohio","Licking County",5,2,1896,989,907
050,39,089,"Ohio","Licking County",5,3,2199,1092,1107
050,39,089,"Ohio","Licking County",5,4,2244,1139,1105
050,39,089,"Ohio","Licking County",5,5,2187,1134,1053
050,39,089,"Ohio","Licking County",5,6,2299,1155,1144
050,39,089,"Ohio","Licking County",5,7,2432,1238,1194
050,39,089,"Ohio","Licking County",5,8,2438,1291,1147
050,39,089,"Ohio","Licking County",5,9,2393,1236,1157
050,39,089,"Ohio","Licking County",5,10,2425,1222,1203
050,39,089,"Ohio","Licking County",5,11,2340,1219,1121
050,39,089,"Ohio","Licking County",5,12,2368,1215,1153
050,39,089,"Ohio","Licking County",5,13,2381,1223,1158
050,39,089,"Ohio","Licking County",5,14,2436,1258,1178
050,39,089,"Ohio","Licking County",5,15,2544,1318,1226
050,39,089,"Ohio","Licking County",5,16,2545,1304,1241
050,39,089,"Ohio","Licking County",5,17,2541,1300,1241
050,39,089,"Ohio","Licking County",5,18,2434,1222,1212
050,39,089,"Ohio","Licking County",5,19,2361,1192,1169
050,39,089,"Ohio","Licking County",5,20,2409,1241,1168
050,39,089,"Ohio","Licking County",5,21,2440,1260,1180
050,39,089,"Ohio","Licking County",5,22,2326,1188,1138
050,39,089,"Ohio","Licking County",5,23,2044,1044,1000
050,39,089,"Ohio","Licking County",5,24,1949,965,984
050,39,089,"Ohio","Licking County",5,25,1999,1025,974
050,39,089,"Ohio","Licking County",5,26,1975,997,978
050,39,089,"Ohio","Licking County",5,27,2096,1084,1012
050,39,089,"Ohio","Licking County",5,28,2165,1102,1063
050,39,089,"Ohio","Licking County",5,29,2158,1078,1080
050,39,089,"Ohio","Licking County",5,30,2158,1090,1068
050,39,089,"Ohio","Licking County",5,31,2278,1131,1147
050,39,089,"Ohio","Licking County",5,32,2360,1176,1184
050,39,089,"Ohio","Licking County",5,33,2376,1164,1212
050,39,089,"Ohio","Licking County",5,34,2368,1149,1219
050,39,089,"Ohio","Licking County",5,35,2377,1172,1205
050,39,089,"Ohio","Licking County",5,36,2373,1138,1235
050,39,089,"Ohio","Licking County",5,37,2442,1147,1295
050,39,089,"Ohio","Licking County",5,38,2432,1161,1271
050,39,089,"Ohio","Licking County",5,39,2354,1176,1178
050,39,089,"Ohio","Licking County",5,40,2380,1193,1187
050,39,089,"Ohio","Licking County",5,41,2455,1233,1222
050,39,089,"Ohio","Licking County",5,42,2372,1191,1181
050,39,089,"Ohio","Licking County",5,43,2332,1175,1157
050,39,089,"Ohio","Licking County",5,44,2215,1122,1093
050,39,089,"Ohio","Licking County",5,45,2207,1101,1106
050,39,089,"Ohio","Licking County",5,46,2233,1116,1117
050,39,089,"Ohio","Licking County",5,47,2041,1002,1039
050,39,089,"Ohio","Licking County",5,48,2159,1080,1079
050,39,089,"Ohio","Licking County",5,49,2144,1099,1045
050,39,089,"Ohio","Licking County",5,50,2119,1070,1049
050,39,089,"Ohio","Licking County",5,51,2326,1150,1176
050,39,089,"Ohio","Licking County",5,52,2528,1272,1256
050,39,089,"Ohio","Licking County",5,53,2515,1269,1246
050,39,089,"Ohio","Licking County",5,54,2407,1203,1204
050,39,089,"Ohio","Licking County",5,55,2304,1127,1177
050,39,089,"Ohio","Licking County",5,56,2374,1184,1190
050,39,089,"Ohio","Licking County",5,57,2370,1172,1198
050,39,089,"Ohio","Licking County",5,58,2451,1237,1214
050,39,089,"Ohio","Licking County",5,59,2569,1269,1300
050,39,089,"Ohio","Licking County",5,60,2533,1243,1290
050,39,089,"Ohio","Licking County",5,61,2545,1276,1269
050,39,089,"Ohio","Licking County",5,62,2549,1301,1248
050,39,089,"Ohio","Licking County",5,63,2459,1242,1217
050,39,089,"Ohio","Licking County",5,64,2454,1231,1223
050,39,089,"Ohio","Licking County",5,65,2394,1177,1217
050,39,089,"Ohio","Licking County",5,66,2311,1111,1200
050,39,089,"Ohio","Licking County",5,67,2199,1033,1166
050,39,089,"Ohio","Licking County",5,68,2084,970,1114
050,39,089,"Ohio","Licking County",5,69,1980,931,1049
050,39,089,"Ohio","Licking County",5,70,1911,906,1005
050,39,089,"Ohio","Licking County",5,71,1804,833,971
050,39,089,"Ohio","Licking County",5,72,1665,781,884
050,39,089,"Ohio","Licking County",5,73,1602,738,864
050,39,089,"Ohio","Licking County",5,74,1631,730,901
050,39,089,"Ohio","Licking County",5,75,1593,704,889
050,39,089,"Ohio","Licking County",5,76,1700,792,908
050,39,089,"Ohio","Licking County",5,77,1143,516,627
050,39,089,"Ohio","Licking County",5,78,1031,469,562
050,39,089,"Ohio","Licking County",5,79,1054,465,589
050,39,089,"Ohio","Licking County",5,80,1090,469,621
050,39,089,"Ohio","Licking County",5,81,857,365,492
050,39,089,"Ohio","Licking County",5,82,734,319,415
050,39,089,"Ohio","Licking County",5,83,670,274,396
050,39,089,"Ohio","Licking County",5,84,588,242,346
050,39,089,"Ohio","Licking County",5,85,2733,1028,1705
050,39,091,"Ohio","Logan County",1,0,552,283,269
050,39,091,"Ohio","Logan County",1,1,534,274,260
050,39,091,"Ohio","Logan County",1,2,565,305,260
050,39,091,"Ohio","Logan County",1,3,510,265,245
050,39,091,"Ohio","Logan County",1,4,569,289,280
050,39,091,"Ohio","Logan County",1,5,568,282,286
050,39,091,"Ohio","Logan County",1,6,574,293,281
050,39,091,"Ohio","Logan County",1,7,569,305,264
050,39,091,"Ohio","Logan County",1,8,551,280,271
050,39,091,"Ohio","Logan County",1,9,580,314,266
050,39,091,"Ohio","Logan County",1,10,581,310,271
050,39,091,"Ohio","Logan County",1,11,619,307,312
050,39,091,"Ohio","Logan County",1,12,672,344,328
050,39,091,"Ohio","Logan County",1,13,672,343,329
050,39,091,"Ohio","Logan County",1,14,657,322,335
050,39,091,"Ohio","Logan County",1,15,636,320,316
050,39,091,"Ohio","Logan County",1,16,640,310,330
050,39,091,"Ohio","Logan County",1,17,647,334,313
050,39,091,"Ohio","Logan County",1,18,531,283,248
050,39,091,"Ohio","Logan County",1,19,424,228,196
050,39,091,"Ohio","Logan County",1,20,493,269,224
050,39,091,"Ohio","Logan County",1,21,529,299,230
050,39,091,"Ohio","Logan County",1,22,487,244,243
050,39,091,"Ohio","Logan County",1,23,522,271,251
050,39,091,"Ohio","Logan County",1,24,511,250,261
050,39,091,"Ohio","Logan County",1,25,524,270,254
050,39,091,"Ohio","Logan County",1,26,539,276,263
050,39,091,"Ohio","Logan County",1,27,529,271,258
050,39,091,"Ohio","Logan County",1,28,562,296,266
050,39,091,"Ohio","Logan County",1,29,524,253,271
050,39,091,"Ohio","Logan County",1,30,508,267,241
050,39,091,"Ohio","Logan County",1,31,502,247,255
050,39,091,"Ohio","Logan County",1,32,509,254,255
050,39,091,"Ohio","Logan County",1,33,511,252,259
050,39,091,"Ohio","Logan County",1,34,516,264,252
050,39,091,"Ohio","Logan County",1,35,528,264,264
050,39,091,"Ohio","Logan County",1,36,503,234,269
050,39,091,"Ohio","Logan County",1,37,506,228,278
050,39,091,"Ohio","Logan County",1,38,560,272,288
050,39,091,"Ohio","Logan County",1,39,570,288,282
050,39,091,"Ohio","Logan County",1,40,586,286,300
050,39,091,"Ohio","Logan County",1,41,539,268,271
050,39,091,"Ohio","Logan County",1,42,538,280,258
050,39,091,"Ohio","Logan County",1,43,545,271,274
050,39,091,"Ohio","Logan County",1,44,516,255,261
050,39,091,"Ohio","Logan County",1,45,571,279,292
050,39,091,"Ohio","Logan County",1,46,560,281,279
050,39,091,"Ohio","Logan County",1,47,578,294,284
050,39,091,"Ohio","Logan County",1,48,603,311,292
050,39,091,"Ohio","Logan County",1,49,640,348,292
050,39,091,"Ohio","Logan County",1,50,611,317,294
050,39,091,"Ohio","Logan County",1,51,594,296,298
050,39,091,"Ohio","Logan County",1,52,575,284,291
050,39,091,"Ohio","Logan County",1,53,603,287,316
050,39,091,"Ohio","Logan County",1,54,644,316,328
050,39,091,"Ohio","Logan County",1,55,648,336,312
050,39,091,"Ohio","Logan County",1,56,698,352,346
050,39,091,"Ohio","Logan County",1,57,694,349,345
050,39,091,"Ohio","Logan County",1,58,720,374,346
050,39,091,"Ohio","Logan County",1,59,725,370,355
050,39,091,"Ohio","Logan County",1,60,705,358,347
050,39,091,"Ohio","Logan County",1,61,658,341,317
050,39,091,"Ohio","Logan County",1,62,674,343,331
050,39,091,"Ohio","Logan County",1,63,651,337,314
050,39,091,"Ohio","Logan County",1,64,663,336,327
050,39,091,"Ohio","Logan County",1,65,679,331,348
050,39,091,"Ohio","Logan County",1,66,640,310,330
050,39,091,"Ohio","Logan County",1,67,631,322,309
050,39,091,"Ohio","Logan County",1,68,585,299,286
050,39,091,"Ohio","Logan County",1,69,517,253,264
050,39,091,"Ohio","Logan County",1,70,492,231,261
050,39,091,"Ohio","Logan County",1,71,486,221,265
050,39,091,"Ohio","Logan County",1,72,449,198,251
050,39,091,"Ohio","Logan County",1,73,482,225,257
050,39,091,"Ohio","Logan County",1,74,330,161,169
050,39,091,"Ohio","Logan County",1,75,322,152,170
050,39,091,"Ohio","Logan County",1,76,322,158,164
050,39,091,"Ohio","Logan County",1,77,328,148,180
050,39,091,"Ohio","Logan County",1,78,271,122,149
050,39,091,"Ohio","Logan County",1,79,249,98,151
050,39,091,"Ohio","Logan County",1,80,213,93,120
050,39,091,"Ohio","Logan County",1,81,203,91,112
050,39,091,"Ohio","Logan County",1,82,184,84,100
050,39,091,"Ohio","Logan County",1,83,157,67,90
050,39,091,"Ohio","Logan County",1,84,159,67,92
050,39,091,"Ohio","Logan County",1,85,831,312,519
050,39,091,"Ohio","Logan County",2,0,555,285,270
050,39,091,"Ohio","Logan County",2,1,532,273,259
050,39,091,"Ohio","Logan County",2,2,554,295,259
050,39,091,"Ohio","Logan County",2,3,519,273,246
050,39,091,"Ohio","Logan County",2,4,549,281,268
050,39,091,"Ohio","Logan County",2,5,568,282,286
050,39,091,"Ohio","Logan County",2,6,570,289,281
050,39,091,"Ohio","Logan County",2,7,566,298,268
050,39,091,"Ohio","Logan County",2,8,555,285,270
050,39,091,"Ohio","Logan County",2,9,570,304,266
050,39,091,"Ohio","Logan County",2,10,579,308,271
050,39,091,"Ohio","Logan County",2,11,606,306,300
050,39,091,"Ohio","Logan County",2,12,663,336,327
050,39,091,"Ohio","Logan County",2,13,670,342,328
050,39,091,"Ohio","Logan County",2,14,661,328,333
050,39,091,"Ohio","Logan County",2,15,643,320,323
050,39,091,"Ohio","Logan County",2,16,639,312,327
050,39,091,"Ohio","Logan County",2,17,647,328,319
050,39,091,"Ohio","Logan County",2,18,529,282,247
050,39,091,"Ohio","Logan County",2,19,427,229,198
050,39,091,"Ohio","Logan County",2,20,493,268,225
050,39,091,"Ohio","Logan County",2,21,522,290,232
050,39,091,"Ohio","Logan County",2,22,500,260,240
050,39,091,"Ohio","Logan County",2,23,518,266,252
050,39,091,"Ohio","Logan County",2,24,512,256,256
050,39,091,"Ohio","Logan County",2,25,522,267,255
050,39,091,"Ohio","Logan County",2,26,534,273,261
050,39,091,"Ohio","Logan County",2,27,530,271,259
050,39,091,"Ohio","Logan County",2,28,553,287,266
050,39,091,"Ohio","Logan County",2,29,536,266,270
050,39,091,"Ohio","Logan County",2,30,515,265,250
050,39,091,"Ohio","Logan County",2,31,501,252,249
050,39,091,"Ohio","Logan County",2,32,507,250,257
050,39,091,"Ohio","Logan County",2,33,508,252,256
050,39,091,"Ohio","Logan County",2,34,514,263,251
050,39,091,"Ohio","Logan County",2,35,528,266,262
050,39,091,"Ohio","Logan County",2,36,501,237,264
050,39,091,"Ohio","Logan County",2,37,503,229,274
050,39,091,"Ohio","Logan County",2,38,548,262,286
050,39,091,"Ohio","Logan County",2,39,568,285,283
050,39,091,"Ohio","Logan County",2,40,584,285,299
050,39,091,"Ohio","Logan County",2,41,548,271,277
050,39,091,"Ohio","Logan County",2,42,537,277,260
050,39,091,"Ohio","Logan County",2,43,547,275,272
050,39,091,"Ohio","Logan County",2,44,522,258,264
050,39,091,"Ohio","Logan County",2,45,561,273,288
050,39,091,"Ohio","Logan County",2,46,557,275,282
050,39,091,"Ohio","Logan County",2,47,571,290,281
050,39,091,"Ohio","Logan County",2,48,597,309,288
050,39,091,"Ohio","Logan County",2,49,638,344,294
050,39,091,"Ohio","Logan County",2,50,624,329,295
050,39,091,"Ohio","Logan County",2,51,593,299,294
050,39,091,"Ohio","Logan County",2,52,579,286,293
050,39,091,"Ohio","Logan County",2,53,599,286,313
050,39,091,"Ohio","Logan County",2,54,630,308,322
050,39,091,"Ohio","Logan County",2,55,646,330,316
050,39,091,"Ohio","Logan County",2,56,689,349,340
050,39,091,"Ohio","Logan County",2,57,696,350,346
050,39,091,"Ohio","Logan County",2,58,713,367,346
050,39,091,"Ohio","Logan County",2,59,725,374,351
050,39,091,"Ohio","Logan County",2,60,702,356,346
050,39,091,"Ohio","Logan County",2,61,666,343,323
050,39,091,"Ohio","Logan County",2,62,672,344,328
050,39,091,"Ohio","Logan County",2,63,665,343,322
050,39,091,"Ohio","Logan County",2,64,652,331,321
050,39,091,"Ohio","Logan County",2,65,675,331,344
050,39,091,"Ohio","Logan County",2,66,649,315,334
050,39,091,"Ohio","Logan County",2,67,631,318,313
050,39,091,"Ohio","Logan County",2,68,589,300,289
050,39,091,"Ohio","Logan County",2,69,536,264,272
050,39,091,"Ohio","Logan County",2,70,493,233,260
050,39,091,"Ohio","Logan County",2,71,487,222,265
050,39,091,"Ohio","Logan County",2,72,447,198,249
050,39,091,"Ohio","Logan County",2,73,495,227,268
050,39,091,"Ohio","Logan County",2,74,342,164,178
050,39,091,"Ohio","Logan County",2,75,323,152,171
050,39,091,"Ohio","Logan County",2,76,317,154,163
050,39,091,"Ohio","Logan County",2,77,334,154,180
050,39,091,"Ohio","Logan County",2,78,278,124,154
050,39,091,"Ohio","Logan County",2,79,248,100,148
050,39,091,"Ohio","Logan County",2,80,218,93,125
050,39,091,"Ohio","Logan County",2,81,206,92,114
050,39,091,"Ohio","Logan County",2,82,178,79,99
050,39,091,"Ohio","Logan County",2,83,155,66,89
050,39,091,"Ohio","Logan County",2,84,156,66,90
050,39,091,"Ohio","Logan County",2,85,831,306,525
050,39,091,"Ohio","Logan County",3,0,500,256,244
050,39,091,"Ohio","Logan County",3,1,561,289,272
050,39,091,"Ohio","Logan County",3,2,546,276,270
050,39,091,"Ohio","Logan County",3,3,563,295,268
050,39,091,"Ohio","Logan County",3,4,528,279,249
050,39,091,"Ohio","Logan County",3,5,564,284,280
050,39,091,"Ohio","Logan County",3,6,586,280,306
050,39,091,"Ohio","Logan County",3,7,573,295,278
050,39,091,"Ohio","Logan County",3,8,564,301,263
050,39,091,"Ohio","Logan County",3,9,555,287,268
050,39,091,"Ohio","Logan County",3,10,576,314,262
050,39,091,"Ohio","Logan County",3,11,571,301,270
050,39,091,"Ohio","Logan County",3,12,619,312,307
050,39,091,"Ohio","Logan County",3,13,672,339,333
050,39,091,"Ohio","Logan County",3,14,667,344,323
050,39,091,"Ohio","Logan County",3,15,663,332,331
050,39,091,"Ohio","Logan County",3,16,643,320,323
050,39,091,"Ohio","Logan County",3,17,633,317,316
050,39,091,"Ohio","Logan County",3,18,549,285,264
050,39,091,"Ohio","Logan County",3,19,423,220,203
050,39,091,"Ohio","Logan County",3,20,471,257,214
050,39,091,"Ohio","Logan County",3,21,499,263,236
050,39,091,"Ohio","Logan County",3,22,536,287,249
050,39,091,"Ohio","Logan County",3,23,515,263,252
050,39,091,"Ohio","Logan County",3,24,502,259,243
050,39,091,"Ohio","Logan County",3,25,505,257,248
050,39,091,"Ohio","Logan County",3,26,533,287,246
050,39,091,"Ohio","Logan County",3,27,541,278,263
050,39,091,"Ohio","Logan County",3,28,532,276,256
050,39,091,"Ohio","Logan County",3,29,563,287,276
050,39,091,"Ohio","Logan County",3,30,543,270,273
050,39,091,"Ohio","Logan County",3,31,528,276,252
050,39,091,"Ohio","Logan County",3,32,513,262,251
050,39,091,"Ohio","Logan County",3,33,505,243,262
050,39,091,"Ohio","Logan County",3,34,498,246,252
050,39,091,"Ohio","Logan County",3,35,516,254,262
050,39,091,"Ohio","Logan County",3,36,521,261,260
050,39,091,"Ohio","Logan County",3,37,499,237,262
050,39,091,"Ohio","Logan County",3,38,500,225,275
050,39,091,"Ohio","Logan County",3,39,564,271,293
050,39,091,"Ohio","Logan County",3,40,568,282,286
050,39,091,"Ohio","Logan County",3,41,590,283,307
050,39,091,"Ohio","Logan County",3,42,553,271,282
050,39,091,"Ohio","Logan County",3,43,531,268,263
050,39,091,"Ohio","Logan County",3,44,544,271,273
050,39,091,"Ohio","Logan County",3,45,539,270,269
050,39,091,"Ohio","Logan County",3,46,553,266,287
050,39,091,"Ohio","Logan County",3,47,547,269,278
050,39,091,"Ohio","Logan County",3,48,554,287,267
050,39,091,"Ohio","Logan County",3,49,589,302,287
050,39,091,"Ohio","Logan County",3,50,675,373,302
050,39,091,"Ohio","Logan County",3,51,627,330,297
050,39,091,"Ohio","Logan County",3,52,604,308,296
050,39,091,"Ohio","Logan County",3,53,581,286,295
050,39,091,"Ohio","Logan County",3,54,588,285,303
050,39,091,"Ohio","Logan County",3,55,637,307,330
050,39,091,"Ohio","Logan County",3,56,641,326,315
050,39,091,"Ohio","Logan County",3,57,691,350,341
050,39,091,"Ohio","Logan County",3,58,701,351,350
050,39,091,"Ohio","Logan County",3,59,719,368,351
050,39,091,"Ohio","Logan County",3,60,727,374,353
050,39,091,"Ohio","Logan County",3,61,698,347,351
050,39,091,"Ohio","Logan County",3,62,677,345,332
050,39,091,"Ohio","Logan County",3,63,666,341,325
050,39,091,"Ohio","Logan County",3,64,662,343,319
050,39,091,"Ohio","Logan County",3,65,639,317,322
050,39,091,"Ohio","Logan County",3,66,670,327,343
050,39,091,"Ohio","Logan County",3,67,643,313,330
050,39,091,"Ohio","Logan County",3,68,605,302,303
050,39,091,"Ohio","Logan County",3,69,573,293,280
050,39,091,"Ohio","Logan County",3,70,529,263,266
050,39,091,"Ohio","Logan County",3,71,472,225,247
050,39,091,"Ohio","Logan County",3,72,464,209,255
050,39,091,"Ohio","Logan County",3,73,419,185,234
050,39,091,"Ohio","Logan County",3,74,485,217,268
050,39,091,"Ohio","Logan County",3,75,319,154,165
050,39,091,"Ohio","Logan County",3,76,303,142,161
050,39,091,"Ohio","Logan County",3,77,313,152,161
050,39,091,"Ohio","Logan County",3,78,318,146,172
050,39,091,"Ohio","Logan County",3,79,271,120,151
050,39,091,"Ohio","Logan County",3,80,221,93,128
050,39,091,"Ohio","Logan County",3,81,209,90,119
050,39,091,"Ohio","Logan County",3,82,188,79,109
050,39,091,"Ohio","Logan County",3,83,153,68,85
050,39,091,"Ohio","Logan County",3,84,141,61,80
050,39,091,"Ohio","Logan County",3,85,821,312,509
050,39,091,"Ohio","Logan County",4,0,515,279,236
050,39,091,"Ohio","Logan County",4,1,499,239,260
050,39,091,"Ohio","Logan County",4,2,563,282,281
050,39,091,"Ohio","Logan County",4,3,557,280,277
050,39,091,"Ohio","Logan County",4,4,565,301,264
050,39,091,"Ohio","Logan County",4,5,532,283,249
050,39,091,"Ohio","Logan County",4,6,568,288,280
050,39,091,"Ohio","Logan County",4,7,585,286,299
050,39,091,"Ohio","Logan County",4,8,571,295,276
050,39,091,"Ohio","Logan County",4,9,559,296,263
050,39,091,"Ohio","Logan County",4,10,548,283,265
050,39,091,"Ohio","Logan County",4,11,574,313,261
050,39,091,"Ohio","Logan County",4,12,585,311,274
050,39,091,"Ohio","Logan County",4,13,606,311,295
050,39,091,"Ohio","Logan County",4,14,680,342,338
050,39,091,"Ohio","Logan County",4,15,680,352,328
050,39,091,"Ohio","Logan County",4,16,668,340,328
050,39,091,"Ohio","Logan County",4,17,634,315,319
050,39,091,"Ohio","Logan County",4,18,528,273,255
050,39,091,"Ohio","Logan County",4,19,415,216,199
050,39,091,"Ohio","Logan County",4,20,445,237,208
050,39,091,"Ohio","Logan County",4,21,488,259,229
050,39,091,"Ohio","Logan County",4,22,488,257,231
050,39,091,"Ohio","Logan County",4,23,547,296,251
050,39,091,"Ohio","Logan County",4,24,520,266,254
050,39,091,"Ohio","Logan County",4,25,491,253,238
050,39,091,"Ohio","Logan County",4,26,547,270,277
050,39,091,"Ohio","Logan County",4,27,524,285,239
050,39,091,"Ohio","Logan County",4,28,544,276,268
050,39,091,"Ohio","Logan County",4,29,561,296,265
050,39,091,"Ohio","Logan County",4,30,588,297,291
050,39,091,"Ohio","Logan County",4,31,532,267,265
050,39,091,"Ohio","Logan County",4,32,528,274,254
050,39,091,"Ohio","Logan County",4,33,514,260,254
050,39,091,"Ohio","Logan County",4,34,493,237,256
050,39,091,"Ohio","Logan County",4,35,502,244,258
050,39,091,"Ohio","Logan County",4,36,517,254,263
050,39,091,"Ohio","Logan County",4,37,520,261,259
050,39,091,"Ohio","Logan County",4,38,513,239,274
050,39,091,"Ohio","Logan County",4,39,506,231,275
050,39,091,"Ohio","Logan County",4,40,555,259,296
050,39,091,"Ohio","Logan County",4,41,568,280,288
050,39,091,"Ohio","Logan County",4,42,593,289,304
050,39,091,"Ohio","Logan County",4,43,553,277,276
050,39,091,"Ohio","Logan County",4,44,533,267,266
050,39,091,"Ohio","Logan County",4,45,547,270,277
050,39,091,"Ohio","Logan County",4,46,528,262,266
050,39,091,"Ohio","Logan County",4,47,544,264,280
050,39,091,"Ohio","Logan County",4,48,548,271,277
050,39,091,"Ohio","Logan County",4,49,548,279,269
050,39,091,"Ohio","Logan County",4,50,605,313,292
050,39,091,"Ohio","Logan County",4,51,666,364,302
050,39,091,"Ohio","Logan County",4,52,619,321,298
050,39,091,"Ohio","Logan County",4,53,607,313,294
050,39,091,"Ohio","Logan County",4,54,580,286,294
050,39,091,"Ohio","Logan County",4,55,593,283,310
050,39,091,"Ohio","Logan County",4,56,624,305,319
050,39,091,"Ohio","Logan County",4,57,637,323,314
050,39,091,"Ohio","Logan County",4,58,708,358,350
050,39,091,"Ohio","Logan County",4,59,716,361,355
050,39,091,"Ohio","Logan County",4,60,715,363,352
050,39,091,"Ohio","Logan County",4,61,707,363,344
050,39,091,"Ohio","Logan County",4,62,696,355,341
050,39,091,"Ohio","Logan County",4,63,670,342,328
050,39,091,"Ohio","Logan County",4,64,654,330,324
050,39,091,"Ohio","Logan County",4,65,638,336,302
050,39,091,"Ohio","Logan County",4,66,630,321,309
050,39,091,"Ohio","Logan County",4,67,661,322,339
050,39,091,"Ohio","Logan County",4,68,622,303,319
050,39,091,"Ohio","Logan County",4,69,600,296,304
050,39,091,"Ohio","Logan County",4,70,560,285,275
050,39,091,"Ohio","Logan County",4,71,516,257,259
050,39,091,"Ohio","Logan County",4,72,457,215,242
050,39,091,"Ohio","Logan County",4,73,443,198,245
050,39,091,"Ohio","Logan County",4,74,400,171,229
050,39,091,"Ohio","Logan County",4,75,459,206,253
050,39,091,"Ohio","Logan County",4,76,297,141,156
050,39,091,"Ohio","Logan County",4,77,298,135,163
050,39,091,"Ohio","Logan County",4,78,301,142,159
050,39,091,"Ohio","Logan County",4,79,310,134,176
050,39,091,"Ohio","Logan County",4,80,240,107,133
050,39,091,"Ohio","Logan County",4,81,209,86,123
050,39,091,"Ohio","Logan County",4,82,197,84,113
050,39,091,"Ohio","Logan County",4,83,177,73,104
050,39,091,"Ohio","Logan County",4,84,149,70,79
050,39,091,"Ohio","Logan County",4,85,784,301,483
050,39,091,"Ohio","Logan County",5,0,523,285,238
050,39,091,"Ohio","Logan County",5,1,542,291,251
050,39,091,"Ohio","Logan County",5,2,526,252,274
050,39,091,"Ohio","Logan County",5,3,555,286,269
050,39,091,"Ohio","Logan County",5,4,570,282,288
050,39,091,"Ohio","Logan County",5,5,556,302,254
050,39,091,"Ohio","Logan County",5,6,544,288,256
050,39,091,"Ohio","Logan County",5,7,571,292,279
050,39,091,"Ohio","Logan County",5,8,605,301,304
050,39,091,"Ohio","Logan County",5,9,587,311,276
050,39,091,"Ohio","Logan County",5,10,560,294,266
050,39,091,"Ohio","Logan County",5,11,541,284,257
050,39,091,"Ohio","Logan County",5,12,577,322,255
050,39,091,"Ohio","Logan County",5,13,588,310,278
050,39,091,"Ohio","Logan County",5,14,607,320,287
050,39,091,"Ohio","Logan County",5,15,683,342,341
050,39,091,"Ohio","Logan County",5,16,672,356,316
050,39,091,"Ohio","Logan County",5,17,662,336,326
050,39,091,"Ohio","Logan County",5,18,526,264,262
050,39,091,"Ohio","Logan County",5,19,405,215,190
050,39,091,"Ohio","Logan County",5,20,454,244,210
050,39,091,"Ohio","Logan County",5,21,459,243,216
050,39,091,"Ohio","Logan County",5,22,493,261,232
050,39,091,"Ohio","Logan County",5,23,482,250,232
050,39,091,"Ohio","Logan County",5,24,521,278,243
050,39,091,"Ohio","Logan County",5,25,501,263,238
050,39,091,"Ohio","Logan County",5,26,502,260,242
050,39,091,"Ohio","Logan County",5,27,557,278,279
050,39,091,"Ohio","Logan County",5,28,516,278,238
050,39,091,"Ohio","Logan County",5,29,554,293,261
050,39,091,"Ohio","Logan County",5,30,566,297,269
050,39,091,"Ohio","Logan County",5,31,583,296,287
050,39,091,"Ohio","Logan County",5,32,540,271,269
050,39,091,"Ohio","Logan County",5,33,544,280,264
050,39,091,"Ohio","Logan County",5,34,525,258,267
050,39,091,"Ohio","Logan County",5,35,503,243,260
050,39,091,"Ohio","Logan County",5,36,511,258,253
050,39,091,"Ohio","Logan County",5,37,504,241,263
050,39,091,"Ohio","Logan County",5,38,532,259,273
050,39,091,"Ohio","Logan County",5,39,520,248,272
050,39,091,"Ohio","Logan County",5,40,502,230,272
050,39,091,"Ohio","Logan County",5,41,541,252,289
050,39,091,"Ohio","Logan County",5,42,568,279,289
050,39,091,"Ohio","Logan County",5,43,605,298,307
050,39,091,"Ohio","Logan County",5,44,565,286,279
050,39,091,"Ohio","Logan County",5,45,532,261,271
050,39,091,"Ohio","Logan County",5,46,542,267,275
050,39,091,"Ohio","Logan County",5,47,526,265,261
050,39,091,"Ohio","Logan County",5,48,550,267,283
050,39,091,"Ohio","Logan County",5,49,551,275,276
050,39,091,"Ohio","Logan County",5,50,553,284,269
050,39,091,"Ohio","Logan County",5,51,593,310,283
050,39,091,"Ohio","Logan County",5,52,664,361,303
050,39,091,"Ohio","Logan County",5,53,616,321,295
050,39,091,"Ohio","Logan County",5,54,612,319,293
050,39,091,"Ohio","Logan County",5,55,584,284,300
050,39,091,"Ohio","Logan County",5,56,593,280,313
050,39,091,"Ohio","Logan County",5,57,632,307,325
050,39,091,"Ohio","Logan County",5,58,634,313,321
050,39,091,"Ohio","Logan County",5,59,716,365,351
050,39,091,"Ohio","Logan County",5,60,700,352,348
050,39,091,"Ohio","Logan County",5,61,701,353,348
050,39,091,"Ohio","Logan County",5,62,713,371,342
050,39,091,"Ohio","Logan County",5,63,687,351,336
050,39,091,"Ohio","Logan County",5,64,682,341,341
050,39,091,"Ohio","Logan County",5,65,638,317,321
050,39,091,"Ohio","Logan County",5,66,624,330,294
050,39,091,"Ohio","Logan County",5,67,610,310,300
050,39,091,"Ohio","Logan County",5,68,640,312,328
050,39,091,"Ohio","Logan County",5,69,605,292,313
050,39,091,"Ohio","Logan County",5,70,593,292,301
050,39,091,"Ohio","Logan County",5,71,543,272,271
050,39,091,"Ohio","Logan County",5,72,499,249,250
050,39,091,"Ohio","Logan County",5,73,444,207,237
050,39,091,"Ohio","Logan County",5,74,429,187,242
050,39,091,"Ohio","Logan County",5,75,382,165,217
050,39,091,"Ohio","Logan County",5,76,419,182,237
050,39,091,"Ohio","Logan County",5,77,292,137,155
050,39,091,"Ohio","Logan County",5,78,285,129,156
050,39,091,"Ohio","Logan County",5,79,288,128,160
050,39,091,"Ohio","Logan County",5,80,284,124,160
050,39,091,"Ohio","Logan County",5,81,230,100,130
050,39,091,"Ohio","Logan County",5,82,200,81,119
050,39,091,"Ohio","Logan County",5,83,182,76,106
050,39,091,"Ohio","Logan County",5,84,168,73,95
050,39,091,"Ohio","Logan County",5,85,773,304,469
050,39,093,"Ohio","Lorain County",1,0,3143,1610,1533
050,39,093,"Ohio","Lorain County",1,1,3270,1705,1565
050,39,093,"Ohio","Lorain County",1,2,3433,1750,1683
050,39,093,"Ohio","Lorain County",1,3,3534,1795,1739
050,39,093,"Ohio","Lorain County",1,4,3676,1866,1810
050,39,093,"Ohio","Lorain County",1,5,3762,1950,1812
050,39,093,"Ohio","Lorain County",1,6,3734,1881,1853
050,39,093,"Ohio","Lorain County",1,7,3741,1904,1837
050,39,093,"Ohio","Lorain County",1,8,3808,1988,1820
050,39,093,"Ohio","Lorain County",1,9,3878,2013,1865
050,39,093,"Ohio","Lorain County",1,10,3897,2053,1844
050,39,093,"Ohio","Lorain County",1,11,4044,2042,2002
050,39,093,"Ohio","Lorain County",1,12,4135,2137,1998
050,39,093,"Ohio","Lorain County",1,13,4037,2114,1923
050,39,093,"Ohio","Lorain County",1,14,4068,2088,1980
050,39,093,"Ohio","Lorain County",1,15,4056,2097,1959
050,39,093,"Ohio","Lorain County",1,16,4152,2123,2029
050,39,093,"Ohio","Lorain County",1,17,4114,2094,2020
050,39,093,"Ohio","Lorain County",1,18,4087,2116,1971
050,39,093,"Ohio","Lorain County",1,19,3887,2023,1864
050,39,093,"Ohio","Lorain County",1,20,3966,2091,1875
050,39,093,"Ohio","Lorain County",1,21,3816,1970,1846
050,39,093,"Ohio","Lorain County",1,22,3634,1877,1757
050,39,093,"Ohio","Lorain County",1,23,3484,1821,1663
050,39,093,"Ohio","Lorain County",1,24,3514,1810,1704
050,39,093,"Ohio","Lorain County",1,25,3567,1854,1713
050,39,093,"Ohio","Lorain County",1,26,3470,1813,1657
050,39,093,"Ohio","Lorain County",1,27,3519,1796,1723
050,39,093,"Ohio","Lorain County",1,28,3545,1772,1773
050,39,093,"Ohio","Lorain County",1,29,3574,1819,1755
050,39,093,"Ohio","Lorain County",1,30,3668,1871,1797
050,39,093,"Ohio","Lorain County",1,31,3582,1829,1753
050,39,093,"Ohio","Lorain County",1,32,3518,1792,1726
050,39,093,"Ohio","Lorain County",1,33,3531,1823,1708
050,39,093,"Ohio","Lorain County",1,34,3657,1848,1809
050,39,093,"Ohio","Lorain County",1,35,3601,1784,1817
050,39,093,"Ohio","Lorain County",1,36,3679,1854,1825
050,39,093,"Ohio","Lorain County",1,37,3835,1911,1924
050,39,093,"Ohio","Lorain County",1,38,3820,1875,1945
050,39,093,"Ohio","Lorain County",1,39,3974,1985,1989
050,39,093,"Ohio","Lorain County",1,40,3882,1976,1906
050,39,093,"Ohio","Lorain County",1,41,3840,1928,1912
050,39,093,"Ohio","Lorain County",1,42,3850,1932,1918
050,39,093,"Ohio","Lorain County",1,43,3740,1878,1862
050,39,093,"Ohio","Lorain County",1,44,3687,1860,1827
050,39,093,"Ohio","Lorain County",1,45,3763,1864,1899
050,39,093,"Ohio","Lorain County",1,46,3776,1912,1864
050,39,093,"Ohio","Lorain County",1,47,3887,1962,1925
050,39,093,"Ohio","Lorain County",1,48,4205,2122,2083
050,39,093,"Ohio","Lorain County",1,49,4396,2252,2144
050,39,093,"Ohio","Lorain County",1,50,4222,2113,2109
050,39,093,"Ohio","Lorain County",1,51,4209,2142,2067
050,39,093,"Ohio","Lorain County",1,52,4105,2105,2000
050,39,093,"Ohio","Lorain County",1,53,4142,2105,2037
050,39,093,"Ohio","Lorain County",1,54,4182,2112,2070
050,39,093,"Ohio","Lorain County",1,55,4348,2191,2157
050,39,093,"Ohio","Lorain County",1,56,4507,2207,2300
050,39,093,"Ohio","Lorain County",1,57,4545,2207,2338
050,39,093,"Ohio","Lorain County",1,58,4614,2270,2344
050,39,093,"Ohio","Lorain County",1,59,4599,2249,2350
050,39,093,"Ohio","Lorain County",1,60,4529,2255,2274
050,39,093,"Ohio","Lorain County",1,61,4524,2205,2319
050,39,093,"Ohio","Lorain County",1,62,4615,2219,2396
050,39,093,"Ohio","Lorain County",1,63,4513,2183,2330
050,39,093,"Ohio","Lorain County",1,64,4266,2069,2197
050,39,093,"Ohio","Lorain County",1,65,4122,1979,2143
050,39,093,"Ohio","Lorain County",1,66,3960,1888,2072
050,39,093,"Ohio","Lorain County",1,67,3956,1925,2031
050,39,093,"Ohio","Lorain County",1,68,3839,1840,1999
050,39,093,"Ohio","Lorain County",1,69,3515,1670,1845
050,39,093,"Ohio","Lorain County",1,70,3447,1606,1841
050,39,093,"Ohio","Lorain County",1,71,3348,1535,1813
050,39,093,"Ohio","Lorain County",1,72,3418,1592,1826
050,39,093,"Ohio","Lorain County",1,73,3412,1604,1808
050,39,093,"Ohio","Lorain County",1,74,2273,1067,1206
050,39,093,"Ohio","Lorain County",1,75,2176,1006,1170
050,39,093,"Ohio","Lorain County",1,76,2137,967,1170
050,39,093,"Ohio","Lorain County",1,77,2215,1007,1208
050,39,093,"Ohio","Lorain County",1,78,1872,831,1041
050,39,093,"Ohio","Lorain County",1,79,1632,712,920
050,39,093,"Ohio","Lorain County",1,80,1525,629,896
050,39,093,"Ohio","Lorain County",1,81,1524,636,888
050,39,093,"Ohio","Lorain County",1,82,1380,574,806
050,39,093,"Ohio","Lorain County",1,83,1204,479,725
050,39,093,"Ohio","Lorain County",1,84,1110,445,665
050,39,093,"Ohio","Lorain County",1,85,6535,2308,4227
050,39,093,"Ohio","Lorain County",2,0,3197,1646,1551
050,39,093,"Ohio","Lorain County",2,1,3263,1689,1574
050,39,093,"Ohio","Lorain County",2,2,3427,1751,1676
050,39,093,"Ohio","Lorain County",2,3,3519,1788,1731
050,39,093,"Ohio","Lorain County",2,4,3667,1862,1805
050,39,093,"Ohio","Lorain County",2,5,3752,1936,1816
050,39,093,"Ohio","Lorain County",2,6,3761,1911,1850
050,39,093,"Ohio","Lorain County",2,7,3745,1903,1842
050,39,093,"Ohio","Lorain County",2,8,3786,1969,1817
050,39,093,"Ohio","Lorain County",2,9,3869,2013,1856
050,39,093,"Ohio","Lorain County",2,10,3894,2037,1857
050,39,093,"Ohio","Lorain County",2,11,4002,2044,1958
050,39,093,"Ohio","Lorain County",2,12,4134,2129,2005
050,39,093,"Ohio","Lorain County",2,13,4058,2118,1940
050,39,093,"Ohio","Lorain County",2,14,4058,2097,1961
050,39,093,"Ohio","Lorain County",2,15,4066,2098,1968
050,39,093,"Ohio","Lorain County",2,16,4137,2118,2019
050,39,093,"Ohio","Lorain County",2,17,4129,2100,2029
050,39,093,"Ohio","Lorain County",2,18,4027,2089,1938
050,39,093,"Ohio","Lorain County",2,19,3895,2017,1878
050,39,093,"Ohio","Lorain County",2,20,4005,2119,1886
050,39,093,"Ohio","Lorain County",2,21,3814,1975,1839
050,39,093,"Ohio","Lorain County",2,22,3621,1870,1751
050,39,093,"Ohio","Lorain County",2,23,3510,1832,1678
050,39,093,"Ohio","Lorain County",2,24,3505,1818,1687
050,39,093,"Ohio","Lorain County",2,25,3559,1848,1711
050,39,093,"Ohio","Lorain County",2,26,3505,1833,1672
050,39,093,"Ohio","Lorain County",2,27,3516,1806,1710
050,39,093,"Ohio","Lorain County",2,28,3562,1793,1769
050,39,093,"Ohio","Lorain County",2,29,3603,1821,1782
050,39,093,"Ohio","Lorain County",2,30,3692,1879,1813
050,39,093,"Ohio","Lorain County",2,31,3624,1849,1775
050,39,093,"Ohio","Lorain County",2,32,3537,1797,1740
050,39,093,"Ohio","Lorain County",2,33,3547,1831,1716
050,39,093,"Ohio","Lorain County",2,34,3638,1849,1789
050,39,093,"Ohio","Lorain County",2,35,3660,1821,1839
050,39,093,"Ohio","Lorain County",2,36,3656,1834,1822
050,39,093,"Ohio","Lorain County",2,37,3821,1911,1910
050,39,093,"Ohio","Lorain County",2,38,3856,1906,1950
050,39,093,"Ohio","Lorain County",2,39,3931,1953,1978
050,39,093,"Ohio","Lorain County",2,40,3940,1993,1947
050,39,093,"Ohio","Lorain County",2,41,3858,1940,1918
050,39,093,"Ohio","Lorain County",2,42,3838,1927,1911
050,39,093,"Ohio","Lorain County",2,43,3783,1897,1886
050,39,093,"Ohio","Lorain County",2,44,3666,1850,1816
050,39,093,"Ohio","Lorain County",2,45,3769,1878,1891
050,39,093,"Ohio","Lorain County",2,46,3763,1900,1863
050,39,093,"Ohio","Lorain County",2,47,3848,1939,1909
050,39,093,"Ohio","Lorain County",2,48,4126,2084,2042
050,39,093,"Ohio","Lorain County",2,49,4374,2235,2139
050,39,093,"Ohio","Lorain County",2,50,4276,2144,2132
050,39,093,"Ohio","Lorain County",2,51,4207,2134,2073
050,39,093,"Ohio","Lorain County",2,52,4118,2107,2011
050,39,093,"Ohio","Lorain County",2,53,4133,2104,2029
050,39,093,"Ohio","Lorain County",2,54,4159,2110,2049
050,39,093,"Ohio","Lorain County",2,55,4304,2168,2136
050,39,093,"Ohio","Lorain County",2,56,4486,2212,2274
050,39,093,"Ohio","Lorain County",2,57,4550,2219,2331
050,39,093,"Ohio","Lorain County",2,58,4590,2248,2342
050,39,093,"Ohio","Lorain County",2,59,4613,2259,2354
050,39,093,"Ohio","Lorain County",2,60,4527,2241,2286
050,39,093,"Ohio","Lorain County",2,61,4518,2212,2306
050,39,093,"Ohio","Lorain County",2,62,4577,2206,2371
050,39,093,"Ohio","Lorain County",2,63,4562,2202,2360
050,39,093,"Ohio","Lorain County",2,64,4297,2079,2218
050,39,093,"Ohio","Lorain County",2,65,4160,1999,2161
050,39,093,"Ohio","Lorain County",2,66,4000,1910,2090
050,39,093,"Ohio","Lorain County",2,67,3943,1906,2037
050,39,093,"Ohio","Lorain County",2,68,3825,1838,1987
050,39,093,"Ohio","Lorain County",2,69,3610,1720,1890
050,39,093,"Ohio","Lorain County",2,70,3449,1615,1834
050,39,093,"Ohio","Lorain County",2,71,3366,1546,1820
050,39,093,"Ohio","Lorain County",2,72,3333,1550,1783
050,39,093,"Ohio","Lorain County",2,73,3571,1671,1900
050,39,093,"Ohio","Lorain County",2,74,2395,1125,1270
050,39,093,"Ohio","Lorain County",2,75,2199,1018,1181
050,39,093,"Ohio","Lorain County",2,76,2112,964,1148
050,39,093,"Ohio","Lorain County",2,77,2224,1010,1214
050,39,093,"Ohio","Lorain County",2,78,1915,855,1060
050,39,093,"Ohio","Lorain County",2,79,1657,726,931
050,39,093,"Ohio","Lorain County",2,80,1529,639,890
050,39,093,"Ohio","Lorain County",2,81,1503,619,884
050,39,093,"Ohio","Lorain County",2,82,1406,579,827
050,39,093,"Ohio","Lorain County",2,83,1227,495,732
050,39,093,"Ohio","Lorain County",2,84,1111,443,668
050,39,093,"Ohio","Lorain County",2,85,6533,2306,4227
050,39,093,"Ohio","Lorain County",3,0,3167,1634,1533
050,39,093,"Ohio","Lorain County",3,1,3353,1715,1638
050,39,093,"Ohio","Lorain County",3,2,3417,1763,1654
050,39,093,"Ohio","Lorain County",3,3,3527,1798,1729
050,39,093,"Ohio","Lorain County",3,4,3643,1862,1781
050,39,093,"Ohio","Lorain County",3,5,3765,1933,1832
050,39,093,"Ohio","Lorain County",3,6,3817,1980,1837
050,39,093,"Ohio","Lorain County",3,7,3785,1923,1862
050,39,093,"Ohio","Lorain County",3,8,3778,1914,1864
050,39,093,"Ohio","Lorain County",3,9,3835,2002,1833
050,39,093,"Ohio","Lorain County",3,10,3921,2031,1890
050,39,093,"Ohio","Lorain County",3,11,3910,2052,1858
050,39,093,"Ohio","Lorain County",3,12,4043,2089,1954
050,39,093,"Ohio","Lorain County",3,13,4144,2141,2003
050,39,093,"Ohio","Lorain County",3,14,4105,2139,1966
050,39,093,"Ohio","Lorain County",3,15,4108,2137,1971
050,39,093,"Ohio","Lorain County",3,16,4069,2109,1960
050,39,093,"Ohio","Lorain County",3,17,4138,2099,2039
050,39,093,"Ohio","Lorain County",3,18,3837,2003,1834
050,39,093,"Ohio","Lorain County",3,19,3548,1832,1716
050,39,093,"Ohio","Lorain County",3,20,3791,2012,1779
050,39,093,"Ohio","Lorain County",3,21,3715,1929,1786
050,39,093,"Ohio","Lorain County",3,22,3636,1876,1760
050,39,093,"Ohio","Lorain County",3,23,3486,1803,1683
050,39,093,"Ohio","Lorain County",3,24,3403,1773,1630
050,39,093,"Ohio","Lorain County",3,25,3542,1813,1729
050,39,093,"Ohio","Lorain County",3,26,3537,1824,1713
050,39,093,"Ohio","Lorain County",3,27,3540,1817,1723
050,39,093,"Ohio","Lorain County",3,28,3532,1782,1750
050,39,093,"Ohio","Lorain County",3,29,3691,1851,1840
050,39,093,"Ohio","Lorain County",3,30,3669,1823,1846
050,39,093,"Ohio","Lorain County",3,31,3822,1912,1910
050,39,093,"Ohio","Lorain County",3,32,3676,1825,1851
050,39,093,"Ohio","Lorain County",3,33,3682,1878,1804
050,39,093,"Ohio","Lorain County",3,34,3665,1874,1791
050,39,093,"Ohio","Lorain County",3,35,3757,1895,1862
050,39,093,"Ohio","Lorain County",3,36,3706,1821,1885
050,39,093,"Ohio","Lorain County",3,37,3700,1847,1853
050,39,093,"Ohio","Lorain County",3,38,3902,1951,1951
050,39,093,"Ohio","Lorain County",3,39,3838,1881,1957
050,39,093,"Ohio","Lorain County",3,40,3953,1967,1986
050,39,093,"Ohio","Lorain County",3,41,3930,1990,1940
050,39,093,"Ohio","Lorain County",3,42,3896,1964,1932
050,39,093,"Ohio","Lorain County",3,43,3808,1896,1912
050,39,093,"Ohio","Lorain County",3,44,3780,1870,1910
050,39,093,"Ohio","Lorain County",3,45,3725,1877,1848
050,39,093,"Ohio","Lorain County",3,46,3812,1923,1889
050,39,093,"Ohio","Lorain County",3,47,3752,1887,1865
050,39,093,"Ohio","Lorain County",3,48,3814,1911,1903
050,39,093,"Ohio","Lorain County",3,49,4114,2075,2039
050,39,093,"Ohio","Lorain County",3,50,4416,2232,2184
050,39,093,"Ohio","Lorain County",3,51,4295,2174,2121
050,39,093,"Ohio","Lorain County",3,52,4174,2128,2046
050,39,093,"Ohio","Lorain County",3,53,4101,2075,2026
050,39,093,"Ohio","Lorain County",3,54,4114,2091,2023
050,39,093,"Ohio","Lorain County",3,55,4164,2093,2071
050,39,093,"Ohio","Lorain County",3,56,4289,2165,2124
050,39,093,"Ohio","Lorain County",3,57,4476,2223,2253
050,39,093,"Ohio","Lorain County",3,58,4513,2164,2349
050,39,093,"Ohio","Lorain County",3,59,4563,2229,2334
050,39,093,"Ohio","Lorain County",3,60,4581,2231,2350
050,39,093,"Ohio","Lorain County",3,61,4466,2184,2282
050,39,093,"Ohio","Lorain County",3,62,4466,2187,2279
050,39,093,"Ohio","Lorain County",3,63,4576,2199,2377
050,39,093,"Ohio","Lorain County",3,64,4518,2173,2345
050,39,093,"Ohio","Lorain County",3,65,4301,2078,2223
050,39,093,"Ohio","Lorain County",3,66,4061,1943,2118
050,39,093,"Ohio","Lorain County",3,67,3970,1894,2076
050,39,093,"Ohio","Lorain County",3,68,3841,1841,2000
050,39,093,"Ohio","Lorain County",3,69,3759,1816,1943
050,39,093,"Ohio","Lorain County",3,70,3564,1690,1874
050,39,093,"Ohio","Lorain County",3,71,3383,1575,1808
050,39,093,"Ohio","Lorain County",3,72,3323,1514,1809
050,39,093,"Ohio","Lorain County",3,73,3243,1495,1748
050,39,093,"Ohio","Lorain County",3,74,3470,1618,1852
050,39,093,"Ohio","Lorain County",3,75,2309,1075,1234
050,39,093,"Ohio","Lorain County",3,76,2119,986,1133
050,39,093,"Ohio","Lorain County",3,77,2048,922,1126
050,39,093,"Ohio","Lorain County",3,78,2120,956,1164
050,39,093,"Ohio","Lorain County",3,79,1812,808,1004
050,39,093,"Ohio","Lorain County",3,80,1600,687,913
050,39,093,"Ohio","Lorain County",3,81,1454,584,870
050,39,093,"Ohio","Lorain County",3,82,1397,568,829
050,39,093,"Ohio","Lorain County",3,83,1286,535,751
050,39,093,"Ohio","Lorain County",3,84,1109,442,667
050,39,093,"Ohio","Lorain County",3,85,6551,2314,4237
050,39,093,"Ohio","Lorain County",4,0,3165,1622,1543
050,39,093,"Ohio","Lorain County",4,1,3278,1697,1581
050,39,093,"Ohio","Lorain County",4,2,3458,1760,1698
050,39,093,"Ohio","Lorain County",4,3,3534,1824,1710
050,39,093,"Ohio","Lorain County",4,4,3649,1854,1795
050,39,093,"Ohio","Lorain County",4,5,3688,1903,1785
050,39,093,"Ohio","Lorain County",4,6,3810,1941,1869
050,39,093,"Ohio","Lorain County",4,7,3868,2020,1848
050,39,093,"Ohio","Lorain County",4,8,3851,1953,1898
050,39,093,"Ohio","Lorain County",4,9,3818,1928,1890
050,39,093,"Ohio","Lorain County",4,10,3858,1991,1867
050,39,093,"Ohio","Lorain County",4,11,3945,2041,1904
050,39,093,"Ohio","Lorain County",4,12,3906,2031,1875
050,39,093,"Ohio","Lorain County",4,13,4041,2064,1977
050,39,093,"Ohio","Lorain County",4,14,4169,2142,2027
050,39,093,"Ohio","Lorain County",4,15,4082,2141,1941
050,39,093,"Ohio","Lorain County",4,16,4131,2139,1992
050,39,093,"Ohio","Lorain County",4,17,4089,2103,1986
050,39,093,"Ohio","Lorain County",4,18,3833,2016,1817
050,39,093,"Ohio","Lorain County",4,19,3410,1772,1638
050,39,093,"Ohio","Lorain County",4,20,3670,1936,1734
050,39,093,"Ohio","Lorain County",4,21,3727,1948,1779
050,39,093,"Ohio","Lorain County",4,22,3725,1921,1804
050,39,093,"Ohio","Lorain County",4,23,3613,1850,1763
050,39,093,"Ohio","Lorain County",4,24,3490,1820,1670
050,39,093,"Ohio","Lorain County",4,25,3427,1767,1660
050,39,093,"Ohio","Lorain County",4,26,3525,1787,1738
050,39,093,"Ohio","Lorain County",4,27,3568,1843,1725
050,39,093,"Ohio","Lorain County",4,28,3576,1824,1752
050,39,093,"Ohio","Lorain County",4,29,3650,1839,1811
050,39,093,"Ohio","Lorain County",4,30,3818,1924,1894
050,39,093,"Ohio","Lorain County",4,31,3852,1949,1903
050,39,093,"Ohio","Lorain County",4,32,3888,1931,1957
050,39,093,"Ohio","Lorain County",4,33,3782,1866,1916
050,39,093,"Ohio","Lorain County",4,34,3741,1900,1841
050,39,093,"Ohio","Lorain County",4,35,3742,1906,1836
050,39,093,"Ohio","Lorain County",4,36,3896,1991,1905
050,39,093,"Ohio","Lorain County",4,37,3764,1839,1925
050,39,093,"Ohio","Lorain County",4,38,3788,1897,1891
050,39,093,"Ohio","Lorain County",4,39,3927,1960,1967
050,39,093,"Ohio","Lorain County",4,40,3904,1914,1990
050,39,093,"Ohio","Lorain County",4,41,3976,2005,1971
050,39,093,"Ohio","Lorain County",4,42,3981,2015,1966
050,39,093,"Ohio","Lorain County",4,43,3889,1955,1934
050,39,093,"Ohio","Lorain County",4,44,3856,1916,1940
050,39,093,"Ohio","Lorain County",4,45,3858,1909,1949
050,39,093,"Ohio","Lorain County",4,46,3743,1908,1835
050,39,093,"Ohio","Lorain County",4,47,3803,1900,1903
050,39,093,"Ohio","Lorain County",4,48,3721,1867,1854
050,39,093,"Ohio","Lorain County",4,49,3811,1928,1883
050,39,093,"Ohio","Lorain County",4,50,4140,2099,2041
050,39,093,"Ohio","Lorain County",4,51,4397,2242,2155
050,39,093,"Ohio","Lorain County",4,52,4263,2159,2104
050,39,093,"Ohio","Lorain County",4,53,4178,2122,2056
050,39,093,"Ohio","Lorain County",4,54,4086,2066,2020
050,39,093,"Ohio","Lorain County",4,55,4110,2065,2045
050,39,093,"Ohio","Lorain County",4,56,4124,2059,2065
050,39,093,"Ohio","Lorain County",4,57,4278,2146,2132
050,39,093,"Ohio","Lorain County",4,58,4428,2190,2238
050,39,093,"Ohio","Lorain County",4,59,4516,2161,2355
050,39,093,"Ohio","Lorain County",4,60,4530,2210,2320
050,39,093,"Ohio","Lorain County",4,61,4570,2216,2354
050,39,093,"Ohio","Lorain County",4,62,4426,2169,2257
050,39,093,"Ohio","Lorain County",4,63,4414,2143,2271
050,39,093,"Ohio","Lorain County",4,64,4527,2171,2356
050,39,093,"Ohio","Lorain County",4,65,4512,2160,2352
050,39,093,"Ohio","Lorain County",4,66,4226,2043,2183
050,39,093,"Ohio","Lorain County",4,67,4056,1929,2127
050,39,093,"Ohio","Lorain County",4,68,3923,1853,2070
050,39,093,"Ohio","Lorain County",4,69,3767,1808,1959
050,39,093,"Ohio","Lorain County",4,70,3702,1769,1933
050,39,093,"Ohio","Lorain County",4,71,3522,1651,1871
050,39,093,"Ohio","Lorain County",4,72,3345,1551,1794
050,39,093,"Ohio","Lorain County",4,73,3247,1472,1775
050,39,093,"Ohio","Lorain County",4,74,3168,1459,1709
050,39,093,"Ohio","Lorain County",4,75,3401,1559,1842
050,39,093,"Ohio","Lorain County",4,76,2208,1030,1178
050,39,093,"Ohio","Lorain County",4,77,2045,938,1107
050,39,093,"Ohio","Lorain County",4,78,1947,864,1083
050,39,093,"Ohio","Lorain County",4,79,2003,904,1099
050,39,093,"Ohio","Lorain County",4,80,1774,791,983
050,39,093,"Ohio","Lorain County",4,81,1544,647,897
050,39,093,"Ohio","Lorain County",4,82,1353,541,812
050,39,093,"Ohio","Lorain County",4,83,1297,527,770
050,39,093,"Ohio","Lorain County",4,84,1200,495,705
050,39,093,"Ohio","Lorain County",4,85,6510,2305,4205
050,39,093,"Ohio","Lorain County",5,0,3168,1623,1545
050,39,093,"Ohio","Lorain County",5,1,3279,1706,1573
050,39,093,"Ohio","Lorain County",5,2,3385,1749,1636
050,39,093,"Ohio","Lorain County",5,3,3486,1802,1684
050,39,093,"Ohio","Lorain County",5,4,3569,1852,1717
050,39,093,"Ohio","Lorain County",5,5,3669,1847,1822
050,39,093,"Ohio","Lorain County",5,6,3720,1915,1805
050,39,093,"Ohio","Lorain County",5,7,3852,1947,1905
050,39,093,"Ohio","Lorain County",5,8,3896,2031,1865
050,39,093,"Ohio","Lorain County",5,9,3908,1977,1931
050,39,093,"Ohio","Lorain County",5,10,3881,1971,1910
050,39,093,"Ohio","Lorain County",5,11,3897,2016,1881
050,39,093,"Ohio","Lorain County",5,12,4001,2053,1948
050,39,093,"Ohio","Lorain County",5,13,3929,2054,1875
050,39,093,"Ohio","Lorain County",5,14,4041,2076,1965
050,39,093,"Ohio","Lorain County",5,15,4183,2164,2019
050,39,093,"Ohio","Lorain County",5,16,4108,2137,1971
050,39,093,"Ohio","Lorain County",5,17,4159,2142,2017
050,39,093,"Ohio","Lorain County",5,18,3767,1990,1777
050,39,093,"Ohio","Lorain County",5,19,3417,1770,1647
050,39,093,"Ohio","Lorain County",5,20,3562,1879,1683
050,39,093,"Ohio","Lorain County",5,21,3665,1914,1751
050,39,093,"Ohio","Lorain County",5,22,3761,1937,1824
050,39,093,"Ohio","Lorain County",5,23,3705,1949,1756
050,39,093,"Ohio","Lorain County",5,24,3514,1825,1689
050,39,093,"Ohio","Lorain County",5,25,3446,1792,1654
050,39,093,"Ohio","Lorain County",5,26,3348,1728,1620
050,39,093,"Ohio","Lorain County",5,27,3522,1795,1727
050,39,093,"Ohio","Lorain County",5,28,3610,1835,1775
050,39,093,"Ohio","Lorain County",5,29,3656,1886,1770
050,39,093,"Ohio","Lorain County",5,30,3706,1855,1851
050,39,093,"Ohio","Lorain County",5,31,3944,2006,1938
050,39,093,"Ohio","Lorain County",5,32,3916,1930,1986
050,39,093,"Ohio","Lorain County",5,33,4001,1990,2011
050,39,093,"Ohio","Lorain County",5,34,3880,1902,1978
050,39,093,"Ohio","Lorain County",5,35,3854,1939,1915
050,39,093,"Ohio","Lorain County",5,36,3840,1962,1878
050,39,093,"Ohio","Lorain County",5,37,3976,2036,1940
050,39,093,"Ohio","Lorain County",5,38,3827,1889,1938
050,39,093,"Ohio","Lorain County",5,39,3818,1909,1909
050,39,093,"Ohio","Lorain County",5,40,3993,1989,2004
050,39,093,"Ohio","Lorain County",5,41,3950,1967,1983
050,39,093,"Ohio","Lorain County",5,42,4060,2051,2009
050,39,093,"Ohio","Lorain County",5,43,3978,2000,1978
050,39,093,"Ohio","Lorain County",5,44,3922,1967,1955
050,39,093,"Ohio","Lorain County",5,45,3899,1959,1940
050,39,093,"Ohio","Lorain County",5,46,3860,1925,1935
050,39,093,"Ohio","Lorain County",5,47,3772,1927,1845
050,39,093,"Ohio","Lorain County",5,48,3792,1889,1903
050,39,093,"Ohio","Lorain County",5,49,3727,1874,1853
050,39,093,"Ohio","Lorain County",5,50,3838,1943,1895
050,39,093,"Ohio","Lorain County",5,51,4174,2144,2030
050,39,093,"Ohio","Lorain County",5,52,4401,2242,2159
050,39,093,"Ohio","Lorain County",5,53,4284,2166,2118
050,39,093,"Ohio","Lorain County",5,54,4170,2114,2056
050,39,093,"Ohio","Lorain County",5,55,4050,2053,1997
050,39,093,"Ohio","Lorain County",5,56,4081,2032,2049
050,39,093,"Ohio","Lorain County",5,57,4106,2057,2049
050,39,093,"Ohio","Lorain County",5,58,4234,2118,2116
050,39,093,"Ohio","Lorain County",5,59,4396,2174,2222
050,39,093,"Ohio","Lorain County",5,60,4497,2172,2325
050,39,093,"Ohio","Lorain County",5,61,4501,2178,2323
050,39,093,"Ohio","Lorain County",5,62,4504,2173,2331
050,39,093,"Ohio","Lorain County",5,63,4381,2143,2238
050,39,093,"Ohio","Lorain County",5,64,4364,2097,2267
050,39,093,"Ohio","Lorain County",5,65,4514,2155,2359
050,39,093,"Ohio","Lorain County",5,66,4457,2125,2332
050,39,093,"Ohio","Lorain County",5,67,4224,2047,2177
050,39,093,"Ohio","Lorain County",5,68,4017,1895,2122
050,39,093,"Ohio","Lorain County",5,69,3896,1843,2053
050,39,093,"Ohio","Lorain County",5,70,3764,1801,1963
050,39,093,"Ohio","Lorain County",5,71,3663,1748,1915
050,39,093,"Ohio","Lorain County",5,72,3503,1623,1880
050,39,093,"Ohio","Lorain County",5,73,3281,1515,1766
050,39,093,"Ohio","Lorain County",5,74,3173,1424,1749
050,39,093,"Ohio","Lorain County",5,75,3086,1404,1682
050,39,093,"Ohio","Lorain County",5,76,3310,1510,1800
050,39,093,"Ohio","Lorain County",5,77,2159,996,1163
050,39,093,"Ohio","Lorain County",5,78,1960,894,1066
050,39,093,"Ohio","Lorain County",5,79,1851,825,1026
050,39,093,"Ohio","Lorain County",5,80,1950,877,1073
050,39,093,"Ohio","Lorain County",5,81,1727,748,979
050,39,093,"Ohio","Lorain County",5,82,1455,610,845
050,39,093,"Ohio","Lorain County",5,83,1262,506,756
050,39,093,"Ohio","Lorain County",5,84,1202,488,714
050,39,093,"Ohio","Lorain County",5,85,6656,2391,4265
050,39,095,"Ohio","Lucas County",1,0,5169,2635,2534
050,39,095,"Ohio","Lucas County",1,1,5256,2659,2597
050,39,095,"Ohio","Lucas County",1,2,5452,2778,2674
050,39,095,"Ohio","Lucas County",1,3,5444,2787,2657
050,39,095,"Ohio","Lucas County",1,4,5536,2831,2705
050,39,095,"Ohio","Lucas County",1,5,5579,2902,2677
050,39,095,"Ohio","Lucas County",1,6,5521,2808,2713
050,39,095,"Ohio","Lucas County",1,7,5403,2716,2687
050,39,095,"Ohio","Lucas County",1,8,5400,2779,2621
050,39,095,"Ohio","Lucas County",1,9,5373,2772,2601
050,39,095,"Ohio","Lucas County",1,10,5574,2856,2718
050,39,095,"Ohio","Lucas County",1,11,5761,2938,2823
050,39,095,"Ohio","Lucas County",1,12,5879,2996,2883
050,39,095,"Ohio","Lucas County",1,13,5826,2975,2851
050,39,095,"Ohio","Lucas County",1,14,5675,2898,2777
050,39,095,"Ohio","Lucas County",1,15,5590,2856,2734
050,39,095,"Ohio","Lucas County",1,16,5700,2909,2791
050,39,095,"Ohio","Lucas County",1,17,5535,2809,2726
050,39,095,"Ohio","Lucas County",1,18,5702,2910,2792
050,39,095,"Ohio","Lucas County",1,19,6017,3103,2914
050,39,095,"Ohio","Lucas County",1,20,5176,2664,2512
050,39,095,"Ohio","Lucas County",1,21,5009,2538,2471
050,39,095,"Ohio","Lucas County",1,22,5223,2610,2613
050,39,095,"Ohio","Lucas County",1,23,5444,2645,2799
050,39,095,"Ohio","Lucas County",1,24,5713,2760,2953
050,39,095,"Ohio","Lucas County",1,25,5854,2894,2960
050,39,095,"Ohio","Lucas County",1,26,6040,2985,3055
050,39,095,"Ohio","Lucas County",1,27,6201,3079,3122
050,39,095,"Ohio","Lucas County",1,28,6317,3102,3215
050,39,095,"Ohio","Lucas County",1,29,6487,3166,3321
050,39,095,"Ohio","Lucas County",1,30,6610,3260,3350
050,39,095,"Ohio","Lucas County",1,31,6263,3147,3116
050,39,095,"Ohio","Lucas County",1,32,6001,3000,3001
050,39,095,"Ohio","Lucas County",1,33,5684,2809,2875
050,39,095,"Ohio","Lucas County",1,34,5542,2682,2860
050,39,095,"Ohio","Lucas County",1,35,5343,2575,2768
050,39,095,"Ohio","Lucas County",1,36,5208,2558,2650
050,39,095,"Ohio","Lucas County",1,37,5263,2617,2646
050,39,095,"Ohio","Lucas County",1,38,5193,2525,2668
050,39,095,"Ohio","Lucas County",1,39,5211,2587,2624
050,39,095,"Ohio","Lucas County",1,40,5164,2537,2627
050,39,095,"Ohio","Lucas County",1,41,4827,2283,2544
050,39,095,"Ohio","Lucas County",1,42,4810,2354,2456
050,39,095,"Ohio","Lucas County",1,43,4684,2279,2405
050,39,095,"Ohio","Lucas County",1,44,4699,2279,2420
050,39,095,"Ohio","Lucas County",1,45,4741,2275,2466
050,39,095,"Ohio","Lucas County",1,46,4826,2276,2550
050,39,095,"Ohio","Lucas County",1,47,5055,2451,2604
050,39,095,"Ohio","Lucas County",1,48,5499,2685,2814
050,39,095,"Ohio","Lucas County",1,49,5690,2827,2863
050,39,095,"Ohio","Lucas County",1,50,5388,2662,2726
050,39,095,"Ohio","Lucas County",1,51,5130,2458,2672
050,39,095,"Ohio","Lucas County",1,52,5020,2414,2606
050,39,095,"Ohio","Lucas County",1,53,5223,2573,2650
050,39,095,"Ohio","Lucas County",1,54,5274,2601,2673
050,39,095,"Ohio","Lucas County",1,55,5588,2679,2909
050,39,095,"Ohio","Lucas County",1,56,5712,2759,2953
050,39,095,"Ohio","Lucas County",1,57,5832,2850,2982
050,39,095,"Ohio","Lucas County",1,58,6099,2958,3141
050,39,095,"Ohio","Lucas County",1,59,6017,2899,3118
050,39,095,"Ohio","Lucas County",1,60,5972,2932,3040
050,39,095,"Ohio","Lucas County",1,61,5992,2884,3108
050,39,095,"Ohio","Lucas County",1,62,5985,2888,3097
050,39,095,"Ohio","Lucas County",1,63,5896,2811,3085
050,39,095,"Ohio","Lucas County",1,64,5601,2691,2910
050,39,095,"Ohio","Lucas County",1,65,5423,2609,2814
050,39,095,"Ohio","Lucas County",1,66,5103,2416,2687
050,39,095,"Ohio","Lucas County",1,67,4917,2296,2621
050,39,095,"Ohio","Lucas County",1,68,4831,2243,2588
050,39,095,"Ohio","Lucas County",1,69,4410,2066,2344
050,39,095,"Ohio","Lucas County",1,70,4235,1984,2251
050,39,095,"Ohio","Lucas County",1,71,4129,1931,2198
050,39,095,"Ohio","Lucas County",1,72,4116,1892,2224
050,39,095,"Ohio","Lucas County",1,73,4008,1896,2112
050,39,095,"Ohio","Lucas County",1,74,2676,1227,1449
050,39,095,"Ohio","Lucas County",1,75,2527,1148,1379
050,39,095,"Ohio","Lucas County",1,76,2549,1092,1457
050,39,095,"Ohio","Lucas County",1,77,2580,1120,1460
050,39,095,"Ohio","Lucas County",1,78,2213,953,1260
050,39,095,"Ohio","Lucas County",1,79,1938,809,1129
050,39,095,"Ohio","Lucas County",1,80,1752,708,1044
050,39,095,"Ohio","Lucas County",1,81,1655,666,989
050,39,095,"Ohio","Lucas County",1,82,1573,635,938
050,39,095,"Ohio","Lucas County",1,83,1446,563,883
050,39,095,"Ohio","Lucas County",1,84,1318,510,808
050,39,095,"Ohio","Lucas County",1,85,7984,2656,5328
050,39,095,"Ohio","Lucas County",2,0,5183,2646,2537
050,39,095,"Ohio","Lucas County",2,1,5230,2652,2578
050,39,095,"Ohio","Lucas County",2,2,5408,2750,2658
050,39,095,"Ohio","Lucas County",2,3,5418,2772,2646
050,39,095,"Ohio","Lucas County",2,4,5518,2823,2695
050,39,095,"Ohio","Lucas County",2,5,5574,2886,2688
050,39,095,"Ohio","Lucas County",2,6,5529,2827,2702
050,39,095,"Ohio","Lucas County",2,7,5422,2736,2686
050,39,095,"Ohio","Lucas County",2,8,5383,2752,2631
050,39,095,"Ohio","Lucas County",2,9,5369,2769,2600
050,39,095,"Ohio","Lucas County",2,10,5527,2840,2687
050,39,095,"Ohio","Lucas County",2,11,5682,2897,2785
050,39,095,"Ohio","Lucas County",2,12,5867,2988,2879
050,39,095,"Ohio","Lucas County",2,13,5832,2983,2849
050,39,095,"Ohio","Lucas County",2,14,5704,2912,2792
050,39,095,"Ohio","Lucas County",2,15,5609,2865,2744
050,39,095,"Ohio","Lucas County",2,16,5674,2893,2781
050,39,095,"Ohio","Lucas County",2,17,5582,2838,2744
050,39,095,"Ohio","Lucas County",2,18,5681,2879,2802
050,39,095,"Ohio","Lucas County",2,19,6033,3112,2921
050,39,095,"Ohio","Lucas County",2,20,5246,2693,2553
050,39,095,"Ohio","Lucas County",2,21,5008,2544,2464
050,39,095,"Ohio","Lucas County",2,22,5227,2614,2613
050,39,095,"Ohio","Lucas County",2,23,5441,2656,2785
050,39,095,"Ohio","Lucas County",2,24,5656,2740,2916
050,39,095,"Ohio","Lucas County",2,25,5834,2870,2964
050,39,095,"Ohio","Lucas County",2,26,6000,2967,3033
050,39,095,"Ohio","Lucas County",2,27,6140,3050,3090
050,39,095,"Ohio","Lucas County",2,28,6286,3101,3185
050,39,095,"Ohio","Lucas County",2,29,6438,3145,3293
050,39,095,"Ohio","Lucas County",2,30,6578,3232,3346
050,39,095,"Ohio","Lucas County",2,31,6329,3171,3158
050,39,095,"Ohio","Lucas County",2,32,6037,3023,3014
050,39,095,"Ohio","Lucas County",2,33,5736,2841,2895
050,39,095,"Ohio","Lucas County",2,34,5563,2706,2857
050,39,095,"Ohio","Lucas County",2,35,5412,2610,2802
050,39,095,"Ohio","Lucas County",2,36,5201,2542,2659
050,39,095,"Ohio","Lucas County",2,37,5251,2601,2650
050,39,095,"Ohio","Lucas County",2,38,5209,2542,2667
050,39,095,"Ohio","Lucas County",2,39,5174,2553,2621
050,39,095,"Ohio","Lucas County",2,40,5200,2558,2642
050,39,095,"Ohio","Lucas County",2,41,4885,2335,2550
050,39,095,"Ohio","Lucas County",2,42,4789,2324,2465
050,39,095,"Ohio","Lucas County",2,43,4747,2311,2436
050,39,095,"Ohio","Lucas County",2,44,4644,2255,2389
050,39,095,"Ohio","Lucas County",2,45,4747,2280,2467
050,39,095,"Ohio","Lucas County",2,46,4777,2264,2513
050,39,095,"Ohio","Lucas County",2,47,4992,2402,2590
050,39,095,"Ohio","Lucas County",2,48,5376,2618,2758
050,39,095,"Ohio","Lucas County",2,49,5683,2821,2862
050,39,095,"Ohio","Lucas County",2,50,5473,2707,2766
050,39,095,"Ohio","Lucas County",2,51,5162,2488,2674
050,39,095,"Ohio","Lucas County",2,52,5033,2420,2613
050,39,095,"Ohio","Lucas County",2,53,5168,2542,2626
050,39,095,"Ohio","Lucas County",2,54,5242,2587,2655
050,39,095,"Ohio","Lucas County",2,55,5489,2643,2846
050,39,095,"Ohio","Lucas County",2,56,5685,2741,2944
050,39,095,"Ohio","Lucas County",2,57,5787,2821,2966
050,39,095,"Ohio","Lucas County",2,58,6007,2913,3094
050,39,095,"Ohio","Lucas County",2,59,6043,2919,3124
050,39,095,"Ohio","Lucas County",2,60,5936,2900,3036
050,39,095,"Ohio","Lucas County",2,61,5946,2871,3075
050,39,095,"Ohio","Lucas County",2,62,5947,2867,3080
050,39,095,"Ohio","Lucas County",2,63,5937,2831,3106
050,39,095,"Ohio","Lucas County",2,64,5615,2694,2921
050,39,095,"Ohio","Lucas County",2,65,5418,2602,2816
050,39,095,"Ohio","Lucas County",2,66,5153,2446,2707
050,39,095,"Ohio","Lucas County",2,67,4907,2296,2611
050,39,095,"Ohio","Lucas County",2,68,4777,2214,2563
050,39,095,"Ohio","Lucas County",2,69,4511,2102,2409
050,39,095,"Ohio","Lucas County",2,70,4240,1982,2258
050,39,095,"Ohio","Lucas County",2,71,4119,1931,2188
050,39,095,"Ohio","Lucas County",2,72,4031,1860,2171
050,39,095,"Ohio","Lucas County",2,73,4184,1959,2225
050,39,095,"Ohio","Lucas County",2,74,2788,1289,1499
050,39,095,"Ohio","Lucas County",2,75,2549,1154,1395
050,39,095,"Ohio","Lucas County",2,76,2492,1082,1410
050,39,095,"Ohio","Lucas County",2,77,2595,1119,1476
050,39,095,"Ohio","Lucas County",2,78,2225,957,1268
050,39,095,"Ohio","Lucas County",2,79,1964,824,1140
050,39,095,"Ohio","Lucas County",2,80,1780,726,1054
050,39,095,"Ohio","Lucas County",2,81,1638,659,979
050,39,095,"Ohio","Lucas County",2,82,1562,636,926
050,39,095,"Ohio","Lucas County",2,83,1437,561,876
050,39,095,"Ohio","Lucas County",2,84,1304,499,805
050,39,095,"Ohio","Lucas County",2,85,7884,2634,5250
050,39,095,"Ohio","Lucas County",3,0,4912,2549,2363
050,39,095,"Ohio","Lucas County",3,1,5136,2595,2541
050,39,095,"Ohio","Lucas County",3,2,5181,2625,2556
050,39,095,"Ohio","Lucas County",3,3,5432,2768,2664
050,39,095,"Ohio","Lucas County",3,4,5360,2754,2606
050,39,095,"Ohio","Lucas County",3,5,5523,2825,2698
050,39,095,"Ohio","Lucas County",3,6,5542,2876,2666
050,39,095,"Ohio","Lucas County",3,7,5528,2822,2706
050,39,095,"Ohio","Lucas County",3,8,5460,2759,2701
050,39,095,"Ohio","Lucas County",3,9,5376,2748,2628
050,39,095,"Ohio","Lucas County",3,10,5366,2772,2594
050,39,095,"Ohio","Lucas County",3,11,5510,2836,2674
050,39,095,"Ohio","Lucas County",3,12,5663,2900,2763
050,39,095,"Ohio","Lucas County",3,13,5823,2968,2855
050,39,095,"Ohio","Lucas County",3,14,5802,2961,2841
050,39,095,"Ohio","Lucas County",3,15,5650,2856,2794
050,39,095,"Ohio","Lucas County",3,16,5568,2826,2742
050,39,095,"Ohio","Lucas County",3,17,5706,2924,2782
050,39,095,"Ohio","Lucas County",3,18,5724,2903,2821
050,39,095,"Ohio","Lucas County",3,19,5967,3060,2907
050,39,095,"Ohio","Lucas County",3,20,5292,2682,2610
050,39,095,"Ohio","Lucas County",3,21,5107,2605,2502
050,39,095,"Ohio","Lucas County",3,22,5257,2632,2625
050,39,095,"Ohio","Lucas County",3,23,5480,2695,2785
050,39,095,"Ohio","Lucas County",3,24,5490,2723,2767
050,39,095,"Ohio","Lucas County",3,25,5668,2791,2877
050,39,095,"Ohio","Lucas County",3,26,5844,2865,2979
050,39,095,"Ohio","Lucas County",3,27,5879,2930,2949
050,39,095,"Ohio","Lucas County",3,28,6140,3024,3116
050,39,095,"Ohio","Lucas County",3,29,6259,3040,3219
050,39,095,"Ohio","Lucas County",3,30,6398,3095,3303
050,39,095,"Ohio","Lucas County",3,31,6493,3171,3322
050,39,095,"Ohio","Lucas County",3,32,6275,3145,3130
050,39,095,"Ohio","Lucas County",3,33,5924,2945,2979
050,39,095,"Ohio","Lucas County",3,34,5694,2822,2872
050,39,095,"Ohio","Lucas County",3,35,5525,2662,2863
050,39,095,"Ohio","Lucas County",3,36,5329,2579,2750
050,39,095,"Ohio","Lucas County",3,37,5138,2485,2653
050,39,095,"Ohio","Lucas County",3,38,5228,2593,2635
050,39,095,"Ohio","Lucas County",3,39,5210,2562,2648
050,39,095,"Ohio","Lucas County",3,40,5182,2545,2637
050,39,095,"Ohio","Lucas County",3,41,5107,2487,2620
050,39,095,"Ohio","Lucas County",3,42,4908,2352,2556
050,39,095,"Ohio","Lucas County",3,43,4749,2304,2445
050,39,095,"Ohio","Lucas County",3,44,4763,2318,2445
050,39,095,"Ohio","Lucas County",3,45,4626,2244,2382
050,39,095,"Ohio","Lucas County",3,46,4675,2235,2440
050,39,095,"Ohio","Lucas County",3,47,4749,2257,2492
050,39,095,"Ohio","Lucas County",3,48,4944,2355,2589
050,39,095,"Ohio","Lucas County",3,49,5374,2637,2737
050,39,095,"Ohio","Lucas County",3,50,5677,2801,2876
050,39,095,"Ohio","Lucas County",3,51,5369,2637,2732
050,39,095,"Ohio","Lucas County",3,52,5145,2476,2669
050,39,095,"Ohio","Lucas County",3,53,4978,2415,2563
050,39,095,"Ohio","Lucas County",3,54,5139,2512,2627
050,39,095,"Ohio","Lucas County",3,55,5149,2532,2617
050,39,095,"Ohio","Lucas County",3,56,5449,2630,2819
050,39,095,"Ohio","Lucas County",3,57,5625,2700,2925
050,39,095,"Ohio","Lucas County",3,58,5711,2779,2932
050,39,095,"Ohio","Lucas County",3,59,5933,2887,3046
050,39,095,"Ohio","Lucas County",3,60,5925,2867,3058
050,39,095,"Ohio","Lucas County",3,61,5793,2785,3008
050,39,095,"Ohio","Lucas County",3,62,5827,2824,3003
050,39,095,"Ohio","Lucas County",3,63,5842,2774,3068
050,39,095,"Ohio","Lucas County",3,64,5807,2788,3019
050,39,095,"Ohio","Lucas County",3,65,5433,2598,2835
050,39,095,"Ohio","Lucas County",3,66,5261,2503,2758
050,39,095,"Ohio","Lucas County",3,67,5018,2354,2664
050,39,095,"Ohio","Lucas County",3,68,4750,2223,2527
050,39,095,"Ohio","Lucas County",3,69,4679,2153,2526
050,39,095,"Ohio","Lucas County",3,70,4382,2028,2354
050,39,095,"Ohio","Lucas County",3,71,4148,1929,2219
050,39,095,"Ohio","Lucas County",3,72,3987,1861,2126
050,39,095,"Ohio","Lucas County",3,73,3862,1759,2103
050,39,095,"Ohio","Lucas County",3,74,4015,1872,2143
050,39,095,"Ohio","Lucas County",3,75,2688,1229,1459
050,39,095,"Ohio","Lucas County",3,76,2452,1102,1350
050,39,095,"Ohio","Lucas County",3,77,2362,1020,1342
050,39,095,"Ohio","Lucas County",3,78,2464,1057,1407
050,39,095,"Ohio","Lucas County",3,79,2087,890,1197
050,39,095,"Ohio","Lucas County",3,80,1873,768,1105
050,39,095,"Ohio","Lucas County",3,81,1652,657,995
050,39,095,"Ohio","Lucas County",3,82,1539,619,920
050,39,095,"Ohio","Lucas County",3,83,1456,574,882
050,39,095,"Ohio","Lucas County",3,84,1286,492,794
050,39,095,"Ohio","Lucas County",3,85,7783,2612,5171
050,39,095,"Ohio","Lucas County",4,0,4872,2482,2390
050,39,095,"Ohio","Lucas County",4,1,4870,2529,2341
050,39,095,"Ohio","Lucas County",4,2,5200,2625,2575
050,39,095,"Ohio","Lucas County",4,3,5166,2597,2569
050,39,095,"Ohio","Lucas County",4,4,5378,2768,2610
050,39,095,"Ohio","Lucas County",4,5,5310,2714,2596
050,39,095,"Ohio","Lucas County",4,6,5448,2795,2653
050,39,095,"Ohio","Lucas County",4,7,5494,2828,2666
050,39,095,"Ohio","Lucas County",4,8,5459,2782,2677
050,39,095,"Ohio","Lucas County",4,9,5429,2741,2688
050,39,095,"Ohio","Lucas County",4,10,5363,2751,2612
050,39,095,"Ohio","Lucas County",4,11,5322,2743,2579
050,39,095,"Ohio","Lucas County",4,12,5469,2800,2669
050,39,095,"Ohio","Lucas County",4,13,5642,2862,2780
050,39,095,"Ohio","Lucas County",4,14,5852,2970,2882
050,39,095,"Ohio","Lucas County",4,15,5729,2915,2814
050,39,095,"Ohio","Lucas County",4,16,5656,2855,2801
050,39,095,"Ohio","Lucas County",4,17,5637,2854,2783
050,39,095,"Ohio","Lucas County",4,18,5731,2920,2811
050,39,095,"Ohio","Lucas County",4,19,5852,3005,2847
050,39,095,"Ohio","Lucas County",4,20,5055,2559,2496
050,39,095,"Ohio","Lucas County",4,21,5094,2562,2532
050,39,095,"Ohio","Lucas County",4,22,5258,2655,2603
050,39,095,"Ohio","Lucas County",4,23,5442,2705,2737
050,39,095,"Ohio","Lucas County",4,24,5587,2741,2846
050,39,095,"Ohio","Lucas County",4,25,5430,2674,2756
050,39,095,"Ohio","Lucas County",4,26,5604,2769,2835
050,39,095,"Ohio","Lucas County",4,27,5827,2882,2945
050,39,095,"Ohio","Lucas County",4,28,5816,2878,2938
050,39,095,"Ohio","Lucas County",4,29,6052,2976,3076
050,39,095,"Ohio","Lucas County",4,30,6216,3000,3216
050,39,095,"Ohio","Lucas County",4,31,6355,3113,3242
050,39,095,"Ohio","Lucas County",4,32,6408,3117,3291
050,39,095,"Ohio","Lucas County",4,33,6152,3068,3084
050,39,095,"Ohio","Lucas County",4,34,5812,2922,2890
050,39,095,"Ohio","Lucas County",4,35,5624,2753,2871
050,39,095,"Ohio","Lucas County",4,36,5457,2647,2810
050,39,095,"Ohio","Lucas County",4,37,5299,2546,2753
050,39,095,"Ohio","Lucas County",4,38,5098,2443,2655
050,39,095,"Ohio","Lucas County",4,39,5204,2560,2644
050,39,095,"Ohio","Lucas County",4,40,5159,2502,2657
050,39,095,"Ohio","Lucas County",4,41,5181,2552,2629
050,39,095,"Ohio","Lucas County",4,42,5106,2470,2636
050,39,095,"Ohio","Lucas County",4,43,4858,2298,2560
050,39,095,"Ohio","Lucas County",4,44,4784,2318,2466
050,39,095,"Ohio","Lucas County",4,45,4686,2283,2403
050,39,095,"Ohio","Lucas County",4,46,4595,2220,2375
050,39,095,"Ohio","Lucas County",4,47,4693,2245,2448
050,39,095,"Ohio","Lucas County",4,48,4683,2220,2463
050,39,095,"Ohio","Lucas County",4,49,4918,2353,2565
050,39,095,"Ohio","Lucas County",4,50,5340,2604,2736
050,39,095,"Ohio","Lucas County",4,51,5604,2746,2858
050,39,095,"Ohio","Lucas County",4,52,5336,2624,2712
050,39,095,"Ohio","Lucas County",4,53,5085,2451,2634
050,39,095,"Ohio","Lucas County",4,54,4921,2387,2534
050,39,095,"Ohio","Lucas County",4,55,5024,2439,2585
050,39,095,"Ohio","Lucas County",4,56,5134,2543,2591
050,39,095,"Ohio","Lucas County",4,57,5317,2559,2758
050,39,095,"Ohio","Lucas County",4,58,5508,2646,2862
050,39,095,"Ohio","Lucas County",4,59,5594,2719,2875
050,39,095,"Ohio","Lucas County",4,60,5806,2818,2988
050,39,095,"Ohio","Lucas County",4,61,5791,2776,3015
050,39,095,"Ohio","Lucas County",4,62,5674,2718,2956
050,39,095,"Ohio","Lucas County",4,63,5702,2761,2941
050,39,095,"Ohio","Lucas County",4,64,5666,2696,2970
050,39,095,"Ohio","Lucas County",4,65,5613,2670,2943
050,39,095,"Ohio","Lucas County",4,66,5294,2505,2789
050,39,095,"Ohio","Lucas County",4,67,5120,2403,2717
050,39,095,"Ohio","Lucas County",4,68,4882,2308,2574
050,39,095,"Ohio","Lucas County",4,69,4624,2145,2479
050,39,095,"Ohio","Lucas County",4,70,4512,2068,2444
050,39,095,"Ohio","Lucas County",4,71,4271,1963,2308
050,39,095,"Ohio","Lucas County",4,72,4015,1855,2160
050,39,095,"Ohio","Lucas County",4,73,3848,1763,2085
050,39,095,"Ohio","Lucas County",4,74,3688,1682,2006
050,39,095,"Ohio","Lucas County",4,75,3860,1785,2075
050,39,095,"Ohio","Lucas County",4,76,2595,1170,1425
050,39,095,"Ohio","Lucas County",4,77,2334,1047,1287
050,39,095,"Ohio","Lucas County",4,78,2244,969,1275
050,39,095,"Ohio","Lucas County",4,79,2314,976,1338
050,39,095,"Ohio","Lucas County",4,80,1999,824,1175
050,39,095,"Ohio","Lucas County",4,81,1751,711,1040
050,39,095,"Ohio","Lucas County",4,82,1549,602,947
050,39,095,"Ohio","Lucas County",4,83,1460,562,898
050,39,095,"Ohio","Lucas County",4,84,1285,512,773
050,39,095,"Ohio","Lucas County",4,85,7627,2547,5080
050,39,095,"Ohio","Lucas County",5,0,4896,2490,2406
050,39,095,"Ohio","Lucas County",5,1,4834,2487,2347
050,39,095,"Ohio","Lucas County",5,2,4873,2513,2360
050,39,095,"Ohio","Lucas County",5,3,5186,2618,2568
050,39,095,"Ohio","Lucas County",5,4,5135,2585,2550
050,39,095,"Ohio","Lucas County",5,5,5312,2729,2583
050,39,095,"Ohio","Lucas County",5,6,5266,2701,2565
050,39,095,"Ohio","Lucas County",5,7,5402,2786,2616
050,39,095,"Ohio","Lucas County",5,8,5493,2853,2640
050,39,095,"Ohio","Lucas County",5,9,5442,2773,2669
050,39,095,"Ohio","Lucas County",5,10,5465,2779,2686
050,39,095,"Ohio","Lucas County",5,11,5348,2730,2618
050,39,095,"Ohio","Lucas County",5,12,5324,2745,2579
050,39,095,"Ohio","Lucas County",5,13,5475,2806,2669
050,39,095,"Ohio","Lucas County",5,14,5619,2870,2749
050,39,095,"Ohio","Lucas County",5,15,5846,2983,2863
050,39,095,"Ohio","Lucas County",5,16,5717,2911,2806
050,39,095,"Ohio","Lucas County",5,17,5706,2877,2829
050,39,095,"Ohio","Lucas County",5,18,5648,2860,2788
050,39,095,"Ohio","Lucas County",5,19,5825,3013,2812
050,39,095,"Ohio","Lucas County",5,20,5013,2546,2467
050,39,095,"Ohio","Lucas County",5,21,4859,2465,2394
050,39,095,"Ohio","Lucas County",5,22,5259,2618,2641
050,39,095,"Ohio","Lucas County",5,23,5377,2689,2688
050,39,095,"Ohio","Lucas County",5,24,5471,2760,2711
050,39,095,"Ohio","Lucas County",5,25,5590,2773,2817
050,39,095,"Ohio","Lucas County",5,26,5417,2664,2753
050,39,095,"Ohio","Lucas County",5,27,5573,2779,2794
050,39,095,"Ohio","Lucas County",5,28,5728,2835,2893
050,39,095,"Ohio","Lucas County",5,29,5724,2825,2899
050,39,095,"Ohio","Lucas County",5,30,5998,2932,3066
050,39,095,"Ohio","Lucas County",5,31,6139,2960,3179
050,39,095,"Ohio","Lucas County",5,32,6314,3070,3244
050,39,095,"Ohio","Lucas County",5,33,6274,3036,3238
050,39,095,"Ohio","Lucas County",5,34,6089,3029,3060
050,39,095,"Ohio","Lucas County",5,35,5798,2902,2896
050,39,095,"Ohio","Lucas County",5,36,5593,2746,2847
050,39,095,"Ohio","Lucas County",5,37,5440,2650,2790
050,39,095,"Ohio","Lucas County",5,38,5242,2512,2730
050,39,095,"Ohio","Lucas County",5,39,5109,2465,2644
050,39,095,"Ohio","Lucas County",5,40,5203,2544,2659
050,39,095,"Ohio","Lucas County",5,41,5128,2480,2648
050,39,095,"Ohio","Lucas County",5,42,5173,2551,2622
050,39,095,"Ohio","Lucas County",5,43,5097,2456,2641
050,39,095,"Ohio","Lucas County",5,44,4866,2292,2574
050,39,095,"Ohio","Lucas County",5,45,4778,2304,2474
050,39,095,"Ohio","Lucas County",5,46,4645,2270,2375
050,39,095,"Ohio","Lucas County",5,47,4590,2240,2350
050,39,095,"Ohio","Lucas County",5,48,4699,2233,2466
050,39,095,"Ohio","Lucas County",5,49,4704,2262,2442
050,39,095,"Ohio","Lucas County",5,50,4888,2325,2563
050,39,095,"Ohio","Lucas County",5,51,5238,2534,2704
050,39,095,"Ohio","Lucas County",5,52,5613,2742,2871
050,39,095,"Ohio","Lucas County",5,53,5307,2628,2679
050,39,095,"Ohio","Lucas County",5,54,5052,2427,2625
050,39,095,"Ohio","Lucas County",5,55,4845,2341,2504
050,39,095,"Ohio","Lucas County",5,56,5024,2437,2587
050,39,095,"Ohio","Lucas County",5,57,5059,2511,2548
050,39,095,"Ohio","Lucas County",5,58,5242,2518,2724
050,39,095,"Ohio","Lucas County",5,59,5420,2617,2803
050,39,095,"Ohio","Lucas County",5,60,5506,2663,2843
050,39,095,"Ohio","Lucas County",5,61,5728,2753,2975
050,39,095,"Ohio","Lucas County",5,62,5694,2741,2953
050,39,095,"Ohio","Lucas County",5,63,5539,2621,2918
050,39,095,"Ohio","Lucas County",5,64,5588,2708,2880
050,39,095,"Ohio","Lucas County",5,65,5527,2605,2922
050,39,095,"Ohio","Lucas County",5,66,5486,2591,2895
050,39,095,"Ohio","Lucas County",5,67,5165,2420,2745
050,39,095,"Ohio","Lucas County",5,68,5005,2357,2648
050,39,095,"Ohio","Lucas County",5,69,4809,2252,2557
050,39,095,"Ohio","Lucas County",5,70,4520,2098,2422
050,39,095,"Ohio","Lucas County",5,71,4414,2013,2401
050,39,095,"Ohio","Lucas County",5,72,4139,1889,2250
050,39,095,"Ohio","Lucas County",5,73,3896,1769,2127
050,39,095,"Ohio","Lucas County",5,74,3697,1692,2005
050,39,095,"Ohio","Lucas County",5,75,3583,1626,1957
050,39,095,"Ohio","Lucas County",5,76,3764,1732,2032
050,39,095,"Ohio","Lucas County",5,77,2501,1131,1370
050,39,095,"Ohio","Lucas County",5,78,2240,1006,1234
050,39,095,"Ohio","Lucas County",5,79,2143,917,1226
050,39,095,"Ohio","Lucas County",5,80,2245,922,1323
050,39,095,"Ohio","Lucas County",5,81,1879,758,1121
050,39,095,"Ohio","Lucas County",5,82,1644,670,974
050,39,095,"Ohio","Lucas County",5,83,1471,553,918
050,39,095,"Ohio","Lucas County",5,84,1310,501,809
050,39,095,"Ohio","Lucas County",5,85,7601,2548,5053
050,39,097,"Ohio","Madison County",1,0,424,219,205
050,39,097,"Ohio","Madison County",1,1,427,216,211
050,39,097,"Ohio","Madison County",1,2,458,241,217
050,39,097,"Ohio","Madison County",1,3,453,219,234
050,39,097,"Ohio","Madison County",1,4,432,226,206
050,39,097,"Ohio","Madison County",1,5,440,221,219
050,39,097,"Ohio","Madison County",1,6,477,226,251
050,39,097,"Ohio","Madison County",1,7,481,245,236
050,39,097,"Ohio","Madison County",1,8,503,269,234
050,39,097,"Ohio","Madison County",1,9,496,249,247
050,39,097,"Ohio","Madison County",1,10,513,257,256
050,39,097,"Ohio","Madison County",1,11,545,257,288
050,39,097,"Ohio","Madison County",1,12,527,262,265
050,39,097,"Ohio","Madison County",1,13,539,271,268
050,39,097,"Ohio","Madison County",1,14,569,293,276
050,39,097,"Ohio","Madison County",1,15,548,281,267
050,39,097,"Ohio","Madison County",1,16,521,285,236
050,39,097,"Ohio","Madison County",1,17,576,330,246
050,39,097,"Ohio","Madison County",1,18,486,277,209
050,39,097,"Ohio","Madison County",1,19,435,256,179
050,39,097,"Ohio","Madison County",1,20,441,266,175
050,39,097,"Ohio","Madison County",1,21,477,284,193
050,39,097,"Ohio","Madison County",1,22,485,293,192
050,39,097,"Ohio","Madison County",1,23,521,314,207
050,39,097,"Ohio","Madison County",1,24,535,310,225
050,39,097,"Ohio","Madison County",1,25,545,326,219
050,39,097,"Ohio","Madison County",1,26,581,342,239
050,39,097,"Ohio","Madison County",1,27,580,353,227
050,39,097,"Ohio","Madison County",1,28,568,346,222
050,39,097,"Ohio","Madison County",1,29,596,374,222
050,39,097,"Ohio","Madison County",1,30,626,377,249
050,39,097,"Ohio","Madison County",1,31,614,396,218
050,39,097,"Ohio","Madison County",1,32,633,387,246
050,39,097,"Ohio","Madison County",1,33,633,383,250
050,39,097,"Ohio","Madison County",1,34,624,386,238
050,39,097,"Ohio","Madison County",1,35,625,393,232
050,39,097,"Ohio","Madison County",1,36,606,372,234
050,39,097,"Ohio","Madison County",1,37,629,370,259
050,39,097,"Ohio","Madison County",1,38,643,384,259
050,39,097,"Ohio","Madison County",1,39,642,397,245
050,39,097,"Ohio","Madison County",1,40,633,387,246
050,39,097,"Ohio","Madison County",1,41,652,391,261
050,39,097,"Ohio","Madison County",1,42,572,331,241
050,39,097,"Ohio","Madison County",1,43,635,408,227
050,39,097,"Ohio","Madison County",1,44,610,374,236
050,39,097,"Ohio","Madison County",1,45,616,369,247
050,39,097,"Ohio","Madison County",1,46,625,361,264
050,39,097,"Ohio","Madison County",1,47,596,348,248
050,39,097,"Ohio","Madison County",1,48,667,393,274
050,39,097,"Ohio","Madison County",1,49,697,410,287
050,39,097,"Ohio","Madison County",1,50,638,369,269
050,39,097,"Ohio","Madison County",1,51,644,368,276
050,39,097,"Ohio","Madison County",1,52,580,324,256
050,39,097,"Ohio","Madison County",1,53,623,329,294
050,39,097,"Ohio","Madison County",1,54,658,335,323
050,39,097,"Ohio","Madison County",1,55,667,356,311
050,39,097,"Ohio","Madison County",1,56,655,358,297
050,39,097,"Ohio","Madison County",1,57,620,334,286
050,39,097,"Ohio","Madison County",1,58,627,339,288
050,39,097,"Ohio","Madison County",1,59,634,336,298
050,39,097,"Ohio","Madison County",1,60,588,309,279
050,39,097,"Ohio","Madison County",1,61,596,313,283
050,39,097,"Ohio","Madison County",1,62,594,319,275
050,39,097,"Ohio","Madison County",1,63,540,279,261
050,39,097,"Ohio","Madison County",1,64,530,266,264
050,39,097,"Ohio","Madison County",1,65,496,253,243
050,39,097,"Ohio","Madison County",1,66,471,223,248
050,39,097,"Ohio","Madison County",1,67,452,223,229
050,39,097,"Ohio","Madison County",1,68,423,195,228
050,39,097,"Ohio","Madison County",1,69,391,189,202
050,39,097,"Ohio","Madison County",1,70,394,185,209
050,39,097,"Ohio","Madison County",1,71,393,193,200
050,39,097,"Ohio","Madison County",1,72,405,198,207
050,39,097,"Ohio","Madison County",1,73,389,183,206
050,39,097,"Ohio","Madison County",1,74,278,132,146
050,39,097,"Ohio","Madison County",1,75,260,126,134
050,39,097,"Ohio","Madison County",1,76,288,138,150
050,39,097,"Ohio","Madison County",1,77,284,136,148
050,39,097,"Ohio","Madison County",1,78,234,101,133
050,39,097,"Ohio","Madison County",1,79,199,84,115
050,39,097,"Ohio","Madison County",1,80,183,76,107
050,39,097,"Ohio","Madison County",1,81,164,72,92
050,39,097,"Ohio","Madison County",1,82,177,77,100
050,39,097,"Ohio","Madison County",1,83,171,71,100
050,39,097,"Ohio","Madison County",1,84,149,53,96
050,39,097,"Ohio","Madison County",1,85,691,253,438
050,39,097,"Ohio","Madison County",2,0,431,219,212
050,39,097,"Ohio","Madison County",2,1,429,219,210
050,39,097,"Ohio","Madison County",2,2,452,234,218
050,39,097,"Ohio","Madison County",2,3,450,224,226
050,39,097,"Ohio","Madison County",2,4,438,224,214
050,39,097,"Ohio","Madison County",2,5,437,221,216
050,39,097,"Ohio","Madison County",2,6,472,229,243
050,39,097,"Ohio","Madison County",2,7,483,244,239
050,39,097,"Ohio","Madison County",2,8,497,264,233
050,39,097,"Ohio","Madison County",2,9,496,254,242
050,39,097,"Ohio","Madison County",2,10,515,256,259
050,39,097,"Ohio","Madison County",2,11,536,255,281
050,39,097,"Ohio","Madison County",2,12,531,262,269
050,39,097,"Ohio","Madison County",2,13,538,272,266
050,39,097,"Ohio","Madison County",2,14,563,288,275
050,39,097,"Ohio","Madison County",2,15,550,282,268
050,39,097,"Ohio","Madison County",2,16,525,281,244
050,39,097,"Ohio","Madison County",2,17,571,330,241
050,39,097,"Ohio","Madison County",2,18,486,277,209
050,39,097,"Ohio","Madison County",2,19,433,255,178
050,39,097,"Ohio","Madison County",2,20,445,266,179
050,39,097,"Ohio","Madison County",2,21,476,285,191
050,39,097,"Ohio","Madison County",2,22,490,295,195
050,39,097,"Ohio","Madison County",2,23,517,310,207
050,39,097,"Ohio","Madison County",2,24,527,309,218
050,39,097,"Ohio","Madison County",2,25,546,324,222
050,39,097,"Ohio","Madison County",2,26,572,336,236
050,39,097,"Ohio","Madison County",2,27,583,353,230
050,39,097,"Ohio","Madison County",2,28,570,348,222
050,39,097,"Ohio","Madison County",2,29,598,375,223
050,39,097,"Ohio","Madison County",2,30,616,373,243
050,39,097,"Ohio","Madison County",2,31,623,399,224
050,39,097,"Ohio","Madison County",2,32,628,387,241
050,39,097,"Ohio","Madison County",2,33,630,380,250
050,39,097,"Ohio","Madison County",2,34,621,381,240
050,39,097,"Ohio","Madison County",2,35,630,394,236
050,39,097,"Ohio","Madison County",2,36,604,371,233
050,39,097,"Ohio","Madison County",2,37,625,371,254
050,39,097,"Ohio","Madison County",2,38,641,382,259
050,39,097,"Ohio","Madison County",2,39,640,393,247
050,39,097,"Ohio","Madison County",2,40,634,389,245
050,39,097,"Ohio","Madison County",2,41,652,393,259
050,39,097,"Ohio","Madison County",2,42,581,336,245
050,39,097,"Ohio","Madison County",2,43,634,400,234
050,39,097,"Ohio","Madison County",2,44,603,372,231
050,39,097,"Ohio","Madison County",2,45,613,369,244
050,39,097,"Ohio","Madison County",2,46,622,363,259
050,39,097,"Ohio","Madison County",2,47,601,348,253
050,39,097,"Ohio","Madison County",2,48,651,383,268
050,39,097,"Ohio","Madison County",2,49,682,401,281
050,39,097,"Ohio","Madison County",2,50,651,375,276
050,39,097,"Ohio","Madison County",2,51,642,368,274
050,39,097,"Ohio","Madison County",2,52,591,330,261
050,39,097,"Ohio","Madison County",2,53,623,333,290
050,39,097,"Ohio","Madison County",2,54,648,333,315
050,39,097,"Ohio","Madison County",2,55,660,347,313
050,39,097,"Ohio","Madison County",2,56,659,356,303
050,39,097,"Ohio","Madison County",2,57,630,341,289
050,39,097,"Ohio","Madison County",2,58,621,335,286
050,39,097,"Ohio","Madison County",2,59,633,335,298
050,39,097,"Ohio","Madison County",2,60,595,313,282
050,39,097,"Ohio","Madison County",2,61,590,311,279
050,39,097,"Ohio","Madison County",2,62,591,314,277
050,39,097,"Ohio","Madison County",2,63,557,291,266
050,39,097,"Ohio","Madison County",2,64,531,268,263
050,39,097,"Ohio","Madison County",2,65,503,256,247
050,39,097,"Ohio","Madison County",2,66,470,227,243
050,39,097,"Ohio","Madison County",2,67,455,223,232
050,39,097,"Ohio","Madison County",2,68,425,197,228
050,39,097,"Ohio","Madison County",2,69,404,194,210
050,39,097,"Ohio","Madison County",2,70,395,185,210
050,39,097,"Ohio","Madison County",2,71,390,191,199
050,39,097,"Ohio","Madison County",2,72,394,190,204
050,39,097,"Ohio","Madison County",2,73,411,193,218
050,39,097,"Ohio","Madison County",2,74,283,133,150
050,39,097,"Ohio","Madison County",2,75,260,125,135
050,39,097,"Ohio","Madison County",2,76,276,131,145
050,39,097,"Ohio","Madison County",2,77,288,136,152
050,39,097,"Ohio","Madison County",2,78,237,106,131
050,39,097,"Ohio","Madison County",2,79,203,85,118
050,39,097,"Ohio","Madison County",2,80,184,78,106
050,39,097,"Ohio","Madison County",2,81,165,72,93
050,39,097,"Ohio","Madison County",2,82,174,74,100
050,39,097,"Ohio","Madison County",2,83,171,73,98
050,39,097,"Ohio","Madison County",2,84,150,57,93
050,39,097,"Ohio","Madison County",2,85,701,253,448
050,39,097,"Ohio","Madison County",3,0,413,222,191
050,39,097,"Ohio","Madison County",3,1,439,236,203
050,39,097,"Ohio","Madison County",3,2,444,237,207
050,39,097,"Ohio","Madison County",3,3,469,246,223
050,39,097,"Ohio","Madison County",3,4,466,221,245
050,39,097,"Ohio","Madison County",3,5,465,240,225
050,39,097,"Ohio","Madison County",3,6,452,235,217
050,39,097,"Ohio","Madison County",3,7,472,235,237
050,39,097,"Ohio","Madison County",3,8,476,240,236
050,39,097,"Ohio","Madison County",3,9,491,256,235
050,39,097,"Ohio","Madison County",3,10,507,257,250
050,39,097,"Ohio","Madison County",3,11,509,255,254
050,39,097,"Ohio","Madison County",3,12,531,246,285
050,39,097,"Ohio","Madison County",3,13,529,258,271
050,39,097,"Ohio","Madison County",3,14,533,272,261
050,39,097,"Ohio","Madison County",3,15,556,281,275
050,39,097,"Ohio","Madison County",3,16,555,290,265
050,39,097,"Ohio","Madison County",3,17,583,342,241
050,39,097,"Ohio","Madison County",3,18,492,291,201
050,39,097,"Ohio","Madison County",3,19,432,254,178
050,39,097,"Ohio","Madison County",3,20,449,268,181
050,39,097,"Ohio","Madison County",3,21,478,287,191
050,39,097,"Ohio","Madison County",3,22,515,305,210
050,39,097,"Ohio","Madison County",3,23,476,287,189
050,39,097,"Ohio","Madison County",3,24,536,315,221
050,39,097,"Ohio","Madison County",3,25,532,324,208
050,39,097,"Ohio","Madison County",3,26,591,346,245
050,39,097,"Ohio","Madison County",3,27,609,370,239
050,39,097,"Ohio","Madison County",3,28,615,368,247
050,39,097,"Ohio","Madison County",3,29,608,375,233
050,39,097,"Ohio","Madison County",3,30,627,373,254
050,39,097,"Ohio","Madison County",3,31,673,433,240
050,39,097,"Ohio","Madison County",3,32,670,436,234
050,39,097,"Ohio","Madison County",3,33,643,388,255
050,39,097,"Ohio","Madison County",3,34,641,384,257
050,39,097,"Ohio","Madison County",3,35,658,410,248
050,39,097,"Ohio","Madison County",3,36,658,413,245
050,39,097,"Ohio","Madison County",3,37,640,398,242
050,39,097,"Ohio","Madison County",3,38,645,387,258
050,39,097,"Ohio","Madison County",3,39,664,403,261
050,39,097,"Ohio","Madison County",3,40,661,418,243
050,39,097,"Ohio","Madison County",3,41,669,424,245
050,39,097,"Ohio","Madison County",3,42,617,370,247
050,39,097,"Ohio","Madison County",3,43,622,378,244
050,39,097,"Ohio","Madison County",3,44,615,377,238
050,39,097,"Ohio","Madison County",3,45,606,377,229
050,39,097,"Ohio","Madison County",3,46,624,373,251
050,39,097,"Ohio","Madison County",3,47,621,361,260
050,39,097,"Ohio","Madison County",3,48,610,354,256
050,39,097,"Ohio","Madison County",3,49,632,364,268
050,39,097,"Ohio","Madison County",3,50,676,389,287
050,39,097,"Ohio","Madison County",3,51,657,379,278
050,39,097,"Ohio","Madison County",3,52,631,365,266
050,39,097,"Ohio","Madison County",3,53,616,354,262
050,39,097,"Ohio","Madison County",3,54,624,334,290
050,39,097,"Ohio","Madison County",3,55,641,324,317
050,39,097,"Ohio","Madison County",3,56,667,351,316
050,39,097,"Ohio","Madison County",3,57,653,350,303
050,39,097,"Ohio","Madison County",3,58,614,334,280
050,39,097,"Ohio","Madison County",3,59,612,328,284
050,39,097,"Ohio","Madison County",3,60,632,324,308
050,39,097,"Ohio","Madison County",3,61,589,309,280
050,39,097,"Ohio","Madison County",3,62,577,300,277
050,39,097,"Ohio","Madison County",3,63,575,306,269
050,39,097,"Ohio","Madison County",3,64,560,289,271
050,39,097,"Ohio","Madison County",3,65,522,267,255
050,39,097,"Ohio","Madison County",3,66,494,249,245
050,39,097,"Ohio","Madison County",3,67,465,228,237
050,39,097,"Ohio","Madison County",3,68,440,209,231
050,39,097,"Ohio","Madison County",3,69,418,194,224
050,39,097,"Ohio","Madison County",3,70,395,188,207
050,39,097,"Ohio","Madison County",3,71,387,181,206
050,39,097,"Ohio","Madison County",3,72,378,184,194
050,39,097,"Ohio","Madison County",3,73,390,184,206
050,39,097,"Ohio","Madison County",3,74,394,188,206
050,39,097,"Ohio","Madison County",3,75,266,123,143
050,39,097,"Ohio","Madison County",3,76,244,115,129
050,39,097,"Ohio","Madison County",3,77,258,122,136
050,39,097,"Ohio","Madison County",3,78,275,128,147
050,39,097,"Ohio","Madison County",3,79,217,96,121
050,39,097,"Ohio","Madison County",3,80,186,80,106
050,39,097,"Ohio","Madison County",3,81,176,71,105
050,39,097,"Ohio","Madison County",3,82,165,68,97
050,39,097,"Ohio","Madison County",3,83,160,61,99
050,39,097,"Ohio","Madison County",3,84,146,65,81
050,39,097,"Ohio","Madison County",3,85,709,243,466
050,39,097,"Ohio","Madison County",4,0,436,230,206
050,39,097,"Ohio","Madison County",4,1,439,225,214
050,39,097,"Ohio","Madison County",4,2,433,223,210
050,39,097,"Ohio","Madison County",4,3,456,246,210
050,39,097,"Ohio","Madison County",4,4,453,243,210
050,39,097,"Ohio","Madison County",4,5,475,218,257
050,39,097,"Ohio","Madison County",4,6,475,243,232
050,39,097,"Ohio","Madison County",4,7,455,241,214
050,39,097,"Ohio","Madison County",4,8,458,219,239
050,39,097,"Ohio","Madison County",4,9,470,234,236
050,39,097,"Ohio","Madison County",4,10,495,252,243
050,39,097,"Ohio","Madison County",4,11,500,249,251
050,39,097,"Ohio","Madison County",4,12,520,257,263
050,39,097,"Ohio","Madison County",4,13,532,241,291
050,39,097,"Ohio","Madison County",4,14,535,267,268
050,39,097,"Ohio","Madison County",4,15,539,272,267
050,39,097,"Ohio","Madison County",4,16,556,281,275
050,39,097,"Ohio","Madison County",4,17,587,334,253
050,39,097,"Ohio","Madison County",4,18,497,291,206
050,39,097,"Ohio","Madison County",4,19,409,242,167
050,39,097,"Ohio","Madison County",4,20,442,263,179
050,39,097,"Ohio","Madison County",4,21,470,278,192
050,39,097,"Ohio","Madison County",4,22,489,281,208
050,39,097,"Ohio","Madison County",4,23,509,285,224
050,39,097,"Ohio","Madison County",4,24,459,260,199
050,39,097,"Ohio","Madison County",4,25,520,314,206
050,39,097,"Ohio","Madison County",4,26,529,313,216
050,39,097,"Ohio","Madison County",4,27,576,345,231
050,39,097,"Ohio","Madison County",4,28,568,335,233
050,39,097,"Ohio","Madison County",4,29,609,372,237
050,39,097,"Ohio","Madison County",4,30,595,348,247
050,39,097,"Ohio","Madison County",4,31,653,397,256
050,39,097,"Ohio","Madison County",4,32,651,398,253
050,39,097,"Ohio","Madison County",4,33,655,411,244
050,39,097,"Ohio","Madison County",4,34,590,346,244
050,39,097,"Ohio","Madison County",4,35,620,353,267
050,39,097,"Ohio","Madison County",4,36,622,368,254
050,39,097,"Ohio","Madison County",4,37,636,388,248
050,39,097,"Ohio","Madison County",4,38,613,368,245
050,39,097,"Ohio","Madison County",4,39,605,354,251
050,39,097,"Ohio","Madison County",4,40,648,376,272
050,39,097,"Ohio","Madison County",4,41,669,418,251
050,39,097,"Ohio","Madison County",4,42,596,356,240
050,39,097,"Ohio","Madison County",4,43,622,379,243
050,39,097,"Ohio","Madison County",4,44,567,324,243
050,39,097,"Ohio","Madison County",4,45,567,336,231
050,39,097,"Ohio","Madison County",4,46,592,357,235
050,39,097,"Ohio","Madison County",4,47,580,336,244
050,39,097,"Ohio","Madison County",4,48,611,345,266
050,39,097,"Ohio","Madison County",4,49,557,308,249
050,39,097,"Ohio","Madison County",4,50,613,340,273
050,39,097,"Ohio","Madison County",4,51,659,372,287
050,39,097,"Ohio","Madison County",4,52,627,362,265
050,39,097,"Ohio","Madison County",4,53,638,371,267
050,39,097,"Ohio","Madison County",4,54,609,337,272
050,39,097,"Ohio","Madison County",4,55,599,313,286
050,39,097,"Ohio","Madison County",4,56,613,291,322
050,39,097,"Ohio","Madison County",4,57,658,339,319
050,39,097,"Ohio","Madison County",4,58,650,343,307
050,39,097,"Ohio","Madison County",4,59,611,330,281
050,39,097,"Ohio","Madison County",4,60,598,312,286
050,39,097,"Ohio","Madison County",4,61,614,316,298
050,39,097,"Ohio","Madison County",4,62,568,293,275
050,39,097,"Ohio","Madison County",4,63,563,290,273
050,39,097,"Ohio","Madison County",4,64,576,300,276
050,39,097,"Ohio","Madison County",4,65,530,271,259
050,39,097,"Ohio","Madison County",4,66,510,256,254
050,39,097,"Ohio","Madison County",4,67,489,248,241
050,39,097,"Ohio","Madison County",4,68,453,224,229
050,39,097,"Ohio","Madison County",4,69,433,207,226
050,39,097,"Ohio","Madison County",4,70,409,185,224
050,39,097,"Ohio","Madison County",4,71,386,180,206
050,39,097,"Ohio","Madison County",4,72,373,171,202
050,39,097,"Ohio","Madison County",4,73,364,174,190
050,39,097,"Ohio","Madison County",4,74,370,177,193
050,39,097,"Ohio","Madison County",4,75,380,181,199
050,39,097,"Ohio","Madison County",4,76,265,121,144
050,39,097,"Ohio","Madison County",4,77,237,105,132
050,39,097,"Ohio","Madison County",4,78,252,114,138
050,39,097,"Ohio","Madison County",4,79,248,115,133
050,39,097,"Ohio","Madison County",4,80,198,92,106
050,39,097,"Ohio","Madison County",4,81,164,72,92
050,39,097,"Ohio","Madison County",4,82,180,67,113
050,39,097,"Ohio","Madison County",4,83,150,54,96
050,39,097,"Ohio","Madison County",4,84,139,54,85
050,39,097,"Ohio","Madison County",4,85,715,252,463
050,39,097,"Ohio","Madison County",5,0,439,234,205
050,39,097,"Ohio","Madison County",5,1,425,223,202
050,39,097,"Ohio","Madison County",5,2,445,225,220
050,39,097,"Ohio","Madison County",5,3,464,236,228
050,39,097,"Ohio","Madison County",5,4,459,252,207
050,39,097,"Ohio","Madison County",5,5,457,240,217
050,39,097,"Ohio","Madison County",5,6,479,227,252
050,39,097,"Ohio","Madison County",5,7,470,239,231
050,39,097,"Ohio","Madison County",5,8,471,248,223
050,39,097,"Ohio","Madison County",5,9,476,234,242
050,39,097,"Ohio","Madison County",5,10,474,238,236
050,39,097,"Ohio","Madison County",5,11,505,243,262
050,39,097,"Ohio","Madison County",5,12,485,244,241
050,39,097,"Ohio","Madison County",5,13,530,265,265
050,39,097,"Ohio","Madison County",5,14,525,249,276
050,39,097,"Ohio","Madison County",5,15,512,252,260
050,39,097,"Ohio","Madison County",5,16,541,283,258
050,39,097,"Ohio","Madison County",5,17,605,335,270
050,39,097,"Ohio","Madison County",5,18,509,297,212
050,39,097,"Ohio","Madison County",5,19,447,269,178
050,39,097,"Ohio","Madison County",5,20,438,267,171
050,39,097,"Ohio","Madison County",5,21,478,296,182
050,39,097,"Ohio","Madison County",5,22,508,302,206
050,39,097,"Ohio","Madison County",5,23,546,310,236
050,39,097,"Ohio","Madison County",5,24,507,278,229
050,39,097,"Ohio","Madison County",5,25,468,286,182
050,39,097,"Ohio","Madison County",5,26,566,345,221
050,39,097,"Ohio","Madison County",5,27,586,354,232
050,39,097,"Ohio","Madison County",5,28,586,353,233
050,39,097,"Ohio","Madison County",5,29,586,356,230
050,39,097,"Ohio","Madison County",5,30,638,393,245
050,39,097,"Ohio","Madison County",5,31,683,419,264
050,39,097,"Ohio","Madison County",5,32,718,434,284
050,39,097,"Ohio","Madison County",5,33,685,426,259
050,39,097,"Ohio","Madison County",5,34,662,417,245
050,39,097,"Ohio","Madison County",5,35,626,362,264
050,39,097,"Ohio","Madison County",5,36,647,379,268
050,39,097,"Ohio","Madison County",5,37,657,403,254
050,39,097,"Ohio","Madison County",5,38,662,409,253
050,39,097,"Ohio","Madison County",5,39,643,395,248
050,39,097,"Ohio","Madison County",5,40,631,371,260
050,39,097,"Ohio","Madison County",5,41,687,406,281
050,39,097,"Ohio","Madison County",5,42,650,395,255
050,39,097,"Ohio","Madison County",5,43,667,420,247
050,39,097,"Ohio","Madison County",5,44,617,361,256
050,39,097,"Ohio","Madison County",5,45,586,335,251
050,39,097,"Ohio","Madison County",5,46,585,346,239
050,39,097,"Ohio","Madison County",5,47,613,371,242
050,39,097,"Ohio","Madison County",5,48,612,364,248
050,39,097,"Ohio","Madison County",5,49,609,351,258
050,39,097,"Ohio","Madison County",5,50,562,301,261
050,39,097,"Ohio","Madison County",5,51,615,334,281
050,39,097,"Ohio","Madison County",5,52,647,363,284
050,39,097,"Ohio","Madison County",5,53,655,392,263
050,39,097,"Ohio","Madison County",5,54,636,369,267
050,39,097,"Ohio","Madison County",5,55,611,339,272
050,39,097,"Ohio","Madison County",5,56,594,307,287
050,39,097,"Ohio","Madison County",5,57,620,295,325
050,39,097,"Ohio","Madison County",5,58,662,336,326
050,39,097,"Ohio","Madison County",5,59,657,345,312
050,39,097,"Ohio","Madison County",5,60,604,322,282
050,39,097,"Ohio","Madison County",5,61,595,319,276
050,39,097,"Ohio","Madison County",5,62,608,313,295
050,39,097,"Ohio","Madison County",5,63,553,283,270
050,39,097,"Ohio","Madison County",5,64,570,288,282
050,39,097,"Ohio","Madison County",5,65,579,305,274
050,39,097,"Ohio","Madison County",5,66,524,261,263
050,39,097,"Ohio","Madison County",5,67,516,264,252
050,39,097,"Ohio","Madison County",5,68,479,237,242
050,39,097,"Ohio","Madison County",5,69,468,236,232
050,39,097,"Ohio","Madison County",5,70,431,200,231
050,39,097,"Ohio","Madison County",5,71,397,182,215
050,39,097,"Ohio","Madison County",5,72,382,182,200
050,39,097,"Ohio","Madison County",5,73,376,170,206
050,39,097,"Ohio","Madison County",5,74,356,169,187
050,39,097,"Ohio","Madison County",5,75,349,165,184
050,39,097,"Ohio","Madison County",5,76,367,172,195
050,39,097,"Ohio","Madison County",5,77,248,112,136
050,39,097,"Ohio","Madison County",5,78,228,96,132
050,39,097,"Ohio","Madison County",5,79,236,105,131
050,39,097,"Ohio","Madison County",5,80,225,102,123
050,39,097,"Ohio","Madison County",5,81,186,84,102
050,39,097,"Ohio","Madison County",5,82,165,68,97
050,39,097,"Ohio","Madison County",5,83,170,55,115
050,39,097,"Ohio","Madison County",5,84,127,48,79
050,39,097,"Ohio","Madison County",5,85,739,252,487
050,39,099,"Ohio","Mahoning County",1,0,2339,1202,1137
050,39,099,"Ohio","Mahoning County",1,1,2399,1238,1161
050,39,099,"Ohio","Mahoning County",1,2,2469,1242,1227
050,39,099,"Ohio","Mahoning County",1,3,2581,1326,1255
050,39,099,"Ohio","Mahoning County",1,4,2468,1244,1224
050,39,099,"Ohio","Mahoning County",1,5,2508,1272,1236
050,39,099,"Ohio","Mahoning County",1,6,2442,1227,1215
050,39,099,"Ohio","Mahoning County",1,7,2480,1290,1190
050,39,099,"Ohio","Mahoning County",1,8,2400,1248,1152
050,39,099,"Ohio","Mahoning County",1,9,2465,1257,1208
050,39,099,"Ohio","Mahoning County",1,10,2511,1307,1204
050,39,099,"Ohio","Mahoning County",1,11,2672,1365,1307
050,39,099,"Ohio","Mahoning County",1,12,2752,1428,1324
050,39,099,"Ohio","Mahoning County",1,13,2786,1490,1296
050,39,099,"Ohio","Mahoning County",1,14,2806,1430,1376
050,39,099,"Ohio","Mahoning County",1,15,2791,1444,1347
050,39,099,"Ohio","Mahoning County",1,16,2867,1508,1359
050,39,099,"Ohio","Mahoning County",1,17,2893,1524,1369
050,39,099,"Ohio","Mahoning County",1,18,2677,1416,1261
050,39,099,"Ohio","Mahoning County",1,19,2428,1260,1168
050,39,099,"Ohio","Mahoning County",1,20,2554,1335,1219
050,39,099,"Ohio","Mahoning County",1,21,2746,1396,1350
050,39,099,"Ohio","Mahoning County",1,22,2703,1360,1343
050,39,099,"Ohio","Mahoning County",1,23,2688,1351,1337
050,39,099,"Ohio","Mahoning County",1,24,2729,1375,1354
050,39,099,"Ohio","Mahoning County",1,25,2685,1380,1305
050,39,099,"Ohio","Mahoning County",1,26,2748,1456,1292
050,39,099,"Ohio","Mahoning County",1,27,2882,1480,1402
050,39,099,"Ohio","Mahoning County",1,28,2966,1522,1444
050,39,099,"Ohio","Mahoning County",1,29,2885,1501,1384
050,39,099,"Ohio","Mahoning County",1,30,2734,1429,1305
050,39,099,"Ohio","Mahoning County",1,31,2673,1380,1293
050,39,099,"Ohio","Mahoning County",1,32,2532,1336,1196
050,39,099,"Ohio","Mahoning County",1,33,2515,1299,1216
050,39,099,"Ohio","Mahoning County",1,34,2536,1295,1241
050,39,099,"Ohio","Mahoning County",1,35,2495,1225,1270
050,39,099,"Ohio","Mahoning County",1,36,2436,1239,1197
050,39,099,"Ohio","Mahoning County",1,37,2521,1245,1276
050,39,099,"Ohio","Mahoning County",1,38,2605,1290,1315
050,39,099,"Ohio","Mahoning County",1,39,2652,1323,1329
050,39,099,"Ohio","Mahoning County",1,40,2643,1336,1307
050,39,099,"Ohio","Mahoning County",1,41,2546,1237,1309
050,39,099,"Ohio","Mahoning County",1,42,2564,1264,1300
050,39,099,"Ohio","Mahoning County",1,43,2568,1320,1248
050,39,099,"Ohio","Mahoning County",1,44,2457,1255,1202
050,39,099,"Ohio","Mahoning County",1,45,2461,1244,1217
050,39,099,"Ohio","Mahoning County",1,46,2466,1242,1224
050,39,099,"Ohio","Mahoning County",1,47,2557,1250,1307
050,39,099,"Ohio","Mahoning County",1,48,2802,1413,1389
050,39,099,"Ohio","Mahoning County",1,49,2930,1466,1464
050,39,099,"Ohio","Mahoning County",1,50,2861,1412,1449
050,39,099,"Ohio","Mahoning County",1,51,2751,1381,1370
050,39,099,"Ohio","Mahoning County",1,52,2755,1394,1361
050,39,099,"Ohio","Mahoning County",1,53,2875,1466,1409
050,39,099,"Ohio","Mahoning County",1,54,2915,1475,1440
050,39,099,"Ohio","Mahoning County",1,55,3017,1504,1513
050,39,099,"Ohio","Mahoning County",1,56,3119,1543,1576
050,39,099,"Ohio","Mahoning County",1,57,3257,1586,1671
050,39,099,"Ohio","Mahoning County",1,58,3452,1658,1794
050,39,099,"Ohio","Mahoning County",1,59,3458,1652,1806
050,39,099,"Ohio","Mahoning County",1,60,3418,1651,1767
050,39,099,"Ohio","Mahoning County",1,61,3556,1687,1869
050,39,099,"Ohio","Mahoning County",1,62,3697,1747,1950
050,39,099,"Ohio","Mahoning County",1,63,3636,1718,1918
050,39,099,"Ohio","Mahoning County",1,64,3486,1650,1836
050,39,099,"Ohio","Mahoning County",1,65,3447,1625,1822
050,39,099,"Ohio","Mahoning County",1,66,3349,1617,1732
050,39,099,"Ohio","Mahoning County",1,67,3296,1612,1684
050,39,099,"Ohio","Mahoning County",1,68,3200,1575,1625
050,39,099,"Ohio","Mahoning County",1,69,2965,1431,1534
050,39,099,"Ohio","Mahoning County",1,70,2814,1322,1492
050,39,099,"Ohio","Mahoning County",1,71,2749,1302,1447
050,39,099,"Ohio","Mahoning County",1,72,2761,1320,1441
050,39,099,"Ohio","Mahoning County",1,73,2619,1238,1381
050,39,099,"Ohio","Mahoning County",1,74,1746,798,948
050,39,099,"Ohio","Mahoning County",1,75,1655,735,920
050,39,099,"Ohio","Mahoning County",1,76,1708,729,979
050,39,099,"Ohio","Mahoning County",1,77,1808,767,1041
050,39,099,"Ohio","Mahoning County",1,78,1607,677,930
050,39,099,"Ohio","Mahoning County",1,79,1409,577,832
050,39,099,"Ohio","Mahoning County",1,80,1278,543,735
050,39,099,"Ohio","Mahoning County",1,81,1234,512,722
050,39,099,"Ohio","Mahoning County",1,82,1143,467,676
050,39,099,"Ohio","Mahoning County",1,83,1056,411,645
050,39,099,"Ohio","Mahoning County",1,84,998,378,620
050,39,099,"Ohio","Mahoning County",1,85,6504,2097,4407
050,39,099,"Ohio","Mahoning County",2,0,2322,1208,1114
050,39,099,"Ohio","Mahoning County",2,1,2380,1228,1152
050,39,099,"Ohio","Mahoning County",2,2,2463,1248,1215
050,39,099,"Ohio","Mahoning County",2,3,2541,1302,1239
050,39,099,"Ohio","Mahoning County",2,4,2501,1271,1230
050,39,099,"Ohio","Mahoning County",2,5,2499,1267,1232
050,39,099,"Ohio","Mahoning County",2,6,2465,1242,1223
050,39,099,"Ohio","Mahoning County",2,7,2463,1268,1195
050,39,099,"Ohio","Mahoning County",2,8,2407,1251,1156
050,39,099,"Ohio","Mahoning County",2,9,2440,1253,1187
050,39,099,"Ohio","Mahoning County",2,10,2494,1291,1203
050,39,099,"Ohio","Mahoning County",2,11,2619,1343,1276
050,39,099,"Ohio","Mahoning County",2,12,2743,1415,1328
050,39,099,"Ohio","Mahoning County",2,13,2776,1471,1305
050,39,099,"Ohio","Mahoning County",2,14,2796,1443,1353
050,39,099,"Ohio","Mahoning County",2,15,2800,1443,1357
050,39,099,"Ohio","Mahoning County",2,16,2845,1487,1358
050,39,099,"Ohio","Mahoning County",2,17,2889,1523,1366
050,39,099,"Ohio","Mahoning County",2,18,2650,1404,1246
050,39,099,"Ohio","Mahoning County",2,19,2442,1269,1173
050,39,099,"Ohio","Mahoning County",2,20,2593,1351,1242
050,39,099,"Ohio","Mahoning County",2,21,2718,1389,1329
050,39,099,"Ohio","Mahoning County",2,22,2720,1372,1348
050,39,099,"Ohio","Mahoning County",2,23,2696,1354,1342
050,39,099,"Ohio","Mahoning County",2,24,2701,1365,1336
050,39,099,"Ohio","Mahoning County",2,25,2691,1384,1307
050,39,099,"Ohio","Mahoning County",2,26,2748,1451,1297
050,39,099,"Ohio","Mahoning County",2,27,2836,1463,1373
050,39,099,"Ohio","Mahoning County",2,28,2956,1522,1434
050,39,099,"Ohio","Mahoning County",2,29,2913,1514,1399
050,39,099,"Ohio","Mahoning County",2,30,2787,1449,1338
050,39,099,"Ohio","Mahoning County",2,31,2680,1390,1290
050,39,099,"Ohio","Mahoning County",2,32,2560,1341,1219
050,39,099,"Ohio","Mahoning County",2,33,2508,1301,1207
050,39,099,"Ohio","Mahoning County",2,34,2534,1296,1238
050,39,099,"Ohio","Mahoning County",2,35,2514,1251,1263
050,39,099,"Ohio","Mahoning County",2,36,2440,1228,1212
050,39,099,"Ohio","Mahoning County",2,37,2503,1246,1257
050,39,099,"Ohio","Mahoning County",2,38,2582,1278,1304
050,39,099,"Ohio","Mahoning County",2,39,2626,1307,1319
050,39,099,"Ohio","Mahoning County",2,40,2659,1338,1321
050,39,099,"Ohio","Mahoning County",2,41,2552,1248,1304
050,39,099,"Ohio","Mahoning County",2,42,2540,1248,1292
050,39,099,"Ohio","Mahoning County",2,43,2579,1311,1268
050,39,099,"Ohio","Mahoning County",2,44,2455,1261,1194
050,39,099,"Ohio","Mahoning County",2,45,2466,1244,1222
050,39,099,"Ohio","Mahoning County",2,46,2451,1237,1214
050,39,099,"Ohio","Mahoning County",2,47,2522,1242,1280
050,39,099,"Ohio","Mahoning County",2,48,2734,1368,1366
050,39,099,"Ohio","Mahoning County",2,49,2905,1454,1451
050,39,099,"Ohio","Mahoning County",2,50,2871,1421,1450
050,39,099,"Ohio","Mahoning County",2,51,2762,1379,1383
050,39,099,"Ohio","Mahoning County",2,52,2738,1380,1358
050,39,099,"Ohio","Mahoning County",2,53,2837,1447,1390
050,39,099,"Ohio","Mahoning County",2,54,2891,1468,1423
050,39,099,"Ohio","Mahoning County",2,55,2987,1501,1486
050,39,099,"Ohio","Mahoning County",2,56,3088,1528,1560
050,39,099,"Ohio","Mahoning County",2,57,3223,1576,1647
050,39,099,"Ohio","Mahoning County",2,58,3382,1625,1757
050,39,099,"Ohio","Mahoning County",2,59,3450,1647,1803
050,39,099,"Ohio","Mahoning County",2,60,3404,1638,1766
050,39,099,"Ohio","Mahoning County",2,61,3502,1667,1835
050,39,099,"Ohio","Mahoning County",2,62,3645,1723,1922
050,39,099,"Ohio","Mahoning County",2,63,3680,1742,1938
050,39,099,"Ohio","Mahoning County",2,64,3496,1652,1844
050,39,099,"Ohio","Mahoning County",2,65,3445,1628,1817
050,39,099,"Ohio","Mahoning County",2,66,3366,1611,1755
050,39,099,"Ohio","Mahoning County",2,67,3286,1602,1684
050,39,099,"Ohio","Mahoning County",2,68,3191,1567,1624
050,39,099,"Ohio","Mahoning County",2,69,3030,1469,1561
050,39,099,"Ohio","Mahoning County",2,70,2814,1330,1484
050,39,099,"Ohio","Mahoning County",2,71,2747,1290,1457
050,39,099,"Ohio","Mahoning County",2,72,2695,1280,1415
050,39,099,"Ohio","Mahoning County",2,73,2765,1310,1455
050,39,099,"Ohio","Mahoning County",2,74,1812,833,979
050,39,099,"Ohio","Mahoning County",2,75,1672,747,925
050,39,099,"Ohio","Mahoning County",2,76,1653,713,940
050,39,099,"Ohio","Mahoning County",2,77,1795,766,1029
050,39,099,"Ohio","Mahoning County",2,78,1603,676,927
050,39,099,"Ohio","Mahoning County",2,79,1436,593,843
050,39,099,"Ohio","Mahoning County",2,80,1278,533,745
050,39,099,"Ohio","Mahoning County",2,81,1209,505,704
050,39,099,"Ohio","Mahoning County",2,82,1135,463,672
050,39,099,"Ohio","Mahoning County",2,83,1059,412,647
050,39,099,"Ohio","Mahoning County",2,84,989,378,611
050,39,099,"Ohio","Mahoning County",2,85,6369,2060,4309
050,39,099,"Ohio","Mahoning County",3,0,2271,1112,1159
050,39,099,"Ohio","Mahoning County",3,1,2347,1202,1145
050,39,099,"Ohio","Mahoning County",3,2,2412,1260,1152
050,39,099,"Ohio","Mahoning County",3,3,2476,1247,1229
050,39,099,"Ohio","Mahoning County",3,4,2559,1324,1235
050,39,099,"Ohio","Mahoning County",3,5,2527,1253,1274
050,39,099,"Ohio","Mahoning County",3,6,2520,1280,1240
050,39,099,"Ohio","Mahoning County",3,7,2468,1246,1222
050,39,099,"Ohio","Mahoning County",3,8,2453,1257,1196
050,39,099,"Ohio","Mahoning County",3,9,2441,1282,1159
050,39,099,"Ohio","Mahoning County",3,10,2433,1266,1167
050,39,099,"Ohio","Mahoning County",3,11,2477,1277,1200
050,39,099,"Ohio","Mahoning County",3,12,2602,1326,1276
050,39,099,"Ohio","Mahoning County",3,13,2734,1412,1322
050,39,099,"Ohio","Mahoning County",3,14,2761,1465,1296
050,39,099,"Ohio","Mahoning County",3,15,2827,1466,1361
050,39,099,"Ohio","Mahoning County",3,16,2753,1421,1332
050,39,099,"Ohio","Mahoning County",3,17,2852,1508,1344
050,39,099,"Ohio","Mahoning County",3,18,2619,1408,1211
050,39,099,"Ohio","Mahoning County",3,19,2386,1247,1139
050,39,099,"Ohio","Mahoning County",3,20,2575,1333,1242
050,39,099,"Ohio","Mahoning County",3,21,2685,1393,1292
050,39,099,"Ohio","Mahoning County",3,22,2774,1415,1359
050,39,099,"Ohio","Mahoning County",3,23,2756,1383,1373
050,39,099,"Ohio","Mahoning County",3,24,2683,1376,1307
050,39,099,"Ohio","Mahoning County",3,25,2685,1348,1337
050,39,099,"Ohio","Mahoning County",3,26,2707,1380,1327
050,39,099,"Ohio","Mahoning County",3,27,2701,1398,1303
050,39,099,"Ohio","Mahoning County",3,28,2835,1457,1378
050,39,099,"Ohio","Mahoning County",3,29,2966,1526,1440
050,39,099,"Ohio","Mahoning County",3,30,2909,1489,1420
050,39,099,"Ohio","Mahoning County",3,31,2799,1443,1356
050,39,099,"Ohio","Mahoning County",3,32,2697,1411,1286
050,39,099,"Ohio","Mahoning County",3,33,2559,1342,1217
050,39,099,"Ohio","Mahoning County",3,34,2531,1299,1232
050,39,099,"Ohio","Mahoning County",3,35,2520,1276,1244
050,39,099,"Ohio","Mahoning County",3,36,2509,1243,1266
050,39,099,"Ohio","Mahoning County",3,37,2396,1191,1205
050,39,099,"Ohio","Mahoning County",3,38,2510,1238,1272
050,39,099,"Ohio","Mahoning County",3,39,2581,1278,1303
050,39,099,"Ohio","Mahoning County",3,40,2637,1326,1311
050,39,099,"Ohio","Mahoning County",3,41,2642,1314,1328
050,39,099,"Ohio","Mahoning County",3,42,2576,1262,1314
050,39,099,"Ohio","Mahoning County",3,43,2524,1222,1302
050,39,099,"Ohio","Mahoning County",3,44,2557,1293,1264
050,39,099,"Ohio","Mahoning County",3,45,2408,1215,1193
050,39,099,"Ohio","Mahoning County",3,46,2448,1233,1215
050,39,099,"Ohio","Mahoning County",3,47,2401,1207,1194
050,39,099,"Ohio","Mahoning County",3,48,2540,1258,1282
050,39,099,"Ohio","Mahoning County",3,49,2710,1332,1378
050,39,099,"Ohio","Mahoning County",3,50,2871,1426,1445
050,39,099,"Ohio","Mahoning County",3,51,2866,1408,1458
050,39,099,"Ohio","Mahoning County",3,52,2739,1359,1380
050,39,099,"Ohio","Mahoning County",3,53,2698,1357,1341
050,39,099,"Ohio","Mahoning County",3,54,2855,1463,1392
050,39,099,"Ohio","Mahoning County",3,55,2853,1452,1401
050,39,099,"Ohio","Mahoning County",3,56,2956,1463,1493
050,39,099,"Ohio","Mahoning County",3,57,3066,1508,1558
050,39,099,"Ohio","Mahoning County",3,58,3156,1520,1636
050,39,099,"Ohio","Mahoning County",3,59,3318,1596,1722
050,39,099,"Ohio","Mahoning County",3,60,3409,1630,1779
050,39,099,"Ohio","Mahoning County",3,61,3348,1612,1736
050,39,099,"Ohio","Mahoning County",3,62,3429,1612,1817
050,39,099,"Ohio","Mahoning County",3,63,3592,1698,1894
050,39,099,"Ohio","Mahoning County",3,64,3585,1689,1896
050,39,099,"Ohio","Mahoning County",3,65,3447,1626,1821
050,39,099,"Ohio","Mahoning County",3,66,3383,1596,1787
050,39,099,"Ohio","Mahoning County",3,67,3290,1565,1725
050,39,099,"Ohio","Mahoning County",3,68,3213,1565,1648
050,39,099,"Ohio","Mahoning County",3,69,3148,1530,1618
050,39,099,"Ohio","Mahoning County",3,70,2976,1437,1539
050,39,099,"Ohio","Mahoning County",3,71,2745,1283,1462
050,39,099,"Ohio","Mahoning County",3,72,2687,1269,1418
050,39,099,"Ohio","Mahoning County",3,73,2590,1235,1355
050,39,099,"Ohio","Mahoning County",3,74,2656,1248,1408
050,39,099,"Ohio","Mahoning County",3,75,1745,801,944
050,39,099,"Ohio","Mahoning County",3,76,1585,704,881
050,39,099,"Ohio","Mahoning County",3,77,1585,681,904
050,39,099,"Ohio","Mahoning County",3,78,1686,703,983
050,39,099,"Ohio","Mahoning County",3,79,1551,646,905
050,39,099,"Ohio","Mahoning County",3,80,1354,553,801
050,39,099,"Ohio","Mahoning County",3,81,1163,475,688
050,39,099,"Ohio","Mahoning County",3,82,1097,454,643
050,39,099,"Ohio","Mahoning County",3,83,1068,420,648
050,39,099,"Ohio","Mahoning County",3,84,957,367,590
050,39,099,"Ohio","Mahoning County",3,85,6123,1956,4167
050,39,099,"Ohio","Mahoning County",4,0,2333,1126,1207
050,39,099,"Ohio","Mahoning County",4,1,2283,1130,1153
050,39,099,"Ohio","Mahoning County",4,2,2383,1233,1150
050,39,099,"Ohio","Mahoning County",4,3,2458,1285,1173
050,39,099,"Ohio","Mahoning County",4,4,2503,1256,1247
050,39,099,"Ohio","Mahoning County",4,5,2561,1325,1236
050,39,099,"Ohio","Mahoning County",4,6,2543,1266,1277
050,39,099,"Ohio","Mahoning County",4,7,2551,1289,1262
050,39,099,"Ohio","Mahoning County",4,8,2469,1248,1221
050,39,099,"Ohio","Mahoning County",4,9,2466,1267,1199
050,39,099,"Ohio","Mahoning County",4,10,2476,1285,1191
050,39,099,"Ohio","Mahoning County",4,11,2443,1265,1178
050,39,099,"Ohio","Mahoning County",4,12,2503,1299,1204
050,39,099,"Ohio","Mahoning County",4,13,2626,1342,1284
050,39,099,"Ohio","Mahoning County",4,14,2767,1446,1321
050,39,099,"Ohio","Mahoning County",4,15,2814,1509,1305
050,39,099,"Ohio","Mahoning County",4,16,2814,1441,1373
050,39,099,"Ohio","Mahoning County",4,17,2761,1409,1352
050,39,099,"Ohio","Mahoning County",4,18,2595,1401,1194
050,39,099,"Ohio","Mahoning County",4,19,2331,1243,1088
050,39,099,"Ohio","Mahoning County",4,20,2473,1308,1165
050,39,099,"Ohio","Mahoning County",4,21,2682,1363,1319
050,39,099,"Ohio","Mahoning County",4,22,2742,1410,1332
050,39,099,"Ohio","Mahoning County",4,23,2782,1412,1370
050,39,099,"Ohio","Mahoning County",4,24,2761,1396,1365
050,39,099,"Ohio","Mahoning County",4,25,2690,1377,1313
050,39,099,"Ohio","Mahoning County",4,26,2679,1374,1305
050,39,099,"Ohio","Mahoning County",4,27,2657,1356,1301
050,39,099,"Ohio","Mahoning County",4,28,2719,1417,1302
050,39,099,"Ohio","Mahoning County",4,29,2834,1481,1353
050,39,099,"Ohio","Mahoning County",4,30,2941,1486,1455
050,39,099,"Ohio","Mahoning County",4,31,2923,1497,1426
050,39,099,"Ohio","Mahoning County",4,32,2812,1458,1354
050,39,099,"Ohio","Mahoning County",4,33,2714,1409,1305
050,39,099,"Ohio","Mahoning County",4,34,2592,1351,1241
050,39,099,"Ohio","Mahoning County",4,35,2555,1322,1233
050,39,099,"Ohio","Mahoning County",4,36,2551,1291,1260
050,39,099,"Ohio","Mahoning County",4,37,2495,1236,1259
050,39,099,"Ohio","Mahoning County",4,38,2376,1187,1189
050,39,099,"Ohio","Mahoning County",4,39,2524,1262,1262
050,39,099,"Ohio","Mahoning County",4,40,2619,1324,1295
050,39,099,"Ohio","Mahoning County",4,41,2602,1282,1320
050,39,099,"Ohio","Mahoning County",4,42,2653,1324,1329
050,39,099,"Ohio","Mahoning County",4,43,2592,1263,1329
050,39,099,"Ohio","Mahoning County",4,44,2542,1235,1307
050,39,099,"Ohio","Mahoning County",4,45,2524,1262,1262
050,39,099,"Ohio","Mahoning County",4,46,2477,1263,1214
050,39,099,"Ohio","Mahoning County",4,47,2460,1247,1213
050,39,099,"Ohio","Mahoning County",4,48,2452,1236,1216
050,39,099,"Ohio","Mahoning County",4,49,2495,1240,1255
050,39,099,"Ohio","Mahoning County",4,50,2720,1346,1374
050,39,099,"Ohio","Mahoning County",4,51,2870,1419,1451
050,39,099,"Ohio","Mahoning County",4,52,2873,1395,1478
050,39,099,"Ohio","Mahoning County",4,53,2722,1341,1381
050,39,099,"Ohio","Mahoning County",4,54,2695,1353,1342
050,39,099,"Ohio","Mahoning County",4,55,2820,1459,1361
050,39,099,"Ohio","Mahoning County",4,56,2808,1412,1396
050,39,099,"Ohio","Mahoning County",4,57,2956,1463,1493
050,39,099,"Ohio","Mahoning County",4,58,3014,1463,1551
050,39,099,"Ohio","Mahoning County",4,59,3108,1504,1604
050,39,099,"Ohio","Mahoning County",4,60,3259,1568,1691
050,39,099,"Ohio","Mahoning County",4,61,3371,1600,1771
050,39,099,"Ohio","Mahoning County",4,62,3286,1563,1723
050,39,099,"Ohio","Mahoning County",4,63,3407,1607,1800
050,39,099,"Ohio","Mahoning County",4,64,3519,1652,1867
050,39,099,"Ohio","Mahoning County",4,65,3511,1647,1864
050,39,099,"Ohio","Mahoning County",4,66,3405,1609,1796
050,39,099,"Ohio","Mahoning County",4,67,3311,1553,1758
050,39,099,"Ohio","Mahoning County",4,68,3181,1503,1678
050,39,099,"Ohio","Mahoning County",4,69,3156,1533,1623
050,39,099,"Ohio","Mahoning County",4,70,3100,1494,1606
050,39,099,"Ohio","Mahoning County",4,71,2887,1381,1506
050,39,099,"Ohio","Mahoning County",4,72,2683,1238,1445
050,39,099,"Ohio","Mahoning County",4,73,2560,1211,1349
050,39,099,"Ohio","Mahoning County",4,74,2501,1185,1316
050,39,099,"Ohio","Mahoning County",4,75,2583,1207,1376
050,39,099,"Ohio","Mahoning County",4,76,1669,761,908
050,39,099,"Ohio","Mahoning County",4,77,1532,669,863
050,39,099,"Ohio","Mahoning County",4,78,1510,631,879
050,39,099,"Ohio","Mahoning County",4,79,1632,666,966
050,39,099,"Ohio","Mahoning County",4,80,1456,608,848
050,39,099,"Ohio","Mahoning County",4,81,1249,491,758
050,39,099,"Ohio","Mahoning County",4,82,1062,439,623
050,39,099,"Ohio","Mahoning County",4,83,1025,396,629
050,39,099,"Ohio","Mahoning County",4,84,976,383,593
050,39,099,"Ohio","Mahoning County",4,85,5907,1886,4021
050,39,099,"Ohio","Mahoning County",5,0,2347,1132,1215
050,39,099,"Ohio","Mahoning County",5,1,2408,1155,1253
050,39,099,"Ohio","Mahoning County",5,2,2336,1166,1170
050,39,099,"Ohio","Mahoning County",5,3,2416,1246,1170
050,39,099,"Ohio","Mahoning County",5,4,2491,1306,1185
050,39,099,"Ohio","Mahoning County",5,5,2499,1277,1222
050,39,099,"Ohio","Mahoning County",5,6,2563,1316,1247
050,39,099,"Ohio","Mahoning County",5,7,2543,1251,1292
050,39,099,"Ohio","Mahoning County",5,8,2567,1289,1278
050,39,099,"Ohio","Mahoning County",5,9,2505,1271,1234
050,39,099,"Ohio","Mahoning County",5,10,2488,1272,1216
050,39,099,"Ohio","Mahoning County",5,11,2458,1293,1165
050,39,099,"Ohio","Mahoning County",5,12,2449,1264,1185
050,39,099,"Ohio","Mahoning County",5,13,2510,1297,1213
050,39,099,"Ohio","Mahoning County",5,14,2644,1349,1295
050,39,099,"Ohio","Mahoning County",5,15,2787,1460,1327
050,39,099,"Ohio","Mahoning County",5,16,2782,1483,1299
050,39,099,"Ohio","Mahoning County",5,17,2824,1450,1374
050,39,099,"Ohio","Mahoning County",5,18,2512,1311,1201
050,39,099,"Ohio","Mahoning County",5,19,2321,1236,1085
050,39,099,"Ohio","Mahoning County",5,20,2487,1327,1160
050,39,099,"Ohio","Mahoning County",5,21,2621,1377,1244
050,39,099,"Ohio","Mahoning County",5,22,2732,1383,1349
050,39,099,"Ohio","Mahoning County",5,23,2762,1394,1368
050,39,099,"Ohio","Mahoning County",5,24,2735,1403,1332
050,39,099,"Ohio","Mahoning County",5,25,2739,1398,1341
050,39,099,"Ohio","Mahoning County",5,26,2740,1415,1325
050,39,099,"Ohio","Mahoning County",5,27,2672,1354,1318
050,39,099,"Ohio","Mahoning County",5,28,2655,1362,1293
050,39,099,"Ohio","Mahoning County",5,29,2700,1416,1284
050,39,099,"Ohio","Mahoning County",5,30,2860,1505,1355
050,39,099,"Ohio","Mahoning County",5,31,2987,1501,1486
050,39,099,"Ohio","Mahoning County",5,32,2927,1500,1427
050,39,099,"Ohio","Mahoning County",5,33,2875,1494,1381
050,39,099,"Ohio","Mahoning County",5,34,2726,1417,1309
050,39,099,"Ohio","Mahoning County",5,35,2590,1363,1227
050,39,099,"Ohio","Mahoning County",5,36,2545,1314,1231
050,39,099,"Ohio","Mahoning County",5,37,2564,1298,1266
050,39,099,"Ohio","Mahoning County",5,38,2527,1242,1285
050,39,099,"Ohio","Mahoning County",5,39,2382,1189,1193
050,39,099,"Ohio","Mahoning County",5,40,2582,1300,1282
050,39,099,"Ohio","Mahoning County",5,41,2594,1287,1307
050,39,099,"Ohio","Mahoning County",5,42,2581,1263,1318
050,39,099,"Ohio","Mahoning County",5,43,2636,1309,1327
050,39,099,"Ohio","Mahoning County",5,44,2578,1271,1307
050,39,099,"Ohio","Mahoning County",5,45,2504,1208,1296
050,39,099,"Ohio","Mahoning County",5,46,2572,1321,1251
050,39,099,"Ohio","Mahoning County",5,47,2464,1253,1211
050,39,099,"Ohio","Mahoning County",5,48,2450,1255,1195
050,39,099,"Ohio","Mahoning County",5,49,2431,1212,1219
050,39,099,"Ohio","Mahoning County",5,50,2473,1227,1246
050,39,099,"Ohio","Mahoning County",5,51,2705,1326,1379
050,39,099,"Ohio","Mahoning County",5,52,2862,1398,1464
050,39,099,"Ohio","Mahoning County",5,53,2852,1389,1463
050,39,099,"Ohio","Mahoning County",5,54,2710,1344,1366
050,39,099,"Ohio","Mahoning County",5,55,2656,1349,1307
050,39,099,"Ohio","Mahoning County",5,56,2781,1423,1358
050,39,099,"Ohio","Mahoning County",5,57,2781,1385,1396
050,39,099,"Ohio","Mahoning County",5,58,2922,1440,1482
050,39,099,"Ohio","Mahoning County",5,59,2977,1445,1532
050,39,099,"Ohio","Mahoning County",5,60,3085,1484,1601
050,39,099,"Ohio","Mahoning County",5,61,3189,1514,1675
050,39,099,"Ohio","Mahoning County",5,62,3319,1549,1770
050,39,099,"Ohio","Mahoning County",5,63,3269,1561,1708
050,39,099,"Ohio","Mahoning County",5,64,3350,1568,1782
050,39,099,"Ohio","Mahoning County",5,65,3472,1624,1848
050,39,099,"Ohio","Mahoning County",5,66,3493,1638,1855
050,39,099,"Ohio","Mahoning County",5,67,3338,1564,1774
050,39,099,"Ohio","Mahoning County",5,68,3243,1512,1731
050,39,099,"Ohio","Mahoning County",5,69,3121,1464,1657
050,39,099,"Ohio","Mahoning County",5,70,3099,1486,1613
050,39,099,"Ohio","Mahoning County",5,71,3010,1441,1569
050,39,099,"Ohio","Mahoning County",5,72,2835,1353,1482
050,39,099,"Ohio","Mahoning County",5,73,2586,1190,1396
050,39,099,"Ohio","Mahoning County",5,74,2486,1171,1315
050,39,099,"Ohio","Mahoning County",5,75,2445,1150,1295
050,39,099,"Ohio","Mahoning County",5,76,2486,1153,1333
050,39,099,"Ohio","Mahoning County",5,77,1625,734,891
050,39,099,"Ohio","Mahoning County",5,78,1467,630,837
050,39,099,"Ohio","Mahoning County",5,79,1468,602,866
050,39,099,"Ohio","Mahoning County",5,80,1531,624,907
050,39,099,"Ohio","Mahoning County",5,81,1365,560,805
050,39,099,"Ohio","Mahoning County",5,82,1145,453,692
050,39,099,"Ohio","Mahoning County",5,83,1011,395,616
050,39,099,"Ohio","Mahoning County",5,84,941,360,581
050,39,099,"Ohio","Mahoning County",5,85,5830,1871,3959
050,39,101,"Ohio","Marion County",1,0,723,370,353
050,39,101,"Ohio","Marion County",1,1,759,392,367
050,39,101,"Ohio","Marion County",1,2,755,385,370
050,39,101,"Ohio","Marion County",1,3,735,379,356
050,39,101,"Ohio","Marion County",1,4,773,393,380
050,39,101,"Ohio","Marion County",1,5,800,393,407
050,39,101,"Ohio","Marion County",1,6,794,399,395
050,39,101,"Ohio","Marion County",1,7,810,405,405
050,39,101,"Ohio","Marion County",1,8,789,429,360
050,39,101,"Ohio","Marion County",1,9,801,421,380
050,39,101,"Ohio","Marion County",1,10,799,411,388
050,39,101,"Ohio","Marion County",1,11,814,408,406
050,39,101,"Ohio","Marion County",1,12,811,418,393
050,39,101,"Ohio","Marion County",1,13,793,413,380
050,39,101,"Ohio","Marion County",1,14,769,405,364
050,39,101,"Ohio","Marion County",1,15,747,393,354
050,39,101,"Ohio","Marion County",1,16,758,396,362
050,39,101,"Ohio","Marion County",1,17,815,409,406
050,39,101,"Ohio","Marion County",1,18,728,385,343
050,39,101,"Ohio","Marion County",1,19,624,369,255
050,39,101,"Ohio","Marion County",1,20,702,432,270
050,39,101,"Ohio","Marion County",1,21,763,455,308
050,39,101,"Ohio","Marion County",1,22,772,438,334
050,39,101,"Ohio","Marion County",1,23,810,472,338
050,39,101,"Ohio","Marion County",1,24,821,471,350
050,39,101,"Ohio","Marion County",1,25,857,469,388
050,39,101,"Ohio","Marion County",1,26,889,521,368
050,39,101,"Ohio","Marion County",1,27,867,496,371
050,39,101,"Ohio","Marion County",1,28,936,503,433
050,39,101,"Ohio","Marion County",1,29,947,531,416
050,39,101,"Ohio","Marion County",1,30,874,511,363
050,39,101,"Ohio","Marion County",1,31,865,481,384
050,39,101,"Ohio","Marion County",1,32,870,497,373
050,39,101,"Ohio","Marion County",1,33,817,452,365
050,39,101,"Ohio","Marion County",1,34,808,474,334
050,39,101,"Ohio","Marion County",1,35,853,493,360
050,39,101,"Ohio","Marion County",1,36,771,441,330
050,39,101,"Ohio","Marion County",1,37,814,488,326
050,39,101,"Ohio","Marion County",1,38,832,488,344
050,39,101,"Ohio","Marion County",1,39,867,488,379
050,39,101,"Ohio","Marion County",1,40,840,472,368
050,39,101,"Ohio","Marion County",1,41,869,516,353
050,39,101,"Ohio","Marion County",1,42,791,468,323
050,39,101,"Ohio","Marion County",1,43,786,433,353
050,39,101,"Ohio","Marion County",1,44,796,466,330
050,39,101,"Ohio","Marion County",1,45,822,475,347
050,39,101,"Ohio","Marion County",1,46,774,435,339
050,39,101,"Ohio","Marion County",1,47,812,472,340
050,39,101,"Ohio","Marion County",1,48,889,507,382
050,39,101,"Ohio","Marion County",1,49,921,526,395
050,39,101,"Ohio","Marion County",1,50,820,461,359
050,39,101,"Ohio","Marion County",1,51,873,499,374
050,39,101,"Ohio","Marion County",1,52,856,480,376
050,39,101,"Ohio","Marion County",1,53,883,506,377
050,39,101,"Ohio","Marion County",1,54,862,489,373
050,39,101,"Ohio","Marion County",1,55,883,481,402
050,39,101,"Ohio","Marion County",1,56,876,482,394
050,39,101,"Ohio","Marion County",1,57,895,489,406
050,39,101,"Ohio","Marion County",1,58,937,506,431
050,39,101,"Ohio","Marion County",1,59,936,493,443
050,39,101,"Ohio","Marion County",1,60,888,457,431
050,39,101,"Ohio","Marion County",1,61,903,458,445
050,39,101,"Ohio","Marion County",1,62,938,474,464
050,39,101,"Ohio","Marion County",1,63,865,443,422
050,39,101,"Ohio","Marion County",1,64,854,442,412
050,39,101,"Ohio","Marion County",1,65,842,436,406
050,39,101,"Ohio","Marion County",1,66,813,401,412
050,39,101,"Ohio","Marion County",1,67,774,399,375
050,39,101,"Ohio","Marion County",1,68,766,370,396
050,39,101,"Ohio","Marion County",1,69,708,335,373
050,39,101,"Ohio","Marion County",1,70,672,327,345
050,39,101,"Ohio","Marion County",1,71,688,326,362
050,39,101,"Ohio","Marion County",1,72,681,329,352
050,39,101,"Ohio","Marion County",1,73,684,311,373
050,39,101,"Ohio","Marion County",1,74,460,199,261
050,39,101,"Ohio","Marion County",1,75,450,214,236
050,39,101,"Ohio","Marion County",1,76,452,208,244
050,39,101,"Ohio","Marion County",1,77,435,204,231
050,39,101,"Ohio","Marion County",1,78,375,155,220
050,39,101,"Ohio","Marion County",1,79,323,138,185
050,39,101,"Ohio","Marion County",1,80,290,123,167
050,39,101,"Ohio","Marion County",1,81,277,117,160
050,39,101,"Ohio","Marion County",1,82,256,106,150
050,39,101,"Ohio","Marion County",1,83,240,101,139
050,39,101,"Ohio","Marion County",1,84,223,89,134
050,39,101,"Ohio","Marion County",1,85,1243,462,781
050,39,101,"Ohio","Marion County",2,0,726,383,343
050,39,101,"Ohio","Marion County",2,1,749,385,364
050,39,101,"Ohio","Marion County",2,2,754,387,367
050,39,101,"Ohio","Marion County",2,3,741,378,363
050,39,101,"Ohio","Marion County",2,4,766,391,375
050,39,101,"Ohio","Marion County",2,5,795,394,401
050,39,101,"Ohio","Marion County",2,6,795,395,400
050,39,101,"Ohio","Marion County",2,7,807,404,403
050,39,101,"Ohio","Marion County",2,8,795,422,373
050,39,101,"Ohio","Marion County",2,9,801,426,375
050,39,101,"Ohio","Marion County",2,10,805,417,388
050,39,101,"Ohio","Marion County",2,11,813,410,403
050,39,101,"Ohio","Marion County",2,12,821,421,400
050,39,101,"Ohio","Marion County",2,13,800,416,384
050,39,101,"Ohio","Marion County",2,14,776,407,369
050,39,101,"Ohio","Marion County",2,15,750,395,355
050,39,101,"Ohio","Marion County",2,16,758,396,362
050,39,101,"Ohio","Marion County",2,17,806,409,397
050,39,101,"Ohio","Marion County",2,18,722,384,338
050,39,101,"Ohio","Marion County",2,19,635,372,263
050,39,101,"Ohio","Marion County",2,20,711,435,276
050,39,101,"Ohio","Marion County",2,21,766,463,303
050,39,101,"Ohio","Marion County",2,22,776,442,334
050,39,101,"Ohio","Marion County",2,23,812,468,344
050,39,101,"Ohio","Marion County",2,24,820,473,347
050,39,101,"Ohio","Marion County",2,25,850,470,380
050,39,101,"Ohio","Marion County",2,26,882,512,370
050,39,101,"Ohio","Marion County",2,27,866,496,370
050,39,101,"Ohio","Marion County",2,28,925,507,418
050,39,101,"Ohio","Marion County",2,29,940,521,419
050,39,101,"Ohio","Marion County",2,30,896,516,380
050,39,101,"Ohio","Marion County",2,31,867,488,379
050,39,101,"Ohio","Marion County",2,32,871,495,376
050,39,101,"Ohio","Marion County",2,33,826,459,367
050,39,101,"Ohio","Marion County",2,34,810,466,344
050,39,101,"Ohio","Marion County",2,35,847,490,357
050,39,101,"Ohio","Marion County",2,36,785,449,336
050,39,101,"Ohio","Marion County",2,37,815,486,329
050,39,101,"Ohio","Marion County",2,38,830,489,341
050,39,101,"Ohio","Marion County",2,39,858,492,366
050,39,101,"Ohio","Marion County",2,40,848,473,375
050,39,101,"Ohio","Marion County",2,41,869,511,358
050,39,101,"Ohio","Marion County",2,42,798,469,329
050,39,101,"Ohio","Marion County",2,43,792,444,348
050,39,101,"Ohio","Marion County",2,44,791,460,331
050,39,101,"Ohio","Marion County",2,45,822,477,345
050,39,101,"Ohio","Marion County",2,46,774,436,338
050,39,101,"Ohio","Marion County",2,47,797,460,337
050,39,101,"Ohio","Marion County",2,48,871,499,372
050,39,101,"Ohio","Marion County",2,49,916,522,394
050,39,101,"Ohio","Marion County",2,50,830,461,369
050,39,101,"Ohio","Marion County",2,51,859,493,366
050,39,101,"Ohio","Marion County",2,52,853,480,373
050,39,101,"Ohio","Marion County",2,53,879,502,377
050,39,101,"Ohio","Marion County",2,54,863,489,374
050,39,101,"Ohio","Marion County",2,55,871,478,393
050,39,101,"Ohio","Marion County",2,56,874,477,397
050,39,101,"Ohio","Marion County",2,57,889,484,405
050,39,101,"Ohio","Marion County",2,58,925,501,424
050,39,101,"Ohio","Marion County",2,59,933,492,441
050,39,101,"Ohio","Marion County",2,60,889,457,432
050,39,101,"Ohio","Marion County",2,61,897,458,439
050,39,101,"Ohio","Marion County",2,62,920,463,457
050,39,101,"Ohio","Marion County",2,63,883,448,435
050,39,101,"Ohio","Marion County",2,64,847,437,410
050,39,101,"Ohio","Marion County",2,65,843,434,409
050,39,101,"Ohio","Marion County",2,66,819,408,411
050,39,101,"Ohio","Marion County",2,67,780,397,383
050,39,101,"Ohio","Marion County",2,68,760,374,386
050,39,101,"Ohio","Marion County",2,69,723,342,381
050,39,101,"Ohio","Marion County",2,70,676,325,351
050,39,101,"Ohio","Marion County",2,71,685,325,360
050,39,101,"Ohio","Marion County",2,72,668,322,346
050,39,101,"Ohio","Marion County",2,73,713,327,386
050,39,101,"Ohio","Marion County",2,74,474,208,266
050,39,101,"Ohio","Marion County",2,75,454,212,242
050,39,101,"Ohio","Marion County",2,76,442,205,237
050,39,101,"Ohio","Marion County",2,77,444,209,235
050,39,101,"Ohio","Marion County",2,78,377,160,217
050,39,101,"Ohio","Marion County",2,79,329,138,191
050,39,101,"Ohio","Marion County",2,80,295,126,169
050,39,101,"Ohio","Marion County",2,81,277,118,159
050,39,101,"Ohio","Marion County",2,82,260,108,152
050,39,101,"Ohio","Marion County",2,83,239,102,137
050,39,101,"Ohio","Marion County",2,84,225,90,135
050,39,101,"Ohio","Marion County",2,85,1247,459,788
050,39,101,"Ohio","Marion County",3,0,668,346,322
050,39,101,"Ohio","Marion County",3,1,730,385,345
050,39,101,"Ohio","Marion County",3,2,746,376,370
050,39,101,"Ohio","Marion County",3,3,768,395,373
050,39,101,"Ohio","Marion County",3,4,731,372,359
050,39,101,"Ohio","Marion County",3,5,772,395,377
050,39,101,"Ohio","Marion County",3,6,796,393,403
050,39,101,"Ohio","Marion County",3,7,787,384,403
050,39,101,"Ohio","Marion County",3,8,797,401,396
050,39,101,"Ohio","Marion County",3,9,801,424,377
050,39,101,"Ohio","Marion County",3,10,793,424,369
050,39,101,"Ohio","Marion County",3,11,799,404,395
050,39,101,"Ohio","Marion County",3,12,799,399,400
050,39,101,"Ohio","Marion County",3,13,831,427,404
050,39,101,"Ohio","Marion County",3,14,788,408,380
050,39,101,"Ohio","Marion County",3,15,773,399,374
050,39,101,"Ohio","Marion County",3,16,732,380,352
050,39,101,"Ohio","Marion County",3,17,779,407,372
050,39,101,"Ohio","Marion County",3,18,682,364,318
050,39,101,"Ohio","Marion County",3,19,652,374,278
050,39,101,"Ohio","Marion County",3,20,717,429,288
050,39,101,"Ohio","Marion County",3,21,788,484,304
050,39,101,"Ohio","Marion County",3,22,798,450,348
050,39,101,"Ohio","Marion County",3,23,824,459,365
050,39,101,"Ohio","Marion County",3,24,832,486,346
050,39,101,"Ohio","Marion County",3,25,823,480,343
050,39,101,"Ohio","Marion County",3,26,874,482,392
050,39,101,"Ohio","Marion County",3,27,862,501,361
050,39,101,"Ohio","Marion County",3,28,885,515,370
050,39,101,"Ohio","Marion County",3,29,902,488,414
050,39,101,"Ohio","Marion County",3,30,948,537,411
050,39,101,"Ohio","Marion County",3,31,898,514,384
050,39,101,"Ohio","Marion County",3,32,897,507,390
050,39,101,"Ohio","Marion County",3,33,874,493,381
050,39,101,"Ohio","Marion County",3,34,829,466,363
050,39,101,"Ohio","Marion County",3,35,814,474,340
050,39,101,"Ohio","Marion County",3,36,833,483,350
050,39,101,"Ohio","Marion County",3,37,821,480,341
050,39,101,"Ohio","Marion County",3,38,805,485,320
050,39,101,"Ohio","Marion County",3,39,860,526,334
050,39,101,"Ohio","Marion County",3,40,825,462,363
050,39,101,"Ohio","Marion County",3,41,898,525,373
050,39,101,"Ohio","Marion County",3,42,831,477,354
050,39,101,"Ohio","Marion County",3,43,796,474,322
050,39,101,"Ohio","Marion County",3,44,796,455,341
050,39,101,"Ohio","Marion County",3,45,793,469,324
050,39,101,"Ohio","Marion County",3,46,810,467,343
050,39,101,"Ohio","Marion County",3,47,780,451,329
050,39,101,"Ohio","Marion County",3,48,816,479,337
050,39,101,"Ohio","Marion County",3,49,879,511,368
050,39,101,"Ohio","Marion County",3,50,860,471,389
050,39,101,"Ohio","Marion County",3,51,858,486,372
050,39,101,"Ohio","Marion County",3,52,856,493,363
050,39,101,"Ohio","Marion County",3,53,869,502,367
050,39,101,"Ohio","Marion County",3,54,860,485,375
050,39,101,"Ohio","Marion County",3,55,845,477,368
050,39,101,"Ohio","Marion County",3,56,828,451,377
050,39,101,"Ohio","Marion County",3,57,866,466,400
050,39,101,"Ohio","Marion County",3,58,892,490,402
050,39,101,"Ohio","Marion County",3,59,887,465,422
050,39,101,"Ohio","Marion County",3,60,905,475,430
050,39,101,"Ohio","Marion County",3,61,883,461,422
050,39,101,"Ohio","Marion County",3,62,858,431,427
050,39,101,"Ohio","Marion County",3,63,901,453,448
050,39,101,"Ohio","Marion County",3,64,879,444,435
050,39,101,"Ohio","Marion County",3,65,831,425,406
050,39,101,"Ohio","Marion County",3,66,827,422,405
050,39,101,"Ohio","Marion County",3,67,808,404,404
050,39,101,"Ohio","Marion County",3,68,756,384,372
050,39,101,"Ohio","Marion County",3,69,742,359,383
050,39,101,"Ohio","Marion County",3,70,698,336,362
050,39,101,"Ohio","Marion County",3,71,660,313,347
050,39,101,"Ohio","Marion County",3,72,664,308,356
050,39,101,"Ohio","Marion County",3,73,642,301,341
050,39,101,"Ohio","Marion County",3,74,693,319,374
050,39,101,"Ohio","Marion County",3,75,456,200,256
050,39,101,"Ohio","Marion County",3,76,443,203,240
050,39,101,"Ohio","Marion County",3,77,413,191,222
050,39,101,"Ohio","Marion County",3,78,426,199,227
050,39,101,"Ohio","Marion County",3,79,362,149,213
050,39,101,"Ohio","Marion County",3,80,302,127,175
050,39,101,"Ohio","Marion County",3,81,271,117,154
050,39,101,"Ohio","Marion County",3,82,241,99,142
050,39,101,"Ohio","Marion County",3,83,236,92,144
050,39,101,"Ohio","Marion County",3,84,220,89,131
050,39,101,"Ohio","Marion County",3,85,1240,475,765
050,39,101,"Ohio","Marion County",4,0,707,356,351
050,39,101,"Ohio","Marion County",4,1,661,340,321
050,39,101,"Ohio","Marion County",4,2,723,377,346
050,39,101,"Ohio","Marion County",4,3,742,380,362
050,39,101,"Ohio","Marion County",4,4,764,396,368
050,39,101,"Ohio","Marion County",4,5,746,382,364
050,39,101,"Ohio","Marion County",4,6,772,394,378
050,39,101,"Ohio","Marion County",4,7,815,411,404
050,39,101,"Ohio","Marion County",4,8,800,394,406
050,39,101,"Ohio","Marion County",4,9,803,409,394
050,39,101,"Ohio","Marion County",4,10,798,425,373
050,39,101,"Ohio","Marion County",4,11,808,424,384
050,39,101,"Ohio","Marion County",4,12,806,415,391
050,39,101,"Ohio","Marion County",4,13,807,410,397
050,39,101,"Ohio","Marion County",4,14,850,439,411
050,39,101,"Ohio","Marion County",4,15,796,415,381
050,39,101,"Ohio","Marion County",4,16,771,398,373
050,39,101,"Ohio","Marion County",4,17,747,388,359
050,39,101,"Ohio","Marion County",4,18,670,377,293
050,39,101,"Ohio","Marion County",4,19,586,338,248
050,39,101,"Ohio","Marion County",4,20,718,428,290
050,39,101,"Ohio","Marion County",4,21,756,463,293
050,39,101,"Ohio","Marion County",4,22,791,471,320
050,39,101,"Ohio","Marion County",4,23,795,446,349
050,39,101,"Ohio","Marion County",4,24,826,463,363
050,39,101,"Ohio","Marion County",4,25,825,472,353
050,39,101,"Ohio","Marion County",4,26,805,479,326
050,39,101,"Ohio","Marion County",4,27,849,454,395
050,39,101,"Ohio","Marion County",4,28,840,476,364
050,39,101,"Ohio","Marion County",4,29,864,497,367
050,39,101,"Ohio","Marion County",4,30,910,499,411
050,39,101,"Ohio","Marion County",4,31,917,507,410
050,39,101,"Ohio","Marion County",4,32,900,508,392
050,39,101,"Ohio","Marion County",4,33,903,500,403
050,39,101,"Ohio","Marion County",4,34,849,471,378
050,39,101,"Ohio","Marion County",4,35,804,448,356
050,39,101,"Ohio","Marion County",4,36,785,451,334
050,39,101,"Ohio","Marion County",4,37,855,508,347
050,39,101,"Ohio","Marion County",4,38,794,461,333
050,39,101,"Ohio","Marion County",4,39,814,489,325
050,39,101,"Ohio","Marion County",4,40,810,484,326
050,39,101,"Ohio","Marion County",4,41,839,480,359
050,39,101,"Ohio","Marion County",4,42,840,469,371
050,39,101,"Ohio","Marion County",4,43,816,456,360
050,39,101,"Ohio","Marion County",4,44,797,477,320
050,39,101,"Ohio","Marion County",4,45,796,452,344
050,39,101,"Ohio","Marion County",4,46,771,442,329
050,39,101,"Ohio","Marion County",4,47,801,456,345
050,39,101,"Ohio","Marion County",4,48,775,454,321
050,39,101,"Ohio","Marion County",4,49,808,476,332
050,39,101,"Ohio","Marion County",4,50,815,446,369
050,39,101,"Ohio","Marion County",4,51,865,476,389
050,39,101,"Ohio","Marion County",4,52,830,465,365
050,39,101,"Ohio","Marion County",4,53,865,494,371
050,39,101,"Ohio","Marion County",4,54,836,473,363
050,39,101,"Ohio","Marion County",4,55,822,454,368
050,39,101,"Ohio","Marion County",4,56,809,441,368
050,39,101,"Ohio","Marion County",4,57,809,435,374
050,39,101,"Ohio","Marion County",4,58,864,452,412
050,39,101,"Ohio","Marion County",4,59,853,457,396
050,39,101,"Ohio","Marion County",4,60,868,449,419
050,39,101,"Ohio","Marion County",4,61,892,470,422
050,39,101,"Ohio","Marion County",4,62,855,440,415
050,39,101,"Ohio","Marion County",4,63,833,419,414
050,39,101,"Ohio","Marion County",4,64,891,445,446
050,39,101,"Ohio","Marion County",4,65,860,432,428
050,39,101,"Ohio","Marion County",4,66,791,403,388
050,39,101,"Ohio","Marion County",4,67,802,410,392
050,39,101,"Ohio","Marion County",4,68,777,390,387
050,39,101,"Ohio","Marion County",4,69,735,363,372
050,39,101,"Ohio","Marion County",4,70,724,350,374
050,39,101,"Ohio","Marion County",4,71,686,330,356
050,39,101,"Ohio","Marion County",4,72,634,298,336
050,39,101,"Ohio","Marion County",4,73,638,292,346
050,39,101,"Ohio","Marion County",4,74,629,299,330
050,39,101,"Ohio","Marion County",4,75,668,307,361
050,39,101,"Ohio","Marion County",4,76,435,184,251
050,39,101,"Ohio","Marion County",4,77,402,190,212
050,39,101,"Ohio","Marion County",4,78,392,179,213
050,39,101,"Ohio","Marion County",4,79,397,188,209
050,39,101,"Ohio","Marion County",4,80,339,141,198
050,39,101,"Ohio","Marion County",4,81,292,118,174
050,39,101,"Ohio","Marion County",4,82,237,104,133
050,39,101,"Ohio","Marion County",4,83,220,88,132
050,39,101,"Ohio","Marion County",4,84,210,76,134
050,39,101,"Ohio","Marion County",4,85,1209,474,735
050,39,101,"Ohio","Marion County",5,0,714,356,358
050,39,101,"Ohio","Marion County",5,1,693,345,348
050,39,101,"Ohio","Marion County",5,2,666,338,328
050,39,101,"Ohio","Marion County",5,3,713,371,342
050,39,101,"Ohio","Marion County",5,4,767,392,375
050,39,101,"Ohio","Marion County",5,5,789,410,379
050,39,101,"Ohio","Marion County",5,6,740,372,368
050,39,101,"Ohio","Marion County",5,7,752,393,359
050,39,101,"Ohio","Marion County",5,8,829,420,409
050,39,101,"Ohio","Marion County",5,9,801,392,409
050,39,101,"Ohio","Marion County",5,10,797,406,391
050,39,101,"Ohio","Marion County",5,11,801,427,374
050,39,101,"Ohio","Marion County",5,12,798,427,371
050,39,101,"Ohio","Marion County",5,13,830,422,408
050,39,101,"Ohio","Marion County",5,14,803,408,395
050,39,101,"Ohio","Marion County",5,15,853,443,410
050,39,101,"Ohio","Marion County",5,16,800,423,377
050,39,101,"Ohio","Marion County",5,17,774,397,377
050,39,101,"Ohio","Marion County",5,18,639,350,289
050,39,101,"Ohio","Marion County",5,19,587,347,240
050,39,101,"Ohio","Marion County",5,20,654,383,271
050,39,101,"Ohio","Marion County",5,21,779,476,303
050,39,101,"Ohio","Marion County",5,22,792,464,328
050,39,101,"Ohio","Marion County",5,23,838,496,342
050,39,101,"Ohio","Marion County",5,24,819,451,368
050,39,101,"Ohio","Marion County",5,25,830,478,352
050,39,101,"Ohio","Marion County",5,26,836,480,356
050,39,101,"Ohio","Marion County",5,27,809,488,321
050,39,101,"Ohio","Marion County",5,28,842,457,385
050,39,101,"Ohio","Marion County",5,29,829,474,355
050,39,101,"Ohio","Marion County",5,30,915,529,386
050,39,101,"Ohio","Marion County",5,31,915,502,413
050,39,101,"Ohio","Marion County",5,32,938,534,404
050,39,101,"Ohio","Marion County",5,33,898,502,396
050,39,101,"Ohio","Marion County",5,34,888,488,400
050,39,101,"Ohio","Marion County",5,35,853,475,378
050,39,101,"Ohio","Marion County",5,36,805,446,359
050,39,101,"Ohio","Marion County",5,37,806,481,325
050,39,101,"Ohio","Marion County",5,38,863,515,348
050,39,101,"Ohio","Marion County",5,39,825,490,335
050,39,101,"Ohio","Marion County",5,40,790,474,316
050,39,101,"Ohio","Marion County",5,41,837,517,320
050,39,101,"Ohio","Marion County",5,42,817,458,359
050,39,101,"Ohio","Marion County",5,43,851,473,378
050,39,101,"Ohio","Marion County",5,44,839,484,355
050,39,101,"Ohio","Marion County",5,45,820,497,323
050,39,101,"Ohio","Marion County",5,46,801,454,347
050,39,101,"Ohio","Marion County",5,47,776,453,323
050,39,101,"Ohio","Marion County",5,48,813,474,339
050,39,101,"Ohio","Marion County",5,49,774,458,316
050,39,101,"Ohio","Marion County",5,50,766,431,335
050,39,101,"Ohio","Marion County",5,51,841,472,369
050,39,101,"Ohio","Marion County",5,52,858,475,383
050,39,101,"Ohio","Marion County",5,53,848,484,364
050,39,101,"Ohio","Marion County",5,54,853,486,367
050,39,101,"Ohio","Marion County",5,55,819,462,357
050,39,101,"Ohio","Marion County",5,56,800,435,365
050,39,101,"Ohio","Marion County",5,57,804,439,365
050,39,101,"Ohio","Marion County",5,58,821,438,383
050,39,101,"Ohio","Marion County",5,59,849,438,411
050,39,101,"Ohio","Marion County",5,60,834,446,388
050,39,101,"Ohio","Marion County",5,61,866,448,418
050,39,101,"Ohio","Marion County",5,62,877,452,425
050,39,101,"Ohio","Marion County",5,63,826,421,405
050,39,101,"Ohio","Marion County",5,64,824,409,415
050,39,101,"Ohio","Marion County",5,65,870,439,431
050,39,101,"Ohio","Marion County",5,66,834,417,417
050,39,101,"Ohio","Marion County",5,67,785,398,387
050,39,101,"Ohio","Marion County",5,68,773,392,381
050,39,101,"Ohio","Marion County",5,69,765,383,382
050,39,101,"Ohio","Marion County",5,70,720,357,363
050,39,101,"Ohio","Marion County",5,71,714,345,369
050,39,101,"Ohio","Marion County",5,72,674,322,352
050,39,101,"Ohio","Marion County",5,73,609,283,326
050,39,101,"Ohio","Marion County",5,74,633,299,334
050,39,101,"Ohio","Marion County",5,75,610,292,318
050,39,101,"Ohio","Marion County",5,76,641,287,354
050,39,101,"Ohio","Marion County",5,77,411,179,232
050,39,101,"Ohio","Marion County",5,78,390,184,206
050,39,101,"Ohio","Marion County",5,79,372,168,204
050,39,101,"Ohio","Marion County",5,80,371,177,194
050,39,101,"Ohio","Marion County",5,81,320,134,186
050,39,101,"Ohio","Marion County",5,82,263,105,158
050,39,101,"Ohio","Marion County",5,83,211,88,123
050,39,101,"Ohio","Marion County",5,84,193,74,119
050,39,101,"Ohio","Marion County",5,85,1208,475,733
050,39,103,"Ohio","Medina County",1,0,1658,843,815
050,39,103,"Ohio","Medina County",1,1,1742,881,861
050,39,103,"Ohio","Medina County",1,2,1872,957,915
050,39,103,"Ohio","Medina County",1,3,1923,986,937
050,39,103,"Ohio","Medina County",1,4,2096,1076,1020
050,39,103,"Ohio","Medina County",1,5,2116,1066,1050
050,39,103,"Ohio","Medina County",1,6,2150,1103,1047
050,39,103,"Ohio","Medina County",1,7,2106,1069,1037
050,39,103,"Ohio","Medina County",1,8,2200,1146,1054
050,39,103,"Ohio","Medina County",1,9,2201,1119,1082
050,39,103,"Ohio","Medina County",1,10,2298,1162,1136
050,39,103,"Ohio","Medina County",1,11,2403,1211,1192
050,39,103,"Ohio","Medina County",1,12,2534,1302,1232
050,39,103,"Ohio","Medina County",1,13,2556,1336,1220
050,39,103,"Ohio","Medina County",1,14,2635,1362,1273
050,39,103,"Ohio","Medina County",1,15,2517,1311,1206
050,39,103,"Ohio","Medina County",1,16,2627,1346,1281
050,39,103,"Ohio","Medina County",1,17,2641,1355,1286
050,39,103,"Ohio","Medina County",1,18,2195,1168,1027
050,39,103,"Ohio","Medina County",1,19,1786,961,825
050,39,103,"Ohio","Medina County",1,20,1877,1000,877
050,39,103,"Ohio","Medina County",1,21,1935,988,947
050,39,103,"Ohio","Medina County",1,22,1918,984,934
050,39,103,"Ohio","Medina County",1,23,1981,1007,974
050,39,103,"Ohio","Medina County",1,24,1914,978,936
050,39,103,"Ohio","Medina County",1,25,1811,906,905
050,39,103,"Ohio","Medina County",1,26,1855,940,915
050,39,103,"Ohio","Medina County",1,27,1886,949,937
050,39,103,"Ohio","Medina County",1,28,1962,979,983
050,39,103,"Ohio","Medina County",1,29,1869,940,929
050,39,103,"Ohio","Medina County",1,30,1905,944,961
050,39,103,"Ohio","Medina County",1,31,1928,955,973
050,39,103,"Ohio","Medina County",1,32,1976,990,986
050,39,103,"Ohio","Medina County",1,33,2113,1081,1032
050,39,103,"Ohio","Medina County",1,34,2204,1108,1096
050,39,103,"Ohio","Medina County",1,35,2207,1100,1107
050,39,103,"Ohio","Medina County",1,36,2235,1113,1122
050,39,103,"Ohio","Medina County",1,37,2230,1140,1090
050,39,103,"Ohio","Medina County",1,38,2360,1176,1184
050,39,103,"Ohio","Medina County",1,39,2393,1191,1202
050,39,103,"Ohio","Medina County",1,40,2422,1206,1216
050,39,103,"Ohio","Medina County",1,41,2316,1177,1139
050,39,103,"Ohio","Medina County",1,42,2282,1154,1128
050,39,103,"Ohio","Medina County",1,43,2245,1125,1120
050,39,103,"Ohio","Medina County",1,44,2290,1164,1126
050,39,103,"Ohio","Medina County",1,45,2184,1098,1086
050,39,103,"Ohio","Medina County",1,46,2222,1128,1094
050,39,103,"Ohio","Medina County",1,47,2368,1175,1193
050,39,103,"Ohio","Medina County",1,48,2595,1336,1259
050,39,103,"Ohio","Medina County",1,49,2825,1443,1382
050,39,103,"Ohio","Medina County",1,50,2573,1289,1284
050,39,103,"Ohio","Medina County",1,51,2561,1257,1304
050,39,103,"Ohio","Medina County",1,52,2605,1298,1307
050,39,103,"Ohio","Medina County",1,53,2664,1343,1321
050,39,103,"Ohio","Medina County",1,54,2750,1373,1377
050,39,103,"Ohio","Medina County",1,55,2787,1393,1394
050,39,103,"Ohio","Medina County",1,56,2824,1379,1445
050,39,103,"Ohio","Medina County",1,57,2787,1395,1392
050,39,103,"Ohio","Medina County",1,58,2742,1376,1366
050,39,103,"Ohio","Medina County",1,59,2729,1366,1363
050,39,103,"Ohio","Medina County",1,60,2692,1333,1359
050,39,103,"Ohio","Medina County",1,61,2703,1346,1357
050,39,103,"Ohio","Medina County",1,62,2719,1370,1349
050,39,103,"Ohio","Medina County",1,63,2511,1268,1243
050,39,103,"Ohio","Medina County",1,64,2464,1214,1250
050,39,103,"Ohio","Medina County",1,65,2429,1158,1271
050,39,103,"Ohio","Medina County",1,66,2266,1112,1154
050,39,103,"Ohio","Medina County",1,67,2221,1066,1155
050,39,103,"Ohio","Medina County",1,68,2192,1042,1150
050,39,103,"Ohio","Medina County",1,69,2003,961,1042
050,39,103,"Ohio","Medina County",1,70,1996,939,1057
050,39,103,"Ohio","Medina County",1,71,1959,937,1022
050,39,103,"Ohio","Medina County",1,72,2012,977,1035
050,39,103,"Ohio","Medina County",1,73,2022,989,1033
050,39,103,"Ohio","Medina County",1,74,1363,635,728
050,39,103,"Ohio","Medina County",1,75,1301,599,702
050,39,103,"Ohio","Medina County",1,76,1298,600,698
050,39,103,"Ohio","Medina County",1,77,1349,615,734
050,39,103,"Ohio","Medina County",1,78,1160,538,622
050,39,103,"Ohio","Medina County",1,79,985,446,539
050,39,103,"Ohio","Medina County",1,80,855,390,465
050,39,103,"Ohio","Medina County",1,81,836,384,452
050,39,103,"Ohio","Medina County",1,82,731,314,417
050,39,103,"Ohio","Medina County",1,83,704,310,394
050,39,103,"Ohio","Medina County",1,84,602,267,335
050,39,103,"Ohio","Medina County",1,85,3516,1235,2281
050,39,103,"Ohio","Medina County",2,0,1639,807,832
050,39,103,"Ohio","Medina County",2,1,1729,876,853
050,39,103,"Ohio","Medina County",2,2,1853,943,910
050,39,103,"Ohio","Medina County",2,3,1914,980,934
050,39,103,"Ohio","Medina County",2,4,2070,1059,1011
050,39,103,"Ohio","Medina County",2,5,2123,1071,1052
050,39,103,"Ohio","Medina County",2,6,2157,1097,1060
050,39,103,"Ohio","Medina County",2,7,2126,1080,1046
050,39,103,"Ohio","Medina County",2,8,2173,1124,1049
050,39,103,"Ohio","Medina County",2,9,2197,1124,1073
050,39,103,"Ohio","Medina County",2,10,2280,1152,1128
050,39,103,"Ohio","Medina County",2,11,2379,1195,1184
050,39,103,"Ohio","Medina County",2,12,2522,1288,1234
050,39,103,"Ohio","Medina County",2,13,2560,1335,1225
050,39,103,"Ohio","Medina County",2,14,2626,1361,1265
050,39,103,"Ohio","Medina County",2,15,2552,1326,1226
050,39,103,"Ohio","Medina County",2,16,2599,1338,1261
050,39,103,"Ohio","Medina County",2,17,2637,1351,1286
050,39,103,"Ohio","Medina County",2,18,2191,1165,1026
050,39,103,"Ohio","Medina County",2,19,1786,955,831
050,39,103,"Ohio","Medina County",2,20,1907,1014,893
050,39,103,"Ohio","Medina County",2,21,1935,996,939
050,39,103,"Ohio","Medina County",2,22,1944,992,952
050,39,103,"Ohio","Medina County",2,23,1978,1009,969
050,39,103,"Ohio","Medina County",2,24,1915,977,938
050,39,103,"Ohio","Medina County",2,25,1835,924,911
050,39,103,"Ohio","Medina County",2,26,1855,941,914
050,39,103,"Ohio","Medina County",2,27,1885,947,938
050,39,103,"Ohio","Medina County",2,28,1949,972,977
050,39,103,"Ohio","Medina County",2,29,1897,948,949
050,39,103,"Ohio","Medina County",2,30,1918,952,966
050,39,103,"Ohio","Medina County",2,31,1937,963,974
050,39,103,"Ohio","Medina County",2,32,1979,992,987
050,39,103,"Ohio","Medina County",2,33,2086,1062,1024
050,39,103,"Ohio","Medina County",2,34,2194,1106,1088
050,39,103,"Ohio","Medina County",2,35,2232,1117,1115
050,39,103,"Ohio","Medina County",2,36,2217,1103,1114
050,39,103,"Ohio","Medina County",2,37,2245,1143,1102
050,39,103,"Ohio","Medina County",2,38,2338,1171,1167
050,39,103,"Ohio","Medina County",2,39,2387,1194,1193
050,39,103,"Ohio","Medina County",2,40,2434,1212,1222
050,39,103,"Ohio","Medina County",2,41,2350,1189,1161
050,39,103,"Ohio","Medina County",2,42,2271,1149,1122
050,39,103,"Ohio","Medina County",2,43,2278,1146,1132
050,39,103,"Ohio","Medina County",2,44,2255,1142,1113
050,39,103,"Ohio","Medina County",2,45,2227,1124,1103
050,39,103,"Ohio","Medina County",2,46,2208,1116,1092
050,39,103,"Ohio","Medina County",2,47,2325,1164,1161
050,39,103,"Ohio","Medina County",2,48,2539,1298,1241
050,39,103,"Ohio","Medina County",2,49,2783,1421,1362
050,39,103,"Ohio","Medina County",2,50,2639,1327,1312
050,39,103,"Ohio","Medina County",2,51,2554,1256,1298
050,39,103,"Ohio","Medina County",2,52,2583,1284,1299
050,39,103,"Ohio","Medina County",2,53,2657,1335,1322
050,39,103,"Ohio","Medina County",2,54,2717,1360,1357
050,39,103,"Ohio","Medina County",2,55,2771,1381,1390
050,39,103,"Ohio","Medina County",2,56,2820,1387,1433
050,39,103,"Ohio","Medina County",2,57,2795,1394,1401
050,39,103,"Ohio","Medina County",2,58,2744,1376,1368
050,39,103,"Ohio","Medina County",2,59,2749,1377,1372
050,39,103,"Ohio","Medina County",2,60,2684,1333,1351
050,39,103,"Ohio","Medina County",2,61,2697,1339,1358
050,39,103,"Ohio","Medina County",2,62,2713,1365,1348
050,39,103,"Ohio","Medina County",2,63,2570,1297,1273
050,39,103,"Ohio","Medina County",2,64,2455,1217,1238
050,39,103,"Ohio","Medina County",2,65,2427,1167,1260
050,39,103,"Ohio","Medina County",2,66,2302,1119,1183
050,39,103,"Ohio","Medina County",2,67,2219,1068,1151
050,39,103,"Ohio","Medina County",2,68,2182,1043,1139
050,39,103,"Ohio","Medina County",2,69,2063,983,1080
050,39,103,"Ohio","Medina County",2,70,1982,939,1043
050,39,103,"Ohio","Medina County",2,71,1964,932,1032
050,39,103,"Ohio","Medina County",2,72,1957,949,1008
050,39,103,"Ohio","Medina County",2,73,2113,1033,1080
050,39,103,"Ohio","Medina County",2,74,1429,672,757
050,39,103,"Ohio","Medina County",2,75,1315,609,706
050,39,103,"Ohio","Medina County",2,76,1282,591,691
050,39,103,"Ohio","Medina County",2,77,1369,624,745
050,39,103,"Ohio","Medina County",2,78,1176,543,633
050,39,103,"Ohio","Medina County",2,79,1012,458,554
050,39,103,"Ohio","Medina County",2,80,884,400,484
050,39,103,"Ohio","Medina County",2,81,826,379,447
050,39,103,"Ohio","Medina County",2,82,744,322,422
050,39,103,"Ohio","Medina County",2,83,700,306,394
050,39,103,"Ohio","Medina County",2,84,606,266,340
050,39,103,"Ohio","Medina County",2,85,3530,1248,2282
050,39,103,"Ohio","Medina County",3,0,1672,888,784
050,39,103,"Ohio","Medina County",3,1,1736,840,896
050,39,103,"Ohio","Medina County",3,2,1812,899,913
050,39,103,"Ohio","Medina County",3,3,1926,980,946
050,39,103,"Ohio","Medina County",3,4,1940,990,950
050,39,103,"Ohio","Medina County",3,5,2103,1069,1034
050,39,103,"Ohio","Medina County",3,6,2134,1079,1055
050,39,103,"Ohio","Medina County",3,7,2226,1133,1093
050,39,103,"Ohio","Medina County",3,8,2151,1115,1036
050,39,103,"Ohio","Medina County",3,9,2190,1128,1062
050,39,103,"Ohio","Medina County",3,10,2222,1127,1095
050,39,103,"Ohio","Medina County",3,11,2304,1170,1134
050,39,103,"Ohio","Medina County",3,12,2367,1196,1171
050,39,103,"Ohio","Medina County",3,13,2542,1301,1241
050,39,103,"Ohio","Medina County",3,14,2574,1362,1212
050,39,103,"Ohio","Medina County",3,15,2628,1354,1274
050,39,103,"Ohio","Medina County",3,16,2548,1325,1223
050,39,103,"Ohio","Medina County",3,17,2609,1337,1272
050,39,103,"Ohio","Medina County",3,18,2255,1196,1059
050,39,103,"Ohio","Medina County",3,19,1734,920,814
050,39,103,"Ohio","Medina County",3,20,1936,1019,917
050,39,103,"Ohio","Medina County",3,21,2035,1061,974
050,39,103,"Ohio","Medina County",3,22,2022,1021,1001
050,39,103,"Ohio","Medina County",3,23,1965,1029,936
050,39,103,"Ohio","Medina County",3,24,1915,968,947
050,39,103,"Ohio","Medina County",3,25,1841,966,875
050,39,103,"Ohio","Medina County",3,26,1818,918,900
050,39,103,"Ohio","Medina County",3,27,1856,940,916
050,39,103,"Ohio","Medina County",3,28,1918,962,956
050,39,103,"Ohio","Medina County",3,29,2011,1010,1001
050,39,103,"Ohio","Medina County",3,30,1969,989,980
050,39,103,"Ohio","Medina County",3,31,1983,993,990
050,39,103,"Ohio","Medina County",3,32,2041,1006,1035
050,39,103,"Ohio","Medina County",3,33,2051,1042,1009
050,39,103,"Ohio","Medina County",3,34,2149,1080,1069
050,39,103,"Ohio","Medina County",3,35,2293,1174,1119
050,39,103,"Ohio","Medina County",3,36,2263,1143,1120
050,39,103,"Ohio","Medina County",3,37,2247,1113,1134
050,39,103,"Ohio","Medina County",3,38,2298,1168,1130
050,39,103,"Ohio","Medina County",3,39,2366,1187,1179
050,39,103,"Ohio","Medina County",3,40,2393,1200,1193
050,39,103,"Ohio","Medina County",3,41,2491,1241,1250
050,39,103,"Ohio","Medina County",3,42,2348,1181,1167
050,39,103,"Ohio","Medina County",3,43,2276,1152,1124
050,39,103,"Ohio","Medina County",3,44,2313,1164,1149
050,39,103,"Ohio","Medina County",3,45,2262,1139,1123
050,39,103,"Ohio","Medina County",3,46,2227,1137,1090
050,39,103,"Ohio","Medina County",3,47,2219,1121,1098
050,39,103,"Ohio","Medina County",3,48,2338,1189,1149
050,39,103,"Ohio","Medina County",3,49,2529,1273,1256
050,39,103,"Ohio","Medina County",3,50,2765,1412,1353
050,39,103,"Ohio","Medina County",3,51,2650,1330,1320
050,39,103,"Ohio","Medina County",3,52,2561,1270,1291
050,39,103,"Ohio","Medina County",3,53,2602,1301,1301
050,39,103,"Ohio","Medina County",3,54,2638,1334,1304
050,39,103,"Ohio","Medina County",3,55,2710,1361,1349
050,39,103,"Ohio","Medina County",3,56,2736,1366,1370
050,39,103,"Ohio","Medina County",3,57,2811,1381,1430
050,39,103,"Ohio","Medina County",3,58,2761,1378,1383
050,39,103,"Ohio","Medina County",3,59,2742,1367,1375
050,39,103,"Ohio","Medina County",3,60,2726,1372,1354
050,39,103,"Ohio","Medina County",3,61,2709,1343,1366
050,39,103,"Ohio","Medina County",3,62,2670,1331,1339
050,39,103,"Ohio","Medina County",3,63,2681,1349,1332
050,39,103,"Ohio","Medina County",3,64,2541,1280,1261
050,39,103,"Ohio","Medina County",3,65,2443,1212,1231
050,39,103,"Ohio","Medina County",3,66,2386,1138,1248
050,39,103,"Ohio","Medina County",3,67,2256,1093,1163
050,39,103,"Ohio","Medina County",3,68,2192,1052,1140
050,39,103,"Ohio","Medina County",3,69,2139,1003,1136
050,39,103,"Ohio","Medina County",3,70,2019,948,1071
050,39,103,"Ohio","Medina County",3,71,1943,916,1027
050,39,103,"Ohio","Medina County",3,72,1924,906,1018
050,39,103,"Ohio","Medina County",3,73,1906,923,983
050,39,103,"Ohio","Medina County",3,74,2074,1005,1069
050,39,103,"Ohio","Medina County",3,75,1390,657,733
050,39,103,"Ohio","Medina County",3,76,1270,582,688
050,39,103,"Ohio","Medina County",3,77,1224,562,662
050,39,103,"Ohio","Medina County",3,78,1323,601,722
050,39,103,"Ohio","Medina County",3,79,1109,502,607
050,39,103,"Ohio","Medina County",3,80,976,448,528
050,39,103,"Ohio","Medina County",3,81,812,365,447
050,39,103,"Ohio","Medina County",3,82,777,334,443
050,39,103,"Ohio","Medina County",3,83,712,306,406
050,39,103,"Ohio","Medina County",3,84,612,266,346
050,39,103,"Ohio","Medina County",3,85,3558,1280,2278
050,39,103,"Ohio","Medina County",4,0,1662,863,799
050,39,103,"Ohio","Medina County",4,1,1762,935,827
050,39,103,"Ohio","Medina County",4,2,1773,866,907
050,39,103,"Ohio","Medina County",4,3,1879,931,948
050,39,103,"Ohio","Medina County",4,4,1949,981,968
050,39,103,"Ohio","Medina County",4,5,1976,994,982
050,39,103,"Ohio","Medina County",4,6,2126,1080,1046
050,39,103,"Ohio","Medina County",4,7,2180,1105,1075
050,39,103,"Ohio","Medina County",4,8,2217,1114,1103
050,39,103,"Ohio","Medina County",4,9,2173,1130,1043
050,39,103,"Ohio","Medina County",4,10,2229,1153,1076
050,39,103,"Ohio","Medina County",4,11,2229,1135,1094
050,39,103,"Ohio","Medina County",4,12,2324,1175,1149
050,39,103,"Ohio","Medina County",4,13,2380,1203,1177
050,39,103,"Ohio","Medina County",4,14,2564,1300,1264
050,39,103,"Ohio","Medina County",4,15,2598,1370,1228
050,39,103,"Ohio","Medina County",4,16,2644,1360,1284
050,39,103,"Ohio","Medina County",4,17,2550,1314,1236
050,39,103,"Ohio","Medina County",4,18,2156,1149,1007
050,39,103,"Ohio","Medina County",4,19,1722,911,811
050,39,103,"Ohio","Medina County",4,20,1836,974,862
050,39,103,"Ohio","Medina County",4,21,2010,1057,953
050,39,103,"Ohio","Medina County",4,22,2120,1103,1017
050,39,103,"Ohio","Medina County",4,23,2000,1037,963
050,39,103,"Ohio","Medina County",4,24,1871,987,884
050,39,103,"Ohio","Medina County",4,25,1828,905,923
050,39,103,"Ohio","Medina County",4,26,1820,953,867
050,39,103,"Ohio","Medina County",4,27,1787,893,894
050,39,103,"Ohio","Medina County",4,28,1840,912,928
050,39,103,"Ohio","Medina County",4,29,1886,937,949
050,39,103,"Ohio","Medina County",4,30,2056,1016,1040
050,39,103,"Ohio","Medina County",4,31,1997,998,999
050,39,103,"Ohio","Medina County",4,32,2067,1022,1045
050,39,103,"Ohio","Medina County",4,33,2097,1043,1054
050,39,103,"Ohio","Medina County",4,34,2122,1086,1036
050,39,103,"Ohio","Medina County",4,35,2218,1109,1109
050,39,103,"Ohio","Medina County",4,36,2324,1175,1149
050,39,103,"Ohio","Medina County",4,37,2319,1167,1152
050,39,103,"Ohio","Medina County",4,38,2269,1123,1146
050,39,103,"Ohio","Medina County",4,39,2356,1209,1147
050,39,103,"Ohio","Medina County",4,40,2416,1225,1191
050,39,103,"Ohio","Medina County",4,41,2433,1219,1214
050,39,103,"Ohio","Medina County",4,42,2485,1224,1261
050,39,103,"Ohio","Medina County",4,43,2358,1200,1158
050,39,103,"Ohio","Medina County",4,44,2288,1164,1124
050,39,103,"Ohio","Medina County",4,45,2320,1162,1158
050,39,103,"Ohio","Medina County",4,46,2269,1145,1124
050,39,103,"Ohio","Medina County",4,47,2221,1147,1074
050,39,103,"Ohio","Medina County",4,48,2275,1169,1106
050,39,103,"Ohio","Medina County",4,49,2302,1167,1135
050,39,103,"Ohio","Medina County",4,50,2532,1280,1252
050,39,103,"Ohio","Medina County",4,51,2763,1398,1365
050,39,103,"Ohio","Medina County",4,52,2640,1334,1306
050,39,103,"Ohio","Medina County",4,53,2541,1253,1288
050,39,103,"Ohio","Medina County",4,54,2595,1307,1288
050,39,103,"Ohio","Medina County",4,55,2610,1313,1297
050,39,103,"Ohio","Medina County",4,56,2705,1364,1341
050,39,103,"Ohio","Medina County",4,57,2723,1354,1369
050,39,103,"Ohio","Medina County",4,58,2766,1353,1413
050,39,103,"Ohio","Medina County",4,59,2752,1357,1395
050,39,103,"Ohio","Medina County",4,60,2704,1347,1357
050,39,103,"Ohio","Medina County",4,61,2708,1350,1358
050,39,103,"Ohio","Medina County",4,62,2680,1329,1351
050,39,103,"Ohio","Medina County",4,63,2630,1306,1324
050,39,103,"Ohio","Medina County",4,64,2653,1340,1313
050,39,103,"Ohio","Medina County",4,65,2523,1267,1256
050,39,103,"Ohio","Medina County",4,66,2402,1182,1220
050,39,103,"Ohio","Medina County",4,67,2349,1117,1232
050,39,103,"Ohio","Medina County",4,68,2249,1083,1166
050,39,103,"Ohio","Medina County",4,69,2163,1028,1135
050,39,103,"Ohio","Medina County",4,70,2080,981,1099
050,39,103,"Ohio","Medina County",4,71,2019,956,1063
050,39,103,"Ohio","Medina County",4,72,1911,887,1024
050,39,103,"Ohio","Medina County",4,73,1883,868,1015
050,39,103,"Ohio","Medina County",4,74,1863,892,971
050,39,103,"Ohio","Medina County",4,75,2017,971,1046
050,39,103,"Ohio","Medina County",4,76,1339,627,712
050,39,103,"Ohio","Medina County",4,77,1232,562,670
050,39,103,"Ohio","Medina County",4,78,1174,530,644
050,39,103,"Ohio","Medina County",4,79,1267,560,707
050,39,103,"Ohio","Medina County",4,80,1074,484,590
050,39,103,"Ohio","Medina County",4,81,917,422,495
050,39,103,"Ohio","Medina County",4,82,769,322,447
050,39,103,"Ohio","Medina County",4,83,739,317,422
050,39,103,"Ohio","Medina County",4,84,630,270,360
050,39,103,"Ohio","Medina County",4,85,3604,1327,2277
050,39,103,"Ohio","Medina County",5,0,1661,867,794
050,39,103,"Ohio","Medina County",5,1,1764,891,873
050,39,103,"Ohio","Medina County",5,2,1827,979,848
050,39,103,"Ohio","Medina County",5,3,1822,905,917
050,39,103,"Ohio","Medina County",5,4,1929,949,980
050,39,103,"Ohio","Medina County",5,5,2004,1010,994
050,39,103,"Ohio","Medina County",5,6,2051,1036,1015
050,39,103,"Ohio","Medina County",5,7,2149,1094,1055
050,39,103,"Ohio","Medina County",5,8,2199,1119,1080
050,39,103,"Ohio","Medina County",5,9,2244,1120,1124
050,39,103,"Ohio","Medina County",5,10,2192,1147,1045
050,39,103,"Ohio","Medina County",5,11,2249,1165,1084
050,39,103,"Ohio","Medina County",5,12,2253,1150,1103
050,39,103,"Ohio","Medina County",5,13,2350,1188,1162
050,39,103,"Ohio","Medina County",5,14,2367,1208,1159
050,39,103,"Ohio","Medina County",5,15,2553,1293,1260
050,39,103,"Ohio","Medina County",5,16,2573,1353,1220
050,39,103,"Ohio","Medina County",5,17,2644,1361,1283
050,39,103,"Ohio","Medina County",5,18,2122,1139,983
050,39,103,"Ohio","Medina County",5,19,1659,892,767
050,39,103,"Ohio","Medina County",5,20,1887,985,902
050,39,103,"Ohio","Medina County",5,21,1958,1033,925
050,39,103,"Ohio","Medina County",5,22,2074,1080,994
050,39,103,"Ohio","Medina County",5,23,2141,1123,1018
050,39,103,"Ohio","Medina County",5,24,1912,1009,903
050,39,103,"Ohio","Medina County",5,25,1803,967,836
050,39,103,"Ohio","Medina County",5,26,1778,902,876
050,39,103,"Ohio","Medina County",5,27,1820,941,879
050,39,103,"Ohio","Medina County",5,28,1818,922,896
050,39,103,"Ohio","Medina County",5,29,1865,907,958
050,39,103,"Ohio","Medina County",5,30,1936,960,976
050,39,103,"Ohio","Medina County",5,31,2116,1045,1071
050,39,103,"Ohio","Medina County",5,32,2100,1055,1045
050,39,103,"Ohio","Medina County",5,33,2102,1049,1053
050,39,103,"Ohio","Medina County",5,34,2162,1076,1086
050,39,103,"Ohio","Medina County",5,35,2172,1121,1051
050,39,103,"Ohio","Medina County",5,36,2228,1108,1120
050,39,103,"Ohio","Medina County",5,37,2360,1215,1145
050,39,103,"Ohio","Medina County",5,38,2361,1175,1186
050,39,103,"Ohio","Medina County",5,39,2294,1147,1147
050,39,103,"Ohio","Medina County",5,40,2364,1207,1157
050,39,103,"Ohio","Medina County",5,41,2435,1236,1199
050,39,103,"Ohio","Medina County",5,42,2422,1206,1216
050,39,103,"Ohio","Medina County",5,43,2497,1237,1260
050,39,103,"Ohio","Medina County",5,44,2364,1207,1157
050,39,103,"Ohio","Medina County",5,45,2284,1161,1123
050,39,103,"Ohio","Medina County",5,46,2319,1176,1143
050,39,103,"Ohio","Medina County",5,47,2262,1146,1116
050,39,103,"Ohio","Medina County",5,48,2230,1166,1064
050,39,103,"Ohio","Medina County",5,49,2245,1147,1098
050,39,103,"Ohio","Medina County",5,50,2307,1163,1144
050,39,103,"Ohio","Medina County",5,51,2514,1262,1252
050,39,103,"Ohio","Medina County",5,52,2764,1409,1355
050,39,103,"Ohio","Medina County",5,53,2590,1304,1286
050,39,103,"Ohio","Medina County",5,54,2543,1263,1280
050,39,103,"Ohio","Medina County",5,55,2584,1295,1289
050,39,103,"Ohio","Medina County",5,56,2622,1332,1290
050,39,103,"Ohio","Medina County",5,57,2711,1376,1335
050,39,103,"Ohio","Medina County",5,58,2693,1327,1366
050,39,103,"Ohio","Medina County",5,59,2779,1367,1412
050,39,103,"Ohio","Medina County",5,60,2733,1340,1393
050,39,103,"Ohio","Medina County",5,61,2699,1339,1360
050,39,103,"Ohio","Medina County",5,62,2680,1339,1341
050,39,103,"Ohio","Medina County",5,63,2647,1312,1335
050,39,103,"Ohio","Medina County",5,64,2607,1287,1320
050,39,103,"Ohio","Medina County",5,65,2642,1334,1308
050,39,103,"Ohio","Medina County",5,66,2491,1238,1253
050,39,103,"Ohio","Medina County",5,67,2381,1169,1212
050,39,103,"Ohio","Medina County",5,68,2343,1118,1225
050,39,103,"Ohio","Medina County",5,69,2224,1052,1172
050,39,103,"Ohio","Medina County",5,70,2136,1018,1118
050,39,103,"Ohio","Medina County",5,71,2058,968,1090
050,39,103,"Ohio","Medina County",5,72,1987,930,1057
050,39,103,"Ohio","Medina County",5,73,1879,869,1010
050,39,103,"Ohio","Medina County",5,74,1837,844,993
050,39,103,"Ohio","Medina County",5,75,1819,871,948
050,39,103,"Ohio","Medina County",5,76,1985,950,1035
050,39,103,"Ohio","Medina County",5,77,1295,610,685
050,39,103,"Ohio","Medina County",5,78,1192,540,652
050,39,103,"Ohio","Medina County",5,79,1124,501,623
050,39,103,"Ohio","Medina County",5,80,1222,539,683
050,39,103,"Ohio","Medina County",5,81,1028,464,564
050,39,103,"Ohio","Medina County",5,82,864,378,486
050,39,103,"Ohio","Medina County",5,83,744,313,431
050,39,103,"Ohio","Medina County",5,84,659,279,380
050,39,103,"Ohio","Medina County",5,85,3738,1400,2338
050,39,105,"Ohio","Meigs County",1,0,196,103,93
050,39,105,"Ohio","Meigs County",1,1,220,118,102
050,39,105,"Ohio","Meigs County",1,2,248,142,106
050,39,105,"Ohio","Meigs County",1,3,239,139,100
050,39,105,"Ohio","Meigs County",1,4,234,120,114
050,39,105,"Ohio","Meigs County",1,5,232,125,107
050,39,105,"Ohio","Meigs County",1,6,242,128,114
050,39,105,"Ohio","Meigs County",1,7,238,118,120
050,39,105,"Ohio","Meigs County",1,8,248,128,120
050,39,105,"Ohio","Meigs County",1,9,251,125,126
050,39,105,"Ohio","Meigs County",1,10,258,128,130
050,39,105,"Ohio","Meigs County",1,11,282,153,129
050,39,105,"Ohio","Meigs County",1,12,278,147,131
050,39,105,"Ohio","Meigs County",1,13,295,144,151
050,39,105,"Ohio","Meigs County",1,14,287,139,148
050,39,105,"Ohio","Meigs County",1,15,317,152,165
050,39,105,"Ohio","Meigs County",1,16,322,155,167
050,39,105,"Ohio","Meigs County",1,17,302,154,148
050,39,105,"Ohio","Meigs County",1,18,277,147,130
050,39,105,"Ohio","Meigs County",1,19,222,123,99
050,39,105,"Ohio","Meigs County",1,20,219,106,113
050,39,105,"Ohio","Meigs County",1,21,221,114,107
050,39,105,"Ohio","Meigs County",1,22,198,98,100
050,39,105,"Ohio","Meigs County",1,23,206,104,102
050,39,105,"Ohio","Meigs County",1,24,201,105,96
050,39,105,"Ohio","Meigs County",1,25,208,99,109
050,39,105,"Ohio","Meigs County",1,26,224,114,110
050,39,105,"Ohio","Meigs County",1,27,227,114,113
050,39,105,"Ohio","Meigs County",1,28,235,123,112
050,39,105,"Ohio","Meigs County",1,29,251,125,126
050,39,105,"Ohio","Meigs County",1,30,244,108,136
050,39,105,"Ohio","Meigs County",1,31,221,119,102
050,39,105,"Ohio","Meigs County",1,32,216,113,103
050,39,105,"Ohio","Meigs County",1,33,269,140,129
050,39,105,"Ohio","Meigs County",1,34,256,116,140
050,39,105,"Ohio","Meigs County",1,35,251,127,124
050,39,105,"Ohio","Meigs County",1,36,238,106,132
050,39,105,"Ohio","Meigs County",1,37,269,113,156
050,39,105,"Ohio","Meigs County",1,38,270,134,136
050,39,105,"Ohio","Meigs County",1,39,305,155,150
050,39,105,"Ohio","Meigs County",1,40,295,160,135
050,39,105,"Ohio","Meigs County",1,41,286,168,118
050,39,105,"Ohio","Meigs County",1,42,273,148,125
050,39,105,"Ohio","Meigs County",1,43,266,132,134
050,39,105,"Ohio","Meigs County",1,44,269,130,139
050,39,105,"Ohio","Meigs County",1,45,268,124,144
050,39,105,"Ohio","Meigs County",1,46,256,129,127
050,39,105,"Ohio","Meigs County",1,47,273,136,137
050,39,105,"Ohio","Meigs County",1,48,307,146,161
050,39,105,"Ohio","Meigs County",1,49,317,147,170
050,39,105,"Ohio","Meigs County",1,50,322,177,145
050,39,105,"Ohio","Meigs County",1,51,308,165,143
050,39,105,"Ohio","Meigs County",1,52,301,159,142
050,39,105,"Ohio","Meigs County",1,53,314,163,151
050,39,105,"Ohio","Meigs County",1,54,326,169,157
050,39,105,"Ohio","Meigs County",1,55,322,167,155
050,39,105,"Ohio","Meigs County",1,56,324,169,155
050,39,105,"Ohio","Meigs County",1,57,349,176,173
050,39,105,"Ohio","Meigs County",1,58,359,184,175
050,39,105,"Ohio","Meigs County",1,59,357,171,186
050,39,105,"Ohio","Meigs County",1,60,341,163,178
050,39,105,"Ohio","Meigs County",1,61,330,157,173
050,39,105,"Ohio","Meigs County",1,62,347,172,175
050,39,105,"Ohio","Meigs County",1,63,310,147,163
050,39,105,"Ohio","Meigs County",1,64,339,171,168
050,39,105,"Ohio","Meigs County",1,65,346,176,170
050,39,105,"Ohio","Meigs County",1,66,337,176,161
050,39,105,"Ohio","Meigs County",1,67,308,162,146
050,39,105,"Ohio","Meigs County",1,68,315,162,153
050,39,105,"Ohio","Meigs County",1,69,281,134,147
050,39,105,"Ohio","Meigs County",1,70,269,128,141
050,39,105,"Ohio","Meigs County",1,71,256,113,143
050,39,105,"Ohio","Meigs County",1,72,244,109,135
050,39,105,"Ohio","Meigs County",1,73,243,130,113
050,39,105,"Ohio","Meigs County",1,74,171,86,85
050,39,105,"Ohio","Meigs County",1,75,174,82,92
050,39,105,"Ohio","Meigs County",1,76,167,76,91
050,39,105,"Ohio","Meigs County",1,77,164,80,84
050,39,105,"Ohio","Meigs County",1,78,155,74,81
050,39,105,"Ohio","Meigs County",1,79,141,63,78
050,39,105,"Ohio","Meigs County",1,80,109,48,61
050,39,105,"Ohio","Meigs County",1,81,115,55,60
050,39,105,"Ohio","Meigs County",1,82,112,45,67
050,39,105,"Ohio","Meigs County",1,83,102,44,58
050,39,105,"Ohio","Meigs County",1,84,78,34,44
050,39,105,"Ohio","Meigs County",1,85,443,152,291
050,39,105,"Ohio","Meigs County",2,0,197,104,93
050,39,105,"Ohio","Meigs County",2,1,217,116,101
050,39,105,"Ohio","Meigs County",2,2,242,138,104
050,39,105,"Ohio","Meigs County",2,3,237,137,100
050,39,105,"Ohio","Meigs County",2,4,237,126,111
050,39,105,"Ohio","Meigs County",2,5,231,122,109
050,39,105,"Ohio","Meigs County",2,6,240,127,113
050,39,105,"Ohio","Meigs County",2,7,240,121,119
050,39,105,"Ohio","Meigs County",2,8,242,124,118
050,39,105,"Ohio","Meigs County",2,9,248,124,124
050,39,105,"Ohio","Meigs County",2,10,256,127,129
050,39,105,"Ohio","Meigs County",2,11,273,145,128
050,39,105,"Ohio","Meigs County",2,12,281,149,132
050,39,105,"Ohio","Meigs County",2,13,290,144,146
050,39,105,"Ohio","Meigs County",2,14,291,141,150
050,39,105,"Ohio","Meigs County",2,15,309,150,159
050,39,105,"Ohio","Meigs County",2,16,323,155,168
050,39,105,"Ohio","Meigs County",2,17,308,154,154
050,39,105,"Ohio","Meigs County",2,18,269,144,125
050,39,105,"Ohio","Meigs County",2,19,221,120,101
050,39,105,"Ohio","Meigs County",2,20,227,114,113
050,39,105,"Ohio","Meigs County",2,21,218,111,107
050,39,105,"Ohio","Meigs County",2,22,204,102,102
050,39,105,"Ohio","Meigs County",2,23,204,103,101
050,39,105,"Ohio","Meigs County",2,24,202,104,98
050,39,105,"Ohio","Meigs County",2,25,208,100,108
050,39,105,"Ohio","Meigs County",2,26,219,110,109
050,39,105,"Ohio","Meigs County",2,27,225,113,112
050,39,105,"Ohio","Meigs County",2,28,233,120,113
050,39,105,"Ohio","Meigs County",2,29,249,124,125
050,39,105,"Ohio","Meigs County",2,30,245,112,133
050,39,105,"Ohio","Meigs County",2,31,225,117,108
050,39,105,"Ohio","Meigs County",2,32,218,115,103
050,39,105,"Ohio","Meigs County",2,33,257,134,123
050,39,105,"Ohio","Meigs County",2,34,258,121,137
050,39,105,"Ohio","Meigs County",2,35,254,124,130
050,39,105,"Ohio","Meigs County",2,36,240,111,129
050,39,105,"Ohio","Meigs County",2,37,262,111,151
050,39,105,"Ohio","Meigs County",2,38,272,131,141
050,39,105,"Ohio","Meigs County",2,39,298,151,147
050,39,105,"Ohio","Meigs County",2,40,297,160,137
050,39,105,"Ohio","Meigs County",2,41,290,167,123
050,39,105,"Ohio","Meigs County",2,42,275,153,122
050,39,105,"Ohio","Meigs County",2,43,268,136,132
050,39,105,"Ohio","Meigs County",2,44,266,129,137
050,39,105,"Ohio","Meigs County",2,45,269,127,142
050,39,105,"Ohio","Meigs County",2,46,258,128,130
050,39,105,"Ohio","Meigs County",2,47,267,133,134
050,39,105,"Ohio","Meigs County",2,48,299,144,155
050,39,105,"Ohio","Meigs County",2,49,315,148,167
050,39,105,"Ohio","Meigs County",2,50,323,171,152
050,39,105,"Ohio","Meigs County",2,51,310,168,142
050,39,105,"Ohio","Meigs County",2,52,301,159,142
050,39,105,"Ohio","Meigs County",2,53,311,164,147
050,39,105,"Ohio","Meigs County",2,54,324,168,156
050,39,105,"Ohio","Meigs County",2,55,322,167,155
050,39,105,"Ohio","Meigs County",2,56,323,168,155
050,39,105,"Ohio","Meigs County",2,57,343,173,170
050,39,105,"Ohio","Meigs County",2,58,354,181,173
050,39,105,"Ohio","Meigs County",2,59,358,176,182
050,39,105,"Ohio","Meigs County",2,60,340,161,179
050,39,105,"Ohio","Meigs County",2,61,330,158,172
050,39,105,"Ohio","Meigs County",2,62,343,168,175
050,39,105,"Ohio","Meigs County",2,63,320,154,166
050,39,105,"Ohio","Meigs County",2,64,329,163,166
050,39,105,"Ohio","Meigs County",2,65,342,171,171
050,39,105,"Ohio","Meigs County",2,66,338,175,163
050,39,105,"Ohio","Meigs County",2,67,314,164,150
050,39,105,"Ohio","Meigs County",2,68,310,159,151
050,39,105,"Ohio","Meigs County",2,69,291,141,150
050,39,105,"Ohio","Meigs County",2,70,271,129,142
050,39,105,"Ohio","Meigs County",2,71,257,116,141
050,39,105,"Ohio","Meigs County",2,72,242,108,134
050,39,105,"Ohio","Meigs County",2,73,255,130,125
050,39,105,"Ohio","Meigs County",2,74,176,89,87
050,39,105,"Ohio","Meigs County",2,75,175,84,91
050,39,105,"Ohio","Meigs County",2,76,162,74,88
050,39,105,"Ohio","Meigs County",2,77,165,79,86
050,39,105,"Ohio","Meigs County",2,78,150,72,78
050,39,105,"Ohio","Meigs County",2,79,145,65,80
050,39,105,"Ohio","Meigs County",2,80,113,51,62
050,39,105,"Ohio","Meigs County",2,81,111,51,60
050,39,105,"Ohio","Meigs County",2,82,112,47,65
050,39,105,"Ohio","Meigs County",2,83,102,43,59
050,39,105,"Ohio","Meigs County",2,84,82,37,45
050,39,105,"Ohio","Meigs County",2,85,441,154,287
050,39,105,"Ohio","Meigs County",3,0,193,91,102
050,39,105,"Ohio","Meigs County",3,1,200,98,102
050,39,105,"Ohio","Meigs County",3,2,219,119,100
050,39,105,"Ohio","Meigs County",3,3,243,138,105
050,39,105,"Ohio","Meigs County",3,4,240,135,105
050,39,105,"Ohio","Meigs County",3,5,246,134,112
050,39,105,"Ohio","Meigs County",3,6,242,133,109
050,39,105,"Ohio","Meigs County",3,7,235,125,110
050,39,105,"Ohio","Meigs County",3,8,250,126,124
050,39,105,"Ohio","Meigs County",3,9,242,120,122
050,39,105,"Ohio","Meigs County",3,10,265,130,135
050,39,105,"Ohio","Meigs County",3,11,262,136,126
050,39,105,"Ohio","Meigs County",3,12,292,157,135
050,39,105,"Ohio","Meigs County",3,13,285,153,132
050,39,105,"Ohio","Meigs County",3,14,305,153,152
050,39,105,"Ohio","Meigs County",3,15,296,146,150
050,39,105,"Ohio","Meigs County",3,16,310,152,158
050,39,105,"Ohio","Meigs County",3,17,327,155,172
050,39,105,"Ohio","Meigs County",3,18,254,132,122
050,39,105,"Ohio","Meigs County",3,19,202,110,92
050,39,105,"Ohio","Meigs County",3,20,230,121,109
050,39,105,"Ohio","Meigs County",3,21,232,117,115
050,39,105,"Ohio","Meigs County",3,22,224,108,116
050,39,105,"Ohio","Meigs County",3,23,195,95,100
050,39,105,"Ohio","Meigs County",3,24,212,108,104
050,39,105,"Ohio","Meigs County",3,25,199,101,98
050,39,105,"Ohio","Meigs County",3,26,204,92,112
050,39,105,"Ohio","Meigs County",3,27,220,119,101
050,39,105,"Ohio","Meigs County",3,28,226,113,113
050,39,105,"Ohio","Meigs County",3,29,241,128,113
050,39,105,"Ohio","Meigs County",3,30,248,124,124
050,39,105,"Ohio","Meigs County",3,31,246,113,133
050,39,105,"Ohio","Meigs County",3,32,223,117,106
050,39,105,"Ohio","Meigs County",3,33,209,109,100
050,39,105,"Ohio","Meigs County",3,34,253,127,126
050,39,105,"Ohio","Meigs County",3,35,267,127,140
050,39,105,"Ohio","Meigs County",3,36,254,122,132
050,39,105,"Ohio","Meigs County",3,37,245,113,132
050,39,105,"Ohio","Meigs County",3,38,266,114,152
050,39,105,"Ohio","Meigs County",3,39,276,135,141
050,39,105,"Ohio","Meigs County",3,40,311,162,149
050,39,105,"Ohio","Meigs County",3,41,301,162,139
050,39,105,"Ohio","Meigs County",3,42,294,166,128
050,39,105,"Ohio","Meigs County",3,43,266,145,121
050,39,105,"Ohio","Meigs County",3,44,269,134,135
050,39,105,"Ohio","Meigs County",3,45,272,137,135
050,39,105,"Ohio","Meigs County",3,46,275,130,145
050,39,105,"Ohio","Meigs County",3,47,265,130,135
050,39,105,"Ohio","Meigs County",3,48,276,138,138
050,39,105,"Ohio","Meigs County",3,49,301,144,157
050,39,105,"Ohio","Meigs County",3,50,317,151,166
050,39,105,"Ohio","Meigs County",3,51,322,170,152
050,39,105,"Ohio","Meigs County",3,52,302,165,137
050,39,105,"Ohio","Meigs County",3,53,295,158,137
050,39,105,"Ohio","Meigs County",3,54,314,166,148
050,39,105,"Ohio","Meigs County",3,55,324,173,151
050,39,105,"Ohio","Meigs County",3,56,313,166,147
050,39,105,"Ohio","Meigs County",3,57,324,166,158
050,39,105,"Ohio","Meigs County",3,58,337,170,167
050,39,105,"Ohio","Meigs County",3,59,356,181,175
050,39,105,"Ohio","Meigs County",3,60,364,176,188
050,39,105,"Ohio","Meigs County",3,61,337,162,175
050,39,105,"Ohio","Meigs County",3,62,328,153,175
050,39,105,"Ohio","Meigs County",3,63,346,171,175
050,39,105,"Ohio","Meigs County",3,64,315,148,167
050,39,105,"Ohio","Meigs County",3,65,323,162,161
050,39,105,"Ohio","Meigs County",3,66,330,167,163
050,39,105,"Ohio","Meigs County",3,67,337,176,161
050,39,105,"Ohio","Meigs County",3,68,307,160,147
050,39,105,"Ohio","Meigs County",3,69,290,151,139
050,39,105,"Ohio","Meigs County",3,70,288,140,148
050,39,105,"Ohio","Meigs County",3,71,262,126,136
050,39,105,"Ohio","Meigs County",3,72,243,111,132
050,39,105,"Ohio","Meigs County",3,73,234,105,129
050,39,105,"Ohio","Meigs County",3,74,250,129,121
050,39,105,"Ohio","Meigs County",3,75,163,80,83
050,39,105,"Ohio","Meigs County",3,76,163,81,82
050,39,105,"Ohio","Meigs County",3,77,150,64,86
050,39,105,"Ohio","Meigs County",3,78,151,71,80
050,39,105,"Ohio","Meigs County",3,79,147,68,79
050,39,105,"Ohio","Meigs County",3,80,128,58,70
050,39,105,"Ohio","Meigs County",3,81,90,35,55
050,39,105,"Ohio","Meigs County",3,82,103,48,55
050,39,105,"Ohio","Meigs County",3,83,105,45,60
050,39,105,"Ohio","Meigs County",3,84,92,36,56
050,39,105,"Ohio","Meigs County",3,85,420,156,264
050,39,105,"Ohio","Meigs County",4,0,214,105,109
050,39,105,"Ohio","Meigs County",4,1,199,99,100
050,39,105,"Ohio","Meigs County",4,2,199,103,96
050,39,105,"Ohio","Meigs County",4,3,214,116,98
050,39,105,"Ohio","Meigs County",4,4,249,139,110
050,39,105,"Ohio","Meigs County",4,5,251,139,112
050,39,105,"Ohio","Meigs County",4,6,241,126,115
050,39,105,"Ohio","Meigs County",4,7,245,133,112
050,39,105,"Ohio","Meigs County",4,8,245,127,118
050,39,105,"Ohio","Meigs County",4,9,249,125,124
050,39,105,"Ohio","Meigs County",4,10,244,125,119
050,39,105,"Ohio","Meigs County",4,11,261,135,126
050,39,105,"Ohio","Meigs County",4,12,257,137,120
050,39,105,"Ohio","Meigs County",4,13,294,160,134
050,39,105,"Ohio","Meigs County",4,14,288,155,133
050,39,105,"Ohio","Meigs County",4,15,295,145,150
050,39,105,"Ohio","Meigs County",4,16,300,154,146
050,39,105,"Ohio","Meigs County",4,17,310,152,158
050,39,105,"Ohio","Meigs County",4,18,274,134,140
050,39,105,"Ohio","Meigs County",4,19,178,91,87
050,39,105,"Ohio","Meigs County",4,20,206,113,93
050,39,105,"Ohio","Meigs County",4,21,246,128,118
050,39,105,"Ohio","Meigs County",4,22,249,125,124
050,39,105,"Ohio","Meigs County",4,23,236,115,121
050,39,105,"Ohio","Meigs County",4,24,196,95,101
050,39,105,"Ohio","Meigs County",4,25,202,106,96
050,39,105,"Ohio","Meigs County",4,26,200,99,101
050,39,105,"Ohio","Meigs County",4,27,217,97,120
050,39,105,"Ohio","Meigs County",4,28,232,123,109
050,39,105,"Ohio","Meigs County",4,29,228,116,112
050,39,105,"Ohio","Meigs County",4,30,244,126,118
050,39,105,"Ohio","Meigs County",4,31,250,131,119
050,39,105,"Ohio","Meigs County",4,32,247,111,136
050,39,105,"Ohio","Meigs County",4,33,224,116,108
050,39,105,"Ohio","Meigs County",4,34,212,111,101
050,39,105,"Ohio","Meigs County",4,35,249,126,123
050,39,105,"Ohio","Meigs County",4,36,267,125,142
050,39,105,"Ohio","Meigs County",4,37,243,121,122
050,39,105,"Ohio","Meigs County",4,38,250,119,131
050,39,105,"Ohio","Meigs County",4,39,264,112,152
050,39,105,"Ohio","Meigs County",4,40,269,131,138
050,39,105,"Ohio","Meigs County",4,41,303,157,146
050,39,105,"Ohio","Meigs County",4,42,304,158,146
050,39,105,"Ohio","Meigs County",4,43,298,168,130
050,39,105,"Ohio","Meigs County",4,44,267,143,124
050,39,105,"Ohio","Meigs County",4,45,269,132,137
050,39,105,"Ohio","Meigs County",4,46,276,138,138
050,39,105,"Ohio","Meigs County",4,47,275,132,143
050,39,105,"Ohio","Meigs County",4,48,277,141,136
050,39,105,"Ohio","Meigs County",4,49,277,137,140
050,39,105,"Ohio","Meigs County",4,50,309,147,162
050,39,105,"Ohio","Meigs County",4,51,319,147,172
050,39,105,"Ohio","Meigs County",4,52,327,177,150
050,39,105,"Ohio","Meigs County",4,53,297,160,137
050,39,105,"Ohio","Meigs County",4,54,294,155,139
050,39,105,"Ohio","Meigs County",4,55,314,169,145
050,39,105,"Ohio","Meigs County",4,56,325,173,152
050,39,105,"Ohio","Meigs County",4,57,318,168,150
050,39,105,"Ohio","Meigs County",4,58,328,168,160
050,39,105,"Ohio","Meigs County",4,59,327,166,161
050,39,105,"Ohio","Meigs County",4,60,361,180,181
050,39,105,"Ohio","Meigs County",4,61,355,173,182
050,39,105,"Ohio","Meigs County",4,62,331,163,168
050,39,105,"Ohio","Meigs County",4,63,325,150,175
050,39,105,"Ohio","Meigs County",4,64,336,165,171
050,39,105,"Ohio","Meigs County",4,65,308,143,165
050,39,105,"Ohio","Meigs County",4,66,311,156,155
050,39,105,"Ohio","Meigs County",4,67,327,165,162
050,39,105,"Ohio","Meigs County",4,68,328,169,159
050,39,105,"Ohio","Meigs County",4,69,306,157,149
050,39,105,"Ohio","Meigs County",4,70,286,150,136
050,39,105,"Ohio","Meigs County",4,71,280,135,145
050,39,105,"Ohio","Meigs County",4,72,251,121,130
050,39,105,"Ohio","Meigs County",4,73,234,108,126
050,39,105,"Ohio","Meigs County",4,74,226,101,125
050,39,105,"Ohio","Meigs County",4,75,237,119,118
050,39,105,"Ohio","Meigs County",4,76,153,76,77
050,39,105,"Ohio","Meigs County",4,77,147,72,75
050,39,105,"Ohio","Meigs County",4,78,138,56,82
050,39,105,"Ohio","Meigs County",4,79,143,65,78
050,39,105,"Ohio","Meigs County",4,80,136,64,72
050,39,105,"Ohio","Meigs County",4,81,112,50,62
050,39,105,"Ohio","Meigs County",4,82,78,29,49
050,39,105,"Ohio","Meigs County",4,83,94,42,52
050,39,105,"Ohio","Meigs County",4,84,98,41,57
050,39,105,"Ohio","Meigs County",4,85,418,157,261
050,39,105,"Ohio","Meigs County",5,0,206,102,104
050,39,105,"Ohio","Meigs County",5,1,221,115,106
050,39,105,"Ohio","Meigs County",5,2,199,102,97
050,39,105,"Ohio","Meigs County",5,3,196,98,98
050,39,105,"Ohio","Meigs County",5,4,216,115,101
050,39,105,"Ohio","Meigs County",5,5,247,130,117
050,39,105,"Ohio","Meigs County",5,6,245,130,115
050,39,105,"Ohio","Meigs County",5,7,238,128,110
050,39,105,"Ohio","Meigs County",5,8,243,129,114
050,39,105,"Ohio","Meigs County",5,9,246,127,119
050,39,105,"Ohio","Meigs County",5,10,255,134,121
050,39,105,"Ohio","Meigs County",5,11,248,125,123
050,39,105,"Ohio","Meigs County",5,12,267,144,123
050,39,105,"Ohio","Meigs County",5,13,260,140,120
050,39,105,"Ohio","Meigs County",5,14,300,166,134
050,39,105,"Ohio","Meigs County",5,15,277,148,129
050,39,105,"Ohio","Meigs County",5,16,304,153,151
050,39,105,"Ohio","Meigs County",5,17,290,153,137
050,39,105,"Ohio","Meigs County",5,18,254,128,126
050,39,105,"Ohio","Meigs County",5,19,212,107,105
050,39,105,"Ohio","Meigs County",5,20,187,95,92
050,39,105,"Ohio","Meigs County",5,21,222,119,103
050,39,105,"Ohio","Meigs County",5,22,258,134,124
050,39,105,"Ohio","Meigs County",5,23,276,138,138
050,39,105,"Ohio","Meigs County",5,24,221,109,112
050,39,105,"Ohio","Meigs County",5,25,199,95,104
050,39,105,"Ohio","Meigs County",5,26,204,107,97
050,39,105,"Ohio","Meigs County",5,27,218,112,106
050,39,105,"Ohio","Meigs County",5,28,215,101,114
050,39,105,"Ohio","Meigs County",5,29,221,118,103
050,39,105,"Ohio","Meigs County",5,30,230,118,112
050,39,105,"Ohio","Meigs County",5,31,239,118,121
050,39,105,"Ohio","Meigs County",5,32,246,127,119
050,39,105,"Ohio","Meigs County",5,33,235,104,131
050,39,105,"Ohio","Meigs County",5,34,224,118,106
050,39,105,"Ohio","Meigs County",5,35,216,115,101
050,39,105,"Ohio","Meigs County",5,36,259,135,124
050,39,105,"Ohio","Meigs County",5,37,267,126,141
050,39,105,"Ohio","Meigs County",5,38,243,121,122
050,39,105,"Ohio","Meigs County",5,39,238,110,128
050,39,105,"Ohio","Meigs County",5,40,261,112,149
050,39,105,"Ohio","Meigs County",5,41,273,135,138
050,39,105,"Ohio","Meigs County",5,42,311,163,148
050,39,105,"Ohio","Meigs County",5,43,297,154,143
050,39,105,"Ohio","Meigs County",5,44,296,160,136
050,39,105,"Ohio","Meigs County",5,45,268,143,125
050,39,105,"Ohio","Meigs County",5,46,264,133,131
050,39,105,"Ohio","Meigs County",5,47,276,138,138
050,39,105,"Ohio","Meigs County",5,48,272,132,140
050,39,105,"Ohio","Meigs County",5,49,276,134,142
050,39,105,"Ohio","Meigs County",5,50,274,134,140
050,39,105,"Ohio","Meigs County",5,51,310,151,159
050,39,105,"Ohio","Meigs County",5,52,318,144,174
050,39,105,"Ohio","Meigs County",5,53,330,180,150
050,39,105,"Ohio","Meigs County",5,54,296,158,138
050,39,105,"Ohio","Meigs County",5,55,291,151,140
050,39,105,"Ohio","Meigs County",5,56,312,166,146
050,39,105,"Ohio","Meigs County",5,57,314,166,148
050,39,105,"Ohio","Meigs County",5,58,316,167,149
050,39,105,"Ohio","Meigs County",5,59,319,161,158
050,39,105,"Ohio","Meigs County",5,60,330,165,165
050,39,105,"Ohio","Meigs County",5,61,350,174,176
050,39,105,"Ohio","Meigs County",5,62,345,172,173
050,39,105,"Ohio","Meigs County",5,63,328,162,166
050,39,105,"Ohio","Meigs County",5,64,319,145,174
050,39,105,"Ohio","Meigs County",5,65,335,164,171
050,39,105,"Ohio","Meigs County",5,66,297,139,158
050,39,105,"Ohio","Meigs County",5,67,306,155,151
050,39,105,"Ohio","Meigs County",5,68,323,165,158
050,39,105,"Ohio","Meigs County",5,69,322,163,159
050,39,105,"Ohio","Meigs County",5,70,304,157,147
050,39,105,"Ohio","Meigs County",5,71,283,148,135
050,39,105,"Ohio","Meigs County",5,72,266,126,140
050,39,105,"Ohio","Meigs County",5,73,242,117,125
050,39,105,"Ohio","Meigs County",5,74,223,104,119
050,39,105,"Ohio","Meigs County",5,75,208,91,117
050,39,105,"Ohio","Meigs County",5,76,225,114,111
050,39,105,"Ohio","Meigs County",5,77,144,69,75
050,39,105,"Ohio","Meigs County",5,78,134,60,74
050,39,105,"Ohio","Meigs County",5,79,132,53,79
050,39,105,"Ohio","Meigs County",5,80,134,61,73
050,39,105,"Ohio","Meigs County",5,81,118,55,63
050,39,105,"Ohio","Meigs County",5,82,100,42,58
050,39,105,"Ohio","Meigs County",5,83,67,21,46
050,39,105,"Ohio","Meigs County",5,84,85,36,49
050,39,105,"Ohio","Meigs County",5,85,431,171,260
050,39,107,"Ohio","Mercer County",1,0,642,328,314
050,39,107,"Ohio","Mercer County",1,1,673,336,337
050,39,107,"Ohio","Mercer County",1,2,675,335,340
050,39,107,"Ohio","Mercer County",1,3,633,365,268
050,39,107,"Ohio","Mercer County",1,4,649,338,311
050,39,107,"Ohio","Mercer County",1,5,623,310,313
050,39,107,"Ohio","Mercer County",1,6,603,304,299
050,39,107,"Ohio","Mercer County",1,7,601,325,276
050,39,107,"Ohio","Mercer County",1,8,580,310,270
050,39,107,"Ohio","Mercer County",1,9,554,287,267
050,39,107,"Ohio","Mercer County",1,10,609,316,293
050,39,107,"Ohio","Mercer County",1,11,613,302,311
050,39,107,"Ohio","Mercer County",1,12,619,323,296
050,39,107,"Ohio","Mercer County",1,13,633,328,305
050,39,107,"Ohio","Mercer County",1,14,657,341,316
050,39,107,"Ohio","Mercer County",1,15,620,321,299
050,39,107,"Ohio","Mercer County",1,16,603,305,298
050,39,107,"Ohio","Mercer County",1,17,580,300,280
050,39,107,"Ohio","Mercer County",1,18,533,283,250
050,39,107,"Ohio","Mercer County",1,19,443,247,196
050,39,107,"Ohio","Mercer County",1,20,463,248,215
050,39,107,"Ohio","Mercer County",1,21,499,263,236
050,39,107,"Ohio","Mercer County",1,22,503,255,248
050,39,107,"Ohio","Mercer County",1,23,491,262,229
050,39,107,"Ohio","Mercer County",1,24,460,240,220
050,39,107,"Ohio","Mercer County",1,25,457,231,226
050,39,107,"Ohio","Mercer County",1,26,464,233,231
050,39,107,"Ohio","Mercer County",1,27,498,251,247
050,39,107,"Ohio","Mercer County",1,28,540,269,271
050,39,107,"Ohio","Mercer County",1,29,532,278,254
050,39,107,"Ohio","Mercer County",1,30,498,275,223
050,39,107,"Ohio","Mercer County",1,31,468,260,208
050,39,107,"Ohio","Mercer County",1,32,497,261,236
050,39,107,"Ohio","Mercer County",1,33,474,248,226
050,39,107,"Ohio","Mercer County",1,34,488,262,226
050,39,107,"Ohio","Mercer County",1,35,477,250,227
050,39,107,"Ohio","Mercer County",1,36,486,244,242
050,39,107,"Ohio","Mercer County",1,37,516,275,241
050,39,107,"Ohio","Mercer County",1,38,533,279,254
050,39,107,"Ohio","Mercer County",1,39,480,255,225
050,39,107,"Ohio","Mercer County",1,40,451,230,221
050,39,107,"Ohio","Mercer County",1,41,442,229,213
050,39,107,"Ohio","Mercer County",1,42,447,233,214
050,39,107,"Ohio","Mercer County",1,43,427,228,199
050,39,107,"Ohio","Mercer County",1,44,432,227,205
050,39,107,"Ohio","Mercer County",1,45,438,226,212
050,39,107,"Ohio","Mercer County",1,46,432,231,201
050,39,107,"Ohio","Mercer County",1,47,411,218,193
050,39,107,"Ohio","Mercer County",1,48,460,225,235
050,39,107,"Ohio","Mercer County",1,49,496,234,262
050,39,107,"Ohio","Mercer County",1,50,480,248,232
050,39,107,"Ohio","Mercer County",1,51,470,234,236
050,39,107,"Ohio","Mercer County",1,52,453,227,226
050,39,107,"Ohio","Mercer County",1,53,500,258,242
050,39,107,"Ohio","Mercer County",1,54,526,269,257
050,39,107,"Ohio","Mercer County",1,55,508,255,253
050,39,107,"Ohio","Mercer County",1,56,557,289,268
050,39,107,"Ohio","Mercer County",1,57,581,292,289
050,39,107,"Ohio","Mercer County",1,58,630,313,317
050,39,107,"Ohio","Mercer County",1,59,626,316,310
050,39,107,"Ohio","Mercer County",1,60,624,330,294
050,39,107,"Ohio","Mercer County",1,61,625,322,303
050,39,107,"Ohio","Mercer County",1,62,586,293,293
050,39,107,"Ohio","Mercer County",1,63,599,300,299
050,39,107,"Ohio","Mercer County",1,64,627,313,314
050,39,107,"Ohio","Mercer County",1,65,602,308,294
050,39,107,"Ohio","Mercer County",1,66,573,312,261
050,39,107,"Ohio","Mercer County",1,67,544,287,257
050,39,107,"Ohio","Mercer County",1,68,521,253,268
050,39,107,"Ohio","Mercer County",1,69,447,207,240
050,39,107,"Ohio","Mercer County",1,70,421,209,212
050,39,107,"Ohio","Mercer County",1,71,382,191,191
050,39,107,"Ohio","Mercer County",1,72,391,193,198
050,39,107,"Ohio","Mercer County",1,73,399,202,197
050,39,107,"Ohio","Mercer County",1,74,285,138,147
050,39,107,"Ohio","Mercer County",1,75,295,146,149
050,39,107,"Ohio","Mercer County",1,76,274,120,154
050,39,107,"Ohio","Mercer County",1,77,265,109,156
050,39,107,"Ohio","Mercer County",1,78,251,120,131
050,39,107,"Ohio","Mercer County",1,79,195,93,102
050,39,107,"Ohio","Mercer County",1,80,185,84,101
050,39,107,"Ohio","Mercer County",1,81,188,84,104
050,39,107,"Ohio","Mercer County",1,82,191,82,109
050,39,107,"Ohio","Mercer County",1,83,169,78,91
050,39,107,"Ohio","Mercer County",1,84,154,65,89
050,39,107,"Ohio","Mercer County",1,85,1012,353,659
050,39,107,"Ohio","Mercer County",2,0,654,342,312
050,39,107,"Ohio","Mercer County",2,1,665,333,332
050,39,107,"Ohio","Mercer County",2,2,673,336,337
050,39,107,"Ohio","Mercer County",2,3,639,354,285
050,39,107,"Ohio","Mercer County",2,4,647,346,301
050,39,107,"Ohio","Mercer County",2,5,628,316,312
050,39,107,"Ohio","Mercer County",2,6,611,308,303
050,39,107,"Ohio","Mercer County",2,7,603,321,282
050,39,107,"Ohio","Mercer County",2,8,583,312,271
050,39,107,"Ohio","Mercer County",2,9,561,293,268
050,39,107,"Ohio","Mercer County",2,10,597,310,287
050,39,107,"Ohio","Mercer County",2,11,606,305,301
050,39,107,"Ohio","Mercer County",2,12,619,319,300
050,39,107,"Ohio","Mercer County",2,13,628,327,301
050,39,107,"Ohio","Mercer County",2,14,648,336,312
050,39,107,"Ohio","Mercer County",2,15,628,324,304
050,39,107,"Ohio","Mercer County",2,16,610,310,300
050,39,107,"Ohio","Mercer County",2,17,585,300,285
050,39,107,"Ohio","Mercer County",2,18,520,275,245
050,39,107,"Ohio","Mercer County",2,19,444,243,201
050,39,107,"Ohio","Mercer County",2,20,469,252,217
050,39,107,"Ohio","Mercer County",2,21,493,258,235
050,39,107,"Ohio","Mercer County",2,22,504,259,245
050,39,107,"Ohio","Mercer County",2,23,486,257,229
050,39,107,"Ohio","Mercer County",2,24,461,243,218
050,39,107,"Ohio","Mercer County",2,25,457,233,224
050,39,107,"Ohio","Mercer County",2,26,461,230,231
050,39,107,"Ohio","Mercer County",2,27,487,243,244
050,39,107,"Ohio","Mercer County",2,28,528,263,265
050,39,107,"Ohio","Mercer County",2,29,537,279,258
050,39,107,"Ohio","Mercer County",2,30,510,277,233
050,39,107,"Ohio","Mercer County",2,31,476,264,212
050,39,107,"Ohio","Mercer County",2,32,488,258,230
050,39,107,"Ohio","Mercer County",2,33,475,249,226
050,39,107,"Ohio","Mercer County",2,34,483,259,224
050,39,107,"Ohio","Mercer County",2,35,484,254,230
050,39,107,"Ohio","Mercer County",2,36,480,243,237
050,39,107,"Ohio","Mercer County",2,37,511,269,242
050,39,107,"Ohio","Mercer County",2,38,529,278,251
050,39,107,"Ohio","Mercer County",2,39,493,261,232
050,39,107,"Ohio","Mercer County",2,40,461,238,223
050,39,107,"Ohio","Mercer County",2,41,443,227,216
050,39,107,"Ohio","Mercer County",2,42,441,228,213
050,39,107,"Ohio","Mercer County",2,43,433,230,203
050,39,107,"Ohio","Mercer County",2,44,426,226,200
050,39,107,"Ohio","Mercer County",2,45,440,229,211
050,39,107,"Ohio","Mercer County",2,46,428,227,201
050,39,107,"Ohio","Mercer County",2,47,415,221,194
050,39,107,"Ohio","Mercer County",2,48,447,223,224
050,39,107,"Ohio","Mercer County",2,49,490,232,258
050,39,107,"Ohio","Mercer County",2,50,484,243,241
050,39,107,"Ohio","Mercer County",2,51,471,236,235
050,39,107,"Ohio","Mercer County",2,52,455,228,227
050,39,107,"Ohio","Mercer County",2,53,491,252,239
050,39,107,"Ohio","Mercer County",2,54,522,269,253
050,39,107,"Ohio","Mercer County",2,55,513,258,255
050,39,107,"Ohio","Mercer County",2,56,549,283,266
050,39,107,"Ohio","Mercer County",2,57,578,292,286
050,39,107,"Ohio","Mercer County",2,58,617,307,310
050,39,107,"Ohio","Mercer County",2,59,630,318,312
050,39,107,"Ohio","Mercer County",2,60,622,326,296
050,39,107,"Ohio","Mercer County",2,61,622,323,299
050,39,107,"Ohio","Mercer County",2,62,593,300,293
050,39,107,"Ohio","Mercer County",2,63,601,300,301
050,39,107,"Ohio","Mercer County",2,64,613,305,308
050,39,107,"Ohio","Mercer County",2,65,607,308,299
050,39,107,"Ohio","Mercer County",2,66,579,311,268
050,39,107,"Ohio","Mercer County",2,67,548,295,253
050,39,107,"Ohio","Mercer County",2,68,521,259,262
050,39,107,"Ohio","Mercer County",2,69,466,219,247
050,39,107,"Ohio","Mercer County",2,70,429,209,220
050,39,107,"Ohio","Mercer County",2,71,386,192,194
050,39,107,"Ohio","Mercer County",2,72,380,188,192
050,39,107,"Ohio","Mercer County",2,73,414,206,208
050,39,107,"Ohio","Mercer County",2,74,293,144,149
050,39,107,"Ohio","Mercer County",2,75,294,144,150
050,39,107,"Ohio","Mercer County",2,76,276,123,153
050,39,107,"Ohio","Mercer County",2,77,273,114,159
050,39,107,"Ohio","Mercer County",2,78,247,114,133
050,39,107,"Ohio","Mercer County",2,79,206,98,108
050,39,107,"Ohio","Mercer County",2,80,183,84,99
050,39,107,"Ohio","Mercer County",2,81,186,84,102
050,39,107,"Ohio","Mercer County",2,82,188,80,108
050,39,107,"Ohio","Mercer County",2,83,169,76,93
050,39,107,"Ohio","Mercer County",2,84,154,66,88
050,39,107,"Ohio","Mercer County",2,85,997,345,652
050,39,107,"Ohio","Mercer County",3,0,620,304,316
050,39,107,"Ohio","Mercer County",3,1,652,345,307
050,39,107,"Ohio","Mercer County",3,2,664,331,333
050,39,107,"Ohio","Mercer County",3,3,673,337,336
050,39,107,"Ohio","Mercer County",3,4,638,353,285
050,39,107,"Ohio","Mercer County",3,5,636,339,297
050,39,107,"Ohio","Mercer County",3,6,615,313,302
050,39,107,"Ohio","Mercer County",3,7,602,302,300
050,39,107,"Ohio","Mercer County",3,8,590,317,273
050,39,107,"Ohio","Mercer County",3,9,582,314,268
050,39,107,"Ohio","Mercer County",3,10,560,295,265
050,39,107,"Ohio","Mercer County",3,11,589,298,291
050,39,107,"Ohio","Mercer County",3,12,603,299,304
050,39,107,"Ohio","Mercer County",3,13,607,305,302
050,39,107,"Ohio","Mercer County",3,14,621,323,298
050,39,107,"Ohio","Mercer County",3,15,633,332,301
050,39,107,"Ohio","Mercer County",3,16,635,329,306
050,39,107,"Ohio","Mercer County",3,17,610,314,296
050,39,107,"Ohio","Mercer County",3,18,505,271,234
050,39,107,"Ohio","Mercer County",3,19,426,227,199
050,39,107,"Ohio","Mercer County",3,20,461,255,206
050,39,107,"Ohio","Mercer County",3,21,478,256,222
050,39,107,"Ohio","Mercer County",3,22,500,262,238
050,39,107,"Ohio","Mercer County",3,23,498,254,244
050,39,107,"Ohio","Mercer County",3,24,474,244,230
050,39,107,"Ohio","Mercer County",3,25,434,237,197
050,39,107,"Ohio","Mercer County",3,26,456,232,224
050,39,107,"Ohio","Mercer County",3,27,450,219,231
050,39,107,"Ohio","Mercer County",3,28,471,227,244
050,39,107,"Ohio","Mercer County",3,29,531,260,271
050,39,107,"Ohio","Mercer County",3,30,529,273,256
050,39,107,"Ohio","Mercer County",3,31,519,282,237
050,39,107,"Ohio","Mercer County",3,32,478,266,212
050,39,107,"Ohio","Mercer County",3,33,476,249,227
050,39,107,"Ohio","Mercer County",3,34,483,255,228
050,39,107,"Ohio","Mercer County",3,35,473,251,222
050,39,107,"Ohio","Mercer County",3,36,485,255,230
050,39,107,"Ohio","Mercer County",3,37,485,252,233
050,39,107,"Ohio","Mercer County",3,38,507,264,243
050,39,107,"Ohio","Mercer County",3,39,517,269,248
050,39,107,"Ohio","Mercer County",3,40,495,259,236
050,39,107,"Ohio","Mercer County",3,41,456,234,222
050,39,107,"Ohio","Mercer County",3,42,455,236,219
050,39,107,"Ohio","Mercer County",3,43,439,229,210
050,39,107,"Ohio","Mercer County",3,44,443,236,207
050,39,107,"Ohio","Mercer County",3,45,422,222,200
050,39,107,"Ohio","Mercer County",3,46,441,230,211
050,39,107,"Ohio","Mercer County",3,47,432,228,204
050,39,107,"Ohio","Mercer County",3,48,415,214,201
050,39,107,"Ohio","Mercer County",3,49,438,219,219
050,39,107,"Ohio","Mercer County",3,50,482,232,250
050,39,107,"Ohio","Mercer County",3,51,483,242,241
050,39,107,"Ohio","Mercer County",3,52,470,233,237
050,39,107,"Ohio","Mercer County",3,53,456,225,231
050,39,107,"Ohio","Mercer County",3,54,497,257,240
050,39,107,"Ohio","Mercer County",3,55,521,263,258
050,39,107,"Ohio","Mercer County",3,56,520,264,256
050,39,107,"Ohio","Mercer County",3,57,544,280,264
050,39,107,"Ohio","Mercer County",3,58,574,289,285
050,39,107,"Ohio","Mercer County",3,59,611,307,304
050,39,107,"Ohio","Mercer County",3,60,625,313,312
050,39,107,"Ohio","Mercer County",3,61,618,320,298
050,39,107,"Ohio","Mercer County",3,62,607,316,291
050,39,107,"Ohio","Mercer County",3,63,587,295,292
050,39,107,"Ohio","Mercer County",3,64,587,290,297
050,39,107,"Ohio","Mercer County",3,65,616,307,309
050,39,107,"Ohio","Mercer County",3,66,607,301,306
050,39,107,"Ohio","Mercer County",3,67,564,304,260
050,39,107,"Ohio","Mercer County",3,68,538,292,246
050,39,107,"Ohio","Mercer County",3,69,514,255,259
050,39,107,"Ohio","Mercer County",3,70,470,223,247
050,39,107,"Ohio","Mercer County",3,71,407,200,207
050,39,107,"Ohio","Mercer County",3,72,378,182,196
050,39,107,"Ohio","Mercer County",3,73,366,183,183
050,39,107,"Ohio","Mercer County",3,74,397,196,201
050,39,107,"Ohio","Mercer County",3,75,289,143,146
050,39,107,"Ohio","Mercer County",3,76,282,136,146
050,39,107,"Ohio","Mercer County",3,77,262,117,145
050,39,107,"Ohio","Mercer County",3,78,265,113,152
050,39,107,"Ohio","Mercer County",3,79,233,101,132
050,39,107,"Ohio","Mercer County",3,80,193,88,105
050,39,107,"Ohio","Mercer County",3,81,169,74,95
050,39,107,"Ohio","Mercer County",3,82,179,80,99
050,39,107,"Ohio","Mercer County",3,83,166,70,96
050,39,107,"Ohio","Mercer County",3,84,150,62,88
050,39,107,"Ohio","Mercer County",3,85,963,341,622
050,39,107,"Ohio","Mercer County",4,0,634,333,301
050,39,107,"Ohio","Mercer County",4,1,620,312,308
050,39,107,"Ohio","Mercer County",4,2,641,334,307
050,39,107,"Ohio","Mercer County",4,3,661,333,328
050,39,107,"Ohio","Mercer County",4,4,672,336,336
050,39,107,"Ohio","Mercer County",4,5,637,352,285
050,39,107,"Ohio","Mercer County",4,6,637,334,303
050,39,107,"Ohio","Mercer County",4,7,617,309,308
050,39,107,"Ohio","Mercer County",4,8,604,299,305
050,39,107,"Ohio","Mercer County",4,9,592,316,276
050,39,107,"Ohio","Mercer County",4,10,584,315,269
050,39,107,"Ohio","Mercer County",4,11,558,300,258
050,39,107,"Ohio","Mercer County",4,12,577,294,283
050,39,107,"Ohio","Mercer County",4,13,605,301,304
050,39,107,"Ohio","Mercer County",4,14,614,309,305
050,39,107,"Ohio","Mercer County",4,15,629,326,303
050,39,107,"Ohio","Mercer County",4,16,626,325,301
050,39,107,"Ohio","Mercer County",4,17,639,326,313
050,39,107,"Ohio","Mercer County",4,18,523,282,241
050,39,107,"Ohio","Mercer County",4,19,407,222,185
050,39,107,"Ohio","Mercer County",4,20,448,233,215
050,39,107,"Ohio","Mercer County",4,21,473,253,220
050,39,107,"Ohio","Mercer County",4,22,489,263,226
050,39,107,"Ohio","Mercer County",4,23,515,277,238
050,39,107,"Ohio","Mercer County",4,24,499,253,246
050,39,107,"Ohio","Mercer County",4,25,448,236,212
050,39,107,"Ohio","Mercer County",4,26,437,241,196
050,39,107,"Ohio","Mercer County",4,27,438,218,220
050,39,107,"Ohio","Mercer County",4,28,449,221,228
050,39,107,"Ohio","Mercer County",4,29,461,224,237
050,39,107,"Ohio","Mercer County",4,30,541,261,280
050,39,107,"Ohio","Mercer County",4,31,545,279,266
050,39,107,"Ohio","Mercer County",4,32,519,285,234
050,39,107,"Ohio","Mercer County",4,33,480,270,210
050,39,107,"Ohio","Mercer County",4,34,481,256,225
050,39,107,"Ohio","Mercer County",4,35,478,253,225
050,39,107,"Ohio","Mercer County",4,36,473,249,224
050,39,107,"Ohio","Mercer County",4,37,487,259,228
050,39,107,"Ohio","Mercer County",4,38,479,243,236
050,39,107,"Ohio","Mercer County",4,39,523,275,248
050,39,107,"Ohio","Mercer County",4,40,517,271,246
050,39,107,"Ohio","Mercer County",4,41,492,258,234
050,39,107,"Ohio","Mercer County",4,42,458,240,218
050,39,107,"Ohio","Mercer County",4,43,454,238,216
050,39,107,"Ohio","Mercer County",4,44,443,236,207
050,39,107,"Ohio","Mercer County",4,45,446,235,211
050,39,107,"Ohio","Mercer County",4,46,420,222,198
050,39,107,"Ohio","Mercer County",4,47,444,230,214
050,39,107,"Ohio","Mercer County",4,48,424,219,205
050,39,107,"Ohio","Mercer County",4,49,425,216,209
050,39,107,"Ohio","Mercer County",4,50,430,215,215
050,39,107,"Ohio","Mercer County",4,51,482,230,252
050,39,107,"Ohio","Mercer County",4,52,483,240,243
050,39,107,"Ohio","Mercer County",4,53,470,233,237
050,39,107,"Ohio","Mercer County",4,54,464,229,235
050,39,107,"Ohio","Mercer County",4,55,487,248,239
050,39,107,"Ohio","Mercer County",4,56,520,266,254
050,39,107,"Ohio","Mercer County",4,57,531,271,260
050,39,107,"Ohio","Mercer County",4,58,540,275,265
050,39,107,"Ohio","Mercer County",4,59,566,287,279
050,39,107,"Ohio","Mercer County",4,60,601,302,299
050,39,107,"Ohio","Mercer County",4,61,622,308,314
050,39,107,"Ohio","Mercer County",4,62,611,321,290
050,39,107,"Ohio","Mercer County",4,63,587,308,279
050,39,107,"Ohio","Mercer County",4,64,572,286,286
050,39,107,"Ohio","Mercer County",4,65,573,286,287
050,39,107,"Ohio","Mercer County",4,66,609,301,308
050,39,107,"Ohio","Mercer County",4,67,594,296,298
050,39,107,"Ohio","Mercer County",4,68,559,301,258
050,39,107,"Ohio","Mercer County",4,69,522,280,242
050,39,107,"Ohio","Mercer County",4,70,500,245,255
050,39,107,"Ohio","Mercer County",4,71,453,216,237
050,39,107,"Ohio","Mercer County",4,72,405,198,207
050,39,107,"Ohio","Mercer County",4,73,367,172,195
050,39,107,"Ohio","Mercer County",4,74,353,178,175
050,39,107,"Ohio","Mercer County",4,75,386,182,204
050,39,107,"Ohio","Mercer County",4,76,282,139,143
050,39,107,"Ohio","Mercer County",4,77,265,130,135
050,39,107,"Ohio","Mercer County",4,78,250,109,141
050,39,107,"Ohio","Mercer County",4,79,254,100,154
050,39,107,"Ohio","Mercer County",4,80,222,92,130
050,39,107,"Ohio","Mercer County",4,81,184,85,99
050,39,107,"Ohio","Mercer County",4,82,165,68,97
050,39,107,"Ohio","Mercer County",4,83,156,70,86
050,39,107,"Ohio","Mercer County",4,84,154,61,93
050,39,107,"Ohio","Mercer County",4,85,942,339,603
050,39,107,"Ohio","Mercer County",5,0,646,339,307
050,39,107,"Ohio","Mercer County",5,1,618,328,290
050,39,107,"Ohio","Mercer County",5,2,614,315,299
050,39,107,"Ohio","Mercer County",5,3,654,344,310
050,39,107,"Ohio","Mercer County",5,4,671,336,335
050,39,107,"Ohio","Mercer County",5,5,663,331,332
050,39,107,"Ohio","Mercer County",5,6,631,350,281
050,39,107,"Ohio","Mercer County",5,7,634,340,294
050,39,107,"Ohio","Mercer County",5,8,616,307,309
050,39,107,"Ohio","Mercer County",5,9,603,304,299
050,39,107,"Ohio","Mercer County",5,10,586,316,270
050,39,107,"Ohio","Mercer County",5,11,580,313,267
050,39,107,"Ohio","Mercer County",5,12,563,304,259
050,39,107,"Ohio","Mercer County",5,13,576,297,279
050,39,107,"Ohio","Mercer County",5,14,603,302,301
050,39,107,"Ohio","Mercer County",5,15,618,308,310
050,39,107,"Ohio","Mercer County",5,16,619,315,304
050,39,107,"Ohio","Mercer County",5,17,631,337,294
050,39,107,"Ohio","Mercer County",5,18,545,286,259
050,39,107,"Ohio","Mercer County",5,19,432,232,200
050,39,107,"Ohio","Mercer County",5,20,423,228,195
050,39,107,"Ohio","Mercer County",5,21,466,236,230
050,39,107,"Ohio","Mercer County",5,22,497,268,229
050,39,107,"Ohio","Mercer County",5,23,480,268,212
050,39,107,"Ohio","Mercer County",5,24,484,267,217
050,39,107,"Ohio","Mercer County",5,25,495,257,238
050,39,107,"Ohio","Mercer County",5,26,461,248,213
050,39,107,"Ohio","Mercer County",5,27,439,234,205
050,39,107,"Ohio","Mercer County",5,28,436,225,211
050,39,107,"Ohio","Mercer County",5,29,451,226,225
050,39,107,"Ohio","Mercer County",5,30,460,227,233
050,39,107,"Ohio","Mercer County",5,31,541,266,275
050,39,107,"Ohio","Mercer County",5,32,561,282,279
050,39,107,"Ohio","Mercer County",5,33,518,288,230
050,39,107,"Ohio","Mercer County",5,34,476,269,207
050,39,107,"Ohio","Mercer County",5,35,486,258,228
050,39,107,"Ohio","Mercer County",5,36,463,247,216
050,39,107,"Ohio","Mercer County",5,37,473,250,223
050,39,107,"Ohio","Mercer County",5,38,477,256,221
050,39,107,"Ohio","Mercer County",5,39,488,251,237
050,39,107,"Ohio","Mercer County",5,40,514,267,247
050,39,107,"Ohio","Mercer County",5,41,511,268,243
050,39,107,"Ohio","Mercer County",5,42,498,257,241
050,39,107,"Ohio","Mercer County",5,43,455,240,215
050,39,107,"Ohio","Mercer County",5,44,449,237,212
050,39,107,"Ohio","Mercer County",5,45,445,234,211
050,39,107,"Ohio","Mercer County",5,46,447,237,210
050,39,107,"Ohio","Mercer County",5,47,420,225,195
050,39,107,"Ohio","Mercer County",5,48,432,219,213
050,39,107,"Ohio","Mercer County",5,49,424,213,211
050,39,107,"Ohio","Mercer County",5,50,421,216,205
050,39,107,"Ohio","Mercer County",5,51,423,212,211
050,39,107,"Ohio","Mercer County",5,52,481,230,251
050,39,107,"Ohio","Mercer County",5,53,481,239,242
050,39,107,"Ohio","Mercer County",5,54,468,236,232
050,39,107,"Ohio","Mercer County",5,55,460,226,234
050,39,107,"Ohio","Mercer County",5,56,494,255,239
050,39,107,"Ohio","Mercer County",5,57,517,259,258
050,39,107,"Ohio","Mercer County",5,58,528,271,257
050,39,107,"Ohio","Mercer County",5,59,538,277,261
050,39,107,"Ohio","Mercer County",5,60,551,282,269
050,39,107,"Ohio","Mercer County",5,61,601,301,300
050,39,107,"Ohio","Mercer County",5,62,610,302,308
050,39,107,"Ohio","Mercer County",5,63,605,319,286
050,39,107,"Ohio","Mercer County",5,64,579,304,275
050,39,107,"Ohio","Mercer County",5,65,572,287,285
050,39,107,"Ohio","Mercer County",5,66,569,280,289
050,39,107,"Ohio","Mercer County",5,67,604,302,302
050,39,107,"Ohio","Mercer County",5,68,584,291,293
050,39,107,"Ohio","Mercer County",5,69,550,288,262
050,39,107,"Ohio","Mercer County",5,70,515,274,241
050,39,107,"Ohio","Mercer County",5,71,485,239,246
050,39,107,"Ohio","Mercer County",5,72,443,210,233
050,39,107,"Ohio","Mercer County",5,73,390,190,200
050,39,107,"Ohio","Mercer County",5,74,350,163,187
050,39,107,"Ohio","Mercer County",5,75,348,167,181
050,39,107,"Ohio","Mercer County",5,76,380,178,202
050,39,107,"Ohio","Mercer County",5,77,261,128,133
050,39,107,"Ohio","Mercer County",5,78,254,124,130
050,39,107,"Ohio","Mercer County",5,79,242,101,141
050,39,107,"Ohio","Mercer County",5,80,240,93,147
050,39,107,"Ohio","Mercer County",5,81,213,88,125
050,39,107,"Ohio","Mercer County",5,82,175,77,98
050,39,107,"Ohio","Mercer County",5,83,144,59,85
050,39,107,"Ohio","Mercer County",5,84,144,61,83
050,39,107,"Ohio","Mercer County",5,85,946,348,598
050,39,109,"Ohio","Miami County",1,0,1184,602,582
050,39,109,"Ohio","Miami County",1,1,1195,613,582
050,39,109,"Ohio","Miami County",1,2,1276,646,630
050,39,109,"Ohio","Miami County",1,3,1310,637,673
050,39,109,"Ohio","Miami County",1,4,1369,671,698
050,39,109,"Ohio","Miami County",1,5,1429,731,698
050,39,109,"Ohio","Miami County",1,6,1378,726,652
050,39,109,"Ohio","Miami County",1,7,1314,641,673
050,39,109,"Ohio","Miami County",1,8,1360,675,685
050,39,109,"Ohio","Miami County",1,9,1432,741,691
050,39,109,"Ohio","Miami County",1,10,1476,780,696
050,39,109,"Ohio","Miami County",1,11,1524,811,713
050,39,109,"Ohio","Miami County",1,12,1509,749,760
050,39,109,"Ohio","Miami County",1,13,1528,805,723
050,39,109,"Ohio","Miami County",1,14,1496,803,693
050,39,109,"Ohio","Miami County",1,15,1474,768,706
050,39,109,"Ohio","Miami County",1,16,1506,781,725
050,39,109,"Ohio","Miami County",1,17,1501,773,728
050,39,109,"Ohio","Miami County",1,18,1281,661,620
050,39,109,"Ohio","Miami County",1,19,1030,535,495
050,39,109,"Ohio","Miami County",1,20,1043,526,517
050,39,109,"Ohio","Miami County",1,21,1025,541,484
050,39,109,"Ohio","Miami County",1,22,1138,600,538
050,39,109,"Ohio","Miami County",1,23,1141,597,544
050,39,109,"Ohio","Miami County",1,24,1163,601,562
050,39,109,"Ohio","Miami County",1,25,1130,577,553
050,39,109,"Ohio","Miami County",1,26,1202,624,578
050,39,109,"Ohio","Miami County",1,27,1225,630,595
050,39,109,"Ohio","Miami County",1,28,1295,628,667
050,39,109,"Ohio","Miami County",1,29,1326,644,682
050,39,109,"Ohio","Miami County",1,30,1288,653,635
050,39,109,"Ohio","Miami County",1,31,1312,671,641
050,39,109,"Ohio","Miami County",1,32,1335,689,646
050,39,109,"Ohio","Miami County",1,33,1332,677,655
050,39,109,"Ohio","Miami County",1,34,1346,685,661
050,39,109,"Ohio","Miami County",1,35,1362,683,679
050,39,109,"Ohio","Miami County",1,36,1415,713,702
050,39,109,"Ohio","Miami County",1,37,1450,719,731
050,39,109,"Ohio","Miami County",1,38,1400,730,670
050,39,109,"Ohio","Miami County",1,39,1380,708,672
050,39,109,"Ohio","Miami County",1,40,1374,688,686
050,39,109,"Ohio","Miami County",1,41,1366,668,698
050,39,109,"Ohio","Miami County",1,42,1292,643,649
050,39,109,"Ohio","Miami County",1,43,1244,634,610
050,39,109,"Ohio","Miami County",1,44,1171,589,582
050,39,109,"Ohio","Miami County",1,45,1287,648,639
050,39,109,"Ohio","Miami County",1,46,1288,651,637
050,39,109,"Ohio","Miami County",1,47,1330,657,673
050,39,109,"Ohio","Miami County",1,48,1418,708,710
050,39,109,"Ohio","Miami County",1,49,1595,800,795
050,39,109,"Ohio","Miami County",1,50,1489,762,727
050,39,109,"Ohio","Miami County",1,51,1382,690,692
050,39,109,"Ohio","Miami County",1,52,1380,703,677
050,39,109,"Ohio","Miami County",1,53,1435,727,708
050,39,109,"Ohio","Miami County",1,54,1371,719,652
050,39,109,"Ohio","Miami County",1,55,1437,749,688
050,39,109,"Ohio","Miami County",1,56,1516,764,752
050,39,109,"Ohio","Miami County",1,57,1526,751,775
050,39,109,"Ohio","Miami County",1,58,1575,776,799
050,39,109,"Ohio","Miami County",1,59,1581,776,805
050,39,109,"Ohio","Miami County",1,60,1509,745,764
050,39,109,"Ohio","Miami County",1,61,1548,756,792
050,39,109,"Ohio","Miami County",1,62,1543,746,797
050,39,109,"Ohio","Miami County",1,63,1463,706,757
050,39,109,"Ohio","Miami County",1,64,1444,709,735
050,39,109,"Ohio","Miami County",1,65,1395,687,708
050,39,109,"Ohio","Miami County",1,66,1331,646,685
050,39,109,"Ohio","Miami County",1,67,1307,642,665
050,39,109,"Ohio","Miami County",1,68,1256,595,661
050,39,109,"Ohio","Miami County",1,69,1179,541,638
050,39,109,"Ohio","Miami County",1,70,1145,511,634
050,39,109,"Ohio","Miami County",1,71,1178,530,648
050,39,109,"Ohio","Miami County",1,72,1223,562,661
050,39,109,"Ohio","Miami County",1,73,1192,563,629
050,39,109,"Ohio","Miami County",1,74,818,393,425
050,39,109,"Ohio","Miami County",1,75,832,396,436
050,39,109,"Ohio","Miami County",1,76,818,378,440
050,39,109,"Ohio","Miami County",1,77,817,376,441
050,39,109,"Ohio","Miami County",1,78,690,313,377
050,39,109,"Ohio","Miami County",1,79,605,267,338
050,39,109,"Ohio","Miami County",1,80,557,222,335
050,39,109,"Ohio","Miami County",1,81,553,225,328
050,39,109,"Ohio","Miami County",1,82,518,212,306
050,39,109,"Ohio","Miami County",1,83,437,178,259
050,39,109,"Ohio","Miami County",1,84,407,161,246
050,39,109,"Ohio","Miami County",1,85,2073,751,1322
050,39,109,"Ohio","Miami County",2,0,1184,605,579
050,39,109,"Ohio","Miami County",2,1,1191,612,579
050,39,109,"Ohio","Miami County",2,2,1263,639,624
050,39,109,"Ohio","Miami County",2,3,1303,640,663
050,39,109,"Ohio","Miami County",2,4,1371,673,698
050,39,109,"Ohio","Miami County",2,5,1420,720,700
050,39,109,"Ohio","Miami County",2,6,1395,727,668
050,39,109,"Ohio","Miami County",2,7,1334,665,669
050,39,109,"Ohio","Miami County",2,8,1354,672,682
050,39,109,"Ohio","Miami County",2,9,1422,728,694
050,39,109,"Ohio","Miami County",2,10,1468,772,696
050,39,109,"Ohio","Miami County",2,11,1511,798,713
050,39,109,"Ohio","Miami County",2,12,1521,768,753
050,39,109,"Ohio","Miami County",2,13,1524,790,734
050,39,109,"Ohio","Miami County",2,14,1504,802,702
050,39,109,"Ohio","Miami County",2,15,1480,779,701
050,39,109,"Ohio","Miami County",2,16,1500,783,717
050,39,109,"Ohio","Miami County",2,17,1505,777,728
050,39,109,"Ohio","Miami County",2,18,1272,664,608
050,39,109,"Ohio","Miami County",2,19,1032,533,499
050,39,109,"Ohio","Miami County",2,20,1061,537,524
050,39,109,"Ohio","Miami County",2,21,1039,540,499
050,39,109,"Ohio","Miami County",2,22,1126,592,534
050,39,109,"Ohio","Miami County",2,23,1159,609,550
050,39,109,"Ohio","Miami County",2,24,1159,602,557
050,39,109,"Ohio","Miami County",2,25,1146,590,556
050,39,109,"Ohio","Miami County",2,26,1193,619,574
050,39,109,"Ohio","Miami County",2,27,1221,629,592
050,39,109,"Ohio","Miami County",2,28,1283,632,651
050,39,109,"Ohio","Miami County",2,29,1319,641,678
050,39,109,"Ohio","Miami County",2,30,1308,657,651
050,39,109,"Ohio","Miami County",2,31,1309,669,640
050,39,109,"Ohio","Miami County",2,32,1332,685,647
050,39,109,"Ohio","Miami County",2,33,1341,684,657
050,39,109,"Ohio","Miami County",2,34,1346,687,659
050,39,109,"Ohio","Miami County",2,35,1369,691,678
050,39,109,"Ohio","Miami County",2,36,1396,700,696
050,39,109,"Ohio","Miami County",2,37,1448,721,727
050,39,109,"Ohio","Miami County",2,38,1420,729,691
050,39,109,"Ohio","Miami County",2,39,1385,712,673
050,39,109,"Ohio","Miami County",2,40,1388,697,691
050,39,109,"Ohio","Miami County",2,41,1372,677,695
050,39,109,"Ohio","Miami County",2,42,1309,647,662
050,39,109,"Ohio","Miami County",2,43,1264,642,622
050,39,109,"Ohio","Miami County",2,44,1177,595,582
050,39,109,"Ohio","Miami County",2,45,1264,635,629
050,39,109,"Ohio","Miami County",2,46,1282,648,634
050,39,109,"Ohio","Miami County",2,47,1315,654,661
050,39,109,"Ohio","Miami County",2,48,1396,696,700
050,39,109,"Ohio","Miami County",2,49,1561,786,775
050,39,109,"Ohio","Miami County",2,50,1514,769,745
050,39,109,"Ohio","Miami County",2,51,1410,709,701
050,39,109,"Ohio","Miami County",2,52,1376,698,678
050,39,109,"Ohio","Miami County",2,53,1418,721,697
050,39,109,"Ohio","Miami County",2,54,1382,717,665
050,39,109,"Ohio","Miami County",2,55,1422,741,681
050,39,109,"Ohio","Miami County",2,56,1500,762,738
050,39,109,"Ohio","Miami County",2,57,1521,752,769
050,39,109,"Ohio","Miami County",2,58,1560,770,790
050,39,109,"Ohio","Miami County",2,59,1585,778,807
050,39,109,"Ohio","Miami County",2,60,1520,749,771
050,39,109,"Ohio","Miami County",2,61,1536,749,787
050,39,109,"Ohio","Miami County",2,62,1544,748,796
050,39,109,"Ohio","Miami County",2,63,1492,719,773
050,39,109,"Ohio","Miami County",2,64,1433,701,732
050,39,109,"Ohio","Miami County",2,65,1402,689,713
050,39,109,"Ohio","Miami County",2,66,1349,656,693
050,39,109,"Ohio","Miami County",2,67,1303,640,663
050,39,109,"Ohio","Miami County",2,68,1252,598,654
050,39,109,"Ohio","Miami County",2,69,1205,557,648
050,39,109,"Ohio","Miami County",2,70,1148,516,632
050,39,109,"Ohio","Miami County",2,71,1174,524,650
050,39,109,"Ohio","Miami County",2,72,1193,546,647
050,39,109,"Ohio","Miami County",2,73,1258,588,670
050,39,109,"Ohio","Miami County",2,74,841,397,444
050,39,109,"Ohio","Miami County",2,75,829,395,434
050,39,109,"Ohio","Miami County",2,76,813,376,437
050,39,109,"Ohio","Miami County",2,77,834,386,448
050,39,109,"Ohio","Miami County",2,78,705,321,384
050,39,109,"Ohio","Miami County",2,79,621,275,346
050,39,109,"Ohio","Miami County",2,80,558,226,332
050,39,109,"Ohio","Miami County",2,81,544,223,321
050,39,109,"Ohio","Miami County",2,82,530,215,315
050,39,109,"Ohio","Miami County",2,83,437,178,259
050,39,109,"Ohio","Miami County",2,84,408,163,245
050,39,109,"Ohio","Miami County",2,85,2100,754,1346
050,39,109,"Ohio","Miami County",3,0,1139,574,565
050,39,109,"Ohio","Miami County",3,1,1238,642,596
050,39,109,"Ohio","Miami County",3,2,1229,629,600
050,39,109,"Ohio","Miami County",3,3,1302,651,651
050,39,109,"Ohio","Miami County",3,4,1325,657,668
050,39,109,"Ohio","Miami County",3,5,1392,691,701
050,39,109,"Ohio","Miami County",3,6,1455,746,709
050,39,109,"Ohio","Miami County",3,7,1441,749,692
050,39,109,"Ohio","Miami County",3,8,1375,677,698
050,39,109,"Ohio","Miami County",3,9,1368,681,687
050,39,109,"Ohio","Miami County",3,10,1409,723,686
050,39,109,"Ohio","Miami County",3,11,1447,757,690
050,39,109,"Ohio","Miami County",3,12,1510,800,710
050,39,109,"Ohio","Miami County",3,13,1526,791,735
050,39,109,"Ohio","Miami County",3,14,1544,803,741
050,39,109,"Ohio","Miami County",3,15,1497,795,702
050,39,109,"Ohio","Miami County",3,16,1486,773,713
050,39,109,"Ohio","Miami County",3,17,1527,780,747
050,39,109,"Ohio","Miami County",3,18,1265,667,598
050,39,109,"Ohio","Miami County",3,19,1004,535,469
050,39,109,"Ohio","Miami County",3,20,1092,557,535
050,39,109,"Ohio","Miami County",3,21,1112,566,546
050,39,109,"Ohio","Miami County",3,22,1074,544,530
050,39,109,"Ohio","Miami County",3,23,1154,597,557
050,39,109,"Ohio","Miami County",3,24,1191,620,571
050,39,109,"Ohio","Miami County",3,25,1147,586,561
050,39,109,"Ohio","Miami County",3,26,1180,598,582
050,39,109,"Ohio","Miami County",3,27,1198,614,584
050,39,109,"Ohio","Miami County",3,28,1225,633,592
050,39,109,"Ohio","Miami County",3,29,1304,638,666
050,39,109,"Ohio","Miami County",3,30,1327,645,682
050,39,109,"Ohio","Miami County",3,31,1344,674,670
050,39,109,"Ohio","Miami County",3,32,1347,695,652
050,39,109,"Ohio","Miami County",3,33,1367,700,667
050,39,109,"Ohio","Miami County",3,34,1359,685,674
050,39,109,"Ohio","Miami County",3,35,1377,709,668
050,39,109,"Ohio","Miami County",3,36,1413,721,692
050,39,109,"Ohio","Miami County",3,37,1443,734,709
050,39,109,"Ohio","Miami County",3,38,1471,731,740
050,39,109,"Ohio","Miami County",3,39,1457,753,704
050,39,109,"Ohio","Miami County",3,40,1410,711,699
050,39,109,"Ohio","Miami County",3,41,1374,699,675
050,39,109,"Ohio","Miami County",3,42,1395,689,706
050,39,109,"Ohio","Miami County",3,43,1324,663,661
050,39,109,"Ohio","Miami County",3,44,1282,640,642
050,39,109,"Ohio","Miami County",3,45,1181,599,582
050,39,109,"Ohio","Miami County",3,46,1260,635,625
050,39,109,"Ohio","Miami County",3,47,1288,655,633
050,39,109,"Ohio","Miami County",3,48,1301,647,654
050,39,109,"Ohio","Miami County",3,49,1411,712,699
050,39,109,"Ohio","Miami County",3,50,1532,761,771
050,39,109,"Ohio","Miami County",3,51,1533,786,747
050,39,109,"Ohio","Miami County",3,52,1406,713,693
050,39,109,"Ohio","Miami County",3,53,1391,715,676
050,39,109,"Ohio","Miami County",3,54,1415,711,704
050,39,109,"Ohio","Miami County",3,55,1397,723,674
050,39,109,"Ohio","Miami County",3,56,1420,749,671
050,39,109,"Ohio","Miami County",3,57,1488,746,742
050,39,109,"Ohio","Miami County",3,58,1514,741,773
050,39,109,"Ohio","Miami County",3,59,1547,765,782
050,39,109,"Ohio","Miami County",3,60,1577,775,802
050,39,109,"Ohio","Miami County",3,61,1499,736,763
050,39,109,"Ohio","Miami County",3,62,1521,747,774
050,39,109,"Ohio","Miami County",3,63,1517,741,776
050,39,109,"Ohio","Miami County",3,64,1462,700,762
050,39,109,"Ohio","Miami County",3,65,1439,699,740
050,39,109,"Ohio","Miami County",3,66,1397,678,719
050,39,109,"Ohio","Miami County",3,67,1332,648,684
050,39,109,"Ohio","Miami County",3,68,1288,628,660
050,39,109,"Ohio","Miami County",3,69,1218,577,641
050,39,109,"Ohio","Miami County",3,70,1180,546,634
050,39,109,"Ohio","Miami County",3,71,1105,492,613
050,39,109,"Ohio","Miami County",3,72,1138,504,634
050,39,109,"Ohio","Miami County",3,73,1158,531,627
050,39,109,"Ohio","Miami County",3,74,1228,572,656
050,39,109,"Ohio","Miami County",3,75,819,379,440
050,39,109,"Ohio","Miami County",3,76,792,375,417
050,39,109,"Ohio","Miami County",3,77,756,351,405
050,39,109,"Ohio","Miami County",3,78,801,369,432
050,39,109,"Ohio","Miami County",3,79,678,307,371
050,39,109,"Ohio","Miami County",3,80,577,251,326
050,39,109,"Ohio","Miami County",3,81,517,217,300
050,39,109,"Ohio","Miami County",3,82,516,205,311
050,39,109,"Ohio","Miami County",3,83,469,178,291
050,39,109,"Ohio","Miami County",3,84,396,158,238
050,39,109,"Ohio","Miami County",3,85,2101,731,1370
050,39,109,"Ohio","Miami County",4,0,1125,537,588
050,39,109,"Ohio","Miami County",4,1,1193,604,589
050,39,109,"Ohio","Miami County",4,2,1287,670,617
050,39,109,"Ohio","Miami County",4,3,1251,629,622
050,39,109,"Ohio","Miami County",4,4,1360,691,669
050,39,109,"Ohio","Miami County",4,5,1367,669,698
050,39,109,"Ohio","Miami County",4,6,1435,720,715
050,39,109,"Ohio","Miami County",4,7,1469,762,707
050,39,109,"Ohio","Miami County",4,8,1434,764,670
050,39,109,"Ohio","Miami County",4,9,1388,693,695
050,39,109,"Ohio","Miami County",4,10,1420,702,718
050,39,109,"Ohio","Miami County",4,11,1436,739,697
050,39,109,"Ohio","Miami County",4,12,1445,752,693
050,39,109,"Ohio","Miami County",4,13,1535,811,724
050,39,109,"Ohio","Miami County",4,14,1562,796,766
050,39,109,"Ohio","Miami County",4,15,1549,820,729
050,39,109,"Ohio","Miami County",4,16,1532,819,713
050,39,109,"Ohio","Miami County",4,17,1494,778,716
050,39,109,"Ohio","Miami County",4,18,1286,681,605
050,39,109,"Ohio","Miami County",4,19,991,522,469
050,39,109,"Ohio","Miami County",4,20,1075,553,522
050,39,109,"Ohio","Miami County",4,21,1146,569,577
050,39,109,"Ohio","Miami County",4,22,1172,572,600
050,39,109,"Ohio","Miami County",4,23,1154,587,567
050,39,109,"Ohio","Miami County",4,24,1149,598,551
050,39,109,"Ohio","Miami County",4,25,1138,591,547
050,39,109,"Ohio","Miami County",4,26,1133,578,555
050,39,109,"Ohio","Miami County",4,27,1175,594,581
050,39,109,"Ohio","Miami County",4,28,1252,645,607
050,39,109,"Ohio","Miami County",4,29,1259,654,605
050,39,109,"Ohio","Miami County",4,30,1315,648,667
050,39,109,"Ohio","Miami County",4,31,1356,659,697
050,39,109,"Ohio","Miami County",4,32,1402,705,697
050,39,109,"Ohio","Miami County",4,33,1364,711,653
050,39,109,"Ohio","Miami County",4,34,1384,697,687
050,39,109,"Ohio","Miami County",4,35,1394,700,694
050,39,109,"Ohio","Miami County",4,36,1473,763,710
050,39,109,"Ohio","Miami County",4,37,1454,742,712
050,39,109,"Ohio","Miami County",4,38,1445,739,706
050,39,109,"Ohio","Miami County",4,39,1488,742,746
050,39,109,"Ohio","Miami County",4,40,1503,772,731
050,39,109,"Ohio","Miami County",4,41,1422,725,697
050,39,109,"Ohio","Miami County",4,42,1389,711,678
050,39,109,"Ohio","Miami County",4,43,1394,693,701
050,39,109,"Ohio","Miami County",4,44,1349,677,672
050,39,109,"Ohio","Miami County",4,45,1278,632,646
050,39,109,"Ohio","Miami County",4,46,1199,612,587
050,39,109,"Ohio","Miami County",4,47,1274,640,634
050,39,109,"Ohio","Miami County",4,48,1301,648,653
050,39,109,"Ohio","Miami County",4,49,1309,652,657
050,39,109,"Ohio","Miami County",4,50,1394,705,689
050,39,109,"Ohio","Miami County",4,51,1569,771,798
050,39,109,"Ohio","Miami County",4,52,1528,788,740
050,39,109,"Ohio","Miami County",4,53,1396,704,692
050,39,109,"Ohio","Miami County",4,54,1383,698,685
050,39,109,"Ohio","Miami County",4,55,1421,717,704
050,39,109,"Ohio","Miami County",4,56,1407,737,670
050,39,109,"Ohio","Miami County",4,57,1415,750,665
050,39,109,"Ohio","Miami County",4,58,1487,739,748
050,39,109,"Ohio","Miami County",4,59,1491,723,768
050,39,109,"Ohio","Miami County",4,60,1555,771,784
050,39,109,"Ohio","Miami County",4,61,1553,759,794
050,39,109,"Ohio","Miami County",4,62,1497,723,774
050,39,109,"Ohio","Miami County",4,63,1487,730,757
050,39,109,"Ohio","Miami County",4,64,1512,734,778
050,39,109,"Ohio","Miami County",4,65,1459,682,777
050,39,109,"Ohio","Miami County",4,66,1415,682,733
050,39,109,"Ohio","Miami County",4,67,1372,668,704
050,39,109,"Ohio","Miami County",4,68,1315,631,684
050,39,109,"Ohio","Miami County",4,69,1265,616,649
050,39,109,"Ohio","Miami County",4,70,1204,562,642
050,39,109,"Ohio","Miami County",4,71,1146,523,623
050,39,109,"Ohio","Miami County",4,72,1086,480,606
050,39,109,"Ohio","Miami County",4,73,1118,501,617
050,39,109,"Ohio","Miami County",4,74,1142,521,621
050,39,109,"Ohio","Miami County",4,75,1209,559,650
050,39,109,"Ohio","Miami County",4,76,784,359,425
050,39,109,"Ohio","Miami County",4,77,741,348,393
050,39,109,"Ohio","Miami County",4,78,724,333,391
050,39,109,"Ohio","Miami County",4,79,767,348,419
050,39,109,"Ohio","Miami County",4,80,636,283,353
050,39,109,"Ohio","Miami County",4,81,540,235,305
050,39,109,"Ohio","Miami County",4,82,484,196,288
050,39,109,"Ohio","Miami County",4,83,459,177,282
050,39,109,"Ohio","Miami County",4,84,437,166,271
050,39,109,"Ohio","Miami County",4,85,2110,734,1376
050,39,109,"Ohio","Miami County",5,0,1143,543,600
050,39,109,"Ohio","Miami County",5,1,1130,543,587
050,39,109,"Ohio","Miami County",5,2,1236,625,611
050,39,109,"Ohio","Miami County",5,3,1331,710,621
050,39,109,"Ohio","Miami County",5,4,1279,653,626
050,39,109,"Ohio","Miami County",5,5,1416,704,712
050,39,109,"Ohio","Miami County",5,6,1371,660,711
050,39,109,"Ohio","Miami County",5,7,1459,729,730
050,39,109,"Ohio","Miami County",5,8,1485,757,728
050,39,109,"Ohio","Miami County",5,9,1460,777,683
050,39,109,"Ohio","Miami County",5,10,1409,702,707
050,39,109,"Ohio","Miami County",5,11,1412,685,727
050,39,109,"Ohio","Miami County",5,12,1440,734,706
050,39,109,"Ohio","Miami County",5,13,1473,768,705
050,39,109,"Ohio","Miami County",5,14,1535,816,719
050,39,109,"Ohio","Miami County",5,15,1569,818,751
050,39,109,"Ohio","Miami County",5,16,1560,824,736
050,39,109,"Ohio","Miami County",5,17,1538,827,711
050,39,109,"Ohio","Miami County",5,18,1258,681,577
050,39,109,"Ohio","Miami County",5,19,1001,540,461
050,39,109,"Ohio","Miami County",5,20,1066,551,515
050,39,109,"Ohio","Miami County",5,21,1139,595,544
050,39,109,"Ohio","Miami County",5,22,1194,578,616
050,39,109,"Ohio","Miami County",5,23,1243,599,644
050,39,109,"Ohio","Miami County",5,24,1181,609,572
050,39,109,"Ohio","Miami County",5,25,1167,588,579
050,39,109,"Ohio","Miami County",5,26,1181,620,561
050,39,109,"Ohio","Miami County",5,27,1146,587,559
050,39,109,"Ohio","Miami County",5,28,1194,574,620
050,39,109,"Ohio","Miami County",5,29,1270,639,631
050,39,109,"Ohio","Miami County",5,30,1291,666,625
050,39,109,"Ohio","Miami County",5,31,1382,679,703
050,39,109,"Ohio","Miami County",5,32,1400,669,731
050,39,109,"Ohio","Miami County",5,33,1402,690,712
050,39,109,"Ohio","Miami County",5,34,1399,734,665
050,39,109,"Ohio","Miami County",5,35,1394,707,687
050,39,109,"Ohio","Miami County",5,36,1436,733,703
050,39,109,"Ohio","Miami County",5,37,1507,790,717
050,39,109,"Ohio","Miami County",5,38,1468,747,721
050,39,109,"Ohio","Miami County",5,39,1457,751,706
050,39,109,"Ohio","Miami County",5,40,1518,762,756
050,39,109,"Ohio","Miami County",5,41,1505,769,736
050,39,109,"Ohio","Miami County",5,42,1436,731,705
050,39,109,"Ohio","Miami County",5,43,1401,719,682
050,39,109,"Ohio","Miami County",5,44,1385,686,699
050,39,109,"Ohio","Miami County",5,45,1347,677,670
050,39,109,"Ohio","Miami County",5,46,1295,639,656
050,39,109,"Ohio","Miami County",5,47,1205,625,580
050,39,109,"Ohio","Miami County",5,48,1262,628,634
050,39,109,"Ohio","Miami County",5,49,1291,640,651
050,39,109,"Ohio","Miami County",5,50,1290,639,651
050,39,109,"Ohio","Miami County",5,51,1414,708,706
050,39,109,"Ohio","Miami County",5,52,1577,781,796
050,39,109,"Ohio","Miami County",5,53,1519,777,742
050,39,109,"Ohio","Miami County",5,54,1381,695,686
050,39,109,"Ohio","Miami County",5,55,1384,700,684
050,39,109,"Ohio","Miami County",5,56,1419,716,703
050,39,109,"Ohio","Miami County",5,57,1393,722,671
050,39,109,"Ohio","Miami County",5,58,1411,752,659
050,39,109,"Ohio","Miami County",5,59,1462,726,736
050,39,109,"Ohio","Miami County",5,60,1485,723,762
050,39,109,"Ohio","Miami County",5,61,1555,776,779
050,39,109,"Ohio","Miami County",5,62,1535,750,785
050,39,109,"Ohio","Miami County",5,63,1464,714,750
050,39,109,"Ohio","Miami County",5,64,1486,722,764
050,39,109,"Ohio","Miami County",5,65,1535,721,814
050,39,109,"Ohio","Miami County",5,66,1437,664,773
050,39,109,"Ohio","Miami County",5,67,1392,676,716
050,39,109,"Ohio","Miami County",5,68,1360,660,700
050,39,109,"Ohio","Miami County",5,69,1292,619,673
050,39,109,"Ohio","Miami County",5,70,1243,601,642
050,39,109,"Ohio","Miami County",5,71,1179,550,629
050,39,109,"Ohio","Miami County",5,72,1125,510,615
050,39,109,"Ohio","Miami County",5,73,1063,467,596
050,39,109,"Ohio","Miami County",5,74,1086,489,597
050,39,109,"Ohio","Miami County",5,75,1104,503,601
050,39,109,"Ohio","Miami County",5,76,1180,539,641
050,39,109,"Ohio","Miami County",5,77,740,333,407
050,39,109,"Ohio","Miami County",5,78,715,327,388
050,39,109,"Ohio","Miami County",5,79,702,319,383
050,39,109,"Ohio","Miami County",5,80,726,324,402
050,39,109,"Ohio","Miami County",5,81,595,265,330
050,39,109,"Ohio","Miami County",5,82,512,217,295
050,39,109,"Ohio","Miami County",5,83,436,167,269
050,39,109,"Ohio","Miami County",5,84,431,168,263
050,39,109,"Ohio","Miami County",5,85,2181,761,1420
050,39,111,"Ohio","Monroe County",1,0,128,67,61
050,39,111,"Ohio","Monroe County",1,1,121,67,54
050,39,111,"Ohio","Monroe County",1,2,120,69,51
050,39,111,"Ohio","Monroe County",1,3,136,64,72
050,39,111,"Ohio","Monroe County",1,4,153,80,73
050,39,111,"Ohio","Monroe County",1,5,150,69,81
050,39,111,"Ohio","Monroe County",1,6,154,83,71
050,39,111,"Ohio","Monroe County",1,7,153,87,66
050,39,111,"Ohio","Monroe County",1,8,156,84,72
050,39,111,"Ohio","Monroe County",1,9,177,85,92
050,39,111,"Ohio","Monroe County",1,10,156,85,71
050,39,111,"Ohio","Monroe County",1,11,165,86,79
050,39,111,"Ohio","Monroe County",1,12,174,86,88
050,39,111,"Ohio","Monroe County",1,13,153,76,77
050,39,111,"Ohio","Monroe County",1,14,158,84,74
050,39,111,"Ohio","Monroe County",1,15,153,70,83
050,39,111,"Ohio","Monroe County",1,16,159,83,76
050,39,111,"Ohio","Monroe County",1,17,162,97,65
050,39,111,"Ohio","Monroe County",1,18,148,78,70
050,39,111,"Ohio","Monroe County",1,19,120,57,63
050,39,111,"Ohio","Monroe County",1,20,130,67,63
050,39,111,"Ohio","Monroe County",1,21,128,66,62
050,39,111,"Ohio","Monroe County",1,22,132,68,64
050,39,111,"Ohio","Monroe County",1,23,138,72,66
050,39,111,"Ohio","Monroe County",1,24,128,67,61
050,39,111,"Ohio","Monroe County",1,25,126,70,56
050,39,111,"Ohio","Monroe County",1,26,132,77,55
050,39,111,"Ohio","Monroe County",1,27,156,80,76
050,39,111,"Ohio","Monroe County",1,28,137,70,67
050,39,111,"Ohio","Monroe County",1,29,137,68,69
050,39,111,"Ohio","Monroe County",1,30,145,62,83
050,39,111,"Ohio","Monroe County",1,31,129,66,63
050,39,111,"Ohio","Monroe County",1,32,130,61,69
050,39,111,"Ohio","Monroe County",1,33,128,60,68
050,39,111,"Ohio","Monroe County",1,34,139,74,65
050,39,111,"Ohio","Monroe County",1,35,161,90,71
050,39,111,"Ohio","Monroe County",1,36,145,65,80
050,39,111,"Ohio","Monroe County",1,37,146,70,76
050,39,111,"Ohio","Monroe County",1,38,140,81,59
050,39,111,"Ohio","Monroe County",1,39,149,79,70
050,39,111,"Ohio","Monroe County",1,40,163,79,84
050,39,111,"Ohio","Monroe County",1,41,156,80,76
050,39,111,"Ohio","Monroe County",1,42,143,74,69
050,39,111,"Ohio","Monroe County",1,43,147,75,72
050,39,111,"Ohio","Monroe County",1,44,143,71,72
050,39,111,"Ohio","Monroe County",1,45,146,75,71
050,39,111,"Ohio","Monroe County",1,46,143,67,76
050,39,111,"Ohio","Monroe County",1,47,167,84,83
050,39,111,"Ohio","Monroe County",1,48,185,93,92
050,39,111,"Ohio","Monroe County",1,49,195,96,99
050,39,111,"Ohio","Monroe County",1,50,179,101,78
050,39,111,"Ohio","Monroe County",1,51,159,97,62
050,39,111,"Ohio","Monroe County",1,52,177,96,81
050,39,111,"Ohio","Monroe County",1,53,180,99,81
050,39,111,"Ohio","Monroe County",1,54,182,89,93
050,39,111,"Ohio","Monroe County",1,55,201,103,98
050,39,111,"Ohio","Monroe County",1,56,197,108,89
050,39,111,"Ohio","Monroe County",1,57,186,91,95
050,39,111,"Ohio","Monroe County",1,58,201,99,102
050,39,111,"Ohio","Monroe County",1,59,217,116,101
050,39,111,"Ohio","Monroe County",1,60,210,107,103
050,39,111,"Ohio","Monroe County",1,61,217,103,114
050,39,111,"Ohio","Monroe County",1,62,208,103,105
050,39,111,"Ohio","Monroe County",1,63,212,113,99
050,39,111,"Ohio","Monroe County",1,64,196,111,85
050,39,111,"Ohio","Monroe County",1,65,197,94,103
050,39,111,"Ohio","Monroe County",1,66,208,106,102
050,39,111,"Ohio","Monroe County",1,67,206,105,101
050,39,111,"Ohio","Monroe County",1,68,184,93,91
050,39,111,"Ohio","Monroe County",1,69,185,91,94
050,39,111,"Ohio","Monroe County",1,70,181,83,98
050,39,111,"Ohio","Monroe County",1,71,179,89,90
050,39,111,"Ohio","Monroe County",1,72,174,89,85
050,39,111,"Ohio","Monroe County",1,73,171,86,85
050,39,111,"Ohio","Monroe County",1,74,123,56,67
050,39,111,"Ohio","Monroe County",1,75,135,63,72
050,39,111,"Ohio","Monroe County",1,76,132,65,67
050,39,111,"Ohio","Monroe County",1,77,131,71,60
050,39,111,"Ohio","Monroe County",1,78,103,51,52
050,39,111,"Ohio","Monroe County",1,79,107,52,55
050,39,111,"Ohio","Monroe County",1,80,87,42,45
050,39,111,"Ohio","Monroe County",1,81,87,46,41
050,39,111,"Ohio","Monroe County",1,82,85,45,40
050,39,111,"Ohio","Monroe County",1,83,67,29,38
050,39,111,"Ohio","Monroe County",1,84,57,34,23
050,39,111,"Ohio","Monroe County",1,85,322,124,198
050,39,111,"Ohio","Monroe County",2,0,129,57,72
050,39,111,"Ohio","Monroe County",2,1,120,66,54
050,39,111,"Ohio","Monroe County",2,2,121,69,52
050,39,111,"Ohio","Monroe County",2,3,132,66,66
050,39,111,"Ohio","Monroe County",2,4,150,76,74
050,39,111,"Ohio","Monroe County",2,5,152,72,80
050,39,111,"Ohio","Monroe County",2,6,155,81,74
050,39,111,"Ohio","Monroe County",2,7,152,85,67
050,39,111,"Ohio","Monroe County",2,8,156,84,72
050,39,111,"Ohio","Monroe County",2,9,171,85,86
050,39,111,"Ohio","Monroe County",2,10,163,86,77
050,39,111,"Ohio","Monroe County",2,11,162,85,77
050,39,111,"Ohio","Monroe County",2,12,171,86,85
050,39,111,"Ohio","Monroe County",2,13,159,80,79
050,39,111,"Ohio","Monroe County",2,14,158,82,76
050,39,111,"Ohio","Monroe County",2,15,155,74,81
050,39,111,"Ohio","Monroe County",2,16,158,81,77
050,39,111,"Ohio","Monroe County",2,17,161,93,68
050,39,111,"Ohio","Monroe County",2,18,144,79,65
050,39,111,"Ohio","Monroe County",2,19,121,59,62
050,39,111,"Ohio","Monroe County",2,20,132,67,65
050,39,111,"Ohio","Monroe County",2,21,129,66,63
050,39,111,"Ohio","Monroe County",2,22,132,68,64
050,39,111,"Ohio","Monroe County",2,23,136,70,66
050,39,111,"Ohio","Monroe County",2,24,129,68,61
050,39,111,"Ohio","Monroe County",2,25,128,70,58
050,39,111,"Ohio","Monroe County",2,26,131,75,56
050,39,111,"Ohio","Monroe County",2,27,151,79,72
050,39,111,"Ohio","Monroe County",2,28,142,73,69
050,39,111,"Ohio","Monroe County",2,29,138,69,69
050,39,111,"Ohio","Monroe County",2,30,142,64,78
050,39,111,"Ohio","Monroe County",2,31,132,65,67
050,39,111,"Ohio","Monroe County",2,32,128,61,67
050,39,111,"Ohio","Monroe County",2,33,127,59,68
050,39,111,"Ohio","Monroe County",2,34,137,72,65
050,39,111,"Ohio","Monroe County",2,35,158,87,71
050,39,111,"Ohio","Monroe County",2,36,150,71,79
050,39,111,"Ohio","Monroe County",2,37,146,70,76
050,39,111,"Ohio","Monroe County",2,38,141,77,64
050,39,111,"Ohio","Monroe County",2,39,148,80,68
050,39,111,"Ohio","Monroe County",2,40,161,80,81
050,39,111,"Ohio","Monroe County",2,41,156,79,77
050,39,111,"Ohio","Monroe County",2,42,147,76,71
050,39,111,"Ohio","Monroe County",2,43,147,75,72
050,39,111,"Ohio","Monroe County",2,44,143,72,71
050,39,111,"Ohio","Monroe County",2,45,147,74,73
050,39,111,"Ohio","Monroe County",2,46,143,69,74
050,39,111,"Ohio","Monroe County",2,47,160,79,81
050,39,111,"Ohio","Monroe County",2,48,180,89,91
050,39,111,"Ohio","Monroe County",2,49,194,96,98
050,39,111,"Ohio","Monroe County",2,50,182,100,82
050,39,111,"Ohio","Monroe County",2,51,163,97,66
050,39,111,"Ohio","Monroe County",2,52,172,96,76
050,39,111,"Ohio","Monroe County",2,53,178,98,80
050,39,111,"Ohio","Monroe County",2,54,182,92,90
050,39,111,"Ohio","Monroe County",2,55,194,97,97
050,39,111,"Ohio","Monroe County",2,56,198,107,91
050,39,111,"Ohio","Monroe County",2,57,188,94,94
050,39,111,"Ohio","Monroe County",2,58,197,97,100
050,39,111,"Ohio","Monroe County",2,59,213,112,101
050,39,111,"Ohio","Monroe County",2,60,212,110,102
050,39,111,"Ohio","Monroe County",2,61,212,100,112
050,39,111,"Ohio","Monroe County",2,62,210,103,107
050,39,111,"Ohio","Monroe County",2,63,212,111,101
050,39,111,"Ohio","Monroe County",2,64,198,109,89
050,39,111,"Ohio","Monroe County",2,65,196,98,98
050,39,111,"Ohio","Monroe County",2,66,205,103,102
050,39,111,"Ohio","Monroe County",2,67,205,104,101
050,39,111,"Ohio","Monroe County",2,68,185,93,92
050,39,111,"Ohio","Monroe County",2,69,183,91,92
050,39,111,"Ohio","Monroe County",2,70,179,83,96
050,39,111,"Ohio","Monroe County",2,71,180,87,93
050,39,111,"Ohio","Monroe County",2,72,170,86,84
050,39,111,"Ohio","Monroe County",2,73,181,91,90
050,39,111,"Ohio","Monroe County",2,74,124,58,66
050,39,111,"Ohio","Monroe County",2,75,132,61,71
050,39,111,"Ohio","Monroe County",2,76,132,64,68
050,39,111,"Ohio","Monroe County",2,77,133,71,62
050,39,111,"Ohio","Monroe County",2,78,104,53,51
050,39,111,"Ohio","Monroe County",2,79,105,52,53
050,39,111,"Ohio","Monroe County",2,80,89,42,47
050,39,111,"Ohio","Monroe County",2,81,87,44,43
050,39,111,"Ohio","Monroe County",2,82,83,44,39
050,39,111,"Ohio","Monroe County",2,83,70,33,37
050,39,111,"Ohio","Monroe County",2,84,57,31,26
050,39,111,"Ohio","Monroe County",2,85,314,121,193
050,39,111,"Ohio","Monroe County",3,0,124,63,61
050,39,111,"Ohio","Monroe County",3,1,138,64,74
050,39,111,"Ohio","Monroe County",3,2,122,72,50
050,39,111,"Ohio","Monroe County",3,3,123,69,54
050,39,111,"Ohio","Monroe County",3,4,133,63,70
050,39,111,"Ohio","Monroe County",3,5,154,74,80
050,39,111,"Ohio","Monroe County",3,6,155,73,82
050,39,111,"Ohio","Monroe County",3,7,165,91,74
050,39,111,"Ohio","Monroe County",3,8,154,88,66
050,39,111,"Ohio","Monroe County",3,9,155,82,73
050,39,111,"Ohio","Monroe County",3,10,172,84,88
050,39,111,"Ohio","Monroe County",3,11,174,89,85
050,39,111,"Ohio","Monroe County",3,12,161,84,77
050,39,111,"Ohio","Monroe County",3,13,155,77,78
050,39,111,"Ohio","Monroe County",3,14,163,83,80
050,39,111,"Ohio","Monroe County",3,15,159,80,79
050,39,111,"Ohio","Monroe County",3,16,149,73,76
050,39,111,"Ohio","Monroe County",3,17,169,85,84
050,39,111,"Ohio","Monroe County",3,18,141,80,61
050,39,111,"Ohio","Monroe County",3,19,109,61,48
050,39,111,"Ohio","Monroe County",3,20,143,70,73
050,39,111,"Ohio","Monroe County",3,21,136,67,69
050,39,111,"Ohio","Monroe County",3,22,129,64,65
050,39,111,"Ohio","Monroe County",3,23,139,78,61
050,39,111,"Ohio","Monroe County",3,24,137,73,64
050,39,111,"Ohio","Monroe County",3,25,122,65,57
050,39,111,"Ohio","Monroe County",3,26,133,75,58
050,39,111,"Ohio","Monroe County",3,27,128,75,53
050,39,111,"Ohio","Monroe County",3,28,156,85,71
050,39,111,"Ohio","Monroe County",3,29,154,79,75
050,39,111,"Ohio","Monroe County",3,30,139,68,71
050,39,111,"Ohio","Monroe County",3,31,139,64,75
050,39,111,"Ohio","Monroe County",3,32,126,64,62
050,39,111,"Ohio","Monroe County",3,33,133,60,73
050,39,111,"Ohio","Monroe County",3,34,130,65,65
050,39,111,"Ohio","Monroe County",3,35,139,70,69
050,39,111,"Ohio","Monroe County",3,36,153,85,68
050,39,111,"Ohio","Monroe County",3,37,154,74,80
050,39,111,"Ohio","Monroe County",3,38,144,67,77
050,39,111,"Ohio","Monroe County",3,39,139,79,60
050,39,111,"Ohio","Monroe County",3,40,149,79,70
050,39,111,"Ohio","Monroe County",3,41,160,80,80
050,39,111,"Ohio","Monroe County",3,42,161,81,80
050,39,111,"Ohio","Monroe County",3,43,146,76,70
050,39,111,"Ohio","Monroe County",3,44,140,73,67
050,39,111,"Ohio","Monroe County",3,45,145,73,72
050,39,111,"Ohio","Monroe County",3,46,155,75,80
050,39,111,"Ohio","Monroe County",3,47,141,69,72
050,39,111,"Ohio","Monroe County",3,48,160,79,81
050,39,111,"Ohio","Monroe County",3,49,175,89,86
050,39,111,"Ohio","Monroe County",3,50,195,97,98
050,39,111,"Ohio","Monroe County",3,51,188,102,86
050,39,111,"Ohio","Monroe County",3,52,164,98,66
050,39,111,"Ohio","Monroe County",3,53,180,100,80
050,39,111,"Ohio","Monroe County",3,54,175,95,80
050,39,111,"Ohio","Monroe County",3,55,179,89,90
050,39,111,"Ohio","Monroe County",3,56,194,97,97
050,39,111,"Ohio","Monroe County",3,57,196,107,89
050,39,111,"Ohio","Monroe County",3,58,195,103,92
050,39,111,"Ohio","Monroe County",3,59,205,99,106
050,39,111,"Ohio","Monroe County",3,60,215,113,102
050,39,111,"Ohio","Monroe County",3,61,207,109,98
050,39,111,"Ohio","Monroe County",3,62,219,101,118
050,39,111,"Ohio","Monroe County",3,63,201,100,101
050,39,111,"Ohio","Monroe County",3,64,208,109,99
050,39,111,"Ohio","Monroe County",3,65,195,106,89
050,39,111,"Ohio","Monroe County",3,66,193,94,99
050,39,111,"Ohio","Monroe County",3,67,207,103,104
050,39,111,"Ohio","Monroe County",3,68,196,99,97
050,39,111,"Ohio","Monroe County",3,69,182,93,89
050,39,111,"Ohio","Monroe County",3,70,171,87,84
050,39,111,"Ohio","Monroe County",3,71,174,78,96
050,39,111,"Ohio","Monroe County",3,72,178,88,90
050,39,111,"Ohio","Monroe County",3,73,163,80,83
050,39,111,"Ohio","Monroe County",3,74,177,87,90
050,39,111,"Ohio","Monroe County",3,75,121,56,65
050,39,111,"Ohio","Monroe County",3,76,126,56,70
050,39,111,"Ohio","Monroe County",3,77,124,62,62
050,39,111,"Ohio","Monroe County",3,78,129,67,62
050,39,111,"Ohio","Monroe County",3,79,92,49,43
050,39,111,"Ohio","Monroe County",3,80,95,47,48
050,39,111,"Ohio","Monroe County",3,81,83,37,46
050,39,111,"Ohio","Monroe County",3,82,84,42,42
050,39,111,"Ohio","Monroe County",3,83,78,40,38
050,39,111,"Ohio","Monroe County",3,84,57,26,31
050,39,111,"Ohio","Monroe County",3,85,305,120,185
050,39,111,"Ohio","Monroe County",4,0,133,69,64
050,39,111,"Ohio","Monroe County",4,1,127,59,68
050,39,111,"Ohio","Monroe County",4,2,139,60,79
050,39,111,"Ohio","Monroe County",4,3,127,74,53
050,39,111,"Ohio","Monroe County",4,4,126,78,48
050,39,111,"Ohio","Monroe County",4,5,131,65,66
050,39,111,"Ohio","Monroe County",4,6,152,78,74
050,39,111,"Ohio","Monroe County",4,7,159,80,79
050,39,111,"Ohio","Monroe County",4,8,167,92,75
050,39,111,"Ohio","Monroe County",4,9,149,86,63
050,39,111,"Ohio","Monroe County",4,10,151,78,73
050,39,111,"Ohio","Monroe County",4,11,171,85,86
050,39,111,"Ohio","Monroe County",4,12,167,86,81
050,39,111,"Ohio","Monroe County",4,13,156,80,76
050,39,111,"Ohio","Monroe County",4,14,158,81,77
050,39,111,"Ohio","Monroe County",4,15,169,92,77
050,39,111,"Ohio","Monroe County",4,16,154,74,80
050,39,111,"Ohio","Monroe County",4,17,150,75,75
050,39,111,"Ohio","Monroe County",4,18,140,75,65
050,39,111,"Ohio","Monroe County",4,19,110,63,47
050,39,111,"Ohio","Monroe County",4,20,121,67,54
050,39,111,"Ohio","Monroe County",4,21,152,74,78
050,39,111,"Ohio","Monroe County",4,22,148,74,74
050,39,111,"Ohio","Monroe County",4,23,129,62,67
050,39,111,"Ohio","Monroe County",4,24,141,79,62
050,39,111,"Ohio","Monroe County",4,25,129,64,65
050,39,111,"Ohio","Monroe County",4,26,126,67,59
050,39,111,"Ohio","Monroe County",4,27,131,70,61
050,39,111,"Ohio","Monroe County",4,28,117,65,52
050,39,111,"Ohio","Monroe County",4,29,148,83,65
050,39,111,"Ohio","Monroe County",4,30,144,73,71
050,39,111,"Ohio","Monroe County",4,31,148,71,77
050,39,111,"Ohio","Monroe County",4,32,140,64,76
050,39,111,"Ohio","Monroe County",4,33,124,65,59
050,39,111,"Ohio","Monroe County",4,34,132,61,71
050,39,111,"Ohio","Monroe County",4,35,126,61,65
050,39,111,"Ohio","Monroe County",4,36,141,72,69
050,39,111,"Ohio","Monroe County",4,37,153,84,69
050,39,111,"Ohio","Monroe County",4,38,162,76,86
050,39,111,"Ohio","Monroe County",4,39,142,65,77
050,39,111,"Ohio","Monroe County",4,40,136,74,62
050,39,111,"Ohio","Monroe County",4,41,144,79,65
050,39,111,"Ohio","Monroe County",4,42,157,77,80
050,39,111,"Ohio","Monroe County",4,43,156,77,79
050,39,111,"Ohio","Monroe County",4,44,144,75,69
050,39,111,"Ohio","Monroe County",4,45,135,68,67
050,39,111,"Ohio","Monroe County",4,46,146,72,74
050,39,111,"Ohio","Monroe County",4,47,150,72,78
050,39,111,"Ohio","Monroe County",4,48,141,68,73
050,39,111,"Ohio","Monroe County",4,49,167,83,84
050,39,111,"Ohio","Monroe County",4,50,181,97,84
050,39,111,"Ohio","Monroe County",4,51,191,94,97
050,39,111,"Ohio","Monroe County",4,52,194,108,86
050,39,111,"Ohio","Monroe County",4,53,167,100,67
050,39,111,"Ohio","Monroe County",4,54,184,106,78
050,39,111,"Ohio","Monroe County",4,55,176,93,83
050,39,111,"Ohio","Monroe County",4,56,177,86,91
050,39,111,"Ohio","Monroe County",4,57,203,97,106
050,39,111,"Ohio","Monroe County",4,58,201,111,90
050,39,111,"Ohio","Monroe County",4,59,202,105,97
050,39,111,"Ohio","Monroe County",4,60,206,99,107
050,39,111,"Ohio","Monroe County",4,61,216,114,102
050,39,111,"Ohio","Monroe County",4,62,212,113,99
050,39,111,"Ohio","Monroe County",4,63,203,98,105
050,39,111,"Ohio","Monroe County",4,64,199,98,101
050,39,111,"Ohio","Monroe County",4,65,205,106,99
050,39,111,"Ohio","Monroe County",4,66,187,103,84
050,39,111,"Ohio","Monroe County",4,67,190,95,95
050,39,111,"Ohio","Monroe County",4,68,204,102,102
050,39,111,"Ohio","Monroe County",4,69,196,103,93
050,39,111,"Ohio","Monroe County",4,70,177,90,87
050,39,111,"Ohio","Monroe County",4,71,164,81,83
050,39,111,"Ohio","Monroe County",4,72,163,73,90
050,39,111,"Ohio","Monroe County",4,73,171,85,86
050,39,111,"Ohio","Monroe County",4,74,158,76,82
050,39,111,"Ohio","Monroe County",4,75,165,80,85
050,39,111,"Ohio","Monroe County",4,76,112,48,64
050,39,111,"Ohio","Monroe County",4,77,125,55,70
050,39,111,"Ohio","Monroe County",4,78,120,58,62
050,39,111,"Ohio","Monroe County",4,79,122,65,57
050,39,111,"Ohio","Monroe County",4,80,85,44,41
050,39,111,"Ohio","Monroe County",4,81,89,41,48
050,39,111,"Ohio","Monroe County",4,82,78,35,43
050,39,111,"Ohio","Monroe County",4,83,78,36,42
050,39,111,"Ohio","Monroe County",4,84,66,34,32
050,39,111,"Ohio","Monroe County",4,85,282,109,173
050,39,111,"Ohio","Monroe County",5,0,121,65,56
050,39,111,"Ohio","Monroe County",5,1,130,64,66
050,39,111,"Ohio","Monroe County",5,2,130,58,72
050,39,111,"Ohio","Monroe County",5,3,142,63,79
050,39,111,"Ohio","Monroe County",5,4,117,65,52
050,39,111,"Ohio","Monroe County",5,5,129,76,53
050,39,111,"Ohio","Monroe County",5,6,134,66,68
050,39,111,"Ohio","Monroe County",5,7,148,78,70
050,39,111,"Ohio","Monroe County",5,8,161,78,83
050,39,111,"Ohio","Monroe County",5,9,170,91,79
050,39,111,"Ohio","Monroe County",5,10,159,94,65
050,39,111,"Ohio","Monroe County",5,11,155,80,75
050,39,111,"Ohio","Monroe County",5,12,173,84,89
050,39,111,"Ohio","Monroe County",5,13,173,85,88
050,39,111,"Ohio","Monroe County",5,14,163,88,75
050,39,111,"Ohio","Monroe County",5,15,156,80,76
050,39,111,"Ohio","Monroe County",5,16,170,89,81
050,39,111,"Ohio","Monroe County",5,17,154,75,79
050,39,111,"Ohio","Monroe County",5,18,128,66,62
050,39,111,"Ohio","Monroe County",5,19,107,58,49
050,39,111,"Ohio","Monroe County",5,20,121,69,52
050,39,111,"Ohio","Monroe County",5,21,128,72,56
050,39,111,"Ohio","Monroe County",5,22,159,79,80
050,39,111,"Ohio","Monroe County",5,23,158,81,77
050,39,111,"Ohio","Monroe County",5,24,134,62,72
050,39,111,"Ohio","Monroe County",5,25,142,77,65
050,39,111,"Ohio","Monroe County",5,26,127,63,64
050,39,111,"Ohio","Monroe County",5,27,126,68,58
050,39,111,"Ohio","Monroe County",5,28,120,64,56
050,39,111,"Ohio","Monroe County",5,29,125,68,57
050,39,111,"Ohio","Monroe County",5,30,155,86,69
050,39,111,"Ohio","Monroe County",5,31,146,74,72
050,39,111,"Ohio","Monroe County",5,32,148,74,74
050,39,111,"Ohio","Monroe County",5,33,137,64,73
050,39,111,"Ohio","Monroe County",5,34,126,61,65
050,39,111,"Ohio","Monroe County",5,35,137,64,73
050,39,111,"Ohio","Monroe County",5,36,126,60,66
050,39,111,"Ohio","Monroe County",5,37,139,73,66
050,39,111,"Ohio","Monroe County",5,38,155,84,71
050,39,111,"Ohio","Monroe County",5,39,158,74,84
050,39,111,"Ohio","Monroe County",5,40,145,68,77
050,39,111,"Ohio","Monroe County",5,41,140,80,60
050,39,111,"Ohio","Monroe County",5,42,146,80,66
050,39,111,"Ohio","Monroe County",5,43,159,76,83
050,39,111,"Ohio","Monroe County",5,44,157,77,80
050,39,111,"Ohio","Monroe County",5,45,147,76,71
050,39,111,"Ohio","Monroe County",5,46,133,67,66
050,39,111,"Ohio","Monroe County",5,47,147,74,73
050,39,111,"Ohio","Monroe County",5,48,145,73,72
050,39,111,"Ohio","Monroe County",5,49,141,68,73
050,39,111,"Ohio","Monroe County",5,50,158,80,78
050,39,111,"Ohio","Monroe County",5,51,180,96,84
050,39,111,"Ohio","Monroe County",5,52,185,87,98
050,39,111,"Ohio","Monroe County",5,53,194,111,83
050,39,111,"Ohio","Monroe County",5,54,159,98,61
050,39,111,"Ohio","Monroe County",5,55,178,101,77
050,39,111,"Ohio","Monroe County",5,56,174,90,84
050,39,111,"Ohio","Monroe County",5,57,181,87,94
050,39,111,"Ohio","Monroe County",5,58,205,100,105
050,39,111,"Ohio","Monroe County",5,59,204,114,90
050,39,111,"Ohio","Monroe County",5,60,195,102,93
050,39,111,"Ohio","Monroe County",5,61,203,97,106
050,39,111,"Ohio","Monroe County",5,62,219,116,103
050,39,111,"Ohio","Monroe County",5,63,205,108,97
050,39,111,"Ohio","Monroe County",5,64,203,99,104
050,39,111,"Ohio","Monroe County",5,65,199,96,103
050,39,111,"Ohio","Monroe County",5,66,198,102,96
050,39,111,"Ohio","Monroe County",5,67,187,104,83
050,39,111,"Ohio","Monroe County",5,68,187,94,93
050,39,111,"Ohio","Monroe County",5,69,205,103,102
050,39,111,"Ohio","Monroe County",5,70,193,98,95
050,39,111,"Ohio","Monroe County",5,71,175,88,87
050,39,111,"Ohio","Monroe County",5,72,159,80,79
050,39,111,"Ohio","Monroe County",5,73,157,69,88
050,39,111,"Ohio","Monroe County",5,74,169,84,85
050,39,111,"Ohio","Monroe County",5,75,149,71,78
050,39,111,"Ohio","Monroe County",5,76,150,67,83
050,39,111,"Ohio","Monroe County",5,77,107,46,61
050,39,111,"Ohio","Monroe County",5,78,118,51,67
050,39,111,"Ohio","Monroe County",5,79,110,55,55
050,39,111,"Ohio","Monroe County",5,80,114,61,53
050,39,111,"Ohio","Monroe County",5,81,76,38,38
050,39,111,"Ohio","Monroe County",5,82,84,39,45
050,39,111,"Ohio","Monroe County",5,83,71,29,42
050,39,111,"Ohio","Monroe County",5,84,67,29,38
050,39,111,"Ohio","Monroe County",5,85,288,114,174
050,39,113,"Ohio","Montgomery County",1,0,6376,3263,3113
050,39,113,"Ohio","Montgomery County",1,1,6468,3346,3122
050,39,113,"Ohio","Montgomery County",1,2,6656,3433,3223
050,39,113,"Ohio","Montgomery County",1,3,6651,3402,3249
050,39,113,"Ohio","Montgomery County",1,4,6704,3460,3244
050,39,113,"Ohio","Montgomery County",1,5,6584,3412,3172
050,39,113,"Ohio","Montgomery County",1,6,6514,3339,3175
050,39,113,"Ohio","Montgomery County",1,7,6634,3328,3306
050,39,113,"Ohio","Montgomery County",1,8,6574,3333,3241
050,39,113,"Ohio","Montgomery County",1,9,6476,3279,3197
050,39,113,"Ohio","Montgomery County",1,10,6754,3450,3304
050,39,113,"Ohio","Montgomery County",1,11,6762,3413,3349
050,39,113,"Ohio","Montgomery County",1,12,6989,3593,3396
050,39,113,"Ohio","Montgomery County",1,13,7006,3578,3428
050,39,113,"Ohio","Montgomery County",1,14,6784,3479,3305
050,39,113,"Ohio","Montgomery County",1,15,6713,3444,3269
050,39,113,"Ohio","Montgomery County",1,16,6891,3515,3376
050,39,113,"Ohio","Montgomery County",1,17,6902,3539,3363
050,39,113,"Ohio","Montgomery County",1,18,6640,3487,3153
050,39,113,"Ohio","Montgomery County",1,19,6914,3549,3365
050,39,113,"Ohio","Montgomery County",1,20,7110,3595,3515
050,39,113,"Ohio","Montgomery County",1,21,7001,3467,3534
050,39,113,"Ohio","Montgomery County",1,22,7014,3540,3474
050,39,113,"Ohio","Montgomery County",1,23,6753,3427,3326
050,39,113,"Ohio","Montgomery County",1,24,6832,3432,3400
050,39,113,"Ohio","Montgomery County",1,25,7047,3501,3546
050,39,113,"Ohio","Montgomery County",1,26,7347,3638,3709
050,39,113,"Ohio","Montgomery County",1,27,7593,3699,3894
050,39,113,"Ohio","Montgomery County",1,28,7782,3793,3989
050,39,113,"Ohio","Montgomery County",1,29,8007,3975,4032
050,39,113,"Ohio","Montgomery County",1,30,7604,3749,3855
050,39,113,"Ohio","Montgomery County",1,31,7468,3706,3762
050,39,113,"Ohio","Montgomery County",1,32,7154,3542,3612
050,39,113,"Ohio","Montgomery County",1,33,6911,3425,3486
050,39,113,"Ohio","Montgomery County",1,34,6880,3438,3442
050,39,113,"Ohio","Montgomery County",1,35,6748,3326,3422
050,39,113,"Ohio","Montgomery County",1,36,6620,3233,3387
050,39,113,"Ohio","Montgomery County",1,37,6715,3304,3411
050,39,113,"Ohio","Montgomery County",1,38,6539,3211,3328
050,39,113,"Ohio","Montgomery County",1,39,6575,3146,3429
050,39,113,"Ohio","Montgomery County",1,40,6539,3146,3393
050,39,113,"Ohio","Montgomery County",1,41,6257,3094,3163
050,39,113,"Ohio","Montgomery County",1,42,6009,2925,3084
050,39,113,"Ohio","Montgomery County",1,43,5691,2792,2899
050,39,113,"Ohio","Montgomery County",1,44,5624,2728,2896
050,39,113,"Ohio","Montgomery County",1,45,5627,2722,2905
050,39,113,"Ohio","Montgomery County",1,46,5604,2709,2895
050,39,113,"Ohio","Montgomery County",1,47,5995,2897,3098
050,39,113,"Ohio","Montgomery County",1,48,6402,3124,3278
050,39,113,"Ohio","Montgomery County",1,49,6869,3366,3503
050,39,113,"Ohio","Montgomery County",1,50,6510,3183,3327
050,39,113,"Ohio","Montgomery County",1,51,6414,3097,3317
050,39,113,"Ohio","Montgomery County",1,52,6222,3038,3184
050,39,113,"Ohio","Montgomery County",1,53,6549,3189,3360
050,39,113,"Ohio","Montgomery County",1,54,6756,3271,3485
050,39,113,"Ohio","Montgomery County",1,55,7051,3402,3649
050,39,113,"Ohio","Montgomery County",1,56,7246,3543,3703
050,39,113,"Ohio","Montgomery County",1,57,7203,3523,3680
050,39,113,"Ohio","Montgomery County",1,58,7353,3574,3779
050,39,113,"Ohio","Montgomery County",1,59,7551,3656,3895
050,39,113,"Ohio","Montgomery County",1,60,7289,3500,3789
050,39,113,"Ohio","Montgomery County",1,61,7336,3509,3827
050,39,113,"Ohio","Montgomery County",1,62,7293,3483,3810
050,39,113,"Ohio","Montgomery County",1,63,7024,3329,3695
050,39,113,"Ohio","Montgomery County",1,64,6862,3273,3589
050,39,113,"Ohio","Montgomery County",1,65,6671,3099,3572
050,39,113,"Ohio","Montgomery County",1,66,6401,2921,3480
050,39,113,"Ohio","Montgomery County",1,67,6164,2846,3318
050,39,113,"Ohio","Montgomery County",1,68,6014,2802,3212
050,39,113,"Ohio","Montgomery County",1,69,5645,2603,3042
050,39,113,"Ohio","Montgomery County",1,70,5447,2452,2995
050,39,113,"Ohio","Montgomery County",1,71,5397,2396,3001
050,39,113,"Ohio","Montgomery County",1,72,5480,2409,3071
050,39,113,"Ohio","Montgomery County",1,73,5411,2422,2989
050,39,113,"Ohio","Montgomery County",1,74,3642,1609,2033
050,39,113,"Ohio","Montgomery County",1,75,3604,1593,2011
050,39,113,"Ohio","Montgomery County",1,76,3602,1611,1991
050,39,113,"Ohio","Montgomery County",1,77,3647,1592,2055
050,39,113,"Ohio","Montgomery County",1,78,3192,1383,1809
050,39,113,"Ohio","Montgomery County",1,79,2784,1178,1606
050,39,113,"Ohio","Montgomery County",1,80,2608,1070,1538
050,39,113,"Ohio","Montgomery County",1,81,2477,1007,1470
050,39,113,"Ohio","Montgomery County",1,82,2257,915,1342
050,39,113,"Ohio","Montgomery County",1,83,2075,834,1241
050,39,113,"Ohio","Montgomery County",1,84,1958,771,1187
050,39,113,"Ohio","Montgomery County",1,85,11862,3960,7902
050,39,113,"Ohio","Montgomery County",2,0,6259,3207,3052
050,39,113,"Ohio","Montgomery County",2,1,6443,3323,3120
050,39,113,"Ohio","Montgomery County",2,2,6615,3414,3201
050,39,113,"Ohio","Montgomery County",2,3,6628,3399,3229
050,39,113,"Ohio","Montgomery County",2,4,6698,3449,3249
050,39,113,"Ohio","Montgomery County",2,5,6608,3423,3185
050,39,113,"Ohio","Montgomery County",2,6,6530,3356,3174
050,39,113,"Ohio","Montgomery County",2,7,6599,3327,3272
050,39,113,"Ohio","Montgomery County",2,8,6563,3322,3241
050,39,113,"Ohio","Montgomery County",2,9,6485,3285,3200
050,39,113,"Ohio","Montgomery County",2,10,6676,3405,3271
050,39,113,"Ohio","Montgomery County",2,11,6740,3417,3323
050,39,113,"Ohio","Montgomery County",2,12,6980,3571,3409
050,39,113,"Ohio","Montgomery County",2,13,7005,3589,3416
050,39,113,"Ohio","Montgomery County",2,14,6840,3506,3334
050,39,113,"Ohio","Montgomery County",2,15,6751,3462,3289
050,39,113,"Ohio","Montgomery County",2,16,6854,3502,3352
050,39,113,"Ohio","Montgomery County",2,17,6905,3537,3368
050,39,113,"Ohio","Montgomery County",2,18,6585,3452,3133
050,39,113,"Ohio","Montgomery County",2,19,6936,3562,3374
050,39,113,"Ohio","Montgomery County",2,20,7185,3639,3546
050,39,113,"Ohio","Montgomery County",2,21,6997,3469,3528
050,39,113,"Ohio","Montgomery County",2,22,7073,3562,3511
050,39,113,"Ohio","Montgomery County",2,23,6754,3425,3329
050,39,113,"Ohio","Montgomery County",2,24,6807,3423,3384
050,39,113,"Ohio","Montgomery County",2,25,7040,3519,3521
050,39,113,"Ohio","Montgomery County",2,26,7304,3621,3683
050,39,113,"Ohio","Montgomery County",2,27,7530,3688,3842
050,39,113,"Ohio","Montgomery County",2,28,7761,3799,3962
050,39,113,"Ohio","Montgomery County",2,29,7928,3915,4013
050,39,113,"Ohio","Montgomery County",2,30,7739,3815,3924
050,39,113,"Ohio","Montgomery County",2,31,7463,3690,3773
050,39,113,"Ohio","Montgomery County",2,32,7198,3562,3636
050,39,113,"Ohio","Montgomery County",2,33,6955,3447,3508
050,39,113,"Ohio","Montgomery County",2,34,6879,3424,3455
050,39,113,"Ohio","Montgomery County",2,35,6811,3366,3445
050,39,113,"Ohio","Montgomery County",2,36,6620,3242,3378
050,39,113,"Ohio","Montgomery County",2,37,6701,3296,3405
050,39,113,"Ohio","Montgomery County",2,38,6593,3239,3354
050,39,113,"Ohio","Montgomery County",2,39,6532,3142,3390
050,39,113,"Ohio","Montgomery County",2,40,6574,3153,3421
050,39,113,"Ohio","Montgomery County",2,41,6311,3101,3210
050,39,113,"Ohio","Montgomery County",2,42,6027,2945,3082
050,39,113,"Ohio","Montgomery County",2,43,5811,2843,2968
050,39,113,"Ohio","Montgomery County",2,44,5597,2725,2872
050,39,113,"Ohio","Montgomery County",2,45,5644,2727,2917
050,39,113,"Ohio","Montgomery County",2,46,5593,2704,2889
050,39,113,"Ohio","Montgomery County",2,47,5883,2840,3043
050,39,113,"Ohio","Montgomery County",2,48,6287,3060,3227
050,39,113,"Ohio","Montgomery County",2,49,6779,3324,3455
050,39,113,"Ohio","Montgomery County",2,50,6596,3224,3372
050,39,113,"Ohio","Montgomery County",2,51,6394,3094,3300
050,39,113,"Ohio","Montgomery County",2,52,6242,3041,3201
050,39,113,"Ohio","Montgomery County",2,53,6456,3141,3315
050,39,113,"Ohio","Montgomery County",2,54,6668,3230,3438
050,39,113,"Ohio","Montgomery County",2,55,6964,3356,3608
050,39,113,"Ohio","Montgomery County",2,56,7202,3512,3690
050,39,113,"Ohio","Montgomery County",2,57,7208,3523,3685
050,39,113,"Ohio","Montgomery County",2,58,7272,3535,3737
050,39,113,"Ohio","Montgomery County",2,59,7509,3641,3868
050,39,113,"Ohio","Montgomery County",2,60,7307,3515,3792
050,39,113,"Ohio","Montgomery County",2,61,7272,3479,3793
050,39,113,"Ohio","Montgomery County",2,62,7266,3467,3799
050,39,113,"Ohio","Montgomery County",2,63,7121,3381,3740
050,39,113,"Ohio","Montgomery County",2,64,6838,3248,3590
050,39,113,"Ohio","Montgomery County",2,65,6679,3120,3559
050,39,113,"Ohio","Montgomery County",2,66,6454,2957,3497
050,39,113,"Ohio","Montgomery County",2,67,6179,2836,3343
050,39,113,"Ohio","Montgomery County",2,68,5981,2783,3198
050,39,113,"Ohio","Montgomery County",2,69,5748,2646,3102
050,39,113,"Ohio","Montgomery County",2,70,5450,2468,2982
050,39,113,"Ohio","Montgomery County",2,71,5376,2389,2987
050,39,113,"Ohio","Montgomery County",2,72,5335,2338,2997
050,39,113,"Ohio","Montgomery County",2,73,5633,2519,3114
050,39,113,"Ohio","Montgomery County",2,74,3804,1679,2125
050,39,113,"Ohio","Montgomery County",2,75,3605,1596,2009
050,39,113,"Ohio","Montgomery County",2,76,3523,1567,1956
050,39,113,"Ohio","Montgomery County",2,77,3666,1604,2062
050,39,113,"Ohio","Montgomery County",2,78,3208,1389,1819
050,39,113,"Ohio","Montgomery County",2,79,2831,1201,1630
050,39,113,"Ohio","Montgomery County",2,80,2627,1079,1548
050,39,113,"Ohio","Montgomery County",2,81,2461,999,1462
050,39,113,"Ohio","Montgomery County",2,82,2275,924,1351
050,39,113,"Ohio","Montgomery County",2,83,2093,838,1255
050,39,113,"Ohio","Montgomery County",2,84,1949,764,1185
050,39,113,"Ohio","Montgomery County",2,85,11851,3950,7901
050,39,113,"Ohio","Montgomery County",3,0,6081,3095,2986
050,39,113,"Ohio","Montgomery County",3,1,6221,3142,3079
050,39,113,"Ohio","Montgomery County",3,2,6411,3282,3129
050,39,113,"Ohio","Montgomery County",3,3,6605,3382,3223
050,39,113,"Ohio","Montgomery County",3,4,6558,3365,3193
050,39,113,"Ohio","Montgomery County",3,5,6678,3447,3231
050,39,113,"Ohio","Montgomery County",3,6,6618,3425,3193
050,39,113,"Ohio","Montgomery County",3,7,6513,3364,3149
050,39,113,"Ohio","Montgomery County",3,8,6572,3327,3245
050,39,113,"Ohio","Montgomery County",3,9,6576,3341,3235
050,39,113,"Ohio","Montgomery County",3,10,6503,3303,3200
050,39,113,"Ohio","Montgomery County",3,11,6614,3378,3236
050,39,113,"Ohio","Montgomery County",3,12,6744,3416,3328
050,39,113,"Ohio","Montgomery County",3,13,7017,3588,3429
050,39,113,"Ohio","Montgomery County",3,14,6986,3580,3406
050,39,113,"Ohio","Montgomery County",3,15,6845,3509,3336
050,39,113,"Ohio","Montgomery County",3,16,6713,3428,3285
050,39,113,"Ohio","Montgomery County",3,17,6906,3511,3395
050,39,113,"Ohio","Montgomery County",3,18,6524,3375,3149
050,39,113,"Ohio","Montgomery County",3,19,6824,3529,3295
050,39,113,"Ohio","Montgomery County",3,20,7125,3636,3489
050,39,113,"Ohio","Montgomery County",3,21,7071,3491,3580
050,39,113,"Ohio","Montgomery County",3,22,7270,3624,3646
050,39,113,"Ohio","Montgomery County",3,23,6937,3433,3504
050,39,113,"Ohio","Montgomery County",3,24,7020,3531,3489
050,39,113,"Ohio","Montgomery County",3,25,7027,3521,3506
050,39,113,"Ohio","Montgomery County",3,26,7201,3597,3604
050,39,113,"Ohio","Montgomery County",3,27,7436,3700,3736
050,39,113,"Ohio","Montgomery County",3,28,7560,3725,3835
050,39,113,"Ohio","Montgomery County",3,29,7807,3819,3988
050,39,113,"Ohio","Montgomery County",3,30,7905,3870,4035
050,39,113,"Ohio","Montgomery County",3,31,7713,3753,3960
050,39,113,"Ohio","Montgomery County",3,32,7435,3658,3777
050,39,113,"Ohio","Montgomery County",3,33,7132,3526,3606
050,39,113,"Ohio","Montgomery County",3,34,6942,3447,3495
050,39,113,"Ohio","Montgomery County",3,35,6850,3387,3463
050,39,113,"Ohio","Montgomery County",3,36,6819,3388,3431
050,39,113,"Ohio","Montgomery County",3,37,6559,3207,3352
050,39,113,"Ohio","Montgomery County",3,38,6591,3227,3364
050,39,113,"Ohio","Montgomery County",3,39,6554,3187,3367
050,39,113,"Ohio","Montgomery County",3,40,6446,3111,3335
050,39,113,"Ohio","Montgomery County",3,41,6537,3137,3400
050,39,113,"Ohio","Montgomery County",3,42,6268,3092,3176
050,39,113,"Ohio","Montgomery County",3,43,5974,2909,3065
050,39,113,"Ohio","Montgomery County",3,44,5792,2830,2962
050,39,113,"Ohio","Montgomery County",3,45,5534,2681,2853
050,39,113,"Ohio","Montgomery County",3,46,5664,2742,2922
050,39,113,"Ohio","Montgomery County",3,47,5560,2693,2867
050,39,113,"Ohio","Montgomery County",3,48,5818,2810,3008
050,39,113,"Ohio","Montgomery County",3,49,6278,3074,3204
050,39,113,"Ohio","Montgomery County",3,50,6772,3330,3442
050,39,113,"Ohio","Montgomery County",3,51,6574,3203,3371
050,39,113,"Ohio","Montgomery County",3,52,6368,3077,3291
050,39,113,"Ohio","Montgomery County",3,53,6166,2962,3204
050,39,113,"Ohio","Montgomery County",3,54,6384,3115,3269
050,39,113,"Ohio","Montgomery County",3,55,6608,3207,3401
050,39,113,"Ohio","Montgomery County",3,56,6868,3325,3543
050,39,113,"Ohio","Montgomery County",3,57,7131,3446,3685
050,39,113,"Ohio","Montgomery County",3,58,7099,3453,3646
050,39,113,"Ohio","Montgomery County",3,59,7191,3495,3696
050,39,113,"Ohio","Montgomery County",3,60,7394,3594,3800
050,39,113,"Ohio","Montgomery County",3,61,7180,3430,3750
050,39,113,"Ohio","Montgomery County",3,62,7125,3399,3726
050,39,113,"Ohio","Montgomery County",3,63,7154,3398,3756
050,39,113,"Ohio","Montgomery County",3,64,6968,3272,3696
050,39,113,"Ohio","Montgomery County",3,65,6685,3182,3503
050,39,113,"Ohio","Montgomery County",3,66,6518,3039,3479
050,39,113,"Ohio","Montgomery County",3,67,6286,2843,3443
050,39,113,"Ohio","Montgomery County",3,68,6005,2752,3253
050,39,113,"Ohio","Montgomery County",3,69,5820,2694,3126
050,39,113,"Ohio","Montgomery County",3,70,5580,2548,3032
050,39,113,"Ohio","Montgomery County",3,71,5296,2370,2926
050,39,113,"Ohio","Montgomery County",3,72,5212,2308,2904
050,39,113,"Ohio","Montgomery County",3,73,5128,2255,2873
050,39,113,"Ohio","Montgomery County",3,74,5417,2385,3032
050,39,113,"Ohio","Montgomery County",3,75,3647,1598,2049
050,39,113,"Ohio","Montgomery County",3,76,3395,1488,1907
050,39,113,"Ohio","Montgomery County",3,77,3351,1475,1876
050,39,113,"Ohio","Montgomery County",3,78,3496,1508,1988
050,39,113,"Ohio","Montgomery County",3,79,3005,1299,1706
050,39,113,"Ohio","Montgomery County",3,80,2683,1117,1566
050,39,113,"Ohio","Montgomery County",3,81,2445,987,1458
050,39,113,"Ohio","Montgomery County",3,82,2242,901,1341
050,39,113,"Ohio","Montgomery County",3,83,2122,855,1267
050,39,113,"Ohio","Montgomery County",3,84,1875,719,1156
050,39,113,"Ohio","Montgomery County",3,85,11631,3888,7743
050,39,113,"Ohio","Montgomery County",4,0,5993,3006,2987
050,39,113,"Ohio","Montgomery County",4,1,6064,3078,2986
050,39,113,"Ohio","Montgomery County",4,2,6162,3110,3052
050,39,113,"Ohio","Montgomery County",4,3,6391,3291,3100
050,39,113,"Ohio","Montgomery County",4,4,6582,3386,3196
050,39,113,"Ohio","Montgomery County",4,5,6559,3380,3179
050,39,113,"Ohio","Montgomery County",4,6,6608,3407,3201
050,39,113,"Ohio","Montgomery County",4,7,6627,3427,3200
050,39,113,"Ohio","Montgomery County",4,8,6491,3370,3121
050,39,113,"Ohio","Montgomery County",4,9,6504,3299,3205
050,39,113,"Ohio","Montgomery County",4,10,6516,3320,3196
050,39,113,"Ohio","Montgomery County",4,11,6494,3277,3217
050,39,113,"Ohio","Montgomery County",4,12,6647,3417,3230
050,39,113,"Ohio","Montgomery County",4,13,6779,3415,3364
050,39,113,"Ohio","Montgomery County",4,14,6984,3578,3406
050,39,113,"Ohio","Montgomery County",4,15,6995,3592,3403
050,39,113,"Ohio","Montgomery County",4,16,6891,3506,3385
050,39,113,"Ohio","Montgomery County",4,17,6804,3454,3350
050,39,113,"Ohio","Montgomery County",4,18,6503,3386,3117
050,39,113,"Ohio","Montgomery County",4,19,6661,3412,3249
050,39,113,"Ohio","Montgomery County",4,20,7041,3641,3400
050,39,113,"Ohio","Montgomery County",4,21,7051,3577,3474
050,39,113,"Ohio","Montgomery County",4,22,7291,3626,3665
050,39,113,"Ohio","Montgomery County",4,23,7069,3511,3558
050,39,113,"Ohio","Montgomery County",4,24,7053,3444,3609
050,39,113,"Ohio","Montgomery County",4,25,7157,3604,3553
050,39,113,"Ohio","Montgomery County",4,26,7066,3555,3511
050,39,113,"Ohio","Montgomery County",4,27,7216,3591,3625
050,39,113,"Ohio","Montgomery County",4,28,7432,3668,3764
050,39,113,"Ohio","Montgomery County",4,29,7525,3717,3808
050,39,113,"Ohio","Montgomery County",4,30,7737,3761,3976
050,39,113,"Ohio","Montgomery County",4,31,7877,3893,3984
050,39,113,"Ohio","Montgomery County",4,32,7626,3714,3912
050,39,113,"Ohio","Montgomery County",4,33,7361,3598,3763
050,39,113,"Ohio","Montgomery County",4,34,7007,3462,3545
050,39,113,"Ohio","Montgomery County",4,35,6866,3415,3451
050,39,113,"Ohio","Montgomery County",4,36,6767,3322,3445
050,39,113,"Ohio","Montgomery County",4,37,6762,3348,3414
050,39,113,"Ohio","Montgomery County",4,38,6501,3165,3336
050,39,113,"Ohio","Montgomery County",4,39,6538,3199,3339
050,39,113,"Ohio","Montgomery County",4,40,6491,3138,3353
050,39,113,"Ohio","Montgomery County",4,41,6443,3102,3341
050,39,113,"Ohio","Montgomery County",4,42,6451,3088,3363
050,39,113,"Ohio","Montgomery County",4,43,6229,3075,3154
050,39,113,"Ohio","Montgomery County",4,44,5905,2887,3018
050,39,113,"Ohio","Montgomery County",4,45,5741,2791,2950
050,39,113,"Ohio","Montgomery County",4,46,5538,2710,2828
050,39,113,"Ohio","Montgomery County",4,47,5666,2764,2902
050,39,113,"Ohio","Montgomery County",4,48,5483,2642,2841
050,39,113,"Ohio","Montgomery County",4,49,5786,2780,3006
050,39,113,"Ohio","Montgomery County",4,50,6201,3037,3164
050,39,113,"Ohio","Montgomery County",4,51,6694,3312,3382
050,39,113,"Ohio","Montgomery County",4,52,6517,3153,3364
050,39,113,"Ohio","Montgomery County",4,53,6291,3020,3271
050,39,113,"Ohio","Montgomery County",4,54,6068,2912,3156
050,39,113,"Ohio","Montgomery County",4,55,6270,3054,3216
050,39,113,"Ohio","Montgomery County",4,56,6538,3165,3373
050,39,113,"Ohio","Montgomery County",4,57,6726,3225,3501
050,39,113,"Ohio","Montgomery County",4,58,7010,3396,3614
050,39,113,"Ohio","Montgomery County",4,59,7010,3380,3630
050,39,113,"Ohio","Montgomery County",4,60,7041,3418,3623
050,39,113,"Ohio","Montgomery County",4,61,7180,3451,3729
050,39,113,"Ohio","Montgomery County",4,62,7016,3322,3694
050,39,113,"Ohio","Montgomery County",4,63,6938,3291,3647
050,39,113,"Ohio","Montgomery County",4,64,6957,3289,3668
050,39,113,"Ohio","Montgomery County",4,65,6846,3207,3639
050,39,113,"Ohio","Montgomery County",4,66,6528,3120,3408
050,39,113,"Ohio","Montgomery County",4,67,6342,2940,3402
050,39,113,"Ohio","Montgomery County",4,68,6085,2747,3338
050,39,113,"Ohio","Montgomery County",4,69,5847,2660,3187
050,39,113,"Ohio","Montgomery County",4,70,5640,2616,3024
050,39,113,"Ohio","Montgomery County",4,71,5420,2462,2958
050,39,113,"Ohio","Montgomery County",4,72,5126,2272,2854
050,39,113,"Ohio","Montgomery County",4,73,5023,2230,2793
050,39,113,"Ohio","Montgomery County",4,74,4923,2132,2791
050,39,113,"Ohio","Montgomery County",4,75,5226,2280,2946
050,39,113,"Ohio","Montgomery County",4,76,3479,1505,1974
050,39,113,"Ohio","Montgomery County",4,77,3273,1422,1851
050,39,113,"Ohio","Montgomery County",4,78,3211,1401,1810
050,39,113,"Ohio","Montgomery County",4,79,3243,1397,1846
050,39,113,"Ohio","Montgomery County",4,80,2860,1219,1641
050,39,113,"Ohio","Montgomery County",4,81,2493,1019,1474
050,39,113,"Ohio","Montgomery County",4,82,2219,897,1322
050,39,113,"Ohio","Montgomery County",4,83,2105,844,1261
050,39,113,"Ohio","Montgomery County",4,84,1895,734,1161
050,39,113,"Ohio","Montgomery County",4,85,11302,3804,7498
050,39,113,"Ohio","Montgomery County",5,0,6054,3045,3009
050,39,113,"Ohio","Montgomery County",5,1,5990,2997,2993
050,39,113,"Ohio","Montgomery County",5,2,6082,3086,2996
050,39,113,"Ohio","Montgomery County",5,3,6153,3100,3053
050,39,113,"Ohio","Montgomery County",5,4,6419,3353,3066
050,39,113,"Ohio","Montgomery County",5,5,6609,3416,3193
050,39,113,"Ohio","Montgomery County",5,6,6577,3412,3165
050,39,113,"Ohio","Montgomery County",5,7,6640,3418,3222
050,39,113,"Ohio","Montgomery County",5,8,6661,3459,3202
050,39,113,"Ohio","Montgomery County",5,9,6535,3377,3158
050,39,113,"Ohio","Montgomery County",5,10,6539,3312,3227
050,39,113,"Ohio","Montgomery County",5,11,6610,3359,3251
050,39,113,"Ohio","Montgomery County",5,12,6553,3305,3248
050,39,113,"Ohio","Montgomery County",5,13,6657,3430,3227
050,39,113,"Ohio","Montgomery County",5,14,6825,3454,3371
050,39,113,"Ohio","Montgomery County",5,15,6978,3577,3401
050,39,113,"Ohio","Montgomery County",5,16,7112,3634,3478
050,39,113,"Ohio","Montgomery County",5,17,6966,3512,3454
050,39,113,"Ohio","Montgomery County",5,18,6379,3302,3077
050,39,113,"Ohio","Montgomery County",5,19,6660,3429,3231
050,39,113,"Ohio","Montgomery County",5,20,6816,3473,3343
050,39,113,"Ohio","Montgomery County",5,21,7001,3578,3423
050,39,113,"Ohio","Montgomery County",5,22,7252,3718,3534
050,39,113,"Ohio","Montgomery County",5,23,6984,3485,3499
050,39,113,"Ohio","Montgomery County",5,24,7252,3582,3670
050,39,113,"Ohio","Montgomery County",5,25,7211,3570,3641
050,39,113,"Ohio","Montgomery County",5,26,7176,3632,3544
050,39,113,"Ohio","Montgomery County",5,27,7080,3522,3558
050,39,113,"Ohio","Montgomery County",5,28,7246,3646,3600
050,39,113,"Ohio","Montgomery County",5,29,7447,3740,3707
050,39,113,"Ohio","Montgomery County",5,30,7534,3735,3799
050,39,113,"Ohio","Montgomery County",5,31,7673,3735,3938
050,39,113,"Ohio","Montgomery County",5,32,7831,3869,3962
050,39,113,"Ohio","Montgomery County",5,33,7556,3663,3893
050,39,113,"Ohio","Montgomery County",5,34,7312,3596,3716
050,39,113,"Ohio","Montgomery County",5,35,6968,3414,3554
050,39,113,"Ohio","Montgomery County",5,36,6863,3397,3466
050,39,113,"Ohio","Montgomery County",5,37,6761,3322,3439
050,39,113,"Ohio","Montgomery County",5,38,6652,3254,3398
050,39,113,"Ohio","Montgomery County",5,39,6530,3177,3353
050,39,113,"Ohio","Montgomery County",5,40,6487,3178,3309
050,39,113,"Ohio","Montgomery County",5,41,6505,3146,3359
050,39,113,"Ohio","Montgomery County",5,42,6425,3080,3345
050,39,113,"Ohio","Montgomery County",5,43,6457,3112,3345
050,39,113,"Ohio","Montgomery County",5,44,6198,3047,3151
050,39,113,"Ohio","Montgomery County",5,45,5871,2850,3021
050,39,113,"Ohio","Montgomery County",5,46,5768,2819,2949
050,39,113,"Ohio","Montgomery County",5,47,5550,2708,2842
050,39,113,"Ohio","Montgomery County",5,48,5642,2729,2913
050,39,113,"Ohio","Montgomery County",5,49,5499,2664,2835
050,39,113,"Ohio","Montgomery County",5,50,5751,2765,2986
050,39,113,"Ohio","Montgomery County",5,51,6172,3013,3159
050,39,113,"Ohio","Montgomery County",5,52,6685,3297,3388
050,39,113,"Ohio","Montgomery County",5,53,6530,3165,3365
050,39,113,"Ohio","Montgomery County",5,54,6268,3009,3259
050,39,113,"Ohio","Montgomery County",5,55,5974,2853,3121
050,39,113,"Ohio","Montgomery County",5,56,6189,3016,3173
050,39,113,"Ohio","Montgomery County",5,57,6425,3073,3352
050,39,113,"Ohio","Montgomery County",5,58,6629,3172,3457
050,39,113,"Ohio","Montgomery County",5,59,6960,3365,3595
050,39,113,"Ohio","Montgomery County",5,60,6916,3317,3599
050,39,113,"Ohio","Montgomery County",5,61,6907,3330,3577
050,39,113,"Ohio","Montgomery County",5,62,7096,3397,3699
050,39,113,"Ohio","Montgomery County",5,63,6907,3237,3670
050,39,113,"Ohio","Montgomery County",5,64,6823,3209,3614
050,39,113,"Ohio","Montgomery County",5,65,6839,3221,3618
050,39,113,"Ohio","Montgomery County",5,66,6728,3149,3579
050,39,113,"Ohio","Montgomery County",5,67,6383,3037,3346
050,39,113,"Ohio","Montgomery County",5,68,6198,2877,3321
050,39,113,"Ohio","Montgomery County",5,69,5967,2669,3298
050,39,113,"Ohio","Montgomery County",5,70,5701,2592,3109
050,39,113,"Ohio","Montgomery County",5,71,5513,2551,2962
050,39,113,"Ohio","Montgomery County",5,72,5278,2382,2896
050,39,113,"Ohio","Montgomery County",5,73,4944,2203,2741
050,39,113,"Ohio","Montgomery County",5,74,4853,2108,2745
050,39,113,"Ohio","Montgomery County",5,75,4765,2042,2723
050,39,113,"Ohio","Montgomery County",5,76,5013,2168,2845
050,39,113,"Ohio","Montgomery County",5,77,3349,1441,1908
050,39,113,"Ohio","Montgomery County",5,78,3151,1350,1801
050,39,113,"Ohio","Montgomery County",5,79,2991,1297,1694
050,39,113,"Ohio","Montgomery County",5,80,3090,1317,1773
050,39,113,"Ohio","Montgomery County",5,81,2702,1140,1562
050,39,113,"Ohio","Montgomery County",5,82,2289,936,1353
050,39,113,"Ohio","Montgomery County",5,83,2093,848,1245
050,39,113,"Ohio","Montgomery County",5,84,1900,728,1172
050,39,113,"Ohio","Montgomery County",5,85,11271,3839,7432
050,39,115,"Ohio","Morgan County",1,0,122,63,59
050,39,115,"Ohio","Morgan County",1,1,133,71,62
050,39,115,"Ohio","Morgan County",1,2,141,62,79
050,39,115,"Ohio","Morgan County",1,3,134,56,78
050,39,115,"Ohio","Morgan County",1,4,156,73,83
050,39,115,"Ohio","Morgan County",1,5,143,70,73
050,39,115,"Ohio","Morgan County",1,6,130,66,64
050,39,115,"Ohio","Morgan County",1,7,136,73,63
050,39,115,"Ohio","Morgan County",1,8,143,74,69
050,39,115,"Ohio","Morgan County",1,9,157,82,75
050,39,115,"Ohio","Morgan County",1,10,176,85,91
050,39,115,"Ohio","Morgan County",1,11,175,87,88
050,39,115,"Ohio","Morgan County",1,12,186,97,89
050,39,115,"Ohio","Morgan County",1,13,185,95,90
050,39,115,"Ohio","Morgan County",1,14,213,114,99
050,39,115,"Ohio","Morgan County",1,15,186,95,91
050,39,115,"Ohio","Morgan County",1,16,180,98,82
050,39,115,"Ohio","Morgan County",1,17,182,93,89
050,39,115,"Ohio","Morgan County",1,18,153,85,68
050,39,115,"Ohio","Morgan County",1,19,131,79,52
050,39,115,"Ohio","Morgan County",1,20,127,75,52
050,39,115,"Ohio","Morgan County",1,21,142,81,61
050,39,115,"Ohio","Morgan County",1,22,135,71,64
050,39,115,"Ohio","Morgan County",1,23,151,82,69
050,39,115,"Ohio","Morgan County",1,24,145,71,74
050,39,115,"Ohio","Morgan County",1,25,143,79,64
050,39,115,"Ohio","Morgan County",1,26,147,80,67
050,39,115,"Ohio","Morgan County",1,27,148,76,72
050,39,115,"Ohio","Morgan County",1,28,148,74,74
050,39,115,"Ohio","Morgan County",1,29,156,74,82
050,39,115,"Ohio","Morgan County",1,30,148,77,71
050,39,115,"Ohio","Morgan County",1,31,134,64,70
050,39,115,"Ohio","Morgan County",1,32,141,66,75
050,39,115,"Ohio","Morgan County",1,33,142,80,62
050,39,115,"Ohio","Morgan County",1,34,135,68,67
050,39,115,"Ohio","Morgan County",1,35,167,83,84
050,39,115,"Ohio","Morgan County",1,36,153,76,77
050,39,115,"Ohio","Morgan County",1,37,159,96,63
050,39,115,"Ohio","Morgan County",1,38,159,80,79
050,39,115,"Ohio","Morgan County",1,39,171,74,97
050,39,115,"Ohio","Morgan County",1,40,171,88,83
050,39,115,"Ohio","Morgan County",1,41,164,79,85
050,39,115,"Ohio","Morgan County",1,42,154,70,84
050,39,115,"Ohio","Morgan County",1,43,153,64,89
050,39,115,"Ohio","Morgan County",1,44,145,71,74
050,39,115,"Ohio","Morgan County",1,45,153,82,71
050,39,115,"Ohio","Morgan County",1,46,163,86,77
050,39,115,"Ohio","Morgan County",1,47,168,82,86
050,39,115,"Ohio","Morgan County",1,48,192,99,93
050,39,115,"Ohio","Morgan County",1,49,192,102,90
050,39,115,"Ohio","Morgan County",1,50,171,88,83
050,39,115,"Ohio","Morgan County",1,51,183,85,98
050,39,115,"Ohio","Morgan County",1,52,161,79,82
050,39,115,"Ohio","Morgan County",1,53,180,92,88
050,39,115,"Ohio","Morgan County",1,54,203,99,104
050,39,115,"Ohio","Morgan County",1,55,209,109,100
050,39,115,"Ohio","Morgan County",1,56,193,97,96
050,39,115,"Ohio","Morgan County",1,57,213,101,112
050,39,115,"Ohio","Morgan County",1,58,233,114,119
050,39,115,"Ohio","Morgan County",1,59,226,123,103
050,39,115,"Ohio","Morgan County",1,60,231,120,111
050,39,115,"Ohio","Morgan County",1,61,225,110,115
050,39,115,"Ohio","Morgan County",1,62,210,113,97
050,39,115,"Ohio","Morgan County",1,63,215,110,105
050,39,115,"Ohio","Morgan County",1,64,209,103,106
050,39,115,"Ohio","Morgan County",1,65,195,97,98
050,39,115,"Ohio","Morgan County",1,66,213,104,109
050,39,115,"Ohio","Morgan County",1,67,198,106,92
050,39,115,"Ohio","Morgan County",1,68,177,89,88
050,39,115,"Ohio","Morgan County",1,69,164,79,85
050,39,115,"Ohio","Morgan County",1,70,179,93,86
050,39,115,"Ohio","Morgan County",1,71,183,92,91
050,39,115,"Ohio","Morgan County",1,72,167,81,86
050,39,115,"Ohio","Morgan County",1,73,162,89,73
050,39,115,"Ohio","Morgan County",1,74,107,55,52
050,39,115,"Ohio","Morgan County",1,75,108,50,58
050,39,115,"Ohio","Morgan County",1,76,95,47,48
050,39,115,"Ohio","Morgan County",1,77,106,49,57
050,39,115,"Ohio","Morgan County",1,78,99,47,52
050,39,115,"Ohio","Morgan County",1,79,95,47,48
050,39,115,"Ohio","Morgan County",1,80,94,44,50
050,39,115,"Ohio","Morgan County",1,81,79,36,43
050,39,115,"Ohio","Morgan County",1,82,82,35,47
050,39,115,"Ohio","Morgan County",1,83,62,26,36
050,39,115,"Ohio","Morgan County",1,84,72,31,41
050,39,115,"Ohio","Morgan County",1,85,340,119,221
050,39,115,"Ohio","Morgan County",2,0,127,60,67
050,39,115,"Ohio","Morgan County",2,1,130,69,61
050,39,115,"Ohio","Morgan County",2,2,138,63,75
050,39,115,"Ohio","Morgan County",2,3,133,57,76
050,39,115,"Ohio","Morgan County",2,4,148,68,80
050,39,115,"Ohio","Morgan County",2,5,147,71,76
050,39,115,"Ohio","Morgan County",2,6,132,67,65
050,39,115,"Ohio","Morgan County",2,7,134,71,63
050,39,115,"Ohio","Morgan County",2,8,139,72,67
050,39,115,"Ohio","Morgan County",2,9,155,80,75
050,39,115,"Ohio","Morgan County",2,10,170,84,86
050,39,115,"Ohio","Morgan County",2,11,174,86,88
050,39,115,"Ohio","Morgan County",2,12,185,95,90
050,39,115,"Ohio","Morgan County",2,13,185,95,90
050,39,115,"Ohio","Morgan County",2,14,207,109,98
050,39,115,"Ohio","Morgan County",2,15,194,100,94
050,39,115,"Ohio","Morgan County",2,16,182,97,85
050,39,115,"Ohio","Morgan County",2,17,180,93,87
050,39,115,"Ohio","Morgan County",2,18,152,83,69
050,39,115,"Ohio","Morgan County",2,19,129,76,53
050,39,115,"Ohio","Morgan County",2,20,130,77,53
050,39,115,"Ohio","Morgan County",2,21,138,80,58
050,39,115,"Ohio","Morgan County",2,22,137,74,63
050,39,115,"Ohio","Morgan County",2,23,148,79,69
050,39,115,"Ohio","Morgan County",2,24,147,75,72
050,39,115,"Ohio","Morgan County",2,25,145,78,67
050,39,115,"Ohio","Morgan County",2,26,144,78,66
050,39,115,"Ohio","Morgan County",2,27,145,76,69
050,39,115,"Ohio","Morgan County",2,28,149,76,73
050,39,115,"Ohio","Morgan County",2,29,154,75,79
050,39,115,"Ohio","Morgan County",2,30,151,77,74
050,39,115,"Ohio","Morgan County",2,31,136,66,70
050,39,115,"Ohio","Morgan County",2,32,137,64,73
050,39,115,"Ohio","Morgan County",2,33,140,76,64
050,39,115,"Ohio","Morgan County",2,34,136,69,67
050,39,115,"Ohio","Morgan County",2,35,161,79,82
050,39,115,"Ohio","Morgan County",2,36,154,77,77
050,39,115,"Ohio","Morgan County",2,37,157,91,66
050,39,115,"Ohio","Morgan County",2,38,160,84,76
050,39,115,"Ohio","Morgan County",2,39,168,75,93
050,39,115,"Ohio","Morgan County",2,40,172,85,87
050,39,115,"Ohio","Morgan County",2,41,164,81,83
050,39,115,"Ohio","Morgan County",2,42,154,71,83
050,39,115,"Ohio","Morgan County",2,43,153,65,88
050,39,115,"Ohio","Morgan County",2,44,145,69,76
050,39,115,"Ohio","Morgan County",2,45,152,80,72
050,39,115,"Ohio","Morgan County",2,46,160,84,76
050,39,115,"Ohio","Morgan County",2,47,165,82,83
050,39,115,"Ohio","Morgan County",2,48,186,95,91
050,39,115,"Ohio","Morgan County",2,49,195,102,93
050,39,115,"Ohio","Morgan County",2,50,177,91,86
050,39,115,"Ohio","Morgan County",2,51,180,85,95
050,39,115,"Ohio","Morgan County",2,52,167,81,86
050,39,115,"Ohio","Morgan County",2,53,175,88,87
050,39,115,"Ohio","Morgan County",2,54,195,96,99
050,39,115,"Ohio","Morgan County",2,55,207,107,100
050,39,115,"Ohio","Morgan County",2,56,198,101,97
050,39,115,"Ohio","Morgan County",2,57,209,100,109
050,39,115,"Ohio","Morgan County",2,58,227,111,116
050,39,115,"Ohio","Morgan County",2,59,228,122,106
050,39,115,"Ohio","Morgan County",2,60,231,121,110
050,39,115,"Ohio","Morgan County",2,61,224,110,114
050,39,115,"Ohio","Morgan County",2,62,213,112,101
050,39,115,"Ohio","Morgan County",2,63,216,112,104
050,39,115,"Ohio","Morgan County",2,64,208,103,105
050,39,115,"Ohio","Morgan County",2,65,199,99,100
050,39,115,"Ohio","Morgan County",2,66,208,101,107
050,39,115,"Ohio","Morgan County",2,67,198,103,95
050,39,115,"Ohio","Morgan County",2,68,178,91,87
050,39,115,"Ohio","Morgan County",2,69,168,81,87
050,39,115,"Ohio","Morgan County",2,70,174,90,84
050,39,115,"Ohio","Morgan County",2,71,181,93,88
050,39,115,"Ohio","Morgan County",2,72,166,82,84
050,39,115,"Ohio","Morgan County",2,73,171,91,80
050,39,115,"Ohio","Morgan County",2,74,112,59,53
050,39,115,"Ohio","Morgan County",2,75,108,50,58
050,39,115,"Ohio","Morgan County",2,76,97,47,50
050,39,115,"Ohio","Morgan County",2,77,105,50,55
050,39,115,"Ohio","Morgan County",2,78,100,47,53
050,39,115,"Ohio","Morgan County",2,79,94,46,48
050,39,115,"Ohio","Morgan County",2,80,93,43,50
050,39,115,"Ohio","Morgan County",2,81,80,37,43
050,39,115,"Ohio","Morgan County",2,82,82,36,46
050,39,115,"Ohio","Morgan County",2,83,62,26,36
050,39,115,"Ohio","Morgan County",2,84,68,29,39
050,39,115,"Ohio","Morgan County",2,85,339,119,220
050,39,115,"Ohio","Morgan County",3,0,152,81,71
050,39,115,"Ohio","Morgan County",3,1,144,69,75
050,39,115,"Ohio","Morgan County",3,2,120,63,57
050,39,115,"Ohio","Morgan County",3,3,142,70,72
050,39,115,"Ohio","Morgan County",3,4,138,60,78
050,39,115,"Ohio","Morgan County",3,5,142,69,73
050,39,115,"Ohio","Morgan County",3,6,145,68,77
050,39,115,"Ohio","Morgan County",3,7,132,67,65
050,39,115,"Ohio","Morgan County",3,8,138,72,66
050,39,115,"Ohio","Morgan County",3,9,139,73,66
050,39,115,"Ohio","Morgan County",3,10,157,77,80
050,39,115,"Ohio","Morgan County",3,11,171,82,89
050,39,115,"Ohio","Morgan County",3,12,177,89,88
050,39,115,"Ohio","Morgan County",3,13,188,95,93
050,39,115,"Ohio","Morgan County",3,14,181,95,86
050,39,115,"Ohio","Morgan County",3,15,207,109,98
050,39,115,"Ohio","Morgan County",3,16,192,97,95
050,39,115,"Ohio","Morgan County",3,17,182,93,89
050,39,115,"Ohio","Morgan County",3,18,152,85,67
050,39,115,"Ohio","Morgan County",3,19,115,63,52
050,39,115,"Ohio","Morgan County",3,20,137,80,57
050,39,115,"Ohio","Morgan County",3,21,129,79,50
050,39,115,"Ohio","Morgan County",3,22,147,81,66
050,39,115,"Ohio","Morgan County",3,23,144,76,68
050,39,115,"Ohio","Morgan County",3,24,152,85,67
050,39,115,"Ohio","Morgan County",3,25,141,75,66
050,39,115,"Ohio","Morgan County",3,26,146,81,65
050,39,115,"Ohio","Morgan County",3,27,134,70,64
050,39,115,"Ohio","Morgan County",3,28,151,83,68
050,39,115,"Ohio","Morgan County",3,29,148,73,75
050,39,115,"Ohio","Morgan County",3,30,157,79,78
050,39,115,"Ohio","Morgan County",3,31,155,75,80
050,39,115,"Ohio","Morgan County",3,32,127,64,63
050,39,115,"Ohio","Morgan County",3,33,134,63,71
050,39,115,"Ohio","Morgan County",3,34,140,76,64
050,39,115,"Ohio","Morgan County",3,35,135,68,67
050,39,115,"Ohio","Morgan County",3,36,158,78,80
050,39,115,"Ohio","Morgan County",3,37,151,75,76
050,39,115,"Ohio","Morgan County",3,38,160,93,67
050,39,115,"Ohio","Morgan County",3,39,161,85,76
050,39,115,"Ohio","Morgan County",3,40,169,77,92
050,39,115,"Ohio","Morgan County",3,41,182,94,88
050,39,115,"Ohio","Morgan County",3,42,166,77,89
050,39,115,"Ohio","Morgan County",3,43,160,75,85
050,39,115,"Ohio","Morgan County",3,44,160,67,93
050,39,115,"Ohio","Morgan County",3,45,135,63,72
050,39,115,"Ohio","Morgan County",3,46,151,78,73
050,39,115,"Ohio","Morgan County",3,47,158,82,76
050,39,115,"Ohio","Morgan County",3,48,163,80,83
050,39,115,"Ohio","Morgan County",3,49,187,94,93
050,39,115,"Ohio","Morgan County",3,50,198,103,95
050,39,115,"Ohio","Morgan County",3,51,173,90,83
050,39,115,"Ohio","Morgan County",3,52,184,86,98
050,39,115,"Ohio","Morgan County",3,53,170,86,84
050,39,115,"Ohio","Morgan County",3,54,174,87,87
050,39,115,"Ohio","Morgan County",3,55,196,96,100
050,39,115,"Ohio","Morgan County",3,56,210,110,100
050,39,115,"Ohio","Morgan County",3,57,195,98,97
050,39,115,"Ohio","Morgan County",3,58,208,99,109
050,39,115,"Ohio","Morgan County",3,59,227,109,118
050,39,115,"Ohio","Morgan County",3,60,229,121,108
050,39,115,"Ohio","Morgan County",3,61,233,122,111
050,39,115,"Ohio","Morgan County",3,62,226,110,116
050,39,115,"Ohio","Morgan County",3,63,210,108,102
050,39,115,"Ohio","Morgan County",3,64,210,107,103
050,39,115,"Ohio","Morgan County",3,65,206,102,104
050,39,115,"Ohio","Morgan County",3,66,193,95,98
050,39,115,"Ohio","Morgan County",3,67,201,101,100
050,39,115,"Ohio","Morgan County",3,68,198,105,93
050,39,115,"Ohio","Morgan County",3,69,171,85,86
050,39,115,"Ohio","Morgan County",3,70,166,77,89
050,39,115,"Ohio","Morgan County",3,71,170,88,82
050,39,115,"Ohio","Morgan County",3,72,171,85,86
050,39,115,"Ohio","Morgan County",3,73,156,76,80
050,39,115,"Ohio","Morgan County",3,74,163,89,74
050,39,115,"Ohio","Morgan County",3,75,113,58,55
050,39,115,"Ohio","Morgan County",3,76,102,48,54
050,39,115,"Ohio","Morgan County",3,77,95,46,49
050,39,115,"Ohio","Morgan County",3,78,96,44,52
050,39,115,"Ohio","Morgan County",3,79,94,46,48
050,39,115,"Ohio","Morgan County",3,80,96,47,49
050,39,115,"Ohio","Morgan County",3,81,83,39,44
050,39,115,"Ohio","Morgan County",3,82,72,34,38
050,39,115,"Ohio","Morgan County",3,83,78,32,46
050,39,115,"Ohio","Morgan County",3,84,52,23,29
050,39,115,"Ohio","Morgan County",3,85,332,119,213
050,39,115,"Ohio","Morgan County",4,0,135,77,58
050,39,115,"Ohio","Morgan County",4,1,155,85,70
050,39,115,"Ohio","Morgan County",4,2,152,81,71
050,39,115,"Ohio","Morgan County",4,3,127,67,60
050,39,115,"Ohio","Morgan County",4,4,145,67,78
050,39,115,"Ohio","Morgan County",4,5,137,61,76
050,39,115,"Ohio","Morgan County",4,6,149,74,75
050,39,115,"Ohio","Morgan County",4,7,155,77,78
050,39,115,"Ohio","Morgan County",4,8,136,65,71
050,39,115,"Ohio","Morgan County",4,9,144,77,67
050,39,115,"Ohio","Morgan County",4,10,141,70,71
050,39,115,"Ohio","Morgan County",4,11,162,80,82
050,39,115,"Ohio","Morgan County",4,12,176,87,89
050,39,115,"Ohio","Morgan County",4,13,175,93,82
050,39,115,"Ohio","Morgan County",4,14,189,94,95
050,39,115,"Ohio","Morgan County",4,15,183,95,88
050,39,115,"Ohio","Morgan County",4,16,204,102,102
050,39,115,"Ohio","Morgan County",4,17,197,103,94
050,39,115,"Ohio","Morgan County",4,18,148,80,68
050,39,115,"Ohio","Morgan County",4,19,107,60,47
050,39,115,"Ohio","Morgan County",4,20,123,63,60
050,39,115,"Ohio","Morgan County",4,21,144,81,63
050,39,115,"Ohio","Morgan County",4,22,134,77,57
050,39,115,"Ohio","Morgan County",4,23,148,81,67
050,39,115,"Ohio","Morgan County",4,24,144,78,66
050,39,115,"Ohio","Morgan County",4,25,150,80,70
050,39,115,"Ohio","Morgan County",4,26,148,79,69
050,39,115,"Ohio","Morgan County",4,27,151,85,66
050,39,115,"Ohio","Morgan County",4,28,141,72,69
050,39,115,"Ohio","Morgan County",4,29,151,85,66
050,39,115,"Ohio","Morgan County",4,30,152,76,76
050,39,115,"Ohio","Morgan County",4,31,160,77,83
050,39,115,"Ohio","Morgan County",4,32,162,79,83
050,39,115,"Ohio","Morgan County",4,33,126,64,62
050,39,115,"Ohio","Morgan County",4,34,133,64,69
050,39,115,"Ohio","Morgan County",4,35,145,78,67
050,39,115,"Ohio","Morgan County",4,36,133,63,70
050,39,115,"Ohio","Morgan County",4,37,156,77,79
050,39,115,"Ohio","Morgan County",4,38,157,81,76
050,39,115,"Ohio","Morgan County",4,39,159,91,68
050,39,115,"Ohio","Morgan County",4,40,160,85,75
050,39,115,"Ohio","Morgan County",4,41,174,77,97
050,39,115,"Ohio","Morgan County",4,42,178,91,87
050,39,115,"Ohio","Morgan County",4,43,178,83,95
050,39,115,"Ohio","Morgan County",4,44,155,74,81
050,39,115,"Ohio","Morgan County",4,45,158,66,92
050,39,115,"Ohio","Morgan County",4,46,136,62,74
050,39,115,"Ohio","Morgan County",4,47,149,78,71
050,39,115,"Ohio","Morgan County",4,48,161,83,78
050,39,115,"Ohio","Morgan County",4,49,157,77,80
050,39,115,"Ohio","Morgan County",4,50,189,94,95
050,39,115,"Ohio","Morgan County",4,51,196,104,92
050,39,115,"Ohio","Morgan County",4,52,173,92,81
050,39,115,"Ohio","Morgan County",4,53,183,82,101
050,39,115,"Ohio","Morgan County",4,54,168,84,84
050,39,115,"Ohio","Morgan County",4,55,179,87,92
050,39,115,"Ohio","Morgan County",4,56,192,97,95
050,39,115,"Ohio","Morgan County",4,57,202,106,96
050,39,115,"Ohio","Morgan County",4,58,191,96,95
050,39,115,"Ohio","Morgan County",4,59,214,105,109
050,39,115,"Ohio","Morgan County",4,60,235,116,119
050,39,115,"Ohio","Morgan County",4,61,231,123,108
050,39,115,"Ohio","Morgan County",4,62,229,120,109
050,39,115,"Ohio","Morgan County",4,63,221,107,114
050,39,115,"Ohio","Morgan County",4,64,207,104,103
050,39,115,"Ohio","Morgan County",4,65,205,106,99
050,39,115,"Ohio","Morgan County",4,66,204,96,108
050,39,115,"Ohio","Morgan County",4,67,185,92,93
050,39,115,"Ohio","Morgan County",4,68,193,96,97
050,39,115,"Ohio","Morgan County",4,69,190,101,89
050,39,115,"Ohio","Morgan County",4,70,170,81,89
050,39,115,"Ohio","Morgan County",4,71,163,73,90
050,39,115,"Ohio","Morgan County",4,72,161,83,78
050,39,115,"Ohio","Morgan County",4,73,163,80,83
050,39,115,"Ohio","Morgan County",4,74,147,71,76
050,39,115,"Ohio","Morgan County",4,75,159,86,73
050,39,115,"Ohio","Morgan County",4,76,105,55,50
050,39,115,"Ohio","Morgan County",4,77,97,47,50
050,39,115,"Ohio","Morgan County",4,78,91,43,48
050,39,115,"Ohio","Morgan County",4,79,89,42,47
050,39,115,"Ohio","Morgan County",4,80,90,44,46
050,39,115,"Ohio","Morgan County",4,81,84,42,42
050,39,115,"Ohio","Morgan County",4,82,77,35,42
050,39,115,"Ohio","Morgan County",4,83,62,30,32
050,39,115,"Ohio","Morgan County",4,84,72,31,41
050,39,115,"Ohio","Morgan County",4,85,312,106,206
050,39,115,"Ohio","Morgan County",5,0,133,74,59
050,39,115,"Ohio","Morgan County",5,1,141,83,58
050,39,115,"Ohio","Morgan County",5,2,164,92,72
050,39,115,"Ohio","Morgan County",5,3,143,76,67
050,39,115,"Ohio","Morgan County",5,4,136,68,68
050,39,115,"Ohio","Morgan County",5,5,144,68,76
050,39,115,"Ohio","Morgan County",5,6,144,68,76
050,39,115,"Ohio","Morgan County",5,7,146,70,76
050,39,115,"Ohio","Morgan County",5,8,158,79,79
050,39,115,"Ohio","Morgan County",5,9,141,67,74
050,39,115,"Ohio","Morgan County",5,10,145,77,68
050,39,115,"Ohio","Morgan County",5,11,135,67,68
050,39,115,"Ohio","Morgan County",5,12,161,80,81
050,39,115,"Ohio","Morgan County",5,13,177,91,86
050,39,115,"Ohio","Morgan County",5,14,180,91,89
050,39,115,"Ohio","Morgan County",5,15,185,91,94
050,39,115,"Ohio","Morgan County",5,16,178,92,86
050,39,115,"Ohio","Morgan County",5,17,207,103,104
050,39,115,"Ohio","Morgan County",5,18,156,84,72
050,39,115,"Ohio","Morgan County",5,19,107,57,50
050,39,115,"Ohio","Morgan County",5,20,124,66,58
050,39,115,"Ohio","Morgan County",5,21,130,64,66
050,39,115,"Ohio","Morgan County",5,22,149,80,69
050,39,115,"Ohio","Morgan County",5,23,142,81,61
050,39,115,"Ohio","Morgan County",5,24,157,93,64
050,39,115,"Ohio","Morgan County",5,25,149,78,71
050,39,115,"Ohio","Morgan County",5,26,150,77,73
050,39,115,"Ohio","Morgan County",5,27,147,76,71
050,39,115,"Ohio","Morgan County",5,28,147,84,63
050,39,115,"Ohio","Morgan County",5,29,150,76,74
050,39,115,"Ohio","Morgan County",5,30,158,86,72
050,39,115,"Ohio","Morgan County",5,31,153,76,77
050,39,115,"Ohio","Morgan County",5,32,170,85,85
050,39,115,"Ohio","Morgan County",5,33,160,79,81
050,39,115,"Ohio","Morgan County",5,34,130,66,64
050,39,115,"Ohio","Morgan County",5,35,147,72,75
050,39,115,"Ohio","Morgan County",5,36,143,78,65
050,39,115,"Ohio","Morgan County",5,37,138,68,70
050,39,115,"Ohio","Morgan County",5,38,152,78,74
050,39,115,"Ohio","Morgan County",5,39,163,86,77
050,39,115,"Ohio","Morgan County",5,40,164,95,69
050,39,115,"Ohio","Morgan County",5,41,162,87,75
050,39,115,"Ohio","Morgan County",5,42,174,77,97
050,39,115,"Ohio","Morgan County",5,43,180,89,91
050,39,115,"Ohio","Morgan County",5,44,176,83,93
050,39,115,"Ohio","Morgan County",5,45,156,73,83
050,39,115,"Ohio","Morgan County",5,46,152,63,89
050,39,115,"Ohio","Morgan County",5,47,137,64,73
050,39,115,"Ohio","Morgan County",5,48,150,78,72
050,39,115,"Ohio","Morgan County",5,49,159,82,77
050,39,115,"Ohio","Morgan County",5,50,157,79,78
050,39,115,"Ohio","Morgan County",5,51,190,96,94
050,39,115,"Ohio","Morgan County",5,52,197,106,91
050,39,115,"Ohio","Morgan County",5,53,175,91,84
050,39,115,"Ohio","Morgan County",5,54,180,83,97
050,39,115,"Ohio","Morgan County",5,55,171,87,84
050,39,115,"Ohio","Morgan County",5,56,174,90,84
050,39,115,"Ohio","Morgan County",5,57,179,90,89
050,39,115,"Ohio","Morgan County",5,58,208,108,100
050,39,115,"Ohio","Morgan County",5,59,188,95,93
050,39,115,"Ohio","Morgan County",5,60,220,108,112
050,39,115,"Ohio","Morgan County",5,61,233,115,118
050,39,115,"Ohio","Morgan County",5,62,227,119,108
050,39,115,"Ohio","Morgan County",5,63,220,115,105
050,39,115,"Ohio","Morgan County",5,64,219,106,113
050,39,115,"Ohio","Morgan County",5,65,204,104,100
050,39,115,"Ohio","Morgan County",5,66,203,104,99
050,39,115,"Ohio","Morgan County",5,67,204,96,108
050,39,115,"Ohio","Morgan County",5,68,181,91,90
050,39,115,"Ohio","Morgan County",5,69,188,93,95
050,39,115,"Ohio","Morgan County",5,70,188,97,91
050,39,115,"Ohio","Morgan County",5,71,165,77,88
050,39,115,"Ohio","Morgan County",5,72,152,68,84
050,39,115,"Ohio","Morgan County",5,73,159,83,76
050,39,115,"Ohio","Morgan County",5,74,158,78,80
050,39,115,"Ohio","Morgan County",5,75,145,71,74
050,39,115,"Ohio","Morgan County",5,76,146,81,65
050,39,115,"Ohio","Morgan County",5,77,95,49,46
050,39,115,"Ohio","Morgan County",5,78,92,44,48
050,39,115,"Ohio","Morgan County",5,79,84,43,41
050,39,115,"Ohio","Morgan County",5,80,89,41,48
050,39,115,"Ohio","Morgan County",5,81,80,40,40
050,39,115,"Ohio","Morgan County",5,82,81,38,43
050,39,115,"Ohio","Morgan County",5,83,69,31,38
050,39,115,"Ohio","Morgan County",5,84,55,28,27
050,39,115,"Ohio","Morgan County",5,85,320,108,212
050,39,117,"Ohio","Morrow County",1,0,367,190,177
050,39,117,"Ohio","Morrow County",1,1,379,195,184
050,39,117,"Ohio","Morrow County",1,2,393,193,200
050,39,117,"Ohio","Morrow County",1,3,387,208,179
050,39,117,"Ohio","Morrow County",1,4,386,191,195
050,39,117,"Ohio","Morrow County",1,5,391,190,201
050,39,117,"Ohio","Morrow County",1,6,386,200,186
050,39,117,"Ohio","Morrow County",1,7,395,216,179
050,39,117,"Ohio","Morrow County",1,8,415,212,203
050,39,117,"Ohio","Morrow County",1,9,432,214,218
050,39,117,"Ohio","Morrow County",1,10,456,235,221
050,39,117,"Ohio","Morrow County",1,11,449,255,194
050,39,117,"Ohio","Morrow County",1,12,490,269,221
050,39,117,"Ohio","Morrow County",1,13,492,245,247
050,39,117,"Ohio","Morrow County",1,14,498,258,240
050,39,117,"Ohio","Morrow County",1,15,518,255,263
050,39,117,"Ohio","Morrow County",1,16,518,260,258
050,39,117,"Ohio","Morrow County",1,17,522,257,265
050,39,117,"Ohio","Morrow County",1,18,430,224,206
050,39,117,"Ohio","Morrow County",1,19,321,176,145
050,39,117,"Ohio","Morrow County",1,20,337,184,153
050,39,117,"Ohio","Morrow County",1,21,357,198,159
050,39,117,"Ohio","Morrow County",1,22,347,184,163
050,39,117,"Ohio","Morrow County",1,23,370,196,174
050,39,117,"Ohio","Morrow County",1,24,343,189,154
050,39,117,"Ohio","Morrow County",1,25,339,178,161
050,39,117,"Ohio","Morrow County",1,26,358,199,159
050,39,117,"Ohio","Morrow County",1,27,399,205,194
050,39,117,"Ohio","Morrow County",1,28,403,196,207
050,39,117,"Ohio","Morrow County",1,29,391,192,199
050,39,117,"Ohio","Morrow County",1,30,407,198,209
050,39,117,"Ohio","Morrow County",1,31,414,198,216
050,39,117,"Ohio","Morrow County",1,32,390,203,187
050,39,117,"Ohio","Morrow County",1,33,374,195,179
050,39,117,"Ohio","Morrow County",1,34,384,178,206
050,39,117,"Ohio","Morrow County",1,35,378,185,193
050,39,117,"Ohio","Morrow County",1,36,407,205,202
050,39,117,"Ohio","Morrow County",1,37,412,206,206
050,39,117,"Ohio","Morrow County",1,38,436,224,212
050,39,117,"Ohio","Morrow County",1,39,454,245,209
050,39,117,"Ohio","Morrow County",1,40,414,217,197
050,39,117,"Ohio","Morrow County",1,41,453,234,219
050,39,117,"Ohio","Morrow County",1,42,436,220,216
050,39,117,"Ohio","Morrow County",1,43,450,234,216
050,39,117,"Ohio","Morrow County",1,44,424,216,208
050,39,117,"Ohio","Morrow County",1,45,416,211,205
050,39,117,"Ohio","Morrow County",1,46,448,231,217
050,39,117,"Ohio","Morrow County",1,47,471,237,234
050,39,117,"Ohio","Morrow County",1,48,520,265,255
050,39,117,"Ohio","Morrow County",1,49,554,286,268
050,39,117,"Ohio","Morrow County",1,50,519,281,238
050,39,117,"Ohio","Morrow County",1,51,480,247,233
050,39,117,"Ohio","Morrow County",1,52,489,251,238
050,39,117,"Ohio","Morrow County",1,53,479,239,240
050,39,117,"Ohio","Morrow County",1,54,492,255,237
050,39,117,"Ohio","Morrow County",1,55,510,269,241
050,39,117,"Ohio","Morrow County",1,56,548,297,251
050,39,117,"Ohio","Morrow County",1,57,537,279,258
050,39,117,"Ohio","Morrow County",1,58,527,265,262
050,39,117,"Ohio","Morrow County",1,59,565,277,288
050,39,117,"Ohio","Morrow County",1,60,536,276,260
050,39,117,"Ohio","Morrow County",1,61,559,285,274
050,39,117,"Ohio","Morrow County",1,62,553,267,286
050,39,117,"Ohio","Morrow County",1,63,536,259,277
050,39,117,"Ohio","Morrow County",1,64,495,232,263
050,39,117,"Ohio","Morrow County",1,65,510,266,244
050,39,117,"Ohio","Morrow County",1,66,459,233,226
050,39,117,"Ohio","Morrow County",1,67,426,219,207
050,39,117,"Ohio","Morrow County",1,68,410,211,199
050,39,117,"Ohio","Morrow County",1,69,374,194,180
050,39,117,"Ohio","Morrow County",1,70,352,159,193
050,39,117,"Ohio","Morrow County",1,71,356,163,193
050,39,117,"Ohio","Morrow County",1,72,344,169,175
050,39,117,"Ohio","Morrow County",1,73,346,164,182
050,39,117,"Ohio","Morrow County",1,74,229,109,120
050,39,117,"Ohio","Morrow County",1,75,234,105,129
050,39,117,"Ohio","Morrow County",1,76,235,108,127
050,39,117,"Ohio","Morrow County",1,77,235,114,121
050,39,117,"Ohio","Morrow County",1,78,202,98,104
050,39,117,"Ohio","Morrow County",1,79,181,81,100
050,39,117,"Ohio","Morrow County",1,80,155,65,90
050,39,117,"Ohio","Morrow County",1,81,151,69,82
050,39,117,"Ohio","Morrow County",1,82,160,70,90
050,39,117,"Ohio","Morrow County",1,83,121,57,64
050,39,117,"Ohio","Morrow County",1,84,118,57,61
050,39,117,"Ohio","Morrow County",1,85,611,217,394
050,39,117,"Ohio","Morrow County",2,0,372,183,189
050,39,117,"Ohio","Morrow County",2,1,376,194,182
050,39,117,"Ohio","Morrow County",2,2,389,192,197
050,39,117,"Ohio","Morrow County",2,3,384,202,182
050,39,117,"Ohio","Morrow County",2,4,391,200,191
050,39,117,"Ohio","Morrow County",2,5,389,190,199
050,39,117,"Ohio","Morrow County",2,6,390,203,187
050,39,117,"Ohio","Morrow County",2,7,396,214,182
050,39,117,"Ohio","Morrow County",2,8,411,213,198
050,39,117,"Ohio","Morrow County",2,9,429,214,215
050,39,117,"Ohio","Morrow County",2,10,448,229,219
050,39,117,"Ohio","Morrow County",2,11,450,250,200
050,39,117,"Ohio","Morrow County",2,12,484,265,219
050,39,117,"Ohio","Morrow County",2,13,490,249,241
050,39,117,"Ohio","Morrow County",2,14,497,255,242
050,39,117,"Ohio","Morrow County",2,15,514,255,259
050,39,117,"Ohio","Morrow County",2,16,519,259,260
050,39,117,"Ohio","Morrow County",2,17,518,256,262
050,39,117,"Ohio","Morrow County",2,18,428,222,206
050,39,117,"Ohio","Morrow County",2,19,325,175,150
050,39,117,"Ohio","Morrow County",2,20,342,187,155
050,39,117,"Ohio","Morrow County",2,21,352,196,156
050,39,117,"Ohio","Morrow County",2,22,355,189,166
050,39,117,"Ohio","Morrow County",2,23,366,195,171
050,39,117,"Ohio","Morrow County",2,24,354,194,160
050,39,117,"Ohio","Morrow County",2,25,344,184,160
050,39,117,"Ohio","Morrow County",2,26,356,195,161
050,39,117,"Ohio","Morrow County",2,27,391,204,187
050,39,117,"Ohio","Morrow County",2,28,402,199,203
050,39,117,"Ohio","Morrow County",2,29,397,195,202
050,39,117,"Ohio","Morrow County",2,30,410,200,210
050,39,117,"Ohio","Morrow County",2,31,413,198,215
050,39,117,"Ohio","Morrow County",2,32,393,200,193
050,39,117,"Ohio","Morrow County",2,33,378,198,180
050,39,117,"Ohio","Morrow County",2,34,383,185,198
050,39,117,"Ohio","Morrow County",2,35,384,186,198
050,39,117,"Ohio","Morrow County",2,36,395,198,197
050,39,117,"Ohio","Morrow County",2,37,414,207,207
050,39,117,"Ohio","Morrow County",2,38,436,222,214
050,39,117,"Ohio","Morrow County",2,39,446,240,206
050,39,117,"Ohio","Morrow County",2,40,426,224,202
050,39,117,"Ohio","Morrow County",2,41,439,227,212
050,39,117,"Ohio","Morrow County",2,42,441,224,217
050,39,117,"Ohio","Morrow County",2,43,452,233,219
050,39,117,"Ohio","Morrow County",2,44,424,216,208
050,39,117,"Ohio","Morrow County",2,45,422,216,206
050,39,117,"Ohio","Morrow County",2,46,441,229,212
050,39,117,"Ohio","Morrow County",2,47,464,235,229
050,39,117,"Ohio","Morrow County",2,48,509,258,251
050,39,117,"Ohio","Morrow County",2,49,548,283,265
050,39,117,"Ohio","Morrow County",2,50,526,282,244
050,39,117,"Ohio","Morrow County",2,51,489,255,234
050,39,117,"Ohio","Morrow County",2,52,482,248,234
050,39,117,"Ohio","Morrow County",2,53,479,241,238
050,39,117,"Ohio","Morrow County",2,54,488,252,236
050,39,117,"Ohio","Morrow County",2,55,508,267,241
050,39,117,"Ohio","Morrow County",2,56,544,293,251
050,39,117,"Ohio","Morrow County",2,57,538,282,256
050,39,117,"Ohio","Morrow County",2,58,530,269,261
050,39,117,"Ohio","Morrow County",2,59,557,275,282
050,39,117,"Ohio","Morrow County",2,60,540,275,265
050,39,117,"Ohio","Morrow County",2,61,548,279,269
050,39,117,"Ohio","Morrow County",2,62,555,271,284
050,39,117,"Ohio","Morrow County",2,63,547,264,283
050,39,117,"Ohio","Morrow County",2,64,498,235,263
050,39,117,"Ohio","Morrow County",2,65,508,258,250
050,39,117,"Ohio","Morrow County",2,66,470,239,231
050,39,117,"Ohio","Morrow County",2,67,437,222,215
050,39,117,"Ohio","Morrow County",2,68,408,210,198
050,39,117,"Ohio","Morrow County",2,69,386,199,187
050,39,117,"Ohio","Morrow County",2,70,354,165,189
050,39,117,"Ohio","Morrow County",2,71,354,160,194
050,39,117,"Ohio","Morrow County",2,72,337,161,176
050,39,117,"Ohio","Morrow County",2,73,360,173,187
050,39,117,"Ohio","Morrow County",2,74,239,114,125
050,39,117,"Ohio","Morrow County",2,75,231,105,126
050,39,117,"Ohio","Morrow County",2,76,231,105,126
050,39,117,"Ohio","Morrow County",2,77,240,114,126
050,39,117,"Ohio","Morrow County",2,78,203,98,105
050,39,117,"Ohio","Morrow County",2,79,183,82,101
050,39,117,"Ohio","Morrow County",2,80,161,68,93
050,39,117,"Ohio","Morrow County",2,81,150,69,81
050,39,117,"Ohio","Morrow County",2,82,159,69,90
050,39,117,"Ohio","Morrow County",2,83,124,58,66
050,39,117,"Ohio","Morrow County",2,84,119,58,61
050,39,117,"Ohio","Morrow County",2,85,620,224,396
050,39,117,"Ohio","Morrow County",3,0,364,190,174
050,39,117,"Ohio","Morrow County",3,1,393,194,199
050,39,117,"Ohio","Morrow County",3,2,394,204,190
050,39,117,"Ohio","Morrow County",3,3,403,206,197
050,39,117,"Ohio","Morrow County",3,4,398,204,194
050,39,117,"Ohio","Morrow County",3,5,386,205,181
050,39,117,"Ohio","Morrow County",3,6,397,182,215
050,39,117,"Ohio","Morrow County",3,7,397,215,182
050,39,117,"Ohio","Morrow County",3,8,410,206,204
050,39,117,"Ohio","Morrow County",3,9,402,213,189
050,39,117,"Ohio","Morrow County",3,10,432,215,217
050,39,117,"Ohio","Morrow County",3,11,437,223,214
050,39,117,"Ohio","Morrow County",3,12,461,264,197
050,39,117,"Ohio","Morrow County",3,13,463,249,214
050,39,117,"Ohio","Morrow County",3,14,500,250,250
050,39,117,"Ohio","Morrow County",3,15,496,253,243
050,39,117,"Ohio","Morrow County",3,16,509,250,259
050,39,117,"Ohio","Morrow County",3,17,522,269,253
050,39,117,"Ohio","Morrow County",3,18,444,225,219
050,39,117,"Ohio","Morrow County",3,19,333,171,162
050,39,117,"Ohio","Morrow County",3,20,327,172,155
050,39,117,"Ohio","Morrow County",3,21,357,194,163
050,39,117,"Ohio","Morrow County",3,22,386,209,177
050,39,117,"Ohio","Morrow County",3,23,338,174,164
050,39,117,"Ohio","Morrow County",3,24,361,212,149
050,39,117,"Ohio","Morrow County",3,25,386,207,179
050,39,117,"Ohio","Morrow County",3,26,353,190,163
050,39,117,"Ohio","Morrow County",3,27,363,192,171
050,39,117,"Ohio","Morrow County",3,28,427,220,207
050,39,117,"Ohio","Morrow County",3,29,411,206,205
050,39,117,"Ohio","Morrow County",3,30,408,197,211
050,39,117,"Ohio","Morrow County",3,31,427,207,220
050,39,117,"Ohio","Morrow County",3,32,428,205,223
050,39,117,"Ohio","Morrow County",3,33,409,211,198
050,39,117,"Ohio","Morrow County",3,34,378,198,180
050,39,117,"Ohio","Morrow County",3,35,397,194,203
050,39,117,"Ohio","Morrow County",3,36,387,193,194
050,39,117,"Ohio","Morrow County",3,37,392,198,194
050,39,117,"Ohio","Morrow County",3,38,418,207,211
050,39,117,"Ohio","Morrow County",3,39,452,232,220
050,39,117,"Ohio","Morrow County",3,40,441,232,209
050,39,117,"Ohio","Morrow County",3,41,425,223,202
050,39,117,"Ohio","Morrow County",3,42,440,232,208
050,39,117,"Ohio","Morrow County",3,43,451,230,221
050,39,117,"Ohio","Morrow County",3,44,461,234,227
050,39,117,"Ohio","Morrow County",3,45,440,230,210
050,39,117,"Ohio","Morrow County",3,46,430,218,212
050,39,117,"Ohio","Morrow County",3,47,450,230,220
050,39,117,"Ohio","Morrow County",3,48,464,234,230
050,39,117,"Ohio","Morrow County",3,49,519,263,256
050,39,117,"Ohio","Morrow County",3,50,555,276,279
050,39,117,"Ohio","Morrow County",3,51,522,273,249
050,39,117,"Ohio","Morrow County",3,52,490,255,235
050,39,117,"Ohio","Morrow County",3,53,482,252,230
050,39,117,"Ohio","Morrow County",3,54,477,242,235
050,39,117,"Ohio","Morrow County",3,55,487,249,238
050,39,117,"Ohio","Morrow County",3,56,507,264,243
050,39,117,"Ohio","Morrow County",3,57,549,295,254
050,39,117,"Ohio","Morrow County",3,58,551,292,259
050,39,117,"Ohio","Morrow County",3,59,533,269,264
050,39,117,"Ohio","Morrow County",3,60,545,267,278
050,39,117,"Ohio","Morrow County",3,61,537,269,268
050,39,117,"Ohio","Morrow County",3,62,543,270,273
050,39,117,"Ohio","Morrow County",3,63,549,268,281
050,39,117,"Ohio","Morrow County",3,64,534,256,278
050,39,117,"Ohio","Morrow County",3,65,500,235,265
050,39,117,"Ohio","Morrow County",3,66,494,254,240
050,39,117,"Ohio","Morrow County",3,67,468,236,232
050,39,117,"Ohio","Morrow County",3,68,432,217,215
050,39,117,"Ohio","Morrow County",3,69,395,204,191
050,39,117,"Ohio","Morrow County",3,70,381,194,187
050,39,117,"Ohio","Morrow County",3,71,346,163,183
050,39,117,"Ohio","Morrow County",3,72,338,149,189
050,39,117,"Ohio","Morrow County",3,73,334,160,174
050,39,117,"Ohio","Morrow County",3,74,350,166,184
050,39,117,"Ohio","Morrow County",3,75,228,106,122
050,39,117,"Ohio","Morrow County",3,76,221,99,122
050,39,117,"Ohio","Morrow County",3,77,220,99,121
050,39,117,"Ohio","Morrow County",3,78,221,104,117
050,39,117,"Ohio","Morrow County",3,79,189,92,97
050,39,117,"Ohio","Morrow County",3,80,171,72,99
050,39,117,"Ohio","Morrow County",3,81,146,60,86
050,39,117,"Ohio","Morrow County",3,82,140,60,80
050,39,117,"Ohio","Morrow County",3,83,137,58,79
050,39,117,"Ohio","Morrow County",3,84,116,50,66
050,39,117,"Ohio","Morrow County",3,85,650,251,399
050,39,117,"Ohio","Morrow County",4,0,375,195,180
050,39,117,"Ohio","Morrow County",4,1,361,185,176
050,39,117,"Ohio","Morrow County",4,2,405,200,205
050,39,117,"Ohio","Morrow County",4,3,395,196,199
050,39,117,"Ohio","Morrow County",4,4,422,226,196
050,39,117,"Ohio","Morrow County",4,5,405,212,193
050,39,117,"Ohio","Morrow County",4,6,380,198,182
050,39,117,"Ohio","Morrow County",4,7,392,188,204
050,39,117,"Ohio","Morrow County",4,8,391,215,176
050,39,117,"Ohio","Morrow County",4,9,417,212,205
050,39,117,"Ohio","Morrow County",4,10,417,224,193
050,39,117,"Ohio","Morrow County",4,11,435,219,216
050,39,117,"Ohio","Morrow County",4,12,449,227,222
050,39,117,"Ohio","Morrow County",4,13,468,267,201
050,39,117,"Ohio","Morrow County",4,14,482,257,225
050,39,117,"Ohio","Morrow County",4,15,505,246,259
050,39,117,"Ohio","Morrow County",4,16,502,262,240
050,39,117,"Ohio","Morrow County",4,17,504,251,253
050,39,117,"Ohio","Morrow County",4,18,426,228,198
050,39,117,"Ohio","Morrow County",4,19,320,161,159
050,39,117,"Ohio","Morrow County",4,20,338,170,168
050,39,117,"Ohio","Morrow County",4,21,333,175,158
050,39,117,"Ohio","Morrow County",4,22,341,180,161
050,39,117,"Ohio","Morrow County",4,23,391,205,186
050,39,117,"Ohio","Morrow County",4,24,323,166,157
050,39,117,"Ohio","Morrow County",4,25,353,205,148
050,39,117,"Ohio","Morrow County",4,26,372,192,180
050,39,117,"Ohio","Morrow County",4,27,351,182,169
050,39,117,"Ohio","Morrow County",4,28,367,188,179
050,39,117,"Ohio","Morrow County",4,29,432,228,204
050,39,117,"Ohio","Morrow County",4,30,418,219,199
050,39,117,"Ohio","Morrow County",4,31,417,205,212
050,39,117,"Ohio","Morrow County",4,32,429,205,224
050,39,117,"Ohio","Morrow County",4,33,439,210,229
050,39,117,"Ohio","Morrow County",4,34,421,223,198
050,39,117,"Ohio","Morrow County",4,35,395,207,188
050,39,117,"Ohio","Morrow County",4,36,418,208,210
050,39,117,"Ohio","Morrow County",4,37,417,207,210
050,39,117,"Ohio","Morrow County",4,38,408,212,196
050,39,117,"Ohio","Morrow County",4,39,432,205,227
050,39,117,"Ohio","Morrow County",4,40,460,233,227
050,39,117,"Ohio","Morrow County",4,41,445,229,216
050,39,117,"Ohio","Morrow County",4,42,433,229,204
050,39,117,"Ohio","Morrow County",4,43,450,241,209
050,39,117,"Ohio","Morrow County",4,44,458,228,230
050,39,117,"Ohio","Morrow County",4,45,461,231,230
050,39,117,"Ohio","Morrow County",4,46,434,232,202
050,39,117,"Ohio","Morrow County",4,47,437,226,211
050,39,117,"Ohio","Morrow County",4,48,456,235,221
050,39,117,"Ohio","Morrow County",4,49,467,238,229
050,39,117,"Ohio","Morrow County",4,50,508,262,246
050,39,117,"Ohio","Morrow County",4,51,564,279,285
050,39,117,"Ohio","Morrow County",4,52,531,274,257
050,39,117,"Ohio","Morrow County",4,53,490,262,228
050,39,117,"Ohio","Morrow County",4,54,484,252,232
050,39,117,"Ohio","Morrow County",4,55,494,250,244
050,39,117,"Ohio","Morrow County",4,56,500,258,242
050,39,117,"Ohio","Morrow County",4,57,513,268,245
050,39,117,"Ohio","Morrow County",4,58,553,296,257
050,39,117,"Ohio","Morrow County",4,59,538,283,255
050,39,117,"Ohio","Morrow County",4,60,522,266,256
050,39,117,"Ohio","Morrow County",4,61,544,269,275
050,39,117,"Ohio","Morrow County",4,62,524,262,262
050,39,117,"Ohio","Morrow County",4,63,542,272,270
050,39,117,"Ohio","Morrow County",4,64,560,276,284
050,39,117,"Ohio","Morrow County",4,65,535,253,282
050,39,117,"Ohio","Morrow County",4,66,498,229,269
050,39,117,"Ohio","Morrow County",4,67,480,245,235
050,39,117,"Ohio","Morrow County",4,68,465,230,235
050,39,117,"Ohio","Morrow County",4,69,424,212,212
050,39,117,"Ohio","Morrow County",4,70,388,201,187
050,39,117,"Ohio","Morrow County",4,71,378,193,185
050,39,117,"Ohio","Morrow County",4,72,331,150,181
050,39,117,"Ohio","Morrow County",4,73,326,142,184
050,39,117,"Ohio","Morrow County",4,74,321,155,166
050,39,117,"Ohio","Morrow County",4,75,336,155,181
050,39,117,"Ohio","Morrow County",4,76,205,95,110
050,39,117,"Ohio","Morrow County",4,77,212,92,120
050,39,117,"Ohio","Morrow County",4,78,210,94,116
050,39,117,"Ohio","Morrow County",4,79,220,102,118
050,39,117,"Ohio","Morrow County",4,80,179,82,97
050,39,117,"Ohio","Morrow County",4,81,157,70,87
050,39,117,"Ohio","Morrow County",4,82,136,51,85
050,39,117,"Ohio","Morrow County",4,83,122,51,71
050,39,117,"Ohio","Morrow County",4,84,125,49,76
050,39,117,"Ohio","Morrow County",4,85,674,266,408
050,39,117,"Ohio","Morrow County",5,0,370,195,175
050,39,117,"Ohio","Morrow County",5,1,379,184,195
050,39,117,"Ohio","Morrow County",5,2,376,187,189
050,39,117,"Ohio","Morrow County",5,3,408,196,212
050,39,117,"Ohio","Morrow County",5,4,404,191,213
050,39,117,"Ohio","Morrow County",5,5,438,239,199
050,39,117,"Ohio","Morrow County",5,6,413,219,194
050,39,117,"Ohio","Morrow County",5,7,393,199,194
050,39,117,"Ohio","Morrow County",5,8,415,197,218
050,39,117,"Ohio","Morrow County",5,9,413,227,186
050,39,117,"Ohio","Morrow County",5,10,425,211,214
050,39,117,"Ohio","Morrow County",5,11,437,235,202
050,39,117,"Ohio","Morrow County",5,12,436,221,215
050,39,117,"Ohio","Morrow County",5,13,448,230,218
050,39,117,"Ohio","Morrow County",5,14,467,256,211
050,39,117,"Ohio","Morrow County",5,15,489,265,224
050,39,117,"Ohio","Morrow County",5,16,507,249,258
050,39,117,"Ohio","Morrow County",5,17,483,251,232
050,39,117,"Ohio","Morrow County",5,18,416,212,204
050,39,117,"Ohio","Morrow County",5,19,315,162,153
050,39,117,"Ohio","Morrow County",5,20,342,173,169
050,39,117,"Ohio","Morrow County",5,21,356,180,176
050,39,117,"Ohio","Morrow County",5,22,371,191,180
050,39,117,"Ohio","Morrow County",5,23,340,174,166
050,39,117,"Ohio","Morrow County",5,24,386,208,178
050,39,117,"Ohio","Morrow County",5,25,323,169,154
050,39,117,"Ohio","Morrow County",5,26,380,219,161
050,39,117,"Ohio","Morrow County",5,27,372,191,181
050,39,117,"Ohio","Morrow County",5,28,378,193,185
050,39,117,"Ohio","Morrow County",5,29,381,205,176
050,39,117,"Ohio","Morrow County",5,30,436,226,210
050,39,117,"Ohio","Morrow County",5,31,413,212,201
050,39,117,"Ohio","Morrow County",5,32,415,206,209
050,39,117,"Ohio","Morrow County",5,33,456,217,239
050,39,117,"Ohio","Morrow County",5,34,438,203,235
050,39,117,"Ohio","Morrow County",5,35,435,229,206
050,39,117,"Ohio","Morrow County",5,36,401,211,190
050,39,117,"Ohio","Morrow County",5,37,433,213,220
050,39,117,"Ohio","Morrow County",5,38,415,206,209
050,39,117,"Ohio","Morrow County",5,39,422,229,193
050,39,117,"Ohio","Morrow County",5,40,434,215,219
050,39,117,"Ohio","Morrow County",5,41,445,221,224
050,39,117,"Ohio","Morrow County",5,42,455,239,216
050,39,117,"Ohio","Morrow County",5,43,440,238,202
050,39,117,"Ohio","Morrow County",5,44,455,238,217
050,39,117,"Ohio","Morrow County",5,45,460,229,231
050,39,117,"Ohio","Morrow County",5,46,472,234,238
050,39,117,"Ohio","Morrow County",5,47,435,232,203
050,39,117,"Ohio","Morrow County",5,48,438,227,211
050,39,117,"Ohio","Morrow County",5,49,465,241,224
050,39,117,"Ohio","Morrow County",5,50,466,227,239
050,39,117,"Ohio","Morrow County",5,51,507,257,250
050,39,117,"Ohio","Morrow County",5,52,587,293,294
050,39,117,"Ohio","Morrow County",5,53,535,280,255
050,39,117,"Ohio","Morrow County",5,54,506,277,229
050,39,117,"Ohio","Morrow County",5,55,490,253,237
050,39,117,"Ohio","Morrow County",5,56,498,250,248
050,39,117,"Ohio","Morrow County",5,57,490,250,240
050,39,117,"Ohio","Morrow County",5,58,506,271,235
050,39,117,"Ohio","Morrow County",5,59,553,296,257
050,39,117,"Ohio","Morrow County",5,60,540,285,255
050,39,117,"Ohio","Morrow County",5,61,526,268,258
050,39,117,"Ohio","Morrow County",5,62,537,269,268
050,39,117,"Ohio","Morrow County",5,63,532,259,273
050,39,117,"Ohio","Morrow County",5,64,539,271,268
050,39,117,"Ohio","Morrow County",5,65,560,278,282
050,39,117,"Ohio","Morrow County",5,66,526,249,277
050,39,117,"Ohio","Morrow County",5,67,479,216,263
050,39,117,"Ohio","Morrow County",5,68,471,239,232
050,39,117,"Ohio","Morrow County",5,69,448,220,228
050,39,117,"Ohio","Morrow County",5,70,413,207,206
050,39,117,"Ohio","Morrow County",5,71,378,198,180
050,39,117,"Ohio","Morrow County",5,72,367,184,183
050,39,117,"Ohio","Morrow County",5,73,320,143,177
050,39,117,"Ohio","Morrow County",5,74,306,131,175
050,39,117,"Ohio","Morrow County",5,75,309,148,161
050,39,117,"Ohio","Morrow County",5,76,311,140,171
050,39,117,"Ohio","Morrow County",5,77,197,90,107
050,39,117,"Ohio","Morrow County",5,78,200,90,110
050,39,117,"Ohio","Morrow County",5,79,207,93,114
050,39,117,"Ohio","Morrow County",5,80,207,93,114
050,39,117,"Ohio","Morrow County",5,81,163,76,87
050,39,117,"Ohio","Morrow County",5,82,150,63,87
050,39,117,"Ohio","Morrow County",5,83,116,42,74
050,39,117,"Ohio","Morrow County",5,84,114,43,71
050,39,117,"Ohio","Morrow County",5,85,717,280,437
050,39,119,"Ohio","Muskingum County",1,0,968,498,470
050,39,119,"Ohio","Muskingum County",1,1,1027,519,508
050,39,119,"Ohio","Muskingum County",1,2,1037,501,536
050,39,119,"Ohio","Muskingum County",1,3,1026,524,502
050,39,119,"Ohio","Muskingum County",1,4,1070,553,517
050,39,119,"Ohio","Muskingum County",1,5,1107,580,527
050,39,119,"Ohio","Muskingum County",1,6,1042,547,495
050,39,119,"Ohio","Muskingum County",1,7,1085,536,549
050,39,119,"Ohio","Muskingum County",1,8,1073,551,522
050,39,119,"Ohio","Muskingum County",1,9,1110,573,537
050,39,119,"Ohio","Muskingum County",1,10,1137,592,545
050,39,119,"Ohio","Muskingum County",1,11,1136,590,546
050,39,119,"Ohio","Muskingum County",1,12,1187,622,565
050,39,119,"Ohio","Muskingum County",1,13,1148,584,564
050,39,119,"Ohio","Muskingum County",1,14,1111,558,553
050,39,119,"Ohio","Muskingum County",1,15,1147,585,562
050,39,119,"Ohio","Muskingum County",1,16,1138,574,564
050,39,119,"Ohio","Muskingum County",1,17,1121,549,572
050,39,119,"Ohio","Muskingum County",1,18,1001,542,459
050,39,119,"Ohio","Muskingum County",1,19,948,499,449
050,39,119,"Ohio","Muskingum County",1,20,1102,552,550
050,39,119,"Ohio","Muskingum County",1,21,1217,616,601
050,39,119,"Ohio","Muskingum County",1,22,1176,590,586
050,39,119,"Ohio","Muskingum County",1,23,1098,555,543
050,39,119,"Ohio","Muskingum County",1,24,1101,561,540
050,39,119,"Ohio","Muskingum County",1,25,1151,555,596
050,39,119,"Ohio","Muskingum County",1,26,1076,540,536
050,39,119,"Ohio","Muskingum County",1,27,1081,570,511
050,39,119,"Ohio","Muskingum County",1,28,1141,570,571
050,39,119,"Ohio","Muskingum County",1,29,1135,548,587
050,39,119,"Ohio","Muskingum County",1,30,1094,535,559
050,39,119,"Ohio","Muskingum County",1,31,986,487,499
050,39,119,"Ohio","Muskingum County",1,32,982,494,488
050,39,119,"Ohio","Muskingum County",1,33,997,484,513
050,39,119,"Ohio","Muskingum County",1,34,962,471,491
050,39,119,"Ohio","Muskingum County",1,35,991,482,509
050,39,119,"Ohio","Muskingum County",1,36,1024,490,534
050,39,119,"Ohio","Muskingum County",1,37,1031,514,517
050,39,119,"Ohio","Muskingum County",1,38,1044,534,510
050,39,119,"Ohio","Muskingum County",1,39,1071,541,530
050,39,119,"Ohio","Muskingum County",1,40,1046,516,530
050,39,119,"Ohio","Muskingum County",1,41,1021,505,516
050,39,119,"Ohio","Muskingum County",1,42,995,481,514
050,39,119,"Ohio","Muskingum County",1,43,967,475,492
050,39,119,"Ohio","Muskingum County",1,44,944,459,485
050,39,119,"Ohio","Muskingum County",1,45,1001,503,498
050,39,119,"Ohio","Muskingum County",1,46,968,471,497
050,39,119,"Ohio","Muskingum County",1,47,1028,496,532
050,39,119,"Ohio","Muskingum County",1,48,1147,560,587
050,39,119,"Ohio","Muskingum County",1,49,1159,567,592
050,39,119,"Ohio","Muskingum County",1,50,1126,552,574
050,39,119,"Ohio","Muskingum County",1,51,1114,560,554
050,39,119,"Ohio","Muskingum County",1,52,1115,578,537
050,39,119,"Ohio","Muskingum County",1,53,1133,587,546
050,39,119,"Ohio","Muskingum County",1,54,1168,604,564
050,39,119,"Ohio","Muskingum County",1,55,1161,573,588
050,39,119,"Ohio","Muskingum County",1,56,1139,565,574
050,39,119,"Ohio","Muskingum County",1,57,1182,574,608
050,39,119,"Ohio","Muskingum County",1,58,1250,598,652
050,39,119,"Ohio","Muskingum County",1,59,1218,561,657
050,39,119,"Ohio","Muskingum County",1,60,1211,587,624
050,39,119,"Ohio","Muskingum County",1,61,1243,625,618
050,39,119,"Ohio","Muskingum County",1,62,1260,622,638
050,39,119,"Ohio","Muskingum County",1,63,1210,590,620
050,39,119,"Ohio","Muskingum County",1,64,1150,554,596
050,39,119,"Ohio","Muskingum County",1,65,1107,552,555
050,39,119,"Ohio","Muskingum County",1,66,1074,522,552
050,39,119,"Ohio","Muskingum County",1,67,1026,486,540
050,39,119,"Ohio","Muskingum County",1,68,985,470,515
050,39,119,"Ohio","Muskingum County",1,69,898,405,493
050,39,119,"Ohio","Muskingum County",1,70,896,407,489
050,39,119,"Ohio","Muskingum County",1,71,902,428,474
050,39,119,"Ohio","Muskingum County",1,72,863,390,473
050,39,119,"Ohio","Muskingum County",1,73,833,390,443
050,39,119,"Ohio","Muskingum County",1,74,572,256,316
050,39,119,"Ohio","Muskingum County",1,75,604,266,338
050,39,119,"Ohio","Muskingum County",1,76,546,240,306
050,39,119,"Ohio","Muskingum County",1,77,580,253,327
050,39,119,"Ohio","Muskingum County",1,78,543,226,317
050,39,119,"Ohio","Muskingum County",1,79,471,213,258
050,39,119,"Ohio","Muskingum County",1,80,417,193,224
050,39,119,"Ohio","Muskingum County",1,81,408,163,245
050,39,119,"Ohio","Muskingum County",1,82,366,152,214
050,39,119,"Ohio","Muskingum County",1,83,303,120,183
050,39,119,"Ohio","Muskingum County",1,84,292,112,180
050,39,119,"Ohio","Muskingum County",1,85,1700,567,1133
050,39,119,"Ohio","Muskingum County",2,0,998,513,485
050,39,119,"Ohio","Muskingum County",2,1,1008,512,496
050,39,119,"Ohio","Muskingum County",2,2,1037,508,529
050,39,119,"Ohio","Muskingum County",2,3,1029,519,510
050,39,119,"Ohio","Muskingum County",2,4,1063,550,513
050,39,119,"Ohio","Muskingum County",2,5,1097,574,523
050,39,119,"Ohio","Muskingum County",2,6,1062,556,506
050,39,119,"Ohio","Muskingum County",2,7,1073,537,536
050,39,119,"Ohio","Muskingum County",2,8,1076,549,527
050,39,119,"Ohio","Muskingum County",2,9,1100,567,533
050,39,119,"Ohio","Muskingum County",2,10,1129,588,541
050,39,119,"Ohio","Muskingum County",2,11,1135,592,543
050,39,119,"Ohio","Muskingum County",2,12,1178,616,562
050,39,119,"Ohio","Muskingum County",2,13,1156,592,564
050,39,119,"Ohio","Muskingum County",2,14,1123,566,557
050,39,119,"Ohio","Muskingum County",2,15,1135,578,557
050,39,119,"Ohio","Muskingum County",2,16,1144,578,566
050,39,119,"Ohio","Muskingum County",2,17,1125,555,570
050,39,119,"Ohio","Muskingum County",2,18,989,527,462
050,39,119,"Ohio","Muskingum County",2,19,948,494,454
050,39,119,"Ohio","Muskingum County",2,20,1107,563,544
050,39,119,"Ohio","Muskingum County",2,21,1204,612,592
050,39,119,"Ohio","Muskingum County",2,22,1178,590,588
050,39,119,"Ohio","Muskingum County",2,23,1110,557,553
050,39,119,"Ohio","Muskingum County",2,24,1099,557,542
050,39,119,"Ohio","Muskingum County",2,25,1141,557,584
050,39,119,"Ohio","Muskingum County",2,26,1096,549,547
050,39,119,"Ohio","Muskingum County",2,27,1077,561,516
050,39,119,"Ohio","Muskingum County",2,28,1127,567,560
050,39,119,"Ohio","Muskingum County",2,29,1135,552,583
050,39,119,"Ohio","Muskingum County",2,30,1106,541,565
050,39,119,"Ohio","Muskingum County",2,31,1009,495,514
050,39,119,"Ohio","Muskingum County",2,32,979,490,489
050,39,119,"Ohio","Muskingum County",2,33,994,487,507
050,39,119,"Ohio","Muskingum County",2,34,973,476,497
050,39,119,"Ohio","Muskingum County",2,35,992,484,508
050,39,119,"Ohio","Muskingum County",2,36,1012,485,527
050,39,119,"Ohio","Muskingum County",2,37,1031,509,522
050,39,119,"Ohio","Muskingum County",2,38,1047,532,515
050,39,119,"Ohio","Muskingum County",2,39,1063,537,526
050,39,119,"Ohio","Muskingum County",2,40,1059,527,532
050,39,119,"Ohio","Muskingum County",2,41,1025,506,519
050,39,119,"Ohio","Muskingum County",2,42,999,484,515
050,39,119,"Ohio","Muskingum County",2,43,976,477,499
050,39,119,"Ohio","Muskingum County",2,44,941,459,482
050,39,119,"Ohio","Muskingum County",2,45,990,493,497
050,39,119,"Ohio","Muskingum County",2,46,973,477,496
050,39,119,"Ohio","Muskingum County",2,47,1012,488,524
050,39,119,"Ohio","Muskingum County",2,48,1116,543,573
050,39,119,"Ohio","Muskingum County",2,49,1168,572,596
050,39,119,"Ohio","Muskingum County",2,50,1138,558,580
050,39,119,"Ohio","Muskingum County",2,51,1112,555,557
050,39,119,"Ohio","Muskingum County",2,52,1113,574,539
050,39,119,"Ohio","Muskingum County",2,53,1128,585,543
050,39,119,"Ohio","Muskingum County",2,54,1154,598,556
050,39,119,"Ohio","Muskingum County",2,55,1157,578,579
050,39,119,"Ohio","Muskingum County",2,56,1149,567,582
050,39,119,"Ohio","Muskingum County",2,57,1178,576,602
050,39,119,"Ohio","Muskingum County",2,58,1230,589,641
050,39,119,"Ohio","Muskingum County",2,59,1227,569,658
050,39,119,"Ohio","Muskingum County",2,60,1210,579,631
050,39,119,"Ohio","Muskingum County",2,61,1223,610,613
050,39,119,"Ohio","Muskingum County",2,62,1254,622,632
050,39,119,"Ohio","Muskingum County",2,63,1233,603,630
050,39,119,"Ohio","Muskingum County",2,64,1161,561,600
050,39,119,"Ohio","Muskingum County",2,65,1111,549,562
050,39,119,"Ohio","Muskingum County",2,66,1077,526,551
050,39,119,"Ohio","Muskingum County",2,67,1030,491,539
050,39,119,"Ohio","Muskingum County",2,68,982,468,514
050,39,119,"Ohio","Muskingum County",2,69,920,421,499
050,39,119,"Ohio","Muskingum County",2,70,888,403,485
050,39,119,"Ohio","Muskingum County",2,71,897,418,479
050,39,119,"Ohio","Muskingum County",2,72,858,393,465
050,39,119,"Ohio","Muskingum County",2,73,871,407,464
050,39,119,"Ohio","Muskingum County",2,74,592,269,323
050,39,119,"Ohio","Muskingum County",2,75,596,263,333
050,39,119,"Ohio","Muskingum County",2,76,551,242,309
050,39,119,"Ohio","Muskingum County",2,77,579,253,326
050,39,119,"Ohio","Muskingum County",2,78,533,224,309
050,39,119,"Ohio","Muskingum County",2,79,484,213,271
050,39,119,"Ohio","Muskingum County",2,80,425,195,230
050,39,119,"Ohio","Muskingum County",2,81,396,163,233
050,39,119,"Ohio","Muskingum County",2,82,372,151,221
050,39,119,"Ohio","Muskingum County",2,83,310,124,186
050,39,119,"Ohio","Muskingum County",2,84,283,108,175
050,39,119,"Ohio","Muskingum County",2,85,1702,569,1133
050,39,119,"Ohio","Muskingum County",3,0,987,488,499
050,39,119,"Ohio","Muskingum County",3,1,1013,518,495
050,39,119,"Ohio","Muskingum County",3,2,1034,523,511
050,39,119,"Ohio","Muskingum County",3,3,1061,515,546
050,39,119,"Ohio","Muskingum County",3,4,1051,539,512
050,39,119,"Ohio","Muskingum County",3,5,1093,566,527
050,39,119,"Ohio","Muskingum County",3,6,1107,584,523
050,39,119,"Ohio","Muskingum County",3,7,1086,578,508
050,39,119,"Ohio","Muskingum County",3,8,1074,529,545
050,39,119,"Ohio","Muskingum County",3,9,1071,543,528
050,39,119,"Ohio","Muskingum County",3,10,1118,577,541
050,39,119,"Ohio","Muskingum County",3,11,1133,569,564
050,39,119,"Ohio","Muskingum County",3,12,1145,596,549
050,39,119,"Ohio","Muskingum County",3,13,1178,618,560
050,39,119,"Ohio","Muskingum County",3,14,1169,600,569
050,39,119,"Ohio","Muskingum County",3,15,1132,571,561
050,39,119,"Ohio","Muskingum County",3,16,1111,567,544
050,39,119,"Ohio","Muskingum County",3,17,1133,577,556
050,39,119,"Ohio","Muskingum County",3,18,986,507,479
050,39,119,"Ohio","Muskingum County",3,19,937,467,470
050,39,119,"Ohio","Muskingum County",3,20,1084,571,513
050,39,119,"Ohio","Muskingum County",3,21,1162,613,549
050,39,119,"Ohio","Muskingum County",3,22,1160,577,583
050,39,119,"Ohio","Muskingum County",3,23,1141,570,571
050,39,119,"Ohio","Muskingum County",3,24,1091,530,561
050,39,119,"Ohio","Muskingum County",3,25,1095,559,536
050,39,119,"Ohio","Muskingum County",3,26,1156,565,591
050,39,119,"Ohio","Muskingum County",3,27,1113,556,557
050,39,119,"Ohio","Muskingum County",3,28,1083,550,533
050,39,119,"Ohio","Muskingum County",3,29,1140,581,559
050,39,119,"Ohio","Muskingum County",3,30,1125,551,574
050,39,119,"Ohio","Muskingum County",3,31,1117,543,574
050,39,119,"Ohio","Muskingum County",3,32,1044,518,526
050,39,119,"Ohio","Muskingum County",3,33,978,493,485
050,39,119,"Ohio","Muskingum County",3,34,995,485,510
050,39,119,"Ohio","Muskingum County",3,35,968,472,496
050,39,119,"Ohio","Muskingum County",3,36,998,484,514
050,39,119,"Ohio","Muskingum County",3,37,1015,486,529
050,39,119,"Ohio","Muskingum County",3,38,1028,508,520
050,39,119,"Ohio","Muskingum County",3,39,1060,528,532
050,39,119,"Ohio","Muskingum County",3,40,1077,540,537
050,39,119,"Ohio","Muskingum County",3,41,1053,520,533
050,39,119,"Ohio","Muskingum County",3,42,1009,496,513
050,39,119,"Ohio","Muskingum County",3,43,1004,487,517
050,39,119,"Ohio","Muskingum County",3,44,991,493,498
050,39,119,"Ohio","Muskingum County",3,45,932,455,477
050,39,119,"Ohio","Muskingum County",3,46,1015,509,506
050,39,119,"Ohio","Muskingum County",3,47,983,487,496
050,39,119,"Ohio","Muskingum County",3,48,997,484,513
050,39,119,"Ohio","Muskingum County",3,49,1103,540,563
050,39,119,"Ohio","Muskingum County",3,50,1165,568,597
050,39,119,"Ohio","Muskingum County",3,51,1127,545,582
050,39,119,"Ohio","Muskingum County",3,52,1095,555,540
050,39,119,"Ohio","Muskingum County",3,53,1105,569,536
050,39,119,"Ohio","Muskingum County",3,54,1112,568,544
050,39,119,"Ohio","Muskingum County",3,55,1136,579,557
050,39,119,"Ohio","Muskingum County",3,56,1146,565,581
050,39,119,"Ohio","Muskingum County",3,57,1148,569,579
050,39,119,"Ohio","Muskingum County",3,58,1173,570,603
050,39,119,"Ohio","Muskingum County",3,59,1204,578,626
050,39,119,"Ohio","Muskingum County",3,60,1233,566,667
050,39,119,"Ohio","Muskingum County",3,61,1193,572,621
050,39,119,"Ohio","Muskingum County",3,62,1208,598,610
050,39,119,"Ohio","Muskingum County",3,63,1239,609,630
050,39,119,"Ohio","Muskingum County",3,64,1206,588,618
050,39,119,"Ohio","Muskingum County",3,65,1132,551,581
050,39,119,"Ohio","Muskingum County",3,66,1086,536,550
050,39,119,"Ohio","Muskingum County",3,67,1050,505,545
050,39,119,"Ohio","Muskingum County",3,68,1014,482,532
050,39,119,"Ohio","Muskingum County",3,69,962,452,510
050,39,119,"Ohio","Muskingum County",3,70,892,404,488
050,39,119,"Ohio","Muskingum County",3,71,866,388,478
050,39,119,"Ohio","Muskingum County",3,72,883,408,475
050,39,119,"Ohio","Muskingum County",3,73,828,370,458
050,39,119,"Ohio","Muskingum County",3,74,836,394,442
050,39,119,"Ohio","Muskingum County",3,75,575,263,312
050,39,119,"Ohio","Muskingum County",3,76,569,252,317
050,39,119,"Ohio","Muskingum County",3,77,528,226,302
050,39,119,"Ohio","Muskingum County",3,78,544,231,313
050,39,119,"Ohio","Muskingum County",3,79,505,214,291
050,39,119,"Ohio","Muskingum County",3,80,464,202,262
050,39,119,"Ohio","Muskingum County",3,81,390,172,218
050,39,119,"Ohio","Muskingum County",3,82,342,138,204
050,39,119,"Ohio","Muskingum County",3,83,333,127,206
050,39,119,"Ohio","Muskingum County",3,84,284,108,176
050,39,119,"Ohio","Muskingum County",3,85,1668,552,1116
050,39,119,"Ohio","Muskingum County",4,0,976,499,477
050,39,119,"Ohio","Muskingum County",4,1,956,492,464
050,39,119,"Ohio","Muskingum County",4,2,1022,525,497
050,39,119,"Ohio","Muskingum County",4,3,1026,528,498
050,39,119,"Ohio","Muskingum County",4,4,1046,513,533
050,39,119,"Ohio","Muskingum County",4,5,1054,540,514
050,39,119,"Ohio","Muskingum County",4,6,1087,561,526
050,39,119,"Ohio","Muskingum County",4,7,1101,588,513
050,39,119,"Ohio","Muskingum County",4,8,1088,578,510
050,39,119,"Ohio","Muskingum County",4,9,1081,540,541
050,39,119,"Ohio","Muskingum County",4,10,1084,549,535
050,39,119,"Ohio","Muskingum County",4,11,1103,571,532
050,39,119,"Ohio","Muskingum County",4,12,1155,593,562
050,39,119,"Ohio","Muskingum County",4,13,1151,592,559
050,39,119,"Ohio","Muskingum County",4,14,1171,606,565
050,39,119,"Ohio","Muskingum County",4,15,1170,599,571
050,39,119,"Ohio","Muskingum County",4,16,1129,578,551
050,39,119,"Ohio","Muskingum County",4,17,1102,559,543
050,39,119,"Ohio","Muskingum County",4,18,977,514,463
050,39,119,"Ohio","Muskingum County",4,19,881,430,451
050,39,119,"Ohio","Muskingum County",4,20,1041,525,516
050,39,119,"Ohio","Muskingum County",4,21,1155,613,542
050,39,119,"Ohio","Muskingum County",4,22,1112,580,532
050,39,119,"Ohio","Muskingum County",4,23,1117,570,547
050,39,119,"Ohio","Muskingum County",4,24,1085,549,536
050,39,119,"Ohio","Muskingum County",4,25,1087,540,547
050,39,119,"Ohio","Muskingum County",4,26,1080,566,514
050,39,119,"Ohio","Muskingum County",4,27,1098,538,560
050,39,119,"Ohio","Muskingum County",4,28,1085,532,553
050,39,119,"Ohio","Muskingum County",4,29,1057,545,512
050,39,119,"Ohio","Muskingum County",4,30,1134,579,555
050,39,119,"Ohio","Muskingum County",4,31,1124,537,587
050,39,119,"Ohio","Muskingum County",4,32,1140,552,588
050,39,119,"Ohio","Muskingum County",4,33,1032,515,517
050,39,119,"Ohio","Muskingum County",4,34,994,495,499
050,39,119,"Ohio","Muskingum County",4,35,992,491,501
050,39,119,"Ohio","Muskingum County",4,36,980,476,504
050,39,119,"Ohio","Muskingum County",4,37,1003,484,519
050,39,119,"Ohio","Muskingum County",4,38,1018,489,529
050,39,119,"Ohio","Muskingum County",4,39,1036,516,520
050,39,119,"Ohio","Muskingum County",4,40,1049,531,518
050,39,119,"Ohio","Muskingum County",4,41,1067,535,532
050,39,119,"Ohio","Muskingum County",4,42,1042,515,527
050,39,119,"Ohio","Muskingum County",4,43,987,488,499
050,39,119,"Ohio","Muskingum County",4,44,1018,497,521
050,39,119,"Ohio","Muskingum County",4,45,983,497,486
050,39,119,"Ohio","Muskingum County",4,46,928,456,472
050,39,119,"Ohio","Muskingum County",4,47,1006,505,501
050,39,119,"Ohio","Muskingum County",4,48,976,484,492
050,39,119,"Ohio","Muskingum County",4,49,995,482,513
050,39,119,"Ohio","Muskingum County",4,50,1096,539,557
050,39,119,"Ohio","Muskingum County",4,51,1176,570,606
050,39,119,"Ohio","Muskingum County",4,52,1140,551,589
050,39,119,"Ohio","Muskingum County",4,53,1081,535,546
050,39,119,"Ohio","Muskingum County",4,54,1093,562,531
050,39,119,"Ohio","Muskingum County",4,55,1110,569,541
050,39,119,"Ohio","Muskingum County",4,56,1130,575,555
050,39,119,"Ohio","Muskingum County",4,57,1153,577,576
050,39,119,"Ohio","Muskingum County",4,58,1134,554,580
050,39,119,"Ohio","Muskingum County",4,59,1157,559,598
050,39,119,"Ohio","Muskingum County",4,60,1215,584,631
050,39,119,"Ohio","Muskingum County",4,61,1211,552,659
050,39,119,"Ohio","Muskingum County",4,62,1169,558,611
050,39,119,"Ohio","Muskingum County",4,63,1203,590,613
050,39,119,"Ohio","Muskingum County",4,64,1215,594,621
050,39,119,"Ohio","Muskingum County",4,65,1183,573,610
050,39,119,"Ohio","Muskingum County",4,66,1102,537,565
050,39,119,"Ohio","Muskingum County",4,67,1058,518,540
050,39,119,"Ohio","Muskingum County",4,68,1029,487,542
050,39,119,"Ohio","Muskingum County",4,69,990,460,530
050,39,119,"Ohio","Muskingum County",4,70,934,435,499
050,39,119,"Ohio","Muskingum County",4,71,864,385,479
050,39,119,"Ohio","Muskingum County",4,72,841,373,468
050,39,119,"Ohio","Muskingum County",4,73,862,395,467
050,39,119,"Ohio","Muskingum County",4,74,787,352,435
050,39,119,"Ohio","Muskingum County",4,75,810,381,429
050,39,119,"Ohio","Muskingum County",4,76,549,251,298
050,39,119,"Ohio","Muskingum County",4,77,547,243,304
050,39,119,"Ohio","Muskingum County",4,78,491,205,286
050,39,119,"Ohio","Muskingum County",4,79,495,210,285
050,39,119,"Ohio","Muskingum County",4,80,477,201,276
050,39,119,"Ohio","Muskingum County",4,81,427,180,247
050,39,119,"Ohio","Muskingum County",4,82,341,148,193
050,39,119,"Ohio","Muskingum County",4,83,303,113,190
050,39,119,"Ohio","Muskingum County",4,84,308,114,194
050,39,119,"Ohio","Muskingum County",4,85,1652,545,1107
050,39,119,"Ohio","Muskingum County",5,0,972,494,478
050,39,119,"Ohio","Muskingum County",5,1,986,515,471
050,39,119,"Ohio","Muskingum County",5,2,951,483,468
050,39,119,"Ohio","Muskingum County",5,3,1032,531,501
050,39,119,"Ohio","Muskingum County",5,4,1011,523,488
050,39,119,"Ohio","Muskingum County",5,5,1062,519,543
050,39,119,"Ohio","Muskingum County",5,6,1069,538,531
050,39,119,"Ohio","Muskingum County",5,7,1114,587,527
050,39,119,"Ohio","Muskingum County",5,8,1115,589,526
050,39,119,"Ohio","Muskingum County",5,9,1089,587,502
050,39,119,"Ohio","Muskingum County",5,10,1083,546,537
050,39,119,"Ohio","Muskingum County",5,11,1096,552,544
050,39,119,"Ohio","Muskingum County",5,12,1109,568,541
050,39,119,"Ohio","Muskingum County",5,13,1182,594,588
050,39,119,"Ohio","Muskingum County",5,14,1137,585,552
050,39,119,"Ohio","Muskingum County",5,15,1177,607,570
050,39,119,"Ohio","Muskingum County",5,16,1192,599,593
050,39,119,"Ohio","Muskingum County",5,17,1120,573,547
050,39,119,"Ohio","Muskingum County",5,18,953,499,454
050,39,119,"Ohio","Muskingum County",5,19,898,448,450
050,39,119,"Ohio","Muskingum County",5,20,994,491,503
050,39,119,"Ohio","Muskingum County",5,21,1096,570,526
050,39,119,"Ohio","Muskingum County",5,22,1101,571,530
050,39,119,"Ohio","Muskingum County",5,23,1065,561,504
050,39,119,"Ohio","Muskingum County",5,24,1091,555,536
050,39,119,"Ohio","Muskingum County",5,25,1080,549,531
050,39,119,"Ohio","Muskingum County",5,26,1094,572,522
050,39,119,"Ohio","Muskingum County",5,27,1075,563,512
050,39,119,"Ohio","Muskingum County",5,28,1076,519,557
050,39,119,"Ohio","Muskingum County",5,29,1097,540,557
050,39,119,"Ohio","Muskingum County",5,30,1055,533,522
050,39,119,"Ohio","Muskingum County",5,31,1141,582,559
050,39,119,"Ohio","Muskingum County",5,32,1134,540,594
050,39,119,"Ohio","Muskingum County",5,33,1148,548,600
050,39,119,"Ohio","Muskingum County",5,34,1048,520,528
050,39,119,"Ohio","Muskingum County",5,35,1025,513,512
050,39,119,"Ohio","Muskingum County",5,36,997,495,502
050,39,119,"Ohio","Muskingum County",5,37,985,484,501
050,39,119,"Ohio","Muskingum County",5,38,1013,488,525
050,39,119,"Ohio","Muskingum County",5,39,1021,491,530
050,39,119,"Ohio","Muskingum County",5,40,1033,520,513
050,39,119,"Ohio","Muskingum County",5,41,1043,518,525
050,39,119,"Ohio","Muskingum County",5,42,1081,539,542
050,39,119,"Ohio","Muskingum County",5,43,1039,515,524
050,39,119,"Ohio","Muskingum County",5,44,1016,512,504
050,39,119,"Ohio","Muskingum County",5,45,1001,488,513
050,39,119,"Ohio","Muskingum County",5,46,994,500,494
050,39,119,"Ohio","Muskingum County",5,47,919,449,470
050,39,119,"Ohio","Muskingum County",5,48,1004,501,503
050,39,119,"Ohio","Muskingum County",5,49,963,477,486
050,39,119,"Ohio","Muskingum County",5,50,985,478,507
050,39,119,"Ohio","Muskingum County",5,51,1085,528,557
050,39,119,"Ohio","Muskingum County",5,52,1185,582,603
050,39,119,"Ohio","Muskingum County",5,53,1138,551,587
050,39,119,"Ohio","Muskingum County",5,54,1086,535,551
050,39,119,"Ohio","Muskingum County",5,55,1092,565,527
050,39,119,"Ohio","Muskingum County",5,56,1117,560,557
050,39,119,"Ohio","Muskingum County",5,57,1141,568,573
050,39,119,"Ohio","Muskingum County",5,58,1152,578,574
050,39,119,"Ohio","Muskingum County",5,59,1135,552,583
050,39,119,"Ohio","Muskingum County",5,60,1155,559,596
050,39,119,"Ohio","Muskingum County",5,61,1192,571,621
050,39,119,"Ohio","Muskingum County",5,62,1182,540,642
050,39,119,"Ohio","Muskingum County",5,63,1162,551,611
050,39,119,"Ohio","Muskingum County",5,64,1184,580,604
050,39,119,"Ohio","Muskingum County",5,65,1201,580,621
050,39,119,"Ohio","Muskingum County",5,66,1159,559,600
050,39,119,"Ohio","Muskingum County",5,67,1090,529,561
050,39,119,"Ohio","Muskingum County",5,68,1038,504,534
050,39,119,"Ohio","Muskingum County",5,69,1019,480,539
050,39,119,"Ohio","Muskingum County",5,70,967,446,521
050,39,119,"Ohio","Muskingum County",5,71,909,421,488
050,39,119,"Ohio","Muskingum County",5,72,847,378,469
050,39,119,"Ohio","Muskingum County",5,73,834,367,467
050,39,119,"Ohio","Muskingum County",5,74,826,385,441
050,39,119,"Ohio","Muskingum County",5,75,777,347,430
050,39,119,"Ohio","Muskingum County",5,76,782,366,416
050,39,119,"Ohio","Muskingum County",5,77,527,238,289
050,39,119,"Ohio","Muskingum County",5,78,518,226,292
050,39,119,"Ohio","Muskingum County",5,79,452,192,260
050,39,119,"Ohio","Muskingum County",5,80,469,192,277
050,39,119,"Ohio","Muskingum County",5,81,441,181,260
050,39,119,"Ohio","Muskingum County",5,82,386,157,229
050,39,119,"Ohio","Muskingum County",5,83,304,129,175
050,39,119,"Ohio","Muskingum County",5,84,282,102,180
050,39,119,"Ohio","Muskingum County",5,85,1709,559,1150
050,39,121,"Ohio","Noble County",1,0,140,72,68
050,39,121,"Ohio","Noble County",1,1,151,80,71
050,39,121,"Ohio","Noble County",1,2,140,72,68
050,39,121,"Ohio","Noble County",1,3,125,72,53
050,39,121,"Ohio","Noble County",1,4,146,83,63
050,39,121,"Ohio","Noble County",1,5,151,79,72
050,39,121,"Ohio","Noble County",1,6,147,74,73
050,39,121,"Ohio","Noble County",1,7,151,83,68
050,39,121,"Ohio","Noble County",1,8,154,74,80
050,39,121,"Ohio","Noble County",1,9,162,77,85
050,39,121,"Ohio","Noble County",1,10,148,79,69
050,39,121,"Ohio","Noble County",1,11,161,90,71
050,39,121,"Ohio","Noble County",1,12,174,91,83
050,39,121,"Ohio","Noble County",1,13,150,74,76
050,39,121,"Ohio","Noble County",1,14,152,71,81
050,39,121,"Ohio","Noble County",1,15,137,68,69
050,39,121,"Ohio","Noble County",1,16,153,76,77
050,39,121,"Ohio","Noble County",1,17,170,83,87
050,39,121,"Ohio","Noble County",1,18,116,57,59
050,39,121,"Ohio","Noble County",1,19,84,41,43
050,39,121,"Ohio","Noble County",1,20,105,53,52
050,39,121,"Ohio","Noble County",1,21,111,57,54
050,39,121,"Ohio","Noble County",1,22,117,56,61
050,39,121,"Ohio","Noble County",1,23,132,68,64
050,39,121,"Ohio","Noble County",1,24,123,57,66
050,39,121,"Ohio","Noble County",1,25,129,63,66
050,39,121,"Ohio","Noble County",1,26,147,76,71
050,39,121,"Ohio","Noble County",1,27,131,64,67
050,39,121,"Ohio","Noble County",1,28,122,64,58
050,39,121,"Ohio","Noble County",1,29,126,64,62
050,39,121,"Ohio","Noble County",1,30,144,64,80
050,39,121,"Ohio","Noble County",1,31,122,56,66
050,39,121,"Ohio","Noble County",1,32,116,62,54
050,39,121,"Ohio","Noble County",1,33,131,76,55
050,39,121,"Ohio","Noble County",1,34,124,57,67
050,39,121,"Ohio","Noble County",1,35,125,60,65
050,39,121,"Ohio","Noble County",1,36,119,64,55
050,39,121,"Ohio","Noble County",1,37,127,68,59
050,39,121,"Ohio","Noble County",1,38,118,67,51
050,39,121,"Ohio","Noble County",1,39,125,66,59
050,39,121,"Ohio","Noble County",1,40,128,64,64
050,39,121,"Ohio","Noble County",1,41,114,57,57
050,39,121,"Ohio","Noble County",1,42,117,47,70
050,39,121,"Ohio","Noble County",1,43,101,53,48
050,39,121,"Ohio","Noble County",1,44,95,50,45
050,39,121,"Ohio","Noble County",1,45,95,49,46
050,39,121,"Ohio","Noble County",1,46,109,59,50
050,39,121,"Ohio","Noble County",1,47,117,59,58
050,39,121,"Ohio","Noble County",1,48,197,138,59
050,39,121,"Ohio","Noble County",1,49,154,75,79
050,39,121,"Ohio","Noble County",1,50,140,73,67
050,39,121,"Ohio","Noble County",1,51,157,102,55
050,39,121,"Ohio","Noble County",1,52,160,102,58
050,39,121,"Ohio","Noble County",1,53,163,103,60
050,39,121,"Ohio","Noble County",1,54,222,153,69
050,39,121,"Ohio","Noble County",1,55,259,184,75
050,39,121,"Ohio","Noble County",1,56,187,114,73
050,39,121,"Ohio","Noble County",1,57,149,80,69
050,39,121,"Ohio","Noble County",1,58,209,134,75
050,39,121,"Ohio","Noble County",1,59,237,160,77
050,39,121,"Ohio","Noble County",1,60,398,328,70
050,39,121,"Ohio","Noble County",1,61,398,313,85
050,39,121,"Ohio","Noble County",1,62,358,272,86
050,39,121,"Ohio","Noble County",1,63,276,202,74
050,39,121,"Ohio","Noble County",1,64,229,158,71
050,39,121,"Ohio","Noble County",1,65,182,116,66
050,39,121,"Ohio","Noble County",1,66,255,168,87
050,39,121,"Ohio","Noble County",1,67,161,81,80
050,39,121,"Ohio","Noble County",1,68,308,233,75
050,39,121,"Ohio","Noble County",1,69,256,188,68
050,39,121,"Ohio","Noble County",1,70,263,192,71
050,39,121,"Ohio","Noble County",1,71,308,236,72
050,39,121,"Ohio","Noble County",1,72,234,162,72
050,39,121,"Ohio","Noble County",1,73,284,206,78
050,39,121,"Ohio","Noble County",1,74,157,99,58
050,39,121,"Ohio","Noble County",1,75,192,134,58
050,39,121,"Ohio","Noble County",1,76,118,61,57
050,39,121,"Ohio","Noble County",1,77,109,56,53
050,39,121,"Ohio","Noble County",1,78,106,57,49
050,39,121,"Ohio","Noble County",1,79,133,84,49
050,39,121,"Ohio","Noble County",1,80,123,72,51
050,39,121,"Ohio","Noble County",1,81,88,41,47
050,39,121,"Ohio","Noble County",1,82,99,47,52
050,39,121,"Ohio","Noble County",1,83,82,37,45
050,39,121,"Ohio","Noble County",1,84,72,28,44
050,39,121,"Ohio","Noble County",1,85,405,129,276
050,39,121,"Ohio","Noble County",2,0,144,74,70
050,39,121,"Ohio","Noble County",2,1,146,77,69
050,39,121,"Ohio","Noble County",2,2,142,74,68
050,39,121,"Ohio","Noble County",2,3,127,71,56
050,39,121,"Ohio","Noble County",2,4,143,81,62
050,39,121,"Ohio","Noble County",2,5,148,80,68
050,39,121,"Ohio","Noble County",2,6,148,76,72
050,39,121,"Ohio","Noble County",2,7,150,80,70
050,39,121,"Ohio","Noble County",2,8,154,76,78
050,39,121,"Ohio","Noble County",2,9,159,76,83
050,39,121,"Ohio","Noble County",2,10,149,77,72
050,39,121,"Ohio","Noble County",2,11,157,87,70
050,39,121,"Ohio","Noble County",2,12,172,91,81
050,39,121,"Ohio","Noble County",2,13,155,78,77
050,39,121,"Ohio","Noble County",2,14,152,73,79
050,39,121,"Ohio","Noble County",2,15,142,69,73
050,39,121,"Ohio","Noble County",2,16,151,74,77
050,39,121,"Ohio","Noble County",2,17,165,80,85
050,39,121,"Ohio","Noble County",2,18,120,59,61
050,39,121,"Ohio","Noble County",2,19,87,42,45
050,39,121,"Ohio","Noble County",2,20,103,52,51
050,39,121,"Ohio","Noble County",2,21,109,55,54
050,39,121,"Ohio","Noble County",2,22,120,59,61
050,39,121,"Ohio","Noble County",2,23,127,65,62
050,39,121,"Ohio","Noble County",2,24,127,60,67
050,39,121,"Ohio","Noble County",2,25,127,62,65
050,39,121,"Ohio","Noble County",2,26,144,73,71
050,39,121,"Ohio","Noble County",2,27,134,67,67
050,39,121,"Ohio","Noble County",2,28,125,64,61
050,39,121,"Ohio","Noble County",2,29,125,65,60
050,39,121,"Ohio","Noble County",2,30,140,65,75
050,39,121,"Ohio","Noble County",2,31,123,56,67
050,39,121,"Ohio","Noble County",2,32,117,61,56
050,39,121,"Ohio","Noble County",2,33,127,72,55
050,39,121,"Ohio","Noble County",2,34,123,61,62
050,39,121,"Ohio","Noble County",2,35,126,60,66
050,39,121,"Ohio","Noble County",2,36,119,62,57
050,39,121,"Ohio","Noble County",2,37,125,67,58
050,39,121,"Ohio","Noble County",2,38,119,67,52
050,39,121,"Ohio","Noble County",2,39,123,66,57
050,39,121,"Ohio","Noble County",2,40,129,66,63
050,39,121,"Ohio","Noble County",2,41,118,58,60
050,39,121,"Ohio","Noble County",2,42,116,49,67
050,39,121,"Ohio","Noble County",2,43,105,52,53
050,39,121,"Ohio","Noble County",2,44,95,50,45
050,39,121,"Ohio","Noble County",2,45,94,49,45
050,39,121,"Ohio","Noble County",2,46,105,56,49
050,39,121,"Ohio","Noble County",2,47,114,58,56
050,39,121,"Ohio","Noble County",2,48,198,138,60
050,39,121,"Ohio","Noble County",2,49,145,71,74
050,39,121,"Ohio","Noble County",2,50,143,74,69
050,39,121,"Ohio","Noble County",2,51,162,104,58
050,39,121,"Ohio","Noble County",2,52,158,102,56
050,39,121,"Ohio","Noble County",2,53,160,102,58
050,39,121,"Ohio","Noble County",2,54,215,150,65
050,39,121,"Ohio","Noble County",2,55,257,184,73
050,39,121,"Ohio","Noble County",2,56,188,114,74
050,39,121,"Ohio","Noble County",2,57,148,78,70
050,39,121,"Ohio","Noble County",2,58,204,131,73
050,39,121,"Ohio","Noble County",2,59,237,161,76
050,39,121,"Ohio","Noble County",2,60,400,330,70
050,39,121,"Ohio","Noble County",2,61,388,308,80
050,39,121,"Ohio","Noble County",2,62,357,271,86
050,39,121,"Ohio","Noble County",2,63,277,200,77
050,39,121,"Ohio","Noble County",2,64,229,158,71
050,39,121,"Ohio","Noble County",2,65,185,118,67
050,39,121,"Ohio","Noble County",2,66,248,164,84
050,39,121,"Ohio","Noble County",2,67,167,84,83
050,39,121,"Ohio","Noble County",2,68,307,231,76
050,39,121,"Ohio","Noble County",2,69,261,190,71
050,39,121,"Ohio","Noble County",2,70,260,190,70
050,39,121,"Ohio","Noble County",2,71,306,234,72
050,39,121,"Ohio","Noble County",2,72,231,160,71
050,39,121,"Ohio","Noble County",2,73,291,210,81
050,39,121,"Ohio","Noble County",2,74,161,102,59
050,39,121,"Ohio","Noble County",2,75,194,136,58
050,39,121,"Ohio","Noble County",2,76,115,59,56
050,39,121,"Ohio","Noble County",2,77,112,58,54
050,39,121,"Ohio","Noble County",2,78,103,56,47
050,39,121,"Ohio","Noble County",2,79,132,84,48
050,39,121,"Ohio","Noble County",2,80,125,75,50
050,39,121,"Ohio","Noble County",2,81,89,41,48
050,39,121,"Ohio","Noble County",2,82,95,44,51
050,39,121,"Ohio","Noble County",2,83,84,39,45
050,39,121,"Ohio","Noble County",2,84,74,30,44
050,39,121,"Ohio","Noble County",2,85,414,131,283
050,39,121,"Ohio","Noble County",3,0,140,75,65
050,39,121,"Ohio","Noble County",3,1,151,75,76
050,39,121,"Ohio","Noble County",3,2,142,78,64
050,39,121,"Ohio","Noble County",3,3,148,75,73
050,39,121,"Ohio","Noble County",3,4,128,75,53
050,39,121,"Ohio","Noble County",3,5,150,86,64
050,39,121,"Ohio","Noble County",3,6,145,79,66
050,39,121,"Ohio","Noble County",3,7,151,76,75
050,39,121,"Ohio","Noble County",3,8,156,84,72
050,39,121,"Ohio","Noble County",3,9,157,81,76
050,39,121,"Ohio","Noble County",3,10,156,75,81
050,39,121,"Ohio","Noble County",3,11,157,84,73
050,39,121,"Ohio","Noble County",3,12,158,90,68
050,39,121,"Ohio","Noble County",3,13,176,98,78
050,39,121,"Ohio","Noble County",3,14,154,77,77
050,39,121,"Ohio","Noble County",3,15,154,73,81
050,39,121,"Ohio","Noble County",3,16,140,66,74
050,39,121,"Ohio","Noble County",3,17,139,70,69
050,39,121,"Ohio","Noble County",3,18,139,75,64
050,39,121,"Ohio","Noble County",3,19,94,50,44
050,39,121,"Ohio","Noble County",3,20,89,43,46
050,39,121,"Ohio","Noble County",3,21,126,61,65
050,39,121,"Ohio","Noble County",3,22,121,63,58
050,39,121,"Ohio","Noble County",3,23,124,68,56
050,39,121,"Ohio","Noble County",3,24,123,63,60
050,39,121,"Ohio","Noble County",3,25,124,55,69
050,39,121,"Ohio","Noble County",3,26,126,59,67
050,39,121,"Ohio","Noble County",3,27,153,81,72
050,39,121,"Ohio","Noble County",3,28,142,78,64
050,39,121,"Ohio","Noble County",3,29,123,63,60
050,39,121,"Ohio","Noble County",3,30,126,67,59
050,39,121,"Ohio","Noble County",3,31,138,62,76
050,39,121,"Ohio","Noble County",3,32,134,66,68
050,39,121,"Ohio","Noble County",3,33,127,63,64
050,39,121,"Ohio","Noble County",3,34,129,78,51
050,39,121,"Ohio","Noble County",3,35,125,66,59
050,39,121,"Ohio","Noble County",3,36,132,65,67
050,39,121,"Ohio","Noble County",3,37,124,66,58
050,39,121,"Ohio","Noble County",3,38,132,75,57
050,39,121,"Ohio","Noble County",3,39,119,68,51
050,39,121,"Ohio","Noble County",3,40,123,71,52
050,39,121,"Ohio","Noble County",3,41,128,67,61
050,39,121,"Ohio","Noble County",3,42,136,66,70
050,39,121,"Ohio","Noble County",3,43,113,51,62
050,39,121,"Ohio","Noble County",3,44,105,53,52
050,39,121,"Ohio","Noble County",3,45,96,52,44
050,39,121,"Ohio","Noble County",3,46,91,48,43
050,39,121,"Ohio","Noble County",3,47,110,60,50
050,39,121,"Ohio","Noble County",3,48,202,144,58
050,39,121,"Ohio","Noble County",3,49,114,54,60
050,39,121,"Ohio","Noble County",3,50,142,72,70
050,39,121,"Ohio","Noble County",3,51,170,110,60
050,39,121,"Ohio","Noble County",3,52,162,108,54
050,39,121,"Ohio","Noble County",3,53,161,109,52
050,39,121,"Ohio","Noble County",3,54,200,142,58
050,39,121,"Ohio","Noble County",3,55,257,192,65
050,39,121,"Ohio","Noble County",3,56,185,112,73
050,39,121,"Ohio","Noble County",3,57,148,77,71
050,39,121,"Ohio","Noble County",3,58,188,120,68
050,39,121,"Ohio","Noble County",3,59,241,170,71
050,39,121,"Ohio","Noble County",3,60,424,349,75
050,39,121,"Ohio","Noble County",3,61,382,315,67
050,39,121,"Ohio","Noble County",3,62,346,271,75
050,39,121,"Ohio","Noble County",3,63,276,196,80
050,39,121,"Ohio","Noble County",3,64,237,161,76
050,39,121,"Ohio","Noble County",3,65,194,122,72
050,39,121,"Ohio","Noble County",3,66,230,161,69
050,39,121,"Ohio","Noble County",3,67,173,87,86
050,39,121,"Ohio","Noble County",3,68,331,244,87
050,39,121,"Ohio","Noble County",3,69,278,199,79
050,39,121,"Ohio","Noble County",3,70,268,197,71
050,39,121,"Ohio","Noble County",3,71,309,238,71
050,39,121,"Ohio","Noble County",3,72,241,165,76
050,39,121,"Ohio","Noble County",3,73,273,204,69
050,39,121,"Ohio","Noble County",3,74,216,136,80
050,39,121,"Ohio","Noble County",3,75,200,140,60
050,39,121,"Ohio","Noble County",3,76,120,62,58
050,39,121,"Ohio","Noble County",3,77,111,57,54
050,39,121,"Ohio","Noble County",3,78,108,55,53
050,39,121,"Ohio","Noble County",3,79,136,90,46
050,39,121,"Ohio","Noble County",3,80,134,84,50
050,39,121,"Ohio","Noble County",3,81,90,43,47
050,39,121,"Ohio","Noble County",3,82,83,37,46
050,39,121,"Ohio","Noble County",3,83,97,43,54
050,39,121,"Ohio","Noble County",3,84,72,36,36
050,39,121,"Ohio","Noble County",3,85,436,134,302
050,39,121,"Ohio","Noble County",4,0,143,83,60
050,39,121,"Ohio","Noble County",4,1,134,72,62
050,39,121,"Ohio","Noble County",4,2,148,75,73
050,39,121,"Ohio","Noble County",4,3,139,75,64
050,39,121,"Ohio","Noble County",4,4,153,80,73
050,39,121,"Ohio","Noble County",4,5,129,76,53
050,39,121,"Ohio","Noble County",4,6,147,86,61
050,39,121,"Ohio","Noble County",4,7,148,80,68
050,39,121,"Ohio","Noble County",4,8,150,79,71
050,39,121,"Ohio","Noble County",4,9,154,85,69
050,39,121,"Ohio","Noble County",4,10,162,83,79
050,39,121,"Ohio","Noble County",4,11,161,79,82
050,39,121,"Ohio","Noble County",4,12,158,83,75
050,39,121,"Ohio","Noble County",4,13,161,92,69
050,39,121,"Ohio","Noble County",4,14,188,100,88
050,39,121,"Ohio","Noble County",4,15,153,79,74
050,39,121,"Ohio","Noble County",4,16,156,77,79
050,39,121,"Ohio","Noble County",4,17,142,68,74
050,39,121,"Ohio","Noble County",4,18,116,61,55
050,39,121,"Ohio","Noble County",4,19,97,51,46
050,39,121,"Ohio","Noble County",4,20,95,51,44
050,39,121,"Ohio","Noble County",4,21,92,41,51
050,39,121,"Ohio","Noble County",4,22,128,60,68
050,39,121,"Ohio","Noble County",4,23,122,69,53
050,39,121,"Ohio","Noble County",4,24,125,59,66
050,39,121,"Ohio","Noble County",4,25,120,64,56
050,39,121,"Ohio","Noble County",4,26,114,49,65
050,39,121,"Ohio","Noble County",4,27,122,58,64
050,39,121,"Ohio","Noble County",4,28,144,74,70
050,39,121,"Ohio","Noble County",4,29,134,70,64
050,39,121,"Ohio","Noble County",4,30,124,62,62
050,39,121,"Ohio","Noble County",4,31,123,67,56
050,39,121,"Ohio","Noble County",4,32,128,59,69
050,39,121,"Ohio","Noble County",4,33,132,62,70
050,39,121,"Ohio","Noble County",4,34,105,56,49
050,39,121,"Ohio","Noble County",4,35,127,74,53
050,39,121,"Ohio","Noble County",4,36,116,58,58
050,39,121,"Ohio","Noble County",4,37,131,65,66
050,39,121,"Ohio","Noble County",4,38,115,63,52
050,39,121,"Ohio","Noble County",4,39,126,68,58
050,39,121,"Ohio","Noble County",4,40,113,64,49
050,39,121,"Ohio","Noble County",4,41,126,73,53
050,39,121,"Ohio","Noble County",4,42,128,65,63
050,39,121,"Ohio","Noble County",4,43,137,65,72
050,39,121,"Ohio","Noble County",4,44,117,49,68
050,39,121,"Ohio","Noble County",4,45,109,56,53
050,39,121,"Ohio","Noble County",4,46,99,55,44
050,39,121,"Ohio","Noble County",4,47,89,46,43
050,39,121,"Ohio","Noble County",4,48,201,147,54
050,39,121,"Ohio","Noble County",4,49,114,60,54
050,39,121,"Ohio","Noble County",4,50,114,55,59
050,39,121,"Ohio","Noble County",4,51,174,114,60
050,39,121,"Ohio","Noble County",4,52,172,111,61
050,39,121,"Ohio","Noble County",4,53,160,104,56
050,39,121,"Ohio","Noble County",4,54,196,146,50
050,39,121,"Ohio","Noble County",4,55,244,186,58
050,39,121,"Ohio","Noble County",4,56,184,118,66
050,39,121,"Ohio","Noble County",4,57,140,71,69
050,39,121,"Ohio","Noble County",4,58,189,118,71
050,39,121,"Ohio","Noble County",4,59,227,162,65
050,39,121,"Ohio","Noble County",4,60,430,360,70
050,39,121,"Ohio","Noble County",4,61,405,332,73
050,39,121,"Ohio","Noble County",4,62,339,273,66
050,39,121,"Ohio","Noble County",4,63,267,194,73
050,39,121,"Ohio","Noble County",4,64,236,159,77
050,39,121,"Ohio","Noble County",4,65,201,124,77
050,39,121,"Ohio","Noble County",4,66,238,165,73
050,39,121,"Ohio","Noble County",4,67,162,90,72
050,39,121,"Ohio","Noble County",4,68,340,252,88
050,39,121,"Ohio","Noble County",4,69,300,209,91
050,39,121,"Ohio","Noble County",4,70,285,204,81
050,39,121,"Ohio","Noble County",4,71,309,237,72
050,39,121,"Ohio","Noble County",4,72,236,164,72
050,39,121,"Ohio","Noble County",4,73,284,207,77
050,39,121,"Ohio","Noble County",4,74,192,124,68
050,39,121,"Ohio","Noble County",4,75,257,180,77
050,39,121,"Ohio","Noble County",4,76,123,65,58
050,39,121,"Ohio","Noble County",4,77,118,58,60
050,39,121,"Ohio","Noble County",4,78,107,56,51
050,39,121,"Ohio","Noble County",4,79,141,91,50
050,39,121,"Ohio","Noble County",4,80,136,89,47
050,39,121,"Ohio","Noble County",4,81,98,52,46
050,39,121,"Ohio","Noble County",4,82,83,36,47
050,39,121,"Ohio","Noble County",4,83,83,37,46
050,39,121,"Ohio","Noble County",4,84,88,39,49
050,39,121,"Ohio","Noble County",4,85,472,157,315
050,39,121,"Ohio","Noble County",5,0,147,86,61
050,39,121,"Ohio","Noble County",5,1,156,85,71
050,39,121,"Ohio","Noble County",5,2,135,72,63
050,39,121,"Ohio","Noble County",5,3,155,79,76
050,39,121,"Ohio","Noble County",5,4,141,75,66
050,39,121,"Ohio","Noble County",5,5,154,86,68
050,39,121,"Ohio","Noble County",5,6,133,76,57
050,39,121,"Ohio","Noble County",5,7,151,88,63
050,39,121,"Ohio","Noble County",5,8,141,79,62
050,39,121,"Ohio","Noble County",5,9,154,77,77
050,39,121,"Ohio","Noble County",5,10,143,75,68
050,39,121,"Ohio","Noble County",5,11,165,85,80
050,39,121,"Ohio","Noble County",5,12,161,78,83
050,39,121,"Ohio","Noble County",5,13,156,81,75
050,39,121,"Ohio","Noble County",5,14,159,94,65
050,39,121,"Ohio","Noble County",5,15,186,102,84
050,39,121,"Ohio","Noble County",5,16,151,80,71
050,39,121,"Ohio","Noble County",5,17,159,78,81
050,39,121,"Ohio","Noble County",5,18,111,58,53
050,39,121,"Ohio","Noble County",5,19,86,46,40
050,39,121,"Ohio","Noble County",5,20,110,56,54
050,39,121,"Ohio","Noble County",5,21,110,54,56
050,39,121,"Ohio","Noble County",5,22,99,41,58
050,39,121,"Ohio","Noble County",5,23,129,64,65
050,39,121,"Ohio","Noble County",5,24,119,66,53
050,39,121,"Ohio","Noble County",5,25,124,60,64
050,39,121,"Ohio","Noble County",5,26,109,59,50
050,39,121,"Ohio","Noble County",5,27,119,50,69
050,39,121,"Ohio","Noble County",5,28,127,62,65
050,39,121,"Ohio","Noble County",5,29,151,80,71
050,39,121,"Ohio","Noble County",5,30,135,69,66
050,39,121,"Ohio","Noble County",5,31,123,64,59
050,39,121,"Ohio","Noble County",5,32,125,68,57
050,39,121,"Ohio","Noble County",5,33,138,65,73
050,39,121,"Ohio","Noble County",5,34,126,62,64
050,39,121,"Ohio","Noble County",5,35,109,59,50
050,39,121,"Ohio","Noble County",5,36,127,74,53
050,39,121,"Ohio","Noble County",5,37,112,55,57
050,39,121,"Ohio","Noble County",5,38,129,67,62
050,39,121,"Ohio","Noble County",5,39,111,60,51
050,39,121,"Ohio","Noble County",5,40,125,67,58
050,39,121,"Ohio","Noble County",5,41,113,63,50
050,39,121,"Ohio","Noble County",5,42,124,73,51
050,39,121,"Ohio","Noble County",5,43,118,64,54
050,39,121,"Ohio","Noble County",5,44,133,63,70
050,39,121,"Ohio","Noble County",5,45,118,50,68
050,39,121,"Ohio","Noble County",5,46,105,53,52
050,39,121,"Ohio","Noble County",5,47,107,58,49
050,39,121,"Ohio","Noble County",5,48,179,131,48
050,39,121,"Ohio","Noble County",5,49,107,57,50
050,39,121,"Ohio","Noble County",5,50,106,55,51
050,39,121,"Ohio","Noble County",5,51,150,94,56
050,39,121,"Ohio","Noble County",5,52,172,113,59
050,39,121,"Ohio","Noble County",5,53,170,110,60
050,39,121,"Ohio","Noble County",5,54,197,145,52
050,39,121,"Ohio","Noble County",5,55,237,183,54
050,39,121,"Ohio","Noble County",5,56,161,102,59
050,39,121,"Ohio","Noble County",5,57,141,76,65
050,39,121,"Ohio","Noble County",5,58,181,111,70
050,39,121,"Ohio","Noble County",5,59,223,156,67
050,39,121,"Ohio","Noble County",5,60,412,347,65
050,39,121,"Ohio","Noble County",5,61,393,327,66
050,39,121,"Ohio","Noble County",5,62,352,280,72
050,39,121,"Ohio","Noble County",5,63,250,188,62
050,39,121,"Ohio","Noble County",5,64,215,144,71
050,39,121,"Ohio","Noble County",5,65,194,120,74
050,39,121,"Ohio","Noble County",5,66,245,167,78
050,39,121,"Ohio","Noble County",5,67,156,82,74
050,39,121,"Ohio","Noble County",5,68,328,255,73
050,39,121,"Ohio","Noble County",5,69,297,210,87
050,39,121,"Ohio","Noble County",5,70,301,209,92
050,39,121,"Ohio","Noble County",5,71,321,240,81
050,39,121,"Ohio","Noble County",5,72,232,159,73
050,39,121,"Ohio","Noble County",5,73,274,202,72
050,39,121,"Ohio","Noble County",5,74,203,127,76
050,39,121,"Ohio","Noble County",5,75,235,167,68
050,39,121,"Ohio","Noble County",5,76,177,101,76
050,39,121,"Ohio","Noble County",5,77,117,61,56
050,39,121,"Ohio","Noble County",5,78,117,58,59
050,39,121,"Ohio","Noble County",5,79,143,93,50
050,39,121,"Ohio","Noble County",5,80,140,90,50
050,39,121,"Ohio","Noble County",5,81,100,56,44
050,39,121,"Ohio","Noble County",5,82,94,50,44
050,39,121,"Ohio","Noble County",5,83,84,37,47
050,39,121,"Ohio","Noble County",5,84,75,34,41
050,39,121,"Ohio","Noble County",5,85,513,178,335
050,39,123,"Ohio","Ottawa County",1,0,313,162,151
050,39,123,"Ohio","Ottawa County",1,1,310,155,155
050,39,123,"Ohio","Ottawa County",1,2,341,163,178
050,39,123,"Ohio","Ottawa County",1,3,346,176,170
050,39,123,"Ohio","Ottawa County",1,4,383,192,191
050,39,123,"Ohio","Ottawa County",1,5,380,200,180
050,39,123,"Ohio","Ottawa County",1,6,330,163,167
050,39,123,"Ohio","Ottawa County",1,7,376,182,194
050,39,123,"Ohio","Ottawa County",1,8,393,207,186
050,39,123,"Ohio","Ottawa County",1,9,406,203,203
050,39,123,"Ohio","Ottawa County",1,10,419,204,215
050,39,123,"Ohio","Ottawa County",1,11,467,241,226
050,39,123,"Ohio","Ottawa County",1,12,467,228,239
050,39,123,"Ohio","Ottawa County",1,13,477,234,243
050,39,123,"Ohio","Ottawa County",1,14,477,224,253
050,39,123,"Ohio","Ottawa County",1,15,484,232,252
050,39,123,"Ohio","Ottawa County",1,16,484,243,241
050,39,123,"Ohio","Ottawa County",1,17,508,266,242
050,39,123,"Ohio","Ottawa County",1,18,431,233,198
050,39,123,"Ohio","Ottawa County",1,19,339,183,156
050,39,123,"Ohio","Ottawa County",1,20,361,193,168
050,39,123,"Ohio","Ottawa County",1,21,380,201,179
050,39,123,"Ohio","Ottawa County",1,22,383,202,181
050,39,123,"Ohio","Ottawa County",1,23,358,200,158
050,39,123,"Ohio","Ottawa County",1,24,376,206,170
050,39,123,"Ohio","Ottawa County",1,25,366,204,162
050,39,123,"Ohio","Ottawa County",1,26,364,184,180
050,39,123,"Ohio","Ottawa County",1,27,349,189,160
050,39,123,"Ohio","Ottawa County",1,28,364,187,177
050,39,123,"Ohio","Ottawa County",1,29,401,192,209
050,39,123,"Ohio","Ottawa County",1,30,424,206,218
050,39,123,"Ohio","Ottawa County",1,31,385,193,192
050,39,123,"Ohio","Ottawa County",1,32,363,189,174
050,39,123,"Ohio","Ottawa County",1,33,405,212,193
050,39,123,"Ohio","Ottawa County",1,34,410,217,193
050,39,123,"Ohio","Ottawa County",1,35,409,202,207
050,39,123,"Ohio","Ottawa County",1,36,385,202,183
050,39,123,"Ohio","Ottawa County",1,37,418,209,209
050,39,123,"Ohio","Ottawa County",1,38,413,201,212
050,39,123,"Ohio","Ottawa County",1,39,392,186,206
050,39,123,"Ohio","Ottawa County",1,40,435,216,219
050,39,123,"Ohio","Ottawa County",1,41,449,236,213
050,39,123,"Ohio","Ottawa County",1,42,398,205,193
050,39,123,"Ohio","Ottawa County",1,43,402,222,180
050,39,123,"Ohio","Ottawa County",1,44,407,202,205
050,39,123,"Ohio","Ottawa County",1,45,435,198,237
050,39,123,"Ohio","Ottawa County",1,46,413,212,201
050,39,123,"Ohio","Ottawa County",1,47,452,226,226
050,39,123,"Ohio","Ottawa County",1,48,502,269,233
050,39,123,"Ohio","Ottawa County",1,49,559,285,274
050,39,123,"Ohio","Ottawa County",1,50,523,278,245
050,39,123,"Ohio","Ottawa County",1,51,498,261,237
050,39,123,"Ohio","Ottawa County",1,52,501,261,240
050,39,123,"Ohio","Ottawa County",1,53,525,263,262
050,39,123,"Ohio","Ottawa County",1,54,560,265,295
050,39,123,"Ohio","Ottawa County",1,55,610,309,301
050,39,123,"Ohio","Ottawa County",1,56,629,312,317
050,39,123,"Ohio","Ottawa County",1,57,666,339,327
050,39,123,"Ohio","Ottawa County",1,58,736,359,377
050,39,123,"Ohio","Ottawa County",1,59,724,363,361
050,39,123,"Ohio","Ottawa County",1,60,697,346,351
050,39,123,"Ohio","Ottawa County",1,61,739,374,365
050,39,123,"Ohio","Ottawa County",1,62,763,388,375
050,39,123,"Ohio","Ottawa County",1,63,757,381,376
050,39,123,"Ohio","Ottawa County",1,64,704,340,364
050,39,123,"Ohio","Ottawa County",1,65,712,353,359
050,39,123,"Ohio","Ottawa County",1,66,715,356,359
050,39,123,"Ohio","Ottawa County",1,67,687,348,339
050,39,123,"Ohio","Ottawa County",1,68,692,345,347
050,39,123,"Ohio","Ottawa County",1,69,649,326,323
050,39,123,"Ohio","Ottawa County",1,70,620,309,311
050,39,123,"Ohio","Ottawa County",1,71,595,289,306
050,39,123,"Ohio","Ottawa County",1,72,602,301,301
050,39,123,"Ohio","Ottawa County",1,73,617,317,300
050,39,123,"Ohio","Ottawa County",1,74,396,196,200
050,39,123,"Ohio","Ottawa County",1,75,398,194,204
050,39,123,"Ohio","Ottawa County",1,76,421,211,210
050,39,123,"Ohio","Ottawa County",1,77,436,226,210
050,39,123,"Ohio","Ottawa County",1,78,382,191,191
050,39,123,"Ohio","Ottawa County",1,79,314,153,161
050,39,123,"Ohio","Ottawa County",1,80,269,117,152
050,39,123,"Ohio","Ottawa County",1,81,257,110,147
050,39,123,"Ohio","Ottawa County",1,82,233,118,115
050,39,123,"Ohio","Ottawa County",1,83,208,101,107
050,39,123,"Ohio","Ottawa County",1,84,190,89,101
050,39,123,"Ohio","Ottawa County",1,85,1048,379,669
050,39,123,"Ohio","Ottawa County",2,0,322,165,157
050,39,123,"Ohio","Ottawa County",2,1,312,158,154
050,39,123,"Ohio","Ottawa County",2,2,335,162,173
050,39,123,"Ohio","Ottawa County",2,3,343,171,172
050,39,123,"Ohio","Ottawa County",2,4,375,188,187
050,39,123,"Ohio","Ottawa County",2,5,378,196,182
050,39,123,"Ohio","Ottawa County",2,6,344,173,171
050,39,123,"Ohio","Ottawa County",2,7,367,178,189
050,39,123,"Ohio","Ottawa County",2,8,387,200,187
050,39,123,"Ohio","Ottawa County",2,9,401,204,197
050,39,123,"Ohio","Ottawa County",2,10,416,204,212
050,39,123,"Ohio","Ottawa County",2,11,455,231,224
050,39,123,"Ohio","Ottawa County",2,12,471,232,239
050,39,123,"Ohio","Ottawa County",2,13,475,232,243
050,39,123,"Ohio","Ottawa County",2,14,477,224,253
050,39,123,"Ohio","Ottawa County",2,15,482,230,252
050,39,123,"Ohio","Ottawa County",2,16,488,242,246
050,39,123,"Ohio","Ottawa County",2,17,505,263,242
050,39,123,"Ohio","Ottawa County",2,18,426,231,195
050,39,123,"Ohio","Ottawa County",2,19,340,184,156
050,39,123,"Ohio","Ottawa County",2,20,367,197,170
050,39,123,"Ohio","Ottawa County",2,21,377,200,177
050,39,123,"Ohio","Ottawa County",2,22,383,202,181
050,39,123,"Ohio","Ottawa County",2,23,367,201,166
050,39,123,"Ohio","Ottawa County",2,24,371,207,164
050,39,123,"Ohio","Ottawa County",2,25,365,204,161
050,39,123,"Ohio","Ottawa County",2,26,360,188,172
050,39,123,"Ohio","Ottawa County",2,27,349,188,161
050,39,123,"Ohio","Ottawa County",2,28,360,186,174
050,39,123,"Ohio","Ottawa County",2,29,394,191,203
050,39,123,"Ohio","Ottawa County",2,30,420,202,218
050,39,123,"Ohio","Ottawa County",2,31,391,195,196
050,39,123,"Ohio","Ottawa County",2,32,370,193,177
050,39,123,"Ohio","Ottawa County",2,33,397,208,189
050,39,123,"Ohio","Ottawa County",2,34,409,217,192
050,39,123,"Ohio","Ottawa County",2,35,410,205,205
050,39,123,"Ohio","Ottawa County",2,36,389,200,189
050,39,123,"Ohio","Ottawa County",2,37,411,207,204
050,39,123,"Ohio","Ottawa County",2,38,418,204,214
050,39,123,"Ohio","Ottawa County",2,39,399,191,208
050,39,123,"Ohio","Ottawa County",2,40,432,213,219
050,39,123,"Ohio","Ottawa County",2,41,443,230,213
050,39,123,"Ohio","Ottawa County",2,42,408,212,196
050,39,123,"Ohio","Ottawa County",2,43,407,222,185
050,39,123,"Ohio","Ottawa County",2,44,404,208,196
050,39,123,"Ohio","Ottawa County",2,45,429,200,229
050,39,123,"Ohio","Ottawa County",2,46,414,207,207
050,39,123,"Ohio","Ottawa County",2,47,440,220,220
050,39,123,"Ohio","Ottawa County",2,48,489,258,231
050,39,123,"Ohio","Ottawa County",2,49,548,283,265
050,39,123,"Ohio","Ottawa County",2,50,527,277,250
050,39,123,"Ohio","Ottawa County",2,51,502,266,236
050,39,123,"Ohio","Ottawa County",2,52,501,262,239
050,39,123,"Ohio","Ottawa County",2,53,518,262,256
050,39,123,"Ohio","Ottawa County",2,54,551,264,287
050,39,123,"Ohio","Ottawa County",2,55,603,300,303
050,39,123,"Ohio","Ottawa County",2,56,629,315,314
050,39,123,"Ohio","Ottawa County",2,57,657,331,326
050,39,123,"Ohio","Ottawa County",2,58,713,351,362
050,39,123,"Ohio","Ottawa County",2,59,730,363,367
050,39,123,"Ohio","Ottawa County",2,60,703,349,354
050,39,123,"Ohio","Ottawa County",2,61,728,367,361
050,39,123,"Ohio","Ottawa County",2,62,758,384,374
050,39,123,"Ohio","Ottawa County",2,63,767,387,380
050,39,123,"Ohio","Ottawa County",2,64,710,345,365
050,39,123,"Ohio","Ottawa County",2,65,715,355,360
050,39,123,"Ohio","Ottawa County",2,66,715,357,358
050,39,123,"Ohio","Ottawa County",2,67,694,347,347
050,39,123,"Ohio","Ottawa County",2,68,685,342,343
050,39,123,"Ohio","Ottawa County",2,69,659,331,328
050,39,123,"Ohio","Ottawa County",2,70,623,310,313
050,39,123,"Ohio","Ottawa County",2,71,598,295,303
050,39,123,"Ohio","Ottawa County",2,72,588,293,295
050,39,123,"Ohio","Ottawa County",2,73,639,326,313
050,39,123,"Ohio","Ottawa County",2,74,419,210,209
050,39,123,"Ohio","Ottawa County",2,75,395,195,200
050,39,123,"Ohio","Ottawa County",2,76,409,204,205
050,39,123,"Ohio","Ottawa County",2,77,435,224,211
050,39,123,"Ohio","Ottawa County",2,78,381,194,187
050,39,123,"Ohio","Ottawa County",2,79,321,155,166
050,39,123,"Ohio","Ottawa County",2,80,278,125,153
050,39,123,"Ohio","Ottawa County",2,81,253,109,144
050,39,123,"Ohio","Ottawa County",2,82,237,116,121
050,39,123,"Ohio","Ottawa County",2,83,211,102,109
050,39,123,"Ohio","Ottawa County",2,84,188,89,99
050,39,123,"Ohio","Ottawa County",2,85,1036,378,658
050,39,123,"Ohio","Ottawa County",3,0,288,133,155
050,39,123,"Ohio","Ottawa County",3,1,338,180,158
050,39,123,"Ohio","Ottawa County",3,2,323,168,155
050,39,123,"Ohio","Ottawa County",3,3,336,167,169
050,39,123,"Ohio","Ottawa County",3,4,350,171,179
050,39,123,"Ohio","Ottawa County",3,5,369,188,181
050,39,123,"Ohio","Ottawa County",3,6,387,198,189
050,39,123,"Ohio","Ottawa County",3,7,365,187,178
050,39,123,"Ohio","Ottawa County",3,8,381,184,197
050,39,123,"Ohio","Ottawa County",3,9,396,203,193
050,39,123,"Ohio","Ottawa County",3,10,404,206,198
050,39,123,"Ohio","Ottawa County",3,11,421,204,217
050,39,123,"Ohio","Ottawa County",3,12,463,234,229
050,39,123,"Ohio","Ottawa County",3,13,475,233,242
050,39,123,"Ohio","Ottawa County",3,14,472,230,242
050,39,123,"Ohio","Ottawa County",3,15,473,226,247
050,39,123,"Ohio","Ottawa County",3,16,485,235,250
050,39,123,"Ohio","Ottawa County",3,17,490,248,242
050,39,123,"Ohio","Ottawa County",3,18,435,232,203
050,39,123,"Ohio","Ottawa County",3,19,345,190,155
050,39,123,"Ohio","Ottawa County",3,20,360,195,165
050,39,123,"Ohio","Ottawa County",3,21,380,202,178
050,39,123,"Ohio","Ottawa County",3,22,387,200,187
050,39,123,"Ohio","Ottawa County",3,23,384,205,179
050,39,123,"Ohio","Ottawa County",3,24,356,186,170
050,39,123,"Ohio","Ottawa County",3,25,371,206,165
050,39,123,"Ohio","Ottawa County",3,26,337,185,152
050,39,123,"Ohio","Ottawa County",3,27,379,194,185
050,39,123,"Ohio","Ottawa County",3,28,354,180,174
050,39,123,"Ohio","Ottawa County",3,29,381,205,176
050,39,123,"Ohio","Ottawa County",3,30,406,199,207
050,39,123,"Ohio","Ottawa County",3,31,414,196,218
050,39,123,"Ohio","Ottawa County",3,32,399,206,193
050,39,123,"Ohio","Ottawa County",3,33,384,200,184
050,39,123,"Ohio","Ottawa County",3,34,380,195,185
050,39,123,"Ohio","Ottawa County",3,35,415,216,199
050,39,123,"Ohio","Ottawa County",3,36,413,200,213
050,39,123,"Ohio","Ottawa County",3,37,381,196,185
050,39,123,"Ohio","Ottawa County",3,38,423,221,202
050,39,123,"Ohio","Ottawa County",3,39,425,210,215
050,39,123,"Ohio","Ottawa County",3,40,404,191,213
050,39,123,"Ohio","Ottawa County",3,41,431,214,217
050,39,123,"Ohio","Ottawa County",3,42,450,234,216
050,39,123,"Ohio","Ottawa County",3,43,412,215,197
050,39,123,"Ohio","Ottawa County",3,44,404,222,182
050,39,123,"Ohio","Ottawa County",3,45,415,210,205
050,39,123,"Ohio","Ottawa County",3,46,433,211,222
050,39,123,"Ohio","Ottawa County",3,47,415,204,211
050,39,123,"Ohio","Ottawa County",3,48,441,221,220
050,39,123,"Ohio","Ottawa County",3,49,487,256,231
050,39,123,"Ohio","Ottawa County",3,50,537,279,258
050,39,123,"Ohio","Ottawa County",3,51,538,273,265
050,39,123,"Ohio","Ottawa County",3,52,522,277,245
050,39,123,"Ohio","Ottawa County",3,53,498,256,242
050,39,123,"Ohio","Ottawa County",3,54,525,264,261
050,39,123,"Ohio","Ottawa County",3,55,564,269,295
050,39,123,"Ohio","Ottawa County",3,56,600,305,295
050,39,123,"Ohio","Ottawa County",3,57,638,318,320
050,39,123,"Ohio","Ottawa County",3,58,672,345,327
050,39,123,"Ohio","Ottawa County",3,59,717,353,364
050,39,123,"Ohio","Ottawa County",3,60,736,369,367
050,39,123,"Ohio","Ottawa County",3,61,709,351,358
050,39,123,"Ohio","Ottawa County",3,62,725,368,357
050,39,123,"Ohio","Ottawa County",3,63,751,379,372
050,39,123,"Ohio","Ottawa County",3,64,770,398,372
050,39,123,"Ohio","Ottawa County",3,65,714,354,360
050,39,123,"Ohio","Ottawa County",3,66,702,355,347
050,39,123,"Ohio","Ottawa County",3,67,706,351,355
050,39,123,"Ohio","Ottawa County",3,68,669,331,338
050,39,123,"Ohio","Ottawa County",3,69,682,334,348
050,39,123,"Ohio","Ottawa County",3,70,647,328,319
050,39,123,"Ohio","Ottawa County",3,71,603,296,307
050,39,123,"Ohio","Ottawa County",3,72,580,289,291
050,39,123,"Ohio","Ottawa County",3,73,560,277,283
050,39,123,"Ohio","Ottawa County",3,74,617,306,311
050,39,123,"Ohio","Ottawa County",3,75,403,201,202
050,39,123,"Ohio","Ottawa County",3,76,382,187,195
050,39,123,"Ohio","Ottawa County",3,77,403,200,203
050,39,123,"Ohio","Ottawa County",3,78,414,216,198
050,39,123,"Ohio","Ottawa County",3,79,353,176,177
050,39,123,"Ohio","Ottawa County",3,80,299,140,159
050,39,123,"Ohio","Ottawa County",3,81,263,117,146
050,39,123,"Ohio","Ottawa County",3,82,223,94,129
050,39,123,"Ohio","Ottawa County",3,83,215,102,113
050,39,123,"Ohio","Ottawa County",3,84,205,99,106
050,39,123,"Ohio","Ottawa County",3,85,1007,373,634
050,39,123,"Ohio","Ottawa County",4,0,272,122,150
050,39,123,"Ohio","Ottawa County",4,1,291,134,157
050,39,123,"Ohio","Ottawa County",4,2,342,175,167
050,39,123,"Ohio","Ottawa County",4,3,327,161,166
050,39,123,"Ohio","Ottawa County",4,4,338,164,174
050,39,123,"Ohio","Ottawa County",4,5,356,180,176
050,39,123,"Ohio","Ottawa County",4,6,374,188,186
050,39,123,"Ohio","Ottawa County",4,7,380,196,184
050,39,123,"Ohio","Ottawa County",4,8,360,186,174
050,39,123,"Ohio","Ottawa County",4,9,390,188,202
050,39,123,"Ohio","Ottawa County",4,10,401,208,193
050,39,123,"Ohio","Ottawa County",4,11,404,206,198
050,39,123,"Ohio","Ottawa County",4,12,426,209,217
050,39,123,"Ohio","Ottawa County",4,13,474,245,229
050,39,123,"Ohio","Ottawa County",4,14,479,238,241
050,39,123,"Ohio","Ottawa County",4,15,479,231,248
050,39,123,"Ohio","Ottawa County",4,16,459,219,240
050,39,123,"Ohio","Ottawa County",4,17,483,239,244
050,39,123,"Ohio","Ottawa County",4,18,413,220,193
050,39,123,"Ohio","Ottawa County",4,19,329,178,151
050,39,123,"Ohio","Ottawa County",4,20,359,202,157
050,39,123,"Ohio","Ottawa County",4,21,365,197,168
050,39,123,"Ohio","Ottawa County",4,22,381,199,182
050,39,123,"Ohio","Ottawa County",4,23,367,183,184
050,39,123,"Ohio","Ottawa County",4,24,379,208,171
050,39,123,"Ohio","Ottawa County",4,25,350,186,164
050,39,123,"Ohio","Ottawa County",4,26,366,204,162
050,39,123,"Ohio","Ottawa County",4,27,332,183,149
050,39,123,"Ohio","Ottawa County",4,28,385,196,189
050,39,123,"Ohio","Ottawa County",4,29,369,189,180
050,39,123,"Ohio","Ottawa County",4,30,376,203,173
050,39,123,"Ohio","Ottawa County",4,31,392,197,195
050,39,123,"Ohio","Ottawa County",4,32,425,203,222
050,39,123,"Ohio","Ottawa County",4,33,392,211,181
050,39,123,"Ohio","Ottawa County",4,34,392,199,193
050,39,123,"Ohio","Ottawa County",4,35,383,196,187
050,39,123,"Ohio","Ottawa County",4,36,404,210,194
050,39,123,"Ohio","Ottawa County",4,37,415,203,212
050,39,123,"Ohio","Ottawa County",4,38,385,203,182
050,39,123,"Ohio","Ottawa County",4,39,416,223,193
050,39,123,"Ohio","Ottawa County",4,40,423,205,218
050,39,123,"Ohio","Ottawa County",4,41,413,198,215
050,39,123,"Ohio","Ottawa County",4,42,435,217,218
050,39,123,"Ohio","Ottawa County",4,43,466,236,230
050,39,123,"Ohio","Ottawa County",4,44,424,219,205
050,39,123,"Ohio","Ottawa County",4,45,402,209,193
050,39,123,"Ohio","Ottawa County",4,46,421,213,208
050,39,123,"Ohio","Ottawa County",4,47,443,213,230
050,39,123,"Ohio","Ottawa County",4,48,421,210,211
050,39,123,"Ohio","Ottawa County",4,49,452,228,224
050,39,123,"Ohio","Ottawa County",4,50,494,253,241
050,39,123,"Ohio","Ottawa County",4,51,553,286,267
050,39,123,"Ohio","Ottawa County",4,52,557,281,276
050,39,123,"Ohio","Ottawa County",4,53,517,273,244
050,39,123,"Ohio","Ottawa County",4,54,511,255,256
050,39,123,"Ohio","Ottawa County",4,55,536,265,271
050,39,123,"Ohio","Ottawa County",4,56,572,274,298
050,39,123,"Ohio","Ottawa County",4,57,604,307,297
050,39,123,"Ohio","Ottawa County",4,58,633,313,320
050,39,123,"Ohio","Ottawa County",4,59,695,355,340
050,39,123,"Ohio","Ottawa County",4,60,717,351,366
050,39,123,"Ohio","Ottawa County",4,61,745,372,373
050,39,123,"Ohio","Ottawa County",4,62,709,351,358
050,39,123,"Ohio","Ottawa County",4,63,731,367,364
050,39,123,"Ohio","Ottawa County",4,64,761,388,373
050,39,123,"Ohio","Ottawa County",4,65,778,410,368
050,39,123,"Ohio","Ottawa County",4,66,718,352,366
050,39,123,"Ohio","Ottawa County",4,67,692,352,340
050,39,123,"Ohio","Ottawa County",4,68,691,340,351
050,39,123,"Ohio","Ottawa County",4,69,659,327,332
050,39,123,"Ohio","Ottawa County",4,70,673,338,335
050,39,123,"Ohio","Ottawa County",4,71,636,322,314
050,39,123,"Ohio","Ottawa County",4,72,576,278,298
050,39,123,"Ohio","Ottawa County",4,73,567,281,286
050,39,123,"Ohio","Ottawa County",4,74,541,267,274
050,39,123,"Ohio","Ottawa County",4,75,586,288,298
050,39,123,"Ohio","Ottawa County",4,76,390,191,199
050,39,123,"Ohio","Ottawa County",4,77,364,182,182
050,39,123,"Ohio","Ottawa County",4,78,382,191,191
050,39,123,"Ohio","Ottawa County",4,79,404,209,195
050,39,123,"Ohio","Ottawa County",4,80,327,162,165
050,39,123,"Ohio","Ottawa County",4,81,286,135,151
050,39,123,"Ohio","Ottawa County",4,82,230,99,131
050,39,123,"Ohio","Ottawa County",4,83,199,76,123
050,39,123,"Ohio","Ottawa County",4,84,222,109,113
050,39,123,"Ohio","Ottawa County",4,85,1002,374,628
050,39,123,"Ohio","Ottawa County",5,0,279,126,153
050,39,123,"Ohio","Ottawa County",5,1,273,126,147
050,39,123,"Ohio","Ottawa County",5,2,293,140,153
050,39,123,"Ohio","Ottawa County",5,3,335,174,161
050,39,123,"Ohio","Ottawa County",5,4,336,168,168
050,39,123,"Ohio","Ottawa County",5,5,328,156,172
050,39,123,"Ohio","Ottawa County",5,6,365,185,180
050,39,123,"Ohio","Ottawa County",5,7,376,191,185
050,39,123,"Ohio","Ottawa County",5,8,380,200,180
050,39,123,"Ohio","Ottawa County",5,9,350,179,171
050,39,123,"Ohio","Ottawa County",5,10,386,187,199
050,39,123,"Ohio","Ottawa County",5,11,390,197,193
050,39,123,"Ohio","Ottawa County",5,12,411,202,209
050,39,123,"Ohio","Ottawa County",5,13,433,209,224
050,39,123,"Ohio","Ottawa County",5,14,471,242,229
050,39,123,"Ohio","Ottawa County",5,15,477,234,243
050,39,123,"Ohio","Ottawa County",5,16,481,230,251
050,39,123,"Ohio","Ottawa County",5,17,464,221,243
050,39,123,"Ohio","Ottawa County",5,18,402,208,194
050,39,123,"Ohio","Ottawa County",5,19,334,180,154
050,39,123,"Ohio","Ottawa County",5,20,354,189,165
050,39,123,"Ohio","Ottawa County",5,21,389,204,185
050,39,123,"Ohio","Ottawa County",5,22,379,195,184
050,39,123,"Ohio","Ottawa County",5,23,371,193,178
050,39,123,"Ohio","Ottawa County",5,24,363,194,169
050,39,123,"Ohio","Ottawa County",5,25,376,205,171
050,39,123,"Ohio","Ottawa County",5,26,329,172,157
050,39,123,"Ohio","Ottawa County",5,27,373,213,160
050,39,123,"Ohio","Ottawa County",5,28,334,182,152
050,39,123,"Ohio","Ottawa County",5,29,385,204,181
050,39,123,"Ohio","Ottawa County",5,30,372,179,193
050,39,123,"Ohio","Ottawa County",5,31,363,197,166
050,39,123,"Ohio","Ottawa County",5,32,390,196,194
050,39,123,"Ohio","Ottawa County",5,33,435,214,221
050,39,123,"Ohio","Ottawa County",5,34,386,207,179
050,39,123,"Ohio","Ottawa County",5,35,390,193,197
050,39,123,"Ohio","Ottawa County",5,36,383,197,186
050,39,123,"Ohio","Ottawa County",5,37,402,209,193
050,39,123,"Ohio","Ottawa County",5,38,415,189,226
050,39,123,"Ohio","Ottawa County",5,39,377,203,174
050,39,123,"Ohio","Ottawa County",5,40,415,214,201
050,39,123,"Ohio","Ottawa County",5,41,418,203,215
050,39,123,"Ohio","Ottawa County",5,42,410,193,217
050,39,123,"Ohio","Ottawa County",5,43,435,220,215
050,39,123,"Ohio","Ottawa County",5,44,465,231,234
050,39,123,"Ohio","Ottawa County",5,45,431,220,211
050,39,123,"Ohio","Ottawa County",5,46,407,215,192
050,39,123,"Ohio","Ottawa County",5,47,431,217,214
050,39,123,"Ohio","Ottawa County",5,48,433,206,227
050,39,123,"Ohio","Ottawa County",5,49,444,223,221
050,39,123,"Ohio","Ottawa County",5,50,438,224,214
050,39,123,"Ohio","Ottawa County",5,51,513,261,252
050,39,123,"Ohio","Ottawa County",5,52,563,287,276
050,39,123,"Ohio","Ottawa County",5,53,559,276,283
050,39,123,"Ohio","Ottawa County",5,54,517,272,245
050,39,123,"Ohio","Ottawa County",5,55,518,264,254
050,39,123,"Ohio","Ottawa County",5,56,541,268,273
050,39,123,"Ohio","Ottawa County",5,57,579,278,301
050,39,123,"Ohio","Ottawa County",5,58,612,308,304
050,39,123,"Ohio","Ottawa County",5,59,661,330,331
050,39,123,"Ohio","Ottawa County",5,60,706,358,348
050,39,123,"Ohio","Ottawa County",5,61,729,360,369
050,39,123,"Ohio","Ottawa County",5,62,757,381,376
050,39,123,"Ohio","Ottawa County",5,63,724,360,364
050,39,123,"Ohio","Ottawa County",5,64,739,370,369
050,39,123,"Ohio","Ottawa County",5,65,760,391,369
050,39,123,"Ohio","Ottawa County",5,66,784,417,367
050,39,123,"Ohio","Ottawa County",5,67,713,348,365
050,39,123,"Ohio","Ottawa County",5,68,682,349,333
050,39,123,"Ohio","Ottawa County",5,69,676,334,342
050,39,123,"Ohio","Ottawa County",5,70,638,316,322
050,39,123,"Ohio","Ottawa County",5,71,667,340,327
050,39,123,"Ohio","Ottawa County",5,72,613,309,304
050,39,123,"Ohio","Ottawa County",5,73,567,272,295
050,39,123,"Ohio","Ottawa County",5,74,552,272,280
050,39,123,"Ohio","Ottawa County",5,75,519,255,264
050,39,123,"Ohio","Ottawa County",5,76,572,275,297
050,39,123,"Ohio","Ottawa County",5,77,369,182,187
050,39,123,"Ohio","Ottawa County",5,78,345,172,173
050,39,123,"Ohio","Ottawa County",5,79,368,180,188
050,39,123,"Ohio","Ottawa County",5,80,384,199,185
050,39,123,"Ohio","Ottawa County",5,81,314,155,159
050,39,123,"Ohio","Ottawa County",5,82,254,119,135
050,39,123,"Ohio","Ottawa County",5,83,213,83,130
050,39,123,"Ohio","Ottawa County",5,84,198,78,120
050,39,123,"Ohio","Ottawa County",5,85,1040,395,645
050,39,125,"Ohio","Paulding County",1,0,220,112,108
050,39,125,"Ohio","Paulding County",1,1,214,99,115
050,39,125,"Ohio","Paulding County",1,2,230,116,114
050,39,125,"Ohio","Paulding County",1,3,210,103,107
050,39,125,"Ohio","Paulding County",1,4,216,107,109
050,39,125,"Ohio","Paulding County",1,5,230,116,114
050,39,125,"Ohio","Paulding County",1,6,238,105,133
050,39,125,"Ohio","Paulding County",1,7,220,120,100
050,39,125,"Ohio","Paulding County",1,8,224,123,101
050,39,125,"Ohio","Paulding County",1,9,242,119,123
050,39,125,"Ohio","Paulding County",1,10,266,125,141
050,39,125,"Ohio","Paulding County",1,11,257,121,136
050,39,125,"Ohio","Paulding County",1,12,293,157,136
050,39,125,"Ohio","Paulding County",1,13,296,152,144
050,39,125,"Ohio","Paulding County",1,14,302,147,155
050,39,125,"Ohio","Paulding County",1,15,288,147,141
050,39,125,"Ohio","Paulding County",1,16,282,142,140
050,39,125,"Ohio","Paulding County",1,17,265,136,129
050,39,125,"Ohio","Paulding County",1,18,242,133,109
050,39,125,"Ohio","Paulding County",1,19,191,94,97
050,39,125,"Ohio","Paulding County",1,20,184,96,88
050,39,125,"Ohio","Paulding County",1,21,191,97,94
050,39,125,"Ohio","Paulding County",1,22,198,93,105
050,39,125,"Ohio","Paulding County",1,23,204,107,97
050,39,125,"Ohio","Paulding County",1,24,203,101,102
050,39,125,"Ohio","Paulding County",1,25,206,99,107
050,39,125,"Ohio","Paulding County",1,26,204,103,101
050,39,125,"Ohio","Paulding County",1,27,216,116,100
050,39,125,"Ohio","Paulding County",1,28,222,113,109
050,39,125,"Ohio","Paulding County",1,29,206,105,101
050,39,125,"Ohio","Paulding County",1,30,187,100,87
050,39,125,"Ohio","Paulding County",1,31,183,86,97
050,39,125,"Ohio","Paulding County",1,32,199,100,99
050,39,125,"Ohio","Paulding County",1,33,190,96,94
050,39,125,"Ohio","Paulding County",1,34,210,105,105
050,39,125,"Ohio","Paulding County",1,35,216,101,115
050,39,125,"Ohio","Paulding County",1,36,230,116,114
050,39,125,"Ohio","Paulding County",1,37,227,114,113
050,39,125,"Ohio","Paulding County",1,38,221,109,112
050,39,125,"Ohio","Paulding County",1,39,211,113,98
050,39,125,"Ohio","Paulding County",1,40,220,114,106
050,39,125,"Ohio","Paulding County",1,41,235,132,103
050,39,125,"Ohio","Paulding County",1,42,214,112,102
050,39,125,"Ohio","Paulding County",1,43,220,109,111
050,39,125,"Ohio","Paulding County",1,44,205,102,103
050,39,125,"Ohio","Paulding County",1,45,212,100,112
050,39,125,"Ohio","Paulding County",1,46,222,112,110
050,39,125,"Ohio","Paulding County",1,47,212,114,98
050,39,125,"Ohio","Paulding County",1,48,243,129,114
050,39,125,"Ohio","Paulding County",1,49,266,134,132
050,39,125,"Ohio","Paulding County",1,50,239,112,127
050,39,125,"Ohio","Paulding County",1,51,232,111,121
050,39,125,"Ohio","Paulding County",1,52,231,121,110
050,39,125,"Ohio","Paulding County",1,53,252,130,122
050,39,125,"Ohio","Paulding County",1,54,258,134,124
050,39,125,"Ohio","Paulding County",1,55,264,141,123
050,39,125,"Ohio","Paulding County",1,56,269,141,128
050,39,125,"Ohio","Paulding County",1,57,271,142,129
050,39,125,"Ohio","Paulding County",1,58,296,145,151
050,39,125,"Ohio","Paulding County",1,59,287,143,144
050,39,125,"Ohio","Paulding County",1,60,291,150,141
050,39,125,"Ohio","Paulding County",1,61,260,133,127
050,39,125,"Ohio","Paulding County",1,62,260,135,125
050,39,125,"Ohio","Paulding County",1,63,265,131,134
050,39,125,"Ohio","Paulding County",1,64,262,126,136
050,39,125,"Ohio","Paulding County",1,65,269,142,127
050,39,125,"Ohio","Paulding County",1,66,262,150,112
050,39,125,"Ohio","Paulding County",1,67,246,128,118
050,39,125,"Ohio","Paulding County",1,68,243,118,125
050,39,125,"Ohio","Paulding County",1,69,230,106,124
050,39,125,"Ohio","Paulding County",1,70,205,110,95
050,39,125,"Ohio","Paulding County",1,71,197,107,90
050,39,125,"Ohio","Paulding County",1,72,201,90,111
050,39,125,"Ohio","Paulding County",1,73,200,87,113
050,39,125,"Ohio","Paulding County",1,74,133,56,77
050,39,125,"Ohio","Paulding County",1,75,138,65,73
050,39,125,"Ohio","Paulding County",1,76,124,56,68
050,39,125,"Ohio","Paulding County",1,77,144,69,75
050,39,125,"Ohio","Paulding County",1,78,125,60,65
050,39,125,"Ohio","Paulding County",1,79,106,48,58
050,39,125,"Ohio","Paulding County",1,80,95,44,51
050,39,125,"Ohio","Paulding County",1,81,91,40,51
050,39,125,"Ohio","Paulding County",1,82,79,37,42
050,39,125,"Ohio","Paulding County",1,83,72,28,44
050,39,125,"Ohio","Paulding County",1,84,69,33,36
050,39,125,"Ohio","Paulding County",1,85,357,126,231
050,39,125,"Ohio","Paulding County",2,0,216,106,110
050,39,125,"Ohio","Paulding County",2,1,218,105,113
050,39,125,"Ohio","Paulding County",2,2,229,113,116
050,39,125,"Ohio","Paulding County",2,3,214,107,107
050,39,125,"Ohio","Paulding County",2,4,215,108,107
050,39,125,"Ohio","Paulding County",2,5,228,116,112
050,39,125,"Ohio","Paulding County",2,6,236,108,128
050,39,125,"Ohio","Paulding County",2,7,223,116,107
050,39,125,"Ohio","Paulding County",2,8,224,123,101
050,39,125,"Ohio","Paulding County",2,9,239,120,119
050,39,125,"Ohio","Paulding County",2,10,260,122,138
050,39,125,"Ohio","Paulding County",2,11,261,124,137
050,39,125,"Ohio","Paulding County",2,12,286,148,138
050,39,125,"Ohio","Paulding County",2,13,297,154,143
050,39,125,"Ohio","Paulding County",2,14,303,150,153
050,39,125,"Ohio","Paulding County",2,15,291,146,145
050,39,125,"Ohio","Paulding County",2,16,283,144,139
050,39,125,"Ohio","Paulding County",2,17,269,137,132
050,39,125,"Ohio","Paulding County",2,18,234,126,108
050,39,125,"Ohio","Paulding County",2,19,189,95,94
050,39,125,"Ohio","Paulding County",2,20,191,97,94
050,39,125,"Ohio","Paulding County",2,21,187,95,92
050,39,125,"Ohio","Paulding County",2,22,197,95,102
050,39,125,"Ohio","Paulding County",2,23,202,104,98
050,39,125,"Ohio","Paulding County",2,24,205,103,102
050,39,125,"Ohio","Paulding County",2,25,206,101,105
050,39,125,"Ohio","Paulding County",2,26,204,102,102
050,39,125,"Ohio","Paulding County",2,27,215,114,101
050,39,125,"Ohio","Paulding County",2,28,222,114,108
050,39,125,"Ohio","Paulding County",2,29,211,107,104
050,39,125,"Ohio","Paulding County",2,30,193,102,91
050,39,125,"Ohio","Paulding County",2,31,183,90,93
050,39,125,"Ohio","Paulding County",2,32,197,96,101
050,39,125,"Ohio","Paulding County",2,33,192,97,95
050,39,125,"Ohio","Paulding County",2,34,205,103,102
050,39,125,"Ohio","Paulding County",2,35,215,101,114
050,39,125,"Ohio","Paulding County",2,36,224,110,114
050,39,125,"Ohio","Paulding County",2,37,227,114,113
050,39,125,"Ohio","Paulding County",2,38,223,111,112
050,39,125,"Ohio","Paulding County",2,39,213,112,101
050,39,125,"Ohio","Paulding County",2,40,220,115,105
050,39,125,"Ohio","Paulding County",2,41,231,126,105
050,39,125,"Ohio","Paulding County",2,42,216,115,101
050,39,125,"Ohio","Paulding County",2,43,219,111,108
050,39,125,"Ohio","Paulding County",2,44,206,103,103
050,39,125,"Ohio","Paulding County",2,45,212,101,111
050,39,125,"Ohio","Paulding County",2,46,218,109,109
050,39,125,"Ohio","Paulding County",2,47,216,114,102
050,39,125,"Ohio","Paulding County",2,48,237,125,112
050,39,125,"Ohio","Paulding County",2,49,260,133,127
050,39,125,"Ohio","Paulding County",2,50,245,117,128
050,39,125,"Ohio","Paulding County",2,51,235,111,124
050,39,125,"Ohio","Paulding County",2,52,232,119,113
050,39,125,"Ohio","Paulding County",2,53,248,128,120
050,39,125,"Ohio","Paulding County",2,54,257,134,123
050,39,125,"Ohio","Paulding County",2,55,260,137,123
050,39,125,"Ohio","Paulding County",2,56,268,141,127
050,39,125,"Ohio","Paulding County",2,57,272,142,130
050,39,125,"Ohio","Paulding County",2,58,290,145,145
050,39,125,"Ohio","Paulding County",2,59,290,144,146
050,39,125,"Ohio","Paulding County",2,60,287,147,140
050,39,125,"Ohio","Paulding County",2,61,266,136,130
050,39,125,"Ohio","Paulding County",2,62,258,134,124
050,39,125,"Ohio","Paulding County",2,63,265,133,132
050,39,125,"Ohio","Paulding County",2,64,260,127,133
050,39,125,"Ohio","Paulding County",2,65,267,138,129
050,39,125,"Ohio","Paulding County",2,66,262,147,115
050,39,125,"Ohio","Paulding County",2,67,249,132,117
050,39,125,"Ohio","Paulding County",2,68,243,120,123
050,39,125,"Ohio","Paulding County",2,69,236,110,126
050,39,125,"Ohio","Paulding County",2,70,211,109,102
050,39,125,"Ohio","Paulding County",2,71,199,108,91
050,39,125,"Ohio","Paulding County",2,72,197,93,104
050,39,125,"Ohio","Paulding County",2,73,207,91,116
050,39,125,"Ohio","Paulding County",2,74,138,59,79
050,39,125,"Ohio","Paulding County",2,75,132,61,71
050,39,125,"Ohio","Paulding County",2,76,126,58,68
050,39,125,"Ohio","Paulding County",2,77,139,67,72
050,39,125,"Ohio","Paulding County",2,78,126,60,66
050,39,125,"Ohio","Paulding County",2,79,109,50,59
050,39,125,"Ohio","Paulding County",2,80,98,44,54
050,39,125,"Ohio","Paulding County",2,81,91,41,50
050,39,125,"Ohio","Paulding County",2,82,80,35,45
050,39,125,"Ohio","Paulding County",2,83,75,31,44
050,39,125,"Ohio","Paulding County",2,84,68,32,36
050,39,125,"Ohio","Paulding County",2,85,363,130,233
050,39,125,"Ohio","Paulding County",3,0,229,123,106
050,39,125,"Ohio","Paulding County",3,1,236,111,125
050,39,125,"Ohio","Paulding County",3,2,229,112,117
050,39,125,"Ohio","Paulding County",3,3,224,109,115
050,39,125,"Ohio","Paulding County",3,4,224,115,109
050,39,125,"Ohio","Paulding County",3,5,222,110,112
050,39,125,"Ohio","Paulding County",3,6,233,122,111
050,39,125,"Ohio","Paulding County",3,7,246,111,135
050,39,125,"Ohio","Paulding County",3,8,232,125,107
050,39,125,"Ohio","Paulding County",3,9,233,125,108
050,39,125,"Ohio","Paulding County",3,10,254,124,130
050,39,125,"Ohio","Paulding County",3,11,266,127,139
050,39,125,"Ohio","Paulding County",3,12,263,125,138
050,39,125,"Ohio","Paulding County",3,13,289,153,136
050,39,125,"Ohio","Paulding County",3,14,309,161,148
050,39,125,"Ohio","Paulding County",3,15,296,147,149
050,39,125,"Ohio","Paulding County",3,16,283,140,143
050,39,125,"Ohio","Paulding County",3,17,278,140,138
050,39,125,"Ohio","Paulding County",3,18,231,121,110
050,39,125,"Ohio","Paulding County",3,19,175,95,80
050,39,125,"Ohio","Paulding County",3,20,204,102,102
050,39,125,"Ohio","Paulding County",3,21,209,109,100
050,39,125,"Ohio","Paulding County",3,22,202,103,99
050,39,125,"Ohio","Paulding County",3,23,198,101,97
050,39,125,"Ohio","Paulding County",3,24,210,115,95
050,39,125,"Ohio","Paulding County",3,25,223,111,112
050,39,125,"Ohio","Paulding County",3,26,208,107,101
050,39,125,"Ohio","Paulding County",3,27,211,102,109
050,39,125,"Ohio","Paulding County",3,28,218,113,105
050,39,125,"Ohio","Paulding County",3,29,221,112,109
050,39,125,"Ohio","Paulding County",3,30,212,104,108
050,39,125,"Ohio","Paulding County",3,31,204,105,99
050,39,125,"Ohio","Paulding County",3,32,190,97,93
050,39,125,"Ohio","Paulding County",3,33,196,93,103
050,39,125,"Ohio","Paulding County",3,34,200,104,96
050,39,125,"Ohio","Paulding County",3,35,213,108,105
050,39,125,"Ohio","Paulding County",3,36,226,106,120
050,39,125,"Ohio","Paulding County",3,37,219,108,111
050,39,125,"Ohio","Paulding County",3,38,235,115,120
050,39,125,"Ohio","Paulding County",3,39,230,119,111
050,39,125,"Ohio","Paulding County",3,40,218,108,110
050,39,125,"Ohio","Paulding County",3,41,213,109,104
050,39,125,"Ohio","Paulding County",3,42,230,127,103
050,39,125,"Ohio","Paulding County",3,43,211,113,98
050,39,125,"Ohio","Paulding County",3,44,217,110,107
050,39,125,"Ohio","Paulding County",3,45,205,108,97
050,39,125,"Ohio","Paulding County",3,46,212,100,112
050,39,125,"Ohio","Paulding County",3,47,215,105,110
050,39,125,"Ohio","Paulding County",3,48,214,113,101
050,39,125,"Ohio","Paulding County",3,49,239,123,116
050,39,125,"Ohio","Paulding County",3,50,256,129,127
050,39,125,"Ohio","Paulding County",3,51,252,120,132
050,39,125,"Ohio","Paulding County",3,52,229,109,120
050,39,125,"Ohio","Paulding County",3,53,229,118,111
050,39,125,"Ohio","Paulding County",3,54,248,128,120
050,39,125,"Ohio","Paulding County",3,55,252,132,120
050,39,125,"Ohio","Paulding County",3,56,255,131,124
050,39,125,"Ohio","Paulding County",3,57,266,137,129
050,39,125,"Ohio","Paulding County",3,58,267,138,129
050,39,125,"Ohio","Paulding County",3,59,285,140,145
050,39,125,"Ohio","Paulding County",3,60,285,139,146
050,39,125,"Ohio","Paulding County",3,61,283,146,137
050,39,125,"Ohio","Paulding County",3,62,270,144,126
050,39,125,"Ohio","Paulding County",3,63,251,131,120
050,39,125,"Ohio","Paulding County",3,64,258,132,126
050,39,125,"Ohio","Paulding County",3,65,258,125,133
050,39,125,"Ohio","Paulding County",3,66,260,133,127
050,39,125,"Ohio","Paulding County",3,67,257,144,113
050,39,125,"Ohio","Paulding County",3,68,241,123,118
050,39,125,"Ohio","Paulding County",3,69,237,117,120
050,39,125,"Ohio","Paulding County",3,70,235,110,125
050,39,125,"Ohio","Paulding County",3,71,200,103,97
050,39,125,"Ohio","Paulding County",3,72,193,106,87
050,39,125,"Ohio","Paulding County",3,73,184,86,98
050,39,125,"Ohio","Paulding County",3,74,193,88,105
050,39,125,"Ohio","Paulding County",3,75,129,52,77
050,39,125,"Ohio","Paulding County",3,76,131,61,70
050,39,125,"Ohio","Paulding County",3,77,127,56,71
050,39,125,"Ohio","Paulding County",3,78,127,58,69
050,39,125,"Ohio","Paulding County",3,79,116,57,59
050,39,125,"Ohio","Paulding County",3,80,108,48,60
050,39,125,"Ohio","Paulding County",3,81,91,42,49
050,39,125,"Ohio","Paulding County",3,82,80,37,43
050,39,125,"Ohio","Paulding County",3,83,78,33,45
050,39,125,"Ohio","Paulding County",3,84,60,28,32
050,39,125,"Ohio","Paulding County",3,85,356,132,224
050,39,125,"Ohio","Paulding County",4,0,200,103,97
050,39,125,"Ohio","Paulding County",4,1,245,134,111
050,39,125,"Ohio","Paulding County",4,2,234,112,122
050,39,125,"Ohio","Paulding County",4,3,230,117,113
050,39,125,"Ohio","Paulding County",4,4,238,118,120
050,39,125,"Ohio","Paulding County",4,5,225,115,110
050,39,125,"Ohio","Paulding County",4,6,218,112,106
050,39,125,"Ohio","Paulding County",4,7,232,120,112
050,39,125,"Ohio","Paulding County",4,8,247,115,132
050,39,125,"Ohio","Paulding County",4,9,222,111,111
050,39,125,"Ohio","Paulding County",4,10,231,126,105
050,39,125,"Ohio","Paulding County",4,11,247,120,127
050,39,125,"Ohio","Paulding County",4,12,267,124,143
050,39,125,"Ohio","Paulding County",4,13,256,125,131
050,39,125,"Ohio","Paulding County",4,14,280,146,134
050,39,125,"Ohio","Paulding County",4,15,301,161,140
050,39,125,"Ohio","Paulding County",4,16,301,147,154
050,39,125,"Ohio","Paulding County",4,17,286,143,143
050,39,125,"Ohio","Paulding County",4,18,237,120,117
050,39,125,"Ohio","Paulding County",4,19,173,89,84
050,39,125,"Ohio","Paulding County",4,20,187,97,90
050,39,125,"Ohio","Paulding County",4,21,200,97,103
050,39,125,"Ohio","Paulding County",4,22,215,115,100
050,39,125,"Ohio","Paulding County",4,23,200,107,93
050,39,125,"Ohio","Paulding County",4,24,194,102,92
050,39,125,"Ohio","Paulding County",4,25,188,107,81
050,39,125,"Ohio","Paulding County",4,26,223,110,113
050,39,125,"Ohio","Paulding County",4,27,200,101,99
050,39,125,"Ohio","Paulding County",4,28,198,95,103
050,39,125,"Ohio","Paulding County",4,29,221,117,104
050,39,125,"Ohio","Paulding County",4,30,228,116,112
050,39,125,"Ohio","Paulding County",4,31,215,111,104
050,39,125,"Ohio","Paulding County",4,32,210,109,101
050,39,125,"Ohio","Paulding County",4,33,199,106,93
050,39,125,"Ohio","Paulding County",4,34,191,92,99
050,39,125,"Ohio","Paulding County",4,35,201,102,99
050,39,125,"Ohio","Paulding County",4,36,212,103,109
050,39,125,"Ohio","Paulding County",4,37,228,107,121
050,39,125,"Ohio","Paulding County",4,38,226,111,115
050,39,125,"Ohio","Paulding County",4,39,232,113,119
050,39,125,"Ohio","Paulding County",4,40,232,120,112
050,39,125,"Ohio","Paulding County",4,41,213,109,104
050,39,125,"Ohio","Paulding County",4,42,215,109,106
050,39,125,"Ohio","Paulding County",4,43,220,121,99
050,39,125,"Ohio","Paulding County",4,44,208,111,97
050,39,125,"Ohio","Paulding County",4,45,229,112,117
050,39,125,"Ohio","Paulding County",4,46,212,112,100
050,39,125,"Ohio","Paulding County",4,47,206,98,108
050,39,125,"Ohio","Paulding County",4,48,211,102,109
050,39,125,"Ohio","Paulding County",4,49,224,120,104
050,39,125,"Ohio","Paulding County",4,50,241,126,115
050,39,125,"Ohio","Paulding County",4,51,262,136,126
050,39,125,"Ohio","Paulding County",4,52,250,118,132
050,39,125,"Ohio","Paulding County",4,53,223,107,116
050,39,125,"Ohio","Paulding County",4,54,233,119,114
050,39,125,"Ohio","Paulding County",4,55,246,124,122
050,39,125,"Ohio","Paulding County",4,56,256,135,121
050,39,125,"Ohio","Paulding County",4,57,253,131,122
050,39,125,"Ohio","Paulding County",4,58,256,134,122
050,39,125,"Ohio","Paulding County",4,59,263,133,130
050,39,125,"Ohio","Paulding County",4,60,287,143,144
050,39,125,"Ohio","Paulding County",4,61,281,133,148
050,39,125,"Ohio","Paulding County",4,62,273,144,129
050,39,125,"Ohio","Paulding County",4,63,266,141,125
050,39,125,"Ohio","Paulding County",4,64,251,131,120
050,39,125,"Ohio","Paulding County",4,65,250,127,123
050,39,125,"Ohio","Paulding County",4,66,255,123,132
050,39,125,"Ohio","Paulding County",4,67,252,125,127
050,39,125,"Ohio","Paulding County",4,68,253,142,111
050,39,125,"Ohio","Paulding County",4,69,229,119,110
050,39,125,"Ohio","Paulding County",4,70,232,114,118
050,39,125,"Ohio","Paulding County",4,71,229,108,121
050,39,125,"Ohio","Paulding County",4,72,199,100,99
050,39,125,"Ohio","Paulding County",4,73,191,103,88
050,39,125,"Ohio","Paulding County",4,74,172,84,88
050,39,125,"Ohio","Paulding County",4,75,190,85,105
050,39,125,"Ohio","Paulding County",4,76,122,50,72
050,39,125,"Ohio","Paulding County",4,77,124,55,69
050,39,125,"Ohio","Paulding County",4,78,120,52,68
050,39,125,"Ohio","Paulding County",4,79,115,56,59
050,39,125,"Ohio","Paulding County",4,80,116,59,57
050,39,125,"Ohio","Paulding County",4,81,95,45,50
050,39,125,"Ohio","Paulding County",4,82,81,36,45
050,39,125,"Ohio","Paulding County",4,83,76,33,43
050,39,125,"Ohio","Paulding County",4,84,62,28,34
050,39,125,"Ohio","Paulding County",4,85,350,134,216
050,39,125,"Ohio","Paulding County",5,0,216,114,102
050,39,125,"Ohio","Paulding County",5,1,213,120,93
050,39,125,"Ohio","Paulding County",5,2,242,133,109
050,39,125,"Ohio","Paulding County",5,3,236,117,119
050,39,125,"Ohio","Paulding County",5,4,241,121,120
050,39,125,"Ohio","Paulding County",5,5,241,117,124
050,39,125,"Ohio","Paulding County",5,6,222,106,116
050,39,125,"Ohio","Paulding County",5,7,216,110,106
050,39,125,"Ohio","Paulding County",5,8,238,124,114
050,39,125,"Ohio","Paulding County",5,9,247,110,137
050,39,125,"Ohio","Paulding County",5,10,217,109,108
050,39,125,"Ohio","Paulding County",5,11,229,115,114
050,39,125,"Ohio","Paulding County",5,12,245,121,124
050,39,125,"Ohio","Paulding County",5,13,266,121,145
050,39,125,"Ohio","Paulding County",5,14,262,127,135
050,39,125,"Ohio","Paulding County",5,15,275,144,131
050,39,125,"Ohio","Paulding County",5,16,302,163,139
050,39,125,"Ohio","Paulding County",5,17,308,152,156
050,39,125,"Ohio","Paulding County",5,18,233,121,112
050,39,125,"Ohio","Paulding County",5,19,179,89,90
050,39,125,"Ohio","Paulding County",5,20,184,96,88
050,39,125,"Ohio","Paulding County",5,21,190,97,93
050,39,125,"Ohio","Paulding County",5,22,202,105,97
050,39,125,"Ohio","Paulding County",5,23,209,113,96
050,39,125,"Ohio","Paulding County",5,24,207,110,97
050,39,125,"Ohio","Paulding County",5,25,183,98,85
050,39,125,"Ohio","Paulding County",5,26,174,100,74
050,39,125,"Ohio","Paulding County",5,27,218,112,106
050,39,125,"Ohio","Paulding County",5,28,197,97,100
050,39,125,"Ohio","Paulding County",5,29,201,99,102
050,39,125,"Ohio","Paulding County",5,30,227,115,112
050,39,125,"Ohio","Paulding County",5,31,229,113,116
050,39,125,"Ohio","Paulding County",5,32,228,118,110
050,39,125,"Ohio","Paulding County",5,33,207,109,98
050,39,125,"Ohio","Paulding County",5,34,209,113,96
050,39,125,"Ohio","Paulding County",5,35,198,96,102
050,39,125,"Ohio","Paulding County",5,36,206,108,98
050,39,125,"Ohio","Paulding County",5,37,212,103,109
050,39,125,"Ohio","Paulding County",5,38,234,111,123
050,39,125,"Ohio","Paulding County",5,39,223,109,114
050,39,125,"Ohio","Paulding County",5,40,230,111,119
050,39,125,"Ohio","Paulding County",5,41,234,124,110
050,39,125,"Ohio","Paulding County",5,42,210,109,101
050,39,125,"Ohio","Paulding County",5,43,213,108,105
050,39,125,"Ohio","Paulding County",5,44,215,118,97
050,39,125,"Ohio","Paulding County",5,45,217,116,101
050,39,125,"Ohio","Paulding County",5,46,222,113,109
050,39,125,"Ohio","Paulding County",5,47,210,110,100
050,39,125,"Ohio","Paulding County",5,48,214,100,114
050,39,125,"Ohio","Paulding County",5,49,206,102,104
050,39,125,"Ohio","Paulding County",5,50,222,119,103
050,39,125,"Ohio","Paulding County",5,51,243,127,116
050,39,125,"Ohio","Paulding County",5,52,261,136,125
050,39,125,"Ohio","Paulding County",5,53,242,120,122
050,39,125,"Ohio","Paulding County",5,54,226,109,117
050,39,125,"Ohio","Paulding County",5,55,226,117,109
050,39,125,"Ohio","Paulding County",5,56,250,125,125
050,39,125,"Ohio","Paulding County",5,57,251,130,121
050,39,125,"Ohio","Paulding County",5,58,250,132,118
050,39,125,"Ohio","Paulding County",5,59,260,134,126
050,39,125,"Ohio","Paulding County",5,60,265,136,129
050,39,125,"Ohio","Paulding County",5,61,287,141,146
050,39,125,"Ohio","Paulding County",5,62,277,131,146
050,39,125,"Ohio","Paulding County",5,63,266,142,124
050,39,125,"Ohio","Paulding County",5,64,265,145,120
050,39,125,"Ohio","Paulding County",5,65,249,131,118
050,39,125,"Ohio","Paulding County",5,66,253,130,123
050,39,125,"Ohio","Paulding County",5,67,252,120,132
050,39,125,"Ohio","Paulding County",5,68,237,119,118
050,39,125,"Ohio","Paulding County",5,69,250,140,110
050,39,125,"Ohio","Paulding County",5,70,225,116,109
050,39,125,"Ohio","Paulding County",5,71,219,109,110
050,39,125,"Ohio","Paulding County",5,72,220,104,116
050,39,125,"Ohio","Paulding County",5,73,201,99,102
050,39,125,"Ohio","Paulding County",5,74,183,102,81
050,39,125,"Ohio","Paulding County",5,75,167,77,90
050,39,125,"Ohio","Paulding County",5,76,178,80,98
050,39,125,"Ohio","Paulding County",5,77,115,44,71
050,39,125,"Ohio","Paulding County",5,78,120,52,68
050,39,125,"Ohio","Paulding County",5,79,111,50,61
050,39,125,"Ohio","Paulding County",5,80,113,55,58
050,39,125,"Ohio","Paulding County",5,81,104,55,49
050,39,125,"Ohio","Paulding County",5,82,85,38,47
050,39,125,"Ohio","Paulding County",5,83,82,34,48
050,39,125,"Ohio","Paulding County",5,84,59,29,30
050,39,125,"Ohio","Paulding County",5,85,355,135,220
050,39,127,"Ohio","Perry County",1,0,392,197,195
050,39,127,"Ohio","Perry County",1,1,394,193,201
050,39,127,"Ohio","Perry County",1,2,425,219,206
050,39,127,"Ohio","Perry County",1,3,412,222,190
050,39,127,"Ohio","Perry County",1,4,460,245,215
050,39,127,"Ohio","Perry County",1,5,468,238,230
050,39,127,"Ohio","Perry County",1,6,457,239,218
050,39,127,"Ohio","Perry County",1,7,470,247,223
050,39,127,"Ohio","Perry County",1,8,454,226,228
050,39,127,"Ohio","Perry County",1,9,460,242,218
050,39,127,"Ohio","Perry County",1,10,467,237,230
050,39,127,"Ohio","Perry County",1,11,491,259,232
050,39,127,"Ohio","Perry County",1,12,526,273,253
050,39,127,"Ohio","Perry County",1,13,518,256,262
050,39,127,"Ohio","Perry County",1,14,525,269,256
050,39,127,"Ohio","Perry County",1,15,484,243,241
050,39,127,"Ohio","Perry County",1,16,473,236,237
050,39,127,"Ohio","Perry County",1,17,471,240,231
050,39,127,"Ohio","Perry County",1,18,422,231,191
050,39,127,"Ohio","Perry County",1,19,323,178,145
050,39,127,"Ohio","Perry County",1,20,366,199,167
050,39,127,"Ohio","Perry County",1,21,376,199,177
050,39,127,"Ohio","Perry County",1,22,372,188,184
050,39,127,"Ohio","Perry County",1,23,408,209,199
050,39,127,"Ohio","Perry County",1,24,408,212,196
050,39,127,"Ohio","Perry County",1,25,403,203,200
050,39,127,"Ohio","Perry County",1,26,404,210,194
050,39,127,"Ohio","Perry County",1,27,438,205,233
050,39,127,"Ohio","Perry County",1,28,418,194,224
050,39,127,"Ohio","Perry County",1,29,438,210,228
050,39,127,"Ohio","Perry County",1,30,433,218,215
050,39,127,"Ohio","Perry County",1,31,419,216,203
050,39,127,"Ohio","Perry County",1,32,375,190,185
050,39,127,"Ohio","Perry County",1,33,396,192,204
050,39,127,"Ohio","Perry County",1,34,430,227,203
050,39,127,"Ohio","Perry County",1,35,425,224,201
050,39,127,"Ohio","Perry County",1,36,419,212,207
050,39,127,"Ohio","Perry County",1,37,431,215,216
050,39,127,"Ohio","Perry County",1,38,431,222,209
050,39,127,"Ohio","Perry County",1,39,460,232,228
050,39,127,"Ohio","Perry County",1,40,431,217,214
050,39,127,"Ohio","Perry County",1,41,423,211,212
050,39,127,"Ohio","Perry County",1,42,437,222,215
050,39,127,"Ohio","Perry County",1,43,431,212,219
050,39,127,"Ohio","Perry County",1,44,409,212,197
050,39,127,"Ohio","Perry County",1,45,417,220,197
050,39,127,"Ohio","Perry County",1,46,428,222,206
050,39,127,"Ohio","Perry County",1,47,458,249,209
050,39,127,"Ohio","Perry County",1,48,454,242,212
050,39,127,"Ohio","Perry County",1,49,487,243,244
050,39,127,"Ohio","Perry County",1,50,489,237,252
050,39,127,"Ohio","Perry County",1,51,486,242,244
050,39,127,"Ohio","Perry County",1,52,471,238,233
050,39,127,"Ohio","Perry County",1,53,505,265,240
050,39,127,"Ohio","Perry County",1,54,506,257,249
050,39,127,"Ohio","Perry County",1,55,532,262,270
050,39,127,"Ohio","Perry County",1,56,557,283,274
050,39,127,"Ohio","Perry County",1,57,517,259,258
050,39,127,"Ohio","Perry County",1,58,504,249,255
050,39,127,"Ohio","Perry County",1,59,506,245,261
050,39,127,"Ohio","Perry County",1,60,526,256,270
050,39,127,"Ohio","Perry County",1,61,520,271,249
050,39,127,"Ohio","Perry County",1,62,532,297,235
050,39,127,"Ohio","Perry County",1,63,494,264,230
050,39,127,"Ohio","Perry County",1,64,506,261,245
050,39,127,"Ohio","Perry County",1,65,488,256,232
050,39,127,"Ohio","Perry County",1,66,490,259,231
050,39,127,"Ohio","Perry County",1,67,419,205,214
050,39,127,"Ohio","Perry County",1,68,380,187,193
050,39,127,"Ohio","Perry County",1,69,357,171,186
050,39,127,"Ohio","Perry County",1,70,370,180,190
050,39,127,"Ohio","Perry County",1,71,366,175,191
050,39,127,"Ohio","Perry County",1,72,389,181,208
050,39,127,"Ohio","Perry County",1,73,367,186,181
050,39,127,"Ohio","Perry County",1,74,219,112,107
050,39,127,"Ohio","Perry County",1,75,224,100,124
050,39,127,"Ohio","Perry County",1,76,229,112,117
050,39,127,"Ohio","Perry County",1,77,219,107,112
050,39,127,"Ohio","Perry County",1,78,176,79,97
050,39,127,"Ohio","Perry County",1,79,155,64,91
050,39,127,"Ohio","Perry County",1,80,164,76,88
050,39,127,"Ohio","Perry County",1,81,142,62,80
050,39,127,"Ohio","Perry County",1,82,139,63,76
050,39,127,"Ohio","Perry County",1,83,137,58,79
050,39,127,"Ohio","Perry County",1,84,99,46,53
050,39,127,"Ohio","Perry County",1,85,509,169,340
050,39,127,"Ohio","Perry County",2,0,409,204,205
050,39,127,"Ohio","Perry County",2,1,395,194,201
050,39,127,"Ohio","Perry County",2,2,418,212,206
050,39,127,"Ohio","Perry County",2,3,414,220,194
050,39,127,"Ohio","Perry County",2,4,450,241,209
050,39,127,"Ohio","Perry County",2,5,468,240,228
050,39,127,"Ohio","Perry County",2,6,465,240,225
050,39,127,"Ohio","Perry County",2,7,466,244,222
050,39,127,"Ohio","Perry County",2,8,459,233,226
050,39,127,"Ohio","Perry County",2,9,459,239,220
050,39,127,"Ohio","Perry County",2,10,467,239,228
050,39,127,"Ohio","Perry County",2,11,484,254,230
050,39,127,"Ohio","Perry County",2,12,517,270,247
050,39,127,"Ohio","Perry County",2,13,522,263,259
050,39,127,"Ohio","Perry County",2,14,520,265,255
050,39,127,"Ohio","Perry County",2,15,490,246,244
050,39,127,"Ohio","Perry County",2,16,473,238,235
050,39,127,"Ohio","Perry County",2,17,472,240,232
050,39,127,"Ohio","Perry County",2,18,413,224,189
050,39,127,"Ohio","Perry County",2,19,330,181,149
050,39,127,"Ohio","Perry County",2,20,365,197,168
050,39,127,"Ohio","Perry County",2,21,377,198,179
050,39,127,"Ohio","Perry County",2,22,381,193,188
050,39,127,"Ohio","Perry County",2,23,407,207,200
050,39,127,"Ohio","Perry County",2,24,411,214,197
050,39,127,"Ohio","Perry County",2,25,407,207,200
050,39,127,"Ohio","Perry County",2,26,411,211,200
050,39,127,"Ohio","Perry County",2,27,432,206,226
050,39,127,"Ohio","Perry County",2,28,423,195,228
050,39,127,"Ohio","Perry County",2,29,436,207,229
050,39,127,"Ohio","Perry County",2,30,434,215,219
050,39,127,"Ohio","Perry County",2,31,421,216,205
050,39,127,"Ohio","Perry County",2,32,387,197,190
050,39,127,"Ohio","Perry County",2,33,392,192,200
050,39,127,"Ohio","Perry County",2,34,420,218,202
050,39,127,"Ohio","Perry County",2,35,430,227,203
050,39,127,"Ohio","Perry County",2,36,420,216,204
050,39,127,"Ohio","Perry County",2,37,427,215,212
050,39,127,"Ohio","Perry County",2,38,435,223,212
050,39,127,"Ohio","Perry County",2,39,452,230,222
050,39,127,"Ohio","Perry County",2,40,440,221,219
050,39,127,"Ohio","Perry County",2,41,423,211,212
050,39,127,"Ohio","Perry County",2,42,431,218,213
050,39,127,"Ohio","Perry County",2,43,435,217,218
050,39,127,"Ohio","Perry County",2,44,412,211,201
050,39,127,"Ohio","Perry County",2,45,420,222,198
050,39,127,"Ohio","Perry County",2,46,423,222,201
050,39,127,"Ohio","Perry County",2,47,450,242,208
050,39,127,"Ohio","Perry County",2,48,455,243,212
050,39,127,"Ohio","Perry County",2,49,484,244,240
050,39,127,"Ohio","Perry County",2,50,488,239,249
050,39,127,"Ohio","Perry County",2,51,483,239,244
050,39,127,"Ohio","Perry County",2,52,472,239,233
050,39,127,"Ohio","Perry County",2,53,496,258,238
050,39,127,"Ohio","Perry County",2,54,503,257,246
050,39,127,"Ohio","Perry County",2,55,526,261,265
050,39,127,"Ohio","Perry County",2,56,554,279,275
050,39,127,"Ohio","Perry County",2,57,524,263,261
050,39,127,"Ohio","Perry County",2,58,507,250,257
050,39,127,"Ohio","Perry County",2,59,504,245,259
050,39,127,"Ohio","Perry County",2,60,517,253,264
050,39,127,"Ohio","Perry County",2,61,518,265,253
050,39,127,"Ohio","Perry County",2,62,526,288,238
050,39,127,"Ohio","Perry County",2,63,508,275,233
050,39,127,"Ohio","Perry County",2,64,496,257,239
050,39,127,"Ohio","Perry County",2,65,491,258,233
050,39,127,"Ohio","Perry County",2,66,489,258,231
050,39,127,"Ohio","Perry County",2,67,432,215,217
050,39,127,"Ohio","Perry County",2,68,384,187,197
050,39,127,"Ohio","Perry County",2,69,365,176,189
050,39,127,"Ohio","Perry County",2,70,364,176,188
050,39,127,"Ohio","Perry County",2,71,365,177,188
050,39,127,"Ohio","Perry County",2,72,371,172,199
050,39,127,"Ohio","Perry County",2,73,387,193,194
050,39,127,"Ohio","Perry County",2,74,237,120,117
050,39,127,"Ohio","Perry County",2,75,224,103,121
050,39,127,"Ohio","Perry County",2,76,222,106,116
050,39,127,"Ohio","Perry County",2,77,225,110,115
050,39,127,"Ohio","Perry County",2,78,182,84,98
050,39,127,"Ohio","Perry County",2,79,157,66,91
050,39,127,"Ohio","Perry County",2,80,162,73,89
050,39,127,"Ohio","Perry County",2,81,145,65,80
050,39,127,"Ohio","Perry County",2,82,139,62,77
050,39,127,"Ohio","Perry County",2,83,138,59,79
050,39,127,"Ohio","Perry County",2,84,107,48,59
050,39,127,"Ohio","Perry County",2,85,506,170,336
050,39,127,"Ohio","Perry County",3,0,382,191,191
050,39,127,"Ohio","Perry County",3,1,409,212,197
050,39,127,"Ohio","Perry County",3,2,405,200,205
050,39,127,"Ohio","Perry County",3,3,419,209,210
050,39,127,"Ohio","Perry County",3,4,423,226,197
050,39,127,"Ohio","Perry County",3,5,450,238,212
050,39,127,"Ohio","Perry County",3,6,460,235,225
050,39,127,"Ohio","Perry County",3,7,477,252,225
050,39,127,"Ohio","Perry County",3,8,465,245,220
050,39,127,"Ohio","Perry County",3,9,472,235,237
050,39,127,"Ohio","Perry County",3,10,467,242,225
050,39,127,"Ohio","Perry County",3,11,470,244,226
050,39,127,"Ohio","Perry County",3,12,488,253,235
050,39,127,"Ohio","Perry County",3,13,526,272,254
050,39,127,"Ohio","Perry County",3,14,537,266,271
050,39,127,"Ohio","Perry County",3,15,512,255,257
050,39,127,"Ohio","Perry County",3,16,497,248,249
050,39,127,"Ohio","Perry County",3,17,479,246,233
050,39,127,"Ohio","Perry County",3,18,393,206,187
050,39,127,"Ohio","Perry County",3,19,313,172,141
050,39,127,"Ohio","Perry County",3,20,346,193,153
050,39,127,"Ohio","Perry County",3,21,374,189,185
050,39,127,"Ohio","Perry County",3,22,395,207,188
050,39,127,"Ohio","Perry County",3,23,389,201,188
050,39,127,"Ohio","Perry County",3,24,395,200,195
050,39,127,"Ohio","Perry County",3,25,393,210,183
050,39,127,"Ohio","Perry County",3,26,405,208,197
050,39,127,"Ohio","Perry County",3,27,404,209,195
050,39,127,"Ohio","Perry County",3,28,420,198,222
050,39,127,"Ohio","Perry County",3,29,439,197,242
050,39,127,"Ohio","Perry County",3,30,446,207,239
050,39,127,"Ohio","Perry County",3,31,451,226,225
050,39,127,"Ohio","Perry County",3,32,425,211,214
050,39,127,"Ohio","Perry County",3,33,402,204,198
050,39,127,"Ohio","Perry County",3,34,399,195,204
050,39,127,"Ohio","Perry County",3,35,419,222,197
050,39,127,"Ohio","Perry County",3,36,447,236,211
050,39,127,"Ohio","Perry County",3,37,415,208,207
050,39,127,"Ohio","Perry County",3,38,423,218,205
050,39,127,"Ohio","Perry County",3,39,439,223,216
050,39,127,"Ohio","Perry County",3,40,449,223,226
050,39,127,"Ohio","Perry County",3,41,429,217,212
050,39,127,"Ohio","Perry County",3,42,427,211,216
050,39,127,"Ohio","Perry County",3,43,423,212,211
050,39,127,"Ohio","Perry County",3,44,439,222,217
050,39,127,"Ohio","Perry County",3,45,422,215,207
050,39,127,"Ohio","Perry County",3,46,419,222,197
050,39,127,"Ohio","Perry County",3,47,414,218,196
050,39,127,"Ohio","Perry County",3,48,442,238,204
050,39,127,"Ohio","Perry County",3,49,457,242,215
050,39,127,"Ohio","Perry County",3,50,480,247,233
050,39,127,"Ohio","Perry County",3,51,480,235,245
050,39,127,"Ohio","Perry County",3,52,489,246,243
050,39,127,"Ohio","Perry County",3,53,472,239,233
050,39,127,"Ohio","Perry County",3,54,505,257,248
050,39,127,"Ohio","Perry County",3,55,502,258,244
050,39,127,"Ohio","Perry County",3,56,518,265,253
050,39,127,"Ohio","Perry County",3,57,542,278,264
050,39,127,"Ohio","Perry County",3,58,526,261,265
050,39,127,"Ohio","Perry County",3,59,502,242,260
050,39,127,"Ohio","Perry County",3,60,503,243,260
050,39,127,"Ohio","Perry County",3,61,519,257,262
050,39,127,"Ohio","Perry County",3,62,511,262,249
050,39,127,"Ohio","Perry County",3,63,523,281,242
050,39,127,"Ohio","Perry County",3,64,513,276,237
050,39,127,"Ohio","Perry County",3,65,480,253,227
050,39,127,"Ohio","Perry County",3,66,486,258,228
050,39,127,"Ohio","Perry County",3,67,479,252,227
050,39,127,"Ohio","Perry County",3,68,429,207,222
050,39,127,"Ohio","Perry County",3,69,368,177,191
050,39,127,"Ohio","Perry County",3,70,363,176,187
050,39,127,"Ohio","Perry County",3,71,365,174,191
050,39,127,"Ohio","Perry County",3,72,365,176,189
050,39,127,"Ohio","Perry County",3,73,355,162,193
050,39,127,"Ohio","Perry County",3,74,378,186,192
050,39,127,"Ohio","Perry County",3,75,231,114,117
050,39,127,"Ohio","Perry County",3,76,212,98,114
050,39,127,"Ohio","Perry County",3,77,215,100,115
050,39,127,"Ohio","Perry County",3,78,211,107,104
050,39,127,"Ohio","Perry County",3,79,176,81,95
050,39,127,"Ohio","Perry County",3,80,153,56,97
050,39,127,"Ohio","Perry County",3,81,153,68,85
050,39,127,"Ohio","Perry County",3,82,138,62,76
050,39,127,"Ohio","Perry County",3,83,122,54,68
050,39,127,"Ohio","Perry County",3,84,122,48,74
050,39,127,"Ohio","Perry County",3,85,487,166,321
050,39,127,"Ohio","Perry County",4,0,376,165,211
050,39,127,"Ohio","Perry County",4,1,380,196,184
050,39,127,"Ohio","Perry County",4,2,419,219,200
050,39,127,"Ohio","Perry County",4,3,414,206,208
050,39,127,"Ohio","Perry County",4,4,439,223,216
050,39,127,"Ohio","Perry County",4,5,423,232,191
050,39,127,"Ohio","Perry County",4,6,455,241,214
050,39,127,"Ohio","Perry County",4,7,462,235,227
050,39,127,"Ohio","Perry County",4,8,480,256,224
050,39,127,"Ohio","Perry County",4,9,473,249,224
050,39,127,"Ohio","Perry County",4,10,460,226,234
050,39,127,"Ohio","Perry County",4,11,467,242,225
050,39,127,"Ohio","Perry County",4,12,473,245,228
050,39,127,"Ohio","Perry County",4,13,492,251,241
050,39,127,"Ohio","Perry County",4,14,543,288,255
050,39,127,"Ohio","Perry County",4,15,536,262,274
050,39,127,"Ohio","Perry County",4,16,524,254,270
050,39,127,"Ohio","Perry County",4,17,489,250,239
050,39,127,"Ohio","Perry County",4,18,392,209,183
050,39,127,"Ohio","Perry County",4,19,295,153,142
050,39,127,"Ohio","Perry County",4,20,322,177,145
050,39,127,"Ohio","Perry County",4,21,351,196,155
050,39,127,"Ohio","Perry County",4,22,398,202,196
050,39,127,"Ohio","Perry County",4,23,390,195,195
050,39,127,"Ohio","Perry County",4,24,398,202,196
050,39,127,"Ohio","Perry County",4,25,393,200,193
050,39,127,"Ohio","Perry County",4,26,385,204,181
050,39,127,"Ohio","Perry County",4,27,421,220,201
050,39,127,"Ohio","Perry County",4,28,421,217,204
050,39,127,"Ohio","Perry County",4,29,455,213,242
050,39,127,"Ohio","Perry County",4,30,434,194,240
050,39,127,"Ohio","Perry County",4,31,432,199,233
050,39,127,"Ohio","Perry County",4,32,444,219,225
050,39,127,"Ohio","Perry County",4,33,437,225,212
050,39,127,"Ohio","Perry County",4,34,411,219,192
050,39,127,"Ohio","Perry County",4,35,391,196,195
050,39,127,"Ohio","Perry County",4,36,402,213,189
050,39,127,"Ohio","Perry County",4,37,442,233,209
050,39,127,"Ohio","Perry County",4,38,395,193,202
050,39,127,"Ohio","Perry County",4,39,424,220,204
050,39,127,"Ohio","Perry County",4,40,449,223,226
050,39,127,"Ohio","Perry County",4,41,454,225,229
050,39,127,"Ohio","Perry County",4,42,427,214,213
050,39,127,"Ohio","Perry County",4,43,428,211,217
050,39,127,"Ohio","Perry County",4,44,432,215,217
050,39,127,"Ohio","Perry County",4,45,438,213,225
050,39,127,"Ohio","Perry County",4,46,428,222,206
050,39,127,"Ohio","Perry County",4,47,424,231,193
050,39,127,"Ohio","Perry County",4,48,413,220,193
050,39,127,"Ohio","Perry County",4,49,449,243,206
050,39,127,"Ohio","Perry County",4,50,461,248,213
050,39,127,"Ohio","Perry County",4,51,480,246,234
050,39,127,"Ohio","Perry County",4,52,479,234,245
050,39,127,"Ohio","Perry County",4,53,487,246,241
050,39,127,"Ohio","Perry County",4,54,466,239,227
050,39,127,"Ohio","Perry County",4,55,499,255,244
050,39,127,"Ohio","Perry County",4,56,505,265,240
050,39,127,"Ohio","Perry County",4,57,510,260,250
050,39,127,"Ohio","Perry County",4,58,552,278,274
050,39,127,"Ohio","Perry County",4,59,516,251,265
050,39,127,"Ohio","Perry County",4,60,507,245,262
050,39,127,"Ohio","Perry County",4,61,501,239,262
050,39,127,"Ohio","Perry County",4,62,506,253,253
050,39,127,"Ohio","Perry County",4,63,497,250,247
050,39,127,"Ohio","Perry County",4,64,531,277,254
050,39,127,"Ohio","Perry County",4,65,497,267,230
050,39,127,"Ohio","Perry County",4,66,476,253,223
050,39,127,"Ohio","Perry County",4,67,476,252,224
050,39,127,"Ohio","Perry County",4,68,481,251,230
050,39,127,"Ohio","Perry County",4,69,419,203,216
050,39,127,"Ohio","Perry County",4,70,360,175,185
050,39,127,"Ohio","Perry County",4,71,360,176,184
050,39,127,"Ohio","Perry County",4,72,365,172,193
050,39,127,"Ohio","Perry County",4,73,347,164,183
050,39,127,"Ohio","Perry County",4,74,339,154,185
050,39,127,"Ohio","Perry County",4,75,371,180,191
050,39,127,"Ohio","Perry County",4,76,218,107,111
050,39,127,"Ohio","Perry County",4,77,195,90,105
050,39,127,"Ohio","Perry County",4,78,204,97,107
050,39,127,"Ohio","Perry County",4,79,205,104,101
050,39,127,"Ohio","Perry County",4,80,171,71,100
050,39,127,"Ohio","Perry County",4,81,137,47,90
050,39,127,"Ohio","Perry County",4,82,147,66,81
050,39,127,"Ohio","Perry County",4,83,124,53,71
050,39,127,"Ohio","Perry County",4,84,104,40,64
050,39,127,"Ohio","Perry County",4,85,498,174,324
050,39,127,"Ohio","Perry County",5,0,377,166,211
050,39,127,"Ohio","Perry County",5,1,386,167,219
050,39,127,"Ohio","Perry County",5,2,382,203,179
050,39,127,"Ohio","Perry County",5,3,427,211,216
050,39,127,"Ohio","Perry County",5,4,417,204,213
050,39,127,"Ohio","Perry County",5,5,451,236,215
050,39,127,"Ohio","Perry County",5,6,439,237,202
050,39,127,"Ohio","Perry County",5,7,467,251,216
050,39,127,"Ohio","Perry County",5,8,477,239,238
050,39,127,"Ohio","Perry County",5,9,482,246,236
050,39,127,"Ohio","Perry County",5,10,470,247,223
050,39,127,"Ohio","Perry County",5,11,467,228,239
050,39,127,"Ohio","Perry County",5,12,465,244,221
050,39,127,"Ohio","Perry County",5,13,486,249,237
050,39,127,"Ohio","Perry County",5,14,496,255,241
050,39,127,"Ohio","Perry County",5,15,536,279,257
050,39,127,"Ohio","Perry County",5,16,536,266,270
050,39,127,"Ohio","Perry County",5,17,530,262,268
050,39,127,"Ohio","Perry County",5,18,410,213,197
050,39,127,"Ohio","Perry County",5,19,294,158,136
050,39,127,"Ohio","Perry County",5,20,313,158,155
050,39,127,"Ohio","Perry County",5,21,341,184,157
050,39,127,"Ohio","Perry County",5,22,380,202,178
050,39,127,"Ohio","Perry County",5,23,416,212,204
050,39,127,"Ohio","Perry County",5,24,380,194,186
050,39,127,"Ohio","Perry County",5,25,412,204,208
050,39,127,"Ohio","Perry County",5,26,419,215,204
050,39,127,"Ohio","Perry County",5,27,395,202,193
050,39,127,"Ohio","Perry County",5,28,423,223,200
050,39,127,"Ohio","Perry County",5,29,421,216,205
050,39,127,"Ohio","Perry County",5,30,444,210,234
050,39,127,"Ohio","Perry County",5,31,443,195,248
050,39,127,"Ohio","Perry County",5,32,428,193,235
050,39,127,"Ohio","Perry County",5,33,444,224,220
050,39,127,"Ohio","Perry County",5,34,432,228,204
050,39,127,"Ohio","Perry County",5,35,414,219,195
050,39,127,"Ohio","Perry County",5,36,401,195,206
050,39,127,"Ohio","Perry County",5,37,392,206,186
050,39,127,"Ohio","Perry County",5,38,449,237,212
050,39,127,"Ohio","Perry County",5,39,408,195,213
050,39,127,"Ohio","Perry County",5,40,428,221,207
050,39,127,"Ohio","Perry County",5,41,441,216,225
050,39,127,"Ohio","Perry County",5,42,453,227,226
050,39,127,"Ohio","Perry County",5,43,436,217,219
050,39,127,"Ohio","Perry County",5,44,430,207,223
050,39,127,"Ohio","Perry County",5,45,434,218,216
050,39,127,"Ohio","Perry County",5,46,445,218,227
050,39,127,"Ohio","Perry County",5,47,438,226,212
050,39,127,"Ohio","Perry County",5,48,424,228,196
050,39,127,"Ohio","Perry County",5,49,429,226,203
050,39,127,"Ohio","Perry County",5,50,446,243,203
050,39,127,"Ohio","Perry County",5,51,468,258,210
050,39,127,"Ohio","Perry County",5,52,477,239,238
050,39,127,"Ohio","Perry County",5,53,470,229,241
050,39,127,"Ohio","Perry County",5,54,478,234,244
050,39,127,"Ohio","Perry County",5,55,460,236,224
050,39,127,"Ohio","Perry County",5,56,489,251,238
050,39,127,"Ohio","Perry County",5,57,490,252,238
050,39,127,"Ohio","Perry County",5,58,516,261,255
050,39,127,"Ohio","Perry County",5,59,533,263,270
050,39,127,"Ohio","Perry County",5,60,513,256,257
050,39,127,"Ohio","Perry County",5,61,506,243,263
050,39,127,"Ohio","Perry County",5,62,495,230,265
050,39,127,"Ohio","Perry County",5,63,494,246,248
050,39,127,"Ohio","Perry County",5,64,495,250,245
050,39,127,"Ohio","Perry County",5,65,516,276,240
050,39,127,"Ohio","Perry County",5,66,496,270,226
050,39,127,"Ohio","Perry County",5,67,461,244,217
050,39,127,"Ohio","Perry County",5,68,469,243,226
050,39,127,"Ohio","Perry County",5,69,465,247,218
050,39,127,"Ohio","Perry County",5,70,413,202,211
050,39,127,"Ohio","Perry County",5,71,352,176,176
050,39,127,"Ohio","Perry County",5,72,357,171,186
050,39,127,"Ohio","Perry County",5,73,351,164,187
050,39,127,"Ohio","Perry County",5,74,335,151,184
050,39,127,"Ohio","Perry County",5,75,326,143,183
050,39,127,"Ohio","Perry County",5,76,352,170,182
050,39,127,"Ohio","Perry County",5,77,211,101,110
050,39,127,"Ohio","Perry County",5,78,184,88,96
050,39,127,"Ohio","Perry County",5,79,199,93,106
050,39,127,"Ohio","Perry County",5,80,196,93,103
050,39,127,"Ohio","Perry County",5,81,155,62,93
050,39,127,"Ohio","Perry County",5,82,133,47,86
050,39,127,"Ohio","Perry County",5,83,135,58,77
050,39,127,"Ohio","Perry County",5,84,109,42,67
050,39,127,"Ohio","Perry County",5,85,498,178,320
050,39,129,"Ohio","Pickaway County",1,0,595,305,290
050,39,129,"Ohio","Pickaway County",1,1,623,317,306
050,39,129,"Ohio","Pickaway County",1,2,601,286,315
050,39,129,"Ohio","Pickaway County",1,3,665,335,330
050,39,129,"Ohio","Pickaway County",1,4,651,350,301
050,39,129,"Ohio","Pickaway County",1,5,716,358,358
050,39,129,"Ohio","Pickaway County",1,6,685,339,346
050,39,129,"Ohio","Pickaway County",1,7,706,352,354
050,39,129,"Ohio","Pickaway County",1,8,649,322,327
050,39,129,"Ohio","Pickaway County",1,9,661,327,334
050,39,129,"Ohio","Pickaway County",1,10,722,367,355
050,39,129,"Ohio","Pickaway County",1,11,749,390,359
050,39,129,"Ohio","Pickaway County",1,12,770,395,375
050,39,129,"Ohio","Pickaway County",1,13,771,385,386
050,39,129,"Ohio","Pickaway County",1,14,744,356,388
050,39,129,"Ohio","Pickaway County",1,15,736,382,354
050,39,129,"Ohio","Pickaway County",1,16,819,428,391
050,39,129,"Ohio","Pickaway County",1,17,784,409,375
050,39,129,"Ohio","Pickaway County",1,18,723,403,320
050,39,129,"Ohio","Pickaway County",1,19,680,397,283
050,39,129,"Ohio","Pickaway County",1,20,653,404,249
050,39,129,"Ohio","Pickaway County",1,21,731,437,294
050,39,129,"Ohio","Pickaway County",1,22,729,445,284
050,39,129,"Ohio","Pickaway County",1,23,737,422,315
050,39,129,"Ohio","Pickaway County",1,24,733,443,290
050,39,129,"Ohio","Pickaway County",1,25,709,421,288
050,39,129,"Ohio","Pickaway County",1,26,734,438,296
050,39,129,"Ohio","Pickaway County",1,27,813,471,342
050,39,129,"Ohio","Pickaway County",1,28,795,455,340
050,39,129,"Ohio","Pickaway County",1,29,810,473,337
050,39,129,"Ohio","Pickaway County",1,30,809,460,349
050,39,129,"Ohio","Pickaway County",1,31,809,438,371
050,39,129,"Ohio","Pickaway County",1,32,801,448,353
050,39,129,"Ohio","Pickaway County",1,33,770,443,327
050,39,129,"Ohio","Pickaway County",1,34,784,433,351
050,39,129,"Ohio","Pickaway County",1,35,785,447,338
050,39,129,"Ohio","Pickaway County",1,36,746,432,314
050,39,129,"Ohio","Pickaway County",1,37,800,448,352
050,39,129,"Ohio","Pickaway County",1,38,770,436,334
050,39,129,"Ohio","Pickaway County",1,39,815,441,374
050,39,129,"Ohio","Pickaway County",1,40,784,405,379
050,39,129,"Ohio","Pickaway County",1,41,781,418,363
050,39,129,"Ohio","Pickaway County",1,42,809,429,380
050,39,129,"Ohio","Pickaway County",1,43,801,435,366
050,39,129,"Ohio","Pickaway County",1,44,738,398,340
050,39,129,"Ohio","Pickaway County",1,45,763,425,338
050,39,129,"Ohio","Pickaway County",1,46,812,470,342
050,39,129,"Ohio","Pickaway County",1,47,779,443,336
050,39,129,"Ohio","Pickaway County",1,48,816,436,380
050,39,129,"Ohio","Pickaway County",1,49,871,465,406
050,39,129,"Ohio","Pickaway County",1,50,864,461,403
050,39,129,"Ohio","Pickaway County",1,51,846,460,386
050,39,129,"Ohio","Pickaway County",1,52,792,428,364
050,39,129,"Ohio","Pickaway County",1,53,792,437,355
050,39,129,"Ohio","Pickaway County",1,54,822,458,364
050,39,129,"Ohio","Pickaway County",1,55,859,465,394
050,39,129,"Ohio","Pickaway County",1,56,813,445,368
050,39,129,"Ohio","Pickaway County",1,57,777,397,380
050,39,129,"Ohio","Pickaway County",1,58,759,393,366
050,39,129,"Ohio","Pickaway County",1,59,762,399,363
050,39,129,"Ohio","Pickaway County",1,60,762,391,371
050,39,129,"Ohio","Pickaway County",1,61,794,399,395
050,39,129,"Ohio","Pickaway County",1,62,756,375,381
050,39,129,"Ohio","Pickaway County",1,63,753,366,387
050,39,129,"Ohio","Pickaway County",1,64,712,345,367
050,39,129,"Ohio","Pickaway County",1,65,706,345,361
050,39,129,"Ohio","Pickaway County",1,66,629,303,326
050,39,129,"Ohio","Pickaway County",1,67,599,279,320
050,39,129,"Ohio","Pickaway County",1,68,597,273,324
050,39,129,"Ohio","Pickaway County",1,69,561,266,295
050,39,129,"Ohio","Pickaway County",1,70,531,245,286
050,39,129,"Ohio","Pickaway County",1,71,511,236,275
050,39,129,"Ohio","Pickaway County",1,72,549,253,296
050,39,129,"Ohio","Pickaway County",1,73,556,267,289
050,39,129,"Ohio","Pickaway County",1,74,365,176,189
050,39,129,"Ohio","Pickaway County",1,75,342,154,188
050,39,129,"Ohio","Pickaway County",1,76,323,141,182
050,39,129,"Ohio","Pickaway County",1,77,349,158,191
050,39,129,"Ohio","Pickaway County",1,78,333,147,186
050,39,129,"Ohio","Pickaway County",1,79,282,129,153
050,39,129,"Ohio","Pickaway County",1,80,267,114,153
050,39,129,"Ohio","Pickaway County",1,81,237,102,135
050,39,129,"Ohio","Pickaway County",1,82,229,88,141
050,39,129,"Ohio","Pickaway County",1,83,220,77,143
050,39,129,"Ohio","Pickaway County",1,84,170,72,98
050,39,129,"Ohio","Pickaway County",1,85,989,364,625
050,39,129,"Ohio","Pickaway County",2,0,622,309,313
050,39,129,"Ohio","Pickaway County",2,1,617,314,303
050,39,129,"Ohio","Pickaway County",2,2,615,297,318
050,39,129,"Ohio","Pickaway County",2,3,647,323,324
050,39,129,"Ohio","Pickaway County",2,4,659,350,309
050,39,129,"Ohio","Pickaway County",2,5,700,358,342
050,39,129,"Ohio","Pickaway County",2,6,697,348,349
050,39,129,"Ohio","Pickaway County",2,7,703,351,352
050,39,129,"Ohio","Pickaway County",2,8,664,331,333
050,39,129,"Ohio","Pickaway County",2,9,659,327,332
050,39,129,"Ohio","Pickaway County",2,10,709,359,350
050,39,129,"Ohio","Pickaway County",2,11,743,385,358
050,39,129,"Ohio","Pickaway County",2,12,769,394,375
050,39,129,"Ohio","Pickaway County",2,13,773,387,386
050,39,129,"Ohio","Pickaway County",2,14,749,363,386
050,39,129,"Ohio","Pickaway County",2,15,742,379,363
050,39,129,"Ohio","Pickaway County",2,16,806,422,384
050,39,129,"Ohio","Pickaway County",2,17,796,418,378
050,39,129,"Ohio","Pickaway County",2,18,718,402,316
050,39,129,"Ohio","Pickaway County",2,19,679,395,284
050,39,129,"Ohio","Pickaway County",2,20,669,411,258
050,39,129,"Ohio","Pickaway County",2,21,716,432,284
050,39,129,"Ohio","Pickaway County",2,22,734,444,290
050,39,129,"Ohio","Pickaway County",2,23,739,431,308
050,39,129,"Ohio","Pickaway County",2,24,735,440,295
050,39,129,"Ohio","Pickaway County",2,25,711,423,288
050,39,129,"Ohio","Pickaway County",2,26,741,441,300
050,39,129,"Ohio","Pickaway County",2,27,793,461,332
050,39,129,"Ohio","Pickaway County",2,28,796,454,342
050,39,129,"Ohio","Pickaway County",2,29,814,472,342
050,39,129,"Ohio","Pickaway County",2,30,812,464,348
050,39,129,"Ohio","Pickaway County",2,31,814,447,367
050,39,129,"Ohio","Pickaway County",2,32,808,445,363
050,39,129,"Ohio","Pickaway County",2,33,779,444,335
050,39,129,"Ohio","Pickaway County",2,34,784,438,346
050,39,129,"Ohio","Pickaway County",2,35,793,448,345
050,39,129,"Ohio","Pickaway County",2,36,747,430,317
050,39,129,"Ohio","Pickaway County",2,37,791,448,343
050,39,129,"Ohio","Pickaway County",2,38,781,436,345
050,39,129,"Ohio","Pickaway County",2,39,814,448,366
050,39,129,"Ohio","Pickaway County",2,40,785,405,380
050,39,129,"Ohio","Pickaway County",2,41,789,422,367
050,39,129,"Ohio","Pickaway County",2,42,794,417,377
050,39,129,"Ohio","Pickaway County",2,43,818,444,374
050,39,129,"Ohio","Pickaway County",2,44,739,397,342
050,39,129,"Ohio","Pickaway County",2,45,765,423,342
050,39,129,"Ohio","Pickaway County",2,46,801,462,339
050,39,129,"Ohio","Pickaway County",2,47,777,440,337
050,39,129,"Ohio","Pickaway County",2,48,804,435,369
050,39,129,"Ohio","Pickaway County",2,49,861,458,403
050,39,129,"Ohio","Pickaway County",2,50,872,465,407
050,39,129,"Ohio","Pickaway County",2,51,849,460,389
050,39,129,"Ohio","Pickaway County",2,52,795,429,366
050,39,129,"Ohio","Pickaway County",2,53,792,435,357
050,39,129,"Ohio","Pickaway County",2,54,816,453,363
050,39,129,"Ohio","Pickaway County",2,55,847,461,386
050,39,129,"Ohio","Pickaway County",2,56,832,453,379
050,39,129,"Ohio","Pickaway County",2,57,785,407,378
050,39,129,"Ohio","Pickaway County",2,58,765,395,370
050,39,129,"Ohio","Pickaway County",2,59,770,402,368
050,39,129,"Ohio","Pickaway County",2,60,764,395,369
050,39,129,"Ohio","Pickaway County",2,61,779,391,388
050,39,129,"Ohio","Pickaway County",2,62,763,381,382
050,39,129,"Ohio","Pickaway County",2,63,760,371,389
050,39,129,"Ohio","Pickaway County",2,64,715,345,370
050,39,129,"Ohio","Pickaway County",2,65,704,343,361
050,39,129,"Ohio","Pickaway County",2,66,650,312,338
050,39,129,"Ohio","Pickaway County",2,67,595,277,318
050,39,129,"Ohio","Pickaway County",2,68,591,269,322
050,39,129,"Ohio","Pickaway County",2,69,567,266,301
050,39,129,"Ohio","Pickaway County",2,70,533,246,287
050,39,129,"Ohio","Pickaway County",2,71,511,232,279
050,39,129,"Ohio","Pickaway County",2,72,526,243,283
050,39,129,"Ohio","Pickaway County",2,73,581,275,306
050,39,129,"Ohio","Pickaway County",2,74,381,183,198
050,39,129,"Ohio","Pickaway County",2,75,340,153,187
050,39,129,"Ohio","Pickaway County",2,76,322,142,180
050,39,129,"Ohio","Pickaway County",2,77,349,156,193
050,39,129,"Ohio","Pickaway County",2,78,326,142,184
050,39,129,"Ohio","Pickaway County",2,79,289,131,158
050,39,129,"Ohio","Pickaway County",2,80,264,115,149
050,39,129,"Ohio","Pickaway County",2,81,245,107,138
050,39,129,"Ohio","Pickaway County",2,82,228,86,142
050,39,129,"Ohio","Pickaway County",2,83,218,76,142
050,39,129,"Ohio","Pickaway County",2,84,178,73,105
050,39,129,"Ohio","Pickaway County",2,85,983,363,620
050,39,129,"Ohio","Pickaway County",3,0,598,329,269
050,39,129,"Ohio","Pickaway County",3,1,633,323,310
050,39,129,"Ohio","Pickaway County",3,2,634,322,312
050,39,129,"Ohio","Pickaway County",3,3,635,299,336
050,39,129,"Ohio","Pickaway County",3,4,670,329,341
050,39,129,"Ohio","Pickaway County",3,5,658,351,307
050,39,129,"Ohio","Pickaway County",3,6,721,356,365
050,39,129,"Ohio","Pickaway County",3,7,719,355,364
050,39,129,"Ohio","Pickaway County",3,8,721,353,368
050,39,129,"Ohio","Pickaway County",3,9,667,332,335
050,39,129,"Ohio","Pickaway County",3,10,668,330,338
050,39,129,"Ohio","Pickaway County",3,11,727,372,355
050,39,129,"Ohio","Pickaway County",3,12,749,383,366
050,39,129,"Ohio","Pickaway County",3,13,783,409,374
050,39,129,"Ohio","Pickaway County",3,14,779,399,380
050,39,129,"Ohio","Pickaway County",3,15,790,384,406
050,39,129,"Ohio","Pickaway County",3,16,786,415,371
050,39,129,"Ohio","Pickaway County",3,17,837,446,391
050,39,129,"Ohio","Pickaway County",3,18,730,416,314
050,39,129,"Ohio","Pickaway County",3,19,630,357,273
050,39,129,"Ohio","Pickaway County",3,20,680,392,288
050,39,129,"Ohio","Pickaway County",3,21,696,422,274
050,39,129,"Ohio","Pickaway County",3,22,726,437,289
050,39,129,"Ohio","Pickaway County",3,23,739,454,285
050,39,129,"Ohio","Pickaway County",3,24,746,443,303
050,39,129,"Ohio","Pickaway County",3,25,723,423,300
050,39,129,"Ohio","Pickaway County",3,26,719,418,301
050,39,129,"Ohio","Pickaway County",3,27,755,425,330
050,39,129,"Ohio","Pickaway County",3,28,790,441,349
050,39,129,"Ohio","Pickaway County",3,29,821,471,350
050,39,129,"Ohio","Pickaway County",3,30,793,441,352
050,39,129,"Ohio","Pickaway County",3,31,828,472,356
050,39,129,"Ohio","Pickaway County",3,32,844,461,383
050,39,129,"Ohio","Pickaway County",3,33,792,425,367
050,39,129,"Ohio","Pickaway County",3,34,779,438,341
050,39,129,"Ohio","Pickaway County",3,35,792,443,349
050,39,129,"Ohio","Pickaway County",3,36,786,441,345
050,39,129,"Ohio","Pickaway County",3,37,770,434,336
050,39,129,"Ohio","Pickaway County",3,38,782,429,353
050,39,129,"Ohio","Pickaway County",3,39,816,457,359
050,39,129,"Ohio","Pickaway County",3,40,772,402,370
050,39,129,"Ohio","Pickaway County",3,41,801,427,374
050,39,129,"Ohio","Pickaway County",3,42,768,406,362
050,39,129,"Ohio","Pickaway County",3,43,823,443,380
050,39,129,"Ohio","Pickaway County",3,44,786,417,369
050,39,129,"Ohio","Pickaway County",3,45,748,411,337
050,39,129,"Ohio","Pickaway County",3,46,780,429,351
050,39,129,"Ohio","Pickaway County",3,47,783,444,339
050,39,129,"Ohio","Pickaway County",3,48,767,428,339
050,39,129,"Ohio","Pickaway County",3,49,787,412,375
050,39,129,"Ohio","Pickaway County",3,50,865,460,405
050,39,129,"Ohio","Pickaway County",3,51,854,454,400
050,39,129,"Ohio","Pickaway County",3,52,840,446,394
050,39,129,"Ohio","Pickaway County",3,53,794,422,372
050,39,129,"Ohio","Pickaway County",3,54,775,418,357
050,39,129,"Ohio","Pickaway County",3,55,814,438,376
050,39,129,"Ohio","Pickaway County",3,56,816,431,385
050,39,129,"Ohio","Pickaway County",3,57,812,441,371
050,39,129,"Ohio","Pickaway County",3,58,786,407,379
050,39,129,"Ohio","Pickaway County",3,59,773,404,369
050,39,129,"Ohio","Pickaway County",3,60,766,404,362
050,39,129,"Ohio","Pickaway County",3,61,744,383,361
050,39,129,"Ohio","Pickaway County",3,62,772,383,389
050,39,129,"Ohio","Pickaway County",3,63,753,379,374
050,39,129,"Ohio","Pickaway County",3,64,728,348,380
050,39,129,"Ohio","Pickaway County",3,65,697,336,361
050,39,129,"Ohio","Pickaway County",3,66,691,337,354
050,39,129,"Ohio","Pickaway County",3,67,631,299,332
050,39,129,"Ohio","Pickaway County",3,68,591,271,320
050,39,129,"Ohio","Pickaway County",3,69,582,264,318
050,39,129,"Ohio","Pickaway County",3,70,558,259,299
050,39,129,"Ohio","Pickaway County",3,71,506,223,283
050,39,129,"Ohio","Pickaway County",3,72,483,220,263
050,39,129,"Ohio","Pickaway County",3,73,508,230,278
050,39,129,"Ohio","Pickaway County",3,74,558,260,298
050,39,129,"Ohio","Pickaway County",3,75,373,175,198
050,39,129,"Ohio","Pickaway County",3,76,315,135,180
050,39,129,"Ohio","Pickaway County",3,77,314,138,176
050,39,129,"Ohio","Pickaway County",3,78,333,142,191
050,39,129,"Ohio","Pickaway County",3,79,283,120,163
050,39,129,"Ohio","Pickaway County",3,80,266,116,150
050,39,129,"Ohio","Pickaway County",3,81,252,116,136
050,39,129,"Ohio","Pickaway County",3,82,232,98,134
050,39,129,"Ohio","Pickaway County",3,83,211,72,139
050,39,129,"Ohio","Pickaway County",3,84,194,70,124
050,39,129,"Ohio","Pickaway County",3,85,968,352,616
050,39,129,"Ohio","Pickaway County",4,0,614,323,291
050,39,129,"Ohio","Pickaway County",4,1,647,355,292
050,39,129,"Ohio","Pickaway County",4,2,674,354,320
050,39,129,"Ohio","Pickaway County",4,3,680,346,334
050,39,129,"Ohio","Pickaway County",4,4,652,296,356
050,39,129,"Ohio","Pickaway County",4,5,687,331,356
050,39,129,"Ohio","Pickaway County",4,6,678,355,323
050,39,129,"Ohio","Pickaway County",4,7,748,370,378
050,39,129,"Ohio","Pickaway County",4,8,738,370,368
050,39,129,"Ohio","Pickaway County",4,9,747,370,377
050,39,129,"Ohio","Pickaway County",4,10,698,341,357
050,39,129,"Ohio","Pickaway County",4,11,696,357,339
050,39,129,"Ohio","Pickaway County",4,12,775,400,375
050,39,129,"Ohio","Pickaway County",4,13,765,396,369
050,39,129,"Ohio","Pickaway County",4,14,788,406,382
050,39,129,"Ohio","Pickaway County",4,15,824,433,391
050,39,129,"Ohio","Pickaway County",4,16,800,403,397
050,39,129,"Ohio","Pickaway County",4,17,801,427,374
050,39,129,"Ohio","Pickaway County",4,18,778,430,348
050,39,129,"Ohio","Pickaway County",4,19,653,382,271
050,39,129,"Ohio","Pickaway County",4,20,633,362,271
050,39,129,"Ohio","Pickaway County",4,21,690,401,289
050,39,129,"Ohio","Pickaway County",4,22,745,455,290
050,39,129,"Ohio","Pickaway County",4,23,781,471,310
050,39,129,"Ohio","Pickaway County",4,24,791,478,313
050,39,129,"Ohio","Pickaway County",4,25,756,442,314
050,39,129,"Ohio","Pickaway County",4,26,790,471,319
050,39,129,"Ohio","Pickaway County",4,27,739,433,306
050,39,129,"Ohio","Pickaway County",4,28,783,439,344
050,39,129,"Ohio","Pickaway County",4,29,842,468,374
050,39,129,"Ohio","Pickaway County",4,30,858,501,357
050,39,129,"Ohio","Pickaway County",4,31,847,472,375
050,39,129,"Ohio","Pickaway County",4,32,872,477,395
050,39,129,"Ohio","Pickaway County",4,33,848,447,401
050,39,129,"Ohio","Pickaway County",4,34,802,430,372
050,39,129,"Ohio","Pickaway County",4,35,842,478,364
050,39,129,"Ohio","Pickaway County",4,36,829,451,378
050,39,129,"Ohio","Pickaway County",4,37,817,464,353
050,39,129,"Ohio","Pickaway County",4,38,774,428,346
050,39,129,"Ohio","Pickaway County",4,39,847,476,371
050,39,129,"Ohio","Pickaway County",4,40,806,441,365
050,39,129,"Ohio","Pickaway County",4,41,801,434,367
050,39,129,"Ohio","Pickaway County",4,42,794,416,378
050,39,129,"Ohio","Pickaway County",4,43,799,438,361
050,39,129,"Ohio","Pickaway County",4,44,801,416,385
050,39,129,"Ohio","Pickaway County",4,45,799,428,371
050,39,129,"Ohio","Pickaway County",4,46,770,436,334
050,39,129,"Ohio","Pickaway County",4,47,784,423,361
050,39,129,"Ohio","Pickaway County",4,48,798,446,352
050,39,129,"Ohio","Pickaway County",4,49,776,428,348
050,39,129,"Ohio","Pickaway County",4,50,801,416,385
050,39,129,"Ohio","Pickaway County",4,51,881,481,400
050,39,129,"Ohio","Pickaway County",4,52,843,447,396
050,39,129,"Ohio","Pickaway County",4,53,841,442,399
050,39,129,"Ohio","Pickaway County",4,54,793,429,364
050,39,129,"Ohio","Pickaway County",4,55,781,412,369
050,39,129,"Ohio","Pickaway County",4,56,831,438,393
050,39,129,"Ohio","Pickaway County",4,57,839,447,392
050,39,129,"Ohio","Pickaway County",4,58,809,430,379
050,39,129,"Ohio","Pickaway County",4,59,796,408,388
050,39,129,"Ohio","Pickaway County",4,60,786,411,375
050,39,129,"Ohio","Pickaway County",4,61,752,403,349
050,39,129,"Ohio","Pickaway County",4,62,725,367,358
050,39,129,"Ohio","Pickaway County",4,63,759,379,380
050,39,129,"Ohio","Pickaway County",4,64,728,365,363
050,39,129,"Ohio","Pickaway County",4,65,712,338,374
050,39,129,"Ohio","Pickaway County",4,66,677,320,357
050,39,129,"Ohio","Pickaway County",4,67,679,330,349
050,39,129,"Ohio","Pickaway County",4,68,615,288,327
050,39,129,"Ohio","Pickaway County",4,69,586,274,312
050,39,129,"Ohio","Pickaway County",4,70,572,260,312
050,39,129,"Ohio","Pickaway County",4,71,542,249,293
050,39,129,"Ohio","Pickaway County",4,72,491,220,271
050,39,129,"Ohio","Pickaway County",4,73,474,220,254
050,39,129,"Ohio","Pickaway County",4,74,485,219,266
050,39,129,"Ohio","Pickaway County",4,75,537,244,293
050,39,129,"Ohio","Pickaway County",4,76,350,161,189
050,39,129,"Ohio","Pickaway County",4,77,298,133,165
050,39,129,"Ohio","Pickaway County",4,78,305,127,178
050,39,129,"Ohio","Pickaway County",4,79,296,123,173
050,39,129,"Ohio","Pickaway County",4,80,259,106,153
050,39,129,"Ohio","Pickaway County",4,81,263,114,149
050,39,129,"Ohio","Pickaway County",4,82,236,102,134
050,39,129,"Ohio","Pickaway County",4,83,216,87,129
050,39,129,"Ohio","Pickaway County",4,84,191,72,119
050,39,129,"Ohio","Pickaway County",4,85,1001,356,645
050,39,129,"Ohio","Pickaway County",5,0,617,326,291
050,39,129,"Ohio","Pickaway County",5,1,655,348,307
050,39,129,"Ohio","Pickaway County",5,2,679,367,312
050,39,129,"Ohio","Pickaway County",5,3,682,362,320
050,39,129,"Ohio","Pickaway County",5,4,697,349,348
050,39,129,"Ohio","Pickaway County",5,5,657,308,349
050,39,129,"Ohio","Pickaway County",5,6,732,355,377
050,39,129,"Ohio","Pickaway County",5,7,690,358,332
050,39,129,"Ohio","Pickaway County",5,8,762,373,389
050,39,129,"Ohio","Pickaway County",5,9,757,380,377
050,39,129,"Ohio","Pickaway County",5,10,773,383,390
050,39,129,"Ohio","Pickaway County",5,11,702,347,355
050,39,129,"Ohio","Pickaway County",5,12,711,357,354
050,39,129,"Ohio","Pickaway County",5,13,760,386,374
050,39,129,"Ohio","Pickaway County",5,14,803,414,389
050,39,129,"Ohio","Pickaway County",5,15,797,424,373
050,39,129,"Ohio","Pickaway County",5,16,833,439,394
050,39,129,"Ohio","Pickaway County",5,17,820,413,407
050,39,129,"Ohio","Pickaway County",5,18,752,439,313
050,39,129,"Ohio","Pickaway County",5,19,685,386,299
050,39,129,"Ohio","Pickaway County",5,20,679,394,285
050,39,129,"Ohio","Pickaway County",5,21,664,374,290
050,39,129,"Ohio","Pickaway County",5,22,739,433,306
050,39,129,"Ohio","Pickaway County",5,23,770,475,295
050,39,129,"Ohio","Pickaway County",5,24,824,511,313
050,39,129,"Ohio","Pickaway County",5,25,803,473,330
050,39,129,"Ohio","Pickaway County",5,26,820,491,329
050,39,129,"Ohio","Pickaway County",5,27,870,517,353
050,39,129,"Ohio","Pickaway County",5,28,777,459,318
050,39,129,"Ohio","Pickaway County",5,29,808,455,353
050,39,129,"Ohio","Pickaway County",5,30,876,485,391
050,39,129,"Ohio","Pickaway County",5,31,928,538,390
050,39,129,"Ohio","Pickaway County",5,32,867,482,385
050,39,129,"Ohio","Pickaway County",5,33,889,478,411
050,39,129,"Ohio","Pickaway County",5,34,867,451,416
050,39,129,"Ohio","Pickaway County",5,35,873,485,388
050,39,129,"Ohio","Pickaway County",5,36,855,480,375
050,39,129,"Ohio","Pickaway County",5,37,868,469,399
050,39,129,"Ohio","Pickaway County",5,38,826,458,368
050,39,129,"Ohio","Pickaway County",5,39,824,474,350
050,39,129,"Ohio","Pickaway County",5,40,813,451,362
050,39,129,"Ohio","Pickaway County",5,41,848,474,374
050,39,129,"Ohio","Pickaway County",5,42,787,419,368
050,39,129,"Ohio","Pickaway County",5,43,845,450,395
050,39,129,"Ohio","Pickaway County",5,44,793,426,367
050,39,129,"Ohio","Pickaway County",5,45,811,431,380
050,39,129,"Ohio","Pickaway County",5,46,825,455,370
050,39,129,"Ohio","Pickaway County",5,47,758,417,341
050,39,129,"Ohio","Pickaway County",5,48,788,427,361
050,39,129,"Ohio","Pickaway County",5,49,794,436,358
050,39,129,"Ohio","Pickaway County",5,50,795,440,355
050,39,129,"Ohio","Pickaway County",5,51,818,433,385
050,39,129,"Ohio","Pickaway County",5,52,880,470,410
050,39,129,"Ohio","Pickaway County",5,53,837,447,390
050,39,129,"Ohio","Pickaway County",5,54,835,440,395
050,39,129,"Ohio","Pickaway County",5,55,761,417,344
050,39,129,"Ohio","Pickaway County",5,56,761,398,363
050,39,129,"Ohio","Pickaway County",5,57,815,425,390
050,39,129,"Ohio","Pickaway County",5,58,826,430,396
050,39,129,"Ohio","Pickaway County",5,59,824,435,389
050,39,129,"Ohio","Pickaway County",5,60,805,416,389
050,39,129,"Ohio","Pickaway County",5,61,773,395,378
050,39,129,"Ohio","Pickaway County",5,62,752,408,344
050,39,129,"Ohio","Pickaway County",5,63,724,368,356
050,39,129,"Ohio","Pickaway County",5,64,749,369,380
050,39,129,"Ohio","Pickaway County",5,65,712,353,359
050,39,129,"Ohio","Pickaway County",5,66,721,340,381
050,39,129,"Ohio","Pickaway County",5,67,666,316,350
050,39,129,"Ohio","Pickaway County",5,68,675,326,349
050,39,129,"Ohio","Pickaway County",5,69,611,297,314
050,39,129,"Ohio","Pickaway County",5,70,573,269,304
050,39,129,"Ohio","Pickaway County",5,71,556,250,306
050,39,129,"Ohio","Pickaway County",5,72,523,240,283
050,39,129,"Ohio","Pickaway County",5,73,480,214,266
050,39,129,"Ohio","Pickaway County",5,74,463,212,251
050,39,129,"Ohio","Pickaway County",5,75,478,208,270
050,39,129,"Ohio","Pickaway County",5,76,514,229,285
050,39,129,"Ohio","Pickaway County",5,77,334,156,178
050,39,129,"Ohio","Pickaway County",5,78,291,123,168
050,39,129,"Ohio","Pickaway County",5,79,264,111,153
050,39,129,"Ohio","Pickaway County",5,80,272,105,167
050,39,129,"Ohio","Pickaway County",5,81,251,105,146
050,39,129,"Ohio","Pickaway County",5,82,242,100,142
050,39,129,"Ohio","Pickaway County",5,83,223,91,132
050,39,129,"Ohio","Pickaway County",5,84,194,84,110
050,39,129,"Ohio","Pickaway County",5,85,1035,365,670
050,39,131,"Ohio","Pike County",1,0,329,169,160
050,39,131,"Ohio","Pike County",1,1,311,152,159
050,39,131,"Ohio","Pike County",1,2,344,150,194
050,39,131,"Ohio","Pike County",1,3,342,161,181
050,39,131,"Ohio","Pike County",1,4,364,183,181
050,39,131,"Ohio","Pike County",1,5,326,163,163
050,39,131,"Ohio","Pike County",1,6,331,165,166
050,39,131,"Ohio","Pike County",1,7,340,182,158
050,39,131,"Ohio","Pike County",1,8,323,177,146
050,39,131,"Ohio","Pike County",1,9,330,180,150
050,39,131,"Ohio","Pike County",1,10,360,195,165
050,39,131,"Ohio","Pike County",1,11,367,188,179
050,39,131,"Ohio","Pike County",1,12,397,205,192
050,39,131,"Ohio","Pike County",1,13,404,215,189
050,39,131,"Ohio","Pike County",1,14,397,211,186
050,39,131,"Ohio","Pike County",1,15,391,208,183
050,39,131,"Ohio","Pike County",1,16,379,208,171
050,39,131,"Ohio","Pike County",1,17,398,212,186
050,39,131,"Ohio","Pike County",1,18,332,183,149
050,39,131,"Ohio","Pike County",1,19,280,162,118
050,39,131,"Ohio","Pike County",1,20,279,154,125
050,39,131,"Ohio","Pike County",1,21,280,152,128
050,39,131,"Ohio","Pike County",1,22,305,136,169
050,39,131,"Ohio","Pike County",1,23,310,149,161
050,39,131,"Ohio","Pike County",1,24,298,157,141
050,39,131,"Ohio","Pike County",1,25,337,177,160
050,39,131,"Ohio","Pike County",1,26,329,172,157
050,39,131,"Ohio","Pike County",1,27,296,149,147
050,39,131,"Ohio","Pike County",1,28,311,158,153
050,39,131,"Ohio","Pike County",1,29,354,184,170
050,39,131,"Ohio","Pike County",1,30,366,186,180
050,39,131,"Ohio","Pike County",1,31,312,150,162
050,39,131,"Ohio","Pike County",1,32,285,142,143
050,39,131,"Ohio","Pike County",1,33,292,143,149
050,39,131,"Ohio","Pike County",1,34,261,126,135
050,39,131,"Ohio","Pike County",1,35,271,131,140
050,39,131,"Ohio","Pike County",1,36,286,130,156
050,39,131,"Ohio","Pike County",1,37,330,158,172
050,39,131,"Ohio","Pike County",1,38,343,163,180
050,39,131,"Ohio","Pike County",1,39,325,163,162
050,39,131,"Ohio","Pike County",1,40,313,171,142
050,39,131,"Ohio","Pike County",1,41,305,156,149
050,39,131,"Ohio","Pike County",1,42,324,165,159
050,39,131,"Ohio","Pike County",1,43,322,177,145
050,39,131,"Ohio","Pike County",1,44,327,162,165
050,39,131,"Ohio","Pike County",1,45,351,158,193
050,39,131,"Ohio","Pike County",1,46,369,175,194
050,39,131,"Ohio","Pike County",1,47,373,189,184
050,39,131,"Ohio","Pike County",1,48,354,190,164
050,39,131,"Ohio","Pike County",1,49,375,198,177
050,39,131,"Ohio","Pike County",1,50,333,168,165
050,39,131,"Ohio","Pike County",1,51,335,177,158
050,39,131,"Ohio","Pike County",1,52,343,170,173
050,39,131,"Ohio","Pike County",1,53,368,184,184
050,39,131,"Ohio","Pike County",1,54,382,195,187
050,39,131,"Ohio","Pike County",1,55,382,190,192
050,39,131,"Ohio","Pike County",1,56,408,201,207
050,39,131,"Ohio","Pike County",1,57,389,193,196
050,39,131,"Ohio","Pike County",1,58,401,199,202
050,39,131,"Ohio","Pike County",1,59,390,193,197
050,39,131,"Ohio","Pike County",1,60,401,192,209
050,39,131,"Ohio","Pike County",1,61,405,206,199
050,39,131,"Ohio","Pike County",1,62,389,190,199
050,39,131,"Ohio","Pike County",1,63,377,184,193
050,39,131,"Ohio","Pike County",1,64,357,179,178
050,39,131,"Ohio","Pike County",1,65,340,170,170
050,39,131,"Ohio","Pike County",1,66,332,162,170
050,39,131,"Ohio","Pike County",1,67,332,171,161
050,39,131,"Ohio","Pike County",1,68,310,164,146
050,39,131,"Ohio","Pike County",1,69,274,138,136
050,39,131,"Ohio","Pike County",1,70,282,125,157
050,39,131,"Ohio","Pike County",1,71,259,121,138
050,39,131,"Ohio","Pike County",1,72,269,125,144
050,39,131,"Ohio","Pike County",1,73,271,122,149
050,39,131,"Ohio","Pike County",1,74,193,94,99
050,39,131,"Ohio","Pike County",1,75,188,90,98
050,39,131,"Ohio","Pike County",1,76,177,79,98
050,39,131,"Ohio","Pike County",1,77,182,77,105
050,39,131,"Ohio","Pike County",1,78,157,67,90
050,39,131,"Ohio","Pike County",1,79,145,66,79
050,39,131,"Ohio","Pike County",1,80,129,62,67
050,39,131,"Ohio","Pike County",1,81,141,63,78
050,39,131,"Ohio","Pike County",1,82,120,51,69
050,39,131,"Ohio","Pike County",1,83,96,40,56
050,39,131,"Ohio","Pike County",1,84,88,35,53
050,39,131,"Ohio","Pike County",1,85,517,195,322
050,39,131,"Ohio","Pike County",2,0,326,164,162
050,39,131,"Ohio","Pike County",2,1,315,154,161
050,39,131,"Ohio","Pike County",2,2,336,151,185
050,39,131,"Ohio","Pike County",2,3,346,160,186
050,39,131,"Ohio","Pike County",2,4,363,179,184
050,39,131,"Ohio","Pike County",2,5,336,170,166
050,39,131,"Ohio","Pike County",2,6,330,167,163
050,39,131,"Ohio","Pike County",2,7,335,177,158
050,39,131,"Ohio","Pike County",2,8,325,176,149
050,39,131,"Ohio","Pike County",2,9,328,179,149
050,39,131,"Ohio","Pike County",2,10,352,189,163
050,39,131,"Ohio","Pike County",2,11,365,190,175
050,39,131,"Ohio","Pike County",2,12,392,202,190
050,39,131,"Ohio","Pike County",2,13,403,213,190
050,39,131,"Ohio","Pike County",2,14,398,212,186
050,39,131,"Ohio","Pike County",2,15,391,207,184
050,39,131,"Ohio","Pike County",2,16,383,208,175
050,39,131,"Ohio","Pike County",2,17,394,211,183
050,39,131,"Ohio","Pike County",2,18,332,184,148
050,39,131,"Ohio","Pike County",2,19,276,158,118
050,39,131,"Ohio","Pike County",2,20,285,159,126
050,39,131,"Ohio","Pike County",2,21,284,154,130
050,39,131,"Ohio","Pike County",2,22,306,142,164
050,39,131,"Ohio","Pike County",2,23,312,149,163
050,39,131,"Ohio","Pike County",2,24,302,155,147
050,39,131,"Ohio","Pike County",2,25,329,174,155
050,39,131,"Ohio","Pike County",2,26,331,173,158
050,39,131,"Ohio","Pike County",2,27,304,155,149
050,39,131,"Ohio","Pike County",2,28,307,155,152
050,39,131,"Ohio","Pike County",2,29,345,179,166
050,39,131,"Ohio","Pike County",2,30,363,184,179
050,39,131,"Ohio","Pike County",2,31,321,157,164
050,39,131,"Ohio","Pike County",2,32,289,143,146
050,39,131,"Ohio","Pike County",2,33,287,142,145
050,39,131,"Ohio","Pike County",2,34,266,128,138
050,39,131,"Ohio","Pike County",2,35,273,132,141
050,39,131,"Ohio","Pike County",2,36,282,131,151
050,39,131,"Ohio","Pike County",2,37,321,152,169
050,39,131,"Ohio","Pike County",2,38,342,162,180
050,39,131,"Ohio","Pike County",2,39,329,165,164
050,39,131,"Ohio","Pike County",2,40,320,172,148
050,39,131,"Ohio","Pike County",2,41,307,160,147
050,39,131,"Ohio","Pike County",2,42,318,162,156
050,39,131,"Ohio","Pike County",2,43,322,174,148
050,39,131,"Ohio","Pike County",2,44,323,164,159
050,39,131,"Ohio","Pike County",2,45,348,161,187
050,39,131,"Ohio","Pike County",2,46,364,170,194
050,39,131,"Ohio","Pike County",2,47,367,183,184
050,39,131,"Ohio","Pike County",2,48,356,189,167
050,39,131,"Ohio","Pike County",2,49,370,198,172
050,39,131,"Ohio","Pike County",2,50,341,175,166
050,39,131,"Ohio","Pike County",2,51,332,172,160
050,39,131,"Ohio","Pike County",2,52,340,171,169
050,39,131,"Ohio","Pike County",2,53,362,181,181
050,39,131,"Ohio","Pike County",2,54,375,190,185
050,39,131,"Ohio","Pike County",2,55,382,190,192
050,39,131,"Ohio","Pike County",2,56,404,198,206
050,39,131,"Ohio","Pike County",2,57,395,196,199
050,39,131,"Ohio","Pike County",2,58,392,193,199
050,39,131,"Ohio","Pike County",2,59,397,197,200
050,39,131,"Ohio","Pike County",2,60,391,189,202
050,39,131,"Ohio","Pike County",2,61,401,202,199
050,39,131,"Ohio","Pike County",2,62,392,195,197
050,39,131,"Ohio","Pike County",2,63,382,186,196
050,39,131,"Ohio","Pike County",2,64,359,179,180
050,39,131,"Ohio","Pike County",2,65,344,171,173
050,39,131,"Ohio","Pike County",2,66,332,160,172
050,39,131,"Ohio","Pike County",2,67,331,169,162
050,39,131,"Ohio","Pike County",2,68,311,163,148
050,39,131,"Ohio","Pike County",2,69,284,144,140
050,39,131,"Ohio","Pike County",2,70,278,125,153
050,39,131,"Ohio","Pike County",2,71,263,120,143
050,39,131,"Ohio","Pike County",2,72,263,123,140
050,39,131,"Ohio","Pike County",2,73,284,129,155
050,39,131,"Ohio","Pike County",2,74,197,94,103
050,39,131,"Ohio","Pike County",2,75,190,91,99
050,39,131,"Ohio","Pike County",2,76,178,80,98
050,39,131,"Ohio","Pike County",2,77,179,78,101
050,39,131,"Ohio","Pike County",2,78,157,67,90
050,39,131,"Ohio","Pike County",2,79,147,65,82
050,39,131,"Ohio","Pike County",2,80,129,60,69
050,39,131,"Ohio","Pike County",2,81,136,62,74
050,39,131,"Ohio","Pike County",2,82,124,53,71
050,39,131,"Ohio","Pike County",2,83,99,42,57
050,39,131,"Ohio","Pike County",2,84,88,35,53
050,39,131,"Ohio","Pike County",2,85,514,194,320
050,39,131,"Ohio","Pike County",3,0,330,186,144
050,39,131,"Ohio","Pike County",3,1,325,158,167
050,39,131,"Ohio","Pike County",3,2,327,154,173
050,39,131,"Ohio","Pike County",3,3,334,147,187
050,39,131,"Ohio","Pike County",3,4,358,164,194
050,39,131,"Ohio","Pike County",3,5,361,182,179
050,39,131,"Ohio","Pike County",3,6,344,170,174
050,39,131,"Ohio","Pike County",3,7,338,172,166
050,39,131,"Ohio","Pike County",3,8,339,177,162
050,39,131,"Ohio","Pike County",3,9,344,183,161
050,39,131,"Ohio","Pike County",3,10,339,185,154
050,39,131,"Ohio","Pike County",3,11,364,196,168
050,39,131,"Ohio","Pike County",3,12,364,191,173
050,39,131,"Ohio","Pike County",3,13,398,197,201
050,39,131,"Ohio","Pike County",3,14,396,207,189
050,39,131,"Ohio","Pike County",3,15,407,222,185
050,39,131,"Ohio","Pike County",3,16,397,206,191
050,39,131,"Ohio","Pike County",3,17,390,213,177
050,39,131,"Ohio","Pike County",3,18,332,189,143
050,39,131,"Ohio","Pike County",3,19,250,137,113
050,39,131,"Ohio","Pike County",3,20,284,171,113
050,39,131,"Ohio","Pike County",3,21,290,164,126
050,39,131,"Ohio","Pike County",3,22,312,159,153
050,39,131,"Ohio","Pike County",3,23,319,147,172
050,39,131,"Ohio","Pike County",3,24,325,158,167
050,39,131,"Ohio","Pike County",3,25,299,157,142
050,39,131,"Ohio","Pike County",3,26,330,178,152
050,39,131,"Ohio","Pike County",3,27,340,181,159
050,39,131,"Ohio","Pike County",3,28,299,151,148
050,39,131,"Ohio","Pike County",3,29,326,168,158
050,39,131,"Ohio","Pike County",3,30,324,169,155
050,39,131,"Ohio","Pike County",3,31,355,187,168
050,39,131,"Ohio","Pike County",3,32,311,151,160
050,39,131,"Ohio","Pike County",3,33,298,144,154
050,39,131,"Ohio","Pike County",3,34,294,141,153
050,39,131,"Ohio","Pike County",3,35,277,134,143
050,39,131,"Ohio","Pike County",3,36,280,140,140
050,39,131,"Ohio","Pike County",3,37,269,126,143
050,39,131,"Ohio","Pike County",3,38,328,154,174
050,39,131,"Ohio","Pike County",3,39,336,161,175
050,39,131,"Ohio","Pike County",3,40,331,163,168
050,39,131,"Ohio","Pike County",3,41,315,165,150
050,39,131,"Ohio","Pike County",3,42,305,162,143
050,39,131,"Ohio","Pike County",3,43,326,164,162
050,39,131,"Ohio","Pike County",3,44,326,179,147
050,39,131,"Ohio","Pike County",3,45,315,156,159
050,39,131,"Ohio","Pike County",3,46,360,167,193
050,39,131,"Ohio","Pike County",3,47,365,170,195
050,39,131,"Ohio","Pike County",3,48,359,183,176
050,39,131,"Ohio","Pike County",3,49,356,189,167
050,39,131,"Ohio","Pike County",3,50,360,195,165
050,39,131,"Ohio","Pike County",3,51,334,169,165
050,39,131,"Ohio","Pike County",3,52,341,177,164
050,39,131,"Ohio","Pike County",3,53,335,174,161
050,39,131,"Ohio","Pike County",3,54,346,176,170
050,39,131,"Ohio","Pike County",3,55,372,182,190
050,39,131,"Ohio","Pike County",3,56,384,197,187
050,39,131,"Ohio","Pike County",3,57,398,198,200
050,39,131,"Ohio","Pike County",3,58,386,189,197
050,39,131,"Ohio","Pike County",3,59,394,191,203
050,39,131,"Ohio","Pike County",3,60,385,188,197
050,39,131,"Ohio","Pike County",3,61,382,186,196
050,39,131,"Ohio","Pike County",3,62,408,206,202
050,39,131,"Ohio","Pike County",3,63,394,193,201
050,39,131,"Ohio","Pike County",3,64,382,184,198
050,39,131,"Ohio","Pike County",3,65,348,177,171
050,39,131,"Ohio","Pike County",3,66,331,161,170
050,39,131,"Ohio","Pike County",3,67,330,159,171
050,39,131,"Ohio","Pike County",3,68,325,168,157
050,39,131,"Ohio","Pike County",3,69,296,154,142
050,39,131,"Ohio","Pike County",3,70,275,139,136
050,39,131,"Ohio","Pike County",3,71,265,119,146
050,39,131,"Ohio","Pike County",3,72,256,118,138
050,39,131,"Ohio","Pike County",3,73,254,116,138
050,39,131,"Ohio","Pike County",3,74,277,129,148
050,39,131,"Ohio","Pike County",3,75,185,90,95
050,39,131,"Ohio","Pike County",3,76,182,85,97
050,39,131,"Ohio","Pike County",3,77,175,80,95
050,39,131,"Ohio","Pike County",3,78,169,67,102
050,39,131,"Ohio","Pike County",3,79,146,60,86
050,39,131,"Ohio","Pike County",3,80,136,62,74
050,39,131,"Ohio","Pike County",3,81,118,52,66
050,39,131,"Ohio","Pike County",3,82,133,59,74
050,39,131,"Ohio","Pike County",3,83,112,51,61
050,39,131,"Ohio","Pike County",3,84,87,32,55
050,39,131,"Ohio","Pike County",3,85,502,192,310
050,39,131,"Ohio","Pike County",4,0,315,183,132
050,39,131,"Ohio","Pike County",4,1,311,170,141
050,39,131,"Ohio","Pike County",4,2,324,167,157
050,39,131,"Ohio","Pike County",4,3,323,155,168
050,39,131,"Ohio","Pike County",4,4,313,143,170
050,39,131,"Ohio","Pike County",4,5,353,165,188
050,39,131,"Ohio","Pike County",4,6,353,175,178
050,39,131,"Ohio","Pike County",4,7,347,175,172
050,39,131,"Ohio","Pike County",4,8,335,166,169
050,39,131,"Ohio","Pike County",4,9,341,179,162
050,39,131,"Ohio","Pike County",4,10,343,184,159
050,39,131,"Ohio","Pike County",4,11,348,184,164
050,39,131,"Ohio","Pike County",4,12,357,196,161
050,39,131,"Ohio","Pike County",4,13,372,196,176
050,39,131,"Ohio","Pike County",4,14,401,203,198
050,39,131,"Ohio","Pike County",4,15,403,212,191
050,39,131,"Ohio","Pike County",4,16,414,221,193
050,39,131,"Ohio","Pike County",4,17,410,219,191
050,39,131,"Ohio","Pike County",4,18,332,189,143
050,39,131,"Ohio","Pike County",4,19,269,147,122
050,39,131,"Ohio","Pike County",4,20,262,142,120
050,39,131,"Ohio","Pike County",4,21,304,177,127
050,39,131,"Ohio","Pike County",4,22,306,165,141
050,39,131,"Ohio","Pike County",4,23,321,163,158
050,39,131,"Ohio","Pike County",4,24,321,145,176
050,39,131,"Ohio","Pike County",4,25,331,164,167
050,39,131,"Ohio","Pike County",4,26,291,154,137
050,39,131,"Ohio","Pike County",4,27,335,185,150
050,39,131,"Ohio","Pike County",4,28,330,187,143
050,39,131,"Ohio","Pike County",4,29,291,154,137
050,39,131,"Ohio","Pike County",4,30,316,162,154
050,39,131,"Ohio","Pike County",4,31,319,167,152
050,39,131,"Ohio","Pike County",4,32,348,184,164
050,39,131,"Ohio","Pike County",4,33,320,156,164
050,39,131,"Ohio","Pike County",4,34,296,144,152
050,39,131,"Ohio","Pike County",4,35,293,136,157
050,39,131,"Ohio","Pike County",4,36,288,142,146
050,39,131,"Ohio","Pike County",4,37,272,135,137
050,39,131,"Ohio","Pike County",4,38,269,128,141
050,39,131,"Ohio","Pike County",4,39,322,151,171
050,39,131,"Ohio","Pike County",4,40,333,168,165
050,39,131,"Ohio","Pike County",4,41,339,169,170
050,39,131,"Ohio","Pike County",4,42,319,160,159
050,39,131,"Ohio","Pike County",4,43,312,159,153
050,39,131,"Ohio","Pike County",4,44,326,167,159
050,39,131,"Ohio","Pike County",4,45,314,174,140
050,39,131,"Ohio","Pike County",4,46,329,171,158
050,39,131,"Ohio","Pike County",4,47,361,163,198
050,39,131,"Ohio","Pike County",4,48,353,166,187
050,39,131,"Ohio","Pike County",4,49,355,184,171
050,39,131,"Ohio","Pike County",4,50,352,182,170
050,39,131,"Ohio","Pike County",4,51,357,191,166
050,39,131,"Ohio","Pike County",4,52,348,174,174
050,39,131,"Ohio","Pike County",4,53,344,178,166
050,39,131,"Ohio","Pike County",4,54,333,176,157
050,39,131,"Ohio","Pike County",4,55,355,177,178
050,39,131,"Ohio","Pike County",4,56,369,181,188
050,39,131,"Ohio","Pike County",4,57,397,203,194
050,39,131,"Ohio","Pike County",4,58,385,191,194
050,39,131,"Ohio","Pike County",4,59,393,194,199
050,39,131,"Ohio","Pike County",4,60,377,183,194
050,39,131,"Ohio","Pike County",4,61,379,187,192
050,39,131,"Ohio","Pike County",4,62,384,190,194
050,39,131,"Ohio","Pike County",4,63,395,190,205
050,39,131,"Ohio","Pike County",4,64,393,191,202
050,39,131,"Ohio","Pike County",4,65,366,174,192
050,39,131,"Ohio","Pike County",4,66,329,164,165
050,39,131,"Ohio","Pike County",4,67,334,166,168
050,39,131,"Ohio","Pike County",4,68,319,148,171
050,39,131,"Ohio","Pike County",4,69,320,163,157
050,39,131,"Ohio","Pike County",4,70,279,142,137
050,39,131,"Ohio","Pike County",4,71,263,130,133
050,39,131,"Ohio","Pike County",4,72,269,124,145
050,39,131,"Ohio","Pike County",4,73,244,114,130
050,39,131,"Ohio","Pike County",4,74,247,114,133
050,39,131,"Ohio","Pike County",4,75,267,123,144
050,39,131,"Ohio","Pike County",4,76,186,85,101
050,39,131,"Ohio","Pike County",4,77,176,82,94
050,39,131,"Ohio","Pike County",4,78,166,73,93
050,39,131,"Ohio","Pike County",4,79,153,61,92
050,39,131,"Ohio","Pike County",4,80,136,59,77
050,39,131,"Ohio","Pike County",4,81,125,51,74
050,39,131,"Ohio","Pike County",4,82,120,50,70
050,39,131,"Ohio","Pike County",4,83,118,57,61
050,39,131,"Ohio","Pike County",4,84,103,47,56
050,39,131,"Ohio","Pike County",4,85,491,185,306
050,39,131,"Ohio","Pike County",5,0,309,180,129
050,39,131,"Ohio","Pike County",5,1,320,179,141
050,39,131,"Ohio","Pike County",5,2,308,173,135
050,39,131,"Ohio","Pike County",5,3,329,172,157
050,39,131,"Ohio","Pike County",5,4,329,156,173
050,39,131,"Ohio","Pike County",5,5,316,149,167
050,39,131,"Ohio","Pike County",5,6,355,167,188
050,39,131,"Ohio","Pike County",5,7,357,173,184
050,39,131,"Ohio","Pike County",5,8,370,190,180
050,39,131,"Ohio","Pike County",5,9,337,171,166
050,39,131,"Ohio","Pike County",5,10,344,173,171
050,39,131,"Ohio","Pike County",5,11,348,189,159
050,39,131,"Ohio","Pike County",5,12,349,190,159
050,39,131,"Ohio","Pike County",5,13,358,195,163
050,39,131,"Ohio","Pike County",5,14,383,198,185
050,39,131,"Ohio","Pike County",5,15,396,199,197
050,39,131,"Ohio","Pike County",5,16,401,215,186
050,39,131,"Ohio","Pike County",5,17,409,220,189
050,39,131,"Ohio","Pike County",5,18,343,190,153
050,39,131,"Ohio","Pike County",5,19,256,139,117
050,39,131,"Ohio","Pike County",5,20,294,160,134
050,39,131,"Ohio","Pike County",5,21,285,153,132
050,39,131,"Ohio","Pike County",5,22,321,181,140
050,39,131,"Ohio","Pike County",5,23,328,172,156
050,39,131,"Ohio","Pike County",5,24,327,172,155
050,39,131,"Ohio","Pike County",5,25,313,151,162
050,39,131,"Ohio","Pike County",5,26,320,155,165
050,39,131,"Ohio","Pike County",5,27,303,168,135
050,39,131,"Ohio","Pike County",5,28,337,189,148
050,39,131,"Ohio","Pike County",5,29,339,181,158
050,39,131,"Ohio","Pike County",5,30,292,150,142
050,39,131,"Ohio","Pike County",5,31,310,161,149
050,39,131,"Ohio","Pike County",5,32,321,165,156
050,39,131,"Ohio","Pike County",5,33,343,178,165
050,39,131,"Ohio","Pike County",5,34,324,159,165
050,39,131,"Ohio","Pike County",5,35,298,144,154
050,39,131,"Ohio","Pike County",5,36,292,139,153
050,39,131,"Ohio","Pike County",5,37,289,141,148
050,39,131,"Ohio","Pike County",5,38,269,133,136
050,39,131,"Ohio","Pike County",5,39,282,134,148
050,39,131,"Ohio","Pike County",5,40,319,154,165
050,39,131,"Ohio","Pike County",5,41,335,172,163
050,39,131,"Ohio","Pike County",5,42,332,163,169
050,39,131,"Ohio","Pike County",5,43,324,162,162
050,39,131,"Ohio","Pike County",5,44,308,164,144
050,39,131,"Ohio","Pike County",5,45,317,163,154
050,39,131,"Ohio","Pike County",5,46,330,180,150
050,39,131,"Ohio","Pike County",5,47,318,165,153
050,39,131,"Ohio","Pike County",5,48,349,158,191
050,39,131,"Ohio","Pike County",5,49,346,167,179
050,39,131,"Ohio","Pike County",5,50,347,178,169
050,39,131,"Ohio","Pike County",5,51,354,179,175
050,39,131,"Ohio","Pike County",5,52,361,196,165
050,39,131,"Ohio","Pike County",5,53,343,170,173
050,39,131,"Ohio","Pike County",5,54,338,179,159
050,39,131,"Ohio","Pike County",5,55,337,173,164
050,39,131,"Ohio","Pike County",5,56,345,174,171
050,39,131,"Ohio","Pike County",5,57,372,178,194
050,39,131,"Ohio","Pike County",5,58,389,201,188
050,39,131,"Ohio","Pike County",5,59,389,189,200
050,39,131,"Ohio","Pike County",5,60,380,188,192
050,39,131,"Ohio","Pike County",5,61,377,183,194
050,39,131,"Ohio","Pike County",5,62,373,184,189
050,39,131,"Ohio","Pike County",5,63,376,180,196
050,39,131,"Ohio","Pike County",5,64,396,197,199
050,39,131,"Ohio","Pike County",5,65,369,178,191
050,39,131,"Ohio","Pike County",5,66,356,166,190
050,39,131,"Ohio","Pike County",5,67,327,163,164
050,39,131,"Ohio","Pike County",5,68,335,161,174
050,39,131,"Ohio","Pike County",5,69,318,146,172
050,39,131,"Ohio","Pike County",5,70,310,157,153
050,39,131,"Ohio","Pike County",5,71,271,136,135
050,39,131,"Ohio","Pike County",5,72,259,129,130
050,39,131,"Ohio","Pike County",5,73,249,115,134
050,39,131,"Ohio","Pike County",5,74,239,110,129
050,39,131,"Ohio","Pike County",5,75,237,108,129
050,39,131,"Ohio","Pike County",5,76,266,118,148
050,39,131,"Ohio","Pike County",5,77,178,81,97
050,39,131,"Ohio","Pike County",5,78,163,74,89
050,39,131,"Ohio","Pike County",5,79,155,67,88
050,39,131,"Ohio","Pike County",5,80,140,58,82
050,39,131,"Ohio","Pike County",5,81,124,50,74
050,39,131,"Ohio","Pike County",5,82,124,47,77
050,39,131,"Ohio","Pike County",5,83,111,50,61
050,39,131,"Ohio","Pike County",5,84,108,50,58
050,39,131,"Ohio","Pike County",5,85,503,188,315
050,39,133,"Ohio","Portage County",1,0,1328,679,649
050,39,133,"Ohio","Portage County",1,1,1400,710,690
050,39,133,"Ohio","Portage County",1,2,1420,734,686
050,39,133,"Ohio","Portage County",1,3,1438,753,685
050,39,133,"Ohio","Portage County",1,4,1493,823,670
050,39,133,"Ohio","Portage County",1,5,1599,826,773
050,39,133,"Ohio","Portage County",1,6,1668,846,822
050,39,133,"Ohio","Portage County",1,7,1569,827,742
050,39,133,"Ohio","Portage County",1,8,1573,827,746
050,39,133,"Ohio","Portage County",1,9,1644,824,820
050,39,133,"Ohio","Portage County",1,10,1675,844,831
050,39,133,"Ohio","Portage County",1,11,1787,903,884
050,39,133,"Ohio","Portage County",1,12,1907,974,933
050,39,133,"Ohio","Portage County",1,13,1883,970,913
050,39,133,"Ohio","Portage County",1,14,1843,942,901
050,39,133,"Ohio","Portage County",1,15,1871,944,927
050,39,133,"Ohio","Portage County",1,16,1949,993,956
050,39,133,"Ohio","Portage County",1,17,1948,966,982
050,39,133,"Ohio","Portage County",1,18,2909,1282,1627
050,39,133,"Ohio","Portage County",1,19,4423,1945,2478
050,39,133,"Ohio","Portage County",1,20,4402,1861,2541
050,39,133,"Ohio","Portage County",1,21,4380,2017,2363
050,39,133,"Ohio","Portage County",1,22,3668,1774,1894
050,39,133,"Ohio","Portage County",1,23,3134,1568,1566
050,39,133,"Ohio","Portage County",1,24,2514,1265,1249
050,39,133,"Ohio","Portage County",1,25,2260,1158,1102
050,39,133,"Ohio","Portage County",1,26,2035,1076,959
050,39,133,"Ohio","Portage County",1,27,1963,1025,938
050,39,133,"Ohio","Portage County",1,28,1882,962,920
050,39,133,"Ohio","Portage County",1,29,1816,926,890
050,39,133,"Ohio","Portage County",1,30,1780,919,861
050,39,133,"Ohio","Portage County",1,31,1734,899,835
050,39,133,"Ohio","Portage County",1,32,1680,849,831
050,39,133,"Ohio","Portage County",1,33,1704,843,861
050,39,133,"Ohio","Portage County",1,34,1731,891,840
050,39,133,"Ohio","Portage County",1,35,1725,891,834
050,39,133,"Ohio","Portage County",1,36,1780,918,862
050,39,133,"Ohio","Portage County",1,37,1818,932,886
050,39,133,"Ohio","Portage County",1,38,1764,904,860
050,39,133,"Ohio","Portage County",1,39,1864,968,896
050,39,133,"Ohio","Portage County",1,40,1785,907,878
050,39,133,"Ohio","Portage County",1,41,1776,900,876
050,39,133,"Ohio","Portage County",1,42,1718,857,861
050,39,133,"Ohio","Portage County",1,43,1701,840,861
050,39,133,"Ohio","Portage County",1,44,1654,820,834
050,39,133,"Ohio","Portage County",1,45,1673,829,844
050,39,133,"Ohio","Portage County",1,46,1670,830,840
050,39,133,"Ohio","Portage County",1,47,1853,917,936
050,39,133,"Ohio","Portage County",1,48,1933,973,960
050,39,133,"Ohio","Portage County",1,49,2170,1118,1052
050,39,133,"Ohio","Portage County",1,50,2126,1057,1069
050,39,133,"Ohio","Portage County",1,51,2031,998,1033
050,39,133,"Ohio","Portage County",1,52,1995,1015,980
050,39,133,"Ohio","Portage County",1,53,2022,1001,1021
050,39,133,"Ohio","Portage County",1,54,2111,1020,1091
050,39,133,"Ohio","Portage County",1,55,2195,1068,1127
050,39,133,"Ohio","Portage County",1,56,2304,1137,1167
050,39,133,"Ohio","Portage County",1,57,2325,1177,1148
050,39,133,"Ohio","Portage County",1,58,2441,1247,1194
050,39,133,"Ohio","Portage County",1,59,2370,1155,1215
050,39,133,"Ohio","Portage County",1,60,2287,1120,1167
050,39,133,"Ohio","Portage County",1,61,2353,1171,1182
050,39,133,"Ohio","Portage County",1,62,2422,1207,1215
050,39,133,"Ohio","Portage County",1,63,2292,1176,1116
050,39,133,"Ohio","Portage County",1,64,2100,1050,1050
050,39,133,"Ohio","Portage County",1,65,2133,1050,1083
050,39,133,"Ohio","Portage County",1,66,2000,1007,993
050,39,133,"Ohio","Portage County",1,67,1945,943,1002
050,39,133,"Ohio","Portage County",1,68,1822,883,939
050,39,133,"Ohio","Portage County",1,69,1639,794,845
050,39,133,"Ohio","Portage County",1,70,1646,788,858
050,39,133,"Ohio","Portage County",1,71,1556,717,839
050,39,133,"Ohio","Portage County",1,72,1576,755,821
050,39,133,"Ohio","Portage County",1,73,1607,789,818
050,39,133,"Ohio","Portage County",1,74,1036,507,529
050,39,133,"Ohio","Portage County",1,75,1061,506,555
050,39,133,"Ohio","Portage County",1,76,1121,529,592
050,39,133,"Ohio","Portage County",1,77,1086,482,604
050,39,133,"Ohio","Portage County",1,78,926,418,508
050,39,133,"Ohio","Portage County",1,79,791,371,420
050,39,133,"Ohio","Portage County",1,80,674,287,387
050,39,133,"Ohio","Portage County",1,81,641,284,357
050,39,133,"Ohio","Portage County",1,82,603,275,328
050,39,133,"Ohio","Portage County",1,83,526,235,291
050,39,133,"Ohio","Portage County",1,84,483,212,271
050,39,133,"Ohio","Portage County",1,85,2656,1020,1636
050,39,133,"Ohio","Portage County",2,0,1336,685,651
050,39,133,"Ohio","Portage County",2,1,1380,701,679
050,39,133,"Ohio","Portage County",2,2,1413,730,683
050,39,133,"Ohio","Portage County",2,3,1430,750,680
050,39,133,"Ohio","Portage County",2,4,1491,811,680
050,39,133,"Ohio","Portage County",2,5,1585,830,755
050,39,133,"Ohio","Portage County",2,6,1663,847,816
050,39,133,"Ohio","Portage County",2,7,1595,830,765
050,39,133,"Ohio","Portage County",2,8,1575,824,751
050,39,133,"Ohio","Portage County",2,9,1623,822,801
050,39,133,"Ohio","Portage County",2,10,1671,839,832
050,39,133,"Ohio","Portage County",2,11,1758,885,873
050,39,133,"Ohio","Portage County",2,12,1880,956,924
050,39,133,"Ohio","Portage County",2,13,1886,968,918
050,39,133,"Ohio","Portage County",2,14,1848,944,904
050,39,133,"Ohio","Portage County",2,15,1866,948,918
050,39,133,"Ohio","Portage County",2,16,1930,984,946
050,39,133,"Ohio","Portage County",2,17,1957,976,981
050,39,133,"Ohio","Portage County",2,18,2886,1268,1618
050,39,133,"Ohio","Portage County",2,19,4414,1933,2481
050,39,133,"Ohio","Portage County",2,20,4443,1878,2565
050,39,133,"Ohio","Portage County",2,21,4364,2009,2355
050,39,133,"Ohio","Portage County",2,22,3642,1767,1875
050,39,133,"Ohio","Portage County",2,23,3138,1563,1575
050,39,133,"Ohio","Portage County",2,24,2501,1259,1242
050,39,133,"Ohio","Portage County",2,25,2284,1161,1123
050,39,133,"Ohio","Portage County",2,26,2049,1077,972
050,39,133,"Ohio","Portage County",2,27,1945,1021,924
050,39,133,"Ohio","Portage County",2,28,1901,974,927
050,39,133,"Ohio","Portage County",2,29,1831,934,897
050,39,133,"Ohio","Portage County",2,30,1803,927,876
050,39,133,"Ohio","Portage County",2,31,1747,903,844
050,39,133,"Ohio","Portage County",2,32,1694,860,834
050,39,133,"Ohio","Portage County",2,33,1694,845,849
050,39,133,"Ohio","Portage County",2,34,1727,882,845
050,39,133,"Ohio","Portage County",2,35,1740,898,842
050,39,133,"Ohio","Portage County",2,36,1760,907,853
050,39,133,"Ohio","Portage County",2,37,1812,929,883
050,39,133,"Ohio","Portage County",2,38,1788,916,872
050,39,133,"Ohio","Portage County",2,39,1840,953,887
050,39,133,"Ohio","Portage County",2,40,1819,930,889
050,39,133,"Ohio","Portage County",2,41,1779,902,877
050,39,133,"Ohio","Portage County",2,42,1728,864,864
050,39,133,"Ohio","Portage County",2,43,1715,845,870
050,39,133,"Ohio","Portage County",2,44,1649,819,830
050,39,133,"Ohio","Portage County",2,45,1677,834,843
050,39,133,"Ohio","Portage County",2,46,1666,825,841
050,39,133,"Ohio","Portage County",2,47,1797,889,908
050,39,133,"Ohio","Portage County",2,48,1914,960,954
050,39,133,"Ohio","Portage County",2,49,2127,1095,1032
050,39,133,"Ohio","Portage County",2,50,2140,1069,1071
050,39,133,"Ohio","Portage County",2,51,2042,1006,1036
050,39,133,"Ohio","Portage County",2,52,2003,1010,993
050,39,133,"Ohio","Portage County",2,53,2016,1004,1012
050,39,133,"Ohio","Portage County",2,54,2084,1015,1069
050,39,133,"Ohio","Portage County",2,55,2179,1059,1120
050,39,133,"Ohio","Portage County",2,56,2284,1127,1157
050,39,133,"Ohio","Portage County",2,57,2328,1174,1154
050,39,133,"Ohio","Portage County",2,58,2409,1225,1184
050,39,133,"Ohio","Portage County",2,59,2394,1182,1212
050,39,133,"Ohio","Portage County",2,60,2294,1121,1173
050,39,133,"Ohio","Portage County",2,61,2328,1154,1174
050,39,133,"Ohio","Portage County",2,62,2400,1197,1203
050,39,133,"Ohio","Portage County",2,63,2337,1190,1147
050,39,133,"Ohio","Portage County",2,64,2134,1074,1060
050,39,133,"Ohio","Portage County",2,65,2115,1040,1075
050,39,133,"Ohio","Portage County",2,66,2030,1015,1015
050,39,133,"Ohio","Portage County",2,67,1947,948,999
050,39,133,"Ohio","Portage County",2,68,1825,887,938
050,39,133,"Ohio","Portage County",2,69,1697,822,875
050,39,133,"Ohio","Portage County",2,70,1629,785,844
050,39,133,"Ohio","Portage County",2,71,1572,730,842
050,39,133,"Ohio","Portage County",2,72,1535,729,806
050,39,133,"Ohio","Portage County",2,73,1657,807,850
050,39,133,"Ohio","Portage County",2,74,1092,535,557
050,39,133,"Ohio","Portage County",2,75,1053,505,548
050,39,133,"Ohio","Portage County",2,76,1092,519,573
050,39,133,"Ohio","Portage County",2,77,1113,501,612
050,39,133,"Ohio","Portage County",2,78,943,423,520
050,39,133,"Ohio","Portage County",2,79,814,376,438
050,39,133,"Ohio","Portage County",2,80,688,300,388
050,39,133,"Ohio","Portage County",2,81,642,283,359
050,39,133,"Ohio","Portage County",2,82,601,268,333
050,39,133,"Ohio","Portage County",2,83,537,243,294
050,39,133,"Ohio","Portage County",2,84,482,211,271
050,39,133,"Ohio","Portage County",2,85,2656,1024,1632
050,39,133,"Ohio","Portage County",3,0,1320,682,638
050,39,133,"Ohio","Portage County",3,1,1368,708,660
050,39,133,"Ohio","Portage County",3,2,1440,713,727
050,39,133,"Ohio","Portage County",3,3,1465,760,705
050,39,133,"Ohio","Portage County",3,4,1466,773,693
050,39,133,"Ohio","Portage County",3,5,1519,832,687
050,39,133,"Ohio","Portage County",3,6,1619,844,775
050,39,133,"Ohio","Portage County",3,7,1700,863,837
050,39,133,"Ohio","Portage County",3,8,1602,835,767
050,39,133,"Ohio","Portage County",3,9,1596,838,758
050,39,133,"Ohio","Portage County",3,10,1661,853,808
050,39,133,"Ohio","Portage County",3,11,1691,849,842
050,39,133,"Ohio","Portage County",3,12,1732,883,849
050,39,133,"Ohio","Portage County",3,13,1921,962,959
050,39,133,"Ohio","Portage County",3,14,1889,976,913
050,39,133,"Ohio","Portage County",3,15,1846,936,910
050,39,133,"Ohio","Portage County",3,16,1870,948,922
050,39,133,"Ohio","Portage County",3,17,1933,978,955
050,39,133,"Ohio","Portage County",3,18,2248,1062,1186
050,39,133,"Ohio","Portage County",3,19,2977,1356,1621
050,39,133,"Ohio","Portage County",3,20,3691,1548,2143
050,39,133,"Ohio","Portage County",3,21,4056,1861,2195
050,39,133,"Ohio","Portage County",3,22,3449,1685,1764
050,39,133,"Ohio","Portage County",3,23,3085,1578,1507
050,39,133,"Ohio","Portage County",3,24,2510,1266,1244
050,39,133,"Ohio","Portage County",3,25,2306,1146,1160
050,39,133,"Ohio","Portage County",3,26,2045,1043,1002
050,39,133,"Ohio","Portage County",3,27,1854,971,883
050,39,133,"Ohio","Portage County",3,28,1940,997,943
050,39,133,"Ohio","Portage County",3,29,1896,970,926
050,39,133,"Ohio","Portage County",3,30,1809,939,870
050,39,133,"Ohio","Portage County",3,31,1833,950,883
050,39,133,"Ohio","Portage County",3,32,1738,897,841
050,39,133,"Ohio","Portage County",3,33,1698,845,853
050,39,133,"Ohio","Portage County",3,34,1730,871,859
050,39,133,"Ohio","Portage County",3,35,1769,908,861
050,39,133,"Ohio","Portage County",3,36,1800,940,860
050,39,133,"Ohio","Portage County",3,37,1764,888,876
050,39,133,"Ohio","Portage County",3,38,1824,925,899
050,39,133,"Ohio","Portage County",3,39,1792,919,873
050,39,133,"Ohio","Portage County",3,40,1840,956,884
050,39,133,"Ohio","Portage County",3,41,1835,931,904
050,39,133,"Ohio","Portage County",3,42,1783,907,876
050,39,133,"Ohio","Portage County",3,43,1741,860,881
050,39,133,"Ohio","Portage County",3,44,1722,861,861
050,39,133,"Ohio","Portage County",3,45,1669,835,834
050,39,133,"Ohio","Portage County",3,46,1684,834,850
050,39,133,"Ohio","Portage County",3,47,1676,845,831
050,39,133,"Ohio","Portage County",3,48,1791,882,909
050,39,133,"Ohio","Portage County",3,49,1951,1009,942
050,39,133,"Ohio","Portage County",3,50,2132,1076,1056
050,39,133,"Ohio","Portage County",3,51,2147,1066,1081
050,39,133,"Ohio","Portage County",3,52,2057,998,1059
050,39,133,"Ohio","Portage County",3,53,2024,1018,1006
050,39,133,"Ohio","Portage County",3,54,2015,1006,1009
050,39,133,"Ohio","Portage County",3,55,2084,1015,1069
050,39,133,"Ohio","Portage County",3,56,2159,1064,1095
050,39,133,"Ohio","Portage County",3,57,2287,1133,1154
050,39,133,"Ohio","Portage County",3,58,2340,1165,1175
050,39,133,"Ohio","Portage County",3,59,2422,1236,1186
050,39,133,"Ohio","Portage County",3,60,2376,1173,1203
050,39,133,"Ohio","Portage County",3,61,2272,1098,1174
050,39,133,"Ohio","Portage County",3,62,2343,1160,1183
050,39,133,"Ohio","Portage County",3,63,2383,1182,1201
050,39,133,"Ohio","Portage County",3,64,2281,1154,1127
050,39,133,"Ohio","Portage County",3,65,2117,1067,1050
050,39,133,"Ohio","Portage County",3,66,2094,1024,1070
050,39,133,"Ohio","Portage County",3,67,2016,999,1017
050,39,133,"Ohio","Portage County",3,68,1916,935,981
050,39,133,"Ohio","Portage County",3,69,1812,875,937
050,39,133,"Ohio","Portage County",3,70,1658,806,852
050,39,133,"Ohio","Portage County",3,71,1599,759,840
050,39,133,"Ohio","Portage County",3,72,1541,710,831
050,39,133,"Ohio","Portage County",3,73,1481,699,782
050,39,133,"Ohio","Portage County",3,74,1615,783,832
050,39,133,"Ohio","Portage County",3,75,1062,510,552
050,39,133,"Ohio","Portage County",3,76,1026,494,532
050,39,133,"Ohio","Portage County",3,77,1051,501,550
050,39,133,"Ohio","Portage County",3,78,1076,477,599
050,39,133,"Ohio","Portage County",3,79,903,400,503
050,39,133,"Ohio","Portage County",3,80,760,351,409
050,39,133,"Ohio","Portage County",3,81,651,291,360
050,39,133,"Ohio","Portage County",3,82,588,248,340
050,39,133,"Ohio","Portage County",3,83,561,243,318
050,39,133,"Ohio","Portage County",3,84,462,216,246
050,39,133,"Ohio","Portage County",3,85,2621,1022,1599
050,39,133,"Ohio","Portage County",4,0,1360,669,691
050,39,133,"Ohio","Portage County",4,1,1382,707,675
050,39,133,"Ohio","Portage County",4,2,1423,722,701
050,39,133,"Ohio","Portage County",4,3,1439,723,716
050,39,133,"Ohio","Portage County",4,4,1466,762,704
050,39,133,"Ohio","Portage County",4,5,1486,782,704
050,39,133,"Ohio","Portage County",4,6,1509,813,696
050,39,133,"Ohio","Portage County",4,7,1631,846,785
050,39,133,"Ohio","Portage County",4,8,1717,888,829
050,39,133,"Ohio","Portage County",4,9,1613,850,763
050,39,133,"Ohio","Portage County",4,10,1608,851,757
050,39,133,"Ohio","Portage County",4,11,1676,870,806
050,39,133,"Ohio","Portage County",4,12,1733,861,872
050,39,133,"Ohio","Portage County",4,13,1768,901,867
050,39,133,"Ohio","Portage County",4,14,1934,978,956
050,39,133,"Ohio","Portage County",4,15,1926,1003,923
050,39,133,"Ohio","Portage County",4,16,1860,931,929
050,39,133,"Ohio","Portage County",4,17,1916,964,952
050,39,133,"Ohio","Portage County",4,18,2708,1215,1493
050,39,133,"Ohio","Portage County",4,19,3888,1719,2169
050,39,133,"Ohio","Portage County",4,20,4071,1686,2385
050,39,133,"Ohio","Portage County",4,21,4338,1975,2363
050,39,133,"Ohio","Portage County",4,22,3643,1780,1863
050,39,133,"Ohio","Portage County",4,23,3106,1572,1534
050,39,133,"Ohio","Portage County",4,24,2554,1319,1235
050,39,133,"Ohio","Portage County",4,25,2303,1140,1163
050,39,133,"Ohio","Portage County",4,26,2024,1027,997
050,39,133,"Ohio","Portage County",4,27,1887,976,911
050,39,133,"Ohio","Portage County",4,28,1872,972,900
050,39,133,"Ohio","Portage County",4,29,1920,988,932
050,39,133,"Ohio","Portage County",4,30,1908,973,935
050,39,133,"Ohio","Portage County",4,31,1779,930,849
050,39,133,"Ohio","Portage County",4,32,1836,936,900
050,39,133,"Ohio","Portage County",4,33,1768,927,841
050,39,133,"Ohio","Portage County",4,34,1744,878,866
050,39,133,"Ohio","Portage County",4,35,1737,880,857
050,39,133,"Ohio","Portage County",4,36,1772,897,875
050,39,133,"Ohio","Portage County",4,37,1861,953,908
050,39,133,"Ohio","Portage County",4,38,1769,893,876
050,39,133,"Ohio","Portage County",4,39,1870,941,929
050,39,133,"Ohio","Portage County",4,40,1800,930,870
050,39,133,"Ohio","Portage County",4,41,1886,979,907
050,39,133,"Ohio","Portage County",4,42,1871,967,904
050,39,133,"Ohio","Portage County",4,43,1780,874,906
050,39,133,"Ohio","Portage County",4,44,1777,892,885
050,39,133,"Ohio","Portage County",4,45,1713,863,850
050,39,133,"Ohio","Portage County",4,46,1671,825,846
050,39,133,"Ohio","Portage County",4,47,1692,842,850
050,39,133,"Ohio","Portage County",4,48,1685,850,835
050,39,133,"Ohio","Portage County",4,49,1814,890,924
050,39,133,"Ohio","Portage County",4,50,1950,994,956
050,39,133,"Ohio","Portage County",4,51,2146,1094,1052
050,39,133,"Ohio","Portage County",4,52,2165,1075,1090
050,39,133,"Ohio","Portage County",4,53,2054,1007,1047
050,39,133,"Ohio","Portage County",4,54,1997,1015,982
050,39,133,"Ohio","Portage County",4,55,2021,1002,1019
050,39,133,"Ohio","Portage County",4,56,2071,1022,1049
050,39,133,"Ohio","Portage County",4,57,2161,1065,1096
050,39,133,"Ohio","Portage County",4,58,2261,1122,1139
050,39,133,"Ohio","Portage County",4,59,2328,1153,1175
050,39,133,"Ohio","Portage County",4,60,2394,1215,1179
050,39,133,"Ohio","Portage County",4,61,2368,1170,1198
050,39,133,"Ohio","Portage County",4,62,2275,1106,1169
050,39,133,"Ohio","Portage County",4,63,2298,1128,1170
050,39,133,"Ohio","Portage County",4,64,2378,1172,1206
050,39,133,"Ohio","Portage County",4,65,2232,1124,1108
050,39,133,"Ohio","Portage County",4,66,2046,1030,1016
050,39,133,"Ohio","Portage County",4,67,2057,1000,1057
050,39,133,"Ohio","Portage County",4,68,1947,957,990
050,39,133,"Ohio","Portage County",4,69,1893,917,976
050,39,133,"Ohio","Portage County",4,70,1756,859,897
050,39,133,"Ohio","Portage County",4,71,1609,776,833
050,39,133,"Ohio","Portage County",4,72,1560,740,820
050,39,133,"Ohio","Portage County",4,73,1483,685,798
050,39,133,"Ohio","Portage County",4,74,1437,669,768
050,39,133,"Ohio","Portage County",4,75,1573,755,818
050,39,133,"Ohio","Portage County",4,76,1012,489,523
050,39,133,"Ohio","Portage County",4,77,984,471,513
050,39,133,"Ohio","Portage County",4,78,1014,469,545
050,39,133,"Ohio","Portage County",4,79,1042,451,591
050,39,133,"Ohio","Portage County",4,80,836,366,470
050,39,133,"Ohio","Portage County",4,81,707,328,379
050,39,133,"Ohio","Portage County",4,82,600,264,336
050,39,133,"Ohio","Portage County",4,83,548,221,327
050,39,133,"Ohio","Portage County",4,84,480,213,267
050,39,133,"Ohio","Portage County",4,85,2565,1033,1532
050,39,133,"Ohio","Portage County",5,0,1363,672,691
050,39,133,"Ohio","Portage County",5,1,1396,666,730
050,39,133,"Ohio","Portage County",5,2,1424,721,703
050,39,133,"Ohio","Portage County",5,3,1440,730,710
050,39,133,"Ohio","Portage County",5,4,1436,711,725
050,39,133,"Ohio","Portage County",5,5,1497,786,711
050,39,133,"Ohio","Portage County",5,6,1531,818,713
050,39,133,"Ohio","Portage County",5,7,1545,832,713
050,39,133,"Ohio","Portage County",5,8,1624,831,793
050,39,133,"Ohio","Portage County",5,9,1742,900,842
050,39,133,"Ohio","Portage County",5,10,1616,853,763
050,39,133,"Ohio","Portage County",5,11,1646,871,775
050,39,133,"Ohio","Portage County",5,12,1678,860,818
050,39,133,"Ohio","Portage County",5,13,1735,854,881
050,39,133,"Ohio","Portage County",5,14,1766,891,875
050,39,133,"Ohio","Portage County",5,15,1966,978,988
050,39,133,"Ohio","Portage County",5,16,1921,1001,920
050,39,133,"Ohio","Portage County",5,17,1904,954,950
050,39,133,"Ohio","Portage County",5,18,2780,1236,1544
050,39,133,"Ohio","Portage County",5,19,4140,1808,2332
050,39,133,"Ohio","Portage County",5,20,4168,1742,2426
050,39,133,"Ohio","Portage County",5,21,4159,1883,2276
050,39,133,"Ohio","Portage County",5,22,3694,1766,1928
050,39,133,"Ohio","Portage County",5,23,3164,1586,1578
050,39,133,"Ohio","Portage County",5,24,2500,1296,1204
050,39,133,"Ohio","Portage County",5,25,2371,1219,1152
050,39,133,"Ohio","Portage County",5,26,2007,1013,994
050,39,133,"Ohio","Portage County",5,27,1862,964,898
050,39,133,"Ohio","Portage County",5,28,1869,983,886
050,39,133,"Ohio","Portage County",5,29,1835,970,865
050,39,133,"Ohio","Portage County",5,30,1908,947,961
050,39,133,"Ohio","Portage County",5,31,1911,970,941
050,39,133,"Ohio","Portage County",5,32,1809,957,852
050,39,133,"Ohio","Portage County",5,33,1869,976,893
050,39,133,"Ohio","Portage County",5,34,1802,945,857
050,39,133,"Ohio","Portage County",5,35,1744,871,873
050,39,133,"Ohio","Portage County",5,36,1790,923,867
050,39,133,"Ohio","Portage County",5,37,1815,919,896
050,39,133,"Ohio","Portage County",5,38,1853,943,910
050,39,133,"Ohio","Portage County",5,39,1819,930,889
050,39,133,"Ohio","Portage County",5,40,1895,958,937
050,39,133,"Ohio","Portage County",5,41,1856,960,896
050,39,133,"Ohio","Portage County",5,42,1890,985,905
050,39,133,"Ohio","Portage County",5,43,1854,952,902
050,39,133,"Ohio","Portage County",5,44,1770,867,903
050,39,133,"Ohio","Portage County",5,45,1788,905,883
050,39,133,"Ohio","Portage County",5,46,1733,857,876
050,39,133,"Ohio","Portage County",5,47,1723,858,865
050,39,133,"Ohio","Portage County",5,48,1704,834,870
050,39,133,"Ohio","Portage County",5,49,1707,870,837
050,39,133,"Ohio","Portage County",5,50,1824,893,931
050,39,133,"Ohio","Portage County",5,51,1948,995,953
050,39,133,"Ohio","Portage County",5,52,2159,1088,1071
050,39,133,"Ohio","Portage County",5,53,2139,1067,1072
050,39,133,"Ohio","Portage County",5,54,2063,1016,1047
050,39,133,"Ohio","Portage County",5,55,2011,1028,983
050,39,133,"Ohio","Portage County",5,56,2032,1002,1030
050,39,133,"Ohio","Portage County",5,57,2061,1013,1048
050,39,133,"Ohio","Portage County",5,58,2157,1063,1094
050,39,133,"Ohio","Portage County",5,59,2217,1085,1132
050,39,133,"Ohio","Portage County",5,60,2305,1144,1161
050,39,133,"Ohio","Portage County",5,61,2380,1219,1161
050,39,133,"Ohio","Portage County",5,62,2361,1175,1186
050,39,133,"Ohio","Portage County",5,63,2241,1082,1159
050,39,133,"Ohio","Portage County",5,64,2254,1104,1150
050,39,133,"Ohio","Portage County",5,65,2355,1159,1196
050,39,133,"Ohio","Portage County",5,66,2209,1119,1090
050,39,133,"Ohio","Portage County",5,67,2021,1010,1011
050,39,133,"Ohio","Portage County",5,68,2015,972,1043
050,39,133,"Ohio","Portage County",5,69,1913,936,977
050,39,133,"Ohio","Portage County",5,70,1849,898,951
050,39,133,"Ohio","Portage County",5,71,1720,835,885
050,39,133,"Ohio","Portage County",5,72,1584,755,829
050,39,133,"Ohio","Portage County",5,73,1509,713,796
050,39,133,"Ohio","Portage County",5,74,1437,654,783
050,39,133,"Ohio","Portage County",5,75,1395,651,744
050,39,133,"Ohio","Portage County",5,76,1527,740,787
050,39,133,"Ohio","Portage County",5,77,982,476,506
050,39,133,"Ohio","Portage County",5,78,957,449,508
050,39,133,"Ohio","Portage County",5,79,971,448,523
050,39,133,"Ohio","Portage County",5,80,969,418,551
050,39,133,"Ohio","Portage County",5,81,787,352,435
050,39,133,"Ohio","Portage County",5,82,665,298,367
050,39,133,"Ohio","Portage County",5,83,565,241,324
050,39,133,"Ohio","Portage County",5,84,466,190,276
050,39,133,"Ohio","Portage County",5,85,2598,1056,1542
050,39,135,"Ohio","Preble County",1,0,430,219,211
050,39,135,"Ohio","Preble County",1,1,438,226,212
050,39,135,"Ohio","Preble County",1,2,439,232,207
050,39,135,"Ohio","Preble County",1,3,434,242,192
050,39,135,"Ohio","Preble County",1,4,449,236,213
050,39,135,"Ohio","Preble County",1,5,470,236,234
050,39,135,"Ohio","Preble County",1,6,488,245,243
050,39,135,"Ohio","Preble County",1,7,473,241,232
050,39,135,"Ohio","Preble County",1,8,479,239,240
050,39,135,"Ohio","Preble County",1,9,496,283,213
050,39,135,"Ohio","Preble County",1,10,526,284,242
050,39,135,"Ohio","Preble County",1,11,559,271,288
050,39,135,"Ohio","Preble County",1,12,614,320,294
050,39,135,"Ohio","Preble County",1,13,626,318,308
050,39,135,"Ohio","Preble County",1,14,585,306,279
050,39,135,"Ohio","Preble County",1,15,572,291,281
050,39,135,"Ohio","Preble County",1,16,597,283,314
050,39,135,"Ohio","Preble County",1,17,596,287,309
050,39,135,"Ohio","Preble County",1,18,472,257,215
050,39,135,"Ohio","Preble County",1,19,379,206,173
050,39,135,"Ohio","Preble County",1,20,414,218,196
050,39,135,"Ohio","Preble County",1,21,415,216,199
050,39,135,"Ohio","Preble County",1,22,438,230,208
050,39,135,"Ohio","Preble County",1,23,450,231,219
050,39,135,"Ohio","Preble County",1,24,406,215,191
050,39,135,"Ohio","Preble County",1,25,422,213,209
050,39,135,"Ohio","Preble County",1,26,457,234,223
050,39,135,"Ohio","Preble County",1,27,438,218,220
050,39,135,"Ohio","Preble County",1,28,455,228,227
050,39,135,"Ohio","Preble County",1,29,481,231,250
050,39,135,"Ohio","Preble County",1,30,444,219,225
050,39,135,"Ohio","Preble County",1,31,436,219,217
050,39,135,"Ohio","Preble County",1,32,447,223,224
050,39,135,"Ohio","Preble County",1,33,434,209,225
050,39,135,"Ohio","Preble County",1,34,440,213,227
050,39,135,"Ohio","Preble County",1,35,474,238,236
050,39,135,"Ohio","Preble County",1,36,472,239,233
050,39,135,"Ohio","Preble County",1,37,480,250,230
050,39,135,"Ohio","Preble County",1,38,528,244,284
050,39,135,"Ohio","Preble County",1,39,490,241,249
050,39,135,"Ohio","Preble County",1,40,477,238,239
050,39,135,"Ohio","Preble County",1,41,507,262,245
050,39,135,"Ohio","Preble County",1,42,496,253,243
050,39,135,"Ohio","Preble County",1,43,472,238,234
050,39,135,"Ohio","Preble County",1,44,469,241,228
050,39,135,"Ohio","Preble County",1,45,496,246,250
050,39,135,"Ohio","Preble County",1,46,506,258,248
050,39,135,"Ohio","Preble County",1,47,500,255,245
050,39,135,"Ohio","Preble County",1,48,536,268,268
050,39,135,"Ohio","Preble County",1,49,589,295,294
050,39,135,"Ohio","Preble County",1,50,545,273,272
050,39,135,"Ohio","Preble County",1,51,529,265,264
050,39,135,"Ohio","Preble County",1,52,526,282,244
050,39,135,"Ohio","Preble County",1,53,535,285,250
050,39,135,"Ohio","Preble County",1,54,574,288,286
050,39,135,"Ohio","Preble County",1,55,604,308,296
050,39,135,"Ohio","Preble County",1,56,607,295,312
050,39,135,"Ohio","Preble County",1,57,612,303,309
050,39,135,"Ohio","Preble County",1,58,642,326,316
050,39,135,"Ohio","Preble County",1,59,619,302,317
050,39,135,"Ohio","Preble County",1,60,599,301,298
050,39,135,"Ohio","Preble County",1,61,629,306,323
050,39,135,"Ohio","Preble County",1,62,640,326,314
050,39,135,"Ohio","Preble County",1,63,617,297,320
050,39,135,"Ohio","Preble County",1,64,557,257,300
050,39,135,"Ohio","Preble County",1,65,570,284,286
050,39,135,"Ohio","Preble County",1,66,535,274,261
050,39,135,"Ohio","Preble County",1,67,560,271,289
050,39,135,"Ohio","Preble County",1,68,541,268,273
050,39,135,"Ohio","Preble County",1,69,495,239,256
050,39,135,"Ohio","Preble County",1,70,508,257,251
050,39,135,"Ohio","Preble County",1,71,470,221,249
050,39,135,"Ohio","Preble County",1,72,460,214,246
050,39,135,"Ohio","Preble County",1,73,492,225,267
050,39,135,"Ohio","Preble County",1,74,320,142,178
050,39,135,"Ohio","Preble County",1,75,292,151,141
050,39,135,"Ohio","Preble County",1,76,292,146,146
050,39,135,"Ohio","Preble County",1,77,284,136,148
050,39,135,"Ohio","Preble County",1,78,261,114,147
050,39,135,"Ohio","Preble County",1,79,231,98,133
050,39,135,"Ohio","Preble County",1,80,205,96,109
050,39,135,"Ohio","Preble County",1,81,211,102,109
050,39,135,"Ohio","Preble County",1,82,193,91,102
050,39,135,"Ohio","Preble County",1,83,168,80,88
050,39,135,"Ohio","Preble County",1,84,153,68,85
050,39,135,"Ohio","Preble County",1,85,731,294,437
050,39,135,"Ohio","Preble County",2,0,415,215,200
050,39,135,"Ohio","Preble County",2,1,432,224,208
050,39,135,"Ohio","Preble County",2,2,437,232,205
050,39,135,"Ohio","Preble County",2,3,436,240,196
050,39,135,"Ohio","Preble County",2,4,448,237,211
050,39,135,"Ohio","Preble County",2,5,469,239,230
050,39,135,"Ohio","Preble County",2,6,484,243,241
050,39,135,"Ohio","Preble County",2,7,479,241,238
050,39,135,"Ohio","Preble County",2,8,478,240,238
050,39,135,"Ohio","Preble County",2,9,492,271,221
050,39,135,"Ohio","Preble County",2,10,518,282,236
050,39,135,"Ohio","Preble County",2,11,552,274,278
050,39,135,"Ohio","Preble County",2,12,605,310,295
050,39,135,"Ohio","Preble County",2,13,626,320,306
050,39,135,"Ohio","Preble County",2,14,596,310,286
050,39,135,"Ohio","Preble County",2,15,578,294,284
050,39,135,"Ohio","Preble County",2,16,592,285,307
050,39,135,"Ohio","Preble County",2,17,599,287,312
050,39,135,"Ohio","Preble County",2,18,474,251,223
050,39,135,"Ohio","Preble County",2,19,377,206,171
050,39,135,"Ohio","Preble County",2,20,414,220,194
050,39,135,"Ohio","Preble County",2,21,418,219,199
050,39,135,"Ohio","Preble County",2,22,437,229,208
050,39,135,"Ohio","Preble County",2,23,449,234,215
050,39,135,"Ohio","Preble County",2,24,417,221,196
050,39,135,"Ohio","Preble County",2,25,421,217,204
050,39,135,"Ohio","Preble County",2,26,449,229,220
050,39,135,"Ohio","Preble County",2,27,443,222,221
050,39,135,"Ohio","Preble County",2,28,455,228,227
050,39,135,"Ohio","Preble County",2,29,478,232,246
050,39,135,"Ohio","Preble County",2,30,455,223,232
050,39,135,"Ohio","Preble County",2,31,437,218,219
050,39,135,"Ohio","Preble County",2,32,445,222,223
050,39,135,"Ohio","Preble County",2,33,440,214,226
050,39,135,"Ohio","Preble County",2,34,441,213,228
050,39,135,"Ohio","Preble County",2,35,471,235,236
050,39,135,"Ohio","Preble County",2,36,469,237,232
050,39,135,"Ohio","Preble County",2,37,480,247,233
050,39,135,"Ohio","Preble County",2,38,521,247,274
050,39,135,"Ohio","Preble County",2,39,495,242,253
050,39,135,"Ohio","Preble County",2,40,486,243,243
050,39,135,"Ohio","Preble County",2,41,499,257,242
050,39,135,"Ohio","Preble County",2,42,498,254,244
050,39,135,"Ohio","Preble County",2,43,484,244,240
050,39,135,"Ohio","Preble County",2,44,461,237,224
050,39,135,"Ohio","Preble County",2,45,493,247,246
050,39,135,"Ohio","Preble County",2,46,506,257,249
050,39,135,"Ohio","Preble County",2,47,499,255,244
050,39,135,"Ohio","Preble County",2,48,524,263,261
050,39,135,"Ohio","Preble County",2,49,581,291,290
050,39,135,"Ohio","Preble County",2,50,557,279,278
050,39,135,"Ohio","Preble County",2,51,528,264,264
050,39,135,"Ohio","Preble County",2,52,526,278,248
050,39,135,"Ohio","Preble County",2,53,532,284,248
050,39,135,"Ohio","Preble County",2,54,562,288,274
050,39,135,"Ohio","Preble County",2,55,592,300,292
050,39,135,"Ohio","Preble County",2,56,610,301,309
050,39,135,"Ohio","Preble County",2,57,611,302,309
050,39,135,"Ohio","Preble County",2,58,636,321,315
050,39,135,"Ohio","Preble County",2,59,628,308,320
050,39,135,"Ohio","Preble County",2,60,600,298,302
050,39,135,"Ohio","Preble County",2,61,619,304,315
050,39,135,"Ohio","Preble County",2,62,638,323,315
050,39,135,"Ohio","Preble County",2,63,627,306,321
050,39,135,"Ohio","Preble County",2,64,567,265,302
050,39,135,"Ohio","Preble County",2,65,567,277,290
050,39,135,"Ohio","Preble County",2,66,542,275,267
050,39,135,"Ohio","Preble County",2,67,553,271,282
050,39,135,"Ohio","Preble County",2,68,537,265,272
050,39,135,"Ohio","Preble County",2,69,506,246,260
050,39,135,"Ohio","Preble County",2,70,498,249,249
050,39,135,"Ohio","Preble County",2,71,479,228,251
050,39,135,"Ohio","Preble County",2,72,455,213,242
050,39,135,"Ohio","Preble County",2,73,508,234,274
050,39,135,"Ohio","Preble County",2,74,333,148,185
050,39,135,"Ohio","Preble County",2,75,301,149,152
050,39,135,"Ohio","Preble County",2,76,290,145,145
050,39,135,"Ohio","Preble County",2,77,288,139,149
050,39,135,"Ohio","Preble County",2,78,258,115,143
050,39,135,"Ohio","Preble County",2,79,231,101,130
050,39,135,"Ohio","Preble County",2,80,209,96,113
050,39,135,"Ohio","Preble County",2,81,206,100,106
050,39,135,"Ohio","Preble County",2,82,192,90,102
050,39,135,"Ohio","Preble County",2,83,171,80,91
050,39,135,"Ohio","Preble County",2,84,153,70,83
050,39,135,"Ohio","Preble County",2,85,744,301,443
050,39,135,"Ohio","Preble County",3,0,397,203,194
050,39,135,"Ohio","Preble County",3,1,427,201,226
050,39,135,"Ohio","Preble County",3,2,449,240,209
050,39,135,"Ohio","Preble County",3,3,436,231,205
050,39,135,"Ohio","Preble County",3,4,467,255,212
050,39,135,"Ohio","Preble County",3,5,464,245,219
050,39,135,"Ohio","Preble County",3,6,482,250,232
050,39,135,"Ohio","Preble County",3,7,483,234,249
050,39,135,"Ohio","Preble County",3,8,488,243,245
050,39,135,"Ohio","Preble County",3,9,488,245,243
050,39,135,"Ohio","Preble County",3,10,495,265,230
050,39,135,"Ohio","Preble County",3,11,548,292,256
050,39,135,"Ohio","Preble County",3,12,548,278,270
050,39,135,"Ohio","Preble County",3,13,603,313,290
050,39,135,"Ohio","Preble County",3,14,612,320,292
050,39,135,"Ohio","Preble County",3,15,603,324,279
050,39,135,"Ohio","Preble County",3,16,567,293,274
050,39,135,"Ohio","Preble County",3,17,589,287,302
050,39,135,"Ohio","Preble County",3,18,509,253,256
050,39,135,"Ohio","Preble County",3,19,377,200,177
050,39,135,"Ohio","Preble County",3,20,400,216,184
050,39,135,"Ohio","Preble County",3,21,446,241,205
050,39,135,"Ohio","Preble County",3,22,449,234,215
050,39,135,"Ohio","Preble County",3,23,419,218,201
050,39,135,"Ohio","Preble County",3,24,447,238,209
050,39,135,"Ohio","Preble County",3,25,416,209,207
050,39,135,"Ohio","Preble County",3,26,424,212,212
050,39,135,"Ohio","Preble County",3,27,444,240,204
050,39,135,"Ohio","Preble County",3,28,448,223,225
050,39,135,"Ohio","Preble County",3,29,467,237,230
050,39,135,"Ohio","Preble County",3,30,463,232,231
050,39,135,"Ohio","Preble County",3,31,465,230,235
050,39,135,"Ohio","Preble County",3,32,438,214,224
050,39,135,"Ohio","Preble County",3,33,461,229,232
050,39,135,"Ohio","Preble County",3,34,455,224,231
050,39,135,"Ohio","Preble County",3,35,454,225,229
050,39,135,"Ohio","Preble County",3,36,484,249,235
050,39,135,"Ohio","Preble County",3,37,457,236,221
050,39,135,"Ohio","Preble County",3,38,476,241,235
050,39,135,"Ohio","Preble County",3,39,514,247,267
050,39,135,"Ohio","Preble County",3,40,503,239,264
050,39,135,"Ohio","Preble County",3,41,479,238,241
050,39,135,"Ohio","Preble County",3,42,497,250,247
050,39,135,"Ohio","Preble County",3,43,502,252,250
050,39,135,"Ohio","Preble County",3,44,485,238,247
050,39,135,"Ohio","Preble County",3,45,464,236,228
050,39,135,"Ohio","Preble County",3,46,498,251,247
050,39,135,"Ohio","Preble County",3,47,514,268,246
050,39,135,"Ohio","Preble County",3,48,487,246,241
050,39,135,"Ohio","Preble County",3,49,515,255,260
050,39,135,"Ohio","Preble County",3,50,594,301,293
050,39,135,"Ohio","Preble County",3,51,557,274,283
050,39,135,"Ohio","Preble County",3,52,525,268,257
050,39,135,"Ohio","Preble County",3,53,518,274,244
050,39,135,"Ohio","Preble County",3,54,548,295,253
050,39,135,"Ohio","Preble County",3,55,558,287,271
050,39,135,"Ohio","Preble County",3,56,596,303,293
050,39,135,"Ohio","Preble County",3,57,588,292,296
050,39,135,"Ohio","Preble County",3,58,608,308,300
050,39,135,"Ohio","Preble County",3,59,622,307,315
050,39,135,"Ohio","Preble County",3,60,629,311,318
050,39,135,"Ohio","Preble County",3,61,603,296,307
050,39,135,"Ohio","Preble County",3,62,611,297,314
050,39,135,"Ohio","Preble County",3,63,621,313,308
050,39,135,"Ohio","Preble County",3,64,607,298,309
050,39,135,"Ohio","Preble County",3,65,553,254,299
050,39,135,"Ohio","Preble County",3,66,554,269,285
050,39,135,"Ohio","Preble County",3,67,539,266,273
050,39,135,"Ohio","Preble County",3,68,535,262,273
050,39,135,"Ohio","Preble County",3,69,522,258,264
050,39,135,"Ohio","Preble County",3,70,489,234,255
050,39,135,"Ohio","Preble County",3,71,484,237,247
050,39,135,"Ohio","Preble County",3,72,471,224,247
050,39,135,"Ohio","Preble County",3,73,434,201,233
050,39,135,"Ohio","Preble County",3,74,477,214,263
050,39,135,"Ohio","Preble County",3,75,316,140,176
050,39,135,"Ohio","Preble County",3,76,298,142,156
050,39,135,"Ohio","Preble County",3,77,261,134,127
050,39,135,"Ohio","Preble County",3,78,270,131,139
050,39,135,"Ohio","Preble County",3,79,235,103,132
050,39,135,"Ohio","Preble County",3,80,212,90,122
050,39,135,"Ohio","Preble County",3,81,204,94,110
050,39,135,"Ohio","Preble County",3,82,181,91,90
050,39,135,"Ohio","Preble County",3,83,172,75,97
050,39,135,"Ohio","Preble County",3,84,142,66,76
050,39,135,"Ohio","Preble County",3,85,734,307,427
050,39,135,"Ohio","Preble County",4,0,383,193,190
050,39,135,"Ohio","Preble County",4,1,397,205,192
050,39,135,"Ohio","Preble County",4,2,432,206,226
050,39,135,"Ohio","Preble County",4,3,474,246,228
050,39,135,"Ohio","Preble County",4,4,444,241,203
050,39,135,"Ohio","Preble County",4,5,464,251,213
050,39,135,"Ohio","Preble County",4,6,461,241,220
050,39,135,"Ohio","Preble County",4,7,477,242,235
050,39,135,"Ohio","Preble County",4,8,500,241,259
050,39,135,"Ohio","Preble County",4,9,482,247,235
050,39,135,"Ohio","Preble County",4,10,496,249,247
050,39,135,"Ohio","Preble County",4,11,504,266,238
050,39,135,"Ohio","Preble County",4,12,553,288,265
050,39,135,"Ohio","Preble County",4,13,558,280,278
050,39,135,"Ohio","Preble County",4,14,609,325,284
050,39,135,"Ohio","Preble County",4,15,601,304,297
050,39,135,"Ohio","Preble County",4,16,601,318,283
050,39,135,"Ohio","Preble County",4,17,580,298,282
050,39,135,"Ohio","Preble County",4,18,490,250,240
050,39,135,"Ohio","Preble County",4,19,379,187,192
050,39,135,"Ohio","Preble County",4,20,391,215,176
050,39,135,"Ohio","Preble County",4,21,411,224,187
050,39,135,"Ohio","Preble County",4,22,459,248,211
050,39,135,"Ohio","Preble County",4,23,440,228,212
050,39,135,"Ohio","Preble County",4,24,421,214,207
050,39,135,"Ohio","Preble County",4,25,453,241,212
050,39,135,"Ohio","Preble County",4,26,413,207,206
050,39,135,"Ohio","Preble County",4,27,416,211,205
050,39,135,"Ohio","Preble County",4,28,433,234,199
050,39,135,"Ohio","Preble County",4,29,435,208,227
050,39,135,"Ohio","Preble County",4,30,456,236,220
050,39,135,"Ohio","Preble County",4,31,464,228,236
050,39,135,"Ohio","Preble County",4,32,457,222,235
050,39,135,"Ohio","Preble County",4,33,441,218,223
050,39,135,"Ohio","Preble County",4,34,469,228,241
050,39,135,"Ohio","Preble County",4,35,476,238,238
050,39,135,"Ohio","Preble County",4,36,455,226,229
050,39,135,"Ohio","Preble County",4,37,485,247,238
050,39,135,"Ohio","Preble County",4,38,481,243,238
050,39,135,"Ohio","Preble County",4,39,471,243,228
050,39,135,"Ohio","Preble County",4,40,518,252,266
050,39,135,"Ohio","Preble County",4,41,514,242,272
050,39,135,"Ohio","Preble County",4,42,472,232,240
050,39,135,"Ohio","Preble County",4,43,509,261,248
050,39,135,"Ohio","Preble County",4,44,492,246,246
050,39,135,"Ohio","Preble County",4,45,477,233,244
050,39,135,"Ohio","Preble County",4,46,463,234,229
050,39,135,"Ohio","Preble County",4,47,483,245,238
050,39,135,"Ohio","Preble County",4,48,502,256,246
050,39,135,"Ohio","Preble County",4,49,500,254,246
050,39,135,"Ohio","Preble County",4,50,520,265,255
050,39,135,"Ohio","Preble County",4,51,589,290,299
050,39,135,"Ohio","Preble County",4,52,563,283,280
050,39,135,"Ohio","Preble County",4,53,518,257,261
050,39,135,"Ohio","Preble County",4,54,520,279,241
050,39,135,"Ohio","Preble County",4,55,544,295,249
050,39,135,"Ohio","Preble County",4,56,564,289,275
050,39,135,"Ohio","Preble County",4,57,587,307,280
050,39,135,"Ohio","Preble County",4,58,580,288,292
050,39,135,"Ohio","Preble County",4,59,595,296,299
050,39,135,"Ohio","Preble County",4,60,612,302,310
050,39,135,"Ohio","Preble County",4,61,620,302,318
050,39,135,"Ohio","Preble County",4,62,604,296,308
050,39,135,"Ohio","Preble County",4,63,601,289,312
050,39,135,"Ohio","Preble County",4,64,605,307,298
050,39,135,"Ohio","Preble County",4,65,594,287,307
050,39,135,"Ohio","Preble County",4,66,536,242,294
050,39,135,"Ohio","Preble County",4,67,553,266,287
050,39,135,"Ohio","Preble County",4,68,515,251,264
050,39,135,"Ohio","Preble County",4,69,516,255,261
050,39,135,"Ohio","Preble County",4,70,506,251,255
050,39,135,"Ohio","Preble County",4,71,472,220,252
050,39,135,"Ohio","Preble County",4,72,474,232,242
050,39,135,"Ohio","Preble County",4,73,446,208,238
050,39,135,"Ohio","Preble County",4,74,410,188,222
050,39,135,"Ohio","Preble County",4,75,457,209,248
050,39,135,"Ohio","Preble County",4,76,314,135,179
050,39,135,"Ohio","Preble County",4,77,287,136,151
050,39,135,"Ohio","Preble County",4,78,253,130,123
050,39,135,"Ohio","Preble County",4,79,244,118,126
050,39,135,"Ohio","Preble County",4,80,216,91,125
050,39,135,"Ohio","Preble County",4,81,195,85,110
050,39,135,"Ohio","Preble County",4,82,181,81,100
050,39,135,"Ohio","Preble County",4,83,154,77,77
050,39,135,"Ohio","Preble County",4,84,158,74,84
050,39,135,"Ohio","Preble County",4,85,729,315,414
050,39,135,"Ohio","Preble County",5,0,400,200,200
050,39,135,"Ohio","Preble County",5,1,382,196,186
050,39,135,"Ohio","Preble County",5,2,397,209,188
050,39,135,"Ohio","Preble County",5,3,443,210,233
050,39,135,"Ohio","Preble County",5,4,480,251,229
050,39,135,"Ohio","Preble County",5,5,454,247,207
050,39,135,"Ohio","Preble County",5,6,459,250,209
050,39,135,"Ohio","Preble County",5,7,482,246,236
050,39,135,"Ohio","Preble County",5,8,477,241,236
050,39,135,"Ohio","Preble County",5,9,517,250,267
050,39,135,"Ohio","Preble County",5,10,486,251,235
050,39,135,"Ohio","Preble County",5,11,511,264,247
050,39,135,"Ohio","Preble County",5,12,511,265,246
050,39,135,"Ohio","Preble County",5,13,574,295,279
050,39,135,"Ohio","Preble County",5,14,552,265,287
050,39,135,"Ohio","Preble County",5,15,616,326,290
050,39,135,"Ohio","Preble County",5,16,595,310,285
050,39,135,"Ohio","Preble County",5,17,625,335,290
050,39,135,"Ohio","Preble County",5,18,479,256,223
050,39,135,"Ohio","Preble County",5,19,363,186,177
050,39,135,"Ohio","Preble County",5,20,401,202,199
050,39,135,"Ohio","Preble County",5,21,414,223,191
050,39,135,"Ohio","Preble County",5,22,411,228,183
050,39,135,"Ohio","Preble County",5,23,473,253,220
050,39,135,"Ohio","Preble County",5,24,452,236,216
050,39,135,"Ohio","Preble County",5,25,424,226,198
050,39,135,"Ohio","Preble County",5,26,444,229,215
050,39,135,"Ohio","Preble County",5,27,417,204,213
050,39,135,"Ohio","Preble County",5,28,412,211,201
050,39,135,"Ohio","Preble County",5,29,449,231,218
050,39,135,"Ohio","Preble County",5,30,422,198,224
050,39,135,"Ohio","Preble County",5,31,470,237,233
050,39,135,"Ohio","Preble County",5,32,457,224,233
050,39,135,"Ohio","Preble County",5,33,466,226,240
050,39,135,"Ohio","Preble County",5,34,457,224,233
050,39,135,"Ohio","Preble County",5,35,477,240,237
050,39,135,"Ohio","Preble County",5,36,480,246,234
050,39,135,"Ohio","Preble County",5,37,457,215,242
050,39,135,"Ohio","Preble County",5,38,493,245,248
050,39,135,"Ohio","Preble County",5,39,468,241,227
050,39,135,"Ohio","Preble County",5,40,486,244,242
050,39,135,"Ohio","Preble County",5,41,520,263,257
050,39,135,"Ohio","Preble County",5,42,511,242,269
050,39,135,"Ohio","Preble County",5,43,476,231,245
050,39,135,"Ohio","Preble County",5,44,518,264,254
050,39,135,"Ohio","Preble County",5,45,487,246,241
050,39,135,"Ohio","Preble County",5,46,492,244,248
050,39,135,"Ohio","Preble County",5,47,458,233,225
050,39,135,"Ohio","Preble County",5,48,475,247,228
050,39,135,"Ohio","Preble County",5,49,503,259,244
050,39,135,"Ohio","Preble County",5,50,507,260,247
050,39,135,"Ohio","Preble County",5,51,509,256,253
050,39,135,"Ohio","Preble County",5,52,599,294,305
050,39,135,"Ohio","Preble County",5,53,548,274,274
050,39,135,"Ohio","Preble County",5,54,518,263,255
050,39,135,"Ohio","Preble County",5,55,520,282,238
050,39,135,"Ohio","Preble County",5,56,554,297,257
050,39,135,"Ohio","Preble County",5,57,555,283,272
050,39,135,"Ohio","Preble County",5,58,585,302,283
050,39,135,"Ohio","Preble County",5,59,564,275,289
050,39,135,"Ohio","Preble County",5,60,588,292,296
050,39,135,"Ohio","Preble County",5,61,603,296,307
050,39,135,"Ohio","Preble County",5,62,620,302,318
050,39,135,"Ohio","Preble County",5,63,598,295,303
050,39,135,"Ohio","Preble County",5,64,586,281,305
050,39,135,"Ohio","Preble County",5,65,594,300,294
050,39,135,"Ohio","Preble County",5,66,580,277,303
050,39,135,"Ohio","Preble County",5,67,537,238,299
050,39,135,"Ohio","Preble County",5,68,546,261,285
050,39,135,"Ohio","Preble County",5,69,498,246,252
050,39,135,"Ohio","Preble County",5,70,493,242,251
050,39,135,"Ohio","Preble County",5,71,499,242,257
050,39,135,"Ohio","Preble County",5,72,466,217,249
050,39,135,"Ohio","Preble County",5,73,462,224,238
050,39,135,"Ohio","Preble County",5,74,432,196,236
050,39,135,"Ohio","Preble County",5,75,396,184,212
050,39,135,"Ohio","Preble County",5,76,451,198,253
050,39,135,"Ohio","Preble County",5,77,300,131,169
050,39,135,"Ohio","Preble County",5,78,276,128,148
050,39,135,"Ohio","Preble County",5,79,230,119,111
050,39,135,"Ohio","Preble County",5,80,225,107,118
050,39,135,"Ohio","Preble County",5,81,205,86,119
050,39,135,"Ohio","Preble County",5,82,172,72,100
050,39,135,"Ohio","Preble County",5,83,159,69,90
050,39,135,"Ohio","Preble County",5,84,143,76,67
050,39,135,"Ohio","Preble County",5,85,765,336,429
050,39,137,"Ohio","Putnam County",1,0,422,218,204
050,39,137,"Ohio","Putnam County",1,1,430,218,212
050,39,137,"Ohio","Putnam County",1,2,438,212,226
050,39,137,"Ohio","Putnam County",1,3,467,238,229
050,39,137,"Ohio","Putnam County",1,4,478,229,249
050,39,137,"Ohio","Putnam County",1,5,489,239,250
050,39,137,"Ohio","Putnam County",1,6,518,253,265
050,39,137,"Ohio","Putnam County",1,7,481,247,234
050,39,137,"Ohio","Putnam County",1,8,487,231,256
050,39,137,"Ohio","Putnam County",1,9,537,277,260
050,39,137,"Ohio","Putnam County",1,10,554,303,251
050,39,137,"Ohio","Putnam County",1,11,549,286,263
050,39,137,"Ohio","Putnam County",1,12,519,273,246
050,39,137,"Ohio","Putnam County",1,13,526,268,258
050,39,137,"Ohio","Putnam County",1,14,521,269,252
050,39,137,"Ohio","Putnam County",1,15,490,258,232
050,39,137,"Ohio","Putnam County",1,16,487,249,238
050,39,137,"Ohio","Putnam County",1,17,478,240,238
050,39,137,"Ohio","Putnam County",1,18,407,215,192
050,39,137,"Ohio","Putnam County",1,19,332,169,163
050,39,137,"Ohio","Putnam County",1,20,365,183,182
050,39,137,"Ohio","Putnam County",1,21,355,183,172
050,39,137,"Ohio","Putnam County",1,22,365,191,174
050,39,137,"Ohio","Putnam County",1,23,382,196,186
050,39,137,"Ohio","Putnam County",1,24,371,192,179
050,39,137,"Ohio","Putnam County",1,25,365,191,174
050,39,137,"Ohio","Putnam County",1,26,342,173,169
050,39,137,"Ohio","Putnam County",1,27,376,195,181
050,39,137,"Ohio","Putnam County",1,28,365,184,181
050,39,137,"Ohio","Putnam County",1,29,402,206,196
050,39,137,"Ohio","Putnam County",1,30,389,194,195
050,39,137,"Ohio","Putnam County",1,31,376,196,180
050,39,137,"Ohio","Putnam County",1,32,368,183,185
050,39,137,"Ohio","Putnam County",1,33,374,181,193
050,39,137,"Ohio","Putnam County",1,34,379,180,199
050,39,137,"Ohio","Putnam County",1,35,397,199,198
050,39,137,"Ohio","Putnam County",1,36,414,215,199
050,39,137,"Ohio","Putnam County",1,37,406,201,205
050,39,137,"Ohio","Putnam County",1,38,433,228,205
050,39,137,"Ohio","Putnam County",1,39,421,213,208
050,39,137,"Ohio","Putnam County",1,40,432,223,209
050,39,137,"Ohio","Putnam County",1,41,404,194,210
050,39,137,"Ohio","Putnam County",1,42,392,202,190
050,39,137,"Ohio","Putnam County",1,43,383,202,181
050,39,137,"Ohio","Putnam County",1,44,366,186,180
050,39,137,"Ohio","Putnam County",1,45,352,174,178
050,39,137,"Ohio","Putnam County",1,46,362,195,167
050,39,137,"Ohio","Putnam County",1,47,393,200,193
050,39,137,"Ohio","Putnam County",1,48,410,210,200
050,39,137,"Ohio","Putnam County",1,49,431,212,219
050,39,137,"Ohio","Putnam County",1,50,429,225,204
050,39,137,"Ohio","Putnam County",1,51,393,215,178
050,39,137,"Ohio","Putnam County",1,52,403,211,192
050,39,137,"Ohio","Putnam County",1,53,419,220,199
050,39,137,"Ohio","Putnam County",1,54,467,230,237
050,39,137,"Ohio","Putnam County",1,55,480,248,232
050,39,137,"Ohio","Putnam County",1,56,477,242,235
050,39,137,"Ohio","Putnam County",1,57,511,252,259
050,39,137,"Ohio","Putnam County",1,58,520,253,267
050,39,137,"Ohio","Putnam County",1,59,498,253,245
050,39,137,"Ohio","Putnam County",1,60,507,263,244
050,39,137,"Ohio","Putnam County",1,61,554,284,270
050,39,137,"Ohio","Putnam County",1,62,538,272,266
050,39,137,"Ohio","Putnam County",1,63,491,255,236
050,39,137,"Ohio","Putnam County",1,64,479,258,221
050,39,137,"Ohio","Putnam County",1,65,444,245,199
050,39,137,"Ohio","Putnam County",1,66,453,228,225
050,39,137,"Ohio","Putnam County",1,67,406,203,203
050,39,137,"Ohio","Putnam County",1,68,384,194,190
050,39,137,"Ohio","Putnam County",1,69,387,189,198
050,39,137,"Ohio","Putnam County",1,70,361,182,179
050,39,137,"Ohio","Putnam County",1,71,328,172,156
050,39,137,"Ohio","Putnam County",1,72,324,174,150
050,39,137,"Ohio","Putnam County",1,73,294,143,151
050,39,137,"Ohio","Putnam County",1,74,205,93,112
050,39,137,"Ohio","Putnam County",1,75,198,87,111
050,39,137,"Ohio","Putnam County",1,76,207,92,115
050,39,137,"Ohio","Putnam County",1,77,225,95,130
050,39,137,"Ohio","Putnam County",1,78,198,96,102
050,39,137,"Ohio","Putnam County",1,79,181,82,99
050,39,137,"Ohio","Putnam County",1,80,175,82,93
050,39,137,"Ohio","Putnam County",1,81,156,58,98
050,39,137,"Ohio","Putnam County",1,82,138,48,90
050,39,137,"Ohio","Putnam County",1,83,132,54,78
050,39,137,"Ohio","Putnam County",1,84,122,47,75
050,39,137,"Ohio","Putnam County",1,85,771,293,478
050,39,137,"Ohio","Putnam County",2,0,417,206,211
050,39,137,"Ohio","Putnam County",2,1,426,217,209
050,39,137,"Ohio","Putnam County",2,2,436,215,221
050,39,137,"Ohio","Putnam County",2,3,458,230,228
050,39,137,"Ohio","Putnam County",2,4,477,230,247
050,39,137,"Ohio","Putnam County",2,5,484,234,250
050,39,137,"Ohio","Putnam County",2,6,513,252,261
050,39,137,"Ohio","Putnam County",2,7,489,247,242
050,39,137,"Ohio","Putnam County",2,8,486,235,251
050,39,137,"Ohio","Putnam County",2,9,522,266,256
050,39,137,"Ohio","Putnam County",2,10,548,295,253
050,39,137,"Ohio","Putnam County",2,11,547,289,258
050,39,137,"Ohio","Putnam County",2,12,528,277,251
050,39,137,"Ohio","Putnam County",2,13,525,269,256
050,39,137,"Ohio","Putnam County",2,14,522,269,253
050,39,137,"Ohio","Putnam County",2,15,497,260,237
050,39,137,"Ohio","Putnam County",2,16,487,250,237
050,39,137,"Ohio","Putnam County",2,17,482,244,238
050,39,137,"Ohio","Putnam County",2,18,404,210,194
050,39,137,"Ohio","Putnam County",2,19,335,173,162
050,39,137,"Ohio","Putnam County",2,20,367,184,183
050,39,137,"Ohio","Putnam County",2,21,356,184,172
050,39,137,"Ohio","Putnam County",2,22,362,190,172
050,39,137,"Ohio","Putnam County",2,23,375,193,182
050,39,137,"Ohio","Putnam County",2,24,369,193,176
050,39,137,"Ohio","Putnam County",2,25,359,187,172
050,39,137,"Ohio","Putnam County",2,26,348,178,170
050,39,137,"Ohio","Putnam County",2,27,364,188,176
050,39,137,"Ohio","Putnam County",2,28,371,189,182
050,39,137,"Ohio","Putnam County",2,29,393,201,192
050,39,137,"Ohio","Putnam County",2,30,394,199,195
050,39,137,"Ohio","Putnam County",2,31,380,195,185
050,39,137,"Ohio","Putnam County",2,32,370,187,183
050,39,137,"Ohio","Putnam County",2,33,371,180,191
050,39,137,"Ohio","Putnam County",2,34,376,180,196
050,39,137,"Ohio","Putnam County",2,35,394,194,200
050,39,137,"Ohio","Putnam County",2,36,409,210,199
050,39,137,"Ohio","Putnam County",2,37,406,204,202
050,39,137,"Ohio","Putnam County",2,38,429,222,207
050,39,137,"Ohio","Putnam County",2,39,423,216,207
050,39,137,"Ohio","Putnam County",2,40,432,223,209
050,39,137,"Ohio","Putnam County",2,41,411,200,211
050,39,137,"Ohio","Putnam County",2,42,391,199,192
050,39,137,"Ohio","Putnam County",2,43,387,203,184
050,39,137,"Ohio","Putnam County",2,44,368,190,178
050,39,137,"Ohio","Putnam County",2,45,359,178,181
050,39,137,"Ohio","Putnam County",2,46,359,190,169
050,39,137,"Ohio","Putnam County",2,47,383,194,189
050,39,137,"Ohio","Putnam County",2,48,401,207,194
050,39,137,"Ohio","Putnam County",2,49,428,213,215
050,39,137,"Ohio","Putnam County",2,50,432,224,208
050,39,137,"Ohio","Putnam County",2,51,395,213,182
050,39,137,"Ohio","Putnam County",2,52,397,211,186
050,39,137,"Ohio","Putnam County",2,53,415,217,198
050,39,137,"Ohio","Putnam County",2,54,450,223,227
050,39,137,"Ohio","Putnam County",2,55,479,245,234
050,39,137,"Ohio","Putnam County",2,56,476,242,234
050,39,137,"Ohio","Putnam County",2,57,503,251,252
050,39,137,"Ohio","Putnam County",2,58,512,250,262
050,39,137,"Ohio","Putnam County",2,59,505,253,252
050,39,137,"Ohio","Putnam County",2,60,505,260,245
050,39,137,"Ohio","Putnam County",2,61,540,280,260
050,39,137,"Ohio","Putnam County",2,62,538,272,266
050,39,137,"Ohio","Putnam County",2,63,508,263,245
050,39,137,"Ohio","Putnam County",2,64,478,255,223
050,39,137,"Ohio","Putnam County",2,65,450,246,204
050,39,137,"Ohio","Putnam County",2,66,454,234,220
050,39,137,"Ohio","Putnam County",2,67,415,208,207
050,39,137,"Ohio","Putnam County",2,68,385,193,192
050,39,137,"Ohio","Putnam County",2,69,387,192,195
050,39,137,"Ohio","Putnam County",2,70,367,183,184
050,39,137,"Ohio","Putnam County",2,71,336,173,163
050,39,137,"Ohio","Putnam County",2,72,313,167,146
050,39,137,"Ohio","Putnam County",2,73,315,159,156
050,39,137,"Ohio","Putnam County",2,74,211,97,114
050,39,137,"Ohio","Putnam County",2,75,200,89,111
050,39,137,"Ohio","Putnam County",2,76,203,88,115
050,39,137,"Ohio","Putnam County",2,77,220,92,128
050,39,137,"Ohio","Putnam County",2,78,201,94,107
050,39,137,"Ohio","Putnam County",2,79,182,84,98
050,39,137,"Ohio","Putnam County",2,80,173,81,92
050,39,137,"Ohio","Putnam County",2,81,159,63,96
050,39,137,"Ohio","Putnam County",2,82,142,50,92
050,39,137,"Ohio","Putnam County",2,83,131,51,80
050,39,137,"Ohio","Putnam County",2,84,124,49,75
050,39,137,"Ohio","Putnam County",2,85,766,290,476
050,39,137,"Ohio","Putnam County",3,0,414,199,215
050,39,137,"Ohio","Putnam County",3,1,417,212,205
050,39,137,"Ohio","Putnam County",3,2,441,228,213
050,39,137,"Ohio","Putnam County",3,3,448,222,226
050,39,137,"Ohio","Putnam County",3,4,472,236,236
050,39,137,"Ohio","Putnam County",3,5,478,234,244
050,39,137,"Ohio","Putnam County",3,6,495,247,248
050,39,137,"Ohio","Putnam County",3,7,506,257,249
050,39,137,"Ohio","Putnam County",3,8,492,245,247
050,39,137,"Ohio","Putnam County",3,9,490,233,257
050,39,137,"Ohio","Putnam County",3,10,524,268,256
050,39,137,"Ohio","Putnam County",3,11,548,290,258
050,39,137,"Ohio","Putnam County",3,12,541,283,258
050,39,137,"Ohio","Putnam County",3,13,520,273,247
050,39,137,"Ohio","Putnam County",3,14,513,263,250
050,39,137,"Ohio","Putnam County",3,15,531,281,250
050,39,137,"Ohio","Putnam County",3,16,489,256,233
050,39,137,"Ohio","Putnam County",3,17,502,262,240
050,39,137,"Ohio","Putnam County",3,18,402,208,194
050,39,137,"Ohio","Putnam County",3,19,323,167,156
050,39,137,"Ohio","Putnam County",3,20,371,187,184
050,39,137,"Ohio","Putnam County",3,21,373,188,185
050,39,137,"Ohio","Putnam County",3,22,366,186,180
050,39,137,"Ohio","Putnam County",3,23,367,197,170
050,39,137,"Ohio","Putnam County",3,24,366,197,169
050,39,137,"Ohio","Putnam County",3,25,354,179,175
050,39,137,"Ohio","Putnam County",3,26,335,177,158
050,39,137,"Ohio","Putnam County",3,27,348,184,164
050,39,137,"Ohio","Putnam County",3,28,351,179,172
050,39,137,"Ohio","Putnam County",3,29,385,200,185
050,39,137,"Ohio","Putnam County",3,30,402,200,202
050,39,137,"Ohio","Putnam County",3,31,394,191,203
050,39,137,"Ohio","Putnam County",3,32,391,204,187
050,39,137,"Ohio","Putnam County",3,33,379,195,184
050,39,137,"Ohio","Putnam County",3,34,371,180,191
050,39,137,"Ohio","Putnam County",3,35,392,186,206
050,39,137,"Ohio","Putnam County",3,36,408,202,206
050,39,137,"Ohio","Putnam County",3,37,399,208,191
050,39,137,"Ohio","Putnam County",3,38,407,202,205
050,39,137,"Ohio","Putnam County",3,39,426,224,202
050,39,137,"Ohio","Putnam County",3,40,426,224,202
050,39,137,"Ohio","Putnam County",3,41,445,223,222
050,39,137,"Ohio","Putnam County",3,42,401,205,196
050,39,137,"Ohio","Putnam County",3,43,388,192,196
050,39,137,"Ohio","Putnam County",3,44,385,200,185
050,39,137,"Ohio","Putnam County",3,45,374,193,181
050,39,137,"Ohio","Putnam County",3,46,361,182,179
050,39,137,"Ohio","Putnam County",3,47,368,179,189
050,39,137,"Ohio","Putnam County",3,48,374,198,176
050,39,137,"Ohio","Putnam County",3,49,407,207,200
050,39,137,"Ohio","Putnam County",3,50,432,221,211
050,39,137,"Ohio","Putnam County",3,51,415,212,203
050,39,137,"Ohio","Putnam County",3,52,394,210,184
050,39,137,"Ohio","Putnam County",3,53,397,209,188
050,39,137,"Ohio","Putnam County",3,54,419,216,203
050,39,137,"Ohio","Putnam County",3,55,456,228,228
050,39,137,"Ohio","Putnam County",3,56,460,236,224
050,39,137,"Ohio","Putnam County",3,57,480,244,236
050,39,137,"Ohio","Putnam County",3,58,495,244,251
050,39,137,"Ohio","Putnam County",3,59,508,250,258
050,39,137,"Ohio","Putnam County",3,60,501,252,249
050,39,137,"Ohio","Putnam County",3,61,504,264,240
050,39,137,"Ohio","Putnam County",3,62,525,270,255
050,39,137,"Ohio","Putnam County",3,63,537,274,263
050,39,137,"Ohio","Putnam County",3,64,501,254,247
050,39,137,"Ohio","Putnam County",3,65,467,246,221
050,39,137,"Ohio","Putnam County",3,66,448,245,203
050,39,137,"Ohio","Putnam County",3,67,434,219,215
050,39,137,"Ohio","Putnam County",3,68,418,210,208
050,39,137,"Ohio","Putnam County",3,69,382,192,190
050,39,137,"Ohio","Putnam County",3,70,385,190,195
050,39,137,"Ohio","Putnam County",3,71,355,178,177
050,39,137,"Ohio","Putnam County",3,72,323,162,161
050,39,137,"Ohio","Putnam County",3,73,306,163,143
050,39,137,"Ohio","Putnam County",3,74,299,149,150
050,39,137,"Ohio","Putnam County",3,75,200,90,110
050,39,137,"Ohio","Putnam County",3,76,197,85,112
050,39,137,"Ohio","Putnam County",3,77,186,84,102
050,39,137,"Ohio","Putnam County",3,78,215,91,124
050,39,137,"Ohio","Putnam County",3,79,188,86,102
050,39,137,"Ohio","Putnam County",3,80,174,81,93
050,39,137,"Ohio","Putnam County",3,81,159,72,87
050,39,137,"Ohio","Putnam County",3,82,146,59,87
050,39,137,"Ohio","Putnam County",3,83,126,42,84
050,39,137,"Ohio","Putnam County",3,84,116,40,76
050,39,137,"Ohio","Putnam County",3,85,733,278,455
050,39,137,"Ohio","Putnam County",4,0,405,197,208
050,39,137,"Ohio","Putnam County",4,1,408,193,215
050,39,137,"Ohio","Putnam County",4,2,426,218,208
050,39,137,"Ohio","Putnam County",4,3,449,231,218
050,39,137,"Ohio","Putnam County",4,4,459,229,230
050,39,137,"Ohio","Putnam County",4,5,464,234,230
050,39,137,"Ohio","Putnam County",4,6,491,239,252
050,39,137,"Ohio","Putnam County",4,7,496,243,253
050,39,137,"Ohio","Putnam County",4,8,509,255,254
050,39,137,"Ohio","Putnam County",4,9,503,255,248
050,39,137,"Ohio","Putnam County",4,10,495,237,258
050,39,137,"Ohio","Putnam County",4,11,537,277,260
050,39,137,"Ohio","Putnam County",4,12,543,291,252
050,39,137,"Ohio","Putnam County",4,13,541,283,258
050,39,137,"Ohio","Putnam County",4,14,524,276,248
050,39,137,"Ohio","Putnam County",4,15,504,259,245
050,39,137,"Ohio","Putnam County",4,16,536,287,249
050,39,137,"Ohio","Putnam County",4,17,489,261,228
050,39,137,"Ohio","Putnam County",4,18,406,218,188
050,39,137,"Ohio","Putnam County",4,19,298,158,140
050,39,137,"Ohio","Putnam County",4,20,356,186,170
050,39,137,"Ohio","Putnam County",4,21,377,198,179
050,39,137,"Ohio","Putnam County",4,22,392,198,194
050,39,137,"Ohio","Putnam County",4,23,373,196,177
050,39,137,"Ohio","Putnam County",4,24,364,198,166
050,39,137,"Ohio","Putnam County",4,25,353,176,177
050,39,137,"Ohio","Putnam County",4,26,347,175,172
050,39,137,"Ohio","Putnam County",4,27,335,176,159
050,39,137,"Ohio","Putnam County",4,28,361,202,159
050,39,137,"Ohio","Putnam County",4,29,364,181,183
050,39,137,"Ohio","Putnam County",4,30,384,196,188
050,39,137,"Ohio","Putnam County",4,31,414,203,211
050,39,137,"Ohio","Putnam County",4,32,397,194,203
050,39,137,"Ohio","Putnam County",4,33,396,210,186
050,39,137,"Ohio","Putnam County",4,34,381,193,188
050,39,137,"Ohio","Putnam County",4,35,389,189,200
050,39,137,"Ohio","Putnam County",4,36,399,193,206
050,39,137,"Ohio","Putnam County",4,37,402,201,201
050,39,137,"Ohio","Putnam County",4,38,408,214,194
050,39,137,"Ohio","Putnam County",4,39,408,204,204
050,39,137,"Ohio","Putnam County",4,40,434,231,203
050,39,137,"Ohio","Putnam County",4,41,436,222,214
050,39,137,"Ohio","Putnam County",4,42,445,234,211
050,39,137,"Ohio","Putnam County",4,43,397,201,196
050,39,137,"Ohio","Putnam County",4,44,393,196,197
050,39,137,"Ohio","Putnam County",4,45,382,200,182
050,39,137,"Ohio","Putnam County",4,46,378,202,176
050,39,137,"Ohio","Putnam County",4,47,355,171,184
050,39,137,"Ohio","Putnam County",4,48,346,175,171
050,39,137,"Ohio","Putnam County",4,49,376,197,179
050,39,137,"Ohio","Putnam County",4,50,416,217,199
050,39,137,"Ohio","Putnam County",4,51,414,209,205
050,39,137,"Ohio","Putnam County",4,52,404,209,195
050,39,137,"Ohio","Putnam County",4,53,392,207,185
050,39,137,"Ohio","Putnam County",4,54,391,206,185
050,39,137,"Ohio","Putnam County",4,55,426,222,204
050,39,137,"Ohio","Putnam County",4,56,448,224,224
050,39,137,"Ohio","Putnam County",4,57,472,245,227
050,39,137,"Ohio","Putnam County",4,58,464,239,225
050,39,137,"Ohio","Putnam County",4,59,494,243,251
050,39,137,"Ohio","Putnam County",4,60,511,247,264
050,39,137,"Ohio","Putnam County",4,61,501,253,248
050,39,137,"Ohio","Putnam County",4,62,490,255,235
050,39,137,"Ohio","Putnam County",4,63,525,269,256
050,39,137,"Ohio","Putnam County",4,64,528,273,255
050,39,137,"Ohio","Putnam County",4,65,493,248,245
050,39,137,"Ohio","Putnam County",4,66,466,244,222
050,39,137,"Ohio","Putnam County",4,67,439,235,204
050,39,137,"Ohio","Putnam County",4,68,431,218,213
050,39,137,"Ohio","Putnam County",4,69,416,208,208
050,39,137,"Ohio","Putnam County",4,70,380,191,189
050,39,137,"Ohio","Putnam County",4,71,371,182,189
050,39,137,"Ohio","Putnam County",4,72,350,170,180
050,39,137,"Ohio","Putnam County",4,73,319,158,161
050,39,137,"Ohio","Putnam County",4,74,298,158,140
050,39,137,"Ohio","Putnam County",4,75,280,140,140
050,39,137,"Ohio","Putnam County",4,76,195,87,108
050,39,137,"Ohio","Putnam County",4,77,181,79,102
050,39,137,"Ohio","Putnam County",4,78,178,81,97
050,39,137,"Ohio","Putnam County",4,79,205,87,118
050,39,137,"Ohio","Putnam County",4,80,176,81,95
050,39,137,"Ohio","Putnam County",4,81,162,72,90
050,39,137,"Ohio","Putnam County",4,82,140,58,82
050,39,137,"Ohio","Putnam County",4,83,137,52,85
050,39,137,"Ohio","Putnam County",4,84,117,36,81
050,39,137,"Ohio","Putnam County",4,85,695,260,435
050,39,137,"Ohio","Putnam County",5,0,412,201,211
050,39,137,"Ohio","Putnam County",5,1,410,198,212
050,39,137,"Ohio","Putnam County",5,2,401,188,213
050,39,137,"Ohio","Putnam County",5,3,423,219,204
050,39,137,"Ohio","Putnam County",5,4,447,221,226
050,39,137,"Ohio","Putnam County",5,5,464,232,232
050,39,137,"Ohio","Putnam County",5,6,476,242,234
050,39,137,"Ohio","Putnam County",5,7,487,238,249
050,39,137,"Ohio","Putnam County",5,8,496,243,253
050,39,137,"Ohio","Putnam County",5,9,511,255,256
050,39,137,"Ohio","Putnam County",5,10,494,247,247
050,39,137,"Ohio","Putnam County",5,11,502,238,264
050,39,137,"Ohio","Putnam County",5,12,523,274,249
050,39,137,"Ohio","Putnam County",5,13,552,292,260
050,39,137,"Ohio","Putnam County",5,14,536,288,248
050,39,137,"Ohio","Putnam County",5,15,523,272,251
050,39,137,"Ohio","Putnam County",5,16,512,263,249
050,39,137,"Ohio","Putnam County",5,17,538,289,249
050,39,137,"Ohio","Putnam County",5,18,396,213,183
050,39,137,"Ohio","Putnam County",5,19,310,167,143
050,39,137,"Ohio","Putnam County",5,20,321,163,158
050,39,137,"Ohio","Putnam County",5,21,366,195,171
050,39,137,"Ohio","Putnam County",5,22,383,199,184
050,39,137,"Ohio","Putnam County",5,23,403,209,194
050,39,137,"Ohio","Putnam County",5,24,383,207,176
050,39,137,"Ohio","Putnam County",5,25,335,186,149
050,39,137,"Ohio","Putnam County",5,26,347,176,171
050,39,137,"Ohio","Putnam County",5,27,345,170,175
050,39,137,"Ohio","Putnam County",5,28,328,172,156
050,39,137,"Ohio","Putnam County",5,29,361,196,165
050,39,137,"Ohio","Putnam County",5,30,362,179,183
050,39,137,"Ohio","Putnam County",5,31,391,205,186
050,39,137,"Ohio","Putnam County",5,32,390,196,194
050,39,137,"Ohio","Putnam County",5,33,393,191,202
050,39,137,"Ohio","Putnam County",5,34,402,212,190
050,39,137,"Ohio","Putnam County",5,35,399,201,198
050,39,137,"Ohio","Putnam County",5,36,392,192,200
050,39,137,"Ohio","Putnam County",5,37,397,194,203
050,39,137,"Ohio","Putnam County",5,38,402,200,202
050,39,137,"Ohio","Putnam County",5,39,420,219,201
050,39,137,"Ohio","Putnam County",5,40,418,213,205
050,39,137,"Ohio","Putnam County",5,41,441,226,215
050,39,137,"Ohio","Putnam County",5,42,420,216,204
050,39,137,"Ohio","Putnam County",5,43,447,230,217
050,39,137,"Ohio","Putnam County",5,44,406,206,200
050,39,137,"Ohio","Putnam County",5,45,396,196,200
050,39,137,"Ohio","Putnam County",5,46,401,215,186
050,39,137,"Ohio","Putnam County",5,47,376,189,187
050,39,137,"Ohio","Putnam County",5,48,345,173,172
050,39,137,"Ohio","Putnam County",5,49,339,171,168
050,39,137,"Ohio","Putnam County",5,50,381,205,176
050,39,137,"Ohio","Putnam County",5,51,394,202,192
050,39,137,"Ohio","Putnam County",5,52,415,213,202
050,39,137,"Ohio","Putnam County",5,53,402,200,202
050,39,137,"Ohio","Putnam County",5,54,397,210,187
050,39,137,"Ohio","Putnam County",5,55,391,206,185
050,39,137,"Ohio","Putnam County",5,56,422,218,204
050,39,137,"Ohio","Putnam County",5,57,450,228,222
050,39,137,"Ohio","Putnam County",5,58,457,235,222
050,39,137,"Ohio","Putnam County",5,59,457,236,221
050,39,137,"Ohio","Putnam County",5,60,492,239,253
050,39,137,"Ohio","Putnam County",5,61,509,253,256
050,39,137,"Ohio","Putnam County",5,62,480,240,240
050,39,137,"Ohio","Putnam County",5,63,485,250,235
050,39,137,"Ohio","Putnam County",5,64,519,267,252
050,39,137,"Ohio","Putnam County",5,65,520,264,256
050,39,137,"Ohio","Putnam County",5,66,491,245,246
050,39,137,"Ohio","Putnam County",5,67,450,232,218
050,39,137,"Ohio","Putnam County",5,68,435,237,198
050,39,137,"Ohio","Putnam County",5,69,425,214,211
050,39,137,"Ohio","Putnam County",5,70,414,208,206
050,39,137,"Ohio","Putnam County",5,71,370,184,186
050,39,137,"Ohio","Putnam County",5,72,366,177,189
050,39,137,"Ohio","Putnam County",5,73,344,164,180
050,39,137,"Ohio","Putnam County",5,74,309,153,156
050,39,137,"Ohio","Putnam County",5,75,280,149,131
050,39,137,"Ohio","Putnam County",5,76,270,135,135
050,39,137,"Ohio","Putnam County",5,77,182,82,100
050,39,137,"Ohio","Putnam County",5,78,173,74,99
050,39,137,"Ohio","Putnam County",5,79,165,72,93
050,39,137,"Ohio","Putnam County",5,80,194,82,112
050,39,137,"Ohio","Putnam County",5,81,160,70,90
050,39,137,"Ohio","Putnam County",5,82,145,62,83
050,39,137,"Ohio","Putnam County",5,83,133,52,81
050,39,137,"Ohio","Putnam County",5,84,126,46,80
050,39,137,"Ohio","Putnam County",5,85,674,245,429
050,39,139,"Ohio","Richland County",1,0,1405,718,687
050,39,139,"Ohio","Richland County",1,1,1399,718,681
050,39,139,"Ohio","Richland County",1,2,1382,740,642
050,39,139,"Ohio","Richland County",1,3,1405,739,666
050,39,139,"Ohio","Richland County",1,4,1530,776,754
050,39,139,"Ohio","Richland County",1,5,1507,754,753
050,39,139,"Ohio","Richland County",1,6,1492,766,726
050,39,139,"Ohio","Richland County",1,7,1525,779,746
050,39,139,"Ohio","Richland County",1,8,1481,751,730
050,39,139,"Ohio","Richland County",1,9,1510,782,728
050,39,139,"Ohio","Richland County",1,10,1559,803,756
050,39,139,"Ohio","Richland County",1,11,1586,791,795
050,39,139,"Ohio","Richland County",1,12,1665,852,813
050,39,139,"Ohio","Richland County",1,13,1666,852,814
050,39,139,"Ohio","Richland County",1,14,1621,833,788
050,39,139,"Ohio","Richland County",1,15,1549,815,734
050,39,139,"Ohio","Richland County",1,16,1655,849,806
050,39,139,"Ohio","Richland County",1,17,1600,820,780
050,39,139,"Ohio","Richland County",1,18,1448,759,689
050,39,139,"Ohio","Richland County",1,19,1397,782,615
050,39,139,"Ohio","Richland County",1,20,1377,772,605
050,39,139,"Ohio","Richland County",1,21,1430,792,638
050,39,139,"Ohio","Richland County",1,22,1491,857,634
050,39,139,"Ohio","Richland County",1,23,1522,856,666
050,39,139,"Ohio","Richland County",1,24,1609,925,684
050,39,139,"Ohio","Richland County",1,25,1591,898,693
050,39,139,"Ohio","Richland County",1,26,1639,944,695
050,39,139,"Ohio","Richland County",1,27,1615,912,703
050,39,139,"Ohio","Richland County",1,28,1673,946,727
050,39,139,"Ohio","Richland County",1,29,1728,977,751
050,39,139,"Ohio","Richland County",1,30,1628,897,731
050,39,139,"Ohio","Richland County",1,31,1561,883,678
050,39,139,"Ohio","Richland County",1,32,1514,815,699
050,39,139,"Ohio","Richland County",1,33,1493,830,663
050,39,139,"Ohio","Richland County",1,34,1505,824,681
050,39,139,"Ohio","Richland County",1,35,1467,807,660
050,39,139,"Ohio","Richland County",1,36,1401,796,605
050,39,139,"Ohio","Richland County",1,37,1457,785,672
050,39,139,"Ohio","Richland County",1,38,1487,807,680
050,39,139,"Ohio","Richland County",1,39,1519,813,706
050,39,139,"Ohio","Richland County",1,40,1540,800,740
050,39,139,"Ohio","Richland County",1,41,1537,841,696
050,39,139,"Ohio","Richland County",1,42,1501,820,681
050,39,139,"Ohio","Richland County",1,43,1533,817,716
050,39,139,"Ohio","Richland County",1,44,1458,773,685
050,39,139,"Ohio","Richland County",1,45,1459,767,692
050,39,139,"Ohio","Richland County",1,46,1417,756,661
050,39,139,"Ohio","Richland County",1,47,1403,763,640
050,39,139,"Ohio","Richland County",1,48,1508,791,717
050,39,139,"Ohio","Richland County",1,49,1581,832,749
050,39,139,"Ohio","Richland County",1,50,1524,798,726
050,39,139,"Ohio","Richland County",1,51,1518,799,719
050,39,139,"Ohio","Richland County",1,52,1509,793,716
050,39,139,"Ohio","Richland County",1,53,1516,792,724
050,39,139,"Ohio","Richland County",1,54,1530,767,763
050,39,139,"Ohio","Richland County",1,55,1599,809,790
050,39,139,"Ohio","Richland County",1,56,1627,813,814
050,39,139,"Ohio","Richland County",1,57,1655,817,838
050,39,139,"Ohio","Richland County",1,58,1704,842,862
050,39,139,"Ohio","Richland County",1,59,1731,875,856
050,39,139,"Ohio","Richland County",1,60,1735,850,885
050,39,139,"Ohio","Richland County",1,61,1727,849,878
050,39,139,"Ohio","Richland County",1,62,1764,860,904
050,39,139,"Ohio","Richland County",1,63,1700,821,879
050,39,139,"Ohio","Richland County",1,64,1686,828,858
050,39,139,"Ohio","Richland County",1,65,1712,847,865
050,39,139,"Ohio","Richland County",1,66,1633,803,830
050,39,139,"Ohio","Richland County",1,67,1534,741,793
050,39,139,"Ohio","Richland County",1,68,1497,692,805
050,39,139,"Ohio","Richland County",1,69,1403,635,768
050,39,139,"Ohio","Richland County",1,70,1358,630,728
050,39,139,"Ohio","Richland County",1,71,1344,609,735
050,39,139,"Ohio","Richland County",1,72,1344,614,730
050,39,139,"Ohio","Richland County",1,73,1386,653,733
050,39,139,"Ohio","Richland County",1,74,932,425,507
050,39,139,"Ohio","Richland County",1,75,927,419,508
050,39,139,"Ohio","Richland County",1,76,885,394,491
050,39,139,"Ohio","Richland County",1,77,905,400,505
050,39,139,"Ohio","Richland County",1,78,824,348,476
050,39,139,"Ohio","Richland County",1,79,748,322,426
050,39,139,"Ohio","Richland County",1,80,675,275,400
050,39,139,"Ohio","Richland County",1,81,655,271,384
050,39,139,"Ohio","Richland County",1,82,622,257,365
050,39,139,"Ohio","Richland County",1,83,552,225,327
050,39,139,"Ohio","Richland County",1,84,502,208,294
050,39,139,"Ohio","Richland County",1,85,2938,1063,1875
050,39,139,"Ohio","Richland County",2,0,1394,711,683
050,39,139,"Ohio","Richland County",2,1,1393,713,680
050,39,139,"Ohio","Richland County",2,2,1393,738,655
050,39,139,"Ohio","Richland County",2,3,1402,737,665
050,39,139,"Ohio","Richland County",2,4,1503,767,736
050,39,139,"Ohio","Richland County",2,5,1520,763,757
050,39,139,"Ohio","Richland County",2,6,1502,768,734
050,39,139,"Ohio","Richland County",2,7,1510,771,739
050,39,139,"Ohio","Richland County",2,8,1486,755,731
050,39,139,"Ohio","Richland County",2,9,1502,777,725
050,39,139,"Ohio","Richland County",2,10,1544,796,748
050,39,139,"Ohio","Richland County",2,11,1569,787,782
050,39,139,"Ohio","Richland County",2,12,1653,839,814
050,39,139,"Ohio","Richland County",2,13,1664,848,816
050,39,139,"Ohio","Richland County",2,14,1634,841,793
050,39,139,"Ohio","Richland County",2,15,1570,822,748
050,39,139,"Ohio","Richland County",2,16,1635,843,792
050,39,139,"Ohio","Richland County",2,17,1619,832,787
050,39,139,"Ohio","Richland County",2,18,1442,755,687
050,39,139,"Ohio","Richland County",2,19,1385,766,619
050,39,139,"Ohio","Richland County",2,20,1401,786,615
050,39,139,"Ohio","Richland County",2,21,1439,801,638
050,39,139,"Ohio","Richland County",2,22,1489,850,639
050,39,139,"Ohio","Richland County",2,23,1523,860,663
050,39,139,"Ohio","Richland County",2,24,1592,912,680
050,39,139,"Ohio","Richland County",2,25,1597,906,691
050,39,139,"Ohio","Richland County",2,26,1635,938,697
050,39,139,"Ohio","Richland County",2,27,1619,917,702
050,39,139,"Ohio","Richland County",2,28,1657,937,720
050,39,139,"Ohio","Richland County",2,29,1717,970,747
050,39,139,"Ohio","Richland County",2,30,1661,920,741
050,39,139,"Ohio","Richland County",2,31,1570,881,689
050,39,139,"Ohio","Richland County",2,32,1520,824,696
050,39,139,"Ohio","Richland County",2,33,1502,830,672
050,39,139,"Ohio","Richland County",2,34,1504,827,677
050,39,139,"Ohio","Richland County",2,35,1478,812,666
050,39,139,"Ohio","Richland County",2,36,1409,793,616
050,39,139,"Ohio","Richland County",2,37,1448,789,659
050,39,139,"Ohio","Richland County",2,38,1492,810,682
050,39,139,"Ohio","Richland County",2,39,1509,809,700
050,39,139,"Ohio","Richland County",2,40,1546,811,735
050,39,139,"Ohio","Richland County",2,41,1538,833,705
050,39,139,"Ohio","Richland County",2,42,1489,811,678
050,39,139,"Ohio","Richland County",2,43,1548,832,716
050,39,139,"Ohio","Richland County",2,44,1468,780,688
050,39,139,"Ohio","Richland County",2,45,1462,768,694
050,39,139,"Ohio","Richland County",2,46,1415,753,662
050,39,139,"Ohio","Richland County",2,47,1398,754,644
050,39,139,"Ohio","Richland County",2,48,1480,782,698
050,39,139,"Ohio","Richland County",2,49,1568,824,744
050,39,139,"Ohio","Richland County",2,50,1545,809,736
050,39,139,"Ohio","Richland County",2,51,1509,790,719
050,39,139,"Ohio","Richland County",2,52,1499,789,710
050,39,139,"Ohio","Richland County",2,53,1513,792,721
050,39,139,"Ohio","Richland County",2,54,1524,772,752
050,39,139,"Ohio","Richland County",2,55,1576,795,781
050,39,139,"Ohio","Richland County",2,56,1614,807,807
050,39,139,"Ohio","Richland County",2,57,1647,818,829
050,39,139,"Ohio","Richland County",2,58,1686,830,856
050,39,139,"Ohio","Richland County",2,59,1730,866,864
050,39,139,"Ohio","Richland County",2,60,1727,853,874
050,39,139,"Ohio","Richland County",2,61,1723,845,878
050,39,139,"Ohio","Richland County",2,62,1750,854,896
050,39,139,"Ohio","Richland County",2,63,1725,833,892
050,39,139,"Ohio","Richland County",2,64,1673,819,854
050,39,139,"Ohio","Richland County",2,65,1703,840,863
050,39,139,"Ohio","Richland County",2,66,1662,819,843
050,39,139,"Ohio","Richland County",2,67,1549,749,800
050,39,139,"Ohio","Richland County",2,68,1490,693,797
050,39,139,"Ohio","Richland County",2,69,1435,650,785
050,39,139,"Ohio","Richland County",2,70,1360,630,730
050,39,139,"Ohio","Richland County",2,71,1339,604,735
050,39,139,"Ohio","Richland County",2,72,1318,600,718
050,39,139,"Ohio","Richland County",2,73,1442,672,770
050,39,139,"Ohio","Richland County",2,74,974,449,525
050,39,139,"Ohio","Richland County",2,75,926,423,503
050,39,139,"Ohio","Richland County",2,76,883,393,490
050,39,139,"Ohio","Richland County",2,77,917,406,511
050,39,139,"Ohio","Richland County",2,78,813,344,469
050,39,139,"Ohio","Richland County",2,79,756,326,430
050,39,139,"Ohio","Richland County",2,80,684,282,402
050,39,139,"Ohio","Richland County",2,81,648,267,381
050,39,139,"Ohio","Richland County",2,82,620,256,364
050,39,139,"Ohio","Richland County",2,83,556,226,330
050,39,139,"Ohio","Richland County",2,84,507,208,299
050,39,139,"Ohio","Richland County",2,85,2949,1072,1877
050,39,139,"Ohio","Richland County",3,0,1359,703,656
050,39,139,"Ohio","Richland County",3,1,1455,741,714
050,39,139,"Ohio","Richland County",3,2,1431,746,685
050,39,139,"Ohio","Richland County",3,3,1415,723,692
050,39,139,"Ohio","Richland County",3,4,1402,739,663
050,39,139,"Ohio","Richland County",3,5,1491,773,718
050,39,139,"Ohio","Richland County",3,6,1513,763,750
050,39,139,"Ohio","Richland County",3,7,1501,769,732
050,39,139,"Ohio","Richland County",3,8,1519,779,740
050,39,139,"Ohio","Richland County",3,9,1512,763,749
050,39,139,"Ohio","Richland County",3,10,1505,786,719
050,39,139,"Ohio","Richland County",3,11,1546,792,754
050,39,139,"Ohio","Richland County",3,12,1600,807,793
050,39,139,"Ohio","Richland County",3,13,1660,853,807
050,39,139,"Ohio","Richland County",3,14,1683,867,816
050,39,139,"Ohio","Richland County",3,15,1636,868,768
050,39,139,"Ohio","Richland County",3,16,1576,826,750
050,39,139,"Ohio","Richland County",3,17,1667,883,784
050,39,139,"Ohio","Richland County",3,18,1435,756,679
050,39,139,"Ohio","Richland County",3,19,1286,705,581
050,39,139,"Ohio","Richland County",3,20,1405,805,600
050,39,139,"Ohio","Richland County",3,21,1470,840,630
050,39,139,"Ohio","Richland County",3,22,1533,853,680
050,39,139,"Ohio","Richland County",3,23,1546,877,669
050,39,139,"Ohio","Richland County",3,24,1590,904,686
050,39,139,"Ohio","Richland County",3,25,1637,944,693
050,39,139,"Ohio","Richland County",3,26,1660,943,717
050,39,139,"Ohio","Richland County",3,27,1670,962,708
050,39,139,"Ohio","Richland County",3,28,1691,961,730
050,39,139,"Ohio","Richland County",3,29,1732,987,745
050,39,139,"Ohio","Richland County",3,30,1741,980,761
050,39,139,"Ohio","Richland County",3,31,1677,929,748
050,39,139,"Ohio","Richland County",3,32,1565,865,700
050,39,139,"Ohio","Richland County",3,33,1526,838,688
050,39,139,"Ohio","Richland County",3,34,1499,819,680
050,39,139,"Ohio","Richland County",3,35,1501,827,674
050,39,139,"Ohio","Richland County",3,36,1481,805,676
050,39,139,"Ohio","Richland County",3,37,1426,793,633
050,39,139,"Ohio","Richland County",3,38,1496,837,659
050,39,139,"Ohio","Richland County",3,39,1513,818,695
050,39,139,"Ohio","Richland County",3,40,1517,811,706
050,39,139,"Ohio","Richland County",3,41,1544,816,728
050,39,139,"Ohio","Richland County",3,42,1488,782,706
050,39,139,"Ohio","Richland County",3,43,1517,834,683
050,39,139,"Ohio","Richland County",3,44,1534,825,709
050,39,139,"Ohio","Richland County",3,45,1460,760,700
050,39,139,"Ohio","Richland County",3,46,1467,772,695
050,39,139,"Ohio","Richland County",3,47,1397,740,657
050,39,139,"Ohio","Richland County",3,48,1411,765,646
050,39,139,"Ohio","Richland County",3,49,1490,786,704
050,39,139,"Ohio","Richland County",3,50,1559,823,736
050,39,139,"Ohio","Richland County",3,51,1523,789,734
050,39,139,"Ohio","Richland County",3,52,1485,777,708
050,39,139,"Ohio","Richland County",3,53,1478,769,709
050,39,139,"Ohio","Richland County",3,54,1516,788,728
050,39,139,"Ohio","Richland County",3,55,1508,755,753
050,39,139,"Ohio","Richland County",3,56,1563,774,789
050,39,139,"Ohio","Richland County",3,57,1599,809,790
050,39,139,"Ohio","Richland County",3,58,1633,795,838
050,39,139,"Ohio","Richland County",3,59,1666,815,851
050,39,139,"Ohio","Richland County",3,60,1720,856,864
050,39,139,"Ohio","Richland County",3,61,1720,842,878
050,39,139,"Ohio","Richland County",3,62,1705,840,865
050,39,139,"Ohio","Richland County",3,63,1709,825,884
050,39,139,"Ohio","Richland County",3,64,1708,826,882
050,39,139,"Ohio","Richland County",3,65,1639,807,832
050,39,139,"Ohio","Richland County",3,66,1704,836,868
050,39,139,"Ohio","Richland County",3,67,1629,799,830
050,39,139,"Ohio","Richland County",3,68,1518,736,782
050,39,139,"Ohio","Richland County",3,69,1457,677,780
050,39,139,"Ohio","Richland County",3,70,1403,641,762
050,39,139,"Ohio","Richland County",3,71,1323,597,726
050,39,139,"Ohio","Richland County",3,72,1304,583,721
050,39,139,"Ohio","Richland County",3,73,1271,576,695
050,39,139,"Ohio","Richland County",3,74,1377,634,743
050,39,139,"Ohio","Richland County",3,75,939,421,518
050,39,139,"Ohio","Richland County",3,76,888,407,481
050,39,139,"Ohio","Richland County",3,77,838,368,470
050,39,139,"Ohio","Richland County",3,78,868,367,501
050,39,139,"Ohio","Richland County",3,79,777,332,445
050,39,139,"Ohio","Richland County",3,80,718,295,423
050,39,139,"Ohio","Richland County",3,81,626,265,361
050,39,139,"Ohio","Richland County",3,82,612,247,365
050,39,139,"Ohio","Richland County",3,83,570,231,339
050,39,139,"Ohio","Richland County",3,84,503,192,311
050,39,139,"Ohio","Richland County",3,85,2909,1073,1836
050,39,139,"Ohio","Richland County",4,0,1345,684,661
050,39,139,"Ohio","Richland County",4,1,1382,699,683
050,39,139,"Ohio","Richland County",4,2,1462,737,725
050,39,139,"Ohio","Richland County",4,3,1451,754,697
050,39,139,"Ohio","Richland County",4,4,1429,726,703
050,39,139,"Ohio","Richland County",4,5,1416,722,694
050,39,139,"Ohio","Richland County",4,6,1476,769,707
050,39,139,"Ohio","Richland County",4,7,1531,764,767
050,39,139,"Ohio","Richland County",4,8,1515,771,744
050,39,139,"Ohio","Richland County",4,9,1521,783,738
050,39,139,"Ohio","Richland County",4,10,1502,762,740
050,39,139,"Ohio","Richland County",4,11,1524,797,727
050,39,139,"Ohio","Richland County",4,12,1575,803,772
050,39,139,"Ohio","Richland County",4,13,1581,796,785
050,39,139,"Ohio","Richland County",4,14,1669,855,814
050,39,139,"Ohio","Richland County",4,15,1669,851,818
050,39,139,"Ohio","Richland County",4,16,1653,873,780
050,39,139,"Ohio","Richland County",4,17,1587,836,751
050,39,139,"Ohio","Richland County",4,18,1473,788,685
050,39,139,"Ohio","Richland County",4,19,1317,720,597
050,39,139,"Ohio","Richland County",4,20,1332,758,574
050,39,139,"Ohio","Richland County",4,21,1476,847,629
050,39,139,"Ohio","Richland County",4,22,1535,885,650
050,39,139,"Ohio","Richland County",4,23,1599,888,711
050,39,139,"Ohio","Richland County",4,24,1579,916,663
050,39,139,"Ohio","Richland County",4,25,1599,900,699
050,39,139,"Ohio","Richland County",4,26,1663,952,711
050,39,139,"Ohio","Richland County",4,27,1638,939,699
050,39,139,"Ohio","Richland County",4,28,1671,958,713
050,39,139,"Ohio","Richland County",4,29,1722,977,745
050,39,139,"Ohio","Richland County",4,30,1754,992,762
050,39,139,"Ohio","Richland County",4,31,1757,996,761
050,39,139,"Ohio","Richland County",4,32,1667,910,757
050,39,139,"Ohio","Richland County",4,33,1585,886,699
050,39,139,"Ohio","Richland County",4,34,1539,840,699
050,39,139,"Ohio","Richland County",4,35,1525,829,696
050,39,139,"Ohio","Richland County",4,36,1506,833,673
050,39,139,"Ohio","Richland County",4,37,1500,824,676
050,39,139,"Ohio","Richland County",4,38,1452,818,634
050,39,139,"Ohio","Richland County",4,39,1513,841,672
050,39,139,"Ohio","Richland County",4,40,1513,819,694
050,39,139,"Ohio","Richland County",4,41,1501,797,704
050,39,139,"Ohio","Richland County",4,42,1505,781,724
050,39,139,"Ohio","Richland County",4,43,1514,821,693
050,39,139,"Ohio","Richland County",4,44,1530,841,689
050,39,139,"Ohio","Richland County",4,45,1519,818,701
050,39,139,"Ohio","Richland County",4,46,1443,751,692
050,39,139,"Ohio","Richland County",4,47,1459,762,697
050,39,139,"Ohio","Richland County",4,48,1412,752,660
050,39,139,"Ohio","Richland County",4,49,1436,770,666
050,39,139,"Ohio","Richland County",4,50,1484,783,701
050,39,139,"Ohio","Richland County",4,51,1525,802,723
050,39,139,"Ohio","Richland County",4,52,1501,782,719
050,39,139,"Ohio","Richland County",4,53,1467,764,703
050,39,139,"Ohio","Richland County",4,54,1463,753,710
050,39,139,"Ohio","Richland County",4,55,1517,779,738
050,39,139,"Ohio","Richland County",4,56,1508,755,753
050,39,139,"Ohio","Richland County",4,57,1545,773,772
050,39,139,"Ohio","Richland County",4,58,1586,799,787
050,39,139,"Ohio","Richland County",4,59,1610,796,814
050,39,139,"Ohio","Richland County",4,60,1631,800,831
050,39,139,"Ohio","Richland County",4,61,1686,837,849
050,39,139,"Ohio","Richland County",4,62,1688,823,865
050,39,139,"Ohio","Richland County",4,63,1665,821,844
050,39,139,"Ohio","Richland County",4,64,1687,810,877
050,39,139,"Ohio","Richland County",4,65,1668,812,856
050,39,139,"Ohio","Richland County",4,66,1639,807,832
050,39,139,"Ohio","Richland County",4,67,1645,800,845
050,39,139,"Ohio","Richland County",4,68,1592,788,804
050,39,139,"Ohio","Richland County",4,69,1491,718,773
050,39,139,"Ohio","Richland County",4,70,1411,658,753
050,39,139,"Ohio","Richland County",4,71,1375,615,760
050,39,139,"Ohio","Richland County",4,72,1280,574,706
050,39,139,"Ohio","Richland County",4,73,1268,566,702
050,39,139,"Ohio","Richland County",4,74,1229,546,683
050,39,139,"Ohio","Richland County",4,75,1337,604,733
050,39,139,"Ohio","Richland County",4,76,889,401,488
050,39,139,"Ohio","Richland County",4,77,855,391,464
050,39,139,"Ohio","Richland County",4,78,787,336,451
050,39,139,"Ohio","Richland County",4,79,817,350,467
050,39,139,"Ohio","Richland County",4,80,719,301,418
050,39,139,"Ohio","Richland County",4,81,649,269,380
050,39,139,"Ohio","Richland County",4,82,584,246,338
050,39,139,"Ohio","Richland County",4,83,570,223,347
050,39,139,"Ohio","Richland County",4,84,488,183,305
050,39,139,"Ohio","Richland County",4,85,2883,1066,1817
050,39,139,"Ohio","Richland County",5,0,1336,679,657
050,39,139,"Ohio","Richland County",5,1,1344,680,664
050,39,139,"Ohio","Richland County",5,2,1392,703,689
050,39,139,"Ohio","Richland County",5,3,1461,738,723
050,39,139,"Ohio","Richland County",5,4,1430,747,683
050,39,139,"Ohio","Richland County",5,5,1409,724,685
050,39,139,"Ohio","Richland County",5,6,1417,733,684
050,39,139,"Ohio","Richland County",5,7,1481,780,701
050,39,139,"Ohio","Richland County",5,8,1549,774,775
050,39,139,"Ohio","Richland County",5,9,1487,756,731
050,39,139,"Ohio","Richland County",5,10,1522,783,739
050,39,139,"Ohio","Richland County",5,11,1513,762,751
050,39,139,"Ohio","Richland County",5,12,1527,793,734
050,39,139,"Ohio","Richland County",5,13,1564,795,769
050,39,139,"Ohio","Richland County",5,14,1626,821,805
050,39,139,"Ohio","Richland County",5,15,1675,865,810
050,39,139,"Ohio","Richland County",5,16,1709,893,816
050,39,139,"Ohio","Richland County",5,17,1668,895,773
050,39,139,"Ohio","Richland County",5,18,1421,764,657
050,39,139,"Ohio","Richland County",5,19,1339,747,592
050,39,139,"Ohio","Richland County",5,20,1357,764,593
050,39,139,"Ohio","Richland County",5,21,1392,780,612
050,39,139,"Ohio","Richland County",5,22,1546,900,646
050,39,139,"Ohio","Richland County",5,23,1577,912,665
050,39,139,"Ohio","Richland County",5,24,1655,936,719
050,39,139,"Ohio","Richland County",5,25,1606,926,680
050,39,139,"Ohio","Richland County",5,26,1627,917,710
050,39,139,"Ohio","Richland County",5,27,1665,942,723
050,39,139,"Ohio","Richland County",5,28,1640,941,699
050,39,139,"Ohio","Richland County",5,29,1673,963,710
050,39,139,"Ohio","Richland County",5,30,1736,979,757
050,39,139,"Ohio","Richland County",5,31,1730,981,749
050,39,139,"Ohio","Richland County",5,32,1685,957,728
050,39,139,"Ohio","Richland County",5,33,1667,911,756
050,39,139,"Ohio","Richland County",5,34,1582,888,694
050,39,139,"Ohio","Richland County",5,35,1510,819,691
050,39,139,"Ohio","Richland County",5,36,1517,812,705
050,39,139,"Ohio","Richland County",5,37,1498,821,677
050,39,139,"Ohio","Richland County",5,38,1504,837,667
050,39,139,"Ohio","Richland County",5,39,1476,813,663
050,39,139,"Ohio","Richland County",5,40,1517,826,691
050,39,139,"Ohio","Richland County",5,41,1524,816,708
050,39,139,"Ohio","Richland County",5,42,1441,746,695
050,39,139,"Ohio","Richland County",5,43,1526,809,717
050,39,139,"Ohio","Richland County",5,44,1510,815,695
050,39,139,"Ohio","Richland County",5,45,1510,824,686
050,39,139,"Ohio","Richland County",5,46,1518,815,703
050,39,139,"Ohio","Richland County",5,47,1431,734,697
050,39,139,"Ohio","Richland County",5,48,1469,768,701
050,39,139,"Ohio","Richland County",5,49,1409,743,666
050,39,139,"Ohio","Richland County",5,50,1437,778,659
050,39,139,"Ohio","Richland County",5,51,1470,769,701
050,39,139,"Ohio","Richland County",5,52,1500,787,713
050,39,139,"Ohio","Richland County",5,53,1490,778,712
050,39,139,"Ohio","Richland County",5,54,1466,747,719
050,39,139,"Ohio","Richland County",5,55,1443,740,703
050,39,139,"Ohio","Richland County",5,56,1488,759,729
050,39,139,"Ohio","Richland County",5,57,1513,769,744
050,39,139,"Ohio","Richland County",5,58,1521,746,775
050,39,139,"Ohio","Richland County",5,59,1573,790,783
050,39,139,"Ohio","Richland County",5,60,1597,790,807
050,39,139,"Ohio","Richland County",5,61,1613,789,824
050,39,139,"Ohio","Richland County",5,62,1665,823,842
050,39,139,"Ohio","Richland County",5,63,1660,806,854
050,39,139,"Ohio","Richland County",5,64,1630,804,826
050,39,139,"Ohio","Richland County",5,65,1674,800,874
050,39,139,"Ohio","Richland County",5,66,1652,797,855
050,39,139,"Ohio","Richland County",5,67,1597,772,825
050,39,139,"Ohio","Richland County",5,68,1621,788,833
050,39,139,"Ohio","Richland County",5,69,1578,775,803
050,39,139,"Ohio","Richland County",5,70,1463,709,754
050,39,139,"Ohio","Richland County",5,71,1375,634,741
050,39,139,"Ohio","Richland County",5,72,1334,598,736
050,39,139,"Ohio","Richland County",5,73,1253,552,701
050,39,139,"Ohio","Richland County",5,74,1230,544,686
050,39,139,"Ohio","Richland County",5,75,1184,522,662
050,39,139,"Ohio","Richland County",5,76,1274,575,699
050,39,139,"Ohio","Richland County",5,77,859,384,475
050,39,139,"Ohio","Richland County",5,78,804,357,447
050,39,139,"Ohio","Richland County",5,79,757,326,431
050,39,139,"Ohio","Richland County",5,80,769,321,448
050,39,139,"Ohio","Richland County",5,81,657,279,378
050,39,139,"Ohio","Richland County",5,82,615,257,358
050,39,139,"Ohio","Richland County",5,83,535,218,317
050,39,139,"Ohio","Richland County",5,84,506,186,320
050,39,139,"Ohio","Richland County",5,85,2893,1077,1816
050,39,141,"Ohio","Ross County",1,0,804,412,392
050,39,141,"Ohio","Ross County",1,1,835,430,405
050,39,141,"Ohio","Ross County",1,2,852,427,425
050,39,141,"Ohio","Ross County",1,3,881,442,439
050,39,141,"Ohio","Ross County",1,4,889,452,437
050,39,141,"Ohio","Ross County",1,5,850,429,421
050,39,141,"Ohio","Ross County",1,6,902,471,431
050,39,141,"Ohio","Ross County",1,7,858,442,416
050,39,141,"Ohio","Ross County",1,8,905,463,442
050,39,141,"Ohio","Ross County",1,9,827,439,388
050,39,141,"Ohio","Ross County",1,10,903,461,442
050,39,141,"Ohio","Ross County",1,11,978,489,489
050,39,141,"Ohio","Ross County",1,12,999,507,492
050,39,141,"Ohio","Ross County",1,13,1068,550,518
050,39,141,"Ohio","Ross County",1,14,1033,535,498
050,39,141,"Ohio","Ross County",1,15,964,477,487
050,39,141,"Ohio","Ross County",1,16,939,486,453
050,39,141,"Ohio","Ross County",1,17,950,501,449
050,39,141,"Ohio","Ross County",1,18,865,489,376
050,39,141,"Ohio","Ross County",1,19,702,386,316
050,39,141,"Ohio","Ross County",1,20,789,442,347
050,39,141,"Ohio","Ross County",1,21,829,464,365
050,39,141,"Ohio","Ross County",1,22,877,477,400
050,39,141,"Ohio","Ross County",1,23,929,514,415
050,39,141,"Ohio","Ross County",1,24,988,525,463
050,39,141,"Ohio","Ross County",1,25,940,518,422
050,39,141,"Ohio","Ross County",1,26,966,538,428
050,39,141,"Ohio","Ross County",1,27,940,541,399
050,39,141,"Ohio","Ross County",1,28,1005,550,455
050,39,141,"Ohio","Ross County",1,29,1015,555,460
050,39,141,"Ohio","Ross County",1,30,992,566,426
050,39,141,"Ohio","Ross County",1,31,1008,587,421
050,39,141,"Ohio","Ross County",1,32,891,517,374
050,39,141,"Ohio","Ross County",1,33,907,533,374
050,39,141,"Ohio","Ross County",1,34,938,543,395
050,39,141,"Ohio","Ross County",1,35,917,525,392
050,39,141,"Ohio","Ross County",1,36,965,543,422
050,39,141,"Ohio","Ross County",1,37,1024,601,423
050,39,141,"Ohio","Ross County",1,38,1034,601,433
050,39,141,"Ohio","Ross County",1,39,1041,594,447
050,39,141,"Ohio","Ross County",1,40,1041,546,495
050,39,141,"Ohio","Ross County",1,41,1034,575,459
050,39,141,"Ohio","Ross County",1,42,1053,593,460
050,39,141,"Ohio","Ross County",1,43,998,541,457
050,39,141,"Ohio","Ross County",1,44,1004,564,440
050,39,141,"Ohio","Ross County",1,45,965,537,428
050,39,141,"Ohio","Ross County",1,46,1008,565,443
050,39,141,"Ohio","Ross County",1,47,1031,581,450
050,39,141,"Ohio","Ross County",1,48,1080,603,477
050,39,141,"Ohio","Ross County",1,49,1183,650,533
050,39,141,"Ohio","Ross County",1,50,1076,608,468
050,39,141,"Ohio","Ross County",1,51,1080,613,467
050,39,141,"Ohio","Ross County",1,52,1056,604,452
050,39,141,"Ohio","Ross County",1,53,1055,563,492
050,39,141,"Ohio","Ross County",1,54,1122,594,528
050,39,141,"Ohio","Ross County",1,55,1137,612,525
050,39,141,"Ohio","Ross County",1,56,1065,570,495
050,39,141,"Ohio","Ross County",1,57,1118,574,544
050,39,141,"Ohio","Ross County",1,58,1131,582,549
050,39,141,"Ohio","Ross County",1,59,1146,580,566
050,39,141,"Ohio","Ross County",1,60,1112,559,553
050,39,141,"Ohio","Ross County",1,61,1114,555,559
050,39,141,"Ohio","Ross County",1,62,1082,539,543
050,39,141,"Ohio","Ross County",1,63,1088,536,552
050,39,141,"Ohio","Ross County",1,64,1077,547,530
050,39,141,"Ohio","Ross County",1,65,1019,528,491
050,39,141,"Ohio","Ross County",1,66,938,467,471
050,39,141,"Ohio","Ross County",1,67,900,429,471
050,39,141,"Ohio","Ross County",1,68,839,409,430
050,39,141,"Ohio","Ross County",1,69,791,374,417
050,39,141,"Ohio","Ross County",1,70,763,358,405
050,39,141,"Ohio","Ross County",1,71,717,331,386
050,39,141,"Ohio","Ross County",1,72,734,344,390
050,39,141,"Ohio","Ross County",1,73,778,372,406
050,39,141,"Ohio","Ross County",1,74,487,228,259
050,39,141,"Ohio","Ross County",1,75,492,215,277
050,39,141,"Ohio","Ross County",1,76,538,240,298
050,39,141,"Ohio","Ross County",1,77,517,243,274
050,39,141,"Ohio","Ross County",1,78,441,192,249
050,39,141,"Ohio","Ross County",1,79,432,186,246
050,39,141,"Ohio","Ross County",1,80,395,159,236
050,39,141,"Ohio","Ross County",1,81,358,144,214
050,39,141,"Ohio","Ross County",1,82,322,139,183
050,39,141,"Ohio","Ross County",1,83,275,119,156
050,39,141,"Ohio","Ross County",1,84,262,113,149
050,39,141,"Ohio","Ross County",1,85,1225,425,800
050,39,141,"Ohio","Ross County",2,0,797,402,395
050,39,141,"Ohio","Ross County",2,1,823,423,400
050,39,141,"Ohio","Ross County",2,2,846,426,420
050,39,141,"Ohio","Ross County",2,3,870,436,434
050,39,141,"Ohio","Ross County",2,4,889,451,438
050,39,141,"Ohio","Ross County",2,5,864,440,424
050,39,141,"Ohio","Ross County",2,6,894,466,428
050,39,141,"Ohio","Ross County",2,7,873,451,422
050,39,141,"Ohio","Ross County",2,8,894,456,438
050,39,141,"Ohio","Ross County",2,9,846,444,402
050,39,141,"Ohio","Ross County",2,10,887,455,432
050,39,141,"Ohio","Ross County",2,11,957,481,476
050,39,141,"Ohio","Ross County",2,12,1004,509,495
050,39,141,"Ohio","Ross County",2,13,1051,542,509
050,39,141,"Ohio","Ross County",2,14,1041,537,504
050,39,141,"Ohio","Ross County",2,15,978,491,487
050,39,141,"Ohio","Ross County",2,16,948,487,461
050,39,141,"Ohio","Ross County",2,17,947,498,449
050,39,141,"Ohio","Ross County",2,18,848,475,373
050,39,141,"Ohio","Ross County",2,19,704,390,314
050,39,141,"Ohio","Ross County",2,20,794,443,351
050,39,141,"Ohio","Ross County",2,21,833,466,367
050,39,141,"Ohio","Ross County",2,22,878,480,398
050,39,141,"Ohio","Ross County",2,23,933,515,418
050,39,141,"Ohio","Ross County",2,24,967,515,452
050,39,141,"Ohio","Ross County",2,25,954,525,429
050,39,141,"Ohio","Ross County",2,26,961,535,426
050,39,141,"Ohio","Ross County",2,27,948,540,408
050,39,141,"Ohio","Ross County",2,28,993,551,442
050,39,141,"Ohio","Ross County",2,29,1020,560,460
050,39,141,"Ohio","Ross County",2,30,1004,566,438
050,39,141,"Ohio","Ross County",2,31,1004,583,421
050,39,141,"Ohio","Ross County",2,32,911,527,384
050,39,141,"Ohio","Ross County",2,33,906,533,373
050,39,141,"Ohio","Ross County",2,34,928,536,392
050,39,141,"Ohio","Ross County",2,35,925,529,396
050,39,141,"Ohio","Ross County",2,36,953,539,414
050,39,141,"Ohio","Ross County",2,37,1024,599,425
050,39,141,"Ohio","Ross County",2,38,1028,597,431
050,39,141,"Ohio","Ross County",2,39,1046,603,443
050,39,141,"Ohio","Ross County",2,40,1037,555,482
050,39,141,"Ohio","Ross County",2,41,1039,572,467
050,39,141,"Ohio","Ross County",2,42,1039,584,455
050,39,141,"Ohio","Ross County",2,43,1013,553,460
050,39,141,"Ohio","Ross County",2,44,996,556,440
050,39,141,"Ohio","Ross County",2,45,975,540,435
050,39,141,"Ohio","Ross County",2,46,1004,566,438
050,39,141,"Ohio","Ross County",2,47,1013,567,446
050,39,141,"Ohio","Ross County",2,48,1067,594,473
050,39,141,"Ohio","Ross County",2,49,1168,646,522
050,39,141,"Ohio","Ross County",2,50,1098,612,486
050,39,141,"Ohio","Ross County",2,51,1078,613,465
050,39,141,"Ohio","Ross County",2,52,1057,601,456
050,39,141,"Ohio","Ross County",2,53,1050,571,479
050,39,141,"Ohio","Ross County",2,54,1103,585,518
050,39,141,"Ohio","Ross County",2,55,1125,603,522
050,39,141,"Ohio","Ross County",2,56,1080,577,503
050,39,141,"Ohio","Ross County",2,57,1099,570,529
050,39,141,"Ohio","Ross County",2,58,1124,579,545
050,39,141,"Ohio","Ross County",2,59,1146,586,560
050,39,141,"Ohio","Ross County",2,60,1110,557,553
050,39,141,"Ohio","Ross County",2,61,1105,550,555
050,39,141,"Ohio","Ross County",2,62,1086,539,547
050,39,141,"Ohio","Ross County",2,63,1093,541,552
050,39,141,"Ohio","Ross County",2,64,1065,538,527
050,39,141,"Ohio","Ross County",2,65,1026,526,500
050,39,141,"Ohio","Ross County",2,66,959,481,478
050,39,141,"Ohio","Ross County",2,67,900,433,467
050,39,141,"Ohio","Ross County",2,68,845,410,435
050,39,141,"Ohio","Ross County",2,69,799,379,420
050,39,141,"Ohio","Ross County",2,70,764,358,406
050,39,141,"Ohio","Ross County",2,71,730,336,394
050,39,141,"Ohio","Ross County",2,72,710,331,379
050,39,141,"Ohio","Ross County",2,73,799,380,419
050,39,141,"Ohio","Ross County",2,74,516,241,275
050,39,141,"Ohio","Ross County",2,75,486,216,270
050,39,141,"Ohio","Ross County",2,76,512,228,284
050,39,141,"Ohio","Ross County",2,77,529,246,283
050,39,141,"Ohio","Ross County",2,78,447,196,251
050,39,141,"Ohio","Ross County",2,79,427,185,242
050,39,141,"Ohio","Ross County",2,80,400,164,236
050,39,141,"Ohio","Ross County",2,81,361,146,215
050,39,141,"Ohio","Ross County",2,82,330,140,190
050,39,141,"Ohio","Ross County",2,83,278,118,160
050,39,141,"Ohio","Ross County",2,84,256,110,146
050,39,141,"Ohio","Ross County",2,85,1234,424,810
050,39,141,"Ohio","Ross County",3,0,790,436,354
050,39,141,"Ohio","Ross County",3,1,800,407,393
050,39,141,"Ohio","Ross County",3,2,845,449,396
050,39,141,"Ohio","Ross County",3,3,861,434,427
050,39,141,"Ohio","Ross County",3,4,853,438,415
050,39,141,"Ohio","Ross County",3,5,869,444,425
050,39,141,"Ohio","Ross County",3,6,868,453,415
050,39,141,"Ohio","Ross County",3,7,873,446,427
050,39,141,"Ohio","Ross County",3,8,868,451,417
050,39,141,"Ohio","Ross County",3,9,906,461,445
050,39,141,"Ohio","Ross County",3,10,856,437,419
050,39,141,"Ohio","Ross County",3,11,884,445,439
050,39,141,"Ohio","Ross County",3,12,964,484,480
050,39,141,"Ohio","Ross County",3,13,1000,507,493
050,39,141,"Ohio","Ross County",3,14,1049,540,509
050,39,141,"Ohio","Ross County",3,15,1018,534,484
050,39,141,"Ohio","Ross County",3,16,1013,514,499
050,39,141,"Ohio","Ross County",3,17,964,492,472
050,39,141,"Ohio","Ross County",3,18,803,437,366
050,39,141,"Ohio","Ross County",3,19,693,390,303
050,39,141,"Ohio","Ross County",3,20,770,426,344
050,39,141,"Ohio","Ross County",3,21,858,467,391
050,39,141,"Ohio","Ross County",3,22,891,497,394
050,39,141,"Ohio","Ross County",3,23,922,509,413
050,39,141,"Ohio","Ross County",3,24,918,505,413
050,39,141,"Ohio","Ross County",3,25,1006,557,449
050,39,141,"Ohio","Ross County",3,26,951,528,423
050,39,141,"Ohio","Ross County",3,27,968,525,443
050,39,141,"Ohio","Ross County",3,28,953,545,408
050,39,141,"Ohio","Ross County",3,29,1002,558,444
050,39,141,"Ohio","Ross County",3,30,980,536,444
050,39,141,"Ohio","Ross County",3,31,1013,569,444
050,39,141,"Ohio","Ross County",3,32,985,563,422
050,39,141,"Ohio","Ross County",3,33,942,544,398
050,39,141,"Ohio","Ross County",3,34,893,526,367
050,39,141,"Ohio","Ross County",3,35,906,513,393
050,39,141,"Ohio","Ross County",3,36,925,525,400
050,39,141,"Ohio","Ross County",3,37,971,557,414
050,39,141,"Ohio","Ross County",3,38,987,556,431
050,39,141,"Ohio","Ross County",3,39,1039,605,434
050,39,141,"Ohio","Ross County",3,40,1013,571,442
050,39,141,"Ohio","Ross County",3,41,1035,563,472
050,39,141,"Ohio","Ross County",3,42,1023,548,475
050,39,141,"Ohio","Ross County",3,43,1021,564,457
050,39,141,"Ohio","Ross County",3,44,1009,560,449
050,39,141,"Ohio","Ross County",3,45,970,534,436
050,39,141,"Ohio","Ross County",3,46,989,556,433
050,39,141,"Ohio","Ross County",3,47,982,545,437
050,39,141,"Ohio","Ross County",3,48,1008,556,452
050,39,141,"Ohio","Ross County",3,49,1071,604,467
050,39,141,"Ohio","Ross County",3,50,1112,595,517
050,39,141,"Ohio","Ross County",3,51,1082,602,480
050,39,141,"Ohio","Ross County",3,52,1061,591,470
050,39,141,"Ohio","Ross County",3,53,1039,587,452
050,39,141,"Ohio","Ross County",3,54,1057,568,489
050,39,141,"Ohio","Ross County",3,55,1070,557,513
050,39,141,"Ohio","Ross County",3,56,1100,583,517
050,39,141,"Ohio","Ross County",3,57,1061,572,489
050,39,141,"Ohio","Ross County",3,58,1074,554,520
050,39,141,"Ohio","Ross County",3,59,1109,569,540
050,39,141,"Ohio","Ross County",3,60,1124,570,554
050,39,141,"Ohio","Ross County",3,61,1097,537,560
050,39,141,"Ohio","Ross County",3,62,1076,524,552
050,39,141,"Ohio","Ross County",3,63,1068,523,545
050,39,141,"Ohio","Ross County",3,64,1055,523,532
050,39,141,"Ohio","Ross County",3,65,1040,519,521
050,39,141,"Ohio","Ross County",3,66,1005,507,498
050,39,141,"Ohio","Ross County",3,67,926,458,468
050,39,141,"Ohio","Ross County",3,68,881,415,466
050,39,141,"Ohio","Ross County",3,69,800,382,418
050,39,141,"Ohio","Ross County",3,70,780,367,413
050,39,141,"Ohio","Ross County",3,71,748,348,400
050,39,141,"Ohio","Ross County",3,72,712,323,389
050,39,141,"Ohio","Ross County",3,73,669,310,359
050,39,141,"Ohio","Ross County",3,74,760,359,401
050,39,141,"Ohio","Ross County",3,75,490,225,265
050,39,141,"Ohio","Ross County",3,76,467,212,255
050,39,141,"Ohio","Ross County",3,77,489,207,282
050,39,141,"Ohio","Ross County",3,78,500,231,269
050,39,141,"Ohio","Ross County",3,79,411,178,233
050,39,141,"Ohio","Ross County",3,80,382,159,223
050,39,141,"Ohio","Ross County",3,81,381,149,232
050,39,141,"Ohio","Ross County",3,82,334,139,195
050,39,141,"Ohio","Ross County",3,83,294,121,173
050,39,141,"Ohio","Ross County",3,84,251,104,147
050,39,141,"Ohio","Ross County",3,85,1217,432,785
050,39,141,"Ohio","Ross County",4,0,757,408,349
050,39,141,"Ohio","Ross County",4,1,821,446,375
050,39,141,"Ohio","Ross County",4,2,797,412,385
050,39,141,"Ohio","Ross County",4,3,854,449,405
050,39,141,"Ohio","Ross County",4,4,863,427,436
050,39,141,"Ohio","Ross County",4,5,857,432,425
050,39,141,"Ohio","Ross County",4,6,892,453,439
050,39,141,"Ohio","Ross County",4,7,861,457,404
050,39,141,"Ohio","Ross County",4,8,891,451,440
050,39,141,"Ohio","Ross County",4,9,883,459,424
050,39,141,"Ohio","Ross County",4,10,914,471,443
050,39,141,"Ohio","Ross County",4,11,864,441,423
050,39,141,"Ohio","Ross County",4,12,870,434,436
050,39,141,"Ohio","Ross County",4,13,976,480,496
050,39,141,"Ohio","Ross County",4,14,1033,518,515
050,39,141,"Ohio","Ross County",4,15,1053,537,516
050,39,141,"Ohio","Ross County",4,16,1034,548,486
050,39,141,"Ohio","Ross County",4,17,1012,509,503
050,39,141,"Ohio","Ross County",4,18,786,422,364
050,39,141,"Ohio","Ross County",4,19,634,352,282
050,39,141,"Ohio","Ross County",4,20,760,436,324
050,39,141,"Ohio","Ross County",4,21,821,457,364
050,39,141,"Ohio","Ross County",4,22,915,497,418
050,39,141,"Ohio","Ross County",4,23,938,529,409
050,39,141,"Ohio","Ross County",4,24,922,508,414
050,39,141,"Ohio","Ross County",4,25,942,509,433
050,39,141,"Ohio","Ross County",4,26,1023,564,459
050,39,141,"Ohio","Ross County",4,27,971,554,417
050,39,141,"Ohio","Ross County",4,28,981,534,447
050,39,141,"Ohio","Ross County",4,29,987,578,409
050,39,141,"Ohio","Ross County",4,30,1000,542,458
050,39,141,"Ohio","Ross County",4,31,1012,571,441
050,39,141,"Ohio","Ross County",4,32,1031,571,460
050,39,141,"Ohio","Ross County",4,33,1008,576,432
050,39,141,"Ohio","Ross County",4,34,935,542,393
050,39,141,"Ohio","Ross County",4,35,902,530,372
050,39,141,"Ohio","Ross County",4,36,911,532,379
050,39,141,"Ohio","Ross County",4,37,958,555,403
050,39,141,"Ohio","Ross County",4,38,953,544,409
050,39,141,"Ohio","Ross County",4,39,1032,597,435
050,39,141,"Ohio","Ross County",4,40,1016,593,423
050,39,141,"Ohio","Ross County",4,41,1029,595,434
050,39,141,"Ohio","Ross County",4,42,1030,555,475
050,39,141,"Ohio","Ross County",4,43,1009,539,470
050,39,141,"Ohio","Ross County",4,44,1035,577,458
050,39,141,"Ohio","Ross County",4,45,1025,560,465
050,39,141,"Ohio","Ross County",4,46,1008,570,438
050,39,141,"Ohio","Ross County",4,47,971,544,427
050,39,141,"Ohio","Ross County",4,48,972,550,422
050,39,141,"Ohio","Ross County",4,49,1023,584,439
050,39,141,"Ohio","Ross County",4,50,1047,579,468
050,39,141,"Ohio","Ross County",4,51,1128,606,522
050,39,141,"Ohio","Ross County",4,52,1060,587,473
050,39,141,"Ohio","Ross County",4,53,1043,586,457
050,39,141,"Ohio","Ross County",4,54,1064,592,472
050,39,141,"Ohio","Ross County",4,55,1034,550,484
050,39,141,"Ohio","Ross County",4,56,1058,549,509
050,39,141,"Ohio","Ross County",4,57,1080,564,516
050,39,141,"Ohio","Ross County",4,58,1035,548,487
050,39,141,"Ohio","Ross County",4,59,1063,550,513
050,39,141,"Ohio","Ross County",4,60,1084,551,533
050,39,141,"Ohio","Ross County",4,61,1111,549,562
050,39,141,"Ohio","Ross County",4,62,1068,515,553
050,39,141,"Ohio","Ross County",4,63,1054,509,545
050,39,141,"Ohio","Ross County",4,64,1036,509,527
050,39,141,"Ohio","Ross County",4,65,1018,495,523
050,39,141,"Ohio","Ross County",4,66,1027,502,525
050,39,141,"Ohio","Ross County",4,67,984,494,490
050,39,141,"Ohio","Ross County",4,68,915,452,463
050,39,141,"Ohio","Ross County",4,69,846,395,451
050,39,141,"Ohio","Ross County",4,70,768,370,398
050,39,141,"Ohio","Ross County",4,71,762,356,406
050,39,141,"Ohio","Ross County",4,72,721,332,389
050,39,141,"Ohio","Ross County",4,73,672,303,369
050,39,141,"Ohio","Ross County",4,74,628,284,344
050,39,141,"Ohio","Ross County",4,75,716,338,378
050,39,141,"Ohio","Ross County",4,76,458,210,248
050,39,141,"Ohio","Ross County",4,77,449,196,253
050,39,141,"Ohio","Ross County",4,78,466,187,279
050,39,141,"Ohio","Ross County",4,79,473,215,258
050,39,141,"Ohio","Ross County",4,80,371,157,214
050,39,141,"Ohio","Ross County",4,81,355,144,211
050,39,141,"Ohio","Ross County",4,82,351,144,207
050,39,141,"Ohio","Ross County",4,83,311,129,182
050,39,141,"Ohio","Ross County",4,84,263,106,157
050,39,141,"Ohio","Ross County",4,85,1217,437,780
050,39,141,"Ohio","Ross County",5,0,764,415,349
050,39,141,"Ohio","Ross County",5,1,774,413,361
050,39,141,"Ohio","Ross County",5,2,824,436,388
050,39,141,"Ohio","Ross County",5,3,810,422,388
050,39,141,"Ohio","Ross County",5,4,855,459,396
050,39,141,"Ohio","Ross County",5,5,849,420,429
050,39,141,"Ohio","Ross County",5,6,862,433,429
050,39,141,"Ohio","Ross County",5,7,907,466,441
050,39,141,"Ohio","Ross County",5,8,865,450,415
050,39,141,"Ohio","Ross County",5,9,901,467,434
050,39,141,"Ohio","Ross County",5,10,879,459,420
050,39,141,"Ohio","Ross County",5,11,912,469,443
050,39,141,"Ohio","Ross County",5,12,877,448,429
050,39,141,"Ohio","Ross County",5,13,886,439,447
050,39,141,"Ohio","Ross County",5,14,969,474,495
050,39,141,"Ohio","Ross County",5,15,1017,514,503
050,39,141,"Ohio","Ross County",5,16,1069,556,513
050,39,141,"Ohio","Ross County",5,17,1016,535,481
050,39,141,"Ohio","Ross County",5,18,838,439,399
050,39,141,"Ohio","Ross County",5,19,620,338,282
050,39,141,"Ohio","Ross County",5,20,696,387,309
050,39,141,"Ohio","Ross County",5,21,828,475,353
050,39,141,"Ohio","Ross County",5,22,911,510,401
050,39,141,"Ohio","Ross County",5,23,962,550,412
050,39,141,"Ohio","Ross County",5,24,941,508,433
050,39,141,"Ohio","Ross County",5,25,926,516,410
050,39,141,"Ohio","Ross County",5,26,975,529,446
050,39,141,"Ohio","Ross County",5,27,1023,565,458
050,39,141,"Ohio","Ross County",5,28,982,555,427
050,39,141,"Ohio","Ross County",5,29,1019,569,450
050,39,141,"Ohio","Ross County",5,30,994,575,419
050,39,141,"Ohio","Ross County",5,31,1039,579,460
050,39,141,"Ohio","Ross County",5,32,1008,546,462
050,39,141,"Ohio","Ross County",5,33,1068,604,464
050,39,141,"Ohio","Ross County",5,34,996,583,413
050,39,141,"Ohio","Ross County",5,35,929,525,404
050,39,141,"Ohio","Ross County",5,36,899,525,374
050,39,141,"Ohio","Ross County",5,37,951,570,381
050,39,141,"Ohio","Ross County",5,38,942,538,404
050,39,141,"Ohio","Ross County",5,39,967,564,403
050,39,141,"Ohio","Ross County",5,40,1014,579,435
050,39,141,"Ohio","Ross County",5,41,1006,587,419
050,39,141,"Ohio","Ross County",5,42,1042,597,445
050,39,141,"Ohio","Ross County",5,43,1016,537,479
050,39,141,"Ohio","Ross County",5,44,1015,545,470
050,39,141,"Ohio","Ross County",5,45,1016,555,461
050,39,141,"Ohio","Ross County",5,46,1060,592,468
050,39,141,"Ohio","Ross County",5,47,992,555,437
050,39,141,"Ohio","Ross County",5,48,966,535,431
050,39,141,"Ohio","Ross County",5,49,983,562,421
050,39,141,"Ohio","Ross County",5,50,992,550,442
050,39,141,"Ohio","Ross County",5,51,1038,575,463
050,39,141,"Ohio","Ross County",5,52,1124,602,522
050,39,141,"Ohio","Ross County",5,53,1056,584,472
050,39,141,"Ohio","Ross County",5,54,1049,589,460
050,39,141,"Ohio","Ross County",5,55,1052,573,479
050,39,141,"Ohio","Ross County",5,56,1026,542,484
050,39,141,"Ohio","Ross County",5,57,1045,536,509
050,39,141,"Ohio","Ross County",5,58,1055,544,511
050,39,141,"Ohio","Ross County",5,59,1027,548,479
050,39,141,"Ohio","Ross County",5,60,1044,535,509
050,39,141,"Ohio","Ross County",5,61,1059,530,529
050,39,141,"Ohio","Ross County",5,62,1080,521,559
050,39,141,"Ohio","Ross County",5,63,1067,509,558
050,39,141,"Ohio","Ross County",5,64,1031,494,537
050,39,141,"Ohio","Ross County",5,65,1017,489,528
050,39,141,"Ohio","Ross County",5,66,993,474,519
050,39,141,"Ohio","Ross County",5,67,1012,495,517
050,39,141,"Ohio","Ross County",5,68,967,482,485
050,39,141,"Ohio","Ross County",5,69,877,429,448
050,39,141,"Ohio","Ross County",5,70,825,388,437
050,39,141,"Ohio","Ross County",5,71,759,364,395
050,39,141,"Ohio","Ross County",5,72,748,345,403
050,39,141,"Ohio","Ross County",5,73,691,318,373
050,39,141,"Ohio","Ross County",5,74,634,281,353
050,39,141,"Ohio","Ross County",5,75,602,273,329
050,39,141,"Ohio","Ross County",5,76,686,324,362
050,39,141,"Ohio","Ross County",5,77,436,191,245
050,39,141,"Ohio","Ross County",5,78,433,182,251
050,39,141,"Ohio","Ross County",5,79,442,176,266
050,39,141,"Ohio","Ross County",5,80,431,193,238
050,39,141,"Ohio","Ross County",5,81,350,143,207
050,39,141,"Ohio","Ross County",5,82,325,134,191
050,39,141,"Ohio","Ross County",5,83,323,133,190
050,39,141,"Ohio","Ross County",5,84,284,118,166
050,39,141,"Ohio","Ross County",5,85,1261,464,797
050,39,143,"Ohio","Sandusky County",1,0,620,316,304
050,39,143,"Ohio","Sandusky County",1,1,636,332,304
050,39,143,"Ohio","Sandusky County",1,2,650,334,316
050,39,143,"Ohio","Sandusky County",1,3,657,342,315
050,39,143,"Ohio","Sandusky County",1,4,686,368,318
050,39,143,"Ohio","Sandusky County",1,5,685,356,329
050,39,143,"Ohio","Sandusky County",1,6,692,347,345
050,39,143,"Ohio","Sandusky County",1,7,682,353,329
050,39,143,"Ohio","Sandusky County",1,8,708,383,325
050,39,143,"Ohio","Sandusky County",1,9,718,379,339
050,39,143,"Ohio","Sandusky County",1,10,753,376,377
050,39,143,"Ohio","Sandusky County",1,11,784,383,401
050,39,143,"Ohio","Sandusky County",1,12,812,404,408
050,39,143,"Ohio","Sandusky County",1,13,796,408,388
050,39,143,"Ohio","Sandusky County",1,14,785,406,379
050,39,143,"Ohio","Sandusky County",1,15,788,414,374
050,39,143,"Ohio","Sandusky County",1,16,803,415,388
050,39,143,"Ohio","Sandusky County",1,17,825,414,411
050,39,143,"Ohio","Sandusky County",1,18,708,388,320
050,39,143,"Ohio","Sandusky County",1,19,586,322,264
050,39,143,"Ohio","Sandusky County",1,20,596,320,276
050,39,143,"Ohio","Sandusky County",1,21,626,337,289
050,39,143,"Ohio","Sandusky County",1,22,614,313,301
050,39,143,"Ohio","Sandusky County",1,23,658,334,324
050,39,143,"Ohio","Sandusky County",1,24,659,335,324
050,39,143,"Ohio","Sandusky County",1,25,670,356,314
050,39,143,"Ohio","Sandusky County",1,26,671,329,342
050,39,143,"Ohio","Sandusky County",1,27,688,319,369
050,39,143,"Ohio","Sandusky County",1,28,657,305,352
050,39,143,"Ohio","Sandusky County",1,29,692,345,347
050,39,143,"Ohio","Sandusky County",1,30,695,362,333
050,39,143,"Ohio","Sandusky County",1,31,647,324,323
050,39,143,"Ohio","Sandusky County",1,32,655,337,318
050,39,143,"Ohio","Sandusky County",1,33,644,323,321
050,39,143,"Ohio","Sandusky County",1,34,697,349,348
050,39,143,"Ohio","Sandusky County",1,35,699,345,354
050,39,143,"Ohio","Sandusky County",1,36,732,376,356
050,39,143,"Ohio","Sandusky County",1,37,711,364,347
050,39,143,"Ohio","Sandusky County",1,38,743,377,366
050,39,143,"Ohio","Sandusky County",1,39,744,374,370
050,39,143,"Ohio","Sandusky County",1,40,771,405,366
050,39,143,"Ohio","Sandusky County",1,41,704,359,345
050,39,143,"Ohio","Sandusky County",1,42,700,370,330
050,39,143,"Ohio","Sandusky County",1,43,679,357,322
050,39,143,"Ohio","Sandusky County",1,44,636,316,320
050,39,143,"Ohio","Sandusky County",1,45,687,353,334
050,39,143,"Ohio","Sandusky County",1,46,694,354,340
050,39,143,"Ohio","Sandusky County",1,47,676,337,339
050,39,143,"Ohio","Sandusky County",1,48,737,369,368
050,39,143,"Ohio","Sandusky County",1,49,822,417,405
050,39,143,"Ohio","Sandusky County",1,50,748,383,365
050,39,143,"Ohio","Sandusky County",1,51,713,362,351
050,39,143,"Ohio","Sandusky County",1,52,752,389,363
050,39,143,"Ohio","Sandusky County",1,53,777,390,387
050,39,143,"Ohio","Sandusky County",1,54,817,415,402
050,39,143,"Ohio","Sandusky County",1,55,870,441,429
050,39,143,"Ohio","Sandusky County",1,56,883,449,434
050,39,143,"Ohio","Sandusky County",1,57,839,425,414
050,39,143,"Ohio","Sandusky County",1,58,854,431,423
050,39,143,"Ohio","Sandusky County",1,59,879,438,441
050,39,143,"Ohio","Sandusky County",1,60,884,434,450
050,39,143,"Ohio","Sandusky County",1,61,906,464,442
050,39,143,"Ohio","Sandusky County",1,62,919,473,446
050,39,143,"Ohio","Sandusky County",1,63,926,466,460
050,39,143,"Ohio","Sandusky County",1,64,884,432,452
050,39,143,"Ohio","Sandusky County",1,65,810,384,426
050,39,143,"Ohio","Sandusky County",1,66,803,384,419
050,39,143,"Ohio","Sandusky County",1,67,787,390,397
050,39,143,"Ohio","Sandusky County",1,68,732,365,367
050,39,143,"Ohio","Sandusky County",1,69,666,322,344
050,39,143,"Ohio","Sandusky County",1,70,630,292,338
050,39,143,"Ohio","Sandusky County",1,71,630,311,319
050,39,143,"Ohio","Sandusky County",1,72,646,313,333
050,39,143,"Ohio","Sandusky County",1,73,653,313,340
050,39,143,"Ohio","Sandusky County",1,74,426,202,224
050,39,143,"Ohio","Sandusky County",1,75,420,197,223
050,39,143,"Ohio","Sandusky County",1,76,431,189,242
050,39,143,"Ohio","Sandusky County",1,77,381,168,213
050,39,143,"Ohio","Sandusky County",1,78,342,150,192
050,39,143,"Ohio","Sandusky County",1,79,341,144,197
050,39,143,"Ohio","Sandusky County",1,80,313,142,171
050,39,143,"Ohio","Sandusky County",1,81,274,125,149
050,39,143,"Ohio","Sandusky County",1,82,261,108,153
050,39,143,"Ohio","Sandusky County",1,83,239,88,151
050,39,143,"Ohio","Sandusky County",1,84,230,94,136
050,39,143,"Ohio","Sandusky County",1,85,1242,440,802
050,39,143,"Ohio","Sandusky County",2,0,622,313,309
050,39,143,"Ohio","Sandusky County",2,1,632,328,304
050,39,143,"Ohio","Sandusky County",2,2,649,335,314
050,39,143,"Ohio","Sandusky County",2,3,650,335,315
050,39,143,"Ohio","Sandusky County",2,4,680,360,320
050,39,143,"Ohio","Sandusky County",2,5,685,357,328
050,39,143,"Ohio","Sandusky County",2,6,692,350,342
050,39,143,"Ohio","Sandusky County",2,7,683,350,333
050,39,143,"Ohio","Sandusky County",2,8,698,376,322
050,39,143,"Ohio","Sandusky County",2,9,719,382,337
050,39,143,"Ohio","Sandusky County",2,10,744,377,367
050,39,143,"Ohio","Sandusky County",2,11,773,381,392
050,39,143,"Ohio","Sandusky County",2,12,809,403,406
050,39,143,"Ohio","Sandusky County",2,13,796,405,391
050,39,143,"Ohio","Sandusky County",2,14,789,408,381
050,39,143,"Ohio","Sandusky County",2,15,791,411,380
050,39,143,"Ohio","Sandusky County",2,16,804,417,387
050,39,143,"Ohio","Sandusky County",2,17,819,412,407
050,39,143,"Ohio","Sandusky County",2,18,699,376,323
050,39,143,"Ohio","Sandusky County",2,19,583,321,262
050,39,143,"Ohio","Sandusky County",2,20,612,330,282
050,39,143,"Ohio","Sandusky County",2,21,621,333,288
050,39,143,"Ohio","Sandusky County",2,22,623,320,303
050,39,143,"Ohio","Sandusky County",2,23,650,328,322
050,39,143,"Ohio","Sandusky County",2,24,659,336,323
050,39,143,"Ohio","Sandusky County",2,25,673,353,320
050,39,143,"Ohio","Sandusky County",2,26,671,333,338
050,39,143,"Ohio","Sandusky County",2,27,683,319,364
050,39,143,"Ohio","Sandusky County",2,28,669,310,359
050,39,143,"Ohio","Sandusky County",2,29,683,337,346
050,39,143,"Ohio","Sandusky County",2,30,698,358,340
050,39,143,"Ohio","Sandusky County",2,31,657,333,324
050,39,143,"Ohio","Sandusky County",2,32,651,331,320
050,39,143,"Ohio","Sandusky County",2,33,648,326,322
050,39,143,"Ohio","Sandusky County",2,34,689,346,343
050,39,143,"Ohio","Sandusky County",2,35,706,350,356
050,39,143,"Ohio","Sandusky County",2,36,720,368,352
050,39,143,"Ohio","Sandusky County",2,37,715,367,348
050,39,143,"Ohio","Sandusky County",2,38,736,374,362
050,39,143,"Ohio","Sandusky County",2,39,740,373,367
050,39,143,"Ohio","Sandusky County",2,40,768,400,368
050,39,143,"Ohio","Sandusky County",2,41,717,367,350
050,39,143,"Ohio","Sandusky County",2,42,698,368,330
050,39,143,"Ohio","Sandusky County",2,43,692,365,327
050,39,143,"Ohio","Sandusky County",2,44,643,323,320
050,39,143,"Ohio","Sandusky County",2,45,679,346,333
050,39,143,"Ohio","Sandusky County",2,46,690,354,336
050,39,143,"Ohio","Sandusky County",2,47,677,341,336
050,39,143,"Ohio","Sandusky County",2,48,720,360,360
050,39,143,"Ohio","Sandusky County",2,49,805,409,396
050,39,143,"Ohio","Sandusky County",2,50,766,389,377
050,39,143,"Ohio","Sandusky County",2,51,721,368,353
050,39,143,"Ohio","Sandusky County",2,52,739,381,358
050,39,143,"Ohio","Sandusky County",2,53,768,388,380
050,39,143,"Ohio","Sandusky County",2,54,805,408,397
050,39,143,"Ohio","Sandusky County",2,55,856,433,423
050,39,143,"Ohio","Sandusky County",2,56,881,447,434
050,39,143,"Ohio","Sandusky County",2,57,848,429,419
050,39,143,"Ohio","Sandusky County",2,58,849,431,418
050,39,143,"Ohio","Sandusky County",2,59,875,439,436
050,39,143,"Ohio","Sandusky County",2,60,880,433,447
050,39,143,"Ohio","Sandusky County",2,61,895,452,443
050,39,143,"Ohio","Sandusky County",2,62,917,472,445
050,39,143,"Ohio","Sandusky County",2,63,928,471,457
050,39,143,"Ohio","Sandusky County",2,64,882,434,448
050,39,143,"Ohio","Sandusky County",2,65,822,395,427
050,39,143,"Ohio","Sandusky County",2,66,800,382,418
050,39,143,"Ohio","Sandusky County",2,67,788,387,401
050,39,143,"Ohio","Sandusky County",2,68,732,365,367
050,39,143,"Ohio","Sandusky County",2,69,685,333,352
050,39,143,"Ohio","Sandusky County",2,70,632,295,337
050,39,143,"Ohio","Sandusky County",2,71,628,304,324
050,39,143,"Ohio","Sandusky County",2,72,632,308,324
050,39,143,"Ohio","Sandusky County",2,73,674,321,353
050,39,143,"Ohio","Sandusky County",2,74,450,213,237
050,39,143,"Ohio","Sandusky County",2,75,418,196,222
050,39,143,"Ohio","Sandusky County",2,76,423,190,233
050,39,143,"Ohio","Sandusky County",2,77,398,173,225
050,39,143,"Ohio","Sandusky County",2,78,342,150,192
050,39,143,"Ohio","Sandusky County",2,79,334,142,192
050,39,143,"Ohio","Sandusky County",2,80,320,142,178
050,39,143,"Ohio","Sandusky County",2,81,276,125,151
050,39,143,"Ohio","Sandusky County",2,82,258,110,148
050,39,143,"Ohio","Sandusky County",2,83,243,92,151
050,39,143,"Ohio","Sandusky County",2,84,230,93,137
050,39,143,"Ohio","Sandusky County",2,85,1251,443,808
050,39,143,"Ohio","Sandusky County",3,0,561,277,284
050,39,143,"Ohio","Sandusky County",3,1,634,314,320
050,39,143,"Ohio","Sandusky County",3,2,628,313,315
050,39,143,"Ohio","Sandusky County",3,3,643,335,308
050,39,143,"Ohio","Sandusky County",3,4,670,353,317
050,39,143,"Ohio","Sandusky County",3,5,694,360,334
050,39,143,"Ohio","Sandusky County",3,6,707,379,328
050,39,143,"Ohio","Sandusky County",3,7,696,346,350
050,39,143,"Ohio","Sandusky County",3,8,682,347,335
050,39,143,"Ohio","Sandusky County",3,9,712,380,332
050,39,143,"Ohio","Sandusky County",3,10,723,384,339
050,39,143,"Ohio","Sandusky County",3,11,759,392,367
050,39,143,"Ohio","Sandusky County",3,12,778,385,393
050,39,143,"Ohio","Sandusky County",3,13,812,401,411
050,39,143,"Ohio","Sandusky County",3,14,798,395,403
050,39,143,"Ohio","Sandusky County",3,15,792,406,386
050,39,143,"Ohio","Sandusky County",3,16,786,413,373
050,39,143,"Ohio","Sandusky County",3,17,786,412,374
050,39,143,"Ohio","Sandusky County",3,18,704,366,338
050,39,143,"Ohio","Sandusky County",3,19,577,310,267
050,39,143,"Ohio","Sandusky County",3,20,629,337,292
050,39,143,"Ohio","Sandusky County",3,21,659,361,298
050,39,143,"Ohio","Sandusky County",3,22,646,340,306
050,39,143,"Ohio","Sandusky County",3,23,634,317,317
050,39,143,"Ohio","Sandusky County",3,24,676,327,349
050,39,143,"Ohio","Sandusky County",3,25,651,341,310
050,39,143,"Ohio","Sandusky County",3,26,680,348,332
050,39,143,"Ohio","Sandusky County",3,27,656,327,329
050,39,143,"Ohio","Sandusky County",3,28,694,335,359
050,39,143,"Ohio","Sandusky County",3,29,692,322,370
050,39,143,"Ohio","Sandusky County",3,30,684,343,341
050,39,143,"Ohio","Sandusky County",3,31,736,380,356
050,39,143,"Ohio","Sandusky County",3,32,694,346,348
050,39,143,"Ohio","Sandusky County",3,33,674,346,328
050,39,143,"Ohio","Sandusky County",3,34,654,333,321
050,39,143,"Ohio","Sandusky County",3,35,710,359,351
050,39,143,"Ohio","Sandusky County",3,36,711,355,356
050,39,143,"Ohio","Sandusky County",3,37,721,372,349
050,39,143,"Ohio","Sandusky County",3,38,706,355,351
050,39,143,"Ohio","Sandusky County",3,39,713,361,352
050,39,143,"Ohio","Sandusky County",3,40,730,375,355
050,39,143,"Ohio","Sandusky County",3,41,768,401,367
050,39,143,"Ohio","Sandusky County",3,42,719,364,355
050,39,143,"Ohio","Sandusky County",3,43,697,365,332
050,39,143,"Ohio","Sandusky County",3,44,684,349,335
050,39,143,"Ohio","Sandusky County",3,45,640,325,315
050,39,143,"Ohio","Sandusky County",3,46,661,340,321
050,39,143,"Ohio","Sandusky County",3,47,693,364,329
050,39,143,"Ohio","Sandusky County",3,48,684,340,344
050,39,143,"Ohio","Sandusky County",3,49,733,368,365
050,39,143,"Ohio","Sandusky County",3,50,798,402,396
050,39,143,"Ohio","Sandusky County",3,51,764,395,369
050,39,143,"Ohio","Sandusky County",3,52,712,368,344
050,39,143,"Ohio","Sandusky County",3,53,737,384,353
050,39,143,"Ohio","Sandusky County",3,54,764,388,376
050,39,143,"Ohio","Sandusky County",3,55,789,399,390
050,39,143,"Ohio","Sandusky County",3,56,841,427,414
050,39,143,"Ohio","Sandusky County",3,57,862,434,428
050,39,143,"Ohio","Sandusky County",3,58,837,417,420
050,39,143,"Ohio","Sandusky County",3,59,842,421,421
050,39,143,"Ohio","Sandusky County",3,60,865,431,434
050,39,143,"Ohio","Sandusky County",3,61,862,423,439
050,39,143,"Ohio","Sandusky County",3,62,875,442,433
050,39,143,"Ohio","Sandusky County",3,63,908,472,436
050,39,143,"Ohio","Sandusky County",3,64,920,467,453
050,39,143,"Ohio","Sandusky County",3,65,870,428,442
050,39,143,"Ohio","Sandusky County",3,66,808,387,421
050,39,143,"Ohio","Sandusky County",3,67,798,380,418
050,39,143,"Ohio","Sandusky County",3,68,751,364,387
050,39,143,"Ohio","Sandusky County",3,69,723,360,363
050,39,143,"Ohio","Sandusky County",3,70,656,320,336
050,39,143,"Ohio","Sandusky County",3,71,612,284,328
050,39,143,"Ohio","Sandusky County",3,72,604,290,314
050,39,143,"Ohio","Sandusky County",3,73,598,290,308
050,39,143,"Ohio","Sandusky County",3,74,660,311,349
050,39,143,"Ohio","Sandusky County",3,75,429,209,220
050,39,143,"Ohio","Sandusky County",3,76,397,182,215
050,39,143,"Ohio","Sandusky County",3,77,408,182,226
050,39,143,"Ohio","Sandusky County",3,78,377,160,217
050,39,143,"Ohio","Sandusky County",3,79,325,145,180
050,39,143,"Ohio","Sandusky County",3,80,326,134,192
050,39,143,"Ohio","Sandusky County",3,81,299,130,169
050,39,143,"Ohio","Sandusky County",3,82,247,113,134
050,39,143,"Ohio","Sandusky County",3,83,239,94,145
050,39,143,"Ohio","Sandusky County",3,84,235,90,145
050,39,143,"Ohio","Sandusky County",3,85,1232,431,801
050,39,143,"Ohio","Sandusky County",4,0,571,279,292
050,39,143,"Ohio","Sandusky County",4,1,562,287,275
050,39,143,"Ohio","Sandusky County",4,2,654,321,333
050,39,143,"Ohio","Sandusky County",4,3,616,321,295
050,39,143,"Ohio","Sandusky County",4,4,671,358,313
050,39,143,"Ohio","Sandusky County",4,5,667,354,313
050,39,143,"Ohio","Sandusky County",4,6,712,367,345
050,39,143,"Ohio","Sandusky County",4,7,705,379,326
050,39,143,"Ohio","Sandusky County",4,8,696,346,350
050,39,143,"Ohio","Sandusky County",4,9,686,344,342
050,39,143,"Ohio","Sandusky County",4,10,732,386,346
050,39,143,"Ohio","Sandusky County",4,11,739,403,336
050,39,143,"Ohio","Sandusky County",4,12,775,405,370
050,39,143,"Ohio","Sandusky County",4,13,788,392,396
050,39,143,"Ohio","Sandusky County",4,14,814,398,416
050,39,143,"Ohio","Sandusky County",4,15,803,394,409
050,39,143,"Ohio","Sandusky County",4,16,798,415,383
050,39,143,"Ohio","Sandusky County",4,17,787,407,380
050,39,143,"Ohio","Sandusky County",4,18,672,361,311
050,39,143,"Ohio","Sandusky County",4,19,565,297,268
050,39,143,"Ohio","Sandusky County",4,20,616,323,293
050,39,143,"Ohio","Sandusky County",4,21,637,346,291
050,39,143,"Ohio","Sandusky County",4,22,670,375,295
050,39,143,"Ohio","Sandusky County",4,23,664,346,318
050,39,143,"Ohio","Sandusky County",4,24,636,315,321
050,39,143,"Ohio","Sandusky County",4,25,671,335,336
050,39,143,"Ohio","Sandusky County",4,26,643,331,312
050,39,143,"Ohio","Sandusky County",4,27,683,351,332
050,39,143,"Ohio","Sandusky County",4,28,634,316,318
050,39,143,"Ohio","Sandusky County",4,29,710,345,365
050,39,143,"Ohio","Sandusky County",4,30,703,327,376
050,39,143,"Ohio","Sandusky County",4,31,675,333,342
050,39,143,"Ohio","Sandusky County",4,32,737,385,352
050,39,143,"Ohio","Sandusky County",4,33,706,350,356
050,39,143,"Ohio","Sandusky County",4,34,679,348,331
050,39,143,"Ohio","Sandusky County",4,35,660,337,323
050,39,143,"Ohio","Sandusky County",4,36,718,370,348
050,39,143,"Ohio","Sandusky County",4,37,706,351,355
050,39,143,"Ohio","Sandusky County",4,38,714,360,354
050,39,143,"Ohio","Sandusky County",4,39,715,358,357
050,39,143,"Ohio","Sandusky County",4,40,719,369,350
050,39,143,"Ohio","Sandusky County",4,41,740,379,361
050,39,143,"Ohio","Sandusky County",4,42,774,412,362
050,39,143,"Ohio","Sandusky County",4,43,725,366,359
050,39,143,"Ohio","Sandusky County",4,44,710,363,347
050,39,143,"Ohio","Sandusky County",4,45,684,345,339
050,39,143,"Ohio","Sandusky County",4,46,650,331,319
050,39,143,"Ohio","Sandusky County",4,47,660,343,317
050,39,143,"Ohio","Sandusky County",4,48,685,355,330
050,39,143,"Ohio","Sandusky County",4,49,680,344,336
050,39,143,"Ohio","Sandusky County",4,50,743,363,380
050,39,143,"Ohio","Sandusky County",4,51,802,406,396
050,39,143,"Ohio","Sandusky County",4,52,740,380,360
050,39,143,"Ohio","Sandusky County",4,53,725,374,351
050,39,143,"Ohio","Sandusky County",4,54,719,371,348
050,39,143,"Ohio","Sandusky County",4,55,753,383,370
050,39,143,"Ohio","Sandusky County",4,56,785,395,390
050,39,143,"Ohio","Sandusky County",4,57,818,415,403
050,39,143,"Ohio","Sandusky County",4,58,847,432,415
050,39,143,"Ohio","Sandusky County",4,59,837,416,421
050,39,143,"Ohio","Sandusky County",4,60,806,402,404
050,39,143,"Ohio","Sandusky County",4,61,851,421,430
050,39,143,"Ohio","Sandusky County",4,62,864,430,434
050,39,143,"Ohio","Sandusky County",4,63,867,441,426
050,39,143,"Ohio","Sandusky County",4,64,901,471,430
050,39,143,"Ohio","Sandusky County",4,65,903,458,445
050,39,143,"Ohio","Sandusky County",4,66,849,417,432
050,39,143,"Ohio","Sandusky County",4,67,815,390,425
050,39,143,"Ohio","Sandusky County",4,68,764,364,400
050,39,143,"Ohio","Sandusky County",4,69,741,364,377
050,39,143,"Ohio","Sandusky County",4,70,700,346,354
050,39,143,"Ohio","Sandusky County",4,71,648,310,338
050,39,143,"Ohio","Sandusky County",4,72,601,277,324
050,39,143,"Ohio","Sandusky County",4,73,573,269,304
050,39,143,"Ohio","Sandusky County",4,74,588,289,299
050,39,143,"Ohio","Sandusky County",4,75,625,299,326
050,39,143,"Ohio","Sandusky County",4,76,419,207,212
050,39,143,"Ohio","Sandusky County",4,77,373,170,203
050,39,143,"Ohio","Sandusky County",4,78,380,161,219
050,39,143,"Ohio","Sandusky County",4,79,353,154,199
050,39,143,"Ohio","Sandusky County",4,80,307,132,175
050,39,143,"Ohio","Sandusky County",4,81,308,127,181
050,39,143,"Ohio","Sandusky County",4,82,273,118,155
050,39,143,"Ohio","Sandusky County",4,83,233,100,133
050,39,143,"Ohio","Sandusky County",4,84,222,86,136
050,39,143,"Ohio","Sandusky County",4,85,1217,423,794
050,39,143,"Ohio","Sandusky County",5,0,572,276,296
050,39,143,"Ohio","Sandusky County",5,1,600,291,309
050,39,143,"Ohio","Sandusky County",5,2,585,293,292
050,39,143,"Ohio","Sandusky County",5,3,665,315,350
050,39,143,"Ohio","Sandusky County",5,4,635,325,310
050,39,143,"Ohio","Sandusky County",5,5,687,370,317
050,39,143,"Ohio","Sandusky County",5,6,651,342,309
050,39,143,"Ohio","Sandusky County",5,7,717,372,345
050,39,143,"Ohio","Sandusky County",5,8,697,378,319
050,39,143,"Ohio","Sandusky County",5,9,707,357,350
050,39,143,"Ohio","Sandusky County",5,10,726,359,367
050,39,143,"Ohio","Sandusky County",5,11,733,393,340
050,39,143,"Ohio","Sandusky County",5,12,743,405,338
050,39,143,"Ohio","Sandusky County",5,13,762,399,363
050,39,143,"Ohio","Sandusky County",5,14,770,392,378
050,39,143,"Ohio","Sandusky County",5,15,818,407,411
050,39,143,"Ohio","Sandusky County",5,16,795,389,406
050,39,143,"Ohio","Sandusky County",5,17,796,414,382
050,39,143,"Ohio","Sandusky County",5,18,660,356,304
050,39,143,"Ohio","Sandusky County",5,19,536,287,249
050,39,143,"Ohio","Sandusky County",5,20,621,320,301
050,39,143,"Ohio","Sandusky County",5,21,651,360,291
050,39,143,"Ohio","Sandusky County",5,22,695,381,314
050,39,143,"Ohio","Sandusky County",5,23,726,392,334
050,39,143,"Ohio","Sandusky County",5,24,671,350,321
050,39,143,"Ohio","Sandusky County",5,25,658,336,322
050,39,143,"Ohio","Sandusky County",5,26,682,341,341
050,39,143,"Ohio","Sandusky County",5,27,646,334,312
050,39,143,"Ohio","Sandusky County",5,28,682,351,331
050,39,143,"Ohio","Sandusky County",5,29,653,327,326
050,39,143,"Ohio","Sandusky County",5,30,705,348,357
050,39,143,"Ohio","Sandusky County",5,31,707,324,383
050,39,143,"Ohio","Sandusky County",5,32,687,344,343
050,39,143,"Ohio","Sandusky County",5,33,743,383,360
050,39,143,"Ohio","Sandusky County",5,34,711,357,354
050,39,143,"Ohio","Sandusky County",5,35,680,352,328
050,39,143,"Ohio","Sandusky County",5,36,678,350,328
050,39,143,"Ohio","Sandusky County",5,37,693,360,333
050,39,143,"Ohio","Sandusky County",5,38,721,359,362
050,39,143,"Ohio","Sandusky County",5,39,726,365,361
050,39,143,"Ohio","Sandusky County",5,40,716,362,354
050,39,143,"Ohio","Sandusky County",5,41,726,369,357
050,39,143,"Ohio","Sandusky County",5,42,747,386,361
050,39,143,"Ohio","Sandusky County",5,43,764,401,363
050,39,143,"Ohio","Sandusky County",5,44,738,367,371
050,39,143,"Ohio","Sandusky County",5,45,705,367,338
050,39,143,"Ohio","Sandusky County",5,46,696,351,345
050,39,143,"Ohio","Sandusky County",5,47,655,337,318
050,39,143,"Ohio","Sandusky County",5,48,662,343,319
050,39,143,"Ohio","Sandusky County",5,49,703,364,339
050,39,143,"Ohio","Sandusky County",5,50,691,349,342
050,39,143,"Ohio","Sandusky County",5,51,756,365,391
050,39,143,"Ohio","Sandusky County",5,52,804,408,396
050,39,143,"Ohio","Sandusky County",5,53,750,381,369
050,39,143,"Ohio","Sandusky County",5,54,728,369,359
050,39,143,"Ohio","Sandusky County",5,55,714,366,348
050,39,143,"Ohio","Sandusky County",5,56,751,379,372
050,39,143,"Ohio","Sandusky County",5,57,767,384,383
050,39,143,"Ohio","Sandusky County",5,58,812,416,396
050,39,143,"Ohio","Sandusky County",5,59,851,430,421
050,39,143,"Ohio","Sandusky County",5,60,804,395,409
050,39,143,"Ohio","Sandusky County",5,61,793,391,402
050,39,143,"Ohio","Sandusky County",5,62,849,417,432
050,39,143,"Ohio","Sandusky County",5,63,865,437,428
050,39,143,"Ohio","Sandusky County",5,64,859,435,424
050,39,143,"Ohio","Sandusky County",5,65,894,469,425
050,39,143,"Ohio","Sandusky County",5,66,874,437,437
050,39,143,"Ohio","Sandusky County",5,67,856,423,433
050,39,143,"Ohio","Sandusky County",5,68,790,375,415
050,39,143,"Ohio","Sandusky County",5,69,752,360,392
050,39,143,"Ohio","Sandusky County",5,70,717,349,368
050,39,143,"Ohio","Sandusky County",5,71,692,334,358
050,39,143,"Ohio","Sandusky County",5,72,629,301,328
050,39,143,"Ohio","Sandusky County",5,73,580,263,317
050,39,143,"Ohio","Sandusky County",5,74,568,265,303
050,39,143,"Ohio","Sandusky County",5,75,567,281,286
050,39,143,"Ohio","Sandusky County",5,76,611,294,317
050,39,143,"Ohio","Sandusky County",5,77,400,200,200
050,39,143,"Ohio","Sandusky County",5,78,347,155,192
050,39,143,"Ohio","Sandusky County",5,79,361,156,205
050,39,143,"Ohio","Sandusky County",5,80,338,145,193
050,39,143,"Ohio","Sandusky County",5,81,289,122,167
050,39,143,"Ohio","Sandusky County",5,82,280,114,166
050,39,143,"Ohio","Sandusky County",5,83,249,103,146
050,39,143,"Ohio","Sandusky County",5,84,213,92,121
050,39,143,"Ohio","Sandusky County",5,85,1205,413,792
050,39,145,"Ohio","Scioto County",1,0,769,390,379
050,39,145,"Ohio","Scioto County",1,1,821,416,405
050,39,145,"Ohio","Scioto County",1,2,836,425,411
050,39,145,"Ohio","Scioto County",1,3,866,445,421
050,39,145,"Ohio","Scioto County",1,4,869,405,464
050,39,145,"Ohio","Scioto County",1,5,883,440,443
050,39,145,"Ohio","Scioto County",1,6,884,443,441
050,39,145,"Ohio","Scioto County",1,7,831,430,401
050,39,145,"Ohio","Scioto County",1,8,878,463,415
050,39,145,"Ohio","Scioto County",1,9,842,417,425
050,39,145,"Ohio","Scioto County",1,10,927,471,456
050,39,145,"Ohio","Scioto County",1,11,949,498,451
050,39,145,"Ohio","Scioto County",1,12,961,493,468
050,39,145,"Ohio","Scioto County",1,13,995,508,487
050,39,145,"Ohio","Scioto County",1,14,948,488,460
050,39,145,"Ohio","Scioto County",1,15,959,502,457
050,39,145,"Ohio","Scioto County",1,16,975,497,478
050,39,145,"Ohio","Scioto County",1,17,959,504,455
050,39,145,"Ohio","Scioto County",1,18,940,498,442
050,39,145,"Ohio","Scioto County",1,19,973,510,463
050,39,145,"Ohio","Scioto County",1,20,958,508,450
050,39,145,"Ohio","Scioto County",1,21,892,490,402
050,39,145,"Ohio","Scioto County",1,22,910,505,405
050,39,145,"Ohio","Scioto County",1,23,910,496,414
050,39,145,"Ohio","Scioto County",1,24,889,474,415
050,39,145,"Ohio","Scioto County",1,25,876,461,415
050,39,145,"Ohio","Scioto County",1,26,897,489,408
050,39,145,"Ohio","Scioto County",1,27,986,539,447
050,39,145,"Ohio","Scioto County",1,28,949,521,428
050,39,145,"Ohio","Scioto County",1,29,1006,551,455
050,39,145,"Ohio","Scioto County",1,30,997,544,453
050,39,145,"Ohio","Scioto County",1,31,964,518,446
050,39,145,"Ohio","Scioto County",1,32,928,490,438
050,39,145,"Ohio","Scioto County",1,33,882,455,427
050,39,145,"Ohio","Scioto County",1,34,864,443,421
050,39,145,"Ohio","Scioto County",1,35,851,446,405
050,39,145,"Ohio","Scioto County",1,36,865,464,401
050,39,145,"Ohio","Scioto County",1,37,921,473,448
050,39,145,"Ohio","Scioto County",1,38,919,477,442
050,39,145,"Ohio","Scioto County",1,39,930,464,466
050,39,145,"Ohio","Scioto County",1,40,902,446,456
050,39,145,"Ohio","Scioto County",1,41,889,452,437
050,39,145,"Ohio","Scioto County",1,42,898,465,433
050,39,145,"Ohio","Scioto County",1,43,915,457,458
050,39,145,"Ohio","Scioto County",1,44,915,448,467
050,39,145,"Ohio","Scioto County",1,45,905,444,461
050,39,145,"Ohio","Scioto County",1,46,894,432,462
050,39,145,"Ohio","Scioto County",1,47,936,468,468
050,39,145,"Ohio","Scioto County",1,48,994,500,494
050,39,145,"Ohio","Scioto County",1,49,1052,544,508
050,39,145,"Ohio","Scioto County",1,50,951,488,463
050,39,145,"Ohio","Scioto County",1,51,925,468,457
050,39,145,"Ohio","Scioto County",1,52,898,438,460
050,39,145,"Ohio","Scioto County",1,53,936,455,481
050,39,145,"Ohio","Scioto County",1,54,959,463,496
050,39,145,"Ohio","Scioto County",1,55,968,460,508
050,39,145,"Ohio","Scioto County",1,56,995,496,499
050,39,145,"Ohio","Scioto County",1,57,1006,505,501
050,39,145,"Ohio","Scioto County",1,58,1032,496,536
050,39,145,"Ohio","Scioto County",1,59,1013,470,543
050,39,145,"Ohio","Scioto County",1,60,988,470,518
050,39,145,"Ohio","Scioto County",1,61,1021,492,529
050,39,145,"Ohio","Scioto County",1,62,1077,507,570
050,39,145,"Ohio","Scioto County",1,63,1040,486,554
050,39,145,"Ohio","Scioto County",1,64,1046,467,579
050,39,145,"Ohio","Scioto County",1,65,1009,487,522
050,39,145,"Ohio","Scioto County",1,66,895,423,472
050,39,145,"Ohio","Scioto County",1,67,869,411,458
050,39,145,"Ohio","Scioto County",1,68,848,409,439
050,39,145,"Ohio","Scioto County",1,69,819,405,414
050,39,145,"Ohio","Scioto County",1,70,764,384,380
050,39,145,"Ohio","Scioto County",1,71,720,339,381
050,39,145,"Ohio","Scioto County",1,72,703,315,388
050,39,145,"Ohio","Scioto County",1,73,761,355,406
050,39,145,"Ohio","Scioto County",1,74,506,233,273
050,39,145,"Ohio","Scioto County",1,75,536,245,291
050,39,145,"Ohio","Scioto County",1,76,523,244,279
050,39,145,"Ohio","Scioto County",1,77,482,210,272
050,39,145,"Ohio","Scioto County",1,78,450,192,258
050,39,145,"Ohio","Scioto County",1,79,395,157,238
050,39,145,"Ohio","Scioto County",1,80,371,161,210
050,39,145,"Ohio","Scioto County",1,81,348,143,205
050,39,145,"Ohio","Scioto County",1,82,349,132,217
050,39,145,"Ohio","Scioto County",1,83,323,127,196
050,39,145,"Ohio","Scioto County",1,84,275,109,166
050,39,145,"Ohio","Scioto County",1,85,1449,511,938
050,39,145,"Ohio","Scioto County",2,0,768,380,388
050,39,145,"Ohio","Scioto County",2,1,806,409,397
050,39,145,"Ohio","Scioto County",2,2,830,421,409
050,39,145,"Ohio","Scioto County",2,3,855,437,418
050,39,145,"Ohio","Scioto County",2,4,868,413,455
050,39,145,"Ohio","Scioto County",2,5,878,428,450
050,39,145,"Ohio","Scioto County",2,6,885,443,442
050,39,145,"Ohio","Scioto County",2,7,842,433,409
050,39,145,"Ohio","Scioto County",2,8,864,453,411
050,39,145,"Ohio","Scioto County",2,9,854,428,426
050,39,145,"Ohio","Scioto County",2,10,908,458,450
050,39,145,"Ohio","Scioto County",2,11,936,488,448
050,39,145,"Ohio","Scioto County",2,12,963,498,465
050,39,145,"Ohio","Scioto County",2,13,983,504,479
050,39,145,"Ohio","Scioto County",2,14,960,495,465
050,39,145,"Ohio","Scioto County",2,15,958,501,457
050,39,145,"Ohio","Scioto County",2,16,973,500,473
050,39,145,"Ohio","Scioto County",2,17,964,504,460
050,39,145,"Ohio","Scioto County",2,18,940,497,443
050,39,145,"Ohio","Scioto County",2,19,970,508,462
050,39,145,"Ohio","Scioto County",2,20,967,514,453
050,39,145,"Ohio","Scioto County",2,21,896,492,404
050,39,145,"Ohio","Scioto County",2,22,912,504,408
050,39,145,"Ohio","Scioto County",2,23,908,494,414
050,39,145,"Ohio","Scioto County",2,24,884,473,411
050,39,145,"Ohio","Scioto County",2,25,880,461,419
050,39,145,"Ohio","Scioto County",2,26,895,485,410
050,39,145,"Ohio","Scioto County",2,27,964,528,436
050,39,145,"Ohio","Scioto County",2,28,953,522,431
050,39,145,"Ohio","Scioto County",2,29,989,544,445
050,39,145,"Ohio","Scioto County",2,30,999,543,456
050,39,145,"Ohio","Scioto County",2,31,960,514,446
050,39,145,"Ohio","Scioto County",2,32,931,493,438
050,39,145,"Ohio","Scioto County",2,33,892,461,431
050,39,145,"Ohio","Scioto County",2,34,867,447,420
050,39,145,"Ohio","Scioto County",2,35,851,443,408
050,39,145,"Ohio","Scioto County",2,36,856,456,400
050,39,145,"Ohio","Scioto County",2,37,908,471,437
050,39,145,"Ohio","Scioto County",2,38,920,475,445
050,39,145,"Ohio","Scioto County",2,39,922,464,458
050,39,145,"Ohio","Scioto County",2,40,916,454,462
050,39,145,"Ohio","Scioto County",2,41,888,447,441
050,39,145,"Ohio","Scioto County",2,42,890,459,431
050,39,145,"Ohio","Scioto County",2,43,919,463,456
050,39,145,"Ohio","Scioto County",2,44,904,444,460
050,39,145,"Ohio","Scioto County",2,45,910,447,463
050,39,145,"Ohio","Scioto County",2,46,893,432,461
050,39,145,"Ohio","Scioto County",2,47,921,461,460
050,39,145,"Ohio","Scioto County",2,48,982,492,490
050,39,145,"Ohio","Scioto County",2,49,1040,534,506
050,39,145,"Ohio","Scioto County",2,50,971,498,473
050,39,145,"Ohio","Scioto County",2,51,927,468,459
050,39,145,"Ohio","Scioto County",2,52,901,442,459
050,39,145,"Ohio","Scioto County",2,53,923,447,476
050,39,145,"Ohio","Scioto County",2,54,946,458,488
050,39,145,"Ohio","Scioto County",2,55,965,459,506
050,39,145,"Ohio","Scioto County",2,56,981,483,498
050,39,145,"Ohio","Scioto County",2,57,1010,506,504
050,39,145,"Ohio","Scioto County",2,58,1011,487,524
050,39,145,"Ohio","Scioto County",2,59,1019,475,544
050,39,145,"Ohio","Scioto County",2,60,983,464,519
050,39,145,"Ohio","Scioto County",2,61,1007,481,526
050,39,145,"Ohio","Scioto County",2,62,1060,503,557
050,39,145,"Ohio","Scioto County",2,63,1052,491,561
050,39,145,"Ohio","Scioto County",2,64,1035,466,569
050,39,145,"Ohio","Scioto County",2,65,1012,480,532
050,39,145,"Ohio","Scioto County",2,66,919,436,483
050,39,145,"Ohio","Scioto County",2,67,866,410,456
050,39,145,"Ohio","Scioto County",2,68,837,402,435
050,39,145,"Ohio","Scioto County",2,69,825,405,420
050,39,145,"Ohio","Scioto County",2,70,768,382,386
050,39,145,"Ohio","Scioto County",2,71,725,346,379
050,39,145,"Ohio","Scioto County",2,72,689,314,375
050,39,145,"Ohio","Scioto County",2,73,777,357,420
050,39,145,"Ohio","Scioto County",2,74,527,244,283
050,39,145,"Ohio","Scioto County",2,75,526,242,284
050,39,145,"Ohio","Scioto County",2,76,515,237,278
050,39,145,"Ohio","Scioto County",2,77,499,222,277
050,39,145,"Ohio","Scioto County",2,78,440,187,253
050,39,145,"Ohio","Scioto County",2,79,401,162,239
050,39,145,"Ohio","Scioto County",2,80,375,161,214
050,39,145,"Ohio","Scioto County",2,81,339,140,199
050,39,145,"Ohio","Scioto County",2,82,344,131,213
050,39,145,"Ohio","Scioto County",2,83,315,122,193
050,39,145,"Ohio","Scioto County",2,84,284,113,171
050,39,145,"Ohio","Scioto County",2,85,1452,516,936
050,39,145,"Ohio","Scioto County",3,0,712,379,333
050,39,145,"Ohio","Scioto County",3,1,792,400,392
050,39,145,"Ohio","Scioto County",3,2,790,400,390
050,39,145,"Ohio","Scioto County",3,3,844,433,411
050,39,145,"Ohio","Scioto County",3,4,839,422,417
050,39,145,"Ohio","Scioto County",3,5,875,414,461
050,39,145,"Ohio","Scioto County",3,6,879,425,454
050,39,145,"Ohio","Scioto County",3,7,907,460,447
050,39,145,"Ohio","Scioto County",3,8,851,433,418
050,39,145,"Ohio","Scioto County",3,9,856,453,403
050,39,145,"Ohio","Scioto County",3,10,858,430,428
050,39,145,"Ohio","Scioto County",3,11,921,465,456
050,39,145,"Ohio","Scioto County",3,12,930,478,452
050,39,145,"Ohio","Scioto County",3,13,982,511,471
050,39,145,"Ohio","Scioto County",3,14,980,491,489
050,39,145,"Ohio","Scioto County",3,15,969,503,466
050,39,145,"Ohio","Scioto County",3,16,964,503,461
050,39,145,"Ohio","Scioto County",3,17,972,493,479
050,39,145,"Ohio","Scioto County",3,18,904,472,432
050,39,145,"Ohio","Scioto County",3,19,848,455,393
050,39,145,"Ohio","Scioto County",3,20,901,479,422
050,39,145,"Ohio","Scioto County",3,21,902,495,407
050,39,145,"Ohio","Scioto County",3,22,916,512,404
050,39,145,"Ohio","Scioto County",3,23,902,498,404
050,39,145,"Ohio","Scioto County",3,24,883,468,415
050,39,145,"Ohio","Scioto County",3,25,879,473,406
050,39,145,"Ohio","Scioto County",3,26,903,485,418
050,39,145,"Ohio","Scioto County",3,27,907,489,418
050,39,145,"Ohio","Scioto County",3,28,945,500,445
050,39,145,"Ohio","Scioto County",3,29,940,520,420
050,39,145,"Ohio","Scioto County",3,30,999,547,452
050,39,145,"Ohio","Scioto County",3,31,979,520,459
050,39,145,"Ohio","Scioto County",3,32,952,512,440
050,39,145,"Ohio","Scioto County",3,33,932,489,443
050,39,145,"Ohio","Scioto County",3,34,906,476,430
050,39,145,"Ohio","Scioto County",3,35,835,424,411
050,39,145,"Ohio","Scioto County",3,36,846,441,405
050,39,145,"Ohio","Scioto County",3,37,879,466,413
050,39,145,"Ohio","Scioto County",3,38,884,450,434
050,39,145,"Ohio","Scioto County",3,39,933,474,459
050,39,145,"Ohio","Scioto County",3,40,929,470,459
050,39,145,"Ohio","Scioto County",3,41,918,451,467
050,39,145,"Ohio","Scioto County",3,42,889,449,440
050,39,145,"Ohio","Scioto County",3,43,889,459,430
050,39,145,"Ohio","Scioto County",3,44,905,457,448
050,39,145,"Ohio","Scioto County",3,45,883,428,455
050,39,145,"Ohio","Scioto County",3,46,911,438,473
050,39,145,"Ohio","Scioto County",3,47,888,445,443
050,39,145,"Ohio","Scioto County",3,48,926,459,467
050,39,145,"Ohio","Scioto County",3,49,981,498,483
050,39,145,"Ohio","Scioto County",3,50,1005,508,497
050,39,145,"Ohio","Scioto County",3,51,958,499,459
050,39,145,"Ohio","Scioto County",3,52,909,454,455
050,39,145,"Ohio","Scioto County",3,53,887,432,455
050,39,145,"Ohio","Scioto County",3,54,882,423,459
050,39,145,"Ohio","Scioto County",3,55,929,446,483
050,39,145,"Ohio","Scioto County",3,56,947,455,492
050,39,145,"Ohio","Scioto County",3,57,964,477,487
050,39,145,"Ohio","Scioto County",3,58,981,477,504
050,39,145,"Ohio","Scioto County",3,59,999,485,514
050,39,145,"Ohio","Scioto County",3,60,995,468,527
050,39,145,"Ohio","Scioto County",3,61,948,443,505
050,39,145,"Ohio","Scioto County",3,62,983,475,508
050,39,145,"Ohio","Scioto County",3,63,1020,475,545
050,39,145,"Ohio","Scioto County",3,64,1042,488,554
050,39,145,"Ohio","Scioto County",3,65,997,450,547
050,39,145,"Ohio","Scioto County",3,66,985,472,513
050,39,145,"Ohio","Scioto County",3,67,900,419,481
050,39,145,"Ohio","Scioto County",3,68,834,395,439
050,39,145,"Ohio","Scioto County",3,69,816,392,424
050,39,145,"Ohio","Scioto County",3,70,788,384,404
050,39,145,"Ohio","Scioto County",3,71,750,370,380
050,39,145,"Ohio","Scioto County",3,72,690,332,358
050,39,145,"Ohio","Scioto County",3,73,644,281,363
050,39,145,"Ohio","Scioto County",3,74,751,344,407
050,39,145,"Ohio","Scioto County",3,75,500,221,279
050,39,145,"Ohio","Scioto County",3,76,494,222,272
050,39,145,"Ohio","Scioto County",3,77,473,220,253
050,39,145,"Ohio","Scioto County",3,78,456,203,253
050,39,145,"Ohio","Scioto County",3,79,402,165,237
050,39,145,"Ohio","Scioto County",3,80,382,160,222
050,39,145,"Ohio","Scioto County",3,81,332,142,190
050,39,145,"Ohio","Scioto County",3,82,316,126,190
050,39,145,"Ohio","Scioto County",3,83,297,105,192
050,39,145,"Ohio","Scioto County",3,84,291,111,180
050,39,145,"Ohio","Scioto County",3,85,1427,495,932
050,39,145,"Ohio","Scioto County",4,0,711,373,338
050,39,145,"Ohio","Scioto County",4,1,735,384,351
050,39,145,"Ohio","Scioto County",4,2,791,391,400
050,39,145,"Ohio","Scioto County",4,3,777,398,379
050,39,145,"Ohio","Scioto County",4,4,838,420,418
050,39,145,"Ohio","Scioto County",4,5,850,424,426
050,39,145,"Ohio","Scioto County",4,6,865,411,454
050,39,145,"Ohio","Scioto County",4,7,870,412,458
050,39,145,"Ohio","Scioto County",4,8,908,456,452
050,39,145,"Ohio","Scioto County",4,9,856,436,420
050,39,145,"Ohio","Scioto County",4,10,861,462,399
050,39,145,"Ohio","Scioto County",4,11,867,436,431
050,39,145,"Ohio","Scioto County",4,12,927,476,451
050,39,145,"Ohio","Scioto County",4,13,917,473,444
050,39,145,"Ohio","Scioto County",4,14,973,505,468
050,39,145,"Ohio","Scioto County",4,15,993,499,494
050,39,145,"Ohio","Scioto County",4,16,966,505,461
050,39,145,"Ohio","Scioto County",4,17,957,496,461
050,39,145,"Ohio","Scioto County",4,18,912,469,443
050,39,145,"Ohio","Scioto County",4,19,830,440,390
050,39,145,"Ohio","Scioto County",4,20,845,463,382
050,39,145,"Ohio","Scioto County",4,21,860,472,388
050,39,145,"Ohio","Scioto County",4,22,953,516,437
050,39,145,"Ohio","Scioto County",4,23,919,511,408
050,39,145,"Ohio","Scioto County",4,24,887,494,393
050,39,145,"Ohio","Scioto County",4,25,890,475,415
050,39,145,"Ohio","Scioto County",4,26,885,490,395
050,39,145,"Ohio","Scioto County",4,27,887,461,426
050,39,145,"Ohio","Scioto County",4,28,881,468,413
050,39,145,"Ohio","Scioto County",4,29,940,501,439
050,39,145,"Ohio","Scioto County",4,30,933,508,425
050,39,145,"Ohio","Scioto County",4,31,952,523,429
050,39,145,"Ohio","Scioto County",4,32,984,518,466
050,39,145,"Ohio","Scioto County",4,33,956,502,454
050,39,145,"Ohio","Scioto County",4,34,928,498,430
050,39,145,"Ohio","Scioto County",4,35,869,451,418
050,39,145,"Ohio","Scioto County",4,36,866,446,420
050,39,145,"Ohio","Scioto County",4,37,835,436,399
050,39,145,"Ohio","Scioto County",4,38,849,436,413
050,39,145,"Ohio","Scioto County",4,39,879,441,438
050,39,145,"Ohio","Scioto County",4,40,926,464,462
050,39,145,"Ohio","Scioto County",4,41,918,458,460
050,39,145,"Ohio","Scioto County",4,42,905,443,462
050,39,145,"Ohio","Scioto County",4,43,885,448,437
050,39,145,"Ohio","Scioto County",4,44,876,452,424
050,39,145,"Ohio","Scioto County",4,45,870,440,430
050,39,145,"Ohio","Scioto County",4,46,888,424,464
050,39,145,"Ohio","Scioto County",4,47,901,446,455
050,39,145,"Ohio","Scioto County",4,48,888,439,449
050,39,145,"Ohio","Scioto County",4,49,944,476,468
050,39,145,"Ohio","Scioto County",4,50,960,472,488
050,39,145,"Ohio","Scioto County",4,51,1011,510,501
050,39,145,"Ohio","Scioto County",4,52,945,483,462
050,39,145,"Ohio","Scioto County",4,53,893,444,449
050,39,145,"Ohio","Scioto County",4,54,867,427,440
050,39,145,"Ohio","Scioto County",4,55,862,407,455
050,39,145,"Ohio","Scioto County",4,56,920,447,473
050,39,145,"Ohio","Scioto County",4,57,945,455,490
050,39,145,"Ohio","Scioto County",4,58,918,437,481
050,39,145,"Ohio","Scioto County",4,59,967,465,502
050,39,145,"Ohio","Scioto County",4,60,977,475,502
050,39,145,"Ohio","Scioto County",4,61,974,449,525
050,39,145,"Ohio","Scioto County",4,62,931,438,493
050,39,145,"Ohio","Scioto County",4,63,944,461,483
050,39,145,"Ohio","Scioto County",4,64,991,465,526
050,39,145,"Ohio","Scioto County",4,65,1016,480,536
050,39,145,"Ohio","Scioto County",4,66,966,438,528
050,39,145,"Ohio","Scioto County",4,67,966,453,513
050,39,145,"Ohio","Scioto County",4,68,869,412,457
050,39,145,"Ohio","Scioto County",4,69,812,381,431
050,39,145,"Ohio","Scioto County",4,70,798,387,411
050,39,145,"Ohio","Scioto County",4,71,767,370,397
050,39,145,"Ohio","Scioto County",4,72,725,359,366
050,39,145,"Ohio","Scioto County",4,73,667,308,359
050,39,145,"Ohio","Scioto County",4,74,623,266,357
050,39,145,"Ohio","Scioto County",4,75,716,328,388
050,39,145,"Ohio","Scioto County",4,76,467,198,269
050,39,145,"Ohio","Scioto County",4,77,450,195,255
050,39,145,"Ohio","Scioto County",4,78,428,191,237
050,39,145,"Ohio","Scioto County",4,79,411,176,235
050,39,145,"Ohio","Scioto County",4,80,376,160,216
050,39,145,"Ohio","Scioto County",4,81,337,140,197
050,39,145,"Ohio","Scioto County",4,82,311,134,177
050,39,145,"Ohio","Scioto County",4,83,279,108,171
050,39,145,"Ohio","Scioto County",4,84,270,92,178
050,39,145,"Ohio","Scioto County",4,85,1427,487,940
050,39,145,"Ohio","Scioto County",5,0,722,376,346
050,39,145,"Ohio","Scioto County",5,1,743,389,354
050,39,145,"Ohio","Scioto County",5,2,719,365,354
050,39,145,"Ohio","Scioto County",5,3,811,404,407
050,39,145,"Ohio","Scioto County",5,4,789,401,388
050,39,145,"Ohio","Scioto County",5,5,840,424,416
050,39,145,"Ohio","Scioto County",5,6,852,430,422
050,39,145,"Ohio","Scioto County",5,7,872,412,460
050,39,145,"Ohio","Scioto County",5,8,867,430,437
050,39,145,"Ohio","Scioto County",5,9,890,451,439
050,39,145,"Ohio","Scioto County",5,10,867,443,424
050,39,145,"Ohio","Scioto County",5,11,858,455,403
050,39,145,"Ohio","Scioto County",5,12,850,427,423
050,39,145,"Ohio","Scioto County",5,13,918,465,453
050,39,145,"Ohio","Scioto County",5,14,930,473,457
050,39,145,"Ohio","Scioto County",5,15,996,522,474
050,39,145,"Ohio","Scioto County",5,16,998,497,501
050,39,145,"Ohio","Scioto County",5,17,977,502,475
050,39,145,"Ohio","Scioto County",5,18,917,480,437
050,39,145,"Ohio","Scioto County",5,19,878,447,431
050,39,145,"Ohio","Scioto County",5,20,879,474,405
050,39,145,"Ohio","Scioto County",5,21,835,464,371
050,39,145,"Ohio","Scioto County",5,22,919,514,405
050,39,145,"Ohio","Scioto County",5,23,978,546,432
050,39,145,"Ohio","Scioto County",5,24,914,503,411
050,39,145,"Ohio","Scioto County",5,25,916,504,412
050,39,145,"Ohio","Scioto County",5,26,918,508,410
050,39,145,"Ohio","Scioto County",5,27,900,493,407
050,39,145,"Ohio","Scioto County",5,28,885,458,427
050,39,145,"Ohio","Scioto County",5,29,868,478,390
050,39,145,"Ohio","Scioto County",5,30,929,494,435
050,39,145,"Ohio","Scioto County",5,31,904,483,421
050,39,145,"Ohio","Scioto County",5,32,955,525,430
050,39,145,"Ohio","Scioto County",5,33,985,511,474
050,39,145,"Ohio","Scioto County",5,34,943,492,451
050,39,145,"Ohio","Scioto County",5,35,914,487,427
050,39,145,"Ohio","Scioto County",5,36,879,463,416
050,39,145,"Ohio","Scioto County",5,37,861,451,410
050,39,145,"Ohio","Scioto County",5,38,816,421,395
050,39,145,"Ohio","Scioto County",5,39,844,433,411
050,39,145,"Ohio","Scioto County",5,40,878,441,437
050,39,145,"Ohio","Scioto County",5,41,914,451,463
050,39,145,"Ohio","Scioto County",5,42,905,459,446
050,39,145,"Ohio","Scioto County",5,43,912,443,469
050,39,145,"Ohio","Scioto County",5,44,895,447,448
050,39,145,"Ohio","Scioto County",5,45,843,432,411
050,39,145,"Ohio","Scioto County",5,46,865,438,427
050,39,145,"Ohio","Scioto County",5,47,897,435,462
050,39,145,"Ohio","Scioto County",5,48,909,445,464
050,39,145,"Ohio","Scioto County",5,49,894,443,451
050,39,145,"Ohio","Scioto County",5,50,904,445,459
050,39,145,"Ohio","Scioto County",5,51,970,476,494
050,39,145,"Ohio","Scioto County",5,52,1010,505,505
050,39,145,"Ohio","Scioto County",5,53,948,480,468
050,39,145,"Ohio","Scioto County",5,54,891,447,444
050,39,145,"Ohio","Scioto County",5,55,862,421,441
050,39,145,"Ohio","Scioto County",5,56,864,416,448
050,39,145,"Ohio","Scioto County",5,57,919,451,468
050,39,145,"Ohio","Scioto County",5,58,919,427,492
050,39,145,"Ohio","Scioto County",5,59,910,439,471
050,39,145,"Ohio","Scioto County",5,60,945,454,491
050,39,145,"Ohio","Scioto County",5,61,942,446,496
050,39,145,"Ohio","Scioto County",5,62,960,452,508
050,39,145,"Ohio","Scioto County",5,63,912,431,481
050,39,145,"Ohio","Scioto County",5,64,918,446,472
050,39,145,"Ohio","Scioto County",5,65,960,451,509
050,39,145,"Ohio","Scioto County",5,66,1000,471,529
050,39,145,"Ohio","Scioto County",5,67,954,432,522
050,39,145,"Ohio","Scioto County",5,68,927,441,486
050,39,145,"Ohio","Scioto County",5,69,853,401,452
050,39,145,"Ohio","Scioto County",5,70,794,377,417
050,39,145,"Ohio","Scioto County",5,71,773,363,410
050,39,145,"Ohio","Scioto County",5,72,745,366,379
050,39,145,"Ohio","Scioto County",5,73,691,334,357
050,39,145,"Ohio","Scioto County",5,74,644,296,348
050,39,145,"Ohio","Scioto County",5,75,590,252,338
050,39,145,"Ohio","Scioto County",5,76,672,299,373
050,39,145,"Ohio","Scioto County",5,77,430,176,254
050,39,145,"Ohio","Scioto County",5,78,413,173,240
050,39,145,"Ohio","Scioto County",5,79,387,169,218
050,39,145,"Ohio","Scioto County",5,80,396,176,220
050,39,145,"Ohio","Scioto County",5,81,335,141,194
050,39,145,"Ohio","Scioto County",5,82,317,134,183
050,39,145,"Ohio","Scioto County",5,83,274,116,158
050,39,145,"Ohio","Scioto County",5,84,254,95,159
050,39,145,"Ohio","Scioto County",5,85,1438,476,962
050,39,147,"Ohio","Seneca County",1,0,571,287,284
050,39,147,"Ohio","Seneca County",1,1,580,281,299
050,39,147,"Ohio","Seneca County",1,2,616,324,292
050,39,147,"Ohio","Seneca County",1,3,611,318,293
050,39,147,"Ohio","Seneca County",1,4,654,343,311
050,39,147,"Ohio","Seneca County",1,5,629,291,338
050,39,147,"Ohio","Seneca County",1,6,581,290,291
050,39,147,"Ohio","Seneca County",1,7,617,318,299
050,39,147,"Ohio","Seneca County",1,8,628,342,286
050,39,147,"Ohio","Seneca County",1,9,630,339,291
050,39,147,"Ohio","Seneca County",1,10,667,336,331
050,39,147,"Ohio","Seneca County",1,11,709,354,355
050,39,147,"Ohio","Seneca County",1,12,741,395,346
050,39,147,"Ohio","Seneca County",1,13,740,389,351
050,39,147,"Ohio","Seneca County",1,14,738,396,342
050,39,147,"Ohio","Seneca County",1,15,768,400,368
050,39,147,"Ohio","Seneca County",1,16,798,427,371
050,39,147,"Ohio","Seneca County",1,17,766,381,385
050,39,147,"Ohio","Seneca County",1,18,938,481,457
050,39,147,"Ohio","Seneca County",1,19,1124,602,522
050,39,147,"Ohio","Seneca County",1,20,1019,553,466
050,39,147,"Ohio","Seneca County",1,21,827,440,387
050,39,147,"Ohio","Seneca County",1,22,751,391,360
050,39,147,"Ohio","Seneca County",1,23,640,363,277
050,39,147,"Ohio","Seneca County",1,24,653,351,302
050,39,147,"Ohio","Seneca County",1,25,614,319,295
050,39,147,"Ohio","Seneca County",1,26,652,325,327
050,39,147,"Ohio","Seneca County",1,27,674,339,335
050,39,147,"Ohio","Seneca County",1,28,635,319,316
050,39,147,"Ohio","Seneca County",1,29,654,327,327
050,39,147,"Ohio","Seneca County",1,30,643,314,329
050,39,147,"Ohio","Seneca County",1,31,627,338,289
050,39,147,"Ohio","Seneca County",1,32,574,297,277
050,39,147,"Ohio","Seneca County",1,33,622,322,300
050,39,147,"Ohio","Seneca County",1,34,648,342,306
050,39,147,"Ohio","Seneca County",1,35,621,313,308
050,39,147,"Ohio","Seneca County",1,36,583,304,279
050,39,147,"Ohio","Seneca County",1,37,623,308,315
050,39,147,"Ohio","Seneca County",1,38,628,304,324
050,39,147,"Ohio","Seneca County",1,39,662,349,313
050,39,147,"Ohio","Seneca County",1,40,680,382,298
050,39,147,"Ohio","Seneca County",1,41,714,378,336
050,39,147,"Ohio","Seneca County",1,42,704,356,348
050,39,147,"Ohio","Seneca County",1,43,669,319,350
050,39,147,"Ohio","Seneca County",1,44,577,279,298
050,39,147,"Ohio","Seneca County",1,45,617,313,304
050,39,147,"Ohio","Seneca County",1,46,637,318,319
050,39,147,"Ohio","Seneca County",1,47,605,313,292
050,39,147,"Ohio","Seneca County",1,48,654,328,326
050,39,147,"Ohio","Seneca County",1,49,646,335,311
050,39,147,"Ohio","Seneca County",1,50,628,332,296
050,39,147,"Ohio","Seneca County",1,51,621,320,301
050,39,147,"Ohio","Seneca County",1,52,637,332,305
050,39,147,"Ohio","Seneca County",1,53,652,321,331
050,39,147,"Ohio","Seneca County",1,54,690,351,339
050,39,147,"Ohio","Seneca County",1,55,722,353,369
050,39,147,"Ohio","Seneca County",1,56,770,396,374
050,39,147,"Ohio","Seneca County",1,57,763,400,363
050,39,147,"Ohio","Seneca County",1,58,757,385,372
050,39,147,"Ohio","Seneca County",1,59,770,374,396
050,39,147,"Ohio","Seneca County",1,60,803,385,418
050,39,147,"Ohio","Seneca County",1,61,818,403,415
050,39,147,"Ohio","Seneca County",1,62,813,409,404
050,39,147,"Ohio","Seneca County",1,63,814,408,406
050,39,147,"Ohio","Seneca County",1,64,760,386,374
050,39,147,"Ohio","Seneca County",1,65,742,370,372
050,39,147,"Ohio","Seneca County",1,66,719,366,353
050,39,147,"Ohio","Seneca County",1,67,721,370,351
050,39,147,"Ohio","Seneca County",1,68,671,330,341
050,39,147,"Ohio","Seneca County",1,69,603,286,317
050,39,147,"Ohio","Seneca County",1,70,605,291,314
050,39,147,"Ohio","Seneca County",1,71,583,291,292
050,39,147,"Ohio","Seneca County",1,72,538,261,277
050,39,147,"Ohio","Seneca County",1,73,546,258,288
050,39,147,"Ohio","Seneca County",1,74,360,169,191
050,39,147,"Ohio","Seneca County",1,75,362,166,196
050,39,147,"Ohio","Seneca County",1,76,354,161,193
050,39,147,"Ohio","Seneca County",1,77,369,171,198
050,39,147,"Ohio","Seneca County",1,78,320,142,178
050,39,147,"Ohio","Seneca County",1,79,285,127,158
050,39,147,"Ohio","Seneca County",1,80,261,119,142
050,39,147,"Ohio","Seneca County",1,81,265,122,143
050,39,147,"Ohio","Seneca County",1,82,232,98,134
050,39,147,"Ohio","Seneca County",1,83,191,89,102
050,39,147,"Ohio","Seneca County",1,84,177,75,102
050,39,147,"Ohio","Seneca County",1,85,1195,366,829
050,39,147,"Ohio","Seneca County",2,0,587,300,287
050,39,147,"Ohio","Seneca County",2,1,577,282,295
050,39,147,"Ohio","Seneca County",2,2,603,312,291
050,39,147,"Ohio","Seneca County",2,3,610,321,289
050,39,147,"Ohio","Seneca County",2,4,646,339,307
050,39,147,"Ohio","Seneca County",2,5,633,303,330
050,39,147,"Ohio","Seneca County",2,6,598,293,305
050,39,147,"Ohio","Seneca County",2,7,609,310,299
050,39,147,"Ohio","Seneca County",2,8,626,335,291
050,39,147,"Ohio","Seneca County",2,9,628,339,289
050,39,147,"Ohio","Seneca County",2,10,660,337,323
050,39,147,"Ohio","Seneca County",2,11,695,350,345
050,39,147,"Ohio","Seneca County",2,12,734,387,347
050,39,147,"Ohio","Seneca County",2,13,739,391,348
050,39,147,"Ohio","Seneca County",2,14,738,395,343
050,39,147,"Ohio","Seneca County",2,15,763,401,362
050,39,147,"Ohio","Seneca County",2,16,792,420,372
050,39,147,"Ohio","Seneca County",2,17,777,395,382
050,39,147,"Ohio","Seneca County",2,18,928,472,456
050,39,147,"Ohio","Seneca County",2,19,1125,598,527
050,39,147,"Ohio","Seneca County",2,20,1026,558,468
050,39,147,"Ohio","Seneca County",2,21,836,444,392
050,39,147,"Ohio","Seneca County",2,22,741,389,352
050,39,147,"Ohio","Seneca County",2,23,654,364,290
050,39,147,"Ohio","Seneca County",2,24,650,352,298
050,39,147,"Ohio","Seneca County",2,25,619,324,295
050,39,147,"Ohio","Seneca County",2,26,642,321,321
050,39,147,"Ohio","Seneca County",2,27,666,333,333
050,39,147,"Ohio","Seneca County",2,28,648,324,324
050,39,147,"Ohio","Seneca County",2,29,647,323,324
050,39,147,"Ohio","Seneca County",2,30,653,323,330
050,39,147,"Ohio","Seneca County",2,31,627,331,296
050,39,147,"Ohio","Seneca County",2,32,586,307,279
050,39,147,"Ohio","Seneca County",2,33,610,316,294
050,39,147,"Ohio","Seneca County",2,34,639,334,305
050,39,147,"Ohio","Seneca County",2,35,631,321,310
050,39,147,"Ohio","Seneca County",2,36,592,305,287
050,39,147,"Ohio","Seneca County",2,37,614,307,307
050,39,147,"Ohio","Seneca County",2,38,631,308,323
050,39,147,"Ohio","Seneca County",2,39,653,337,316
050,39,147,"Ohio","Seneca County",2,40,680,376,304
050,39,147,"Ohio","Seneca County",2,41,706,378,328
050,39,147,"Ohio","Seneca County",2,42,701,358,343
050,39,147,"Ohio","Seneca County",2,43,683,331,352
050,39,147,"Ohio","Seneca County",2,44,591,285,306
050,39,147,"Ohio","Seneca County",2,45,613,308,305
050,39,147,"Ohio","Seneca County",2,46,633,315,318
050,39,147,"Ohio","Seneca County",2,47,609,312,297
050,39,147,"Ohio","Seneca County",2,48,641,325,316
050,39,147,"Ohio","Seneca County",2,49,651,335,316
050,39,147,"Ohio","Seneca County",2,50,633,333,300
050,39,147,"Ohio","Seneca County",2,51,622,324,298
050,39,147,"Ohio","Seneca County",2,52,628,324,304
050,39,147,"Ohio","Seneca County",2,53,649,324,325
050,39,147,"Ohio","Seneca County",2,54,676,340,336
050,39,147,"Ohio","Seneca County",2,55,716,353,363
050,39,147,"Ohio","Seneca County",2,56,758,385,373
050,39,147,"Ohio","Seneca County",2,57,763,398,365
050,39,147,"Ohio","Seneca County",2,58,758,388,370
050,39,147,"Ohio","Seneca County",2,59,765,376,389
050,39,147,"Ohio","Seneca County",2,60,797,383,414
050,39,147,"Ohio","Seneca County",2,61,808,395,413
050,39,147,"Ohio","Seneca County",2,62,805,402,403
050,39,147,"Ohio","Seneca County",2,63,818,412,406
050,39,147,"Ohio","Seneca County",2,64,764,385,379
050,39,147,"Ohio","Seneca County",2,65,743,370,373
050,39,147,"Ohio","Seneca County",2,66,722,367,355
050,39,147,"Ohio","Seneca County",2,67,719,369,350
050,39,147,"Ohio","Seneca County",2,68,670,333,337
050,39,147,"Ohio","Seneca County",2,69,623,299,324
050,39,147,"Ohio","Seneca County",2,70,599,286,313
050,39,147,"Ohio","Seneca County",2,71,583,288,295
050,39,147,"Ohio","Seneca County",2,72,541,265,276
050,39,147,"Ohio","Seneca County",2,73,567,271,296
050,39,147,"Ohio","Seneca County",2,74,378,177,201
050,39,147,"Ohio","Seneca County",2,75,359,165,194
050,39,147,"Ohio","Seneca County",2,76,351,160,191
050,39,147,"Ohio","Seneca County",2,77,373,173,200
050,39,147,"Ohio","Seneca County",2,78,322,145,177
050,39,147,"Ohio","Seneca County",2,79,287,128,159
050,39,147,"Ohio","Seneca County",2,80,262,119,143
050,39,147,"Ohio","Seneca County",2,81,261,121,140
050,39,147,"Ohio","Seneca County",2,82,237,103,134
050,39,147,"Ohio","Seneca County",2,83,192,88,104
050,39,147,"Ohio","Seneca County",2,84,179,78,101
050,39,147,"Ohio","Seneca County",2,85,1185,367,818
050,39,147,"Ohio","Seneca County",3,0,574,281,293
050,39,147,"Ohio","Seneca County",3,1,606,315,291
050,39,147,"Ohio","Seneca County",3,2,574,277,297
050,39,147,"Ohio","Seneca County",3,3,636,330,306
050,39,147,"Ohio","Seneca County",3,4,619,320,299
050,39,147,"Ohio","Seneca County",3,5,659,336,323
050,39,147,"Ohio","Seneca County",3,6,637,306,331
050,39,147,"Ohio","Seneca County",3,7,587,291,296
050,39,147,"Ohio","Seneca County",3,8,605,310,295
050,39,147,"Ohio","Seneca County",3,9,618,338,280
050,39,147,"Ohio","Seneca County",3,10,634,346,288
050,39,147,"Ohio","Seneca County",3,11,666,334,332
050,39,147,"Ohio","Seneca County",3,12,699,346,353
050,39,147,"Ohio","Seneca County",3,13,721,382,339
050,39,147,"Ohio","Seneca County",3,14,741,398,343
050,39,147,"Ohio","Seneca County",3,15,745,399,346
050,39,147,"Ohio","Seneca County",3,16,772,401,371
050,39,147,"Ohio","Seneca County",3,17,804,428,376
050,39,147,"Ohio","Seneca County",3,18,923,477,446
050,39,147,"Ohio","Seneca County",3,19,1071,565,506
050,39,147,"Ohio","Seneca County",3,20,991,528,463
050,39,147,"Ohio","Seneca County",3,21,846,451,395
050,39,147,"Ohio","Seneca County",3,22,751,396,355
050,39,147,"Ohio","Seneca County",3,23,693,377,316
050,39,147,"Ohio","Seneca County",3,24,660,367,293
050,39,147,"Ohio","Seneca County",3,25,630,328,302
050,39,147,"Ohio","Seneca County",3,26,608,320,288
050,39,147,"Ohio","Seneca County",3,27,635,314,321
050,39,147,"Ohio","Seneca County",3,28,663,339,324
050,39,147,"Ohio","Seneca County",3,29,645,321,324
050,39,147,"Ohio","Seneca County",3,30,683,348,335
050,39,147,"Ohio","Seneca County",3,31,651,328,323
050,39,147,"Ohio","Seneca County",3,32,623,322,301
050,39,147,"Ohio","Seneca County",3,33,610,311,299
050,39,147,"Ohio","Seneca County",3,34,609,313,296
050,39,147,"Ohio","Seneca County",3,35,620,320,300
050,39,147,"Ohio","Seneca County",3,36,659,341,318
050,39,147,"Ohio","Seneca County",3,37,596,300,296
050,39,147,"Ohio","Seneca County",3,38,614,309,305
050,39,147,"Ohio","Seneca County",3,39,629,307,322
050,39,147,"Ohio","Seneca County",3,40,663,347,316
050,39,147,"Ohio","Seneca County",3,41,669,369,300
050,39,147,"Ohio","Seneca County",3,42,706,384,322
050,39,147,"Ohio","Seneca County",3,43,698,362,336
050,39,147,"Ohio","Seneca County",3,44,662,323,339
050,39,147,"Ohio","Seneca County",3,45,595,294,301
050,39,147,"Ohio","Seneca County",3,46,625,312,313
050,39,147,"Ohio","Seneca County",3,47,618,302,316
050,39,147,"Ohio","Seneca County",3,48,606,309,297
050,39,147,"Ohio","Seneca County",3,49,637,330,307
050,39,147,"Ohio","Seneca County",3,50,635,323,312
050,39,147,"Ohio","Seneca County",3,51,621,318,303
050,39,147,"Ohio","Seneca County",3,52,622,323,299
050,39,147,"Ohio","Seneca County",3,53,633,325,308
050,39,147,"Ohio","Seneca County",3,54,644,313,331
050,39,147,"Ohio","Seneca County",3,55,681,343,338
050,39,147,"Ohio","Seneca County",3,56,730,360,370
050,39,147,"Ohio","Seneca County",3,57,759,383,376
050,39,147,"Ohio","Seneca County",3,58,748,388,360
050,39,147,"Ohio","Seneca County",3,59,743,374,369
050,39,147,"Ohio","Seneca County",3,60,761,370,391
050,39,147,"Ohio","Seneca County",3,61,788,382,406
050,39,147,"Ohio","Seneca County",3,62,788,377,411
050,39,147,"Ohio","Seneca County",3,63,794,397,397
050,39,147,"Ohio","Seneca County",3,64,806,400,406
050,39,147,"Ohio","Seneca County",3,65,757,380,377
050,39,147,"Ohio","Seneca County",3,66,727,359,368
050,39,147,"Ohio","Seneca County",3,67,713,357,356
050,39,147,"Ohio","Seneca County",3,68,697,360,337
050,39,147,"Ohio","Seneca County",3,69,653,317,336
050,39,147,"Ohio","Seneca County",3,70,608,291,317
050,39,147,"Ohio","Seneca County",3,71,581,273,308
050,39,147,"Ohio","Seneca County",3,72,568,278,290
050,39,147,"Ohio","Seneca County",3,73,523,251,272
050,39,147,"Ohio","Seneca County",3,74,550,258,292
050,39,147,"Ohio","Seneca County",3,75,356,167,189
050,39,147,"Ohio","Seneca County",3,76,348,163,185
050,39,147,"Ohio","Seneca County",3,77,328,152,176
050,39,147,"Ohio","Seneca County",3,78,351,161,190
050,39,147,"Ohio","Seneca County",3,79,302,135,167
050,39,147,"Ohio","Seneca County",3,80,261,114,147
050,39,147,"Ohio","Seneca County",3,81,257,113,144
050,39,147,"Ohio","Seneca County",3,82,243,111,132
050,39,147,"Ohio","Seneca County",3,83,230,102,128
050,39,147,"Ohio","Seneca County",3,84,167,69,98
050,39,147,"Ohio","Seneca County",3,85,1105,343,762
050,39,147,"Ohio","Seneca County",4,0,583,292,291
050,39,147,"Ohio","Seneca County",4,1,594,282,312
050,39,147,"Ohio","Seneca County",4,2,588,310,278
050,39,147,"Ohio","Seneca County",4,3,583,285,298
050,39,147,"Ohio","Seneca County",4,4,632,328,304
050,39,147,"Ohio","Seneca County",4,5,623,328,295
050,39,147,"Ohio","Seneca County",4,6,653,334,319
050,39,147,"Ohio","Seneca County",4,7,642,307,335
050,39,147,"Ohio","Seneca County",4,8,601,289,312
050,39,147,"Ohio","Seneca County",4,9,612,312,300
050,39,147,"Ohio","Seneca County",4,10,632,344,288
050,39,147,"Ohio","Seneca County",4,11,631,345,286
050,39,147,"Ohio","Seneca County",4,12,678,344,334
050,39,147,"Ohio","Seneca County",4,13,678,331,347
050,39,147,"Ohio","Seneca County",4,14,713,384,329
050,39,147,"Ohio","Seneca County",4,15,742,402,340
050,39,147,"Ohio","Seneca County",4,16,749,406,343
050,39,147,"Ohio","Seneca County",4,17,760,394,366
050,39,147,"Ohio","Seneca County",4,18,917,478,439
050,39,147,"Ohio","Seneca County",4,19,1076,571,505
050,39,147,"Ohio","Seneca County",4,20,969,519,450
050,39,147,"Ohio","Seneca County",4,21,833,444,389
050,39,147,"Ohio","Seneca County",4,22,762,402,360
050,39,147,"Ohio","Seneca County",4,23,686,370,316
050,39,147,"Ohio","Seneca County",4,24,689,366,323
050,39,147,"Ohio","Seneca County",4,25,632,354,278
050,39,147,"Ohio","Seneca County",4,26,622,318,304
050,39,147,"Ohio","Seneca County",4,27,593,314,279
050,39,147,"Ohio","Seneca County",4,28,647,325,322
050,39,147,"Ohio","Seneca County",4,29,653,333,320
050,39,147,"Ohio","Seneca County",4,30,646,325,321
050,39,147,"Ohio","Seneca County",4,31,682,355,327
050,39,147,"Ohio","Seneca County",4,32,638,323,315
050,39,147,"Ohio","Seneca County",4,33,620,316,304
050,39,147,"Ohio","Seneca County",4,34,603,296,307
050,39,147,"Ohio","Seneca County",4,35,590,300,290
050,39,147,"Ohio","Seneca County",4,36,634,331,303
050,39,147,"Ohio","Seneca County",4,37,661,340,321
050,39,147,"Ohio","Seneca County",4,38,604,309,295
050,39,147,"Ohio","Seneca County",4,39,609,305,304
050,39,147,"Ohio","Seneca County",4,40,646,311,335
050,39,147,"Ohio","Seneca County",4,41,660,349,311
050,39,147,"Ohio","Seneca County",4,42,670,371,299
050,39,147,"Ohio","Seneca County",4,43,693,375,318
050,39,147,"Ohio","Seneca County",4,44,695,364,331
050,39,147,"Ohio","Seneca County",4,45,663,330,333
050,39,147,"Ohio","Seneca County",4,46,588,292,296
050,39,147,"Ohio","Seneca County",4,47,617,304,313
050,39,147,"Ohio","Seneca County",4,48,625,309,316
050,39,147,"Ohio","Seneca County",4,49,615,317,298
050,39,147,"Ohio","Seneca County",4,50,623,322,301
050,39,147,"Ohio","Seneca County",4,51,633,318,315
050,39,147,"Ohio","Seneca County",4,52,626,315,311
050,39,147,"Ohio","Seneca County",4,53,623,328,295
050,39,147,"Ohio","Seneca County",4,54,629,325,304
050,39,147,"Ohio","Seneca County",4,55,643,313,330
050,39,147,"Ohio","Seneca County",4,56,672,339,333
050,39,147,"Ohio","Seneca County",4,57,724,362,362
050,39,147,"Ohio","Seneca County",4,58,755,383,372
050,39,147,"Ohio","Seneca County",4,59,740,387,353
050,39,147,"Ohio","Seneca County",4,60,736,363,373
050,39,147,"Ohio","Seneca County",4,61,754,363,391
050,39,147,"Ohio","Seneca County",4,62,766,370,396
050,39,147,"Ohio","Seneca County",4,63,777,370,407
050,39,147,"Ohio","Seneca County",4,64,792,397,395
050,39,147,"Ohio","Seneca County",4,65,798,394,404
050,39,147,"Ohio","Seneca County",4,66,720,361,359
050,39,147,"Ohio","Seneca County",4,67,715,350,365
050,39,147,"Ohio","Seneca County",4,68,691,345,346
050,39,147,"Ohio","Seneca County",4,69,667,338,329
050,39,147,"Ohio","Seneca County",4,70,636,310,326
050,39,147,"Ohio","Seneca County",4,71,591,281,310
050,39,147,"Ohio","Seneca County",4,72,562,261,301
050,39,147,"Ohio","Seneca County",4,73,541,263,278
050,39,147,"Ohio","Seneca County",4,74,506,244,262
050,39,147,"Ohio","Seneca County",4,75,515,237,278
050,39,147,"Ohio","Seneca County",4,76,342,159,183
050,39,147,"Ohio","Seneca County",4,77,334,158,176
050,39,147,"Ohio","Seneca County",4,78,315,144,171
050,39,147,"Ohio","Seneca County",4,79,334,154,180
050,39,147,"Ohio","Seneca County",4,80,272,120,152
050,39,147,"Ohio","Seneca County",4,81,245,102,143
050,39,147,"Ohio","Seneca County",4,82,230,98,132
050,39,147,"Ohio","Seneca County",4,83,229,103,126
050,39,147,"Ohio","Seneca County",4,84,202,85,117
050,39,147,"Ohio","Seneca County",4,85,1064,341,723
050,39,147,"Ohio","Seneca County",5,0,582,288,294
050,39,147,"Ohio","Seneca County",5,1,591,309,282
050,39,147,"Ohio","Seneca County",5,2,595,282,313
050,39,147,"Ohio","Seneca County",5,3,590,308,282
050,39,147,"Ohio","Seneca County",5,4,586,286,300
050,39,147,"Ohio","Seneca County",5,5,643,338,305
050,39,147,"Ohio","Seneca County",5,6,632,331,301
050,39,147,"Ohio","Seneca County",5,7,651,327,324
050,39,147,"Ohio","Seneca County",5,8,653,306,347
050,39,147,"Ohio","Seneca County",5,9,618,290,328
050,39,147,"Ohio","Seneca County",5,10,611,315,296
050,39,147,"Ohio","Seneca County",5,11,621,337,284
050,39,147,"Ohio","Seneca County",5,12,632,342,290
050,39,147,"Ohio","Seneca County",5,13,671,334,337
050,39,147,"Ohio","Seneca County",5,14,707,344,363
050,39,147,"Ohio","Seneca County",5,15,711,382,329
050,39,147,"Ohio","Seneca County",5,16,744,395,349
050,39,147,"Ohio","Seneca County",5,17,741,391,350
050,39,147,"Ohio","Seneca County",5,18,882,444,438
050,39,147,"Ohio","Seneca County",5,19,1051,561,490
050,39,147,"Ohio","Seneca County",5,20,962,519,443
050,39,147,"Ohio","Seneca County",5,21,815,433,382
050,39,147,"Ohio","Seneca County",5,22,741,387,354
050,39,147,"Ohio","Seneca County",5,23,729,392,337
050,39,147,"Ohio","Seneca County",5,24,716,377,339
050,39,147,"Ohio","Seneca County",5,25,689,371,318
050,39,147,"Ohio","Seneca County",5,26,629,341,288
050,39,147,"Ohio","Seneca County",5,27,623,329,294
050,39,147,"Ohio","Seneca County",5,28,608,310,298
050,39,147,"Ohio","Seneca County",5,29,651,338,313
050,39,147,"Ohio","Seneca County",5,30,655,337,318
050,39,147,"Ohio","Seneca County",5,31,657,339,318
050,39,147,"Ohio","Seneca County",5,32,663,347,316
050,39,147,"Ohio","Seneca County",5,33,633,323,310
050,39,147,"Ohio","Seneca County",5,34,632,317,315
050,39,147,"Ohio","Seneca County",5,35,602,298,304
050,39,147,"Ohio","Seneca County",5,36,587,303,284
050,39,147,"Ohio","Seneca County",5,37,623,328,295
050,39,147,"Ohio","Seneca County",5,38,672,346,326
050,39,147,"Ohio","Seneca County",5,39,615,313,302
050,39,147,"Ohio","Seneca County",5,40,612,299,313
050,39,147,"Ohio","Seneca County",5,41,646,314,332
050,39,147,"Ohio","Seneca County",5,42,660,351,309
050,39,147,"Ohio","Seneca County",5,43,683,381,302
050,39,147,"Ohio","Seneca County",5,44,687,367,320
050,39,147,"Ohio","Seneca County",5,45,703,367,336
050,39,147,"Ohio","Seneca County",5,46,662,328,334
050,39,147,"Ohio","Seneca County",5,47,580,286,294
050,39,147,"Ohio","Seneca County",5,48,626,316,310
050,39,147,"Ohio","Seneca County",5,49,630,312,318
050,39,147,"Ohio","Seneca County",5,50,609,309,300
050,39,147,"Ohio","Seneca County",5,51,624,317,307
050,39,147,"Ohio","Seneca County",5,52,630,318,312
050,39,147,"Ohio","Seneca County",5,53,635,322,313
050,39,147,"Ohio","Seneca County",5,54,621,327,294
050,39,147,"Ohio","Seneca County",5,55,626,329,297
050,39,147,"Ohio","Seneca County",5,56,640,315,325
050,39,147,"Ohio","Seneca County",5,57,669,337,332
050,39,147,"Ohio","Seneca County",5,58,711,354,357
050,39,147,"Ohio","Seneca County",5,59,735,373,362
050,39,147,"Ohio","Seneca County",5,60,733,383,350
050,39,147,"Ohio","Seneca County",5,61,732,358,374
050,39,147,"Ohio","Seneca County",5,62,741,353,388
050,39,147,"Ohio","Seneca County",5,63,758,367,391
050,39,147,"Ohio","Seneca County",5,64,778,374,404
050,39,147,"Ohio","Seneca County",5,65,788,389,399
050,39,147,"Ohio","Seneca County",5,66,773,379,394
050,39,147,"Ohio","Seneca County",5,67,705,354,351
050,39,147,"Ohio","Seneca County",5,68,697,343,354
050,39,147,"Ohio","Seneca County",5,69,682,336,346
050,39,147,"Ohio","Seneca County",5,70,649,328,321
050,39,147,"Ohio","Seneca County",5,71,625,303,322
050,39,147,"Ohio","Seneca County",5,72,572,273,299
050,39,147,"Ohio","Seneca County",5,73,542,255,287
050,39,147,"Ohio","Seneca County",5,74,528,258,270
050,39,147,"Ohio","Seneca County",5,75,481,231,250
050,39,147,"Ohio","Seneca County",5,76,503,231,272
050,39,147,"Ohio","Seneca County",5,77,331,154,177
050,39,147,"Ohio","Seneca County",5,78,322,152,170
050,39,147,"Ohio","Seneca County",5,79,290,133,157
050,39,147,"Ohio","Seneca County",5,80,309,147,162
050,39,147,"Ohio","Seneca County",5,81,255,106,149
050,39,147,"Ohio","Seneca County",5,82,233,98,135
050,39,147,"Ohio","Seneca County",5,83,222,92,130
050,39,147,"Ohio","Seneca County",5,84,208,86,122
050,39,147,"Ohio","Seneca County",5,85,1067,359,708
050,39,149,"Ohio","Shelby County",1,0,601,307,294
050,39,149,"Ohio","Shelby County",1,1,609,297,312
050,39,149,"Ohio","Shelby County",1,2,591,300,291
050,39,149,"Ohio","Shelby County",1,3,633,330,303
050,39,149,"Ohio","Shelby County",1,4,634,323,311
050,39,149,"Ohio","Shelby County",1,5,650,334,316
050,39,149,"Ohio","Shelby County",1,6,629,309,320
050,39,149,"Ohio","Shelby County",1,7,640,334,306
050,39,149,"Ohio","Shelby County",1,8,641,352,289
050,39,149,"Ohio","Shelby County",1,9,636,338,298
050,39,149,"Ohio","Shelby County",1,10,646,320,326
050,39,149,"Ohio","Shelby County",1,11,691,349,342
050,39,149,"Ohio","Shelby County",1,12,730,393,337
050,39,149,"Ohio","Shelby County",1,13,744,391,353
050,39,149,"Ohio","Shelby County",1,14,701,362,339
050,39,149,"Ohio","Shelby County",1,15,719,365,354
050,39,149,"Ohio","Shelby County",1,16,778,399,379
050,39,149,"Ohio","Shelby County",1,17,727,372,355
050,39,149,"Ohio","Shelby County",1,18,639,355,284
050,39,149,"Ohio","Shelby County",1,19,499,267,232
050,39,149,"Ohio","Shelby County",1,20,542,284,258
050,39,149,"Ohio","Shelby County",1,21,547,286,261
050,39,149,"Ohio","Shelby County",1,22,569,305,264
050,39,149,"Ohio","Shelby County",1,23,544,274,270
050,39,149,"Ohio","Shelby County",1,24,552,274,278
050,39,149,"Ohio","Shelby County",1,25,566,276,290
050,39,149,"Ohio","Shelby County",1,26,548,277,271
050,39,149,"Ohio","Shelby County",1,27,593,312,281
050,39,149,"Ohio","Shelby County",1,28,617,316,301
050,39,149,"Ohio","Shelby County",1,29,581,285,296
050,39,149,"Ohio","Shelby County",1,30,555,265,290
050,39,149,"Ohio","Shelby County",1,31,534,277,257
050,39,149,"Ohio","Shelby County",1,32,521,266,255
050,39,149,"Ohio","Shelby County",1,33,503,259,244
050,39,149,"Ohio","Shelby County",1,34,569,285,284
050,39,149,"Ohio","Shelby County",1,35,542,271,271
050,39,149,"Ohio","Shelby County",1,36,523,266,257
050,39,149,"Ohio","Shelby County",1,37,569,292,277
050,39,149,"Ohio","Shelby County",1,38,558,300,258
050,39,149,"Ohio","Shelby County",1,39,537,277,260
050,39,149,"Ohio","Shelby County",1,40,549,277,272
050,39,149,"Ohio","Shelby County",1,41,552,277,275
050,39,149,"Ohio","Shelby County",1,42,554,283,271
050,39,149,"Ohio","Shelby County",1,43,572,278,294
050,39,149,"Ohio","Shelby County",1,44,565,273,292
050,39,149,"Ohio","Shelby County",1,45,556,281,275
050,39,149,"Ohio","Shelby County",1,46,554,274,280
050,39,149,"Ohio","Shelby County",1,47,577,303,274
050,39,149,"Ohio","Shelby County",1,48,620,304,316
050,39,149,"Ohio","Shelby County",1,49,645,333,312
050,39,149,"Ohio","Shelby County",1,50,592,296,296
050,39,149,"Ohio","Shelby County",1,51,609,322,287
050,39,149,"Ohio","Shelby County",1,52,633,331,302
050,39,149,"Ohio","Shelby County",1,53,664,349,315
050,39,149,"Ohio","Shelby County",1,54,691,361,330
050,39,149,"Ohio","Shelby County",1,55,726,371,355
050,39,149,"Ohio","Shelby County",1,56,711,360,351
050,39,149,"Ohio","Shelby County",1,57,712,360,352
050,39,149,"Ohio","Shelby County",1,58,707,356,351
050,39,149,"Ohio","Shelby County",1,59,673,359,314
050,39,149,"Ohio","Shelby County",1,60,662,352,310
050,39,149,"Ohio","Shelby County",1,61,696,354,342
050,39,149,"Ohio","Shelby County",1,62,717,364,353
050,39,149,"Ohio","Shelby County",1,63,709,369,340
050,39,149,"Ohio","Shelby County",1,64,596,298,298
050,39,149,"Ohio","Shelby County",1,65,586,295,291
050,39,149,"Ohio","Shelby County",1,66,602,305,297
050,39,149,"Ohio","Shelby County",1,67,552,278,274
050,39,149,"Ohio","Shelby County",1,68,541,282,259
050,39,149,"Ohio","Shelby County",1,69,522,262,260
050,39,149,"Ohio","Shelby County",1,70,464,228,236
050,39,149,"Ohio","Shelby County",1,71,445,221,224
050,39,149,"Ohio","Shelby County",1,72,465,220,245
050,39,149,"Ohio","Shelby County",1,73,445,205,240
050,39,149,"Ohio","Shelby County",1,74,310,145,165
050,39,149,"Ohio","Shelby County",1,75,301,133,168
050,39,149,"Ohio","Shelby County",1,76,310,143,167
050,39,149,"Ohio","Shelby County",1,77,288,132,156
050,39,149,"Ohio","Shelby County",1,78,274,125,149
050,39,149,"Ohio","Shelby County",1,79,228,100,128
050,39,149,"Ohio","Shelby County",1,80,230,96,134
050,39,149,"Ohio","Shelby County",1,81,196,77,119
050,39,149,"Ohio","Shelby County",1,82,171,82,89
050,39,149,"Ohio","Shelby County",1,83,159,72,87
050,39,149,"Ohio","Shelby County",1,84,137,59,78
050,39,149,"Ohio","Shelby County",1,85,953,319,634
050,39,149,"Ohio","Shelby County",2,0,595,307,288
050,39,149,"Ohio","Shelby County",2,1,601,295,306
050,39,149,"Ohio","Shelby County",2,2,597,300,297
050,39,149,"Ohio","Shelby County",2,3,619,320,299
050,39,149,"Ohio","Shelby County",2,4,635,323,312
050,39,149,"Ohio","Shelby County",2,5,642,328,314
050,39,149,"Ohio","Shelby County",2,6,633,315,318
050,39,149,"Ohio","Shelby County",2,7,633,325,308
050,39,149,"Ohio","Shelby County",2,8,639,347,292
050,39,149,"Ohio","Shelby County",2,9,636,342,294
050,39,149,"Ohio","Shelby County",2,10,643,323,320
050,39,149,"Ohio","Shelby County",2,11,678,343,335
050,39,149,"Ohio","Shelby County",2,12,723,384,339
050,39,149,"Ohio","Shelby County",2,13,738,389,349
050,39,149,"Ohio","Shelby County",2,14,711,368,343
050,39,149,"Ohio","Shelby County",2,15,715,364,351
050,39,149,"Ohio","Shelby County",2,16,767,392,375
050,39,149,"Ohio","Shelby County",2,17,741,382,359
050,39,149,"Ohio","Shelby County",2,18,628,347,281
050,39,149,"Ohio","Shelby County",2,19,500,268,232
050,39,149,"Ohio","Shelby County",2,20,549,289,260
050,39,149,"Ohio","Shelby County",2,21,551,289,262
050,39,149,"Ohio","Shelby County",2,22,565,301,264
050,39,149,"Ohio","Shelby County",2,23,551,283,268
050,39,149,"Ohio","Shelby County",2,24,550,274,276
050,39,149,"Ohio","Shelby County",2,25,559,275,284
050,39,149,"Ohio","Shelby County",2,26,550,276,274
050,39,149,"Ohio","Shelby County",2,27,579,305,274
050,39,149,"Ohio","Shelby County",2,28,611,315,296
050,39,149,"Ohio","Shelby County",2,29,587,290,297
050,39,149,"Ohio","Shelby County",2,30,559,270,289
050,39,149,"Ohio","Shelby County",2,31,538,275,263
050,39,149,"Ohio","Shelby County",2,32,519,268,251
050,39,149,"Ohio","Shelby County",2,33,508,260,248
050,39,149,"Ohio","Shelby County",2,34,555,279,276
050,39,149,"Ohio","Shelby County",2,35,551,274,277
050,39,149,"Ohio","Shelby County",2,36,525,266,259
050,39,149,"Ohio","Shelby County",2,37,558,286,272
050,39,149,"Ohio","Shelby County",2,38,560,296,264
050,39,149,"Ohio","Shelby County",2,39,542,283,259
050,39,149,"Ohio","Shelby County",2,40,545,275,270
050,39,149,"Ohio","Shelby County",2,41,550,277,273
050,39,149,"Ohio","Shelby County",2,42,549,279,270
050,39,149,"Ohio","Shelby County",2,43,572,280,292
050,39,149,"Ohio","Shelby County",2,44,559,270,289
050,39,149,"Ohio","Shelby County",2,45,562,281,281
050,39,149,"Ohio","Shelby County",2,46,550,273,277
050,39,149,"Ohio","Shelby County",2,47,568,293,275
050,39,149,"Ohio","Shelby County",2,48,607,302,305
050,39,149,"Ohio","Shelby County",2,49,643,329,314
050,39,149,"Ohio","Shelby County",2,50,608,307,301
050,39,149,"Ohio","Shelby County",2,51,602,313,289
050,39,149,"Ohio","Shelby County",2,52,625,327,298
050,39,149,"Ohio","Shelby County",2,53,658,345,313
050,39,149,"Ohio","Shelby County",2,54,680,358,322
050,39,149,"Ohio","Shelby County",2,55,715,365,350
050,39,149,"Ohio","Shelby County",2,56,715,364,351
050,39,149,"Ohio","Shelby County",2,57,709,355,354
050,39,149,"Ohio","Shelby County",2,58,705,355,350
050,39,149,"Ohio","Shelby County",2,59,685,360,325
050,39,149,"Ohio","Shelby County",2,60,665,354,311
050,39,149,"Ohio","Shelby County",2,61,681,350,331
050,39,149,"Ohio","Shelby County",2,62,706,359,347
050,39,149,"Ohio","Shelby County",2,63,715,370,345
050,39,149,"Ohio","Shelby County",2,64,609,306,303
050,39,149,"Ohio","Shelby County",2,65,586,294,292
050,39,149,"Ohio","Shelby County",2,66,596,301,295
050,39,149,"Ohio","Shelby County",2,67,558,281,277
050,39,149,"Ohio","Shelby County",2,68,536,276,260
050,39,149,"Ohio","Shelby County",2,69,531,268,263
050,39,149,"Ohio","Shelby County",2,70,476,236,240
050,39,149,"Ohio","Shelby County",2,71,449,223,226
050,39,149,"Ohio","Shelby County",2,72,453,217,236
050,39,149,"Ohio","Shelby County",2,73,463,214,249
050,39,149,"Ohio","Shelby County",2,74,319,148,171
050,39,149,"Ohio","Shelby County",2,75,300,136,164
050,39,149,"Ohio","Shelby County",2,76,301,134,167
050,39,149,"Ohio","Shelby County",2,77,298,138,160
050,39,149,"Ohio","Shelby County",2,78,269,124,145
050,39,149,"Ohio","Shelby County",2,79,234,102,132
050,39,149,"Ohio","Shelby County",2,80,230,97,133
050,39,149,"Ohio","Shelby County",2,81,202,80,122
050,39,149,"Ohio","Shelby County",2,82,173,80,93
050,39,149,"Ohio","Shelby County",2,83,163,75,88
050,39,149,"Ohio","Shelby County",2,84,138,59,79
050,39,149,"Ohio","Shelby County",2,85,947,317,630
050,39,149,"Ohio","Shelby County",3,0,592,308,284
050,39,149,"Ohio","Shelby County",3,1,633,324,309
050,39,149,"Ohio","Shelby County",3,2,615,306,309
050,39,149,"Ohio","Shelby County",3,3,625,315,310
050,39,149,"Ohio","Shelby County",3,4,604,302,302
050,39,149,"Ohio","Shelby County",3,5,645,326,319
050,39,149,"Ohio","Shelby County",3,6,647,333,314
050,39,149,"Ohio","Shelby County",3,7,637,322,315
050,39,149,"Ohio","Shelby County",3,8,626,322,304
050,39,149,"Ohio","Shelby County",3,9,630,341,289
050,39,149,"Ohio","Shelby County",3,10,626,327,299
050,39,149,"Ohio","Shelby County",3,11,659,335,324
050,39,149,"Ohio","Shelby County",3,12,666,338,328
050,39,149,"Ohio","Shelby County",3,13,735,385,350
050,39,149,"Ohio","Shelby County",3,14,734,380,354
050,39,149,"Ohio","Shelby County",3,15,718,379,339
050,39,149,"Ohio","Shelby County",3,16,718,363,355
050,39,149,"Ohio","Shelby County",3,17,746,387,359
050,39,149,"Ohio","Shelby County",3,18,649,346,303
050,39,149,"Ohio","Shelby County",3,19,484,259,225
050,39,149,"Ohio","Shelby County",3,20,560,296,264
050,39,149,"Ohio","Shelby County",3,21,584,307,277
050,39,149,"Ohio","Shelby County",3,22,584,303,281
050,39,149,"Ohio","Shelby County",3,23,548,304,244
050,39,149,"Ohio","Shelby County",3,24,547,278,269
050,39,149,"Ohio","Shelby County",3,25,551,281,270
050,39,149,"Ohio","Shelby County",3,26,551,267,284
050,39,149,"Ohio","Shelby County",3,27,535,276,259
050,39,149,"Ohio","Shelby County",3,28,582,300,282
050,39,149,"Ohio","Shelby County",3,29,604,305,299
050,39,149,"Ohio","Shelby County",3,30,602,301,301
050,39,149,"Ohio","Shelby County",3,31,560,276,284
050,39,149,"Ohio","Shelby County",3,32,530,272,258
050,39,149,"Ohio","Shelby County",3,33,514,259,255
050,39,149,"Ohio","Shelby County",3,34,510,268,242
050,39,149,"Ohio","Shelby County",3,35,561,281,280
050,39,149,"Ohio","Shelby County",3,36,556,280,276
050,39,149,"Ohio","Shelby County",3,37,531,272,259
050,39,149,"Ohio","Shelby County",3,38,554,282,272
050,39,149,"Ohio","Shelby County",3,39,561,301,260
050,39,149,"Ohio","Shelby County",3,40,543,274,269
050,39,149,"Ohio","Shelby County",3,41,555,284,271
050,39,149,"Ohio","Shelby County",3,42,550,276,274
050,39,149,"Ohio","Shelby County",3,43,542,273,269
050,39,149,"Ohio","Shelby County",3,44,560,282,278
050,39,149,"Ohio","Shelby County",3,45,545,263,282
050,39,149,"Ohio","Shelby County",3,46,572,287,285
050,39,149,"Ohio","Shelby County",3,47,546,270,276
050,39,149,"Ohio","Shelby County",3,48,562,289,273
050,39,149,"Ohio","Shelby County",3,49,607,307,300
050,39,149,"Ohio","Shelby County",3,50,632,326,306
050,39,149,"Ohio","Shelby County",3,51,606,302,304
050,39,149,"Ohio","Shelby County",3,52,604,314,290
050,39,149,"Ohio","Shelby County",3,53,619,325,294
050,39,149,"Ohio","Shelby County",3,54,649,344,305
050,39,149,"Ohio","Shelby County",3,55,671,355,316
050,39,149,"Ohio","Shelby County",3,56,706,363,343
050,39,149,"Ohio","Shelby County",3,57,703,356,347
050,39,149,"Ohio","Shelby County",3,58,703,363,340
050,39,149,"Ohio","Shelby County",3,59,695,353,342
050,39,149,"Ohio","Shelby County",3,60,680,347,333
050,39,149,"Ohio","Shelby County",3,61,640,339,301
050,39,149,"Ohio","Shelby County",3,62,665,343,322
050,39,149,"Ohio","Shelby County",3,63,702,353,349
050,39,149,"Ohio","Shelby County",3,64,698,365,333
050,39,149,"Ohio","Shelby County",3,65,597,300,297
050,39,149,"Ohio","Shelby County",3,66,562,282,280
050,39,149,"Ohio","Shelby County",3,67,586,296,290
050,39,149,"Ohio","Shelby County",3,68,545,278,267
050,39,149,"Ohio","Shelby County",3,69,524,265,259
050,39,149,"Ohio","Shelby County",3,70,522,261,261
050,39,149,"Ohio","Shelby County",3,71,460,228,232
050,39,149,"Ohio","Shelby County",3,72,438,220,218
050,39,149,"Ohio","Shelby County",3,73,440,209,231
050,39,149,"Ohio","Shelby County",3,74,447,204,243
050,39,149,"Ohio","Shelby County",3,75,304,140,164
050,39,149,"Ohio","Shelby County",3,76,285,129,156
050,39,149,"Ohio","Shelby County",3,77,285,124,161
050,39,149,"Ohio","Shelby County",3,78,280,125,155
050,39,149,"Ohio","Shelby County",3,79,247,114,133
050,39,149,"Ohio","Shelby County",3,80,226,98,128
050,39,149,"Ohio","Shelby County",3,81,217,85,132
050,39,149,"Ohio","Shelby County",3,82,180,75,105
050,39,149,"Ohio","Shelby County",3,83,173,76,97
050,39,149,"Ohio","Shelby County",3,84,135,54,81
050,39,149,"Ohio","Shelby County",3,85,901,295,606
050,39,149,"Ohio","Shelby County",4,0,626,327,299
050,39,149,"Ohio","Shelby County",4,1,592,309,283
050,39,149,"Ohio","Shelby County",4,2,629,325,304
050,39,149,"Ohio","Shelby County",4,3,604,309,295
050,39,149,"Ohio","Shelby County",4,4,618,308,310
050,39,149,"Ohio","Shelby County",4,5,608,305,303
050,39,149,"Ohio","Shelby County",4,6,629,322,307
050,39,149,"Ohio","Shelby County",4,7,627,320,307
050,39,149,"Ohio","Shelby County",4,8,638,317,321
050,39,149,"Ohio","Shelby County",4,9,627,320,307
050,39,149,"Ohio","Shelby County",4,10,641,348,293
050,39,149,"Ohio","Shelby County",4,11,639,342,297
050,39,149,"Ohio","Shelby County",4,12,646,325,321
050,39,149,"Ohio","Shelby County",4,13,680,340,340
050,39,149,"Ohio","Shelby County",4,14,721,381,340
050,39,149,"Ohio","Shelby County",4,15,731,391,340
050,39,149,"Ohio","Shelby County",4,16,707,369,338
050,39,149,"Ohio","Shelby County",4,17,718,364,354
050,39,149,"Ohio","Shelby County",4,18,637,344,293
050,39,149,"Ohio","Shelby County",4,19,467,251,216
050,39,149,"Ohio","Shelby County",4,20,518,277,241
050,39,149,"Ohio","Shelby County",4,21,578,300,278
050,39,149,"Ohio","Shelby County",4,22,625,333,292
050,39,149,"Ohio","Shelby County",4,23,574,304,270
050,39,149,"Ohio","Shelby County",4,24,544,292,252
050,39,149,"Ohio","Shelby County",4,25,552,289,263
050,39,149,"Ohio","Shelby County",4,26,550,284,266
050,39,149,"Ohio","Shelby County",4,27,536,259,277
050,39,149,"Ohio","Shelby County",4,28,515,262,253
050,39,149,"Ohio","Shelby County",4,29,576,295,281
050,39,149,"Ohio","Shelby County",4,30,583,286,297
050,39,149,"Ohio","Shelby County",4,31,607,312,295
050,39,149,"Ohio","Shelby County",4,32,564,276,288
050,39,149,"Ohio","Shelby County",4,33,557,281,276
050,39,149,"Ohio","Shelby County",4,34,512,255,257
050,39,149,"Ohio","Shelby County",4,35,515,274,241
050,39,149,"Ohio","Shelby County",4,36,551,278,273
050,39,149,"Ohio","Shelby County",4,37,550,273,277
050,39,149,"Ohio","Shelby County",4,38,515,268,247
050,39,149,"Ohio","Shelby County",4,39,547,285,262
050,39,149,"Ohio","Shelby County",4,40,547,292,255
050,39,149,"Ohio","Shelby County",4,41,536,272,264
050,39,149,"Ohio","Shelby County",4,42,551,284,267
050,39,149,"Ohio","Shelby County",4,43,557,279,278
050,39,149,"Ohio","Shelby County",4,44,544,276,268
050,39,149,"Ohio","Shelby County",4,45,558,279,279
050,39,149,"Ohio","Shelby County",4,46,552,264,288
050,39,149,"Ohio","Shelby County",4,47,573,287,286
050,39,149,"Ohio","Shelby County",4,48,544,268,276
050,39,149,"Ohio","Shelby County",4,49,556,292,264
050,39,149,"Ohio","Shelby County",4,50,598,297,301
050,39,149,"Ohio","Shelby County",4,51,624,319,305
050,39,149,"Ohio","Shelby County",4,52,597,298,299
050,39,149,"Ohio","Shelby County",4,53,596,306,290
050,39,149,"Ohio","Shelby County",4,54,616,328,288
050,39,149,"Ohio","Shelby County",4,55,644,338,306
050,39,149,"Ohio","Shelby County",4,56,674,361,313
050,39,149,"Ohio","Shelby County",4,57,684,348,336
050,39,149,"Ohio","Shelby County",4,58,695,349,346
050,39,149,"Ohio","Shelby County",4,59,700,359,341
050,39,149,"Ohio","Shelby County",4,60,688,349,339
050,39,149,"Ohio","Shelby County",4,61,657,337,320
050,39,149,"Ohio","Shelby County",4,62,623,328,295
050,39,149,"Ohio","Shelby County",4,63,654,341,313
050,39,149,"Ohio","Shelby County",4,64,686,346,340
050,39,149,"Ohio","Shelby County",4,65,688,362,326
050,39,149,"Ohio","Shelby County",4,66,560,281,279
050,39,149,"Ohio","Shelby County",4,67,559,282,277
050,39,149,"Ohio","Shelby County",4,68,567,292,275
050,39,149,"Ohio","Shelby County",4,69,525,260,265
050,39,149,"Ohio","Shelby County",4,70,514,258,256
050,39,149,"Ohio","Shelby County",4,71,506,251,255
050,39,149,"Ohio","Shelby County",4,72,447,226,221
050,39,149,"Ohio","Shelby County",4,73,423,213,210
050,39,149,"Ohio","Shelby County",4,74,425,205,220
050,39,149,"Ohio","Shelby County",4,75,429,193,236
050,39,149,"Ohio","Shelby County",4,76,287,128,159
050,39,149,"Ohio","Shelby County",4,77,268,119,149
050,39,149,"Ohio","Shelby County",4,78,263,113,150
050,39,149,"Ohio","Shelby County",4,79,268,116,152
050,39,149,"Ohio","Shelby County",4,80,237,111,126
050,39,149,"Ohio","Shelby County",4,81,210,85,125
050,39,149,"Ohio","Shelby County",4,82,194,77,117
050,39,149,"Ohio","Shelby County",4,83,186,75,111
050,39,149,"Ohio","Shelby County",4,84,153,65,88
050,39,149,"Ohio","Shelby County",4,85,867,285,582
050,39,149,"Ohio","Shelby County",5,0,622,323,299
050,39,149,"Ohio","Shelby County",5,1,647,349,298
050,39,149,"Ohio","Shelby County",5,2,614,319,295
050,39,149,"Ohio","Shelby County",5,3,645,338,307
050,39,149,"Ohio","Shelby County",5,4,613,318,295
050,39,149,"Ohio","Shelby County",5,5,611,320,291
050,39,149,"Ohio","Shelby County",5,6,614,308,306
050,39,149,"Ohio","Shelby County",5,7,616,303,313
050,39,149,"Ohio","Shelby County",5,8,642,330,312
050,39,149,"Ohio","Shelby County",5,9,641,319,322
050,39,149,"Ohio","Shelby County",5,10,628,320,308
050,39,149,"Ohio","Shelby County",5,11,641,355,286
050,39,149,"Ohio","Shelby County",5,12,639,340,299
050,39,149,"Ohio","Shelby County",5,13,640,326,314
050,39,149,"Ohio","Shelby County",5,14,689,352,337
050,39,149,"Ohio","Shelby County",5,15,730,385,345
050,39,149,"Ohio","Shelby County",5,16,738,386,352
050,39,149,"Ohio","Shelby County",5,17,708,371,337
050,39,149,"Ohio","Shelby County",5,18,616,332,284
050,39,149,"Ohio","Shelby County",5,19,477,249,228
050,39,149,"Ohio","Shelby County",5,20,513,266,247
050,39,149,"Ohio","Shelby County",5,21,548,281,267
050,39,149,"Ohio","Shelby County",5,22,640,327,313
050,39,149,"Ohio","Shelby County",5,23,632,339,293
050,39,149,"Ohio","Shelby County",5,24,569,309,260
050,39,149,"Ohio","Shelby County",5,25,561,296,265
050,39,149,"Ohio","Shelby County",5,26,554,290,264
050,39,149,"Ohio","Shelby County",5,27,548,291,257
050,39,149,"Ohio","Shelby County",5,28,534,254,280
050,39,149,"Ohio","Shelby County",5,29,527,269,258
050,39,149,"Ohio","Shelby County",5,30,561,295,266
050,39,149,"Ohio","Shelby County",5,31,576,284,292
050,39,149,"Ohio","Shelby County",5,32,621,322,299
050,39,149,"Ohio","Shelby County",5,33,559,276,283
050,39,149,"Ohio","Shelby County",5,34,575,295,280
050,39,149,"Ohio","Shelby County",5,35,515,248,267
050,39,149,"Ohio","Shelby County",5,36,514,265,249
050,39,149,"Ohio","Shelby County",5,37,557,282,275
050,39,149,"Ohio","Shelby County",5,38,556,275,281
050,39,149,"Ohio","Shelby County",5,39,528,277,251
050,39,149,"Ohio","Shelby County",5,40,534,280,254
050,39,149,"Ohio","Shelby County",5,41,547,295,252
050,39,149,"Ohio","Shelby County",5,42,541,275,266
050,39,149,"Ohio","Shelby County",5,43,544,285,259
050,39,149,"Ohio","Shelby County",5,44,543,272,271
050,39,149,"Ohio","Shelby County",5,45,548,274,274
050,39,149,"Ohio","Shelby County",5,46,547,272,275
050,39,149,"Ohio","Shelby County",5,47,546,260,286
050,39,149,"Ohio","Shelby County",5,48,565,280,285
050,39,149,"Ohio","Shelby County",5,49,540,273,267
050,39,149,"Ohio","Shelby County",5,50,556,291,265
050,39,149,"Ohio","Shelby County",5,51,595,294,301
050,39,149,"Ohio","Shelby County",5,52,633,328,305
050,39,149,"Ohio","Shelby County",5,53,597,298,299
050,39,149,"Ohio","Shelby County",5,54,593,306,287
050,39,149,"Ohio","Shelby County",5,55,610,324,286
050,39,149,"Ohio","Shelby County",5,56,633,337,296
050,39,149,"Ohio","Shelby County",5,57,661,345,316
050,39,149,"Ohio","Shelby County",5,58,665,340,325
050,39,149,"Ohio","Shelby County",5,59,695,345,350
050,39,149,"Ohio","Shelby County",5,60,704,358,346
050,39,149,"Ohio","Shelby County",5,61,671,341,330
050,39,149,"Ohio","Shelby County",5,62,654,332,322
050,39,149,"Ohio","Shelby County",5,63,629,339,290
050,39,149,"Ohio","Shelby County",5,64,639,331,308
050,39,149,"Ohio","Shelby County",5,65,678,341,337
050,39,149,"Ohio","Shelby County",5,66,660,347,313
050,39,149,"Ohio","Shelby County",5,67,548,274,274
050,39,149,"Ohio","Shelby County",5,68,547,277,270
050,39,149,"Ohio","Shelby County",5,69,552,278,274
050,39,149,"Ohio","Shelby County",5,70,517,255,262
050,39,149,"Ohio","Shelby County",5,71,498,251,247
050,39,149,"Ohio","Shelby County",5,72,490,245,245
050,39,149,"Ohio","Shelby County",5,73,439,218,221
050,39,149,"Ohio","Shelby County",5,74,411,210,201
050,39,149,"Ohio","Shelby County",5,75,404,191,213
050,39,149,"Ohio","Shelby County",5,76,410,182,228
050,39,149,"Ohio","Shelby County",5,77,276,121,155
050,39,149,"Ohio","Shelby County",5,78,247,110,137
050,39,149,"Ohio","Shelby County",5,79,249,105,144
050,39,149,"Ohio","Shelby County",5,80,251,108,143
050,39,149,"Ohio","Shelby County",5,81,220,100,120
050,39,149,"Ohio","Shelby County",5,82,181,75,106
050,39,149,"Ohio","Shelby County",5,83,191,73,118
050,39,149,"Ohio","Shelby County",5,84,162,64,98
050,39,149,"Ohio","Shelby County",5,85,885,297,588
050,39,151,"Ohio","Stark County",1,0,4051,2072,1979
050,39,151,"Ohio","Stark County",1,1,4083,2115,1968
050,39,151,"Ohio","Stark County",1,2,4176,2148,2028
050,39,151,"Ohio","Stark County",1,3,4255,2184,2071
050,39,151,"Ohio","Stark County",1,4,4394,2271,2123
050,39,151,"Ohio","Stark County",1,5,4434,2303,2131
050,39,151,"Ohio","Stark County",1,6,4389,2282,2107
050,39,151,"Ohio","Stark County",1,7,4318,2216,2102
050,39,151,"Ohio","Stark County",1,8,4384,2277,2107
050,39,151,"Ohio","Stark County",1,9,4432,2267,2165
050,39,151,"Ohio","Stark County",1,10,4553,2343,2210
050,39,151,"Ohio","Stark County",1,11,4735,2441,2294
050,39,151,"Ohio","Stark County",1,12,4962,2534,2428
050,39,151,"Ohio","Stark County",1,13,4911,2501,2410
050,39,151,"Ohio","Stark County",1,14,4857,2483,2374
050,39,151,"Ohio","Stark County",1,15,4856,2483,2373
050,39,151,"Ohio","Stark County",1,16,4851,2501,2350
050,39,151,"Ohio","Stark County",1,17,4876,2532,2344
050,39,151,"Ohio","Stark County",1,18,4516,2294,2222
050,39,151,"Ohio","Stark County",1,19,4359,2196,2163
050,39,151,"Ohio","Stark County",1,20,4414,2263,2151
050,39,151,"Ohio","Stark County",1,21,4432,2241,2191
050,39,151,"Ohio","Stark County",1,22,4559,2312,2247
050,39,151,"Ohio","Stark County",1,23,4315,2190,2125
050,39,151,"Ohio","Stark County",1,24,4407,2247,2160
050,39,151,"Ohio","Stark County",1,25,4389,2202,2187
050,39,151,"Ohio","Stark County",1,26,4472,2257,2215
050,39,151,"Ohio","Stark County",1,27,4586,2294,2292
050,39,151,"Ohio","Stark County",1,28,4770,2341,2429
050,39,151,"Ohio","Stark County",1,29,4762,2330,2432
050,39,151,"Ohio","Stark County",1,30,4735,2309,2426
050,39,151,"Ohio","Stark County",1,31,4549,2238,2311
050,39,151,"Ohio","Stark County",1,32,4331,2153,2178
050,39,151,"Ohio","Stark County",1,33,4254,2124,2130
050,39,151,"Ohio","Stark County",1,34,4368,2202,2166
050,39,151,"Ohio","Stark County",1,35,4350,2184,2166
050,39,151,"Ohio","Stark County",1,36,4300,2131,2169
050,39,151,"Ohio","Stark County",1,37,4494,2253,2241
050,39,151,"Ohio","Stark County",1,38,4524,2273,2251
050,39,151,"Ohio","Stark County",1,39,4589,2274,2315
050,39,151,"Ohio","Stark County",1,40,4427,2139,2288
050,39,151,"Ohio","Stark County",1,41,4340,2146,2194
050,39,151,"Ohio","Stark County",1,42,4231,2107,2124
050,39,151,"Ohio","Stark County",1,43,4100,2040,2060
050,39,151,"Ohio","Stark County",1,44,4029,1995,2034
050,39,151,"Ohio","Stark County",1,45,4053,1989,2064
050,39,151,"Ohio","Stark County",1,46,4053,1990,2063
050,39,151,"Ohio","Stark County",1,47,4261,2046,2215
050,39,151,"Ohio","Stark County",1,48,4715,2302,2413
050,39,151,"Ohio","Stark County",1,49,5143,2610,2533
050,39,151,"Ohio","Stark County",1,50,4918,2469,2449
050,39,151,"Ohio","Stark County",1,51,4780,2397,2383
050,39,151,"Ohio","Stark County",1,52,4657,2318,2339
050,39,151,"Ohio","Stark County",1,53,4824,2405,2419
050,39,151,"Ohio","Stark County",1,54,4966,2428,2538
050,39,151,"Ohio","Stark County",1,55,5182,2561,2621
050,39,151,"Ohio","Stark County",1,56,5219,2548,2671
050,39,151,"Ohio","Stark County",1,57,5274,2608,2666
050,39,151,"Ohio","Stark County",1,58,5389,2633,2756
050,39,151,"Ohio","Stark County",1,59,5512,2699,2813
050,39,151,"Ohio","Stark County",1,60,5459,2601,2858
050,39,151,"Ohio","Stark County",1,61,5498,2634,2864
050,39,151,"Ohio","Stark County",1,62,5588,2684,2904
050,39,151,"Ohio","Stark County",1,63,5426,2660,2766
050,39,151,"Ohio","Stark County",1,64,5226,2535,2691
050,39,151,"Ohio","Stark County",1,65,5099,2461,2638
050,39,151,"Ohio","Stark County",1,66,4961,2328,2633
050,39,151,"Ohio","Stark County",1,67,4782,2263,2519
050,39,151,"Ohio","Stark County",1,68,4655,2229,2426
050,39,151,"Ohio","Stark County",1,69,4309,2011,2298
050,39,151,"Ohio","Stark County",1,70,4293,2045,2248
050,39,151,"Ohio","Stark County",1,71,4188,1981,2207
050,39,151,"Ohio","Stark County",1,72,4177,1922,2255
050,39,151,"Ohio","Stark County",1,73,4098,1933,2165
050,39,151,"Ohio","Stark County",1,74,2728,1239,1489
050,39,151,"Ohio","Stark County",1,75,2749,1249,1500
050,39,151,"Ohio","Stark County",1,76,2782,1239,1543
050,39,151,"Ohio","Stark County",1,77,2829,1267,1562
050,39,151,"Ohio","Stark County",1,78,2414,1049,1365
050,39,151,"Ohio","Stark County",1,79,2136,913,1223
050,39,151,"Ohio","Stark County",1,80,1958,833,1125
050,39,151,"Ohio","Stark County",1,81,1892,778,1114
050,39,151,"Ohio","Stark County",1,82,1798,754,1044
050,39,151,"Ohio","Stark County",1,83,1550,656,894
050,39,151,"Ohio","Stark County",1,84,1439,572,867
050,39,151,"Ohio","Stark County",1,85,8765,2958,5807
050,39,151,"Ohio","Stark County",2,0,3992,2047,1945
050,39,151,"Ohio","Stark County",2,1,4074,2106,1968
050,39,151,"Ohio","Stark County",2,2,4168,2146,2022
050,39,151,"Ohio","Stark County",2,3,4231,2174,2057
050,39,151,"Ohio","Stark County",2,4,4382,2261,2121
050,39,151,"Ohio","Stark County",2,5,4437,2302,2135
050,39,151,"Ohio","Stark County",2,6,4410,2289,2121
050,39,151,"Ohio","Stark County",2,7,4342,2234,2108
050,39,151,"Ohio","Stark County",2,8,4366,2261,2105
050,39,151,"Ohio","Stark County",2,9,4419,2272,2147
050,39,151,"Ohio","Stark County",2,10,4526,2330,2196
050,39,151,"Ohio","Stark County",2,11,4678,2411,2267
050,39,151,"Ohio","Stark County",2,12,4930,2520,2410
050,39,151,"Ohio","Stark County",2,13,4920,2504,2416
050,39,151,"Ohio","Stark County",2,14,4877,2486,2391
050,39,151,"Ohio","Stark County",2,15,4870,2488,2382
050,39,151,"Ohio","Stark County",2,16,4861,2507,2354
050,39,151,"Ohio","Stark County",2,17,4870,2526,2344
050,39,151,"Ohio","Stark County",2,18,4485,2291,2194
050,39,151,"Ohio","Stark County",2,19,4345,2182,2163
050,39,151,"Ohio","Stark County",2,20,4464,2280,2184
050,39,151,"Ohio","Stark County",2,21,4436,2243,2193
050,39,151,"Ohio","Stark County",2,22,4519,2292,2227
050,39,151,"Ohio","Stark County",2,23,4336,2197,2139
050,39,151,"Ohio","Stark County",2,24,4364,2227,2137
050,39,151,"Ohio","Stark County",2,25,4382,2207,2175
050,39,151,"Ohio","Stark County",2,26,4454,2244,2210
050,39,151,"Ohio","Stark County",2,27,4562,2286,2276
050,39,151,"Ohio","Stark County",2,28,4726,2335,2391
050,39,151,"Ohio","Stark County",2,29,4774,2337,2437
050,39,151,"Ohio","Stark County",2,30,4771,2326,2445
050,39,151,"Ohio","Stark County",2,31,4595,2258,2337
050,39,151,"Ohio","Stark County",2,32,4375,2170,2205
050,39,151,"Ohio","Stark County",2,33,4270,2130,2140
050,39,151,"Ohio","Stark County",2,34,4345,2184,2161
050,39,151,"Ohio","Stark County",2,35,4387,2205,2182
050,39,151,"Ohio","Stark County",2,36,4289,2136,2153
050,39,151,"Ohio","Stark County",2,37,4461,2234,2227
050,39,151,"Ohio","Stark County",2,38,4540,2280,2260
050,39,151,"Ohio","Stark County",2,39,4568,2270,2298
050,39,151,"Ohio","Stark County",2,40,4488,2182,2306
050,39,151,"Ohio","Stark County",2,41,4347,2135,2212
050,39,151,"Ohio","Stark County",2,42,4241,2108,2133
050,39,151,"Ohio","Stark County",2,43,4153,2064,2089
050,39,151,"Ohio","Stark County",2,44,4000,1984,2016
050,39,151,"Ohio","Stark County",2,45,4055,1996,2059
050,39,151,"Ohio","Stark County",2,46,4032,1976,2056
050,39,151,"Ohio","Stark County",2,47,4198,2029,2169
050,39,151,"Ohio","Stark County",2,48,4591,2236,2355
050,39,151,"Ohio","Stark County",2,49,5052,2545,2507
050,39,151,"Ohio","Stark County",2,50,4979,2508,2471
050,39,151,"Ohio","Stark County",2,51,4796,2409,2387
050,39,151,"Ohio","Stark County",2,52,4665,2331,2334
050,39,151,"Ohio","Stark County",2,53,4787,2379,2408
050,39,151,"Ohio","Stark County",2,54,4908,2412,2496
050,39,151,"Ohio","Stark County",2,55,5109,2516,2593
050,39,151,"Ohio","Stark County",2,56,5215,2548,2667
050,39,151,"Ohio","Stark County",2,57,5255,2592,2663
050,39,151,"Ohio","Stark County",2,58,5343,2623,2720
050,39,151,"Ohio","Stark County",2,59,5494,2687,2807
050,39,151,"Ohio","Stark County",2,60,5442,2606,2836
050,39,151,"Ohio","Stark County",2,61,5454,2611,2843
050,39,151,"Ohio","Stark County",2,62,5540,2657,2883
050,39,151,"Ohio","Stark County",2,63,5499,2679,2820
050,39,151,"Ohio","Stark County",2,64,5223,2540,2683
050,39,151,"Ohio","Stark County",2,65,5097,2461,2636
050,39,151,"Ohio","Stark County",2,66,4980,2345,2635
050,39,151,"Ohio","Stark County",2,67,4787,2255,2532
050,39,151,"Ohio","Stark County",2,68,4642,2219,2423
050,39,151,"Ohio","Stark County",2,69,4400,2056,2344
050,39,151,"Ohio","Stark County",2,70,4255,2013,2242
050,39,151,"Ohio","Stark County",2,71,4186,1973,2213
050,39,151,"Ohio","Stark County",2,72,4091,1891,2200
050,39,151,"Ohio","Stark County",2,73,4285,2010,2275
050,39,151,"Ohio","Stark County",2,74,2861,1311,1550
050,39,151,"Ohio","Stark County",2,75,2740,1241,1499
050,39,151,"Ohio","Stark County",2,76,2711,1214,1497
050,39,151,"Ohio","Stark County",2,77,2850,1273,1577
050,39,151,"Ohio","Stark County",2,78,2444,1069,1375
050,39,151,"Ohio","Stark County",2,79,2167,924,1243
050,39,151,"Ohio","Stark County",2,80,1973,840,1133
050,39,151,"Ohio","Stark County",2,81,1861,760,1101
050,39,151,"Ohio","Stark County",2,82,1791,742,1049
050,39,151,"Ohio","Stark County",2,83,1572,660,912
050,39,151,"Ohio","Stark County",2,84,1430,576,854
050,39,151,"Ohio","Stark County",2,85,8732,2945,5787
050,39,151,"Ohio","Stark County",3,0,3943,2008,1935
050,39,151,"Ohio","Stark County",3,1,4049,2059,1990
050,39,151,"Ohio","Stark County",3,2,4134,2133,2001
050,39,151,"Ohio","Stark County",3,3,4213,2148,2065
050,39,151,"Ohio","Stark County",3,4,4268,2180,2088
050,39,151,"Ohio","Stark County",3,5,4415,2279,2136
050,39,151,"Ohio","Stark County",3,6,4469,2331,2138
050,39,151,"Ohio","Stark County",3,7,4446,2329,2117
050,39,151,"Ohio","Stark County",3,8,4349,2255,2094
050,39,151,"Ohio","Stark County",3,9,4361,2252,2109
050,39,151,"Ohio","Stark County",3,10,4471,2295,2176
050,39,151,"Ohio","Stark County",3,11,4540,2327,2213
050,39,151,"Ohio","Stark County",3,12,4705,2418,2287
050,39,151,"Ohio","Stark County",3,13,4989,2549,2440
050,39,151,"Ohio","Stark County",3,14,4938,2514,2424
050,39,151,"Ohio","Stark County",3,15,4928,2537,2391
050,39,151,"Ohio","Stark County",3,16,4872,2508,2364
050,39,151,"Ohio","Stark County",3,17,4861,2522,2339
050,39,151,"Ohio","Stark County",3,18,4462,2317,2145
050,39,151,"Ohio","Stark County",3,19,4146,2078,2068
050,39,151,"Ohio","Stark County",3,20,4412,2218,2194
050,39,151,"Ohio","Stark County",3,21,4483,2249,2234
050,39,151,"Ohio","Stark County",3,22,4515,2271,2244
050,39,151,"Ohio","Stark County",3,23,4472,2243,2229
050,39,151,"Ohio","Stark County",3,24,4358,2194,2164
050,39,151,"Ohio","Stark County",3,25,4327,2205,2122
050,39,151,"Ohio","Stark County",3,26,4390,2210,2180
050,39,151,"Ohio","Stark County",3,27,4440,2219,2221
050,39,151,"Ohio","Stark County",3,28,4632,2331,2301
050,39,151,"Ohio","Stark County",3,29,4725,2319,2406
050,39,151,"Ohio","Stark County",3,30,4845,2398,2447
050,39,151,"Ohio","Stark County",3,31,4828,2381,2447
050,39,151,"Ohio","Stark County",3,32,4621,2278,2343
050,39,151,"Ohio","Stark County",3,33,4421,2168,2253
050,39,151,"Ohio","Stark County",3,34,4302,2154,2148
050,39,151,"Ohio","Stark County",3,35,4369,2213,2156
050,39,151,"Ohio","Stark County",3,36,4429,2233,2196
050,39,151,"Ohio","Stark County",3,37,4333,2152,2181
050,39,151,"Ohio","Stark County",3,38,4460,2227,2233
050,39,151,"Ohio","Stark County",3,39,4575,2298,2277
050,39,151,"Ohio","Stark County",3,40,4588,2280,2308
050,39,151,"Ohio","Stark County",3,41,4495,2176,2319
050,39,151,"Ohio","Stark County",3,42,4368,2147,2221
050,39,151,"Ohio","Stark County",3,43,4258,2121,2137
050,39,151,"Ohio","Stark County",3,44,4175,2084,2091
050,39,151,"Ohio","Stark County",3,45,3978,1968,2010
050,39,151,"Ohio","Stark County",3,46,4036,1974,2062
050,39,151,"Ohio","Stark County",3,47,4045,1982,2063
050,39,151,"Ohio","Stark County",3,48,4164,2016,2148
050,39,151,"Ohio","Stark County",3,49,4595,2248,2347
050,39,151,"Ohio","Stark County",3,50,5015,2518,2497
050,39,151,"Ohio","Stark County",3,51,4955,2493,2462
050,39,151,"Ohio","Stark County",3,52,4762,2397,2365
050,39,151,"Ohio","Stark County",3,53,4646,2313,2333
050,39,151,"Ohio","Stark County",3,54,4742,2377,2365
050,39,151,"Ohio","Stark County",3,55,4845,2379,2466
050,39,151,"Ohio","Stark County",3,56,5095,2516,2579
050,39,151,"Ohio","Stark County",3,57,5141,2518,2623
050,39,151,"Ohio","Stark County",3,58,5244,2576,2668
050,39,151,"Ohio","Stark County",3,59,5263,2575,2688
050,39,151,"Ohio","Stark County",3,60,5444,2656,2788
050,39,151,"Ohio","Stark County",3,61,5359,2563,2796
050,39,151,"Ohio","Stark County",3,62,5338,2554,2784
050,39,151,"Ohio","Stark County",3,63,5450,2606,2844
050,39,151,"Ohio","Stark County",3,64,5400,2618,2782
050,39,151,"Ohio","Stark County",3,65,5124,2489,2635
050,39,151,"Ohio","Stark County",3,66,4987,2396,2591
050,39,151,"Ohio","Stark County",3,67,4862,2266,2596
050,39,151,"Ohio","Stark County",3,68,4700,2206,2494
050,39,151,"Ohio","Stark County",3,69,4515,2133,2382
050,39,151,"Ohio","Stark County",3,70,4275,1994,2281
050,39,151,"Ohio","Stark County",3,71,4140,1959,2181
050,39,151,"Ohio","Stark County",3,72,4064,1915,2149
050,39,151,"Ohio","Stark County",3,73,3961,1812,2149
050,39,151,"Ohio","Stark County",3,74,4167,1930,2237
050,39,151,"Ohio","Stark County",3,75,2767,1265,1502
050,39,151,"Ohio","Stark County",3,76,2603,1169,1434
050,39,151,"Ohio","Stark County",3,77,2576,1140,1436
050,39,151,"Ohio","Stark County",3,78,2670,1184,1486
050,39,151,"Ohio","Stark County",3,79,2332,996,1336
050,39,151,"Ohio","Stark County",3,80,2049,884,1165
050,39,151,"Ohio","Stark County",3,81,1851,765,1086
050,39,151,"Ohio","Stark County",3,82,1715,678,1037
050,39,151,"Ohio","Stark County",3,83,1640,666,974
050,39,151,"Ohio","Stark County",3,84,1450,593,857
050,39,151,"Ohio","Stark County",3,85,8447,2854,5593
050,39,151,"Ohio","Stark County",4,0,3844,1971,1873
050,39,151,"Ohio","Stark County",4,1,3979,1988,1991
050,39,151,"Ohio","Stark County",4,2,4112,2092,2020
050,39,151,"Ohio","Stark County",4,3,4183,2151,2032
050,39,151,"Ohio","Stark County",4,4,4255,2177,2078
050,39,151,"Ohio","Stark County",4,5,4325,2193,2132
050,39,151,"Ohio","Stark County",4,6,4445,2300,2145
050,39,151,"Ohio","Stark County",4,7,4495,2354,2141
050,39,151,"Ohio","Stark County",4,8,4482,2354,2128
050,39,151,"Ohio","Stark County",4,9,4407,2278,2129
050,39,151,"Ohio","Stark County",4,10,4387,2268,2119
050,39,151,"Ohio","Stark County",4,11,4493,2303,2190
050,39,151,"Ohio","Stark County",4,12,4583,2354,2229
050,39,151,"Ohio","Stark County",4,13,4765,2429,2336
050,39,151,"Ohio","Stark County",4,14,5022,2580,2442
050,39,151,"Ohio","Stark County",4,15,4983,2530,2453
050,39,151,"Ohio","Stark County",4,16,4934,2569,2365
050,39,151,"Ohio","Stark County",4,17,4909,2547,2362
050,39,151,"Ohio","Stark County",4,18,4432,2330,2102
050,39,151,"Ohio","Stark County",4,19,4013,2055,1958
050,39,151,"Ohio","Stark County",4,20,4178,2118,2060
050,39,151,"Ohio","Stark County",4,21,4387,2191,2196
050,39,151,"Ohio","Stark County",4,22,4538,2236,2302
050,39,151,"Ohio","Stark County",4,23,4425,2222,2203
050,39,151,"Ohio","Stark County",4,24,4440,2203,2237
050,39,151,"Ohio","Stark County",4,25,4359,2209,2150
050,39,151,"Ohio","Stark County",4,26,4346,2205,2141
050,39,151,"Ohio","Stark County",4,27,4424,2234,2190
050,39,151,"Ohio","Stark County",4,28,4387,2208,2179
050,39,151,"Ohio","Stark County",4,29,4640,2338,2302
050,39,151,"Ohio","Stark County",4,30,4718,2295,2423
050,39,151,"Ohio","Stark County",4,31,4902,2448,2454
050,39,151,"Ohio","Stark County",4,32,4824,2389,2435
050,39,151,"Ohio","Stark County",4,33,4654,2275,2379
050,39,151,"Ohio","Stark County",4,34,4443,2179,2264
050,39,151,"Ohio","Stark County",4,35,4378,2198,2180
050,39,151,"Ohio","Stark County",4,36,4375,2234,2141
050,39,151,"Ohio","Stark County",4,37,4429,2212,2217
050,39,151,"Ohio","Stark County",4,38,4332,2158,2174
050,39,151,"Ohio","Stark County",4,39,4492,2251,2241
050,39,151,"Ohio","Stark County",4,40,4594,2304,2290
050,39,151,"Ohio","Stark County",4,41,4608,2296,2312
050,39,151,"Ohio","Stark County",4,42,4515,2193,2322
050,39,151,"Ohio","Stark County",4,43,4385,2175,2210
050,39,151,"Ohio","Stark County",4,44,4248,2099,2149
050,39,151,"Ohio","Stark County",4,45,4157,2063,2094
050,39,151,"Ohio","Stark County",4,46,3956,1953,2003
050,39,151,"Ohio","Stark County",4,47,4061,1979,2082
050,39,151,"Ohio","Stark County",4,48,4052,1984,2068
050,39,151,"Ohio","Stark County",4,49,4146,2022,2124
050,39,151,"Ohio","Stark County",4,50,4548,2209,2339
050,39,151,"Ohio","Stark County",4,51,4981,2488,2493
050,39,151,"Ohio","Stark County",4,52,4930,2499,2431
050,39,151,"Ohio","Stark County",4,53,4733,2381,2352
050,39,151,"Ohio","Stark County",4,54,4621,2304,2317
050,39,151,"Ohio","Stark County",4,55,4666,2334,2332
050,39,151,"Ohio","Stark County",4,56,4833,2373,2460
050,39,151,"Ohio","Stark County",4,57,5038,2488,2550
050,39,151,"Ohio","Stark County",4,58,5105,2487,2618
050,39,151,"Ohio","Stark County",4,59,5153,2522,2631
050,39,151,"Ohio","Stark County",4,60,5214,2538,2676
050,39,151,"Ohio","Stark County",4,61,5358,2615,2743
050,39,151,"Ohio","Stark County",4,62,5266,2511,2755
050,39,151,"Ohio","Stark County",4,63,5249,2481,2768
050,39,151,"Ohio","Stark County",4,64,5326,2539,2787
050,39,151,"Ohio","Stark County",4,65,5320,2547,2773
050,39,151,"Ohio","Stark County",4,66,5015,2418,2597
050,39,151,"Ohio","Stark County",4,67,4864,2326,2538
050,39,151,"Ohio","Stark County",4,68,4780,2219,2561
050,39,151,"Ohio","Stark County",4,69,4575,2124,2451
050,39,151,"Ohio","Stark County",4,70,4401,2087,2314
050,39,151,"Ohio","Stark County",4,71,4162,1918,2244
050,39,151,"Ohio","Stark County",4,72,4023,1892,2131
050,39,151,"Ohio","Stark County",4,73,3956,1860,2096
050,39,151,"Ohio","Stark County",4,74,3827,1737,2090
050,39,151,"Ohio","Stark County",4,75,4053,1875,2178
050,39,151,"Ohio","Stark County",4,76,2624,1193,1431
050,39,151,"Ohio","Stark County",4,77,2495,1095,1400
050,39,151,"Ohio","Stark County",4,78,2451,1073,1378
050,39,151,"Ohio","Stark County",4,79,2531,1105,1426
050,39,151,"Ohio","Stark County",4,80,2223,955,1268
050,39,151,"Ohio","Stark County",4,81,1945,814,1131
050,39,151,"Ohio","Stark County",4,82,1712,709,1003
050,39,151,"Ohio","Stark County",4,83,1594,618,976
050,39,151,"Ohio","Stark County",4,84,1493,587,906
050,39,151,"Ohio","Stark County",4,85,8279,2827,5452
050,39,151,"Ohio","Stark County",5,0,3906,2005,1901
050,39,151,"Ohio","Stark County",5,1,3858,1974,1884
050,39,151,"Ohio","Stark County",5,2,4029,2007,2022
050,39,151,"Ohio","Stark County",5,3,4103,2105,1998
050,39,151,"Ohio","Stark County",5,4,4185,2138,2047
050,39,151,"Ohio","Stark County",5,5,4260,2169,2091
050,39,151,"Ohio","Stark County",5,6,4357,2199,2158
050,39,151,"Ohio","Stark County",5,7,4474,2306,2168
050,39,151,"Ohio","Stark County",5,8,4511,2347,2164
050,39,151,"Ohio","Stark County",5,9,4516,2357,2159
050,39,151,"Ohio","Stark County",5,10,4409,2275,2134
050,39,151,"Ohio","Stark County",5,11,4416,2272,2144
050,39,151,"Ohio","Stark County",5,12,4506,2326,2180
050,39,151,"Ohio","Stark County",5,13,4579,2351,2228
050,39,151,"Ohio","Stark County",5,14,4794,2434,2360
050,39,151,"Ohio","Stark County",5,15,5091,2619,2472
050,39,151,"Ohio","Stark County",5,16,5000,2545,2455
050,39,151,"Ohio","Stark County",5,17,4983,2578,2405
050,39,151,"Ohio","Stark County",5,18,4382,2291,2091
050,39,151,"Ohio","Stark County",5,19,4048,2068,1980
050,39,151,"Ohio","Stark County",5,20,4201,2152,2049
050,39,151,"Ohio","Stark County",5,21,4287,2137,2150
050,39,151,"Ohio","Stark County",5,22,4507,2253,2254
050,39,151,"Ohio","Stark County",5,23,4497,2234,2263
050,39,151,"Ohio","Stark County",5,24,4403,2231,2172
050,39,151,"Ohio","Stark County",5,25,4395,2180,2215
050,39,151,"Ohio","Stark County",5,26,4398,2242,2156
050,39,151,"Ohio","Stark County",5,27,4344,2186,2158
050,39,151,"Ohio","Stark County",5,28,4433,2240,2193
050,39,151,"Ohio","Stark County",5,29,4390,2210,2180
050,39,151,"Ohio","Stark County",5,30,4651,2320,2331
050,39,151,"Ohio","Stark County",5,31,4815,2366,2449
050,39,151,"Ohio","Stark County",5,32,4895,2451,2444
050,39,151,"Ohio","Stark County",5,33,4844,2386,2458
050,39,151,"Ohio","Stark County",5,34,4686,2293,2393
050,39,151,"Ohio","Stark County",5,35,4463,2193,2270
050,39,151,"Ohio","Stark County",5,36,4397,2201,2196
050,39,151,"Ohio","Stark County",5,37,4382,2202,2180
050,39,151,"Ohio","Stark County",5,38,4466,2240,2226
050,39,151,"Ohio","Stark County",5,39,4324,2141,2183
050,39,151,"Ohio","Stark County",5,40,4479,2243,2236
050,39,151,"Ohio","Stark County",5,41,4628,2310,2318
050,39,151,"Ohio","Stark County",5,42,4602,2290,2312
050,39,151,"Ohio","Stark County",5,43,4501,2179,2322
050,39,151,"Ohio","Stark County",5,44,4390,2170,2220
050,39,151,"Ohio","Stark County",5,45,4244,2100,2144
050,39,151,"Ohio","Stark County",5,46,4152,2048,2104
050,39,151,"Ohio","Stark County",5,47,3962,1959,2003
050,39,151,"Ohio","Stark County",5,48,4069,1968,2101
050,39,151,"Ohio","Stark County",5,49,4043,1981,2062
050,39,151,"Ohio","Stark County",5,50,4121,2018,2103
050,39,151,"Ohio","Stark County",5,51,4563,2218,2345
050,39,151,"Ohio","Stark County",5,52,4938,2476,2462
050,39,151,"Ohio","Stark County",5,53,4914,2475,2439
050,39,151,"Ohio","Stark County",5,54,4729,2368,2361
050,39,151,"Ohio","Stark County",5,55,4587,2282,2305
050,39,151,"Ohio","Stark County",5,56,4638,2307,2331
050,39,151,"Ohio","Stark County",5,57,4772,2332,2440
050,39,151,"Ohio","Stark County",5,58,5016,2458,2558
050,39,151,"Ohio","Stark County",5,59,5032,2454,2578
050,39,151,"Ohio","Stark County",5,60,5121,2499,2622
050,39,151,"Ohio","Stark County",5,61,5160,2496,2664
050,39,151,"Ohio","Stark County",5,62,5327,2590,2737
050,39,151,"Ohio","Stark County",5,63,5245,2496,2749
050,39,151,"Ohio","Stark County",5,64,5171,2432,2739
050,39,151,"Ohio","Stark County",5,65,5225,2479,2746
050,39,151,"Ohio","Stark County",5,66,5257,2501,2756
050,39,151,"Ohio","Stark County",5,67,4906,2362,2544
050,39,151,"Ohio","Stark County",5,68,4802,2289,2513
050,39,151,"Ohio","Stark County",5,69,4690,2169,2521
050,39,151,"Ohio","Stark County",5,70,4468,2078,2390
050,39,151,"Ohio","Stark County",5,71,4266,2005,2261
050,39,151,"Ohio","Stark County",5,72,4080,1870,2210
050,39,151,"Ohio","Stark County",5,73,3922,1833,2089
050,39,151,"Ohio","Stark County",5,74,3861,1795,2066
050,39,151,"Ohio","Stark County",5,75,3742,1703,2039
050,39,151,"Ohio","Stark County",5,76,3902,1794,2108
050,39,151,"Ohio","Stark County",5,77,2532,1135,1397
050,39,151,"Ohio","Stark County",5,78,2392,1034,1358
050,39,151,"Ohio","Stark County",5,79,2333,999,1334
050,39,151,"Ohio","Stark County",5,80,2407,1054,1353
050,39,151,"Ohio","Stark County",5,81,2124,889,1235
050,39,151,"Ohio","Stark County",5,82,1809,757,1052
050,39,151,"Ohio","Stark County",5,83,1585,649,936
050,39,151,"Ohio","Stark County",5,84,1476,549,927
050,39,151,"Ohio","Stark County",5,85,8348,2887,5461
050,39,153,"Ohio","Summit County",1,0,5748,2933,2815
050,39,153,"Ohio","Summit County",1,1,5825,2923,2902
050,39,153,"Ohio","Summit County",1,2,5977,2972,3005
050,39,153,"Ohio","Summit County",1,3,6106,3108,2998
050,39,153,"Ohio","Summit County",1,4,6238,3134,3104
050,39,153,"Ohio","Summit County",1,5,6157,3105,3052
050,39,153,"Ohio","Summit County",1,6,6284,3184,3100
050,39,153,"Ohio","Summit County",1,7,6239,3185,3054
050,39,153,"Ohio","Summit County",1,8,6159,3179,2980
050,39,153,"Ohio","Summit County",1,9,6145,3188,2957
050,39,153,"Ohio","Summit County",1,10,6392,3238,3154
050,39,153,"Ohio","Summit County",1,11,6474,3251,3223
050,39,153,"Ohio","Summit County",1,12,6697,3397,3300
050,39,153,"Ohio","Summit County",1,13,6718,3426,3292
050,39,153,"Ohio","Summit County",1,14,6544,3336,3208
050,39,153,"Ohio","Summit County",1,15,6579,3362,3217
050,39,153,"Ohio","Summit County",1,16,6725,3402,3323
050,39,153,"Ohio","Summit County",1,17,6685,3400,3285
050,39,153,"Ohio","Summit County",1,18,6347,3282,3065
050,39,153,"Ohio","Summit County",1,19,5896,3107,2789
050,39,153,"Ohio","Summit County",1,20,5675,2906,2769
050,39,153,"Ohio","Summit County",1,21,5984,3013,2971
050,39,153,"Ohio","Summit County",1,22,6431,3219,3212
050,39,153,"Ohio","Summit County",1,23,6788,3410,3378
050,39,153,"Ohio","Summit County",1,24,6975,3514,3461
050,39,153,"Ohio","Summit County",1,25,7044,3578,3466
050,39,153,"Ohio","Summit County",1,26,7225,3606,3619
050,39,153,"Ohio","Summit County",1,27,7340,3685,3655
050,39,153,"Ohio","Summit County",1,28,7476,3735,3741
050,39,153,"Ohio","Summit County",1,29,7505,3715,3790
050,39,153,"Ohio","Summit County",1,30,7401,3714,3687
050,39,153,"Ohio","Summit County",1,31,7305,3562,3743
050,39,153,"Ohio","Summit County",1,32,7043,3494,3549
050,39,153,"Ohio","Summit County",1,33,6912,3448,3464
050,39,153,"Ohio","Summit County",1,34,6854,3432,3422
050,39,153,"Ohio","Summit County",1,35,6749,3334,3415
050,39,153,"Ohio","Summit County",1,36,6618,3255,3363
050,39,153,"Ohio","Summit County",1,37,6711,3289,3422
050,39,153,"Ohio","Summit County",1,38,6599,3259,3340
050,39,153,"Ohio","Summit County",1,39,6687,3335,3352
050,39,153,"Ohio","Summit County",1,40,6575,3252,3323
050,39,153,"Ohio","Summit County",1,41,6415,3175,3240
050,39,153,"Ohio","Summit County",1,42,6398,3171,3227
050,39,153,"Ohio","Summit County",1,43,6099,3013,3086
050,39,153,"Ohio","Summit County",1,44,5973,2934,3039
050,39,153,"Ohio","Summit County",1,45,6092,3040,3052
050,39,153,"Ohio","Summit County",1,46,5974,2960,3014
050,39,153,"Ohio","Summit County",1,47,6219,3104,3115
050,39,153,"Ohio","Summit County",1,48,6770,3349,3421
050,39,153,"Ohio","Summit County",1,49,7524,3691,3833
050,39,153,"Ohio","Summit County",1,50,7266,3557,3709
050,39,153,"Ohio","Summit County",1,51,7045,3470,3575
050,39,153,"Ohio","Summit County",1,52,6943,3442,3501
050,39,153,"Ohio","Summit County",1,53,7120,3545,3575
050,39,153,"Ohio","Summit County",1,54,7253,3541,3712
050,39,153,"Ohio","Summit County",1,55,7601,3679,3922
050,39,153,"Ohio","Summit County",1,56,7723,3757,3966
050,39,153,"Ohio","Summit County",1,57,7744,3759,3985
050,39,153,"Ohio","Summit County",1,58,7990,3905,4085
050,39,153,"Ohio","Summit County",1,59,7888,3818,4070
050,39,153,"Ohio","Summit County",1,60,7823,3780,4043
050,39,153,"Ohio","Summit County",1,61,8031,3912,4119
050,39,153,"Ohio","Summit County",1,62,8019,3918,4101
050,39,153,"Ohio","Summit County",1,63,7795,3674,4121
050,39,153,"Ohio","Summit County",1,64,7498,3547,3951
050,39,153,"Ohio","Summit County",1,65,7271,3451,3820
050,39,153,"Ohio","Summit County",1,66,6933,3282,3651
050,39,153,"Ohio","Summit County",1,67,6646,3163,3483
050,39,153,"Ohio","Summit County",1,68,6494,3087,3407
050,39,153,"Ohio","Summit County",1,69,5884,2777,3107
050,39,153,"Ohio","Summit County",1,70,5749,2669,3080
050,39,153,"Ohio","Summit County",1,71,5749,2618,3131
050,39,153,"Ohio","Summit County",1,72,5827,2676,3151
050,39,153,"Ohio","Summit County",1,73,5662,2627,3035
050,39,153,"Ohio","Summit County",1,74,3731,1666,2065
050,39,153,"Ohio","Summit County",1,75,3567,1578,1989
050,39,153,"Ohio","Summit County",1,76,3574,1608,1966
050,39,153,"Ohio","Summit County",1,77,3694,1637,2057
050,39,153,"Ohio","Summit County",1,78,3018,1290,1728
050,39,153,"Ohio","Summit County",1,79,2605,1090,1515
050,39,153,"Ohio","Summit County",1,80,2449,1032,1417
050,39,153,"Ohio","Summit County",1,81,2427,1011,1416
050,39,153,"Ohio","Summit County",1,82,2298,942,1356
050,39,153,"Ohio","Summit County",1,83,2051,802,1249
050,39,153,"Ohio","Summit County",1,84,1913,770,1143
050,39,153,"Ohio","Summit County",1,85,11852,4055,7797
050,39,153,"Ohio","Summit County",2,0,5686,2891,2795
050,39,153,"Ohio","Summit County",2,1,5794,2917,2877
050,39,153,"Ohio","Summit County",2,2,5941,2965,2976
050,39,153,"Ohio","Summit County",2,3,6064,3073,2991
050,39,153,"Ohio","Summit County",2,4,6218,3135,3083
050,39,153,"Ohio","Summit County",2,5,6185,3117,3068
050,39,153,"Ohio","Summit County",2,6,6260,3167,3093
050,39,153,"Ohio","Summit County",2,7,6246,3185,3061
050,39,153,"Ohio","Summit County",2,8,6160,3170,2990
050,39,153,"Ohio","Summit County",2,9,6140,3179,2961
050,39,153,"Ohio","Summit County",2,10,6329,3221,3108
050,39,153,"Ohio","Summit County",2,11,6435,3240,3195
050,39,153,"Ohio","Summit County",2,12,6668,3372,3296
050,39,153,"Ohio","Summit County",2,13,6710,3417,3293
050,39,153,"Ohio","Summit County",2,14,6578,3356,3222
050,39,153,"Ohio","Summit County",2,15,6581,3358,3223
050,39,153,"Ohio","Summit County",2,16,6697,3395,3302
050,39,153,"Ohio","Summit County",2,17,6684,3392,3292
050,39,153,"Ohio","Summit County",2,18,6280,3249,3031
050,39,153,"Ohio","Summit County",2,19,5895,3097,2798
050,39,153,"Ohio","Summit County",2,20,5755,2947,2808
050,39,153,"Ohio","Summit County",2,21,5952,3003,2949
050,39,153,"Ohio","Summit County",2,22,6407,3194,3213
050,39,153,"Ohio","Summit County",2,23,6767,3382,3385
050,39,153,"Ohio","Summit County",2,24,6928,3490,3438
050,39,153,"Ohio","Summit County",2,25,7046,3573,3473
050,39,153,"Ohio","Summit County",2,26,7180,3599,3581
050,39,153,"Ohio","Summit County",2,27,7297,3662,3635
050,39,153,"Ohio","Summit County",2,28,7421,3717,3704
050,39,153,"Ohio","Summit County",2,29,7483,3715,3768
050,39,153,"Ohio","Summit County",2,30,7439,3705,3734
050,39,153,"Ohio","Summit County",2,31,7309,3591,3718
050,39,153,"Ohio","Summit County",2,32,7083,3484,3599
050,39,153,"Ohio","Summit County",2,33,6939,3457,3482
050,39,153,"Ohio","Summit County",2,34,6867,3429,3438
050,39,153,"Ohio","Summit County",2,35,6820,3380,3440
050,39,153,"Ohio","Summit County",2,36,6607,3254,3353
050,39,153,"Ohio","Summit County",2,37,6688,3281,3407
050,39,153,"Ohio","Summit County",2,38,6648,3274,3374
050,39,153,"Ohio","Summit County",2,39,6637,3300,3337
050,39,153,"Ohio","Summit County",2,40,6637,3294,3343
050,39,153,"Ohio","Summit County",2,41,6437,3183,3254
050,39,153,"Ohio","Summit County",2,42,6365,3161,3204
050,39,153,"Ohio","Summit County",2,43,6206,3069,3137
050,39,153,"Ohio","Summit County",2,44,5949,2927,3022
050,39,153,"Ohio","Summit County",2,45,6096,3030,3066
050,39,153,"Ohio","Summit County",2,46,5973,2968,3005
050,39,153,"Ohio","Summit County",2,47,6133,3057,3076
050,39,153,"Ohio","Summit County",2,48,6626,3285,3341
050,39,153,"Ohio","Summit County",2,49,7364,3617,3747
050,39,153,"Ohio","Summit County",2,50,7326,3591,3735
050,39,153,"Ohio","Summit County",2,51,7061,3473,3588
050,39,153,"Ohio","Summit County",2,52,6940,3434,3506
050,39,153,"Ohio","Summit County",2,53,7069,3514,3555
050,39,153,"Ohio","Summit County",2,54,7200,3529,3671
050,39,153,"Ohio","Summit County",2,55,7491,3633,3858
050,39,153,"Ohio","Summit County",2,56,7680,3728,3952
050,39,153,"Ohio","Summit County",2,57,7728,3749,3979
050,39,153,"Ohio","Summit County",2,58,7895,3850,4045
050,39,153,"Ohio","Summit County",2,59,7925,3846,4079
050,39,153,"Ohio","Summit County",2,60,7798,3763,4035
050,39,153,"Ohio","Summit County",2,61,7929,3858,4071
050,39,153,"Ohio","Summit County",2,62,7976,3891,4085
050,39,153,"Ohio","Summit County",2,63,7877,3735,4142
050,39,153,"Ohio","Summit County",2,64,7480,3531,3949
050,39,153,"Ohio","Summit County",2,65,7280,3453,3827
050,39,153,"Ohio","Summit County",2,66,6999,3319,3680
050,39,153,"Ohio","Summit County",2,67,6675,3172,3503
050,39,153,"Ohio","Summit County",2,68,6464,3072,3392
050,39,153,"Ohio","Summit County",2,69,6036,2848,3188
050,39,153,"Ohio","Summit County",2,70,5728,2674,3054
050,39,153,"Ohio","Summit County",2,71,5713,2606,3107
050,39,153,"Ohio","Summit County",2,72,5680,2600,3080
050,39,153,"Ohio","Summit County",2,73,5939,2748,3191
050,39,153,"Ohio","Summit County",2,74,3929,1766,2163
050,39,153,"Ohio","Summit County",2,75,3582,1585,1997
050,39,153,"Ohio","Summit County",2,76,3514,1574,1940
050,39,153,"Ohio","Summit County",2,77,3706,1642,2064
050,39,153,"Ohio","Summit County",2,78,3085,1328,1757
050,39,153,"Ohio","Summit County",2,79,2668,1118,1550
050,39,153,"Ohio","Summit County",2,80,2451,1029,1422
050,39,153,"Ohio","Summit County",2,81,2381,992,1389
050,39,153,"Ohio","Summit County",2,82,2272,928,1344
050,39,153,"Ohio","Summit County",2,83,2047,808,1239
050,39,153,"Ohio","Summit County",2,84,1899,757,1142
050,39,153,"Ohio","Summit County",2,85,11788,4058,7730
050,39,153,"Ohio","Summit County",3,0,5372,2779,2593
050,39,153,"Ohio","Summit County",3,1,5665,2860,2805
050,39,153,"Ohio","Summit County",3,2,5823,2927,2896
050,39,153,"Ohio","Summit County",3,3,5950,2988,2962
050,39,153,"Ohio","Summit County",3,4,6025,3035,2990
050,39,153,"Ohio","Summit County",3,5,6236,3135,3101
050,39,153,"Ohio","Summit County",3,6,6171,3117,3054
050,39,153,"Ohio","Summit County",3,7,6257,3151,3106
050,39,153,"Ohio","Summit County",3,8,6208,3156,3052
050,39,153,"Ohio","Summit County",3,9,6151,3142,3009
050,39,153,"Ohio","Summit County",3,10,6110,3176,2934
050,39,153,"Ohio","Summit County",3,11,6322,3213,3109
050,39,153,"Ohio","Summit County",3,12,6438,3234,3204
050,39,153,"Ohio","Summit County",3,13,6646,3384,3262
050,39,153,"Ohio","Summit County",3,14,6697,3391,3306
050,39,153,"Ohio","Summit County",3,15,6634,3372,3262
050,39,153,"Ohio","Summit County",3,16,6566,3352,3214
050,39,153,"Ohio","Summit County",3,17,6698,3372,3326
050,39,153,"Ohio","Summit County",3,18,6020,3130,2890
050,39,153,"Ohio","Summit County",3,19,5373,2795,2578
050,39,153,"Ohio","Summit County",3,20,5627,2887,2740
050,39,153,"Ohio","Summit County",3,21,5931,3004,2927
050,39,153,"Ohio","Summit County",3,22,6316,3169,3147
050,39,153,"Ohio","Summit County",3,23,6712,3347,3365
050,39,153,"Ohio","Summit County",3,24,6935,3520,3415
050,39,153,"Ohio","Summit County",3,25,7008,3485,3523
050,39,153,"Ohio","Summit County",3,26,7109,3602,3507
050,39,153,"Ohio","Summit County",3,27,7237,3575,3662
050,39,153,"Ohio","Summit County",3,28,7271,3639,3632
050,39,153,"Ohio","Summit County",3,29,7440,3724,3716
050,39,153,"Ohio","Summit County",3,30,7443,3650,3793
050,39,153,"Ohio","Summit County",3,31,7430,3684,3746
050,39,153,"Ohio","Summit County",3,32,7262,3574,3688
050,39,153,"Ohio","Summit County",3,33,6998,3428,3570
050,39,153,"Ohio","Summit County",3,34,6930,3448,3482
050,39,153,"Ohio","Summit County",3,35,6843,3415,3428
050,39,153,"Ohio","Summit County",3,36,6789,3373,3416
050,39,153,"Ohio","Summit County",3,37,6630,3269,3361
050,39,153,"Ohio","Summit County",3,38,6656,3281,3375
050,39,153,"Ohio","Summit County",3,39,6681,3305,3376
050,39,153,"Ohio","Summit County",3,40,6597,3285,3312
050,39,153,"Ohio","Summit County",3,41,6578,3246,3332
050,39,153,"Ohio","Summit County",3,42,6425,3180,3245
050,39,153,"Ohio","Summit County",3,43,6327,3112,3215
050,39,153,"Ohio","Summit County",3,44,6158,3032,3126
050,39,153,"Ohio","Summit County",3,45,5989,2958,3031
050,39,153,"Ohio","Summit County",3,46,6084,3014,3070
050,39,153,"Ohio","Summit County",3,47,5955,2947,3008
050,39,153,"Ohio","Summit County",3,48,6106,3042,3064
050,39,153,"Ohio","Summit County",3,49,6569,3225,3344
050,39,153,"Ohio","Summit County",3,50,7320,3618,3702
050,39,153,"Ohio","Summit County",3,51,7267,3565,3702
050,39,153,"Ohio","Summit County",3,52,7034,3444,3590
050,39,153,"Ohio","Summit County",3,53,6892,3402,3490
050,39,153,"Ohio","Summit County",3,54,7064,3503,3561
050,39,153,"Ohio","Summit County",3,55,7174,3503,3671
050,39,153,"Ohio","Summit County",3,56,7391,3580,3811
050,39,153,"Ohio","Summit County",3,57,7670,3727,3943
050,39,153,"Ohio","Summit County",3,58,7602,3689,3913
050,39,153,"Ohio","Summit County",3,59,7774,3778,3996
050,39,153,"Ohio","Summit County",3,60,7817,3741,4076
050,39,153,"Ohio","Summit County",3,61,7655,3701,3954
050,39,153,"Ohio","Summit County",3,62,7774,3778,3996
050,39,153,"Ohio","Summit County",3,63,7826,3792,4034
050,39,153,"Ohio","Summit County",3,64,7723,3656,4067
050,39,153,"Ohio","Summit County",3,65,7290,3420,3870
050,39,153,"Ohio","Summit County",3,66,7148,3382,3766
050,39,153,"Ohio","Summit County",3,67,6849,3224,3625
050,39,153,"Ohio","Summit County",3,68,6579,3110,3469
050,39,153,"Ohio","Summit County",3,69,6302,2984,3318
050,39,153,"Ohio","Summit County",3,70,5907,2763,3144
050,39,153,"Ohio","Summit County",3,71,5590,2572,3018
050,39,153,"Ohio","Summit County",3,72,5580,2536,3044
050,39,153,"Ohio","Summit County",3,73,5486,2503,2983
050,39,153,"Ohio","Summit County",3,74,5782,2636,3146
050,39,153,"Ohio","Summit County",3,75,3788,1698,2090
050,39,153,"Ohio","Summit County",3,76,3409,1506,1903
050,39,153,"Ohio","Summit County",3,77,3406,1503,1903
050,39,153,"Ohio","Summit County",3,78,3506,1532,1974
050,39,153,"Ohio","Summit County",3,79,2944,1243,1701
050,39,153,"Ohio","Summit County",3,80,2496,1040,1456
050,39,153,"Ohio","Summit County",3,81,2325,959,1366
050,39,153,"Ohio","Summit County",3,82,2195,882,1313
050,39,153,"Ohio","Summit County",3,83,2086,839,1247
050,39,153,"Ohio","Summit County",3,84,1927,738,1189
050,39,153,"Ohio","Summit County",3,85,11460,3943,7517
050,39,153,"Ohio","Summit County",4,0,5443,2783,2660
050,39,153,"Ohio","Summit County",4,1,5372,2803,2569
050,39,153,"Ohio","Summit County",4,2,5657,2863,2794
050,39,153,"Ohio","Summit County",4,3,5829,2918,2911
050,39,153,"Ohio","Summit County",4,4,5960,2982,2978
050,39,153,"Ohio","Summit County",4,5,6038,3056,2982
050,39,153,"Ohio","Summit County",4,6,6261,3128,3133
050,39,153,"Ohio","Summit County",4,7,6135,3101,3034
050,39,153,"Ohio","Summit County",4,8,6291,3163,3128
050,39,153,"Ohio","Summit County",4,9,6212,3144,3068
050,39,153,"Ohio","Summit County",4,10,6136,3147,2989
050,39,153,"Ohio","Summit County",4,11,6090,3147,2943
050,39,153,"Ohio","Summit County",4,12,6330,3217,3113
050,39,153,"Ohio","Summit County",4,13,6410,3212,3198
050,39,153,"Ohio","Summit County",4,14,6678,3391,3287
050,39,153,"Ohio","Summit County",4,15,6697,3412,3285
050,39,153,"Ohio","Summit County",4,16,6608,3360,3248
050,39,153,"Ohio","Summit County",4,17,6524,3328,3196
050,39,153,"Ohio","Summit County",4,18,6141,3159,2982
050,39,153,"Ohio","Summit County",4,19,5508,2878,2630
050,39,153,"Ohio","Summit County",4,20,5502,2790,2712
050,39,153,"Ohio","Summit County",4,21,5927,2988,2939
050,39,153,"Ohio","Summit County",4,22,6275,3139,3136
050,39,153,"Ohio","Summit County",4,23,6593,3311,3282
050,39,153,"Ohio","Summit County",4,24,6827,3409,3418
050,39,153,"Ohio","Summit County",4,25,6986,3554,3432
050,39,153,"Ohio","Summit County",4,26,7046,3558,3488
050,39,153,"Ohio","Summit County",4,27,7079,3540,3539
050,39,153,"Ohio","Summit County",4,28,7176,3567,3609
050,39,153,"Ohio","Summit County",4,29,7215,3607,3608
050,39,153,"Ohio","Summit County",4,30,7455,3679,3776
050,39,153,"Ohio","Summit County",4,31,7422,3631,3791
050,39,153,"Ohio","Summit County",4,32,7446,3707,3739
050,39,153,"Ohio","Summit County",4,33,7270,3593,3677
050,39,153,"Ohio","Summit County",4,34,7004,3416,3588
050,39,153,"Ohio","Summit County",4,35,6893,3443,3450
050,39,153,"Ohio","Summit County",4,36,6807,3372,3435
050,39,153,"Ohio","Summit County",4,37,6752,3358,3394
050,39,153,"Ohio","Summit County",4,38,6618,3245,3373
050,39,153,"Ohio","Summit County",4,39,6622,3263,3359
050,39,153,"Ohio","Summit County",4,40,6687,3306,3381
050,39,153,"Ohio","Summit County",4,41,6518,3240,3278
050,39,153,"Ohio","Summit County",4,42,6548,3245,3303
050,39,153,"Ohio","Summit County",4,43,6388,3174,3214
050,39,153,"Ohio","Summit County",4,44,6277,3078,3199
050,39,153,"Ohio","Summit County",4,45,6192,3041,3151
050,39,153,"Ohio","Summit County",4,46,5990,2947,3043
050,39,153,"Ohio","Summit County",4,47,6072,2991,3081
050,39,153,"Ohio","Summit County",4,48,5911,2927,2984
050,39,153,"Ohio","Summit County",4,49,6109,3039,3070
050,39,153,"Ohio","Summit County",4,50,6552,3230,3322
050,39,153,"Ohio","Summit County",4,51,7318,3627,3691
050,39,153,"Ohio","Summit County",4,52,7230,3547,3683
050,39,153,"Ohio","Summit County",4,53,6993,3424,3569
050,39,153,"Ohio","Summit County",4,54,6807,3343,3464
050,39,153,"Ohio","Summit County",4,55,7013,3463,3550
050,39,153,"Ohio","Summit County",4,56,7091,3457,3634
050,39,153,"Ohio","Summit County",4,57,7355,3549,3806
050,39,153,"Ohio","Summit County",4,58,7548,3632,3916
050,39,153,"Ohio","Summit County",4,59,7450,3639,3811
050,39,153,"Ohio","Summit County",4,60,7688,3688,4000
050,39,153,"Ohio","Summit County",4,61,7645,3665,3980
050,39,153,"Ohio","Summit County",4,62,7486,3605,3881
050,39,153,"Ohio","Summit County",4,63,7676,3720,3956
050,39,153,"Ohio","Summit County",4,64,7645,3697,3948
050,39,153,"Ohio","Summit County",4,65,7514,3542,3972
050,39,153,"Ohio","Summit County",4,66,7143,3331,3812
050,39,153,"Ohio","Summit County",4,67,6992,3285,3707
050,39,153,"Ohio","Summit County",4,68,6661,3112,3549
050,39,153,"Ohio","Summit County",4,69,6392,2995,3397
050,39,153,"Ohio","Summit County",4,70,6177,2905,3272
050,39,153,"Ohio","Summit County",4,71,5758,2670,3088
050,39,153,"Ohio","Summit County",4,72,5459,2495,2964
050,39,153,"Ohio","Summit County",4,73,5378,2456,2922
050,39,153,"Ohio","Summit County",4,74,5298,2383,2915
050,39,153,"Ohio","Summit County",4,75,5623,2551,3072
050,39,153,"Ohio","Summit County",4,76,3683,1645,2038
050,39,153,"Ohio","Summit County",4,77,3274,1440,1834
050,39,153,"Ohio","Summit County",4,78,3253,1428,1825
050,39,153,"Ohio","Summit County",4,79,3341,1436,1905
050,39,153,"Ohio","Summit County",4,80,2766,1158,1608
050,39,153,"Ohio","Summit County",4,81,2362,975,1387
050,39,153,"Ohio","Summit County",4,82,2132,869,1263
050,39,153,"Ohio","Summit County",4,83,2006,780,1226
050,39,153,"Ohio","Summit County",4,84,1960,775,1185
050,39,153,"Ohio","Summit County",4,85,11173,3836,7337
050,39,153,"Ohio","Summit County",5,0,5404,2773,2631
050,39,153,"Ohio","Summit County",5,1,5482,2834,2648
050,39,153,"Ohio","Summit County",5,2,5390,2827,2563
050,39,153,"Ohio","Summit County",5,3,5781,2905,2876
050,39,153,"Ohio","Summit County",5,4,5879,2926,2953
050,39,153,"Ohio","Summit County",5,5,5968,2985,2983
050,39,153,"Ohio","Summit County",5,6,6014,3020,2994
050,39,153,"Ohio","Summit County",5,7,6295,3133,3162
050,39,153,"Ohio","Summit County",5,8,6175,3139,3036
050,39,153,"Ohio","Summit County",5,9,6273,3148,3125
050,39,153,"Ohio","Summit County",5,10,6238,3156,3082
050,39,153,"Ohio","Summit County",5,11,6110,3129,2981
050,39,153,"Ohio","Summit County",5,12,6127,3176,2951
050,39,153,"Ohio","Summit County",5,13,6338,3222,3116
050,39,153,"Ohio","Summit County",5,14,6457,3214,3243
050,39,153,"Ohio","Summit County",5,15,6692,3406,3286
050,39,153,"Ohio","Summit County",5,16,6737,3425,3312
050,39,153,"Ohio","Summit County",5,17,6606,3331,3275
050,39,153,"Ohio","Summit County",5,18,5977,3103,2874
050,39,153,"Ohio","Summit County",5,19,5468,2851,2617
050,39,153,"Ohio","Summit County",5,20,5307,2693,2614
050,39,153,"Ohio","Summit County",5,21,5719,2859,2860
050,39,153,"Ohio","Summit County",5,22,6358,3168,3190
050,39,153,"Ohio","Summit County",5,23,6575,3299,3276
050,39,153,"Ohio","Summit County",5,24,6743,3339,3404
050,39,153,"Ohio","Summit County",5,25,6943,3472,3471
050,39,153,"Ohio","Summit County",5,26,7024,3568,3456
050,39,153,"Ohio","Summit County",5,27,7165,3615,3550
050,39,153,"Ohio","Summit County",5,28,7141,3569,3572
050,39,153,"Ohio","Summit County",5,29,7233,3615,3618
050,39,153,"Ohio","Summit County",5,30,7276,3650,3626
050,39,153,"Ohio","Summit County",5,31,7462,3677,3785
050,39,153,"Ohio","Summit County",5,32,7440,3635,3805
050,39,153,"Ohio","Summit County",5,33,7450,3682,3768
050,39,153,"Ohio","Summit County",5,34,7296,3602,3694
050,39,153,"Ohio","Summit County",5,35,6992,3399,3593
050,39,153,"Ohio","Summit County",5,36,6937,3456,3481
050,39,153,"Ohio","Summit County",5,37,6850,3398,3452
050,39,153,"Ohio","Summit County",5,38,6784,3366,3418
050,39,153,"Ohio","Summit County",5,39,6579,3230,3349
050,39,153,"Ohio","Summit County",5,40,6648,3281,3367
050,39,153,"Ohio","Summit County",5,41,6641,3266,3375
050,39,153,"Ohio","Summit County",5,42,6541,3262,3279
050,39,153,"Ohio","Summit County",5,43,6517,3233,3284
050,39,153,"Ohio","Summit County",5,44,6406,3174,3232
050,39,153,"Ohio","Summit County",5,45,6257,3055,3202
050,39,153,"Ohio","Summit County",5,46,6178,3036,3142
050,39,153,"Ohio","Summit County",5,47,5955,2930,3025
050,39,153,"Ohio","Summit County",5,48,6034,2970,3064
050,39,153,"Ohio","Summit County",5,49,5901,2904,2997
050,39,153,"Ohio","Summit County",5,50,6089,3014,3075
050,39,153,"Ohio","Summit County",5,51,6515,3233,3282
050,39,153,"Ohio","Summit County",5,52,7277,3613,3664
050,39,153,"Ohio","Summit County",5,53,7201,3539,3662
050,39,153,"Ohio","Summit County",5,54,6942,3386,3556
050,39,153,"Ohio","Summit County",5,55,6732,3297,3435
050,39,153,"Ohio","Summit County",5,56,6927,3420,3507
050,39,153,"Ohio","Summit County",5,57,7062,3451,3611
050,39,153,"Ohio","Summit County",5,58,7290,3512,3778
050,39,153,"Ohio","Summit County",5,59,7483,3602,3881
050,39,153,"Ohio","Summit County",5,60,7368,3555,3813
050,39,153,"Ohio","Summit County",5,61,7558,3625,3933
050,39,153,"Ohio","Summit County",5,62,7494,3575,3919
050,39,153,"Ohio","Summit County",5,63,7424,3544,3880
050,39,153,"Ohio","Summit County",5,64,7548,3647,3901
050,39,153,"Ohio","Summit County",5,65,7521,3635,3886
050,39,153,"Ohio","Summit County",5,66,7369,3468,3901
050,39,153,"Ohio","Summit County",5,67,6992,3244,3748
050,39,153,"Ohio","Summit County",5,68,6854,3209,3645
050,39,153,"Ohio","Summit County",5,69,6530,3033,3497
050,39,153,"Ohio","Summit County",5,70,6249,2924,3325
050,39,153,"Ohio","Summit County",5,71,6070,2816,3254
050,39,153,"Ohio","Summit County",5,72,5603,2586,3017
050,39,153,"Ohio","Summit County",5,73,5282,2418,2864
050,39,153,"Ohio","Summit County",5,74,5203,2350,2853
050,39,153,"Ohio","Summit County",5,75,5139,2305,2834
050,39,153,"Ohio","Summit County",5,76,5434,2468,2966
050,39,153,"Ohio","Summit County",5,77,3564,1583,1981
050,39,153,"Ohio","Summit County",5,78,3146,1382,1764
050,39,153,"Ohio","Summit County",5,79,3122,1348,1774
050,39,153,"Ohio","Summit County",5,80,3172,1350,1822
050,39,153,"Ohio","Summit County",5,81,2637,1079,1558
050,39,153,"Ohio","Summit County",5,82,2190,889,1301
050,39,153,"Ohio","Summit County",5,83,1972,785,1187
050,39,153,"Ohio","Summit County",5,84,1888,727,1161
050,39,153,"Ohio","Summit County",5,85,11123,3866,7257
050,39,155,"Ohio","Trumbull County",1,0,2100,1069,1031
050,39,155,"Ohio","Trumbull County",1,1,2131,1117,1014
050,39,155,"Ohio","Trumbull County",1,2,2143,1115,1028
050,39,155,"Ohio","Trumbull County",1,3,2144,1086,1058
050,39,155,"Ohio","Trumbull County",1,4,2225,1149,1076
050,39,155,"Ohio","Trumbull County",1,5,2210,1143,1067
050,39,155,"Ohio","Trumbull County",1,6,2224,1150,1074
050,39,155,"Ohio","Trumbull County",1,7,2169,1109,1060
050,39,155,"Ohio","Trumbull County",1,8,2184,1101,1083
050,39,155,"Ohio","Trumbull County",1,9,2176,1109,1067
050,39,155,"Ohio","Trumbull County",1,10,2332,1196,1136
050,39,155,"Ohio","Trumbull County",1,11,2469,1265,1204
050,39,155,"Ohio","Trumbull County",1,12,2485,1244,1241
050,39,155,"Ohio","Trumbull County",1,13,2559,1298,1261
050,39,155,"Ohio","Trumbull County",1,14,2548,1307,1241
050,39,155,"Ohio","Trumbull County",1,15,2514,1299,1215
050,39,155,"Ohio","Trumbull County",1,16,2547,1307,1240
050,39,155,"Ohio","Trumbull County",1,17,2549,1288,1261
050,39,155,"Ohio","Trumbull County",1,18,2222,1174,1048
050,39,155,"Ohio","Trumbull County",1,19,1855,1013,842
050,39,155,"Ohio","Trumbull County",1,20,2048,1069,979
050,39,155,"Ohio","Trumbull County",1,21,2123,1085,1038
050,39,155,"Ohio","Trumbull County",1,22,2263,1146,1117
050,39,155,"Ohio","Trumbull County",1,23,2390,1199,1191
050,39,155,"Ohio","Trumbull County",1,24,2387,1218,1169
050,39,155,"Ohio","Trumbull County",1,25,2477,1272,1205
050,39,155,"Ohio","Trumbull County",1,26,2466,1275,1191
050,39,155,"Ohio","Trumbull County",1,27,2439,1255,1184
050,39,155,"Ohio","Trumbull County",1,28,2513,1247,1266
050,39,155,"Ohio","Trumbull County",1,29,2527,1279,1248
050,39,155,"Ohio","Trumbull County",1,30,2375,1190,1185
050,39,155,"Ohio","Trumbull County",1,31,2312,1195,1117
050,39,155,"Ohio","Trumbull County",1,32,2248,1163,1085
050,39,155,"Ohio","Trumbull County",1,33,2188,1127,1061
050,39,155,"Ohio","Trumbull County",1,34,2227,1142,1085
050,39,155,"Ohio","Trumbull County",1,35,2178,1076,1102
050,39,155,"Ohio","Trumbull County",1,36,2122,1041,1081
050,39,155,"Ohio","Trumbull County",1,37,2204,1083,1121
050,39,155,"Ohio","Trumbull County",1,38,2184,1092,1092
050,39,155,"Ohio","Trumbull County",1,39,2269,1110,1159
050,39,155,"Ohio","Trumbull County",1,40,2250,1122,1128
050,39,155,"Ohio","Trumbull County",1,41,2223,1142,1081
050,39,155,"Ohio","Trumbull County",1,42,2196,1109,1087
050,39,155,"Ohio","Trumbull County",1,43,2140,1067,1073
050,39,155,"Ohio","Trumbull County",1,44,2225,1106,1119
050,39,155,"Ohio","Trumbull County",1,45,2313,1154,1159
050,39,155,"Ohio","Trumbull County",1,46,2219,1110,1109
050,39,155,"Ohio","Trumbull County",1,47,2356,1168,1188
050,39,155,"Ohio","Trumbull County",1,48,2536,1276,1260
050,39,155,"Ohio","Trumbull County",1,49,2666,1312,1354
050,39,155,"Ohio","Trumbull County",1,50,2610,1294,1316
050,39,155,"Ohio","Trumbull County",1,51,2610,1288,1322
050,39,155,"Ohio","Trumbull County",1,52,2597,1293,1304
050,39,155,"Ohio","Trumbull County",1,53,2681,1350,1331
050,39,155,"Ohio","Trumbull County",1,54,2656,1305,1351
050,39,155,"Ohio","Trumbull County",1,55,2828,1387,1441
050,39,155,"Ohio","Trumbull County",1,56,2890,1399,1491
050,39,155,"Ohio","Trumbull County",1,57,2937,1401,1536
050,39,155,"Ohio","Trumbull County",1,58,2981,1418,1563
050,39,155,"Ohio","Trumbull County",1,59,3083,1509,1574
050,39,155,"Ohio","Trumbull County",1,60,3103,1511,1592
050,39,155,"Ohio","Trumbull County",1,61,3179,1561,1618
050,39,155,"Ohio","Trumbull County",1,62,3201,1570,1631
050,39,155,"Ohio","Trumbull County",1,63,3102,1538,1564
050,39,155,"Ohio","Trumbull County",1,64,2941,1447,1494
050,39,155,"Ohio","Trumbull County",1,65,2907,1392,1515
050,39,155,"Ohio","Trumbull County",1,66,2889,1377,1512
050,39,155,"Ohio","Trumbull County",1,67,2879,1325,1554
050,39,155,"Ohio","Trumbull County",1,68,2818,1320,1498
050,39,155,"Ohio","Trumbull County",1,69,2678,1271,1407
050,39,155,"Ohio","Trumbull County",1,70,2613,1222,1391
050,39,155,"Ohio","Trumbull County",1,71,2475,1147,1328
050,39,155,"Ohio","Trumbull County",1,72,2525,1198,1327
050,39,155,"Ohio","Trumbull County",1,73,2561,1232,1329
050,39,155,"Ohio","Trumbull County",1,74,1631,750,881
050,39,155,"Ohio","Trumbull County",1,75,1595,735,860
050,39,155,"Ohio","Trumbull County",1,76,1659,748,911
050,39,155,"Ohio","Trumbull County",1,77,1679,768,911
050,39,155,"Ohio","Trumbull County",1,78,1474,651,823
050,39,155,"Ohio","Trumbull County",1,79,1262,546,716
050,39,155,"Ohio","Trumbull County",1,80,1184,516,668
050,39,155,"Ohio","Trumbull County",1,81,1122,464,658
050,39,155,"Ohio","Trumbull County",1,82,1036,431,605
050,39,155,"Ohio","Trumbull County",1,83,915,392,523
050,39,155,"Ohio","Trumbull County",1,84,831,336,495
050,39,155,"Ohio","Trumbull County",1,85,5082,1829,3253
050,39,155,"Ohio","Trumbull County",2,0,2079,1069,1010
050,39,155,"Ohio","Trumbull County",2,1,2121,1104,1017
050,39,155,"Ohio","Trumbull County",2,2,2141,1115,1026
050,39,155,"Ohio","Trumbull County",2,3,2139,1092,1047
050,39,155,"Ohio","Trumbull County",2,4,2209,1134,1075
050,39,155,"Ohio","Trumbull County",2,5,2215,1144,1071
050,39,155,"Ohio","Trumbull County",2,6,2223,1150,1073
050,39,155,"Ohio","Trumbull County",2,7,2186,1120,1066
050,39,155,"Ohio","Trumbull County",2,8,2176,1102,1074
050,39,155,"Ohio","Trumbull County",2,9,2181,1110,1071
050,39,155,"Ohio","Trumbull County",2,10,2296,1176,1120
050,39,155,"Ohio","Trumbull County",2,11,2426,1243,1183
050,39,155,"Ohio","Trumbull County",2,12,2497,1259,1238
050,39,155,"Ohio","Trumbull County",2,13,2545,1288,1257
050,39,155,"Ohio","Trumbull County",2,14,2556,1307,1249
050,39,155,"Ohio","Trumbull County",2,15,2527,1301,1226
050,39,155,"Ohio","Trumbull County",2,16,2544,1308,1236
050,39,155,"Ohio","Trumbull County",2,17,2546,1290,1256
050,39,155,"Ohio","Trumbull County",2,18,2194,1156,1038
050,39,155,"Ohio","Trumbull County",2,19,1857,1004,853
050,39,155,"Ohio","Trumbull County",2,20,2067,1087,980
050,39,155,"Ohio","Trumbull County",2,21,2127,1088,1039
050,39,155,"Ohio","Trumbull County",2,22,2268,1150,1118
050,39,155,"Ohio","Trumbull County",2,23,2380,1197,1183
050,39,155,"Ohio","Trumbull County",2,24,2379,1212,1167
050,39,155,"Ohio","Trumbull County",2,25,2453,1259,1194
050,39,155,"Ohio","Trumbull County",2,26,2459,1269,1190
050,39,155,"Ohio","Trumbull County",2,27,2432,1251,1181
050,39,155,"Ohio","Trumbull County",2,28,2491,1253,1238
050,39,155,"Ohio","Trumbull County",2,29,2514,1266,1248
050,39,155,"Ohio","Trumbull County",2,30,2422,1215,1207
050,39,155,"Ohio","Trumbull County",2,31,2333,1200,1133
050,39,155,"Ohio","Trumbull County",2,32,2261,1168,1093
050,39,155,"Ohio","Trumbull County",2,33,2199,1137,1062
050,39,155,"Ohio","Trumbull County",2,34,2218,1138,1080
050,39,155,"Ohio","Trumbull County",2,35,2197,1095,1102
050,39,155,"Ohio","Trumbull County",2,36,2123,1041,1082
050,39,155,"Ohio","Trumbull County",2,37,2196,1081,1115
050,39,155,"Ohio","Trumbull County",2,38,2196,1093,1103
050,39,155,"Ohio","Trumbull County",2,39,2234,1099,1135
050,39,155,"Ohio","Trumbull County",2,40,2267,1125,1142
050,39,155,"Ohio","Trumbull County",2,41,2225,1127,1098
050,39,155,"Ohio","Trumbull County",2,42,2183,1100,1083
050,39,155,"Ohio","Trumbull County",2,43,2167,1081,1086
050,39,155,"Ohio","Trumbull County",2,44,2174,1082,1092
050,39,155,"Ohio","Trumbull County",2,45,2292,1141,1151
050,39,155,"Ohio","Trumbull County",2,46,2226,1111,1115
050,39,155,"Ohio","Trumbull County",2,47,2307,1146,1161
050,39,155,"Ohio","Trumbull County",2,48,2481,1243,1238
050,39,155,"Ohio","Trumbull County",2,49,2639,1305,1334
050,39,155,"Ohio","Trumbull County",2,50,2631,1300,1331
050,39,155,"Ohio","Trumbull County",2,51,2598,1283,1315
050,39,155,"Ohio","Trumbull County",2,52,2585,1283,1302
050,39,155,"Ohio","Trumbull County",2,53,2653,1330,1323
050,39,155,"Ohio","Trumbull County",2,54,2652,1309,1343
050,39,155,"Ohio","Trumbull County",2,55,2776,1360,1416
050,39,155,"Ohio","Trumbull County",2,56,2879,1398,1481
050,39,155,"Ohio","Trumbull County",2,57,2920,1396,1524
050,39,155,"Ohio","Trumbull County",2,58,2958,1409,1549
050,39,155,"Ohio","Trumbull County",2,59,3067,1491,1576
050,39,155,"Ohio","Trumbull County",2,60,3074,1498,1576
050,39,155,"Ohio","Trumbull County",2,61,3132,1532,1600
050,39,155,"Ohio","Trumbull County",2,62,3172,1555,1617
050,39,155,"Ohio","Trumbull County",2,63,3137,1553,1584
050,39,155,"Ohio","Trumbull County",2,64,2951,1454,1497
050,39,155,"Ohio","Trumbull County",2,65,2901,1397,1504
050,39,155,"Ohio","Trumbull County",2,66,2892,1381,1511
050,39,155,"Ohio","Trumbull County",2,67,2855,1323,1532
050,39,155,"Ohio","Trumbull County",2,68,2798,1304,1494
050,39,155,"Ohio","Trumbull County",2,69,2720,1289,1431
050,39,155,"Ohio","Trumbull County",2,70,2594,1215,1379
050,39,155,"Ohio","Trumbull County",2,71,2487,1151,1336
050,39,155,"Ohio","Trumbull County",2,72,2460,1162,1298
050,39,155,"Ohio","Trumbull County",2,73,2663,1275,1388
050,39,155,"Ohio","Trumbull County",2,74,1738,808,930
050,39,155,"Ohio","Trumbull County",2,75,1595,735,860
050,39,155,"Ohio","Trumbull County",2,76,1612,726,886
050,39,155,"Ohio","Trumbull County",2,77,1703,775,928
050,39,155,"Ohio","Trumbull County",2,78,1482,659,823
050,39,155,"Ohio","Trumbull County",2,79,1286,560,726
050,39,155,"Ohio","Trumbull County",2,80,1185,513,672
050,39,155,"Ohio","Trumbull County",2,81,1105,467,638
050,39,155,"Ohio","Trumbull County",2,82,1042,433,609
050,39,155,"Ohio","Trumbull County",2,83,926,395,531
050,39,155,"Ohio","Trumbull County",2,84,831,340,491
050,39,155,"Ohio","Trumbull County",2,85,5053,1816,3237
050,39,155,"Ohio","Trumbull County",3,0,2012,1015,997
050,39,155,"Ohio","Trumbull County",3,1,2108,1089,1019
050,39,155,"Ohio","Trumbull County",3,2,2130,1098,1032
050,39,155,"Ohio","Trumbull County",3,3,2183,1135,1048
050,39,155,"Ohio","Trumbull County",3,4,2182,1100,1082
050,39,155,"Ohio","Trumbull County",3,5,2253,1174,1079
050,39,155,"Ohio","Trumbull County",3,6,2256,1157,1099
050,39,155,"Ohio","Trumbull County",3,7,2240,1163,1077
050,39,155,"Ohio","Trumbull County",3,8,2227,1143,1084
050,39,155,"Ohio","Trumbull County",3,9,2199,1105,1094
050,39,155,"Ohio","Trumbull County",3,10,2248,1132,1116
050,39,155,"Ohio","Trumbull County",3,11,2331,1200,1131
050,39,155,"Ohio","Trumbull County",3,12,2491,1281,1210
050,39,155,"Ohio","Trumbull County",3,13,2516,1275,1241
050,39,155,"Ohio","Trumbull County",3,14,2576,1303,1273
050,39,155,"Ohio","Trumbull County",3,15,2573,1312,1261
050,39,155,"Ohio","Trumbull County",3,16,2544,1309,1235
050,39,155,"Ohio","Trumbull County",3,17,2570,1321,1249
050,39,155,"Ohio","Trumbull County",3,18,2202,1155,1047
050,39,155,"Ohio","Trumbull County",3,19,1826,967,859
050,39,155,"Ohio","Trumbull County",3,20,2060,1099,961
050,39,155,"Ohio","Trumbull County",3,21,2160,1118,1042
050,39,155,"Ohio","Trumbull County",3,22,2310,1159,1151
050,39,155,"Ohio","Trumbull County",3,23,2428,1234,1194
050,39,155,"Ohio","Trumbull County",3,24,2375,1210,1165
050,39,155,"Ohio","Trumbull County",3,25,2389,1237,1152
050,39,155,"Ohio","Trumbull County",3,26,2481,1291,1190
050,39,155,"Ohio","Trumbull County",3,27,2462,1275,1187
050,39,155,"Ohio","Trumbull County",3,28,2458,1276,1182
050,39,155,"Ohio","Trumbull County",3,29,2469,1249,1220
050,39,155,"Ohio","Trumbull County",3,30,2500,1268,1232
050,39,155,"Ohio","Trumbull County",3,31,2441,1226,1215
050,39,155,"Ohio","Trumbull County",3,32,2373,1213,1160
050,39,155,"Ohio","Trumbull County",3,33,2262,1162,1100
050,39,155,"Ohio","Trumbull County",3,34,2229,1158,1071
050,39,155,"Ohio","Trumbull County",3,35,2208,1138,1070
050,39,155,"Ohio","Trumbull County",3,36,2250,1118,1132
050,39,155,"Ohio","Trumbull County",3,37,2162,1069,1093
050,39,155,"Ohio","Trumbull County",3,38,2209,1076,1133
050,39,155,"Ohio","Trumbull County",3,39,2195,1082,1113
050,39,155,"Ohio","Trumbull County",3,40,2274,1130,1144
050,39,155,"Ohio","Trumbull County",3,41,2280,1142,1138
050,39,155,"Ohio","Trumbull County",3,42,2228,1127,1101
050,39,155,"Ohio","Trumbull County",3,43,2217,1121,1096
050,39,155,"Ohio","Trumbull County",3,44,2185,1103,1082
050,39,155,"Ohio","Trumbull County",3,45,2163,1084,1079
050,39,155,"Ohio","Trumbull County",3,46,2320,1168,1152
050,39,155,"Ohio","Trumbull County",3,47,2225,1114,1111
050,39,155,"Ohio","Trumbull County",3,48,2325,1150,1175
050,39,155,"Ohio","Trumbull County",3,49,2452,1214,1238
050,39,155,"Ohio","Trumbull County",3,50,2640,1319,1321
050,39,155,"Ohio","Trumbull County",3,51,2615,1303,1312
050,39,155,"Ohio","Trumbull County",3,52,2574,1268,1306
050,39,155,"Ohio","Trumbull County",3,53,2561,1284,1277
050,39,155,"Ohio","Trumbull County",3,54,2650,1309,1341
050,39,155,"Ohio","Trumbull County",3,55,2630,1316,1314
050,39,155,"Ohio","Trumbull County",3,56,2762,1341,1421
050,39,155,"Ohio","Trumbull County",3,57,2863,1389,1474
050,39,155,"Ohio","Trumbull County",3,58,2894,1393,1501
050,39,155,"Ohio","Trumbull County",3,59,2922,1383,1539
050,39,155,"Ohio","Trumbull County",3,60,3025,1462,1563
050,39,155,"Ohio","Trumbull County",3,61,3036,1459,1577
050,39,155,"Ohio","Trumbull County",3,62,3080,1508,1572
050,39,155,"Ohio","Trumbull County",3,63,3098,1513,1585
050,39,155,"Ohio","Trumbull County",3,64,3085,1509,1576
050,39,155,"Ohio","Trumbull County",3,65,2885,1423,1462
050,39,155,"Ohio","Trumbull County",3,66,2854,1363,1491
050,39,155,"Ohio","Trumbull County",3,67,2827,1344,1483
050,39,155,"Ohio","Trumbull County",3,68,2783,1272,1511
050,39,155,"Ohio","Trumbull County",3,69,2718,1260,1458
050,39,155,"Ohio","Trumbull County",3,70,2618,1233,1385
050,39,155,"Ohio","Trumbull County",3,71,2521,1176,1345
050,39,155,"Ohio","Trumbull County",3,72,2416,1109,1307
050,39,155,"Ohio","Trumbull County",3,73,2368,1112,1256
050,39,155,"Ohio","Trumbull County",3,74,2573,1214,1359
050,39,155,"Ohio","Trumbull County",3,75,1652,766,886
050,39,155,"Ohio","Trumbull County",3,76,1513,674,839
050,39,155,"Ohio","Trumbull County",3,77,1552,700,852
050,39,155,"Ohio","Trumbull County",3,78,1643,739,904
050,39,155,"Ohio","Trumbull County",3,79,1390,623,767
050,39,155,"Ohio","Trumbull County",3,80,1233,529,704
050,39,155,"Ohio","Trumbull County",3,81,1106,470,636
050,39,155,"Ohio","Trumbull County",3,82,1022,432,590
050,39,155,"Ohio","Trumbull County",3,83,952,401,551
050,39,155,"Ohio","Trumbull County",3,84,833,344,489
050,39,155,"Ohio","Trumbull County",3,85,4921,1800,3121
050,39,155,"Ohio","Trumbull County",4,0,1975,1013,962
050,39,155,"Ohio","Trumbull County",4,1,2049,1041,1008
050,39,155,"Ohio","Trumbull County",4,2,2154,1117,1037
050,39,155,"Ohio","Trumbull County",4,3,2159,1115,1044
050,39,155,"Ohio","Trumbull County",4,4,2177,1129,1048
050,39,155,"Ohio","Trumbull County",4,5,2238,1129,1109
050,39,155,"Ohio","Trumbull County",4,6,2295,1197,1098
050,39,155,"Ohio","Trumbull County",4,7,2292,1186,1106
050,39,155,"Ohio","Trumbull County",4,8,2270,1184,1086
050,39,155,"Ohio","Trumbull County",4,9,2261,1157,1104
050,39,155,"Ohio","Trumbull County",4,10,2221,1128,1093
050,39,155,"Ohio","Trumbull County",4,11,2262,1143,1119
050,39,155,"Ohio","Trumbull County",4,12,2362,1222,1140
050,39,155,"Ohio","Trumbull County",4,13,2494,1291,1203
050,39,155,"Ohio","Trumbull County",4,14,2559,1302,1257
050,39,155,"Ohio","Trumbull County",4,15,2589,1289,1300
050,39,155,"Ohio","Trumbull County",4,16,2573,1317,1256
050,39,155,"Ohio","Trumbull County",4,17,2550,1304,1246
050,39,155,"Ohio","Trumbull County",4,18,2164,1153,1011
050,39,155,"Ohio","Trumbull County",4,19,1750,929,821
050,39,155,"Ohio","Trumbull County",4,20,1941,1018,923
050,39,155,"Ohio","Trumbull County",4,21,2160,1139,1021
050,39,155,"Ohio","Trumbull County",4,22,2316,1193,1123
050,39,155,"Ohio","Trumbull County",4,23,2431,1224,1207
050,39,155,"Ohio","Trumbull County",4,24,2437,1255,1182
050,39,155,"Ohio","Trumbull County",4,25,2367,1222,1145
050,39,155,"Ohio","Trumbull County",4,26,2417,1257,1160
050,39,155,"Ohio","Trumbull County",4,27,2486,1264,1222
050,39,155,"Ohio","Trumbull County",4,28,2487,1293,1194
050,39,155,"Ohio","Trumbull County",4,29,2512,1310,1202
050,39,155,"Ohio","Trumbull County",4,30,2484,1264,1220
050,39,155,"Ohio","Trumbull County",4,31,2537,1305,1232
050,39,155,"Ohio","Trumbull County",4,32,2451,1241,1210
050,39,155,"Ohio","Trumbull County",4,33,2391,1219,1172
050,39,155,"Ohio","Trumbull County",4,34,2285,1186,1099
050,39,155,"Ohio","Trumbull County",4,35,2214,1150,1064
050,39,155,"Ohio","Trumbull County",4,36,2225,1139,1086
050,39,155,"Ohio","Trumbull County",4,37,2285,1142,1143
050,39,155,"Ohio","Trumbull County",4,38,2196,1083,1113
050,39,155,"Ohio","Trumbull County",4,39,2209,1077,1132
050,39,155,"Ohio","Trumbull County",4,40,2183,1070,1113
050,39,155,"Ohio","Trumbull County",4,41,2324,1161,1163
050,39,155,"Ohio","Trumbull County",4,42,2263,1124,1139
050,39,155,"Ohio","Trumbull County",4,43,2238,1129,1109
050,39,155,"Ohio","Trumbull County",4,44,2212,1122,1090
050,39,155,"Ohio","Trumbull County",4,45,2158,1074,1084
050,39,155,"Ohio","Trumbull County",4,46,2174,1086,1088
050,39,155,"Ohio","Trumbull County",4,47,2323,1176,1147
050,39,155,"Ohio","Trumbull County",4,48,2230,1135,1095
050,39,155,"Ohio","Trumbull County",4,49,2289,1130,1159
050,39,155,"Ohio","Trumbull County",4,50,2440,1211,1229
050,39,155,"Ohio","Trumbull County",4,51,2612,1305,1307
050,39,155,"Ohio","Trumbull County",4,52,2602,1301,1301
050,39,155,"Ohio","Trumbull County",4,53,2551,1260,1291
050,39,155,"Ohio","Trumbull County",4,54,2539,1255,1284
050,39,155,"Ohio","Trumbull County",4,55,2610,1305,1305
050,39,155,"Ohio","Trumbull County",4,56,2599,1284,1315
050,39,155,"Ohio","Trumbull County",4,57,2720,1315,1405
050,39,155,"Ohio","Trumbull County",4,58,2805,1366,1439
050,39,155,"Ohio","Trumbull County",4,59,2868,1381,1487
050,39,155,"Ohio","Trumbull County",4,60,2889,1369,1520
050,39,155,"Ohio","Trumbull County",4,61,2997,1435,1562
050,39,155,"Ohio","Trumbull County",4,62,2985,1423,1562
050,39,155,"Ohio","Trumbull County",4,63,3026,1475,1551
050,39,155,"Ohio","Trumbull County",4,64,3007,1469,1538
050,39,155,"Ohio","Trumbull County",4,65,3019,1468,1551
050,39,155,"Ohio","Trumbull County",4,66,2830,1398,1432
050,39,155,"Ohio","Trumbull County",4,67,2793,1338,1455
050,39,155,"Ohio","Trumbull County",4,68,2760,1299,1461
050,39,155,"Ohio","Trumbull County",4,69,2705,1231,1474
050,39,155,"Ohio","Trumbull County",4,70,2596,1187,1409
050,39,155,"Ohio","Trumbull County",4,71,2543,1189,1354
050,39,155,"Ohio","Trumbull County",4,72,2456,1137,1319
050,39,155,"Ohio","Trumbull County",4,73,2331,1060,1271
050,39,155,"Ohio","Trumbull County",4,74,2270,1062,1208
050,39,155,"Ohio","Trumbull County",4,75,2449,1149,1300
050,39,155,"Ohio","Trumbull County",4,76,1566,709,857
050,39,155,"Ohio","Trumbull County",4,77,1440,643,797
050,39,155,"Ohio","Trumbull County",4,78,1471,662,809
050,39,155,"Ohio","Trumbull County",4,79,1522,689,833
050,39,155,"Ohio","Trumbull County",4,80,1329,582,747
050,39,155,"Ohio","Trumbull County",4,81,1147,479,668
050,39,155,"Ohio","Trumbull County",4,82,1017,426,591
050,39,155,"Ohio","Trumbull County",4,83,936,399,537
050,39,155,"Ohio","Trumbull County",4,84,863,351,512
050,39,155,"Ohio","Trumbull County",4,85,4814,1771,3043
050,39,155,"Ohio","Trumbull County",5,0,1971,1008,963
050,39,155,"Ohio","Trumbull County",5,1,1978,1046,932
050,39,155,"Ohio","Trumbull County",5,2,2072,1052,1020
050,39,155,"Ohio","Trumbull County",5,3,2186,1114,1072
050,39,155,"Ohio","Trumbull County",5,4,2165,1121,1044
050,39,155,"Ohio","Trumbull County",5,5,2233,1141,1092
050,39,155,"Ohio","Trumbull County",5,6,2249,1149,1100
050,39,155,"Ohio","Trumbull County",5,7,2287,1195,1092
050,39,155,"Ohio","Trumbull County",5,8,2297,1195,1102
050,39,155,"Ohio","Trumbull County",5,9,2293,1191,1102
050,39,155,"Ohio","Trumbull County",5,10,2275,1178,1097
050,39,155,"Ohio","Trumbull County",5,11,2235,1132,1103
050,39,155,"Ohio","Trumbull County",5,12,2274,1143,1131
050,39,155,"Ohio","Trumbull County",5,13,2391,1237,1154
050,39,155,"Ohio","Trumbull County",5,14,2509,1297,1212
050,39,155,"Ohio","Trumbull County",5,15,2587,1320,1267
050,39,155,"Ohio","Trumbull County",5,16,2579,1282,1297
050,39,155,"Ohio","Trumbull County",5,17,2595,1335,1260
050,39,155,"Ohio","Trumbull County",5,18,2111,1122,989
050,39,155,"Ohio","Trumbull County",5,19,1744,942,802
050,39,155,"Ohio","Trumbull County",5,20,1937,1020,917
050,39,155,"Ohio","Trumbull County",5,21,2035,1052,983
050,39,155,"Ohio","Trumbull County",5,22,2303,1187,1116
050,39,155,"Ohio","Trumbull County",5,23,2453,1255,1198
050,39,155,"Ohio","Trumbull County",5,24,2432,1231,1201
050,39,155,"Ohio","Trumbull County",5,25,2455,1271,1184
050,39,155,"Ohio","Trumbull County",5,26,2395,1239,1156
050,39,155,"Ohio","Trumbull County",5,27,2429,1271,1158
050,39,155,"Ohio","Trumbull County",5,28,2507,1279,1228
050,39,155,"Ohio","Trumbull County",5,29,2518,1294,1224
050,39,155,"Ohio","Trumbull County",5,30,2492,1264,1228
050,39,155,"Ohio","Trumbull County",5,31,2484,1263,1221
050,39,155,"Ohio","Trumbull County",5,32,2522,1277,1245
050,39,155,"Ohio","Trumbull County",5,33,2457,1235,1222
050,39,155,"Ohio","Trumbull County",5,34,2406,1238,1168
050,39,155,"Ohio","Trumbull County",5,35,2259,1162,1097
050,39,155,"Ohio","Trumbull County",5,36,2247,1158,1089
050,39,155,"Ohio","Trumbull County",5,37,2293,1177,1116
050,39,155,"Ohio","Trumbull County",5,38,2307,1169,1138
050,39,155,"Ohio","Trumbull County",5,39,2195,1071,1124
050,39,155,"Ohio","Trumbull County",5,40,2230,1096,1134
050,39,155,"Ohio","Trumbull County",5,41,2214,1095,1119
050,39,155,"Ohio","Trumbull County",5,42,2325,1150,1175
050,39,155,"Ohio","Trumbull County",5,43,2306,1145,1161
050,39,155,"Ohio","Trumbull County",5,44,2259,1143,1116
050,39,155,"Ohio","Trumbull County",5,45,2196,1114,1082
050,39,155,"Ohio","Trumbull County",5,46,2180,1083,1097
050,39,155,"Ohio","Trumbull County",5,47,2177,1084,1093
050,39,155,"Ohio","Trumbull County",5,48,2325,1180,1145
050,39,155,"Ohio","Trumbull County",5,49,2197,1118,1079
050,39,155,"Ohio","Trumbull County",5,50,2293,1146,1147
050,39,155,"Ohio","Trumbull County",5,51,2442,1221,1221
050,39,155,"Ohio","Trumbull County",5,52,2601,1312,1289
050,39,155,"Ohio","Trumbull County",5,53,2591,1305,1286
050,39,155,"Ohio","Trumbull County",5,54,2543,1242,1301
050,39,155,"Ohio","Trumbull County",5,55,2535,1260,1275
050,39,155,"Ohio","Trumbull County",5,56,2587,1282,1305
050,39,155,"Ohio","Trumbull County",5,57,2579,1266,1313
050,39,155,"Ohio","Trumbull County",5,58,2681,1298,1383
050,39,155,"Ohio","Trumbull County",5,59,2792,1357,1435
050,39,155,"Ohio","Trumbull County",5,60,2833,1358,1475
050,39,155,"Ohio","Trumbull County",5,61,2841,1349,1492
050,39,155,"Ohio","Trumbull County",5,62,2952,1405,1547
050,39,155,"Ohio","Trumbull County",5,63,2946,1394,1552
050,39,155,"Ohio","Trumbull County",5,64,2993,1455,1538
050,39,155,"Ohio","Trumbull County",5,65,2968,1450,1518
050,39,155,"Ohio","Trumbull County",5,66,2972,1450,1522
050,39,155,"Ohio","Trumbull County",5,67,2774,1371,1403
050,39,155,"Ohio","Trumbull County",5,68,2731,1293,1438
050,39,155,"Ohio","Trumbull County",5,69,2718,1269,1449
050,39,155,"Ohio","Trumbull County",5,70,2613,1175,1438
050,39,155,"Ohio","Trumbull County",5,71,2546,1162,1384
050,39,155,"Ohio","Trumbull County",5,72,2487,1156,1331
050,39,155,"Ohio","Trumbull County",5,73,2373,1094,1279
050,39,155,"Ohio","Trumbull County",5,74,2262,1021,1241
050,39,155,"Ohio","Trumbull County",5,75,2182,1020,1162
050,39,155,"Ohio","Trumbull County",5,76,2355,1089,1266
050,39,155,"Ohio","Trumbull County",5,77,1501,679,822
050,39,155,"Ohio","Trumbull County",5,78,1365,606,759
050,39,155,"Ohio","Trumbull County",5,79,1366,618,748
050,39,155,"Ohio","Trumbull County",5,80,1468,658,810
050,39,155,"Ohio","Trumbull County",5,81,1253,546,707
050,39,155,"Ohio","Trumbull County",5,82,1064,443,621
050,39,155,"Ohio","Trumbull County",5,83,928,390,538
050,39,155,"Ohio","Trumbull County",5,84,854,359,495
050,39,155,"Ohio","Trumbull County",5,85,4818,1769,3049
050,39,157,"Ohio","Tuscarawas County",1,0,1158,595,563
050,39,157,"Ohio","Tuscarawas County",1,1,1200,617,583
050,39,157,"Ohio","Tuscarawas County",1,2,1224,637,587
050,39,157,"Ohio","Tuscarawas County",1,3,1216,606,610
050,39,157,"Ohio","Tuscarawas County",1,4,1206,589,617
050,39,157,"Ohio","Tuscarawas County",1,5,1192,648,544
050,39,157,"Ohio","Tuscarawas County",1,6,1122,614,508
050,39,157,"Ohio","Tuscarawas County",1,7,1193,622,571
050,39,157,"Ohio","Tuscarawas County",1,8,1200,618,582
050,39,157,"Ohio","Tuscarawas County",1,9,1156,577,579
050,39,157,"Ohio","Tuscarawas County",1,10,1211,628,583
050,39,157,"Ohio","Tuscarawas County",1,11,1266,667,599
050,39,157,"Ohio","Tuscarawas County",1,12,1252,643,609
050,39,157,"Ohio","Tuscarawas County",1,13,1257,644,613
050,39,157,"Ohio","Tuscarawas County",1,14,1217,631,586
050,39,157,"Ohio","Tuscarawas County",1,15,1236,626,610
050,39,157,"Ohio","Tuscarawas County",1,16,1312,656,656
050,39,157,"Ohio","Tuscarawas County",1,17,1303,664,639
050,39,157,"Ohio","Tuscarawas County",1,18,1066,584,482
050,39,157,"Ohio","Tuscarawas County",1,19,890,486,404
050,39,157,"Ohio","Tuscarawas County",1,20,971,518,453
050,39,157,"Ohio","Tuscarawas County",1,21,991,521,470
050,39,157,"Ohio","Tuscarawas County",1,22,1025,518,507
050,39,157,"Ohio","Tuscarawas County",1,23,1077,538,539
050,39,157,"Ohio","Tuscarawas County",1,24,1145,562,583
050,39,157,"Ohio","Tuscarawas County",1,25,1114,588,526
050,39,157,"Ohio","Tuscarawas County",1,26,1097,574,523
050,39,157,"Ohio","Tuscarawas County",1,27,1081,571,510
050,39,157,"Ohio","Tuscarawas County",1,28,1134,592,542
050,39,157,"Ohio","Tuscarawas County",1,29,1082,531,551
050,39,157,"Ohio","Tuscarawas County",1,30,1073,523,550
050,39,157,"Ohio","Tuscarawas County",1,31,1055,535,520
050,39,157,"Ohio","Tuscarawas County",1,32,1048,537,511
050,39,157,"Ohio","Tuscarawas County",1,33,1018,511,507
050,39,157,"Ohio","Tuscarawas County",1,34,1061,554,507
050,39,157,"Ohio","Tuscarawas County",1,35,1131,601,530
050,39,157,"Ohio","Tuscarawas County",1,36,1183,616,567
050,39,157,"Ohio","Tuscarawas County",1,37,1152,576,576
050,39,157,"Ohio","Tuscarawas County",1,38,1132,581,551
050,39,157,"Ohio","Tuscarawas County",1,39,1105,554,551
050,39,157,"Ohio","Tuscarawas County",1,40,1112,563,549
050,39,157,"Ohio","Tuscarawas County",1,41,1099,591,508
050,39,157,"Ohio","Tuscarawas County",1,42,1089,558,531
050,39,157,"Ohio","Tuscarawas County",1,43,1043,553,490
050,39,157,"Ohio","Tuscarawas County",1,44,1017,519,498
050,39,157,"Ohio","Tuscarawas County",1,45,1060,534,526
050,39,157,"Ohio","Tuscarawas County",1,46,1025,531,494
050,39,157,"Ohio","Tuscarawas County",1,47,1060,542,518
050,39,157,"Ohio","Tuscarawas County",1,48,1122,568,554
050,39,157,"Ohio","Tuscarawas County",1,49,1289,649,640
050,39,157,"Ohio","Tuscarawas County",1,50,1123,568,555
050,39,157,"Ohio","Tuscarawas County",1,51,1060,537,523
050,39,157,"Ohio","Tuscarawas County",1,52,1089,551,538
050,39,157,"Ohio","Tuscarawas County",1,53,1158,581,577
050,39,157,"Ohio","Tuscarawas County",1,54,1169,585,584
050,39,157,"Ohio","Tuscarawas County",1,55,1210,604,606
050,39,157,"Ohio","Tuscarawas County",1,56,1272,640,632
050,39,157,"Ohio","Tuscarawas County",1,57,1279,651,628
050,39,157,"Ohio","Tuscarawas County",1,58,1345,675,670
050,39,157,"Ohio","Tuscarawas County",1,59,1370,676,694
050,39,157,"Ohio","Tuscarawas County",1,60,1369,683,686
050,39,157,"Ohio","Tuscarawas County",1,61,1347,651,696
050,39,157,"Ohio","Tuscarawas County",1,62,1374,677,697
050,39,157,"Ohio","Tuscarawas County",1,63,1311,657,654
050,39,157,"Ohio","Tuscarawas County",1,64,1257,630,627
050,39,157,"Ohio","Tuscarawas County",1,65,1253,622,631
050,39,157,"Ohio","Tuscarawas County",1,66,1220,587,633
050,39,157,"Ohio","Tuscarawas County",1,67,1192,559,633
050,39,157,"Ohio","Tuscarawas County",1,68,1134,548,586
050,39,157,"Ohio","Tuscarawas County",1,69,1076,520,556
050,39,157,"Ohio","Tuscarawas County",1,70,1030,482,548
050,39,157,"Ohio","Tuscarawas County",1,71,1027,490,537
050,39,157,"Ohio","Tuscarawas County",1,72,1025,501,524
050,39,157,"Ohio","Tuscarawas County",1,73,1022,481,541
050,39,157,"Ohio","Tuscarawas County",1,74,665,301,364
050,39,157,"Ohio","Tuscarawas County",1,75,643,297,346
050,39,157,"Ohio","Tuscarawas County",1,76,664,298,366
050,39,157,"Ohio","Tuscarawas County",1,77,670,288,382
050,39,157,"Ohio","Tuscarawas County",1,78,587,247,340
050,39,157,"Ohio","Tuscarawas County",1,79,530,218,312
050,39,157,"Ohio","Tuscarawas County",1,80,482,215,267
050,39,157,"Ohio","Tuscarawas County",1,81,451,195,256
050,39,157,"Ohio","Tuscarawas County",1,82,482,205,277
050,39,157,"Ohio","Tuscarawas County",1,83,392,153,239
050,39,157,"Ohio","Tuscarawas County",1,84,359,135,224
050,39,157,"Ohio","Tuscarawas County",1,85,2160,750,1410
050,39,157,"Ohio","Tuscarawas County",2,0,1138,575,563
050,39,157,"Ohio","Tuscarawas County",2,1,1185,610,575
050,39,157,"Ohio","Tuscarawas County",2,2,1219,635,584
050,39,157,"Ohio","Tuscarawas County",2,3,1210,606,604
050,39,157,"Ohio","Tuscarawas County",2,4,1211,595,616
050,39,157,"Ohio","Tuscarawas County",2,5,1197,635,562
050,39,157,"Ohio","Tuscarawas County",2,6,1144,624,520
050,39,157,"Ohio","Tuscarawas County",2,7,1174,619,555
050,39,157,"Ohio","Tuscarawas County",2,8,1195,617,578
050,39,157,"Ohio","Tuscarawas County",2,9,1167,587,580
050,39,157,"Ohio","Tuscarawas County",2,10,1198,617,581
050,39,157,"Ohio","Tuscarawas County",2,11,1245,653,592
050,39,157,"Ohio","Tuscarawas County",2,12,1263,653,610
050,39,157,"Ohio","Tuscarawas County",2,13,1253,643,610
050,39,157,"Ohio","Tuscarawas County",2,14,1227,634,593
050,39,157,"Ohio","Tuscarawas County",2,15,1233,630,603
050,39,157,"Ohio","Tuscarawas County",2,16,1297,651,646
050,39,157,"Ohio","Tuscarawas County",2,17,1307,662,645
050,39,157,"Ohio","Tuscarawas County",2,18,1070,582,488
050,39,157,"Ohio","Tuscarawas County",2,19,885,483,402
050,39,157,"Ohio","Tuscarawas County",2,20,979,524,455
050,39,157,"Ohio","Tuscarawas County",2,21,996,523,473
050,39,157,"Ohio","Tuscarawas County",2,22,1026,523,503
050,39,157,"Ohio","Tuscarawas County",2,23,1074,541,533
050,39,157,"Ohio","Tuscarawas County",2,24,1129,558,571
050,39,157,"Ohio","Tuscarawas County",2,25,1119,581,538
050,39,157,"Ohio","Tuscarawas County",2,26,1100,578,522
050,39,157,"Ohio","Tuscarawas County",2,27,1080,570,510
050,39,157,"Ohio","Tuscarawas County",2,28,1126,590,536
050,39,157,"Ohio","Tuscarawas County",2,29,1101,550,551
050,39,157,"Ohio","Tuscarawas County",2,30,1082,528,554
050,39,157,"Ohio","Tuscarawas County",2,31,1056,533,523
050,39,157,"Ohio","Tuscarawas County",2,32,1050,538,512
050,39,157,"Ohio","Tuscarawas County",2,33,1020,514,506
050,39,157,"Ohio","Tuscarawas County",2,34,1050,546,504
050,39,157,"Ohio","Tuscarawas County",2,35,1123,596,527
050,39,157,"Ohio","Tuscarawas County",2,36,1159,606,553
050,39,157,"Ohio","Tuscarawas County",2,37,1157,585,572
050,39,157,"Ohio","Tuscarawas County",2,38,1143,582,561
050,39,157,"Ohio","Tuscarawas County",2,39,1110,560,550
050,39,157,"Ohio","Tuscarawas County",2,40,1116,563,553
050,39,157,"Ohio","Tuscarawas County",2,41,1099,582,517
050,39,157,"Ohio","Tuscarawas County",2,42,1086,565,521
050,39,157,"Ohio","Tuscarawas County",2,43,1057,554,503
050,39,157,"Ohio","Tuscarawas County",2,44,1015,523,492
050,39,157,"Ohio","Tuscarawas County",2,45,1048,524,524
050,39,157,"Ohio","Tuscarawas County",2,46,1028,527,501
050,39,157,"Ohio","Tuscarawas County",2,47,1045,535,510
050,39,157,"Ohio","Tuscarawas County",2,48,1105,560,545
050,39,157,"Ohio","Tuscarawas County",2,49,1253,631,622
050,39,157,"Ohio","Tuscarawas County",2,50,1165,591,574
050,39,157,"Ohio","Tuscarawas County",2,51,1074,546,528
050,39,157,"Ohio","Tuscarawas County",2,52,1077,544,533
050,39,157,"Ohio","Tuscarawas County",2,53,1143,575,568
050,39,157,"Ohio","Tuscarawas County",2,54,1159,582,577
050,39,157,"Ohio","Tuscarawas County",2,55,1197,596,601
050,39,157,"Ohio","Tuscarawas County",2,56,1259,631,628
050,39,157,"Ohio","Tuscarawas County",2,57,1274,646,628
050,39,157,"Ohio","Tuscarawas County",2,58,1328,668,660
050,39,157,"Ohio","Tuscarawas County",2,59,1363,675,688
050,39,157,"Ohio","Tuscarawas County",2,60,1362,678,684
050,39,157,"Ohio","Tuscarawas County",2,61,1346,655,691
050,39,157,"Ohio","Tuscarawas County",2,62,1367,671,696
050,39,157,"Ohio","Tuscarawas County",2,63,1333,665,668
050,39,157,"Ohio","Tuscarawas County",2,64,1257,629,628
050,39,157,"Ohio","Tuscarawas County",2,65,1249,621,628
050,39,157,"Ohio","Tuscarawas County",2,66,1228,595,633
050,39,157,"Ohio","Tuscarawas County",2,67,1188,558,630
050,39,157,"Ohio","Tuscarawas County",2,68,1136,548,588
050,39,157,"Ohio","Tuscarawas County",2,69,1091,526,565
050,39,157,"Ohio","Tuscarawas County",2,70,1031,486,545
050,39,157,"Ohio","Tuscarawas County",2,71,1022,484,538
050,39,157,"Ohio","Tuscarawas County",2,72,1006,491,515
050,39,157,"Ohio","Tuscarawas County",2,73,1075,512,563
050,39,157,"Ohio","Tuscarawas County",2,74,694,318,376
050,39,157,"Ohio","Tuscarawas County",2,75,648,297,351
050,39,157,"Ohio","Tuscarawas County",2,76,644,289,355
050,39,157,"Ohio","Tuscarawas County",2,77,685,297,388
050,39,157,"Ohio","Tuscarawas County",2,78,587,247,340
050,39,157,"Ohio","Tuscarawas County",2,79,529,218,311
050,39,157,"Ohio","Tuscarawas County",2,80,488,215,273
050,39,157,"Ohio","Tuscarawas County",2,81,447,194,253
050,39,157,"Ohio","Tuscarawas County",2,82,475,201,274
050,39,157,"Ohio","Tuscarawas County",2,83,400,160,240
050,39,157,"Ohio","Tuscarawas County",2,84,357,135,222
050,39,157,"Ohio","Tuscarawas County",2,85,2159,754,1405
050,39,157,"Ohio","Tuscarawas County",3,0,1092,569,523
050,39,157,"Ohio","Tuscarawas County",3,1,1161,598,563
050,39,157,"Ohio","Tuscarawas County",3,2,1172,605,567
050,39,157,"Ohio","Tuscarawas County",3,3,1215,627,588
050,39,157,"Ohio","Tuscarawas County",3,4,1213,597,616
050,39,157,"Ohio","Tuscarawas County",3,5,1178,589,589
050,39,157,"Ohio","Tuscarawas County",3,6,1173,617,556
050,39,157,"Ohio","Tuscarawas County",3,7,1138,608,530
050,39,157,"Ohio","Tuscarawas County",3,8,1176,625,551
050,39,157,"Ohio","Tuscarawas County",3,9,1174,600,574
050,39,157,"Ohio","Tuscarawas County",3,10,1175,587,588
050,39,157,"Ohio","Tuscarawas County",3,11,1181,607,574
050,39,157,"Ohio","Tuscarawas County",3,12,1226,642,584
050,39,157,"Ohio","Tuscarawas County",3,13,1247,641,606
050,39,157,"Ohio","Tuscarawas County",3,14,1238,647,591
050,39,157,"Ohio","Tuscarawas County",3,15,1208,625,583
050,39,157,"Ohio","Tuscarawas County",3,16,1220,617,603
050,39,157,"Ohio","Tuscarawas County",3,17,1283,652,631
050,39,157,"Ohio","Tuscarawas County",3,18,1088,576,512
050,39,157,"Ohio","Tuscarawas County",3,19,841,454,387
050,39,157,"Ohio","Tuscarawas County",3,20,965,512,453
050,39,157,"Ohio","Tuscarawas County",3,21,1021,540,481
050,39,157,"Ohio","Tuscarawas County",3,22,1078,552,526
050,39,157,"Ohio","Tuscarawas County",3,23,1057,539,518
050,39,157,"Ohio","Tuscarawas County",3,24,1131,570,561
050,39,157,"Ohio","Tuscarawas County",3,25,1147,565,582
050,39,157,"Ohio","Tuscarawas County",3,26,1112,571,541
050,39,157,"Ohio","Tuscarawas County",3,27,1094,586,508
050,39,157,"Ohio","Tuscarawas County",3,28,1096,577,519
050,39,157,"Ohio","Tuscarawas County",3,29,1122,591,531
050,39,157,"Ohio","Tuscarawas County",3,30,1087,534,553
050,39,157,"Ohio","Tuscarawas County",3,31,1094,534,560
050,39,157,"Ohio","Tuscarawas County",3,32,1076,549,527
050,39,157,"Ohio","Tuscarawas County",3,33,1060,541,519
050,39,157,"Ohio","Tuscarawas County",3,34,1025,515,510
050,39,157,"Ohio","Tuscarawas County",3,35,1034,533,501
050,39,157,"Ohio","Tuscarawas County",3,36,1115,597,518
050,39,157,"Ohio","Tuscarawas County",3,37,1137,599,538
050,39,157,"Ohio","Tuscarawas County",3,38,1156,587,569
050,39,157,"Ohio","Tuscarawas County",3,39,1139,590,549
050,39,157,"Ohio","Tuscarawas County",3,40,1108,561,547
050,39,157,"Ohio","Tuscarawas County",3,41,1105,560,545
050,39,157,"Ohio","Tuscarawas County",3,42,1095,583,512
050,39,157,"Ohio","Tuscarawas County",3,43,1051,541,510
050,39,157,"Ohio","Tuscarawas County",3,44,1062,558,504
050,39,157,"Ohio","Tuscarawas County",3,45,994,502,492
050,39,157,"Ohio","Tuscarawas County",3,46,1034,518,516
050,39,157,"Ohio","Tuscarawas County",3,47,1013,519,494
050,39,157,"Ohio","Tuscarawas County",3,48,1038,532,506
050,39,157,"Ohio","Tuscarawas County",3,49,1106,556,550
050,39,157,"Ohio","Tuscarawas County",3,50,1237,616,621
050,39,157,"Ohio","Tuscarawas County",3,51,1153,586,567
050,39,157,"Ohio","Tuscarawas County",3,52,1077,548,529
050,39,157,"Ohio","Tuscarawas County",3,53,1087,547,540
050,39,157,"Ohio","Tuscarawas County",3,54,1131,575,556
050,39,157,"Ohio","Tuscarawas County",3,55,1155,572,583
050,39,157,"Ohio","Tuscarawas County",3,56,1200,602,598
050,39,157,"Ohio","Tuscarawas County",3,57,1256,625,631
050,39,157,"Ohio","Tuscarawas County",3,58,1256,647,609
050,39,157,"Ohio","Tuscarawas County",3,59,1307,653,654
050,39,157,"Ohio","Tuscarawas County",3,60,1343,661,682
050,39,157,"Ohio","Tuscarawas County",3,61,1345,666,679
050,39,157,"Ohio","Tuscarawas County",3,62,1348,656,692
050,39,157,"Ohio","Tuscarawas County",3,63,1337,653,684
050,39,157,"Ohio","Tuscarawas County",3,64,1323,656,667
050,39,157,"Ohio","Tuscarawas County",3,65,1234,616,618
050,39,157,"Ohio","Tuscarawas County",3,66,1232,610,622
050,39,157,"Ohio","Tuscarawas County",3,67,1203,576,627
050,39,157,"Ohio","Tuscarawas County",3,68,1151,541,610
050,39,157,"Ohio","Tuscarawas County",3,69,1104,529,575
050,39,157,"Ohio","Tuscarawas County",3,70,1067,516,551
050,39,157,"Ohio","Tuscarawas County",3,71,992,460,532
050,39,157,"Ohio","Tuscarawas County",3,72,979,466,513
050,39,157,"Ohio","Tuscarawas County",3,73,983,474,509
050,39,157,"Ohio","Tuscarawas County",3,74,1017,485,532
050,39,157,"Ohio","Tuscarawas County",3,75,669,302,367
050,39,157,"Ohio","Tuscarawas County",3,76,623,283,340
050,39,157,"Ohio","Tuscarawas County",3,77,625,287,338
050,39,157,"Ohio","Tuscarawas County",3,78,658,279,379
050,39,157,"Ohio","Tuscarawas County",3,79,540,220,320
050,39,157,"Ohio","Tuscarawas County",3,80,484,190,294
050,39,157,"Ohio","Tuscarawas County",3,81,453,188,265
050,39,157,"Ohio","Tuscarawas County",3,82,429,184,245
050,39,157,"Ohio","Tuscarawas County",3,83,410,167,243
050,39,157,"Ohio","Tuscarawas County",3,84,359,145,214
050,39,157,"Ohio","Tuscarawas County",3,85,2100,720,1380
050,39,157,"Ohio","Tuscarawas County",4,0,1132,579,553
050,39,157,"Ohio","Tuscarawas County",4,1,1091,566,525
050,39,157,"Ohio","Tuscarawas County",4,2,1136,571,565
050,39,157,"Ohio","Tuscarawas County",4,3,1189,608,581
050,39,157,"Ohio","Tuscarawas County",4,4,1226,636,590
050,39,157,"Ohio","Tuscarawas County",4,5,1195,590,605
050,39,157,"Ohio","Tuscarawas County",4,6,1170,589,581
050,39,157,"Ohio","Tuscarawas County",4,7,1184,618,566
050,39,157,"Ohio","Tuscarawas County",4,8,1128,600,528
050,39,157,"Ohio","Tuscarawas County",4,9,1163,613,550
050,39,157,"Ohio","Tuscarawas County",4,10,1182,601,581
050,39,157,"Ohio","Tuscarawas County",4,11,1154,579,575
050,39,157,"Ohio","Tuscarawas County",4,12,1187,604,583
050,39,157,"Ohio","Tuscarawas County",4,13,1222,632,590
050,39,157,"Ohio","Tuscarawas County",4,14,1254,649,605
050,39,157,"Ohio","Tuscarawas County",4,15,1219,642,577
050,39,157,"Ohio","Tuscarawas County",4,16,1214,629,585
050,39,157,"Ohio","Tuscarawas County",4,17,1247,648,599
050,39,157,"Ohio","Tuscarawas County",4,18,1067,570,497
050,39,157,"Ohio","Tuscarawas County",4,19,846,449,397
050,39,157,"Ohio","Tuscarawas County",4,20,894,476,418
050,39,157,"Ohio","Tuscarawas County",4,21,1008,538,470
050,39,157,"Ohio","Tuscarawas County",4,22,1056,560,496
050,39,157,"Ohio","Tuscarawas County",4,23,1118,584,534
050,39,157,"Ohio","Tuscarawas County",4,24,1065,552,513
050,39,157,"Ohio","Tuscarawas County",4,25,1102,550,552
050,39,157,"Ohio","Tuscarawas County",4,26,1127,558,569
050,39,157,"Ohio","Tuscarawas County",4,27,1112,563,549
050,39,157,"Ohio","Tuscarawas County",4,28,1089,574,515
050,39,157,"Ohio","Tuscarawas County",4,29,1085,577,508
050,39,157,"Ohio","Tuscarawas County",4,30,1115,587,528
050,39,157,"Ohio","Tuscarawas County",4,31,1118,554,564
050,39,157,"Ohio","Tuscarawas County",4,32,1103,534,569
050,39,157,"Ohio","Tuscarawas County",4,33,1076,559,517
050,39,157,"Ohio","Tuscarawas County",4,34,1055,546,509
050,39,157,"Ohio","Tuscarawas County",4,35,1018,511,507
050,39,157,"Ohio","Tuscarawas County",4,36,1032,541,491
050,39,157,"Ohio","Tuscarawas County",4,37,1106,589,517
050,39,157,"Ohio","Tuscarawas County",4,38,1118,581,537
050,39,157,"Ohio","Tuscarawas County",4,39,1130,567,563
050,39,157,"Ohio","Tuscarawas County",4,40,1120,572,548
050,39,157,"Ohio","Tuscarawas County",4,41,1111,565,546
050,39,157,"Ohio","Tuscarawas County",4,42,1097,562,535
050,39,157,"Ohio","Tuscarawas County",4,43,1094,570,524
050,39,157,"Ohio","Tuscarawas County",4,44,1045,535,510
050,39,157,"Ohio","Tuscarawas County",4,45,1066,566,500
050,39,157,"Ohio","Tuscarawas County",4,46,985,501,484
050,39,157,"Ohio","Tuscarawas County",4,47,1032,521,511
050,39,157,"Ohio","Tuscarawas County",4,48,1001,514,487
050,39,157,"Ohio","Tuscarawas County",4,49,1044,533,511
050,39,157,"Ohio","Tuscarawas County",4,50,1095,556,539
050,39,157,"Ohio","Tuscarawas County",4,51,1207,593,614
050,39,157,"Ohio","Tuscarawas County",4,52,1131,569,562
050,39,157,"Ohio","Tuscarawas County",4,53,1071,540,531
050,39,157,"Ohio","Tuscarawas County",4,54,1073,544,529
050,39,157,"Ohio","Tuscarawas County",4,55,1122,567,555
050,39,157,"Ohio","Tuscarawas County",4,56,1149,573,576
050,39,157,"Ohio","Tuscarawas County",4,57,1185,594,591
050,39,157,"Ohio","Tuscarawas County",4,58,1238,618,620
050,39,157,"Ohio","Tuscarawas County",4,59,1219,618,601
050,39,157,"Ohio","Tuscarawas County",4,60,1293,642,651
050,39,157,"Ohio","Tuscarawas County",4,61,1324,645,679
050,39,157,"Ohio","Tuscarawas County",4,62,1341,662,679
050,39,157,"Ohio","Tuscarawas County",4,63,1316,636,680
050,39,157,"Ohio","Tuscarawas County",4,64,1309,640,669
050,39,157,"Ohio","Tuscarawas County",4,65,1318,658,660
050,39,157,"Ohio","Tuscarawas County",4,66,1228,609,619
050,39,157,"Ohio","Tuscarawas County",4,67,1197,588,609
050,39,157,"Ohio","Tuscarawas County",4,68,1178,563,615
050,39,157,"Ohio","Tuscarawas County",4,69,1118,516,602
050,39,157,"Ohio","Tuscarawas County",4,70,1075,511,564
050,39,157,"Ohio","Tuscarawas County",4,71,1012,486,526
050,39,157,"Ohio","Tuscarawas County",4,72,966,448,518
050,39,157,"Ohio","Tuscarawas County",4,73,956,449,507
050,39,157,"Ohio","Tuscarawas County",4,74,929,452,477
050,39,157,"Ohio","Tuscarawas County",4,75,980,460,520
050,39,157,"Ohio","Tuscarawas County",4,76,646,292,354
050,39,157,"Ohio","Tuscarawas County",4,77,596,277,319
050,39,157,"Ohio","Tuscarawas County",4,78,588,265,323
050,39,157,"Ohio","Tuscarawas County",4,79,605,251,354
050,39,157,"Ohio","Tuscarawas County",4,80,497,196,301
050,39,157,"Ohio","Tuscarawas County",4,81,446,171,275
050,39,157,"Ohio","Tuscarawas County",4,82,435,177,258
050,39,157,"Ohio","Tuscarawas County",4,83,359,150,209
050,39,157,"Ohio","Tuscarawas County",4,84,371,159,212
050,39,157,"Ohio","Tuscarawas County",4,85,2070,716,1354
050,39,157,"Ohio","Tuscarawas County",5,0,1117,569,548
050,39,157,"Ohio","Tuscarawas County",5,1,1118,580,538
050,39,157,"Ohio","Tuscarawas County",5,2,1098,569,529
050,39,157,"Ohio","Tuscarawas County",5,3,1143,574,569
050,39,157,"Ohio","Tuscarawas County",5,4,1201,610,591
050,39,157,"Ohio","Tuscarawas County",5,5,1193,613,580
050,39,157,"Ohio","Tuscarawas County",5,6,1184,591,593
050,39,157,"Ohio","Tuscarawas County",5,7,1172,586,586
050,39,157,"Ohio","Tuscarawas County",5,8,1186,622,564
050,39,157,"Ohio","Tuscarawas County",5,9,1137,608,529
050,39,157,"Ohio","Tuscarawas County",5,10,1157,610,547
050,39,157,"Ohio","Tuscarawas County",5,11,1178,600,578
050,39,157,"Ohio","Tuscarawas County",5,12,1150,577,573
050,39,157,"Ohio","Tuscarawas County",5,13,1185,610,575
050,39,157,"Ohio","Tuscarawas County",5,14,1225,632,593
050,39,157,"Ohio","Tuscarawas County",5,15,1232,644,588
050,39,157,"Ohio","Tuscarawas County",5,16,1223,643,580
050,39,157,"Ohio","Tuscarawas County",5,17,1233,652,581
050,39,157,"Ohio","Tuscarawas County",5,18,1044,563,481
050,39,157,"Ohio","Tuscarawas County",5,19,848,449,399
050,39,157,"Ohio","Tuscarawas County",5,20,923,484,439
050,39,157,"Ohio","Tuscarawas County",5,21,953,497,456
050,39,157,"Ohio","Tuscarawas County",5,22,1071,567,504
050,39,157,"Ohio","Tuscarawas County",5,23,1144,602,542
050,39,157,"Ohio","Tuscarawas County",5,24,1166,598,568
050,39,157,"Ohio","Tuscarawas County",5,25,1051,556,495
050,39,157,"Ohio","Tuscarawas County",5,26,1131,567,564
050,39,157,"Ohio","Tuscarawas County",5,27,1111,560,551
050,39,157,"Ohio","Tuscarawas County",5,28,1126,579,547
050,39,157,"Ohio","Tuscarawas County",5,29,1073,559,514
050,39,157,"Ohio","Tuscarawas County",5,30,1077,576,501
050,39,157,"Ohio","Tuscarawas County",5,31,1130,600,530
050,39,157,"Ohio","Tuscarawas County",5,32,1125,561,564
050,39,157,"Ohio","Tuscarawas County",5,33,1104,540,564
050,39,157,"Ohio","Tuscarawas County",5,34,1075,543,532
050,39,157,"Ohio","Tuscarawas County",5,35,1056,543,513
050,39,157,"Ohio","Tuscarawas County",5,36,1018,515,503
050,39,157,"Ohio","Tuscarawas County",5,37,1029,530,499
050,39,157,"Ohio","Tuscarawas County",5,38,1110,590,520
050,39,157,"Ohio","Tuscarawas County",5,39,1097,564,533
050,39,157,"Ohio","Tuscarawas County",5,40,1130,564,566
050,39,157,"Ohio","Tuscarawas County",5,41,1101,566,535
050,39,157,"Ohio","Tuscarawas County",5,42,1104,561,543
050,39,157,"Ohio","Tuscarawas County",5,43,1075,547,528
050,39,157,"Ohio","Tuscarawas County",5,44,1084,566,518
050,39,157,"Ohio","Tuscarawas County",5,45,1029,524,505
050,39,157,"Ohio","Tuscarawas County",5,46,1061,559,502
050,39,157,"Ohio","Tuscarawas County",5,47,976,491,485
050,39,157,"Ohio","Tuscarawas County",5,48,1025,526,499
050,39,157,"Ohio","Tuscarawas County",5,49,1017,517,500
050,39,157,"Ohio","Tuscarawas County",5,50,1043,532,511
050,39,157,"Ohio","Tuscarawas County",5,51,1076,541,535
050,39,157,"Ohio","Tuscarawas County",5,52,1206,587,619
050,39,157,"Ohio","Tuscarawas County",5,53,1123,566,557
050,39,157,"Ohio","Tuscarawas County",5,54,1068,544,524
050,39,157,"Ohio","Tuscarawas County",5,55,1066,544,522
050,39,157,"Ohio","Tuscarawas County",5,56,1096,547,549
050,39,157,"Ohio","Tuscarawas County",5,57,1149,574,575
050,39,157,"Ohio","Tuscarawas County",5,58,1164,589,575
050,39,157,"Ohio","Tuscarawas County",5,59,1216,604,612
050,39,157,"Ohio","Tuscarawas County",5,60,1210,607,603
050,39,157,"Ohio","Tuscarawas County",5,61,1295,637,658
050,39,157,"Ohio","Tuscarawas County",5,62,1316,642,674
050,39,157,"Ohio","Tuscarawas County",5,63,1323,649,674
050,39,157,"Ohio","Tuscarawas County",5,64,1295,622,673
050,39,157,"Ohio","Tuscarawas County",5,65,1298,634,664
050,39,157,"Ohio","Tuscarawas County",5,66,1328,662,666
050,39,157,"Ohio","Tuscarawas County",5,67,1212,594,618
050,39,157,"Ohio","Tuscarawas County",5,68,1181,585,596
050,39,157,"Ohio","Tuscarawas County",5,69,1165,551,614
050,39,157,"Ohio","Tuscarawas County",5,70,1113,511,602
050,39,157,"Ohio","Tuscarawas County",5,71,1031,488,543
050,39,157,"Ohio","Tuscarawas County",5,72,989,477,512
050,39,157,"Ohio","Tuscarawas County",5,73,954,437,517
050,39,157,"Ohio","Tuscarawas County",5,74,909,430,479
050,39,157,"Ohio","Tuscarawas County",5,75,902,428,474
050,39,157,"Ohio","Tuscarawas County",5,76,966,452,514
050,39,157,"Ohio","Tuscarawas County",5,77,624,286,338
050,39,157,"Ohio","Tuscarawas County",5,78,569,260,309
050,39,157,"Ohio","Tuscarawas County",5,79,546,243,303
050,39,157,"Ohio","Tuscarawas County",5,80,567,229,338
050,39,157,"Ohio","Tuscarawas County",5,81,456,175,281
050,39,157,"Ohio","Tuscarawas County",5,82,436,165,271
050,39,157,"Ohio","Tuscarawas County",5,83,373,148,225
050,39,157,"Ohio","Tuscarawas County",5,84,324,146,178
050,39,157,"Ohio","Tuscarawas County",5,85,2089,741,1348
050,39,159,"Ohio","Union County",1,0,729,374,355
050,39,159,"Ohio","Union County",1,1,759,398,361
050,39,159,"Ohio","Union County",1,2,815,393,422
050,39,159,"Ohio","Union County",1,3,808,404,404
050,39,159,"Ohio","Union County",1,4,851,443,408
050,39,159,"Ohio","Union County",1,5,900,467,433
050,39,159,"Ohio","Union County",1,6,849,420,429
050,39,159,"Ohio","Union County",1,7,859,439,420
050,39,159,"Ohio","Union County",1,8,828,421,407
050,39,159,"Ohio","Union County",1,9,861,434,427
050,39,159,"Ohio","Union County",1,10,842,417,425
050,39,159,"Ohio","Union County",1,11,886,438,448
050,39,159,"Ohio","Union County",1,12,936,479,457
050,39,159,"Ohio","Union County",1,13,895,451,444
050,39,159,"Ohio","Union County",1,14,939,450,489
050,39,159,"Ohio","Union County",1,15,910,470,440
050,39,159,"Ohio","Union County",1,16,936,498,438
050,39,159,"Ohio","Union County",1,17,880,473,407
050,39,159,"Ohio","Union County",1,18,719,379,340
050,39,159,"Ohio","Union County",1,19,615,326,289
050,39,159,"Ohio","Union County",1,20,658,313,345
050,39,159,"Ohio","Union County",1,21,697,316,381
050,39,159,"Ohio","Union County",1,22,700,313,387
050,39,159,"Ohio","Union County",1,23,695,329,366
050,39,159,"Ohio","Union County",1,24,711,342,369
050,39,159,"Ohio","Union County",1,25,757,348,409
050,39,159,"Ohio","Union County",1,26,737,339,398
050,39,159,"Ohio","Union County",1,27,765,335,430
050,39,159,"Ohio","Union County",1,28,834,366,468
050,39,159,"Ohio","Union County",1,29,862,380,482
050,39,159,"Ohio","Union County",1,30,855,397,458
050,39,159,"Ohio","Union County",1,31,856,382,474
050,39,159,"Ohio","Union County",1,32,826,361,465
050,39,159,"Ohio","Union County",1,33,901,403,498
050,39,159,"Ohio","Union County",1,34,889,396,493
050,39,159,"Ohio","Union County",1,35,957,401,556
050,39,159,"Ohio","Union County",1,36,974,447,527
050,39,159,"Ohio","Union County",1,37,949,457,492
050,39,159,"Ohio","Union County",1,38,993,471,522
050,39,159,"Ohio","Union County",1,39,948,443,505
050,39,159,"Ohio","Union County",1,40,976,459,517
050,39,159,"Ohio","Union County",1,41,964,462,502
050,39,159,"Ohio","Union County",1,42,945,448,497
050,39,159,"Ohio","Union County",1,43,952,445,507
050,39,159,"Ohio","Union County",1,44,947,422,525
050,39,159,"Ohio","Union County",1,45,904,434,470
050,39,159,"Ohio","Union County",1,46,894,446,448
050,39,159,"Ohio","Union County",1,47,839,409,430
050,39,159,"Ohio","Union County",1,48,900,472,428
050,39,159,"Ohio","Union County",1,49,1027,500,527
050,39,159,"Ohio","Union County",1,50,978,469,509
050,39,159,"Ohio","Union County",1,51,872,431,441
050,39,159,"Ohio","Union County",1,52,798,409,389
050,39,159,"Ohio","Union County",1,53,849,416,433
050,39,159,"Ohio","Union County",1,54,857,434,423
050,39,159,"Ohio","Union County",1,55,855,443,412
050,39,159,"Ohio","Union County",1,56,862,447,415
050,39,159,"Ohio","Union County",1,57,851,431,420
050,39,159,"Ohio","Union County",1,58,808,395,413
050,39,159,"Ohio","Union County",1,59,784,388,396
050,39,159,"Ohio","Union County",1,60,796,404,392
050,39,159,"Ohio","Union County",1,61,775,397,378
050,39,159,"Ohio","Union County",1,62,710,353,357
050,39,159,"Ohio","Union County",1,63,663,334,329
050,39,159,"Ohio","Union County",1,64,625,303,322
050,39,159,"Ohio","Union County",1,65,634,295,339
050,39,159,"Ohio","Union County",1,66,611,302,309
050,39,159,"Ohio","Union County",1,67,580,285,295
050,39,159,"Ohio","Union County",1,68,548,283,265
050,39,159,"Ohio","Union County",1,69,485,248,237
050,39,159,"Ohio","Union County",1,70,461,211,250
050,39,159,"Ohio","Union County",1,71,446,200,246
050,39,159,"Ohio","Union County",1,72,446,214,232
050,39,159,"Ohio","Union County",1,73,464,218,246
050,39,159,"Ohio","Union County",1,74,301,133,168
050,39,159,"Ohio","Union County",1,75,297,127,170
050,39,159,"Ohio","Union County",1,76,300,130,170
050,39,159,"Ohio","Union County",1,77,283,127,156
050,39,159,"Ohio","Union County",1,78,268,125,143
050,39,159,"Ohio","Union County",1,79,237,112,125
050,39,159,"Ohio","Union County",1,80,189,84,105
050,39,159,"Ohio","Union County",1,81,181,74,107
050,39,159,"Ohio","Union County",1,82,168,68,100
050,39,159,"Ohio","Union County",1,83,152,71,81
050,39,159,"Ohio","Union County",1,84,126,50,76
050,39,159,"Ohio","Union County",1,85,794,295,499
050,39,159,"Ohio","Union County",2,0,709,364,345
050,39,159,"Ohio","Union County",2,1,760,396,364
050,39,159,"Ohio","Union County",2,2,811,398,413
050,39,159,"Ohio","Union County",2,3,816,406,410
050,39,159,"Ohio","Union County",2,4,857,442,415
050,39,159,"Ohio","Union County",2,5,894,465,429
050,39,159,"Ohio","Union County",2,6,872,437,435
050,39,159,"Ohio","Union County",2,7,860,435,425
050,39,159,"Ohio","Union County",2,8,839,427,412
050,39,159,"Ohio","Union County",2,9,856,433,423
050,39,159,"Ohio","Union County",2,10,849,422,427
050,39,159,"Ohio","Union County",2,11,876,436,440
050,39,159,"Ohio","Union County",2,12,928,472,456
050,39,159,"Ohio","Union County",2,13,908,458,450
050,39,159,"Ohio","Union County",2,14,926,451,475
050,39,159,"Ohio","Union County",2,15,919,466,453
050,39,159,"Ohio","Union County",2,16,935,494,441
050,39,159,"Ohio","Union County",2,17,895,480,415
050,39,159,"Ohio","Union County",2,18,720,385,335
050,39,159,"Ohio","Union County",2,19,609,321,288
050,39,159,"Ohio","Union County",2,20,669,324,345
050,39,159,"Ohio","Union County",2,21,700,316,384
050,39,159,"Ohio","Union County",2,22,702,313,389
050,39,159,"Ohio","Union County",2,23,696,327,369
050,39,159,"Ohio","Union County",2,24,715,343,372
050,39,159,"Ohio","Union County",2,25,744,342,402
050,39,159,"Ohio","Union County",2,26,741,338,403
050,39,159,"Ohio","Union County",2,27,762,334,428
050,39,159,"Ohio","Union County",2,28,821,361,460
050,39,159,"Ohio","Union County",2,29,862,380,482
050,39,159,"Ohio","Union County",2,30,865,400,465
050,39,159,"Ohio","Union County",2,31,861,385,476
050,39,159,"Ohio","Union County",2,32,840,373,467
050,39,159,"Ohio","Union County",2,33,893,396,497
050,39,159,"Ohio","Union County",2,34,902,404,498
050,39,159,"Ohio","Union County",2,35,960,409,551
050,39,159,"Ohio","Union County",2,36,967,436,531
050,39,159,"Ohio","Union County",2,37,962,459,503
050,39,159,"Ohio","Union County",2,38,999,474,525
050,39,159,"Ohio","Union County",2,39,957,451,506
050,39,159,"Ohio","Union County",2,40,980,464,516
050,39,159,"Ohio","Union County",2,41,975,463,512
050,39,159,"Ohio","Union County",2,42,950,451,499
050,39,159,"Ohio","Union County",2,43,961,453,508
050,39,159,"Ohio","Union County",2,44,949,425,524
050,39,159,"Ohio","Union County",2,45,915,439,476
050,39,159,"Ohio","Union County",2,46,903,445,458
050,39,159,"Ohio","Union County",2,47,851,420,431
050,39,159,"Ohio","Union County",2,48,886,459,427
050,39,159,"Ohio","Union County",2,49,1006,497,509
050,39,159,"Ohio","Union County",2,50,997,480,517
050,39,159,"Ohio","Union County",2,51,890,437,453
050,39,159,"Ohio","Union County",2,52,809,413,396
050,39,159,"Ohio","Union County",2,53,839,415,424
050,39,159,"Ohio","Union County",2,54,854,428,426
050,39,159,"Ohio","Union County",2,55,855,441,414
050,39,159,"Ohio","Union County",2,56,864,449,415
050,39,159,"Ohio","Union County",2,57,855,434,421
050,39,159,"Ohio","Union County",2,58,816,402,414
050,39,159,"Ohio","Union County",2,59,794,392,402
050,39,159,"Ohio","Union County",2,60,793,399,394
050,39,159,"Ohio","Union County",2,61,776,394,382
050,39,159,"Ohio","Union County",2,62,724,365,359
050,39,159,"Ohio","Union County",2,63,679,340,339
050,39,159,"Ohio","Union County",2,64,630,308,322
050,39,159,"Ohio","Union County",2,65,635,299,336
050,39,159,"Ohio","Union County",2,66,622,302,320
050,39,159,"Ohio","Union County",2,67,586,288,298
050,39,159,"Ohio","Union County",2,68,553,283,270
050,39,159,"Ohio","Union County",2,69,505,256,249
050,39,159,"Ohio","Union County",2,70,462,221,241
050,39,159,"Ohio","Union County",2,71,451,204,247
050,39,159,"Ohio","Union County",2,72,440,208,232
050,39,159,"Ohio","Union County",2,73,478,229,249
050,39,159,"Ohio","Union County",2,74,317,141,176
050,39,159,"Ohio","Union County",2,75,296,128,168
050,39,159,"Ohio","Union County",2,76,297,128,169
050,39,159,"Ohio","Union County",2,77,294,131,163
050,39,159,"Ohio","Union County",2,78,265,122,143
050,39,159,"Ohio","Union County",2,79,241,115,126
050,39,159,"Ohio","Union County",2,80,197,88,109
050,39,159,"Ohio","Union County",2,81,184,76,108
050,39,159,"Ohio","Union County",2,82,171,68,103
050,39,159,"Ohio","Union County",2,83,156,69,87
050,39,159,"Ohio","Union County",2,84,130,55,75
050,39,159,"Ohio","Union County",2,85,797,299,498
050,39,159,"Ohio","Union County",3,0,680,365,315
050,39,159,"Ohio","Union County",3,1,783,411,372
050,39,159,"Ohio","Union County",3,2,794,417,377
050,39,159,"Ohio","Union County",3,3,850,422,428
050,39,159,"Ohio","Union County",3,4,829,393,436
050,39,159,"Ohio","Union County",3,5,911,473,438
050,39,159,"Ohio","Union County",3,6,929,485,444
050,39,159,"Ohio","Union County",3,7,900,456,444
050,39,159,"Ohio","Union County",3,8,888,453,435
050,39,159,"Ohio","Union County",3,9,867,443,424
050,39,159,"Ohio","Union County",3,10,877,447,430
050,39,159,"Ohio","Union County",3,11,870,444,426
050,39,159,"Ohio","Union County",3,12,902,440,462
050,39,159,"Ohio","Union County",3,13,952,483,469
050,39,159,"Ohio","Union County",3,14,908,461,447
050,39,159,"Ohio","Union County",3,15,953,467,486
050,39,159,"Ohio","Union County",3,16,944,480,464
050,39,159,"Ohio","Union County",3,17,931,495,436
050,39,159,"Ohio","Union County",3,18,749,408,341
050,39,159,"Ohio","Union County",3,19,614,321,293
050,39,159,"Ohio","Union County",3,20,680,341,339
050,39,159,"Ohio","Union County",3,21,743,333,410
050,39,159,"Ohio","Union County",3,22,725,321,404
050,39,159,"Ohio","Union County",3,23,702,312,390
050,39,159,"Ohio","Union County",3,24,722,337,385
050,39,159,"Ohio","Union County",3,25,770,359,411
050,39,159,"Ohio","Union County",3,26,773,356,417
050,39,159,"Ohio","Union County",3,27,775,345,430
050,39,159,"Ohio","Union County",3,28,804,348,456
050,39,159,"Ohio","Union County",3,29,851,377,474
050,39,159,"Ohio","Union County",3,30,900,395,505
050,39,159,"Ohio","Union County",3,31,952,435,517
050,39,159,"Ohio","Union County",3,32,941,430,511
050,39,159,"Ohio","Union County",3,33,915,393,522
050,39,159,"Ohio","Union County",3,34,956,440,516
050,39,159,"Ohio","Union County",3,35,971,441,530
050,39,159,"Ohio","Union County",3,36,1033,452,581
050,39,159,"Ohio","Union County",3,37,1008,459,549
050,39,159,"Ohio","Union County",3,38,1013,467,546
050,39,159,"Ohio","Union County",3,39,1017,489,528
050,39,159,"Ohio","Union County",3,40,971,456,515
050,39,159,"Ohio","Union County",3,41,1021,473,548
050,39,159,"Ohio","Union County",3,42,1005,486,519
050,39,159,"Ohio","Union County",3,43,1003,477,526
050,39,159,"Ohio","Union County",3,44,1010,468,542
050,39,159,"Ohio","Union County",3,45,924,437,487
050,39,159,"Ohio","Union County",3,46,959,454,505
050,39,159,"Ohio","Union County",3,47,923,464,459
050,39,159,"Ohio","Union County",3,48,882,447,435
050,39,159,"Ohio","Union County",3,49,911,458,453
050,39,159,"Ohio","Union County",3,50,1025,497,528
050,39,159,"Ohio","Union County",3,51,999,495,504
050,39,159,"Ohio","Union County",3,52,879,439,440
050,39,159,"Ohio","Union County",3,53,849,430,419
050,39,159,"Ohio","Union County",3,54,842,409,433
050,39,159,"Ohio","Union County",3,55,865,428,437
050,39,159,"Ohio","Union County",3,56,852,439,413
050,39,159,"Ohio","Union County",3,57,853,442,411
050,39,159,"Ohio","Union County",3,58,852,433,419
050,39,159,"Ohio","Union County",3,59,828,411,417
050,39,159,"Ohio","Union County",3,60,799,393,406
050,39,159,"Ohio","Union County",3,61,789,391,398
050,39,159,"Ohio","Union County",3,62,777,393,384
050,39,159,"Ohio","Union County",3,63,727,369,358
050,39,159,"Ohio","Union County",3,64,679,347,332
050,39,159,"Ohio","Union County",3,65,647,315,332
050,39,159,"Ohio","Union County",3,66,639,300,339
050,39,159,"Ohio","Union County",3,67,621,301,320
050,39,159,"Ohio","Union County",3,68,586,282,304
050,39,159,"Ohio","Union County",3,69,556,284,272
050,39,159,"Ohio","Union County",3,70,494,243,251
050,39,159,"Ohio","Union County",3,71,468,225,243
050,39,159,"Ohio","Union County",3,72,446,200,246
050,39,159,"Ohio","Union County",3,73,437,208,229
050,39,159,"Ohio","Union County",3,74,475,229,246
050,39,159,"Ohio","Union County",3,75,315,136,179
050,39,159,"Ohio","Union County",3,76,287,124,163
050,39,159,"Ohio","Union County",3,77,302,133,169
050,39,159,"Ohio","Union County",3,78,286,125,161
050,39,159,"Ohio","Union County",3,79,251,117,134
050,39,159,"Ohio","Union County",3,80,230,110,120
050,39,159,"Ohio","Union County",3,81,183,84,99
050,39,159,"Ohio","Union County",3,82,170,68,102
050,39,159,"Ohio","Union County",3,83,170,67,103
050,39,159,"Ohio","Union County",3,84,137,62,75
050,39,159,"Ohio","Union County",3,85,800,295,505
050,39,159,"Ohio","Union County",4,0,714,368,346
050,39,159,"Ohio","Union County",4,1,729,395,334
050,39,159,"Ohio","Union County",4,2,851,448,403
050,39,159,"Ohio","Union County",4,3,861,451,410
050,39,159,"Ohio","Union County",4,4,893,443,450
050,39,159,"Ohio","Union County",4,5,899,425,474
050,39,159,"Ohio","Union County",4,6,948,484,464
050,39,159,"Ohio","Union County",4,7,980,505,475
050,39,159,"Ohio","Union County",4,8,936,482,454
050,39,159,"Ohio","Union County",4,9,936,482,454
050,39,159,"Ohio","Union County",4,10,909,457,452
050,39,159,"Ohio","Union County",4,11,927,470,457
050,39,159,"Ohio","Union County",4,12,899,452,447
050,39,159,"Ohio","Union County",4,13,918,454,464
050,39,159,"Ohio","Union County",4,14,945,478,467
050,39,159,"Ohio","Union County",4,15,928,464,464
050,39,159,"Ohio","Union County",4,16,930,452,478
050,39,159,"Ohio","Union County",4,17,952,483,469
050,39,159,"Ohio","Union County",4,18,766,411,355
050,39,159,"Ohio","Union County",4,19,589,314,275
050,39,159,"Ohio","Union County",4,20,672,330,342
050,39,159,"Ohio","Union County",4,21,733,350,383
050,39,159,"Ohio","Union County",4,22,765,343,422
050,39,159,"Ohio","Union County",4,23,745,346,399
050,39,159,"Ohio","Union County",4,24,741,336,405
050,39,159,"Ohio","Union County",4,25,731,352,379
050,39,159,"Ohio","Union County",4,26,792,385,407
050,39,159,"Ohio","Union County",4,27,795,384,411
050,39,159,"Ohio","Union County",4,28,811,350,461
050,39,159,"Ohio","Union County",4,29,887,387,500
050,39,159,"Ohio","Union County",4,30,864,394,470
050,39,159,"Ohio","Union County",4,31,950,425,525
050,39,159,"Ohio","Union County",4,32,1004,473,531
050,39,159,"Ohio","Union County",4,33,999,471,528
050,39,159,"Ohio","Union County",4,34,925,429,496
050,39,159,"Ohio","Union County",4,35,1039,490,549
050,39,159,"Ohio","Union County",4,36,1017,474,543
050,39,159,"Ohio","Union County",4,37,1072,493,579
050,39,159,"Ohio","Union County",4,38,1064,488,576
050,39,159,"Ohio","Union County",4,39,1033,495,538
050,39,159,"Ohio","Union County",4,40,1055,531,524
050,39,159,"Ohio","Union County",4,41,999,478,521
050,39,159,"Ohio","Union County",4,42,1043,475,568
050,39,159,"Ohio","Union County",4,43,1029,509,520
050,39,159,"Ohio","Union County",4,44,1046,495,551
050,39,159,"Ohio","Union County",4,45,980,481,499
050,39,159,"Ohio","Union County",4,46,946,446,500
050,39,159,"Ohio","Union County",4,47,949,472,477
050,39,159,"Ohio","Union County",4,48,927,472,455
050,39,159,"Ohio","Union County",4,49,900,453,447
050,39,159,"Ohio","Union County",4,50,925,466,459
050,39,159,"Ohio","Union County",4,51,1000,512,488
050,39,159,"Ohio","Union County",4,52,980,493,487
050,39,159,"Ohio","Union County",4,53,894,432,462
050,39,159,"Ohio","Union County",4,54,864,444,420
050,39,159,"Ohio","Union County",4,55,842,407,435
050,39,159,"Ohio","Union County",4,56,848,418,430
050,39,159,"Ohio","Union County",4,57,861,448,413
050,39,159,"Ohio","Union County",4,58,836,433,403
050,39,159,"Ohio","Union County",4,59,859,437,422
050,39,159,"Ohio","Union County",4,60,832,415,417
050,39,159,"Ohio","Union County",4,61,800,395,405
050,39,159,"Ohio","Union County",4,62,788,389,399
050,39,159,"Ohio","Union County",4,63,770,390,380
050,39,159,"Ohio","Union County",4,64,757,382,375
050,39,159,"Ohio","Union County",4,65,693,353,340
050,39,159,"Ohio","Union County",4,66,645,306,339
050,39,159,"Ohio","Union County",4,67,651,304,347
050,39,159,"Ohio","Union County",4,68,627,303,324
050,39,159,"Ohio","Union County",4,69,598,290,308
050,39,159,"Ohio","Union County",4,70,555,284,271
050,39,159,"Ohio","Union County",4,71,495,245,250
050,39,159,"Ohio","Union County",4,72,460,212,248
050,39,159,"Ohio","Union County",4,73,460,207,253
050,39,159,"Ohio","Union County",4,74,431,203,228
050,39,159,"Ohio","Union County",4,75,468,227,241
050,39,159,"Ohio","Union County",4,76,310,131,179
050,39,159,"Ohio","Union County",4,77,294,126,168
050,39,159,"Ohio","Union County",4,78,292,131,161
050,39,159,"Ohio","Union County",4,79,271,120,151
050,39,159,"Ohio","Union County",4,80,231,103,128
050,39,159,"Ohio","Union County",4,81,213,103,110
050,39,159,"Ohio","Union County",4,82,178,82,96
050,39,159,"Ohio","Union County",4,83,168,67,101
050,39,159,"Ohio","Union County",4,84,151,55,96
050,39,159,"Ohio","Union County",4,85,806,302,504
050,39,159,"Ohio","Union County",5,0,725,372,353
050,39,159,"Ohio","Union County",5,1,797,429,368
050,39,159,"Ohio","Union County",5,2,806,441,365
050,39,159,"Ohio","Union County",5,3,884,450,434
050,39,159,"Ohio","Union County",5,4,928,498,430
050,39,159,"Ohio","Union County",5,5,950,468,482
050,39,159,"Ohio","Union County",5,6,940,444,496
050,39,159,"Ohio","Union County",5,7,991,515,476
050,39,159,"Ohio","Union County",5,8,1007,524,483
050,39,159,"Ohio","Union County",5,9,977,507,470
050,39,159,"Ohio","Union County",5,10,970,497,473
050,39,159,"Ohio","Union County",5,11,933,465,468
050,39,159,"Ohio","Union County",5,12,974,483,491
050,39,159,"Ohio","Union County",5,13,905,463,442
050,39,159,"Ohio","Union County",5,14,968,475,493
050,39,159,"Ohio","Union County",5,15,967,489,478
050,39,159,"Ohio","Union County",5,16,935,470,465
050,39,159,"Ohio","Union County",5,17,943,461,482
050,39,159,"Ohio","Union County",5,18,785,409,376
050,39,159,"Ohio","Union County",5,19,647,338,309
050,39,159,"Ohio","Union County",5,20,691,347,344
050,39,159,"Ohio","Union County",5,21,754,359,395
050,39,159,"Ohio","Union County",5,22,815,365,450
050,39,159,"Ohio","Union County",5,23,824,391,433
050,39,159,"Ohio","Union County",5,24,806,378,428
050,39,159,"Ohio","Union County",5,25,742,335,407
050,39,159,"Ohio","Union County",5,26,750,373,377
050,39,159,"Ohio","Union County",5,27,825,376,449
050,39,159,"Ohio","Union County",5,28,818,380,438
050,39,159,"Ohio","Union County",5,29,905,384,521
050,39,159,"Ohio","Union County",5,30,957,424,533
050,39,159,"Ohio","Union County",5,31,943,420,523
050,39,159,"Ohio","Union County",5,32,1013,454,559
050,39,159,"Ohio","Union County",5,33,1057,486,571
050,39,159,"Ohio","Union County",5,34,1091,513,578
050,39,159,"Ohio","Union County",5,35,1019,471,548
050,39,159,"Ohio","Union County",5,36,1103,525,578
050,39,159,"Ohio","Union County",5,37,1124,537,587
050,39,159,"Ohio","Union County",5,38,1172,528,644
050,39,159,"Ohio","Union County",5,39,1108,513,595
050,39,159,"Ohio","Union County",5,40,1090,530,560
050,39,159,"Ohio","Union County",5,41,1120,552,568
050,39,159,"Ohio","Union County",5,42,1041,492,549
050,39,159,"Ohio","Union County",5,43,1117,526,591
050,39,159,"Ohio","Union County",5,44,1096,521,575
050,39,159,"Ohio","Union County",5,45,1057,521,536
050,39,159,"Ohio","Union County",5,46,1029,505,524
050,39,159,"Ohio","Union County",5,47,977,462,515
050,39,159,"Ohio","Union County",5,48,993,506,487
050,39,159,"Ohio","Union County",5,49,950,472,478
050,39,159,"Ohio","Union County",5,50,910,444,466
050,39,159,"Ohio","Union County",5,51,913,475,438
050,39,159,"Ohio","Union County",5,52,1012,520,492
050,39,159,"Ohio","Union County",5,53,1020,516,504
050,39,159,"Ohio","Union County",5,54,903,431,472
050,39,159,"Ohio","Union County",5,55,893,460,433
050,39,159,"Ohio","Union County",5,56,843,407,436
050,39,159,"Ohio","Union County",5,57,857,428,429
050,39,159,"Ohio","Union County",5,58,867,446,421
050,39,159,"Ohio","Union County",5,59,823,440,383
050,39,159,"Ohio","Union County",5,60,867,444,423
050,39,159,"Ohio","Union County",5,61,846,414,432
050,39,159,"Ohio","Union County",5,62,802,396,406
050,39,159,"Ohio","Union County",5,63,789,389,400
050,39,159,"Ohio","Union County",5,64,772,392,380
050,39,159,"Ohio","Union County",5,65,767,384,383
050,39,159,"Ohio","Union County",5,66,693,351,342
050,39,159,"Ohio","Union County",5,67,642,308,334
050,39,159,"Ohio","Union County",5,68,653,304,349
050,39,159,"Ohio","Union County",5,69,625,305,320
050,39,159,"Ohio","Union County",5,70,586,283,303
050,39,159,"Ohio","Union County",5,71,550,276,274
050,39,159,"Ohio","Union County",5,72,496,243,253
050,39,159,"Ohio","Union County",5,73,458,210,248
050,39,159,"Ohio","Union County",5,74,452,200,252
050,39,159,"Ohio","Union County",5,75,412,194,218
050,39,159,"Ohio","Union County",5,76,463,223,240
050,39,159,"Ohio","Union County",5,77,318,138,180
050,39,159,"Ohio","Union County",5,78,276,118,158
050,39,159,"Ohio","Union County",5,79,276,128,148
050,39,159,"Ohio","Union County",5,80,253,111,142
050,39,159,"Ohio","Union County",5,81,220,97,123
050,39,159,"Ohio","Union County",5,82,194,93,101
050,39,159,"Ohio","Union County",5,83,176,75,101
050,39,159,"Ohio","Union County",5,84,150,53,97
050,39,159,"Ohio","Union County",5,85,841,315,526
050,39,161,"Ohio","Van Wert County",1,0,345,179,166
050,39,161,"Ohio","Van Wert County",1,1,354,183,171
050,39,161,"Ohio","Van Wert County",1,2,345,175,170
050,39,161,"Ohio","Van Wert County",1,3,388,194,194
050,39,161,"Ohio","Van Wert County",1,4,381,206,175
050,39,161,"Ohio","Van Wert County",1,5,363,204,159
050,39,161,"Ohio","Van Wert County",1,6,387,189,198
050,39,161,"Ohio","Van Wert County",1,7,363,180,183
050,39,161,"Ohio","Van Wert County",1,8,340,166,174
050,39,161,"Ohio","Van Wert County",1,9,333,175,158
050,39,161,"Ohio","Van Wert County",1,10,347,170,177
050,39,161,"Ohio","Van Wert County",1,11,399,206,193
050,39,161,"Ohio","Van Wert County",1,12,419,210,209
050,39,161,"Ohio","Van Wert County",1,13,415,209,206
050,39,161,"Ohio","Van Wert County",1,14,393,199,194
050,39,161,"Ohio","Van Wert County",1,15,395,184,211
050,39,161,"Ohio","Van Wert County",1,16,405,201,204
050,39,161,"Ohio","Van Wert County",1,17,378,183,195
050,39,161,"Ohio","Van Wert County",1,18,331,173,158
050,39,161,"Ohio","Van Wert County",1,19,264,143,121
050,39,161,"Ohio","Van Wert County",1,20,289,151,138
050,39,161,"Ohio","Van Wert County",1,21,297,145,152
050,39,161,"Ohio","Van Wert County",1,22,313,155,158
050,39,161,"Ohio","Van Wert County",1,23,333,184,149
050,39,161,"Ohio","Van Wert County",1,24,338,173,165
050,39,161,"Ohio","Van Wert County",1,25,365,177,188
050,39,161,"Ohio","Van Wert County",1,26,353,180,173
050,39,161,"Ohio","Van Wert County",1,27,342,170,172
050,39,161,"Ohio","Van Wert County",1,28,377,192,185
050,39,161,"Ohio","Van Wert County",1,29,372,195,177
050,39,161,"Ohio","Van Wert County",1,30,328,163,165
050,39,161,"Ohio","Van Wert County",1,31,347,172,175
050,39,161,"Ohio","Van Wert County",1,32,298,148,150
050,39,161,"Ohio","Van Wert County",1,33,294,152,142
050,39,161,"Ohio","Van Wert County",1,34,325,157,168
050,39,161,"Ohio","Van Wert County",1,35,338,177,161
050,39,161,"Ohio","Van Wert County",1,36,320,163,157
050,39,161,"Ohio","Van Wert County",1,37,337,166,171
050,39,161,"Ohio","Van Wert County",1,38,361,198,163
050,39,161,"Ohio","Van Wert County",1,39,355,189,166
050,39,161,"Ohio","Van Wert County",1,40,368,191,177
050,39,161,"Ohio","Van Wert County",1,41,378,194,184
050,39,161,"Ohio","Van Wert County",1,42,368,192,176
050,39,161,"Ohio","Van Wert County",1,43,337,173,164
050,39,161,"Ohio","Van Wert County",1,44,323,167,156
050,39,161,"Ohio","Van Wert County",1,45,332,178,154
050,39,161,"Ohio","Van Wert County",1,46,311,166,145
050,39,161,"Ohio","Van Wert County",1,47,332,166,166
050,39,161,"Ohio","Van Wert County",1,48,363,172,191
050,39,161,"Ohio","Van Wert County",1,49,373,195,178
050,39,161,"Ohio","Van Wert County",1,50,354,183,171
050,39,161,"Ohio","Van Wert County",1,51,353,182,171
050,39,161,"Ohio","Van Wert County",1,52,329,162,167
050,39,161,"Ohio","Van Wert County",1,53,347,184,163
050,39,161,"Ohio","Van Wert County",1,54,352,189,163
050,39,161,"Ohio","Van Wert County",1,55,377,190,187
050,39,161,"Ohio","Van Wert County",1,56,434,203,231
050,39,161,"Ohio","Van Wert County",1,57,411,207,204
050,39,161,"Ohio","Van Wert County",1,58,415,206,209
050,39,161,"Ohio","Van Wert County",1,59,424,196,228
050,39,161,"Ohio","Van Wert County",1,60,411,212,199
050,39,161,"Ohio","Van Wert County",1,61,427,220,207
050,39,161,"Ohio","Van Wert County",1,62,413,197,216
050,39,161,"Ohio","Van Wert County",1,63,400,184,216
050,39,161,"Ohio","Van Wert County",1,64,421,199,222
050,39,161,"Ohio","Van Wert County",1,65,410,208,202
050,39,161,"Ohio","Van Wert County",1,66,379,195,184
050,39,161,"Ohio","Van Wert County",1,67,352,181,171
050,39,161,"Ohio","Van Wert County",1,68,344,180,164
050,39,161,"Ohio","Van Wert County",1,69,336,171,165
050,39,161,"Ohio","Van Wert County",1,70,306,153,153
050,39,161,"Ohio","Van Wert County",1,71,284,127,157
050,39,161,"Ohio","Van Wert County",1,72,291,130,161
050,39,161,"Ohio","Van Wert County",1,73,290,138,152
050,39,161,"Ohio","Van Wert County",1,74,215,99,116
050,39,161,"Ohio","Van Wert County",1,75,208,94,114
050,39,161,"Ohio","Van Wert County",1,76,228,106,122
050,39,161,"Ohio","Van Wert County",1,77,226,102,124
050,39,161,"Ohio","Van Wert County",1,78,182,82,100
050,39,161,"Ohio","Van Wert County",1,79,169,78,91
050,39,161,"Ohio","Van Wert County",1,80,143,56,87
050,39,161,"Ohio","Van Wert County",1,81,135,56,79
050,39,161,"Ohio","Van Wert County",1,82,149,62,87
050,39,161,"Ohio","Van Wert County",1,83,117,53,64
050,39,161,"Ohio","Van Wert County",1,84,106,49,57
050,39,161,"Ohio","Van Wert County",1,85,681,221,460
050,39,161,"Ohio","Van Wert County",2,0,347,173,174
050,39,161,"Ohio","Van Wert County",2,1,348,181,167
050,39,161,"Ohio","Van Wert County",2,2,348,177,171
050,39,161,"Ohio","Van Wert County",2,3,378,188,190
050,39,161,"Ohio","Van Wert County",2,4,383,204,179
050,39,161,"Ohio","Van Wert County",2,5,368,204,164
050,39,161,"Ohio","Van Wert County",2,6,382,194,188
050,39,161,"Ohio","Van Wert County",2,7,366,182,184
050,39,161,"Ohio","Van Wert County",2,8,342,168,174
050,39,161,"Ohio","Van Wert County",2,9,335,172,163
050,39,161,"Ohio","Van Wert County",2,10,346,171,175
050,39,161,"Ohio","Van Wert County",2,11,387,196,191
050,39,161,"Ohio","Van Wert County",2,12,420,213,207
050,39,161,"Ohio","Van Wert County",2,13,414,210,204
050,39,161,"Ohio","Van Wert County",2,14,396,201,195
050,39,161,"Ohio","Van Wert County",2,15,398,190,208
050,39,161,"Ohio","Van Wert County",2,16,402,197,205
050,39,161,"Ohio","Van Wert County",2,17,384,188,196
050,39,161,"Ohio","Van Wert County",2,18,322,167,155
050,39,161,"Ohio","Van Wert County",2,19,266,143,123
050,39,161,"Ohio","Van Wert County",2,20,293,154,139
050,39,161,"Ohio","Van Wert County",2,21,301,148,153
050,39,161,"Ohio","Van Wert County",2,22,311,156,155
050,39,161,"Ohio","Van Wert County",2,23,327,176,151
050,39,161,"Ohio","Van Wert County",2,24,335,174,161
050,39,161,"Ohio","Van Wert County",2,25,356,174,182
050,39,161,"Ohio","Van Wert County",2,26,356,179,177
050,39,161,"Ohio","Van Wert County",2,27,344,172,172
050,39,161,"Ohio","Van Wert County",2,28,370,189,181
050,39,161,"Ohio","Van Wert County",2,29,371,192,179
050,39,161,"Ohio","Van Wert County",2,30,343,173,170
050,39,161,"Ohio","Van Wert County",2,31,341,169,172
050,39,161,"Ohio","Van Wert County",2,32,309,155,154
050,39,161,"Ohio","Van Wert County",2,33,297,151,146
050,39,161,"Ohio","Van Wert County",2,34,317,154,163
050,39,161,"Ohio","Van Wert County",2,35,338,174,164
050,39,161,"Ohio","Van Wert County",2,36,321,165,156
050,39,161,"Ohio","Van Wert County",2,37,331,165,166
050,39,161,"Ohio","Van Wert County",2,38,356,190,166
050,39,161,"Ohio","Van Wert County",2,39,356,192,164
050,39,161,"Ohio","Van Wert County",2,40,367,190,177
050,39,161,"Ohio","Van Wert County",2,41,376,194,182
050,39,161,"Ohio","Van Wert County",2,42,371,194,177
050,39,161,"Ohio","Van Wert County",2,43,350,180,170
050,39,161,"Ohio","Van Wert County",2,44,325,167,158
050,39,161,"Ohio","Van Wert County",2,45,333,177,156
050,39,161,"Ohio","Van Wert County",2,46,313,167,146
050,39,161,"Ohio","Van Wert County",2,47,325,164,161
050,39,161,"Ohio","Van Wert County",2,48,353,170,183
050,39,161,"Ohio","Van Wert County",2,49,370,189,181
050,39,161,"Ohio","Van Wert County",2,50,358,186,172
050,39,161,"Ohio","Van Wert County",2,51,351,181,170
050,39,161,"Ohio","Van Wert County",2,52,331,165,166
050,39,161,"Ohio","Van Wert County",2,53,342,178,164
050,39,161,"Ohio","Van Wert County",2,54,350,188,162
050,39,161,"Ohio","Van Wert County",2,55,365,187,178
050,39,161,"Ohio","Van Wert County",2,56,418,198,220
050,39,161,"Ohio","Van Wert County",2,57,415,206,209
050,39,161,"Ohio","Van Wert County",2,58,412,206,206
050,39,161,"Ohio","Van Wert County",2,59,423,199,224
050,39,161,"Ohio","Van Wert County",2,60,413,207,206
050,39,161,"Ohio","Van Wert County",2,61,422,217,205
050,39,161,"Ohio","Van Wert County",2,62,414,201,213
050,39,161,"Ohio","Van Wert County",2,63,409,189,220
050,39,161,"Ohio","Van Wert County",2,64,413,195,218
050,39,161,"Ohio","Van Wert County",2,65,412,204,208
050,39,161,"Ohio","Van Wert County",2,66,386,197,189
050,39,161,"Ohio","Van Wert County",2,67,357,185,172
050,39,161,"Ohio","Van Wert County",2,68,346,180,166
050,39,161,"Ohio","Van Wert County",2,69,341,175,166
050,39,161,"Ohio","Van Wert County",2,70,310,155,155
050,39,161,"Ohio","Van Wert County",2,71,287,131,156
050,39,161,"Ohio","Van Wert County",2,72,284,127,157
050,39,161,"Ohio","Van Wert County",2,73,305,143,162
050,39,161,"Ohio","Van Wert County",2,74,217,100,117
050,39,161,"Ohio","Van Wert County",2,75,210,94,116
050,39,161,"Ohio","Van Wert County",2,76,217,99,118
050,39,161,"Ohio","Van Wert County",2,77,232,105,127
050,39,161,"Ohio","Van Wert County",2,78,188,85,103
050,39,161,"Ohio","Van Wert County",2,79,169,79,90
050,39,161,"Ohio","Van Wert County",2,80,149,61,88
050,39,161,"Ohio","Van Wert County",2,81,136,55,81
050,39,161,"Ohio","Van Wert County",2,82,145,59,86
050,39,161,"Ohio","Van Wert County",2,83,116,51,65
050,39,161,"Ohio","Van Wert County",2,84,104,47,57
050,39,161,"Ohio","Van Wert County",2,85,681,224,457
050,39,161,"Ohio","Van Wert County",3,0,310,143,167
050,39,161,"Ohio","Van Wert County",3,1,367,192,175
050,39,161,"Ohio","Van Wert County",3,2,343,183,160
050,39,161,"Ohio","Van Wert County",3,3,355,179,176
050,39,161,"Ohio","Van Wert County",3,4,374,179,195
050,39,161,"Ohio","Van Wert County",3,5,364,189,175
050,39,161,"Ohio","Van Wert County",3,6,378,210,168
050,39,161,"Ohio","Van Wert County",3,7,381,187,194
050,39,161,"Ohio","Van Wert County",3,8,368,182,186
050,39,161,"Ohio","Van Wert County",3,9,329,155,174
050,39,161,"Ohio","Van Wert County",3,10,346,176,170
050,39,161,"Ohio","Van Wert County",3,11,340,174,166
050,39,161,"Ohio","Van Wert County",3,12,380,202,178
050,39,161,"Ohio","Van Wert County",3,13,401,204,197
050,39,161,"Ohio","Van Wert County",3,14,413,201,212
050,39,161,"Ohio","Van Wert County",3,15,398,192,206
050,39,161,"Ohio","Van Wert County",3,16,402,195,207
050,39,161,"Ohio","Van Wert County",3,17,390,189,201
050,39,161,"Ohio","Van Wert County",3,18,317,163,154
050,39,161,"Ohio","Van Wert County",3,19,254,132,122
050,39,161,"Ohio","Van Wert County",3,20,300,162,138
050,39,161,"Ohio","Van Wert County",3,21,296,153,143
050,39,161,"Ohio","Van Wert County",3,22,318,147,171
050,39,161,"Ohio","Van Wert County",3,23,306,145,161
050,39,161,"Ohio","Van Wert County",3,24,339,189,150
050,39,161,"Ohio","Van Wert County",3,25,352,188,164
050,39,161,"Ohio","Van Wert County",3,26,366,192,174
050,39,161,"Ohio","Van Wert County",3,27,370,184,186
050,39,161,"Ohio","Van Wert County",3,28,344,176,168
050,39,161,"Ohio","Van Wert County",3,29,371,186,185
050,39,161,"Ohio","Van Wert County",3,30,371,190,181
050,39,161,"Ohio","Van Wert County",3,31,350,173,177
050,39,161,"Ohio","Van Wert County",3,32,328,164,164
050,39,161,"Ohio","Van Wert County",3,33,318,164,154
050,39,161,"Ohio","Van Wert County",3,34,296,150,146
050,39,161,"Ohio","Van Wert County",3,35,315,158,157
050,39,161,"Ohio","Van Wert County",3,36,331,175,156
050,39,161,"Ohio","Van Wert County",3,37,317,162,155
050,39,161,"Ohio","Van Wert County",3,38,318,163,155
050,39,161,"Ohio","Van Wert County",3,39,348,183,165
050,39,161,"Ohio","Van Wert County",3,40,359,191,168
050,39,161,"Ohio","Van Wert County",3,41,375,195,180
050,39,161,"Ohio","Van Wert County",3,42,374,188,186
050,39,161,"Ohio","Van Wert County",3,43,379,200,179
050,39,161,"Ohio","Van Wert County",3,44,344,181,163
050,39,161,"Ohio","Van Wert County",3,45,328,165,163
050,39,161,"Ohio","Van Wert County",3,46,327,174,153
050,39,161,"Ohio","Van Wert County",3,47,308,167,141
050,39,161,"Ohio","Van Wert County",3,48,320,164,156
050,39,161,"Ohio","Van Wert County",3,49,357,173,184
050,39,161,"Ohio","Van Wert County",3,50,355,187,168
050,39,161,"Ohio","Van Wert County",3,51,348,177,171
050,39,161,"Ohio","Van Wert County",3,52,357,187,170
050,39,161,"Ohio","Van Wert County",3,53,339,169,170
050,39,161,"Ohio","Van Wert County",3,54,350,182,168
050,39,161,"Ohio","Van Wert County",3,55,350,190,160
050,39,161,"Ohio","Van Wert County",3,56,359,185,174
050,39,161,"Ohio","Van Wert County",3,57,412,198,214
050,39,161,"Ohio","Van Wert County",3,58,411,202,209
050,39,161,"Ohio","Van Wert County",3,59,415,205,210
050,39,161,"Ohio","Van Wert County",3,60,421,200,221
050,39,161,"Ohio","Van Wert County",3,61,409,202,207
050,39,161,"Ohio","Van Wert County",3,62,409,215,194
050,39,161,"Ohio","Van Wert County",3,63,412,198,214
050,39,161,"Ohio","Van Wert County",3,64,400,188,212
050,39,161,"Ohio","Van Wert County",3,65,398,186,212
050,39,161,"Ohio","Van Wert County",3,66,396,195,201
050,39,161,"Ohio","Van Wert County",3,67,387,198,189
050,39,161,"Ohio","Van Wert County",3,68,356,182,174
050,39,161,"Ohio","Van Wert County",3,69,341,180,161
050,39,161,"Ohio","Van Wert County",3,70,331,167,164
050,39,161,"Ohio","Van Wert County",3,71,307,155,152
050,39,161,"Ohio","Van Wert County",3,72,282,128,154
050,39,161,"Ohio","Van Wert County",3,73,270,119,151
050,39,161,"Ohio","Van Wert County",3,74,296,133,163
050,39,161,"Ohio","Van Wert County",3,75,216,99,117
050,39,161,"Ohio","Van Wert County",3,76,193,84,109
050,39,161,"Ohio","Van Wert County",3,77,209,95,114
050,39,161,"Ohio","Van Wert County",3,78,227,100,127
050,39,161,"Ohio","Van Wert County",3,79,173,78,95
050,39,161,"Ohio","Van Wert County",3,80,152,70,82
050,39,161,"Ohio","Van Wert County",3,81,143,58,85
050,39,161,"Ohio","Van Wert County",3,82,139,56,83
050,39,161,"Ohio","Van Wert County",3,83,118,45,73
050,39,161,"Ohio","Van Wert County",3,84,115,49,66
050,39,161,"Ohio","Van Wert County",3,85,653,223,430
050,39,161,"Ohio","Van Wert County",4,0,335,149,186
050,39,161,"Ohio","Van Wert County",4,1,323,144,179
050,39,161,"Ohio","Van Wert County",4,2,382,197,185
050,39,161,"Ohio","Van Wert County",4,3,346,179,167
050,39,161,"Ohio","Van Wert County",4,4,365,180,185
050,39,161,"Ohio","Van Wert County",4,5,383,191,192
050,39,161,"Ohio","Van Wert County",4,6,375,193,182
050,39,161,"Ohio","Van Wert County",4,7,374,203,171
050,39,161,"Ohio","Van Wert County",4,8,387,194,193
050,39,161,"Ohio","Van Wert County",4,9,377,189,188
050,39,161,"Ohio","Van Wert County",4,10,335,161,174
050,39,161,"Ohio","Van Wert County",4,11,341,168,173
050,39,161,"Ohio","Van Wert County",4,12,344,177,167
050,39,161,"Ohio","Van Wert County",4,13,384,195,189
050,39,161,"Ohio","Van Wert County",4,14,407,205,202
050,39,161,"Ohio","Van Wert County",4,15,429,213,216
050,39,161,"Ohio","Van Wert County",4,16,411,201,210
050,39,161,"Ohio","Van Wert County",4,17,393,189,204
050,39,161,"Ohio","Van Wert County",4,18,328,167,161
050,39,161,"Ohio","Van Wert County",4,19,248,131,117
050,39,161,"Ohio","Van Wert County",4,20,281,148,133
050,39,161,"Ohio","Van Wert County",4,21,293,157,136
050,39,161,"Ohio","Van Wert County",4,22,313,153,160
050,39,161,"Ohio","Van Wert County",4,23,314,150,164
050,39,161,"Ohio","Van Wert County",4,24,307,150,157
050,39,161,"Ohio","Van Wert County",4,25,349,181,168
050,39,161,"Ohio","Van Wert County",4,26,353,193,160
050,39,161,"Ohio","Van Wert County",4,27,377,199,178
050,39,161,"Ohio","Van Wert County",4,28,377,186,191
050,39,161,"Ohio","Van Wert County",4,29,337,168,169
050,39,161,"Ohio","Van Wert County",4,30,374,188,186
050,39,161,"Ohio","Van Wert County",4,31,382,192,190
050,39,161,"Ohio","Van Wert County",4,32,355,176,179
050,39,161,"Ohio","Van Wert County",4,33,348,187,161
050,39,161,"Ohio","Van Wert County",4,34,317,159,158
050,39,161,"Ohio","Van Wert County",4,35,310,158,152
050,39,161,"Ohio","Van Wert County",4,36,309,150,159
050,39,161,"Ohio","Van Wert County",4,37,335,178,157
050,39,161,"Ohio","Van Wert County",4,38,320,161,159
050,39,161,"Ohio","Van Wert County",4,39,329,165,164
050,39,161,"Ohio","Van Wert County",4,40,354,186,168
050,39,161,"Ohio","Van Wert County",4,41,354,190,164
050,39,161,"Ohio","Van Wert County",4,42,364,191,173
050,39,161,"Ohio","Van Wert County",4,43,373,186,187
050,39,161,"Ohio","Van Wert County",4,44,375,196,179
050,39,161,"Ohio","Van Wert County",4,45,334,176,158
050,39,161,"Ohio","Van Wert County",4,46,325,162,163
050,39,161,"Ohio","Van Wert County",4,47,322,171,151
050,39,161,"Ohio","Van Wert County",4,48,312,164,148
050,39,161,"Ohio","Van Wert County",4,49,322,157,165
050,39,161,"Ohio","Van Wert County",4,50,346,165,181
050,39,161,"Ohio","Van Wert County",4,51,354,183,171
050,39,161,"Ohio","Van Wert County",4,52,341,174,167
050,39,161,"Ohio","Van Wert County",4,53,357,189,168
050,39,161,"Ohio","Van Wert County",4,54,332,165,167
050,39,161,"Ohio","Van Wert County",4,55,341,175,166
050,39,161,"Ohio","Van Wert County",4,56,346,182,164
050,39,161,"Ohio","Van Wert County",4,57,350,179,171
050,39,161,"Ohio","Van Wert County",4,58,408,192,216
050,39,161,"Ohio","Van Wert County",4,59,401,195,206
050,39,161,"Ohio","Van Wert County",4,60,415,206,209
050,39,161,"Ohio","Van Wert County",4,61,419,198,221
050,39,161,"Ohio","Van Wert County",4,62,398,196,202
050,39,161,"Ohio","Van Wert County",4,63,405,213,192
050,39,161,"Ohio","Van Wert County",4,64,394,196,198
050,39,161,"Ohio","Van Wert County",4,65,385,179,206
050,39,161,"Ohio","Van Wert County",4,66,390,181,209
050,39,161,"Ohio","Van Wert County",4,67,398,193,205
050,39,161,"Ohio","Van Wert County",4,68,377,191,186
050,39,161,"Ohio","Van Wert County",4,69,353,184,169
050,39,161,"Ohio","Van Wert County",4,70,329,172,157
050,39,161,"Ohio","Van Wert County",4,71,327,166,161
050,39,161,"Ohio","Van Wert County",4,72,297,154,143
050,39,161,"Ohio","Van Wert County",4,73,277,127,150
050,39,161,"Ohio","Van Wert County",4,74,257,107,150
050,39,161,"Ohio","Van Wert County",4,75,290,129,161
050,39,161,"Ohio","Van Wert County",4,76,205,92,113
050,39,161,"Ohio","Van Wert County",4,77,188,83,105
050,39,161,"Ohio","Van Wert County",4,78,200,90,110
050,39,161,"Ohio","Van Wert County",4,79,212,94,118
050,39,161,"Ohio","Van Wert County",4,80,159,73,86
050,39,161,"Ohio","Van Wert County",4,81,141,63,78
050,39,161,"Ohio","Van Wert County",4,82,146,60,86
050,39,161,"Ohio","Van Wert County",4,83,117,46,71
050,39,161,"Ohio","Van Wert County",4,84,117,42,75
050,39,161,"Ohio","Van Wert County",4,85,650,228,422
050,39,161,"Ohio","Van Wert County",5,0,337,147,190
050,39,161,"Ohio","Van Wert County",5,1,358,168,190
050,39,161,"Ohio","Van Wert County",5,2,321,147,174
050,39,161,"Ohio","Van Wert County",5,3,387,205,182
050,39,161,"Ohio","Van Wert County",5,4,346,186,160
050,39,161,"Ohio","Van Wert County",5,5,357,178,179
050,39,161,"Ohio","Van Wert County",5,6,367,185,182
050,39,161,"Ohio","Van Wert County",5,7,369,186,183
050,39,161,"Ohio","Van Wert County",5,8,364,200,164
050,39,161,"Ohio","Van Wert County",5,9,390,195,195
050,39,161,"Ohio","Van Wert County",5,10,377,193,184
050,39,161,"Ohio","Van Wert County",5,11,325,156,169
050,39,161,"Ohio","Van Wert County",5,12,350,171,179
050,39,161,"Ohio","Van Wert County",5,13,341,177,164
050,39,161,"Ohio","Van Wert County",5,14,380,196,184
050,39,161,"Ohio","Van Wert County",5,15,411,211,200
050,39,161,"Ohio","Van Wert County",5,16,417,203,214
050,39,161,"Ohio","Van Wert County",5,17,410,198,212
050,39,161,"Ohio","Van Wert County",5,18,342,169,173
050,39,161,"Ohio","Van Wert County",5,19,250,131,119
050,39,161,"Ohio","Van Wert County",5,20,264,134,130
050,39,161,"Ohio","Van Wert County",5,21,304,161,143
050,39,161,"Ohio","Van Wert County",5,22,324,177,147
050,39,161,"Ohio","Van Wert County",5,23,316,167,149
050,39,161,"Ohio","Van Wert County",5,24,319,153,166
050,39,161,"Ohio","Van Wert County",5,25,306,147,159
050,39,161,"Ohio","Van Wert County",5,26,347,186,161
050,39,161,"Ohio","Van Wert County",5,27,358,194,164
050,39,161,"Ohio","Van Wert County",5,28,376,199,177
050,39,161,"Ohio","Van Wert County",5,29,367,176,191
050,39,161,"Ohio","Van Wert County",5,30,344,175,169
050,39,161,"Ohio","Van Wert County",5,31,377,182,195
050,39,161,"Ohio","Van Wert County",5,32,363,186,177
050,39,161,"Ohio","Van Wert County",5,33,356,178,178
050,39,161,"Ohio","Van Wert County",5,34,348,189,159
050,39,161,"Ohio","Van Wert County",5,35,307,145,162
050,39,161,"Ohio","Van Wert County",5,36,313,159,154
050,39,161,"Ohio","Van Wert County",5,37,302,142,160
050,39,161,"Ohio","Van Wert County",5,38,332,173,159
050,39,161,"Ohio","Van Wert County",5,39,323,164,159
050,39,161,"Ohio","Van Wert County",5,40,327,163,164
050,39,161,"Ohio","Van Wert County",5,41,351,183,168
050,39,161,"Ohio","Van Wert County",5,42,350,190,160
050,39,161,"Ohio","Van Wert County",5,43,364,193,171
050,39,161,"Ohio","Van Wert County",5,44,371,184,187
050,39,161,"Ohio","Van Wert County",5,45,380,199,181
050,39,161,"Ohio","Van Wert County",5,46,326,171,155
050,39,161,"Ohio","Van Wert County",5,47,326,161,165
050,39,161,"Ohio","Van Wert County",5,48,328,172,156
050,39,161,"Ohio","Van Wert County",5,49,323,162,161
050,39,161,"Ohio","Van Wert County",5,50,329,164,165
050,39,161,"Ohio","Van Wert County",5,51,347,163,184
050,39,161,"Ohio","Van Wert County",5,52,349,181,168
050,39,161,"Ohio","Van Wert County",5,53,337,172,165
050,39,161,"Ohio","Van Wert County",5,54,352,187,165
050,39,161,"Ohio","Van Wert County",5,55,324,160,164
050,39,161,"Ohio","Van Wert County",5,56,344,174,170
050,39,161,"Ohio","Van Wert County",5,57,342,183,159
050,39,161,"Ohio","Van Wert County",5,58,344,176,168
050,39,161,"Ohio","Van Wert County",5,59,403,187,216
050,39,161,"Ohio","Van Wert County",5,60,393,194,199
050,39,161,"Ohio","Van Wert County",5,61,414,201,213
050,39,161,"Ohio","Van Wert County",5,62,414,197,217
050,39,161,"Ohio","Van Wert County",5,63,398,195,203
050,39,161,"Ohio","Van Wert County",5,64,395,211,184
050,39,161,"Ohio","Van Wert County",5,65,387,191,196
050,39,161,"Ohio","Van Wert County",5,66,372,171,201
050,39,161,"Ohio","Van Wert County",5,67,388,182,206
050,39,161,"Ohio","Van Wert County",5,68,388,184,204
050,39,161,"Ohio","Van Wert County",5,69,371,189,182
050,39,161,"Ohio","Van Wert County",5,70,336,174,162
050,39,161,"Ohio","Van Wert County",5,71,325,172,153
050,39,161,"Ohio","Van Wert County",5,72,315,160,155
050,39,161,"Ohio","Van Wert County",5,73,292,154,138
050,39,161,"Ohio","Van Wert County",5,74,265,119,146
050,39,161,"Ohio","Van Wert County",5,75,249,106,143
050,39,161,"Ohio","Van Wert County",5,76,275,119,156
050,39,161,"Ohio","Van Wert County",5,77,203,92,111
050,39,161,"Ohio","Van Wert County",5,78,178,77,101
050,39,161,"Ohio","Van Wert County",5,79,184,83,101
050,39,161,"Ohio","Van Wert County",5,80,200,88,112
050,39,161,"Ohio","Van Wert County",5,81,151,66,85
050,39,161,"Ohio","Van Wert County",5,82,144,67,77
050,39,161,"Ohio","Van Wert County",5,83,124,49,75
050,39,161,"Ohio","Van Wert County",5,84,115,44,71
050,39,161,"Ohio","Van Wert County",5,85,666,233,433
050,39,163,"Ohio","Vinton County",1,0,121,61,60
050,39,163,"Ohio","Vinton County",1,1,140,68,72
050,39,163,"Ohio","Vinton County",1,2,138,69,69
050,39,163,"Ohio","Vinton County",1,3,145,76,69
050,39,163,"Ohio","Vinton County",1,4,155,78,77
050,39,163,"Ohio","Vinton County",1,5,145,79,66
050,39,163,"Ohio","Vinton County",1,6,164,87,77
050,39,163,"Ohio","Vinton County",1,7,147,78,69
050,39,163,"Ohio","Vinton County",1,8,136,72,64
050,39,163,"Ohio","Vinton County",1,9,146,73,73
050,39,163,"Ohio","Vinton County",1,10,157,78,79
050,39,163,"Ohio","Vinton County",1,11,156,77,79
050,39,163,"Ohio","Vinton County",1,12,159,81,78
050,39,163,"Ohio","Vinton County",1,13,172,93,79
050,39,163,"Ohio","Vinton County",1,14,181,91,90
050,39,163,"Ohio","Vinton County",1,15,160,75,85
050,39,163,"Ohio","Vinton County",1,16,196,99,97
050,39,163,"Ohio","Vinton County",1,17,182,94,88
050,39,163,"Ohio","Vinton County",1,18,149,78,71
050,39,163,"Ohio","Vinton County",1,19,123,67,56
050,39,163,"Ohio","Vinton County",1,20,124,62,62
050,39,163,"Ohio","Vinton County",1,21,133,72,61
050,39,163,"Ohio","Vinton County",1,22,156,78,78
050,39,163,"Ohio","Vinton County",1,23,134,59,75
050,39,163,"Ohio","Vinton County",1,24,137,73,64
050,39,163,"Ohio","Vinton County",1,25,145,83,62
050,39,163,"Ohio","Vinton County",1,26,146,81,65
050,39,163,"Ohio","Vinton County",1,27,165,90,75
050,39,163,"Ohio","Vinton County",1,28,164,92,72
050,39,163,"Ohio","Vinton County",1,29,141,82,59
050,39,163,"Ohio","Vinton County",1,30,156,80,76
050,39,163,"Ohio","Vinton County",1,31,145,69,76
050,39,163,"Ohio","Vinton County",1,32,141,78,63
050,39,163,"Ohio","Vinton County",1,33,146,82,64
050,39,163,"Ohio","Vinton County",1,34,114,63,51
050,39,163,"Ohio","Vinton County",1,35,100,48,52
050,39,163,"Ohio","Vinton County",1,36,122,62,60
050,39,163,"Ohio","Vinton County",1,37,130,69,61
050,39,163,"Ohio","Vinton County",1,38,151,53,98
050,39,163,"Ohio","Vinton County",1,39,153,65,88
050,39,163,"Ohio","Vinton County",1,40,168,82,86
050,39,163,"Ohio","Vinton County",1,41,156,81,75
050,39,163,"Ohio","Vinton County",1,42,147,71,76
050,39,163,"Ohio","Vinton County",1,43,166,91,75
050,39,163,"Ohio","Vinton County",1,44,166,90,76
050,39,163,"Ohio","Vinton County",1,45,182,96,86
050,39,163,"Ohio","Vinton County",1,46,178,89,89
050,39,163,"Ohio","Vinton County",1,47,175,87,88
050,39,163,"Ohio","Vinton County",1,48,174,100,74
050,39,163,"Ohio","Vinton County",1,49,175,82,93
050,39,163,"Ohio","Vinton County",1,50,182,86,96
050,39,163,"Ohio","Vinton County",1,51,188,92,96
050,39,163,"Ohio","Vinton County",1,52,167,80,87
050,39,163,"Ohio","Vinton County",1,53,175,87,88
050,39,163,"Ohio","Vinton County",1,54,183,91,92
050,39,163,"Ohio","Vinton County",1,55,180,79,101
050,39,163,"Ohio","Vinton County",1,56,188,96,92
050,39,163,"Ohio","Vinton County",1,57,195,109,86
050,39,163,"Ohio","Vinton County",1,58,209,112,97
050,39,163,"Ohio","Vinton County",1,59,217,112,105
050,39,163,"Ohio","Vinton County",1,60,212,107,105
050,39,163,"Ohio","Vinton County",1,61,218,116,102
050,39,163,"Ohio","Vinton County",1,62,208,104,104
050,39,163,"Ohio","Vinton County",1,63,209,106,103
050,39,163,"Ohio","Vinton County",1,64,181,92,89
050,39,163,"Ohio","Vinton County",1,65,185,90,95
050,39,163,"Ohio","Vinton County",1,66,179,88,91
050,39,163,"Ohio","Vinton County",1,67,152,70,82
050,39,163,"Ohio","Vinton County",1,68,162,79,83
050,39,163,"Ohio","Vinton County",1,69,160,82,78
050,39,163,"Ohio","Vinton County",1,70,140,68,72
050,39,163,"Ohio","Vinton County",1,71,136,70,66
050,39,163,"Ohio","Vinton County",1,72,136,69,67
050,39,163,"Ohio","Vinton County",1,73,130,64,66
050,39,163,"Ohio","Vinton County",1,74,87,48,39
050,39,163,"Ohio","Vinton County",1,75,97,55,42
050,39,163,"Ohio","Vinton County",1,76,89,46,43
050,39,163,"Ohio","Vinton County",1,77,91,45,46
050,39,163,"Ohio","Vinton County",1,78,66,30,36
050,39,163,"Ohio","Vinton County",1,79,64,28,36
050,39,163,"Ohio","Vinton County",1,80,58,30,28
050,39,163,"Ohio","Vinton County",1,81,53,19,34
050,39,163,"Ohio","Vinton County",1,82,54,15,39
050,39,163,"Ohio","Vinton County",1,83,51,21,30
050,39,163,"Ohio","Vinton County",1,84,44,18,26
050,39,163,"Ohio","Vinton County",1,85,192,66,126
050,39,163,"Ohio","Vinton County",2,0,130,70,60
050,39,163,"Ohio","Vinton County",2,1,133,65,68
050,39,163,"Ohio","Vinton County",2,2,137,69,68
050,39,163,"Ohio","Vinton County",2,3,142,73,69
050,39,163,"Ohio","Vinton County",2,4,150,77,73
050,39,163,"Ohio","Vinton County",2,5,148,78,70
050,39,163,"Ohio","Vinton County",2,6,163,86,77
050,39,163,"Ohio","Vinton County",2,7,152,80,72
050,39,163,"Ohio","Vinton County",2,8,140,73,67
050,39,163,"Ohio","Vinton County",2,9,143,72,71
050,39,163,"Ohio","Vinton County",2,10,155,77,78
050,39,163,"Ohio","Vinton County",2,11,154,76,78
050,39,163,"Ohio","Vinton County",2,12,158,79,79
050,39,163,"Ohio","Vinton County",2,13,170,90,80
050,39,163,"Ohio","Vinton County",2,14,175,89,86
050,39,163,"Ohio","Vinton County",2,15,166,80,86
050,39,163,"Ohio","Vinton County",2,16,188,94,94
050,39,163,"Ohio","Vinton County",2,17,189,97,92
050,39,163,"Ohio","Vinton County",2,18,148,78,70
050,39,163,"Ohio","Vinton County",2,19,123,66,57
050,39,163,"Ohio","Vinton County",2,20,129,65,64
050,39,163,"Ohio","Vinton County",2,21,135,71,64
050,39,163,"Ohio","Vinton County",2,22,155,78,77
050,39,163,"Ohio","Vinton County",2,23,142,66,76
050,39,163,"Ohio","Vinton County",2,24,139,72,67
050,39,163,"Ohio","Vinton County",2,25,143,79,64
050,39,163,"Ohio","Vinton County",2,26,145,81,64
050,39,163,"Ohio","Vinton County",2,27,161,88,73
050,39,163,"Ohio","Vinton County",2,28,163,91,72
050,39,163,"Ohio","Vinton County",2,29,147,85,62
050,39,163,"Ohio","Vinton County",2,30,153,79,74
050,39,163,"Ohio","Vinton County",2,31,145,71,74
050,39,163,"Ohio","Vinton County",2,32,141,76,65
050,39,163,"Ohio","Vinton County",2,33,144,81,63
050,39,163,"Ohio","Vinton County",2,34,121,67,54
050,39,163,"Ohio","Vinton County",2,35,105,53,52
050,39,163,"Ohio","Vinton County",2,36,114,57,57
050,39,163,"Ohio","Vinton County",2,37,129,66,63
050,39,163,"Ohio","Vinton County",2,38,149,58,91
050,39,163,"Ohio","Vinton County",2,39,150,61,89
050,39,163,"Ohio","Vinton County",2,40,165,78,87
050,39,163,"Ohio","Vinton County",2,41,158,80,78
050,39,163,"Ohio","Vinton County",2,42,149,73,76
050,39,163,"Ohio","Vinton County",2,43,161,86,75
050,39,163,"Ohio","Vinton County",2,44,166,91,75
050,39,163,"Ohio","Vinton County",2,45,177,94,83
050,39,163,"Ohio","Vinton County",2,46,178,90,88
050,39,163,"Ohio","Vinton County",2,47,176,88,88
050,39,163,"Ohio","Vinton County",2,48,172,95,77
050,39,163,"Ohio","Vinton County",2,49,177,87,90
050,39,163,"Ohio","Vinton County",2,50,182,86,96
050,39,163,"Ohio","Vinton County",2,51,185,89,96
050,39,163,"Ohio","Vinton County",2,52,173,83,90
050,39,163,"Ohio","Vinton County",2,53,170,82,88
050,39,163,"Ohio","Vinton County",2,54,181,90,91
050,39,163,"Ohio","Vinton County",2,55,180,82,98
050,39,163,"Ohio","Vinton County",2,56,187,94,93
050,39,163,"Ohio","Vinton County",2,57,194,106,88
050,39,163,"Ohio","Vinton County",2,58,205,111,94
050,39,163,"Ohio","Vinton County",2,59,215,112,103
050,39,163,"Ohio","Vinton County",2,60,211,108,103
050,39,163,"Ohio","Vinton County",2,61,217,114,103
050,39,163,"Ohio","Vinton County",2,62,212,108,104
050,39,163,"Ohio","Vinton County",2,63,210,105,105
050,39,163,"Ohio","Vinton County",2,64,186,95,91
050,39,163,"Ohio","Vinton County",2,65,184,90,94
050,39,163,"Ohio","Vinton County",2,66,182,89,93
050,39,163,"Ohio","Vinton County",2,67,159,74,85
050,39,163,"Ohio","Vinton County",2,68,157,75,82
050,39,163,"Ohio","Vinton County",2,69,160,81,79
050,39,163,"Ohio","Vinton County",2,70,142,71,71
050,39,163,"Ohio","Vinton County",2,71,137,69,68
050,39,163,"Ohio","Vinton County",2,72,135,69,66
050,39,163,"Ohio","Vinton County",2,73,138,68,70
050,39,163,"Ohio","Vinton County",2,74,90,48,42
050,39,163,"Ohio","Vinton County",2,75,91,51,40
050,39,163,"Ohio","Vinton County",2,76,88,46,42
050,39,163,"Ohio","Vinton County",2,77,93,46,47
050,39,163,"Ohio","Vinton County",2,78,70,32,38
050,39,163,"Ohio","Vinton County",2,79,62,27,35
050,39,163,"Ohio","Vinton County",2,80,58,30,28
050,39,163,"Ohio","Vinton County",2,81,53,22,31
050,39,163,"Ohio","Vinton County",2,82,53,16,37
050,39,163,"Ohio","Vinton County",2,83,51,20,31
050,39,163,"Ohio","Vinton County",2,84,45,18,27
050,39,163,"Ohio","Vinton County",2,85,192,67,125
050,39,163,"Ohio","Vinton County",3,0,111,55,56
050,39,163,"Ohio","Vinton County",3,1,134,70,64
050,39,163,"Ohio","Vinton County",3,2,135,67,68
050,39,163,"Ohio","Vinton County",3,3,147,79,68
050,39,163,"Ohio","Vinton County",3,4,138,70,68
050,39,163,"Ohio","Vinton County",3,5,146,76,70
050,39,163,"Ohio","Vinton County",3,6,148,76,72
050,39,163,"Ohio","Vinton County",3,7,162,83,79
050,39,163,"Ohio","Vinton County",3,8,150,81,69
050,39,163,"Ohio","Vinton County",3,9,138,74,64
050,39,163,"Ohio","Vinton County",3,10,136,68,68
050,39,163,"Ohio","Vinton County",3,11,154,76,78
050,39,163,"Ohio","Vinton County",3,12,157,75,82
050,39,163,"Ohio","Vinton County",3,13,159,76,83
050,39,163,"Ohio","Vinton County",3,14,178,95,83
050,39,163,"Ohio","Vinton County",3,15,166,89,77
050,39,163,"Ohio","Vinton County",3,16,158,79,79
050,39,163,"Ohio","Vinton County",3,17,183,92,91
050,39,163,"Ohio","Vinton County",3,18,166,88,78
050,39,163,"Ohio","Vinton County",3,19,111,58,53
050,39,163,"Ohio","Vinton County",3,20,131,66,65
050,39,163,"Ohio","Vinton County",3,21,138,72,66
050,39,163,"Ohio","Vinton County",3,22,154,85,69
050,39,163,"Ohio","Vinton County",3,23,158,79,79
050,39,163,"Ohio","Vinton County",3,24,139,68,71
050,39,163,"Ohio","Vinton County",3,25,132,62,70
050,39,163,"Ohio","Vinton County",3,26,148,84,64
050,39,163,"Ohio","Vinton County",3,27,148,81,67
050,39,163,"Ohio","Vinton County",3,28,161,88,73
050,39,163,"Ohio","Vinton County",3,29,159,85,74
050,39,163,"Ohio","Vinton County",3,30,149,86,63
050,39,163,"Ohio","Vinton County",3,31,147,74,73
050,39,163,"Ohio","Vinton County",3,32,145,71,74
050,39,163,"Ohio","Vinton County",3,33,143,80,63
050,39,163,"Ohio","Vinton County",3,34,143,84,59
050,39,163,"Ohio","Vinton County",3,35,126,66,60
050,39,163,"Ohio","Vinton County",3,36,101,48,53
050,39,163,"Ohio","Vinton County",3,37,112,55,57
050,39,163,"Ohio","Vinton County",3,38,126,69,57
050,39,163,"Ohio","Vinton County",3,39,154,59,95
050,39,163,"Ohio","Vinton County",3,40,152,65,87
050,39,163,"Ohio","Vinton County",3,41,164,74,90
050,39,163,"Ohio","Vinton County",3,42,157,81,76
050,39,163,"Ohio","Vinton County",3,43,151,76,75
050,39,163,"Ohio","Vinton County",3,44,158,85,73
050,39,163,"Ohio","Vinton County",3,45,164,93,71
050,39,163,"Ohio","Vinton County",3,46,176,93,83
050,39,163,"Ohio","Vinton County",3,47,176,86,90
050,39,163,"Ohio","Vinton County",3,48,176,87,89
050,39,163,"Ohio","Vinton County",3,49,180,98,82
050,39,163,"Ohio","Vinton County",3,50,175,84,91
050,39,163,"Ohio","Vinton County",3,51,186,87,99
050,39,163,"Ohio","Vinton County",3,52,184,90,94
050,39,163,"Ohio","Vinton County",3,53,175,84,91
050,39,163,"Ohio","Vinton County",3,54,176,83,93
050,39,163,"Ohio","Vinton County",3,55,180,87,93
050,39,163,"Ohio","Vinton County",3,56,175,81,94
050,39,163,"Ohio","Vinton County",3,57,189,96,93
050,39,163,"Ohio","Vinton County",3,58,195,103,92
050,39,163,"Ohio","Vinton County",3,59,201,110,91
050,39,163,"Ohio","Vinton County",3,60,206,105,101
050,39,163,"Ohio","Vinton County",3,61,211,109,102
050,39,163,"Ohio","Vinton County",3,62,218,111,107
050,39,163,"Ohio","Vinton County",3,63,211,109,102
050,39,163,"Ohio","Vinton County",3,64,202,99,103
050,39,163,"Ohio","Vinton County",3,65,181,89,92
050,39,163,"Ohio","Vinton County",3,66,175,85,90
050,39,163,"Ohio","Vinton County",3,67,180,84,96
050,39,163,"Ohio","Vinton County",3,68,153,71,82
050,39,163,"Ohio","Vinton County",3,69,158,77,81
050,39,163,"Ohio","Vinton County",3,70,153,77,76
050,39,163,"Ohio","Vinton County",3,71,137,68,69
050,39,163,"Ohio","Vinton County",3,72,131,67,64
050,39,163,"Ohio","Vinton County",3,73,133,68,65
050,39,163,"Ohio","Vinton County",3,74,127,58,69
050,39,163,"Ohio","Vinton County",3,75,88,45,43
050,39,163,"Ohio","Vinton County",3,76,81,47,34
050,39,163,"Ohio","Vinton County",3,77,82,43,39
050,39,163,"Ohio","Vinton County",3,78,82,41,41
050,39,163,"Ohio","Vinton County",3,79,65,29,36
050,39,163,"Ohio","Vinton County",3,80,58,25,33
050,39,163,"Ohio","Vinton County",3,81,54,28,26
050,39,163,"Ohio","Vinton County",3,82,49,20,29
050,39,163,"Ohio","Vinton County",3,83,47,13,34
050,39,163,"Ohio","Vinton County",3,84,44,16,28
050,39,163,"Ohio","Vinton County",3,85,196,63,133
050,39,163,"Ohio","Vinton County",4,0,149,89,60
050,39,163,"Ohio","Vinton County",4,1,113,59,54
050,39,163,"Ohio","Vinton County",4,2,141,74,67
050,39,163,"Ohio","Vinton County",4,3,133,65,68
050,39,163,"Ohio","Vinton County",4,4,148,73,75
050,39,163,"Ohio","Vinton County",4,5,137,75,62
050,39,163,"Ohio","Vinton County",4,6,143,77,66
050,39,163,"Ohio","Vinton County",4,7,150,78,72
050,39,163,"Ohio","Vinton County",4,8,167,84,83
050,39,163,"Ohio","Vinton County",4,9,149,78,71
050,39,163,"Ohio","Vinton County",4,10,146,75,71
050,39,163,"Ohio","Vinton County",4,11,139,69,70
050,39,163,"Ohio","Vinton County",4,12,151,76,75
050,39,163,"Ohio","Vinton County",4,13,170,80,90
050,39,163,"Ohio","Vinton County",4,14,151,76,75
050,39,163,"Ohio","Vinton County",4,15,170,89,81
050,39,163,"Ohio","Vinton County",4,16,160,85,75
050,39,163,"Ohio","Vinton County",4,17,158,75,83
050,39,163,"Ohio","Vinton County",4,18,154,82,72
050,39,163,"Ohio","Vinton County",4,19,121,65,56
050,39,163,"Ohio","Vinton County",4,20,111,56,55
050,39,163,"Ohio","Vinton County",4,21,126,63,63
050,39,163,"Ohio","Vinton County",4,22,143,75,68
050,39,163,"Ohio","Vinton County",4,23,158,83,75
050,39,163,"Ohio","Vinton County",4,24,161,82,79
050,39,163,"Ohio","Vinton County",4,25,140,67,73
050,39,163,"Ohio","Vinton County",4,26,123,64,59
050,39,163,"Ohio","Vinton County",4,27,150,85,65
050,39,163,"Ohio","Vinton County",4,28,149,82,67
050,39,163,"Ohio","Vinton County",4,29,148,79,69
050,39,163,"Ohio","Vinton County",4,30,168,89,79
050,39,163,"Ohio","Vinton County",4,31,144,80,64
050,39,163,"Ohio","Vinton County",4,32,149,77,72
050,39,163,"Ohio","Vinton County",4,33,141,73,68
050,39,163,"Ohio","Vinton County",4,34,146,80,66
050,39,163,"Ohio","Vinton County",4,35,145,88,57
050,39,163,"Ohio","Vinton County",4,36,122,61,61
050,39,163,"Ohio","Vinton County",4,37,97,47,50
050,39,163,"Ohio","Vinton County",4,38,113,53,60
050,39,163,"Ohio","Vinton County",4,39,127,72,55
050,39,163,"Ohio","Vinton County",4,40,155,56,99
050,39,163,"Ohio","Vinton County",4,41,157,68,89
050,39,163,"Ohio","Vinton County",4,42,161,71,90
050,39,163,"Ohio","Vinton County",4,43,164,83,81
050,39,163,"Ohio","Vinton County",4,44,150,72,78
050,39,163,"Ohio","Vinton County",4,45,154,83,71
050,39,163,"Ohio","Vinton County",4,46,171,96,75
050,39,163,"Ohio","Vinton County",4,47,175,92,83
050,39,163,"Ohio","Vinton County",4,48,174,84,90
050,39,163,"Ohio","Vinton County",4,49,174,86,88
050,39,163,"Ohio","Vinton County",4,50,180,96,84
050,39,163,"Ohio","Vinton County",4,51,172,84,88
050,39,163,"Ohio","Vinton County",4,52,191,93,98
050,39,163,"Ohio","Vinton County",4,53,177,88,89
050,39,163,"Ohio","Vinton County",4,54,174,85,89
050,39,163,"Ohio","Vinton County",4,55,182,83,99
050,39,163,"Ohio","Vinton County",4,56,179,87,92
050,39,163,"Ohio","Vinton County",4,57,178,81,97
050,39,163,"Ohio","Vinton County",4,58,185,91,94
050,39,163,"Ohio","Vinton County",4,59,182,102,80
050,39,163,"Ohio","Vinton County",4,60,200,106,94
050,39,163,"Ohio","Vinton County",4,61,205,104,101
050,39,163,"Ohio","Vinton County",4,62,207,106,101
050,39,163,"Ohio","Vinton County",4,63,214,111,103
050,39,163,"Ohio","Vinton County",4,64,206,107,99
050,39,163,"Ohio","Vinton County",4,65,192,93,99
050,39,163,"Ohio","Vinton County",4,66,179,86,93
050,39,163,"Ohio","Vinton County",4,67,169,82,87
050,39,163,"Ohio","Vinton County",4,68,173,79,94
050,39,163,"Ohio","Vinton County",4,69,156,72,84
050,39,163,"Ohio","Vinton County",4,70,154,70,84
050,39,163,"Ohio","Vinton County",4,71,149,75,74
050,39,163,"Ohio","Vinton County",4,72,126,62,64
050,39,163,"Ohio","Vinton County",4,73,123,65,58
050,39,163,"Ohio","Vinton County",4,74,122,61,61
050,39,163,"Ohio","Vinton County",4,75,114,52,62
050,39,163,"Ohio","Vinton County",4,76,80,42,38
050,39,163,"Ohio","Vinton County",4,77,81,47,34
050,39,163,"Ohio","Vinton County",4,78,72,36,36
050,39,163,"Ohio","Vinton County",4,79,80,39,41
050,39,163,"Ohio","Vinton County",4,80,64,28,36
050,39,163,"Ohio","Vinton County",4,81,50,19,31
050,39,163,"Ohio","Vinton County",4,82,47,24,23
050,39,163,"Ohio","Vinton County",4,83,42,16,26
050,39,163,"Ohio","Vinton County",4,84,36,8,28
050,39,163,"Ohio","Vinton County",4,85,190,56,134
050,39,163,"Ohio","Vinton County",5,0,147,92,55
050,39,163,"Ohio","Vinton County",5,1,129,76,53
050,39,163,"Ohio","Vinton County",5,2,123,63,60
050,39,163,"Ohio","Vinton County",5,3,133,70,63
050,39,163,"Ohio","Vinton County",5,4,132,66,66
050,39,163,"Ohio","Vinton County",5,5,144,73,71
050,39,163,"Ohio","Vinton County",5,6,139,74,65
050,39,163,"Ohio","Vinton County",5,7,144,83,61
050,39,163,"Ohio","Vinton County",5,8,150,76,74
050,39,163,"Ohio","Vinton County",5,9,162,85,77
050,39,163,"Ohio","Vinton County",5,10,148,80,68
050,39,163,"Ohio","Vinton County",5,11,136,76,60
050,39,163,"Ohio","Vinton County",5,12,142,68,74
050,39,163,"Ohio","Vinton County",5,13,162,81,81
050,39,163,"Ohio","Vinton County",5,14,168,77,91
050,39,163,"Ohio","Vinton County",5,15,154,80,74
050,39,163,"Ohio","Vinton County",5,16,177,94,83
050,39,163,"Ohio","Vinton County",5,17,169,87,82
050,39,163,"Ohio","Vinton County",5,18,128,64,64
050,39,163,"Ohio","Vinton County",5,19,119,62,57
050,39,163,"Ohio","Vinton County",5,20,130,73,57
050,39,163,"Ohio","Vinton County",5,21,111,57,54
050,39,163,"Ohio","Vinton County",5,22,124,59,65
050,39,163,"Ohio","Vinton County",5,23,155,83,72
050,39,163,"Ohio","Vinton County",5,24,155,80,75
050,39,163,"Ohio","Vinton County",5,25,156,83,73
050,39,163,"Ohio","Vinton County",5,26,145,64,81
050,39,163,"Ohio","Vinton County",5,27,123,67,56
050,39,163,"Ohio","Vinton County",5,28,154,81,73
050,39,163,"Ohio","Vinton County",5,29,141,77,64
050,39,163,"Ohio","Vinton County",5,30,156,84,72
050,39,163,"Ohio","Vinton County",5,31,163,86,77
050,39,163,"Ohio","Vinton County",5,32,143,78,65
050,39,163,"Ohio","Vinton County",5,33,153,75,78
050,39,163,"Ohio","Vinton County",5,34,138,70,68
050,39,163,"Ohio","Vinton County",5,35,152,81,71
050,39,163,"Ohio","Vinton County",5,36,135,83,52
050,39,163,"Ohio","Vinton County",5,37,125,61,64
050,39,163,"Ohio","Vinton County",5,38,99,48,51
050,39,163,"Ohio","Vinton County",5,39,116,56,60
050,39,163,"Ohio","Vinton County",5,40,125,72,53
050,39,163,"Ohio","Vinton County",5,41,158,59,99
050,39,163,"Ohio","Vinton County",5,42,157,66,91
050,39,163,"Ohio","Vinton County",5,43,166,71,95
050,39,163,"Ohio","Vinton County",5,44,158,79,79
050,39,163,"Ohio","Vinton County",5,45,150,73,77
050,39,163,"Ohio","Vinton County",5,46,156,85,71
050,39,163,"Ohio","Vinton County",5,47,167,92,75
050,39,163,"Ohio","Vinton County",5,48,179,93,86
050,39,163,"Ohio","Vinton County",5,49,172,85,87
050,39,163,"Ohio","Vinton County",5,50,173,84,89
050,39,163,"Ohio","Vinton County",5,51,181,93,88
050,39,163,"Ohio","Vinton County",5,52,175,84,91
050,39,163,"Ohio","Vinton County",5,53,190,95,95
050,39,163,"Ohio","Vinton County",5,54,185,90,95
050,39,163,"Ohio","Vinton County",5,55,175,86,89
050,39,163,"Ohio","Vinton County",5,56,176,80,96
050,39,163,"Ohio","Vinton County",5,57,179,87,92
050,39,163,"Ohio","Vinton County",5,58,177,78,99
050,39,163,"Ohio","Vinton County",5,59,180,89,91
050,39,163,"Ohio","Vinton County",5,60,179,100,79
050,39,163,"Ohio","Vinton County",5,61,194,103,91
050,39,163,"Ohio","Vinton County",5,62,201,102,99
050,39,163,"Ohio","Vinton County",5,63,206,105,101
050,39,163,"Ohio","Vinton County",5,64,207,109,98
050,39,163,"Ohio","Vinton County",5,65,201,106,95
050,39,163,"Ohio","Vinton County",5,66,188,88,100
050,39,163,"Ohio","Vinton County",5,67,176,84,92
050,39,163,"Ohio","Vinton County",5,68,167,78,89
050,39,163,"Ohio","Vinton County",5,69,169,79,90
050,39,163,"Ohio","Vinton County",5,70,146,66,80
050,39,163,"Ohio","Vinton County",5,71,151,71,80
050,39,163,"Ohio","Vinton County",5,72,139,69,70
050,39,163,"Ohio","Vinton County",5,73,118,61,57
050,39,163,"Ohio","Vinton County",5,74,114,59,55
050,39,163,"Ohio","Vinton County",5,75,108,53,55
050,39,163,"Ohio","Vinton County",5,76,101,46,55
050,39,163,"Ohio","Vinton County",5,77,80,41,39
050,39,163,"Ohio","Vinton County",5,78,72,42,30
050,39,163,"Ohio","Vinton County",5,79,69,34,35
050,39,163,"Ohio","Vinton County",5,80,80,38,42
050,39,163,"Ohio","Vinton County",5,81,54,21,33
050,39,163,"Ohio","Vinton County",5,82,45,18,27
050,39,163,"Ohio","Vinton County",5,83,41,20,21
050,39,163,"Ohio","Vinton County",5,84,31,9,22
050,39,163,"Ohio","Vinton County",5,85,178,47,131
050,39,165,"Ohio","Warren County",1,0,2359,1207,1152
050,39,165,"Ohio","Warren County",1,1,2537,1302,1235
050,39,165,"Ohio","Warren County",1,2,2676,1378,1298
050,39,165,"Ohio","Warren County",1,3,2823,1416,1407
050,39,165,"Ohio","Warren County",1,4,3050,1557,1493
050,39,165,"Ohio","Warren County",1,5,3100,1597,1503
050,39,165,"Ohio","Warren County",1,6,3149,1638,1511
050,39,165,"Ohio","Warren County",1,7,3237,1696,1541
050,39,165,"Ohio","Warren County",1,8,3255,1674,1581
050,39,165,"Ohio","Warren County",1,9,3385,1716,1669
050,39,165,"Ohio","Warren County",1,10,3479,1770,1709
050,39,165,"Ohio","Warren County",1,11,3519,1844,1675
050,39,165,"Ohio","Warren County",1,12,3694,1916,1778
050,39,165,"Ohio","Warren County",1,13,3757,1964,1793
050,39,165,"Ohio","Warren County",1,14,3728,1937,1791
050,39,165,"Ohio","Warren County",1,15,3709,1918,1791
050,39,165,"Ohio","Warren County",1,16,3832,1951,1881
050,39,165,"Ohio","Warren County",1,17,3785,1920,1865
050,39,165,"Ohio","Warren County",1,18,3187,1677,1510
050,39,165,"Ohio","Warren County",1,19,2599,1402,1197
050,39,165,"Ohio","Warren County",1,20,2797,1547,1250
050,39,165,"Ohio","Warren County",1,21,2765,1495,1270
050,39,165,"Ohio","Warren County",1,22,2805,1514,1291
050,39,165,"Ohio","Warren County",1,23,2638,1404,1234
050,39,165,"Ohio","Warren County",1,24,2538,1392,1146
050,39,165,"Ohio","Warren County",1,25,2468,1349,1119
050,39,165,"Ohio","Warren County",1,26,2446,1304,1142
050,39,165,"Ohio","Warren County",1,27,2486,1324,1162
050,39,165,"Ohio","Warren County",1,28,2552,1358,1194
050,39,165,"Ohio","Warren County",1,29,2658,1387,1271
050,39,165,"Ohio","Warren County",1,30,2666,1396,1270
050,39,165,"Ohio","Warren County",1,31,2766,1445,1321
050,39,165,"Ohio","Warren County",1,32,2879,1521,1358
050,39,165,"Ohio","Warren County",1,33,2991,1518,1473
050,39,165,"Ohio","Warren County",1,34,3129,1622,1507
050,39,165,"Ohio","Warren County",1,35,3255,1695,1560
050,39,165,"Ohio","Warren County",1,36,3192,1634,1558
050,39,165,"Ohio","Warren County",1,37,3439,1731,1708
050,39,165,"Ohio","Warren County",1,38,3432,1770,1662
050,39,165,"Ohio","Warren County",1,39,3479,1777,1702
050,39,165,"Ohio","Warren County",1,40,3462,1750,1712
050,39,165,"Ohio","Warren County",1,41,3363,1661,1702
050,39,165,"Ohio","Warren County",1,42,3290,1664,1626
050,39,165,"Ohio","Warren County",1,43,3229,1652,1577
050,39,165,"Ohio","Warren County",1,44,3209,1627,1582
050,39,165,"Ohio","Warren County",1,45,3360,1722,1638
050,39,165,"Ohio","Warren County",1,46,3269,1703,1566
050,39,165,"Ohio","Warren County",1,47,3285,1699,1586
050,39,165,"Ohio","Warren County",1,48,3629,1823,1806
050,39,165,"Ohio","Warren County",1,49,3889,1977,1912
050,39,165,"Ohio","Warren County",1,50,3650,1865,1785
050,39,165,"Ohio","Warren County",1,51,3565,1799,1766
050,39,165,"Ohio","Warren County",1,52,3437,1759,1678
050,39,165,"Ohio","Warren County",1,53,3412,1708,1704
050,39,165,"Ohio","Warren County",1,54,3385,1726,1659
050,39,165,"Ohio","Warren County",1,55,3519,1760,1759
050,39,165,"Ohio","Warren County",1,56,3547,1773,1774
050,39,165,"Ohio","Warren County",1,57,3455,1757,1698
050,39,165,"Ohio","Warren County",1,58,3453,1770,1683
050,39,165,"Ohio","Warren County",1,59,3385,1704,1681
050,39,165,"Ohio","Warren County",1,60,3297,1663,1634
050,39,165,"Ohio","Warren County",1,61,3177,1563,1614
050,39,165,"Ohio","Warren County",1,62,3149,1576,1573
050,39,165,"Ohio","Warren County",1,63,3039,1502,1537
050,39,165,"Ohio","Warren County",1,64,2851,1396,1455
050,39,165,"Ohio","Warren County",1,65,2675,1336,1339
050,39,165,"Ohio","Warren County",1,66,2504,1251,1253
050,39,165,"Ohio","Warren County",1,67,2372,1177,1195
050,39,165,"Ohio","Warren County",1,68,2386,1102,1284
050,39,165,"Ohio","Warren County",1,69,2118,1001,1117
050,39,165,"Ohio","Warren County",1,70,2121,993,1128
050,39,165,"Ohio","Warren County",1,71,2108,994,1114
050,39,165,"Ohio","Warren County",1,72,2081,989,1092
050,39,165,"Ohio","Warren County",1,73,2055,981,1074
050,39,165,"Ohio","Warren County",1,74,1426,642,784
050,39,165,"Ohio","Warren County",1,75,1411,657,754
050,39,165,"Ohio","Warren County",1,76,1345,623,722
050,39,165,"Ohio","Warren County",1,77,1363,623,740
050,39,165,"Ohio","Warren County",1,78,1124,509,615
050,39,165,"Ohio","Warren County",1,79,1035,453,582
050,39,165,"Ohio","Warren County",1,80,965,437,528
050,39,165,"Ohio","Warren County",1,81,943,435,508
050,39,165,"Ohio","Warren County",1,82,807,327,480
050,39,165,"Ohio","Warren County",1,83,695,275,420
050,39,165,"Ohio","Warren County",1,84,679,286,393
050,39,165,"Ohio","Warren County",1,85,3586,1315,2271
050,39,165,"Ohio","Warren County",2,0,2363,1222,1141
050,39,165,"Ohio","Warren County",2,1,2520,1295,1225
050,39,165,"Ohio","Warren County",2,2,2680,1377,1303
050,39,165,"Ohio","Warren County",2,3,2813,1419,1394
050,39,165,"Ohio","Warren County",2,4,3022,1534,1488
050,39,165,"Ohio","Warren County",2,5,3114,1599,1515
050,39,165,"Ohio","Warren County",2,6,3166,1645,1521
050,39,165,"Ohio","Warren County",2,7,3227,1690,1537
050,39,165,"Ohio","Warren County",2,8,3262,1686,1576
050,39,165,"Ohio","Warren County",2,9,3373,1720,1653
050,39,165,"Ohio","Warren County",2,10,3466,1764,1702
050,39,165,"Ohio","Warren County",2,11,3507,1824,1683
050,39,165,"Ohio","Warren County",2,12,3678,1910,1768
050,39,165,"Ohio","Warren County",2,13,3750,1953,1797
050,39,165,"Ohio","Warren County",2,14,3749,1951,1798
050,39,165,"Ohio","Warren County",2,15,3721,1928,1793
050,39,165,"Ohio","Warren County",2,16,3823,1955,1868
050,39,165,"Ohio","Warren County",2,17,3803,1931,1872
050,39,165,"Ohio","Warren County",2,18,3178,1674,1504
050,39,165,"Ohio","Warren County",2,19,2616,1404,1212
050,39,165,"Ohio","Warren County",2,20,2840,1562,1278
050,39,165,"Ohio","Warren County",2,21,2800,1523,1277
050,39,165,"Ohio","Warren County",2,22,2809,1510,1299
050,39,165,"Ohio","Warren County",2,23,2667,1422,1245
050,39,165,"Ohio","Warren County",2,24,2563,1402,1161
050,39,165,"Ohio","Warren County",2,25,2481,1351,1130
050,39,165,"Ohio","Warren County",2,26,2468,1322,1146
050,39,165,"Ohio","Warren County",2,27,2492,1324,1168
050,39,165,"Ohio","Warren County",2,28,2565,1363,1202
050,39,165,"Ohio","Warren County",2,29,2663,1393,1270
050,39,165,"Ohio","Warren County",2,30,2703,1410,1293
050,39,165,"Ohio","Warren County",2,31,2774,1450,1324
050,39,165,"Ohio","Warren County",2,32,2885,1513,1372
050,39,165,"Ohio","Warren County",2,33,3000,1535,1465
050,39,165,"Ohio","Warren County",2,34,3146,1624,1522
050,39,165,"Ohio","Warren County",2,35,3269,1701,1568
050,39,165,"Ohio","Warren County",2,36,3226,1658,1568
050,39,165,"Ohio","Warren County",2,37,3408,1722,1686
050,39,165,"Ohio","Warren County",2,38,3471,1780,1691
050,39,165,"Ohio","Warren County",2,39,3476,1780,1696
050,39,165,"Ohio","Warren County",2,40,3497,1770,1727
050,39,165,"Ohio","Warren County",2,41,3394,1689,1705
050,39,165,"Ohio","Warren County",2,42,3305,1666,1639
050,39,165,"Ohio","Warren County",2,43,3271,1666,1605
050,39,165,"Ohio","Warren County",2,44,3199,1628,1571
050,39,165,"Ohio","Warren County",2,45,3346,1712,1634
050,39,165,"Ohio","Warren County",2,46,3272,1699,1573
050,39,165,"Ohio","Warren County",2,47,3269,1693,1576
050,39,165,"Ohio","Warren County",2,48,3541,1794,1747
050,39,165,"Ohio","Warren County",2,49,3842,1951,1891
050,39,165,"Ohio","Warren County",2,50,3717,1895,1822
050,39,165,"Ohio","Warren County",2,51,3584,1814,1770
050,39,165,"Ohio","Warren County",2,52,3458,1758,1700
050,39,165,"Ohio","Warren County",2,53,3419,1726,1693
050,39,165,"Ohio","Warren County",2,54,3383,1718,1665
050,39,165,"Ohio","Warren County",2,55,3487,1751,1736
050,39,165,"Ohio","Warren County",2,56,3544,1769,1775
050,39,165,"Ohio","Warren County",2,57,3474,1756,1718
050,39,165,"Ohio","Warren County",2,58,3449,1761,1688
050,39,165,"Ohio","Warren County",2,59,3421,1729,1692
050,39,165,"Ohio","Warren County",2,60,3310,1669,1641
050,39,165,"Ohio","Warren County",2,61,3198,1582,1616
050,39,165,"Ohio","Warren County",2,62,3156,1574,1582
050,39,165,"Ohio","Warren County",2,63,3083,1528,1555
050,39,165,"Ohio","Warren County",2,64,2872,1410,1462
050,39,165,"Ohio","Warren County",2,65,2713,1346,1367
050,39,165,"Ohio","Warren County",2,66,2546,1269,1277
050,39,165,"Ohio","Warren County",2,67,2389,1184,1205
050,39,165,"Ohio","Warren County",2,68,2366,1114,1252
050,39,165,"Ohio","Warren County",2,69,2198,1031,1167
050,39,165,"Ohio","Warren County",2,70,2111,990,1121
050,39,165,"Ohio","Warren County",2,71,2116,993,1123
050,39,165,"Ohio","Warren County",2,72,2049,973,1076
050,39,165,"Ohio","Warren County",2,73,2146,1020,1126
050,39,165,"Ohio","Warren County",2,74,1478,675,803
050,39,165,"Ohio","Warren County",2,75,1416,650,766
050,39,165,"Ohio","Warren County",2,76,1345,626,719
050,39,165,"Ohio","Warren County",2,77,1380,633,747
050,39,165,"Ohio","Warren County",2,78,1158,523,635
050,39,165,"Ohio","Warren County",2,79,1039,463,576
050,39,165,"Ohio","Warren County",2,80,972,438,534
050,39,165,"Ohio","Warren County",2,81,932,426,506
050,39,165,"Ohio","Warren County",2,82,829,346,483
050,39,165,"Ohio","Warren County",2,83,703,282,421
050,39,165,"Ohio","Warren County",2,84,677,281,396
050,39,165,"Ohio","Warren County",2,85,3637,1335,2302
050,39,165,"Ohio","Warren County",3,0,2447,1268,1179
050,39,165,"Ohio","Warren County",3,1,2580,1337,1243
050,39,165,"Ohio","Warren County",3,2,2698,1399,1299
050,39,165,"Ohio","Warren County",3,3,2855,1483,1372
050,39,165,"Ohio","Warren County",3,4,2976,1505,1471
050,39,165,"Ohio","Warren County",3,5,3162,1591,1571
050,39,165,"Ohio","Warren County",3,6,3202,1634,1568
050,39,165,"Ohio","Warren County",3,7,3270,1675,1595
050,39,165,"Ohio","Warren County",3,8,3337,1720,1617
050,39,165,"Ohio","Warren County",3,9,3332,1715,1617
050,39,165,"Ohio","Warren County",3,10,3404,1720,1684
050,39,165,"Ohio","Warren County",3,11,3518,1792,1726
050,39,165,"Ohio","Warren County",3,12,3608,1864,1744
050,39,165,"Ohio","Warren County",3,13,3706,1916,1790
050,39,165,"Ohio","Warren County",3,14,3814,1989,1825
050,39,165,"Ohio","Warren County",3,15,3761,1936,1825
050,39,165,"Ohio","Warren County",3,16,3739,1942,1797
050,39,165,"Ohio","Warren County",3,17,3847,1955,1892
050,39,165,"Ohio","Warren County",3,18,3254,1723,1531
050,39,165,"Ohio","Warren County",3,19,2596,1395,1201
050,39,165,"Ohio","Warren County",3,20,2865,1550,1315
050,39,165,"Ohio","Warren County",3,21,2955,1613,1342
050,39,165,"Ohio","Warren County",3,22,2928,1552,1376
050,39,165,"Ohio","Warren County",3,23,2749,1496,1253
050,39,165,"Ohio","Warren County",3,24,2617,1448,1169
050,39,165,"Ohio","Warren County",3,25,2535,1381,1154
050,39,165,"Ohio","Warren County",3,26,2509,1378,1131
050,39,165,"Ohio","Warren County",3,27,2568,1330,1238
050,39,165,"Ohio","Warren County",3,28,2675,1408,1267
050,39,165,"Ohio","Warren County",3,29,2768,1489,1279
050,39,165,"Ohio","Warren County",3,30,2870,1487,1383
050,39,165,"Ohio","Warren County",3,31,2838,1469,1369
050,39,165,"Ohio","Warren County",3,32,2892,1525,1367
050,39,165,"Ohio","Warren County",3,33,3066,1598,1468
050,39,165,"Ohio","Warren County",3,34,3202,1668,1534
050,39,165,"Ohio","Warren County",3,35,3285,1678,1607
050,39,165,"Ohio","Warren County",3,36,3366,1746,1620
050,39,165,"Ohio","Warren County",3,37,3406,1750,1656
050,39,165,"Ohio","Warren County",3,38,3547,1807,1740
050,39,165,"Ohio","Warren County",3,39,3519,1799,1720
050,39,165,"Ohio","Warren County",3,40,3537,1798,1739
050,39,165,"Ohio","Warren County",3,41,3558,1786,1772
050,39,165,"Ohio","Warren County",3,42,3435,1707,1728
050,39,165,"Ohio","Warren County",3,43,3333,1688,1645
050,39,165,"Ohio","Warren County",3,44,3275,1671,1604
050,39,165,"Ohio","Warren County",3,45,3203,1636,1567
050,39,165,"Ohio","Warren County",3,46,3320,1708,1612
050,39,165,"Ohio","Warren County",3,47,3301,1712,1589
050,39,165,"Ohio","Warren County",3,48,3323,1717,1606
050,39,165,"Ohio","Warren County",3,49,3567,1814,1753
050,39,165,"Ohio","Warren County",3,50,3847,1940,1907
050,39,165,"Ohio","Warren County",3,51,3706,1892,1814
050,39,165,"Ohio","Warren County",3,52,3576,1796,1780
050,39,165,"Ohio","Warren County",3,53,3444,1766,1678
050,39,165,"Ohio","Warren County",3,54,3398,1706,1692
050,39,165,"Ohio","Warren County",3,55,3355,1697,1658
050,39,165,"Ohio","Warren County",3,56,3441,1722,1719
050,39,165,"Ohio","Warren County",3,57,3519,1763,1756
050,39,165,"Ohio","Warren County",3,58,3436,1724,1712
050,39,165,"Ohio","Warren County",3,59,3440,1755,1685
050,39,165,"Ohio","Warren County",3,60,3406,1727,1679
050,39,165,"Ohio","Warren County",3,61,3233,1620,1613
050,39,165,"Ohio","Warren County",3,62,3177,1570,1607
050,39,165,"Ohio","Warren County",3,63,3135,1557,1578
050,39,165,"Ohio","Warren County",3,64,3044,1490,1554
050,39,165,"Ohio","Warren County",3,65,2865,1408,1457
050,39,165,"Ohio","Warren County",3,66,2683,1314,1369
050,39,165,"Ohio","Warren County",3,67,2492,1233,1259
050,39,165,"Ohio","Warren County",3,68,2374,1154,1220
050,39,165,"Ohio","Warren County",3,69,2324,1076,1248
050,39,165,"Ohio","Warren County",3,70,2187,1027,1160
050,39,165,"Ohio","Warren County",3,71,2083,964,1119
050,39,165,"Ohio","Warren County",3,72,2104,982,1122
050,39,165,"Ohio","Warren County",3,73,1979,938,1041
050,39,165,"Ohio","Warren County",3,74,2104,994,1110
050,39,165,"Ohio","Warren County",3,75,1433,630,803
050,39,165,"Ohio","Warren County",3,76,1361,617,744
050,39,165,"Ohio","Warren County",3,77,1298,608,690
050,39,165,"Ohio","Warren County",3,78,1367,612,755
050,39,165,"Ohio","Warren County",3,79,1109,498,611
050,39,165,"Ohio","Warren County",3,80,993,439,554
050,39,165,"Ohio","Warren County",3,81,926,416,510
050,39,165,"Ohio","Warren County",3,82,845,380,465
050,39,165,"Ohio","Warren County",3,83,747,304,443
050,39,165,"Ohio","Warren County",3,84,649,255,394
050,39,165,"Ohio","Warren County",3,85,3630,1355,2275
050,39,165,"Ohio","Warren County",4,0,2474,1270,1204
050,39,165,"Ohio","Warren County",4,1,2685,1385,1300
050,39,165,"Ohio","Warren County",4,2,2751,1432,1319
050,39,165,"Ohio","Warren County",4,3,2849,1471,1378
050,39,165,"Ohio","Warren County",4,4,2980,1519,1461
050,39,165,"Ohio","Warren County",4,5,3098,1558,1540
050,39,165,"Ohio","Warren County",4,6,3267,1675,1592
050,39,165,"Ohio","Warren County",4,7,3310,1685,1625
050,39,165,"Ohio","Warren County",4,8,3358,1723,1635
050,39,165,"Ohio","Warren County",4,9,3414,1746,1668
050,39,165,"Ohio","Warren County",4,10,3398,1747,1651
050,39,165,"Ohio","Warren County",4,11,3457,1761,1696
050,39,165,"Ohio","Warren County",4,12,3598,1829,1769
050,39,165,"Ohio","Warren County",4,13,3664,1905,1759
050,39,165,"Ohio","Warren County",4,14,3739,1937,1802
050,39,165,"Ohio","Warren County",4,15,3844,1974,1870
050,39,165,"Ohio","Warren County",4,16,3803,1970,1833
050,39,165,"Ohio","Warren County",4,17,3755,1945,1810
050,39,165,"Ohio","Warren County",4,18,3258,1730,1528
050,39,165,"Ohio","Warren County",4,19,2530,1347,1183
050,39,165,"Ohio","Warren County",4,20,2760,1508,1252
050,39,165,"Ohio","Warren County",4,21,2994,1621,1373
050,39,165,"Ohio","Warren County",4,22,3059,1639,1420
050,39,165,"Ohio","Warren County",4,23,2932,1553,1379
050,39,165,"Ohio","Warren County",4,24,2637,1449,1188
050,39,165,"Ohio","Warren County",4,25,2518,1373,1145
050,39,165,"Ohio","Warren County",4,26,2527,1356,1171
050,39,165,"Ohio","Warren County",4,27,2538,1350,1188
050,39,165,"Ohio","Warren County",4,28,2660,1390,1270
050,39,165,"Ohio","Warren County",4,29,2757,1435,1322
050,39,165,"Ohio","Warren County",4,30,2897,1542,1355
050,39,165,"Ohio","Warren County",4,31,3019,1502,1517
050,39,165,"Ohio","Warren County",4,32,3010,1556,1454
050,39,165,"Ohio","Warren County",4,33,3075,1595,1480
050,39,165,"Ohio","Warren County",4,34,3178,1658,1520
050,39,165,"Ohio","Warren County",4,35,3354,1758,1596
050,39,165,"Ohio","Warren County",4,36,3404,1760,1644
050,39,165,"Ohio","Warren County",4,37,3466,1822,1644
050,39,165,"Ohio","Warren County",4,38,3506,1784,1722
050,39,165,"Ohio","Warren County",4,39,3578,1810,1768
050,39,165,"Ohio","Warren County",4,40,3578,1818,1760
050,39,165,"Ohio","Warren County",4,41,3595,1839,1756
050,39,165,"Ohio","Warren County",4,42,3627,1807,1820
050,39,165,"Ohio","Warren County",4,43,3488,1749,1739
050,39,165,"Ohio","Warren County",4,44,3375,1676,1699
050,39,165,"Ohio","Warren County",4,45,3307,1697,1610
050,39,165,"Ohio","Warren County",4,46,3192,1609,1583
050,39,165,"Ohio","Warren County",4,47,3355,1717,1638
050,39,165,"Ohio","Warren County",4,48,3310,1725,1585
050,39,165,"Ohio","Warren County",4,49,3342,1725,1617
050,39,165,"Ohio","Warren County",4,50,3522,1788,1734
050,39,165,"Ohio","Warren County",4,51,3832,1938,1894
050,39,165,"Ohio","Warren County",4,52,3695,1876,1819
050,39,165,"Ohio","Warren County",4,53,3575,1813,1762
050,39,165,"Ohio","Warren County",4,54,3421,1735,1686
050,39,165,"Ohio","Warren County",4,55,3352,1685,1667
050,39,165,"Ohio","Warren County",4,56,3318,1679,1639
050,39,165,"Ohio","Warren County",4,57,3422,1710,1712
050,39,165,"Ohio","Warren County",4,58,3461,1734,1727
050,39,165,"Ohio","Warren County",4,59,3403,1719,1684
050,39,165,"Ohio","Warren County",4,60,3448,1728,1720
050,39,165,"Ohio","Warren County",4,61,3372,1719,1653
050,39,165,"Ohio","Warren County",4,62,3176,1574,1602
050,39,165,"Ohio","Warren County",4,63,3137,1552,1585
050,39,165,"Ohio","Warren County",4,64,3074,1514,1560
050,39,165,"Ohio","Warren County",4,65,3020,1462,1558
050,39,165,"Ohio","Warren County",4,66,2833,1378,1455
050,39,165,"Ohio","Warren County",4,67,2654,1298,1356
050,39,165,"Ohio","Warren County",4,68,2469,1217,1252
050,39,165,"Ohio","Warren County",4,69,2312,1110,1202
050,39,165,"Ohio","Warren County",4,70,2324,1082,1242
050,39,165,"Ohio","Warren County",4,71,2154,1000,1154
050,39,165,"Ohio","Warren County",4,72,2049,950,1099
050,39,165,"Ohio","Warren County",4,73,2056,963,1093
050,39,165,"Ohio","Warren County",4,74,1932,902,1030
050,39,165,"Ohio","Warren County",4,75,2074,963,1111
050,39,165,"Ohio","Warren County",4,76,1398,614,784
050,39,165,"Ohio","Warren County",4,77,1345,613,732
050,39,165,"Ohio","Warren County",4,78,1261,587,674
050,39,165,"Ohio","Warren County",4,79,1347,595,752
050,39,165,"Ohio","Warren County",4,80,1072,484,588
050,39,165,"Ohio","Warren County",4,81,956,419,537
050,39,165,"Ohio","Warren County",4,82,863,374,489
050,39,165,"Ohio","Warren County",4,83,776,351,425
050,39,165,"Ohio","Warren County",4,84,691,281,410
050,39,165,"Ohio","Warren County",4,85,3671,1369,2302
050,39,165,"Ohio","Warren County",5,0,2447,1254,1193
050,39,165,"Ohio","Warren County",5,1,2665,1366,1299
050,39,165,"Ohio","Warren County",5,2,2819,1461,1358
050,39,165,"Ohio","Warren County",5,3,2859,1478,1381
050,39,165,"Ohio","Warren County",5,4,2936,1505,1431
050,39,165,"Ohio","Warren County",5,5,3119,1595,1524
050,39,165,"Ohio","Warren County",5,6,3181,1596,1585
050,39,165,"Ohio","Warren County",5,7,3350,1705,1645
050,39,165,"Ohio","Warren County",5,8,3385,1704,1681
050,39,165,"Ohio","Warren County",5,9,3448,1775,1673
050,39,165,"Ohio","Warren County",5,10,3481,1764,1717
050,39,165,"Ohio","Warren County",5,11,3451,1789,1662
050,39,165,"Ohio","Warren County",5,12,3515,1788,1727
050,39,165,"Ohio","Warren County",5,13,3656,1845,1811
050,39,165,"Ohio","Warren County",5,14,3707,1909,1798
050,39,165,"Ohio","Warren County",5,15,3770,1953,1817
050,39,165,"Ohio","Warren County",5,16,3856,1989,1867
050,39,165,"Ohio","Warren County",5,17,3849,2004,1845
050,39,165,"Ohio","Warren County",5,18,3177,1721,1456
050,39,165,"Ohio","Warren County",5,19,2554,1381,1173
050,39,165,"Ohio","Warren County",5,20,2807,1502,1305
050,39,165,"Ohio","Warren County",5,21,2878,1556,1322
050,39,165,"Ohio","Warren County",5,22,3085,1627,1458
050,39,165,"Ohio","Warren County",5,23,3031,1598,1433
050,39,165,"Ohio","Warren County",5,24,2769,1479,1290
050,39,165,"Ohio","Warren County",5,25,2647,1441,1206
050,39,165,"Ohio","Warren County",5,26,2512,1354,1158
050,39,165,"Ohio","Warren County",5,27,2596,1371,1225
050,39,165,"Ohio","Warren County",5,28,2579,1365,1214
050,39,165,"Ohio","Warren County",5,29,2790,1440,1350
050,39,165,"Ohio","Warren County",5,30,2765,1428,1337
050,39,165,"Ohio","Warren County",5,31,2987,1569,1418
050,39,165,"Ohio","Warren County",5,32,3152,1578,1574
050,39,165,"Ohio","Warren County",5,33,3086,1577,1509
050,39,165,"Ohio","Warren County",5,34,3204,1679,1525
050,39,165,"Ohio","Warren County",5,35,3285,1723,1562
050,39,165,"Ohio","Warren County",5,36,3396,1761,1635
050,39,165,"Ohio","Warren County",5,37,3451,1772,1679
050,39,165,"Ohio","Warren County",5,38,3526,1853,1673
050,39,165,"Ohio","Warren County",5,39,3569,1808,1761
050,39,165,"Ohio","Warren County",5,40,3585,1808,1777
050,39,165,"Ohio","Warren County",5,41,3634,1832,1802
050,39,165,"Ohio","Warren County",5,42,3617,1849,1768
050,39,165,"Ohio","Warren County",5,43,3652,1822,1830
050,39,165,"Ohio","Warren County",5,44,3484,1753,1731
050,39,165,"Ohio","Warren County",5,45,3381,1659,1722
050,39,165,"Ohio","Warren County",5,46,3350,1715,1635
050,39,165,"Ohio","Warren County",5,47,3209,1623,1586
050,39,165,"Ohio","Warren County",5,48,3398,1738,1660
050,39,165,"Ohio","Warren County",5,49,3303,1727,1576
050,39,165,"Ohio","Warren County",5,50,3314,1719,1595
050,39,165,"Ohio","Warren County",5,51,3524,1806,1718
050,39,165,"Ohio","Warren County",5,52,3788,1900,1888
050,39,165,"Ohio","Warren County",5,53,3665,1867,1798
050,39,165,"Ohio","Warren County",5,54,3534,1782,1752
050,39,165,"Ohio","Warren County",5,55,3444,1741,1703
050,39,165,"Ohio","Warren County",5,56,3341,1672,1669
050,39,165,"Ohio","Warren County",5,57,3280,1661,1619
050,39,165,"Ohio","Warren County",5,58,3393,1695,1698
050,39,165,"Ohio","Warren County",5,59,3415,1720,1695
050,39,165,"Ohio","Warren County",5,60,3348,1681,1667
050,39,165,"Ohio","Warren County",5,61,3402,1702,1700
050,39,165,"Ohio","Warren County",5,62,3327,1685,1642
050,39,165,"Ohio","Warren County",5,63,3162,1560,1602
050,39,165,"Ohio","Warren County",5,64,3085,1522,1563
050,39,165,"Ohio","Warren County",5,65,3056,1503,1553
050,39,165,"Ohio","Warren County",5,66,3007,1444,1563
050,39,165,"Ohio","Warren County",5,67,2800,1346,1454
050,39,165,"Ohio","Warren County",5,68,2649,1299,1350
050,39,165,"Ohio","Warren County",5,69,2441,1201,1240
050,39,165,"Ohio","Warren County",5,70,2309,1109,1200
050,39,165,"Ohio","Warren County",5,71,2316,1070,1246
050,39,165,"Ohio","Warren County",5,72,2122,975,1147
050,39,165,"Ohio","Warren County",5,73,1981,914,1067
050,39,165,"Ohio","Warren County",5,74,2018,936,1082
050,39,165,"Ohio","Warren County",5,75,1911,874,1037
050,39,165,"Ohio","Warren County",5,76,2040,935,1105
050,39,165,"Ohio","Warren County",5,77,1402,624,778
050,39,165,"Ohio","Warren County",5,78,1319,584,735
050,39,165,"Ohio","Warren County",5,79,1239,576,663
050,39,165,"Ohio","Warren County",5,80,1272,568,704
050,39,165,"Ohio","Warren County",5,81,1048,469,579
050,39,165,"Ohio","Warren County",5,82,898,385,513
050,39,165,"Ohio","Warren County",5,83,797,345,452
050,39,165,"Ohio","Warren County",5,84,741,335,406
050,39,165,"Ohio","Warren County",5,85,3807,1441,2366
050,39,167,"Ohio","Washington County",1,0,585,299,286
050,39,167,"Ohio","Washington County",1,1,581,286,295
050,39,167,"Ohio","Washington County",1,2,598,307,291
050,39,167,"Ohio","Washington County",1,3,607,310,297
050,39,167,"Ohio","Washington County",1,4,623,320,303
050,39,167,"Ohio","Washington County",1,5,610,318,292
050,39,167,"Ohio","Washington County",1,6,644,336,308
050,39,167,"Ohio","Washington County",1,7,672,324,348
050,39,167,"Ohio","Washington County",1,8,666,336,330
050,39,167,"Ohio","Washington County",1,9,685,349,336
050,39,167,"Ohio","Washington County",1,10,660,351,309
050,39,167,"Ohio","Washington County",1,11,695,363,332
050,39,167,"Ohio","Washington County",1,12,703,352,351
050,39,167,"Ohio","Washington County",1,13,706,352,354
050,39,167,"Ohio","Washington County",1,14,715,356,359
050,39,167,"Ohio","Washington County",1,15,698,339,359
050,39,167,"Ohio","Washington County",1,16,764,379,385
050,39,167,"Ohio","Washington County",1,17,760,380,380
050,39,167,"Ohio","Washington County",1,18,746,392,354
050,39,167,"Ohio","Washington County",1,19,740,382,358
050,39,167,"Ohio","Washington County",1,20,751,402,349
050,39,167,"Ohio","Washington County",1,21,724,365,359
050,39,167,"Ohio","Washington County",1,22,727,363,364
050,39,167,"Ohio","Washington County",1,23,695,363,332
050,39,167,"Ohio","Washington County",1,24,661,358,303
050,39,167,"Ohio","Washington County",1,25,697,361,336
050,39,167,"Ohio","Washington County",1,26,670,334,336
050,39,167,"Ohio","Washington County",1,27,695,355,340
050,39,167,"Ohio","Washington County",1,28,703,365,338
050,39,167,"Ohio","Washington County",1,29,715,368,347
050,39,167,"Ohio","Washington County",1,30,674,333,341
050,39,167,"Ohio","Washington County",1,31,663,344,319
050,39,167,"Ohio","Washington County",1,32,630,316,314
050,39,167,"Ohio","Washington County",1,33,631,316,315
050,39,167,"Ohio","Washington County",1,34,671,349,322
050,39,167,"Ohio","Washington County",1,35,674,356,318
050,39,167,"Ohio","Washington County",1,36,694,359,335
050,39,167,"Ohio","Washington County",1,37,700,352,348
050,39,167,"Ohio","Washington County",1,38,697,363,334
050,39,167,"Ohio","Washington County",1,39,709,350,359
050,39,167,"Ohio","Washington County",1,40,732,376,356
050,39,167,"Ohio","Washington County",1,41,683,342,341
050,39,167,"Ohio","Washington County",1,42,656,323,333
050,39,167,"Ohio","Washington County",1,43,625,316,309
050,39,167,"Ohio","Washington County",1,44,672,327,345
050,39,167,"Ohio","Washington County",1,45,684,322,362
050,39,167,"Ohio","Washington County",1,46,686,315,371
050,39,167,"Ohio","Washington County",1,47,723,350,373
050,39,167,"Ohio","Washington County",1,48,737,363,374
050,39,167,"Ohio","Washington County",1,49,779,382,397
050,39,167,"Ohio","Washington County",1,50,766,389,377
050,39,167,"Ohio","Washington County",1,51,773,396,377
050,39,167,"Ohio","Washington County",1,52,751,394,357
050,39,167,"Ohio","Washington County",1,53,762,386,376
050,39,167,"Ohio","Washington County",1,54,775,381,394
050,39,167,"Ohio","Washington County",1,55,824,419,405
050,39,167,"Ohio","Washington County",1,56,850,417,433
050,39,167,"Ohio","Washington County",1,57,853,415,438
050,39,167,"Ohio","Washington County",1,58,908,453,455
050,39,167,"Ohio","Washington County",1,59,930,445,485
050,39,167,"Ohio","Washington County",1,60,943,465,478
050,39,167,"Ohio","Washington County",1,61,946,469,477
050,39,167,"Ohio","Washington County",1,62,966,477,489
050,39,167,"Ohio","Washington County",1,63,937,461,476
050,39,167,"Ohio","Washington County",1,64,855,445,410
050,39,167,"Ohio","Washington County",1,65,892,463,429
050,39,167,"Ohio","Washington County",1,66,876,448,428
050,39,167,"Ohio","Washington County",1,67,817,395,422
050,39,167,"Ohio","Washington County",1,68,785,371,414
050,39,167,"Ohio","Washington County",1,69,747,363,384
050,39,167,"Ohio","Washington County",1,70,694,333,361
050,39,167,"Ohio","Washington County",1,71,711,359,352
050,39,167,"Ohio","Washington County",1,72,704,339,365
050,39,167,"Ohio","Washington County",1,73,739,352,387
050,39,167,"Ohio","Washington County",1,74,475,214,261
050,39,167,"Ohio","Washington County",1,75,481,212,269
050,39,167,"Ohio","Washington County",1,76,490,212,278
050,39,167,"Ohio","Washington County",1,77,518,229,289
050,39,167,"Ohio","Washington County",1,78,457,204,253
050,39,167,"Ohio","Washington County",1,79,410,197,213
050,39,167,"Ohio","Washington County",1,80,375,170,205
050,39,167,"Ohio","Washington County",1,81,346,154,192
050,39,167,"Ohio","Washington County",1,82,293,136,157
050,39,167,"Ohio","Washington County",1,83,278,116,162
050,39,167,"Ohio","Washington County",1,84,253,106,147
050,39,167,"Ohio","Washington County",1,85,1371,506,865
050,39,167,"Ohio","Washington County",2,0,567,279,288
050,39,167,"Ohio","Washington County",2,1,581,289,292
050,39,167,"Ohio","Washington County",2,2,594,302,292
050,39,167,"Ohio","Washington County",2,3,605,308,297
050,39,167,"Ohio","Washington County",2,4,622,318,304
050,39,167,"Ohio","Washington County",2,5,614,318,296
050,39,167,"Ohio","Washington County",2,6,638,333,305
050,39,167,"Ohio","Washington County",2,7,663,326,337
050,39,167,"Ohio","Washington County",2,8,668,332,336
050,39,167,"Ohio","Washington County",2,9,681,345,336
050,39,167,"Ohio","Washington County",2,10,664,349,315
050,39,167,"Ohio","Washington County",2,11,681,356,325
050,39,167,"Ohio","Washington County",2,12,706,356,350
050,39,167,"Ohio","Washington County",2,13,707,353,354
050,39,167,"Ohio","Washington County",2,14,710,353,357
050,39,167,"Ohio","Washington County",2,15,703,345,358
050,39,167,"Ohio","Washington County",2,16,750,372,378
050,39,167,"Ohio","Washington County",2,17,763,382,381
050,39,167,"Ohio","Washington County",2,18,737,386,351
050,39,167,"Ohio","Washington County",2,19,746,385,361
050,39,167,"Ohio","Washington County",2,20,755,400,355
050,39,167,"Ohio","Washington County",2,21,732,372,360
050,39,167,"Ohio","Washington County",2,22,720,360,360
050,39,167,"Ohio","Washington County",2,23,688,357,331
050,39,167,"Ohio","Washington County",2,24,667,358,309
050,39,167,"Ohio","Washington County",2,25,684,359,325
050,39,167,"Ohio","Washington County",2,26,674,340,334
050,39,167,"Ohio","Washington County",2,27,687,350,337
050,39,167,"Ohio","Washington County",2,28,703,366,337
050,39,167,"Ohio","Washington County",2,29,709,366,343
050,39,167,"Ohio","Washington County",2,30,688,343,345
050,39,167,"Ohio","Washington County",2,31,664,341,323
050,39,167,"Ohio","Washington County",2,32,635,321,314
050,39,167,"Ohio","Washington County",2,33,631,314,317
050,39,167,"Ohio","Washington County",2,34,663,342,321
050,39,167,"Ohio","Washington County",2,35,675,355,320
050,39,167,"Ohio","Washington County",2,36,684,355,329
050,39,167,"Ohio","Washington County",2,37,698,354,344
050,39,167,"Ohio","Washington County",2,38,700,361,339
050,39,167,"Ohio","Washington County",2,39,701,351,350
050,39,167,"Ohio","Washington County",2,40,728,371,357
050,39,167,"Ohio","Washington County",2,41,692,349,343
050,39,167,"Ohio","Washington County",2,42,654,323,331
050,39,167,"Ohio","Washington County",2,43,633,318,315
050,39,167,"Ohio","Washington County",2,44,655,321,334
050,39,167,"Ohio","Washington County",2,45,689,324,365
050,39,167,"Ohio","Washington County",2,46,682,315,367
050,39,167,"Ohio","Washington County",2,47,712,341,371
050,39,167,"Ohio","Washington County",2,48,729,358,371
050,39,167,"Ohio","Washington County",2,49,774,380,394
050,39,167,"Ohio","Washington County",2,50,768,386,382
050,39,167,"Ohio","Washington County",2,51,768,392,376
050,39,167,"Ohio","Washington County",2,52,757,395,362
050,39,167,"Ohio","Washington County",2,53,757,387,370
050,39,167,"Ohio","Washington County",2,54,769,382,387
050,39,167,"Ohio","Washington County",2,55,809,408,401
050,39,167,"Ohio","Washington County",2,56,848,416,432
050,39,167,"Ohio","Washington County",2,57,854,416,438
050,39,167,"Ohio","Washington County",2,58,888,437,451
050,39,167,"Ohio","Washington County",2,59,927,449,478
050,39,167,"Ohio","Washington County",2,60,937,461,476
050,39,167,"Ohio","Washington County",2,61,938,466,472
050,39,167,"Ohio","Washington County",2,62,959,473,486
050,39,167,"Ohio","Washington County",2,63,949,465,484
050,39,167,"Ohio","Washington County",2,64,866,443,423
050,39,167,"Ohio","Washington County",2,65,874,453,421
050,39,167,"Ohio","Washington County",2,66,879,451,428
050,39,167,"Ohio","Washington County",2,67,823,402,421
050,39,167,"Ohio","Washington County",2,68,789,376,413
050,39,167,"Ohio","Washington County",2,69,759,364,395
050,39,167,"Ohio","Washington County",2,70,702,338,364
050,39,167,"Ohio","Washington County",2,71,700,350,350
050,39,167,"Ohio","Washington County",2,72,688,334,354
050,39,167,"Ohio","Washington County",2,73,759,358,401
050,39,167,"Ohio","Washington County",2,74,499,227,272
050,39,167,"Ohio","Washington County",2,75,480,212,268
050,39,167,"Ohio","Washington County",2,76,477,206,271
050,39,167,"Ohio","Washington County",2,77,521,229,292
050,39,167,"Ohio","Washington County",2,78,456,202,254
050,39,167,"Ohio","Washington County",2,79,413,195,218
050,39,167,"Ohio","Washington County",2,80,376,172,204
050,39,167,"Ohio","Washington County",2,81,346,157,189
050,39,167,"Ohio","Washington County",2,82,301,139,162
050,39,167,"Ohio","Washington County",2,83,275,118,157
050,39,167,"Ohio","Washington County",2,84,252,106,146
050,39,167,"Ohio","Washington County",2,85,1378,505,873
050,39,167,"Ohio","Washington County",3,0,550,285,265
050,39,167,"Ohio","Washington County",3,1,575,284,291
050,39,167,"Ohio","Washington County",3,2,578,289,289
050,39,167,"Ohio","Washington County",3,3,586,302,284
050,39,167,"Ohio","Washington County",3,4,626,315,311
050,39,167,"Ohio","Washington County",3,5,603,315,288
050,39,167,"Ohio","Washington County",3,6,619,328,291
050,39,167,"Ohio","Washington County",3,7,633,334,299
050,39,167,"Ohio","Washington County",3,8,672,334,338
050,39,167,"Ohio","Washington County",3,9,671,329,342
050,39,167,"Ohio","Washington County",3,10,680,351,329
050,39,167,"Ohio","Washington County",3,11,663,354,309
050,39,167,"Ohio","Washington County",3,12,693,365,328
050,39,167,"Ohio","Washington County",3,13,722,366,356
050,39,167,"Ohio","Washington County",3,14,715,361,354
050,39,167,"Ohio","Washington County",3,15,721,358,363
050,39,167,"Ohio","Washington County",3,16,712,348,364
050,39,167,"Ohio","Washington County",3,17,757,377,380
050,39,167,"Ohio","Washington County",3,18,768,402,366
050,39,167,"Ohio","Washington County",3,19,755,381,374
050,39,167,"Ohio","Washington County",3,20,756,388,368
050,39,167,"Ohio","Washington County",3,21,760,399,361
050,39,167,"Ohio","Washington County",3,22,685,345,340
050,39,167,"Ohio","Washington County",3,23,650,323,327
050,39,167,"Ohio","Washington County",3,24,678,347,331
050,39,167,"Ohio","Washington County",3,25,643,347,296
050,39,167,"Ohio","Washington County",3,26,688,353,335
050,39,167,"Ohio","Washington County",3,27,699,346,353
050,39,167,"Ohio","Washington County",3,28,686,355,331
050,39,167,"Ohio","Washington County",3,29,690,374,316
050,39,167,"Ohio","Washington County",3,30,705,353,352
050,39,167,"Ohio","Washington County",3,31,684,325,359
050,39,167,"Ohio","Washington County",3,32,679,344,335
050,39,167,"Ohio","Washington County",3,33,634,320,314
050,39,167,"Ohio","Washington County",3,34,645,320,325
050,39,167,"Ohio","Washington County",3,35,678,353,325
050,39,167,"Ohio","Washington County",3,36,680,354,326
050,39,167,"Ohio","Washington County",3,37,680,351,329
050,39,167,"Ohio","Washington County",3,38,694,352,342
050,39,167,"Ohio","Washington County",3,39,708,371,337
050,39,167,"Ohio","Washington County",3,40,705,359,346
050,39,167,"Ohio","Washington County",3,41,726,363,363
050,39,167,"Ohio","Washington County",3,42,689,345,344
050,39,167,"Ohio","Washington County",3,43,650,320,330
050,39,167,"Ohio","Washington County",3,44,629,314,315
050,39,167,"Ohio","Washington County",3,45,661,322,339
050,39,167,"Ohio","Washington County",3,46,676,324,352
050,39,167,"Ohio","Washington County",3,47,680,313,367
050,39,167,"Ohio","Washington County",3,48,716,346,370
050,39,167,"Ohio","Washington County",3,49,738,362,376
050,39,167,"Ohio","Washington County",3,50,760,368,392
050,39,167,"Ohio","Washington County",3,51,772,386,386
050,39,167,"Ohio","Washington County",3,52,771,385,386
050,39,167,"Ohio","Washington County",3,53,757,394,363
050,39,167,"Ohio","Washington County",3,54,749,385,364
050,39,167,"Ohio","Washington County",3,55,762,382,380
050,39,167,"Ohio","Washington County",3,56,803,400,403
050,39,167,"Ohio","Washington County",3,57,851,416,435
050,39,167,"Ohio","Washington County",3,58,845,417,428
050,39,167,"Ohio","Washington County",3,59,876,432,444
050,39,167,"Ohio","Washington County",3,60,919,446,473
050,39,167,"Ohio","Washington County",3,61,911,440,471
050,39,167,"Ohio","Washington County",3,62,932,459,473
050,39,167,"Ohio","Washington County",3,63,927,450,477
050,39,167,"Ohio","Washington County",3,64,943,457,486
050,39,167,"Ohio","Washington County",3,65,854,438,416
050,39,167,"Ohio","Washington County",3,66,864,450,414
050,39,167,"Ohio","Washington County",3,67,856,440,416
050,39,167,"Ohio","Washington County",3,68,811,400,411
050,39,167,"Ohio","Washington County",3,69,767,364,403
050,39,167,"Ohio","Washington County",3,70,739,354,385
050,39,167,"Ohio","Washington County",3,71,678,326,352
050,39,167,"Ohio","Washington County",3,72,682,340,342
050,39,167,"Ohio","Washington County",3,73,678,326,352
050,39,167,"Ohio","Washington County",3,74,722,334,388
050,39,167,"Ohio","Washington County",3,75,488,222,266
050,39,167,"Ohio","Washington County",3,76,470,203,267
050,39,167,"Ohio","Washington County",3,77,465,200,265
050,39,167,"Ohio","Washington County",3,78,490,211,279
050,39,167,"Ohio","Washington County",3,79,432,191,241
050,39,167,"Ohio","Washington County",3,80,389,177,212
050,39,167,"Ohio","Washington County",3,81,352,161,191
050,39,167,"Ohio","Washington County",3,82,319,142,177
050,39,167,"Ohio","Washington County",3,83,286,130,156
050,39,167,"Ohio","Washington County",3,84,249,100,149
050,39,167,"Ohio","Washington County",3,85,1426,526,900
050,39,167,"Ohio","Washington County",4,0,539,280,259
050,39,167,"Ohio","Washington County",4,1,554,281,273
050,39,167,"Ohio","Washington County",4,2,554,271,283
050,39,167,"Ohio","Washington County",4,3,571,277,294
050,39,167,"Ohio","Washington County",4,4,579,294,285
050,39,167,"Ohio","Washington County",4,5,617,310,307
050,39,167,"Ohio","Washington County",4,6,598,320,278
050,39,167,"Ohio","Washington County",4,7,598,310,288
050,39,167,"Ohio","Washington County",4,8,652,342,310
050,39,167,"Ohio","Washington County",4,9,658,328,330
050,39,167,"Ohio","Washington County",4,10,671,329,342
050,39,167,"Ohio","Washington County",4,11,676,344,332
050,39,167,"Ohio","Washington County",4,12,670,357,313
050,39,167,"Ohio","Washington County",4,13,691,363,328
050,39,167,"Ohio","Washington County",4,14,731,378,353
050,39,167,"Ohio","Washington County",4,15,716,363,353
050,39,167,"Ohio","Washington County",4,16,726,358,368
050,39,167,"Ohio","Washington County",4,17,720,341,379
050,39,167,"Ohio","Washington County",4,18,734,390,344
050,39,167,"Ohio","Washington County",4,19,753,389,364
050,39,167,"Ohio","Washington County",4,20,765,382,383
050,39,167,"Ohio","Washington County",4,21,759,386,373
050,39,167,"Ohio","Washington County",4,22,732,384,348
050,39,167,"Ohio","Washington County",4,23,641,325,316
050,39,167,"Ohio","Washington County",4,24,648,334,314
050,39,167,"Ohio","Washington County",4,25,684,352,332
050,39,167,"Ohio","Washington County",4,26,625,337,288
050,39,167,"Ohio","Washington County",4,27,678,345,333
050,39,167,"Ohio","Washington County",4,28,681,342,339
050,39,167,"Ohio","Washington County",4,29,680,346,334
050,39,167,"Ohio","Washington County",4,30,710,376,334
050,39,167,"Ohio","Washington County",4,31,688,351,337
050,39,167,"Ohio","Washington County",4,32,677,330,347
050,39,167,"Ohio","Washington County",4,33,673,334,339
050,39,167,"Ohio","Washington County",4,34,627,314,313
050,39,167,"Ohio","Washington County",4,35,657,330,327
050,39,167,"Ohio","Washington County",4,36,668,352,316
050,39,167,"Ohio","Washington County",4,37,676,356,320
050,39,167,"Ohio","Washington County",4,38,674,351,323
050,39,167,"Ohio","Washington County",4,39,683,343,340
050,39,167,"Ohio","Washington County",4,40,728,372,356
050,39,167,"Ohio","Washington County",4,41,707,361,346
050,39,167,"Ohio","Washington County",4,42,725,360,365
050,39,167,"Ohio","Washington County",4,43,693,347,346
050,39,167,"Ohio","Washington County",4,44,641,323,318
050,39,167,"Ohio","Washington County",4,45,636,321,315
050,39,167,"Ohio","Washington County",4,46,649,317,332
050,39,167,"Ohio","Washington County",4,47,686,329,357
050,39,167,"Ohio","Washington County",4,48,667,308,359
050,39,167,"Ohio","Washington County",4,49,708,342,366
050,39,167,"Ohio","Washington County",4,50,720,347,373
050,39,167,"Ohio","Washington County",4,51,755,371,384
050,39,167,"Ohio","Washington County",4,52,761,377,384
050,39,167,"Ohio","Washington County",4,53,751,382,369
050,39,167,"Ohio","Washington County",4,54,750,380,370
050,39,167,"Ohio","Washington County",4,55,741,380,361
050,39,167,"Ohio","Washington County",4,56,752,376,376
050,39,167,"Ohio","Washington County",4,57,807,406,401
050,39,167,"Ohio","Washington County",4,58,842,418,424
050,39,167,"Ohio","Washington County",4,59,825,408,417
050,39,167,"Ohio","Washington County",4,60,867,426,441
050,39,167,"Ohio","Washington County",4,61,902,433,469
050,39,167,"Ohio","Washington County",4,62,889,422,467
050,39,167,"Ohio","Washington County",4,63,917,447,470
050,39,167,"Ohio","Washington County",4,64,903,440,463
050,39,167,"Ohio","Washington County",4,65,936,454,482
050,39,167,"Ohio","Washington County",4,66,825,425,400
050,39,167,"Ohio","Washington County",4,67,841,436,405
050,39,167,"Ohio","Washington County",4,68,840,433,407
050,39,167,"Ohio","Washington County",4,69,796,390,406
050,39,167,"Ohio","Washington County",4,70,741,352,389
050,39,167,"Ohio","Washington County",4,71,705,339,366
050,39,167,"Ohio","Washington County",4,72,654,318,336
050,39,167,"Ohio","Washington County",4,73,682,328,354
050,39,167,"Ohio","Washington County",4,74,633,305,328
050,39,167,"Ohio","Washington County",4,75,696,326,370
050,39,167,"Ohio","Washington County",4,76,463,202,261
050,39,167,"Ohio","Washington County",4,77,464,203,261
050,39,167,"Ohio","Washington County",4,78,427,173,254
050,39,167,"Ohio","Washington County",4,79,457,196,261
050,39,167,"Ohio","Washington County",4,80,393,164,229
050,39,167,"Ohio","Washington County",4,81,369,174,195
050,39,167,"Ohio","Washington County",4,82,321,138,183
050,39,167,"Ohio","Washington County",4,83,295,131,164
050,39,167,"Ohio","Washington County",4,84,253,111,142
050,39,167,"Ohio","Washington County",4,85,1421,523,898
050,39,167,"Ohio","Washington County",5,0,517,261,256
050,39,167,"Ohio","Washington County",5,1,559,291,268
050,39,167,"Ohio","Washington County",5,2,548,284,264
050,39,167,"Ohio","Washington County",5,3,558,281,277
050,39,167,"Ohio","Washington County",5,4,592,294,298
050,39,167,"Ohio","Washington County",5,5,594,299,295
050,39,167,"Ohio","Washington County",5,6,618,315,303
050,39,167,"Ohio","Washington County",5,7,609,321,288
050,39,167,"Ohio","Washington County",5,8,604,319,285
050,39,167,"Ohio","Washington County",5,9,661,341,320
050,39,167,"Ohio","Washington County",5,10,664,328,336
050,39,167,"Ohio","Washington County",5,11,656,334,322
050,39,167,"Ohio","Washington County",5,12,672,337,335
050,39,167,"Ohio","Washington County",5,13,675,364,311
050,39,167,"Ohio","Washington County",5,14,696,364,332
050,39,167,"Ohio","Washington County",5,15,725,374,351
050,39,167,"Ohio","Washington County",5,16,716,360,356
050,39,167,"Ohio","Washington County",5,17,736,368,368
050,39,167,"Ohio","Washington County",5,18,690,352,338
050,39,167,"Ohio","Washington County",5,19,728,376,352
050,39,167,"Ohio","Washington County",5,20,773,396,377
050,39,167,"Ohio","Washington County",5,21,749,378,371
050,39,167,"Ohio","Washington County",5,22,707,358,349
050,39,167,"Ohio","Washington County",5,23,672,348,324
050,39,167,"Ohio","Washington County",5,24,640,332,308
050,39,167,"Ohio","Washington County",5,25,609,315,294
050,39,167,"Ohio","Washington County",5,26,671,349,322
050,39,167,"Ohio","Washington County",5,27,647,349,298
050,39,167,"Ohio","Washington County",5,28,678,339,339
050,39,167,"Ohio","Washington County",5,29,685,344,341
050,39,167,"Ohio","Washington County",5,30,687,348,339
050,39,167,"Ohio","Washington County",5,31,707,371,336
050,39,167,"Ohio","Washington County",5,32,678,349,329
050,39,167,"Ohio","Washington County",5,33,686,335,351
050,39,167,"Ohio","Washington County",5,34,676,336,340
050,39,167,"Ohio","Washington County",5,35,643,325,318
050,39,167,"Ohio","Washington County",5,36,652,327,325
050,39,167,"Ohio","Washington County",5,37,663,345,318
050,39,167,"Ohio","Washington County",5,38,686,357,329
050,39,167,"Ohio","Washington County",5,39,666,344,322
050,39,167,"Ohio","Washington County",5,40,680,344,336
050,39,167,"Ohio","Washington County",5,41,736,369,367
050,39,167,"Ohio","Washington County",5,42,701,360,341
050,39,167,"Ohio","Washington County",5,43,732,358,374
050,39,167,"Ohio","Washington County",5,44,694,353,341
050,39,167,"Ohio","Washington County",5,45,637,313,324
050,39,167,"Ohio","Washington County",5,46,637,321,316
050,39,167,"Ohio","Washington County",5,47,645,316,329
050,39,167,"Ohio","Washington County",5,48,684,327,357
050,39,167,"Ohio","Washington County",5,49,641,296,345
050,39,167,"Ohio","Washington County",5,50,716,353,363
050,39,167,"Ohio","Washington County",5,51,722,348,374
050,39,167,"Ohio","Washington County",5,52,764,375,389
050,39,167,"Ohio","Washington County",5,53,763,384,379
050,39,167,"Ohio","Washington County",5,54,758,386,372
050,39,167,"Ohio","Washington County",5,55,737,370,367
050,39,167,"Ohio","Washington County",5,56,739,376,363
050,39,167,"Ohio","Washington County",5,57,739,365,374
050,39,167,"Ohio","Washington County",5,58,806,400,406
050,39,167,"Ohio","Washington County",5,59,829,408,421
050,39,167,"Ohio","Washington County",5,60,818,410,408
050,39,167,"Ohio","Washington County",5,61,855,418,437
050,39,167,"Ohio","Washington County",5,62,899,425,474
050,39,167,"Ohio","Washington County",5,63,873,418,455
050,39,167,"Ohio","Washington County",5,64,893,432,461
050,39,167,"Ohio","Washington County",5,65,895,435,460
050,39,167,"Ohio","Washington County",5,66,918,446,472
050,39,167,"Ohio","Washington County",5,67,811,413,398
050,39,167,"Ohio","Washington County",5,68,829,438,391
050,39,167,"Ohio","Washington County",5,69,836,428,408
050,39,167,"Ohio","Washington County",5,70,766,374,392
050,39,167,"Ohio","Washington County",5,71,716,341,375
050,39,167,"Ohio","Washington County",5,72,681,327,354
050,39,167,"Ohio","Washington County",5,73,660,314,346
050,39,167,"Ohio","Washington County",5,74,647,312,335
050,39,167,"Ohio","Washington County",5,75,603,291,312
050,39,167,"Ohio","Washington County",5,76,675,311,364
050,39,167,"Ohio","Washington County",5,77,463,202,261
050,39,167,"Ohio","Washington County",5,78,431,180,251
050,39,167,"Ohio","Washington County",5,79,391,161,230
050,39,167,"Ohio","Washington County",5,80,419,173,246
050,39,167,"Ohio","Washington County",5,81,376,160,216
050,39,167,"Ohio","Washington County",5,82,337,154,183
050,39,167,"Ohio","Washington County",5,83,305,133,172
050,39,167,"Ohio","Washington County",5,84,270,115,155
050,39,167,"Ohio","Washington County",5,85,1457,544,913
050,39,169,"Ohio","Wayne County",1,0,1430,733,697
050,39,169,"Ohio","Wayne County",1,1,1481,769,712
050,39,169,"Ohio","Wayne County",1,2,1498,753,745
050,39,169,"Ohio","Wayne County",1,3,1548,782,766
050,39,169,"Ohio","Wayne County",1,4,1537,788,749
050,39,169,"Ohio","Wayne County",1,5,1591,823,768
050,39,169,"Ohio","Wayne County",1,6,1546,809,737
050,39,169,"Ohio","Wayne County",1,7,1612,839,773
050,39,169,"Ohio","Wayne County",1,8,1569,802,767
050,39,169,"Ohio","Wayne County",1,9,1527,785,742
050,39,169,"Ohio","Wayne County",1,10,1546,794,752
050,39,169,"Ohio","Wayne County",1,11,1587,836,751
050,39,169,"Ohio","Wayne County",1,12,1635,857,778
050,39,169,"Ohio","Wayne County",1,13,1692,886,806
050,39,169,"Ohio","Wayne County",1,14,1643,845,798
050,39,169,"Ohio","Wayne County",1,15,1611,803,808
050,39,169,"Ohio","Wayne County",1,16,1660,856,804
050,39,169,"Ohio","Wayne County",1,17,1660,875,785
050,39,169,"Ohio","Wayne County",1,18,1754,908,846
050,39,169,"Ohio","Wayne County",1,19,1871,936,935
050,39,169,"Ohio","Wayne County",1,20,1816,938,878
050,39,169,"Ohio","Wayne County",1,21,1826,935,891
050,39,169,"Ohio","Wayne County",1,22,1574,818,756
050,39,169,"Ohio","Wayne County",1,23,1324,674,650
050,39,169,"Ohio","Wayne County",1,24,1328,706,622
050,39,169,"Ohio","Wayne County",1,25,1342,704,638
050,39,169,"Ohio","Wayne County",1,26,1326,660,666
050,39,169,"Ohio","Wayne County",1,27,1431,715,716
050,39,169,"Ohio","Wayne County",1,28,1429,712,717
050,39,169,"Ohio","Wayne County",1,29,1396,714,682
050,39,169,"Ohio","Wayne County",1,30,1400,710,690
050,39,169,"Ohio","Wayne County",1,31,1363,707,656
050,39,169,"Ohio","Wayne County",1,32,1378,717,661
050,39,169,"Ohio","Wayne County",1,33,1351,681,670
050,39,169,"Ohio","Wayne County",1,34,1323,662,661
050,39,169,"Ohio","Wayne County",1,35,1304,665,639
050,39,169,"Ohio","Wayne County",1,36,1288,656,632
050,39,169,"Ohio","Wayne County",1,37,1353,684,669
050,39,169,"Ohio","Wayne County",1,38,1367,688,679
050,39,169,"Ohio","Wayne County",1,39,1372,709,663
050,39,169,"Ohio","Wayne County",1,40,1281,676,605
050,39,169,"Ohio","Wayne County",1,41,1252,621,631
050,39,169,"Ohio","Wayne County",1,42,1306,652,654
050,39,169,"Ohio","Wayne County",1,43,1270,640,630
050,39,169,"Ohio","Wayne County",1,44,1251,634,617
050,39,169,"Ohio","Wayne County",1,45,1286,651,635
050,39,169,"Ohio","Wayne County",1,46,1229,612,617
050,39,169,"Ohio","Wayne County",1,47,1287,646,641
050,39,169,"Ohio","Wayne County",1,48,1362,682,680
050,39,169,"Ohio","Wayne County",1,49,1464,718,746
050,39,169,"Ohio","Wayne County",1,50,1361,687,674
050,39,169,"Ohio","Wayne County",1,51,1334,662,672
050,39,169,"Ohio","Wayne County",1,52,1301,648,653
050,39,169,"Ohio","Wayne County",1,53,1315,649,666
050,39,169,"Ohio","Wayne County",1,54,1340,661,679
050,39,169,"Ohio","Wayne County",1,55,1479,733,746
050,39,169,"Ohio","Wayne County",1,56,1612,820,792
050,39,169,"Ohio","Wayne County",1,57,1612,812,800
050,39,169,"Ohio","Wayne County",1,58,1655,843,812
050,39,169,"Ohio","Wayne County",1,59,1639,841,798
050,39,169,"Ohio","Wayne County",1,60,1576,793,783
050,39,169,"Ohio","Wayne County",1,61,1574,769,805
050,39,169,"Ohio","Wayne County",1,62,1605,800,805
050,39,169,"Ohio","Wayne County",1,63,1590,791,799
050,39,169,"Ohio","Wayne County",1,64,1552,782,770
050,39,169,"Ohio","Wayne County",1,65,1438,709,729
050,39,169,"Ohio","Wayne County",1,66,1428,706,722
050,39,169,"Ohio","Wayne County",1,67,1414,718,696
050,39,169,"Ohio","Wayne County",1,68,1302,627,675
050,39,169,"Ohio","Wayne County",1,69,1221,582,639
050,39,169,"Ohio","Wayne County",1,70,1217,592,625
050,39,169,"Ohio","Wayne County",1,71,1162,555,607
050,39,169,"Ohio","Wayne County",1,72,1172,556,616
050,39,169,"Ohio","Wayne County",1,73,1196,565,631
050,39,169,"Ohio","Wayne County",1,74,783,365,418
050,39,169,"Ohio","Wayne County",1,75,775,364,411
050,39,169,"Ohio","Wayne County",1,76,787,365,422
050,39,169,"Ohio","Wayne County",1,77,827,375,452
050,39,169,"Ohio","Wayne County",1,78,723,333,390
050,39,169,"Ohio","Wayne County",1,79,640,288,352
050,39,169,"Ohio","Wayne County",1,80,569,252,317
050,39,169,"Ohio","Wayne County",1,81,538,241,297
050,39,169,"Ohio","Wayne County",1,82,526,237,289
050,39,169,"Ohio","Wayne County",1,83,493,207,286
050,39,169,"Ohio","Wayne County",1,84,429,177,252
050,39,169,"Ohio","Wayne County",1,85,2438,884,1554
050,39,169,"Ohio","Wayne County",2,0,1443,719,724
050,39,169,"Ohio","Wayne County",2,1,1466,758,708
050,39,169,"Ohio","Wayne County",2,2,1503,760,743
050,39,169,"Ohio","Wayne County",2,3,1531,770,761
050,39,169,"Ohio","Wayne County",2,4,1545,787,758
050,39,169,"Ohio","Wayne County",2,5,1577,815,762
050,39,169,"Ohio","Wayne County",2,6,1565,818,747
050,39,169,"Ohio","Wayne County",2,7,1593,829,764
050,39,169,"Ohio","Wayne County",2,8,1575,810,765
050,39,169,"Ohio","Wayne County",2,9,1534,786,748
050,39,169,"Ohio","Wayne County",2,10,1535,789,746
050,39,169,"Ohio","Wayne County",2,11,1573,825,748
050,39,169,"Ohio","Wayne County",2,12,1632,856,776
050,39,169,"Ohio","Wayne County",2,13,1677,878,799
050,39,169,"Ohio","Wayne County",2,14,1650,853,797
050,39,169,"Ohio","Wayne County",2,15,1620,813,807
050,39,169,"Ohio","Wayne County",2,16,1654,847,807
050,39,169,"Ohio","Wayne County",2,17,1666,873,793
050,39,169,"Ohio","Wayne County",2,18,1735,900,835
050,39,169,"Ohio","Wayne County",2,19,1881,943,938
050,39,169,"Ohio","Wayne County",2,20,1834,946,888
050,39,169,"Ohio","Wayne County",2,21,1832,939,893
050,39,169,"Ohio","Wayne County",2,22,1577,821,756
050,39,169,"Ohio","Wayne County",2,23,1335,680,655
050,39,169,"Ohio","Wayne County",2,24,1331,703,628
050,39,169,"Ohio","Wayne County",2,25,1336,702,634
050,39,169,"Ohio","Wayne County",2,26,1334,674,660
050,39,169,"Ohio","Wayne County",2,27,1400,701,699
050,39,169,"Ohio","Wayne County",2,28,1431,716,715
050,39,169,"Ohio","Wayne County",2,29,1410,716,694
050,39,169,"Ohio","Wayne County",2,30,1404,711,693
050,39,169,"Ohio","Wayne County",2,31,1372,712,660
050,39,169,"Ohio","Wayne County",2,32,1378,715,663
050,39,169,"Ohio","Wayne County",2,33,1355,688,667
050,39,169,"Ohio","Wayne County",2,34,1331,667,664
050,39,169,"Ohio","Wayne County",2,35,1315,667,648
050,39,169,"Ohio","Wayne County",2,36,1285,654,631
050,39,169,"Ohio","Wayne County",2,37,1342,680,662
050,39,169,"Ohio","Wayne County",2,38,1370,690,680
050,39,169,"Ohio","Wayne County",2,39,1369,704,665
050,39,169,"Ohio","Wayne County",2,40,1311,687,624
050,39,169,"Ohio","Wayne County",2,41,1260,635,625
050,39,169,"Ohio","Wayne County",2,42,1285,640,645
050,39,169,"Ohio","Wayne County",2,43,1287,647,640
050,39,169,"Ohio","Wayne County",2,44,1242,628,614
050,39,169,"Ohio","Wayne County",2,45,1285,649,636
050,39,169,"Ohio","Wayne County",2,46,1238,620,618
050,39,169,"Ohio","Wayne County",2,47,1266,634,632
050,39,169,"Ohio","Wayne County",2,48,1346,673,673
050,39,169,"Ohio","Wayne County",2,49,1448,715,733
050,39,169,"Ohio","Wayne County",2,50,1388,694,694
050,39,169,"Ohio","Wayne County",2,51,1337,666,671
050,39,169,"Ohio","Wayne County",2,52,1300,648,652
050,39,169,"Ohio","Wayne County",2,53,1313,649,664
050,39,169,"Ohio","Wayne County",2,54,1330,658,672
050,39,169,"Ohio","Wayne County",2,55,1445,716,729
050,39,169,"Ohio","Wayne County",2,56,1589,801,788
050,39,169,"Ohio","Wayne County",2,57,1606,811,795
050,39,169,"Ohio","Wayne County",2,58,1644,834,810
050,39,169,"Ohio","Wayne County",2,59,1645,845,800
050,39,169,"Ohio","Wayne County",2,60,1575,794,781
050,39,169,"Ohio","Wayne County",2,61,1562,767,795
050,39,169,"Ohio","Wayne County",2,62,1595,792,803
050,39,169,"Ohio","Wayne County",2,63,1610,799,811
050,39,169,"Ohio","Wayne County",2,64,1549,776,773
050,39,169,"Ohio","Wayne County",2,65,1461,725,736
050,39,169,"Ohio","Wayne County",2,66,1428,704,724
050,39,169,"Ohio","Wayne County",2,67,1411,710,701
050,39,169,"Ohio","Wayne County",2,68,1313,642,671
050,39,169,"Ohio","Wayne County",2,69,1243,592,651
050,39,169,"Ohio","Wayne County",2,70,1209,584,625
050,39,169,"Ohio","Wayne County",2,71,1170,561,609
050,39,169,"Ohio","Wayne County",2,72,1135,540,595
050,39,169,"Ohio","Wayne County",2,73,1245,587,658
050,39,169,"Ohio","Wayne County",2,74,825,387,438
050,39,169,"Ohio","Wayne County",2,75,776,365,411
050,39,169,"Ohio","Wayne County",2,76,774,359,415
050,39,169,"Ohio","Wayne County",2,77,833,381,452
050,39,169,"Ohio","Wayne County",2,78,730,332,398
050,39,169,"Ohio","Wayne County",2,79,648,294,354
050,39,169,"Ohio","Wayne County",2,80,582,257,325
050,39,169,"Ohio","Wayne County",2,81,525,234,291
050,39,169,"Ohio","Wayne County",2,82,519,233,286
050,39,169,"Ohio","Wayne County",2,83,490,210,280
050,39,169,"Ohio","Wayne County",2,84,429,180,249
050,39,169,"Ohio","Wayne County",2,85,2425,879,1546
050,39,169,"Ohio","Wayne County",3,0,1357,711,646
050,39,169,"Ohio","Wayne County",3,1,1470,723,747
050,39,169,"Ohio","Wayne County",3,2,1454,758,696
050,39,169,"Ohio","Wayne County",3,3,1519,767,752
050,39,169,"Ohio","Wayne County",3,4,1527,770,757
050,39,169,"Ohio","Wayne County",3,5,1538,803,735
050,39,169,"Ohio","Wayne County",3,6,1601,832,769
050,39,169,"Ohio","Wayne County",3,7,1569,827,742
050,39,169,"Ohio","Wayne County",3,8,1597,829,768
050,39,169,"Ohio","Wayne County",3,9,1577,826,751
050,39,169,"Ohio","Wayne County",3,10,1522,768,754
050,39,169,"Ohio","Wayne County",3,11,1539,801,738
050,39,169,"Ohio","Wayne County",3,12,1584,829,755
050,39,169,"Ohio","Wayne County",3,13,1632,856,776
050,39,169,"Ohio","Wayne County",3,14,1680,883,797
050,39,169,"Ohio","Wayne County",3,15,1642,851,791
050,39,169,"Ohio","Wayne County",3,16,1632,823,809
050,39,169,"Ohio","Wayne County",3,17,1655,843,812
050,39,169,"Ohio","Wayne County",3,18,1664,874,790
050,39,169,"Ohio","Wayne County",3,19,1701,873,828
050,39,169,"Ohio","Wayne County",3,20,1656,872,784
050,39,169,"Ohio","Wayne County",3,21,1684,880,804
050,39,169,"Ohio","Wayne County",3,22,1530,789,741
050,39,169,"Ohio","Wayne County",3,23,1349,701,648
050,39,169,"Ohio","Wayne County",3,24,1343,704,639
050,39,169,"Ohio","Wayne County",3,25,1287,690,597
050,39,169,"Ohio","Wayne County",3,26,1368,717,651
050,39,169,"Ohio","Wayne County",3,27,1354,679,675
050,39,169,"Ohio","Wayne County",3,28,1397,706,691
050,39,169,"Ohio","Wayne County",3,29,1439,730,709
050,39,169,"Ohio","Wayne County",3,30,1386,716,670
050,39,169,"Ohio","Wayne County",3,31,1432,726,706
050,39,169,"Ohio","Wayne County",3,32,1350,691,659
050,39,169,"Ohio","Wayne County",3,33,1407,725,682
050,39,169,"Ohio","Wayne County",3,34,1371,709,662
050,39,169,"Ohio","Wayne County",3,35,1335,662,673
050,39,169,"Ohio","Wayne County",3,36,1329,683,646
050,39,169,"Ohio","Wayne County",3,37,1288,660,628
050,39,169,"Ohio","Wayne County",3,38,1350,681,669
050,39,169,"Ohio","Wayne County",3,39,1375,697,678
050,39,169,"Ohio","Wayne County",3,40,1356,695,661
050,39,169,"Ohio","Wayne County",3,41,1310,681,629
050,39,169,"Ohio","Wayne County",3,42,1262,636,626
050,39,169,"Ohio","Wayne County",3,43,1288,635,653
050,39,169,"Ohio","Wayne County",3,44,1253,627,626
050,39,169,"Ohio","Wayne County",3,45,1254,639,615
050,39,169,"Ohio","Wayne County",3,46,1276,652,624
050,39,169,"Ohio","Wayne County",3,47,1226,619,607
050,39,169,"Ohio","Wayne County",3,48,1271,627,644
050,39,169,"Ohio","Wayne County",3,49,1364,677,687
050,39,169,"Ohio","Wayne County",3,50,1437,707,730
050,39,169,"Ohio","Wayne County",3,51,1376,683,693
050,39,169,"Ohio","Wayne County",3,52,1321,664,657
050,39,169,"Ohio","Wayne County",3,53,1283,633,650
050,39,169,"Ohio","Wayne County",3,54,1311,648,663
050,39,169,"Ohio","Wayne County",3,55,1315,664,651
050,39,169,"Ohio","Wayne County",3,56,1462,717,745
050,39,169,"Ohio","Wayne County",3,57,1546,786,760
050,39,169,"Ohio","Wayne County",3,58,1599,814,785
050,39,169,"Ohio","Wayne County",3,59,1630,833,797
050,39,169,"Ohio","Wayne County",3,60,1624,826,798
050,39,169,"Ohio","Wayne County",3,61,1572,781,791
050,39,169,"Ohio","Wayne County",3,62,1535,750,785
050,39,169,"Ohio","Wayne County",3,63,1571,781,790
050,39,169,"Ohio","Wayne County",3,64,1571,783,788
050,39,169,"Ohio","Wayne County",3,65,1536,754,782
050,39,169,"Ohio","Wayne County",3,66,1422,698,724
050,39,169,"Ohio","Wayne County",3,67,1403,686,717
050,39,169,"Ohio","Wayne County",3,68,1390,698,692
050,39,169,"Ohio","Wayne County",3,69,1281,624,657
050,39,169,"Ohio","Wayne County",3,70,1222,573,649
050,39,169,"Ohio","Wayne County",3,71,1185,566,619
050,39,169,"Ohio","Wayne County",3,72,1129,540,589
050,39,169,"Ohio","Wayne County",3,73,1115,523,592
050,39,169,"Ohio","Wayne County",3,74,1203,562,641
050,39,169,"Ohio","Wayne County",3,75,779,354,425
050,39,169,"Ohio","Wayne County",3,76,758,343,415
050,39,169,"Ohio","Wayne County",3,77,745,353,392
050,39,169,"Ohio","Wayne County",3,78,812,364,448
050,39,169,"Ohio","Wayne County",3,79,689,313,376
050,39,169,"Ohio","Wayne County",3,80,600,262,338
050,39,169,"Ohio","Wayne County",3,81,544,242,302
050,39,169,"Ohio","Wayne County",3,82,499,227,272
050,39,169,"Ohio","Wayne County",3,83,485,213,272
050,39,169,"Ohio","Wayne County",3,84,463,193,270
050,39,169,"Ohio","Wayne County",3,85,2412,885,1527
050,39,169,"Ohio","Wayne County",4,0,1391,720,671
050,39,169,"Ohio","Wayne County",4,1,1370,717,653
050,39,169,"Ohio","Wayne County",4,2,1472,724,748
050,39,169,"Ohio","Wayne County",4,3,1439,749,690
050,39,169,"Ohio","Wayne County",4,4,1536,788,748
050,39,169,"Ohio","Wayne County",4,5,1526,771,755
050,39,169,"Ohio","Wayne County",4,6,1534,797,737
050,39,169,"Ohio","Wayne County",4,7,1598,850,748
050,39,169,"Ohio","Wayne County",4,8,1572,826,746
050,39,169,"Ohio","Wayne County",4,9,1585,820,765
050,39,169,"Ohio","Wayne County",4,10,1569,829,740
050,39,169,"Ohio","Wayne County",4,11,1535,774,761
050,39,169,"Ohio","Wayne County",4,12,1538,800,738
050,39,169,"Ohio","Wayne County",4,13,1611,847,764
050,39,169,"Ohio","Wayne County",4,14,1654,877,777
050,39,169,"Ohio","Wayne County",4,15,1683,884,799
050,39,169,"Ohio","Wayne County",4,16,1669,878,791
050,39,169,"Ohio","Wayne County",4,17,1629,822,807
050,39,169,"Ohio","Wayne County",4,18,1727,882,845
050,39,169,"Ohio","Wayne County",4,19,1840,935,905
050,39,169,"Ohio","Wayne County",4,20,1795,922,873
050,39,169,"Ohio","Wayne County",4,21,1811,936,875
050,39,169,"Ohio","Wayne County",4,22,1580,840,740
050,39,169,"Ohio","Wayne County",4,23,1345,682,663
050,39,169,"Ohio","Wayne County",4,24,1365,714,651
050,39,169,"Ohio","Wayne County",4,25,1302,678,624
050,39,169,"Ohio","Wayne County",4,26,1287,683,604
050,39,169,"Ohio","Wayne County",4,27,1370,716,654
050,39,169,"Ohio","Wayne County",4,28,1378,703,675
050,39,169,"Ohio","Wayne County",4,29,1438,729,709
050,39,169,"Ohio","Wayne County",4,30,1444,725,719
050,39,169,"Ohio","Wayne County",4,31,1412,728,684
050,39,169,"Ohio","Wayne County",4,32,1423,706,717
050,39,169,"Ohio","Wayne County",4,33,1372,692,680
050,39,169,"Ohio","Wayne County",4,34,1412,729,683
050,39,169,"Ohio","Wayne County",4,35,1354,697,657
050,39,169,"Ohio","Wayne County",4,36,1350,670,680
050,39,169,"Ohio","Wayne County",4,37,1336,684,652
050,39,169,"Ohio","Wayne County",4,38,1278,650,628
050,39,169,"Ohio","Wayne County",4,39,1345,688,657
050,39,169,"Ohio","Wayne County",4,40,1370,685,685
050,39,169,"Ohio","Wayne County",4,41,1353,683,670
050,39,169,"Ohio","Wayne County",4,42,1302,671,631
050,39,169,"Ohio","Wayne County",4,43,1262,638,624
050,39,169,"Ohio","Wayne County",4,44,1280,645,635
050,39,169,"Ohio","Wayne County",4,45,1253,628,625
050,39,169,"Ohio","Wayne County",4,46,1245,634,611
050,39,169,"Ohio","Wayne County",4,47,1275,647,628
050,39,169,"Ohio","Wayne County",4,48,1236,618,618
050,39,169,"Ohio","Wayne County",4,49,1271,636,635
050,39,169,"Ohio","Wayne County",4,50,1349,670,679
050,39,169,"Ohio","Wayne County",4,51,1430,701,729
050,39,169,"Ohio","Wayne County",4,52,1347,665,682
050,39,169,"Ohio","Wayne County",4,53,1342,664,678
050,39,169,"Ohio","Wayne County",4,54,1271,629,642
050,39,169,"Ohio","Wayne County",4,55,1296,645,651
050,39,169,"Ohio","Wayne County",4,56,1326,653,673
050,39,169,"Ohio","Wayne County",4,57,1438,707,731
050,39,169,"Ohio","Wayne County",4,58,1550,786,764
050,39,169,"Ohio","Wayne County",4,59,1557,801,756
050,39,169,"Ohio","Wayne County",4,60,1601,822,779
050,39,169,"Ohio","Wayne County",4,61,1593,800,793
050,39,169,"Ohio","Wayne County",4,62,1538,765,773
050,39,169,"Ohio","Wayne County",4,63,1506,736,770
050,39,169,"Ohio","Wayne County",4,64,1546,768,778
050,39,169,"Ohio","Wayne County",4,65,1557,771,786
050,39,169,"Ohio","Wayne County",4,66,1500,726,774
050,39,169,"Ohio","Wayne County",4,67,1407,678,729
050,39,169,"Ohio","Wayne County",4,68,1382,673,709
050,39,169,"Ohio","Wayne County",4,69,1368,682,686
050,39,169,"Ohio","Wayne County",4,70,1268,615,653
050,39,169,"Ohio","Wayne County",4,71,1179,539,640
050,39,169,"Ohio","Wayne County",4,72,1136,545,591
050,39,169,"Ohio","Wayne County",4,73,1108,517,591
050,39,169,"Ohio","Wayne County",4,74,1079,495,584
050,39,169,"Ohio","Wayne County",4,75,1155,531,624
050,39,169,"Ohio","Wayne County",4,76,759,340,419
050,39,169,"Ohio","Wayne County",4,77,737,336,401
050,39,169,"Ohio","Wayne County",4,78,715,326,389
050,39,169,"Ohio","Wayne County",4,79,763,340,423
050,39,169,"Ohio","Wayne County",4,80,636,275,361
050,39,169,"Ohio","Wayne County",4,81,555,250,305
050,39,169,"Ohio","Wayne County",4,82,512,226,286
050,39,169,"Ohio","Wayne County",4,83,446,202,244
050,39,169,"Ohio","Wayne County",4,84,455,202,253
050,39,169,"Ohio","Wayne County",4,85,2423,902,1521
050,39,169,"Ohio","Wayne County",5,0,1396,724,672
050,39,169,"Ohio","Wayne County",5,1,1396,709,687
050,39,169,"Ohio","Wayne County",5,2,1358,717,641
050,39,169,"Ohio","Wayne County",5,3,1474,708,766
050,39,169,"Ohio","Wayne County",5,4,1439,767,672
050,39,169,"Ohio","Wayne County",5,5,1546,783,763
050,39,169,"Ohio","Wayne County",5,6,1510,753,757
050,39,169,"Ohio","Wayne County",5,7,1515,783,732
050,39,169,"Ohio","Wayne County",5,8,1592,842,750
050,39,169,"Ohio","Wayne County",5,9,1573,836,737
050,39,169,"Ohio","Wayne County",5,10,1582,810,772
050,39,169,"Ohio","Wayne County",5,11,1572,820,752
050,39,169,"Ohio","Wayne County",5,12,1554,791,763
050,39,169,"Ohio","Wayne County",5,13,1554,812,742
050,39,169,"Ohio","Wayne County",5,14,1616,844,772
050,39,169,"Ohio","Wayne County",5,15,1655,867,788
050,39,169,"Ohio","Wayne County",5,16,1721,902,819
050,39,169,"Ohio","Wayne County",5,17,1677,886,791
050,39,169,"Ohio","Wayne County",5,18,1719,876,843
050,39,169,"Ohio","Wayne County",5,19,1851,929,922
050,39,169,"Ohio","Wayne County",5,20,1804,937,867
050,39,169,"Ohio","Wayne County",5,21,1818,936,882
050,39,169,"Ohio","Wayne County",5,22,1604,831,773
050,39,169,"Ohio","Wayne County",5,23,1339,713,626
050,39,169,"Ohio","Wayne County",5,24,1321,684,637
050,39,169,"Ohio","Wayne County",5,25,1313,704,609
050,39,169,"Ohio","Wayne County",5,26,1281,655,626
050,39,169,"Ohio","Wayne County",5,27,1288,694,594
050,39,169,"Ohio","Wayne County",5,28,1364,721,643
050,39,169,"Ohio","Wayne County",5,29,1389,699,690
050,39,169,"Ohio","Wayne County",5,30,1419,721,698
050,39,169,"Ohio","Wayne County",5,31,1443,726,717
050,39,169,"Ohio","Wayne County",5,32,1402,719,683
050,39,169,"Ohio","Wayne County",5,33,1455,719,736
050,39,169,"Ohio","Wayne County",5,34,1374,697,677
050,39,169,"Ohio","Wayne County",5,35,1407,720,687
050,39,169,"Ohio","Wayne County",5,36,1335,687,648
050,39,169,"Ohio","Wayne County",5,37,1363,691,672
050,39,169,"Ohio","Wayne County",5,38,1345,684,661
050,39,169,"Ohio","Wayne County",5,39,1307,668,639
050,39,169,"Ohio","Wayne County",5,40,1346,682,664
050,39,169,"Ohio","Wayne County",5,41,1380,692,688
050,39,169,"Ohio","Wayne County",5,42,1358,689,669
050,39,169,"Ohio","Wayne County",5,43,1312,678,634
050,39,169,"Ohio","Wayne County",5,44,1258,637,621
050,39,169,"Ohio","Wayne County",5,45,1283,639,644
050,39,169,"Ohio","Wayne County",5,46,1240,618,622
050,39,169,"Ohio","Wayne County",5,47,1223,624,599
050,39,169,"Ohio","Wayne County",5,48,1266,634,632
050,39,169,"Ohio","Wayne County",5,49,1228,614,614
050,39,169,"Ohio","Wayne County",5,50,1267,638,629
050,39,169,"Ohio","Wayne County",5,51,1348,672,676
050,39,169,"Ohio","Wayne County",5,52,1419,697,722
050,39,169,"Ohio","Wayne County",5,53,1334,649,685
050,39,169,"Ohio","Wayne County",5,54,1349,675,674
050,39,169,"Ohio","Wayne County",5,55,1267,622,645
050,39,169,"Ohio","Wayne County",5,56,1310,651,659
050,39,169,"Ohio","Wayne County",5,57,1316,643,673
050,39,169,"Ohio","Wayne County",5,58,1421,699,722
050,39,169,"Ohio","Wayne County",5,59,1528,772,756
050,39,169,"Ohio","Wayne County",5,60,1525,783,742
050,39,169,"Ohio","Wayne County",5,61,1596,815,781
050,39,169,"Ohio","Wayne County",5,62,1571,793,778
050,39,169,"Ohio","Wayne County",5,63,1533,752,781
050,39,169,"Ohio","Wayne County",5,64,1488,718,770
050,39,169,"Ohio","Wayne County",5,65,1544,764,780
050,39,169,"Ohio","Wayne County",5,66,1504,740,764
050,39,169,"Ohio","Wayne County",5,67,1482,706,776
050,39,169,"Ohio","Wayne County",5,68,1377,661,716
050,39,169,"Ohio","Wayne County",5,69,1364,667,697
050,39,169,"Ohio","Wayne County",5,70,1339,671,668
050,39,169,"Ohio","Wayne County",5,71,1236,590,646
050,39,169,"Ohio","Wayne County",5,72,1133,514,619
050,39,169,"Ohio","Wayne County",5,73,1104,521,583
050,39,169,"Ohio","Wayne County",5,74,1093,510,583
050,39,169,"Ohio","Wayne County",5,75,1046,473,573
050,39,169,"Ohio","Wayne County",5,76,1131,510,621
050,39,169,"Ohio","Wayne County",5,77,746,337,409
050,39,169,"Ohio","Wayne County",5,78,714,318,396
050,39,169,"Ohio","Wayne County",5,79,683,305,378
050,39,169,"Ohio","Wayne County",5,80,711,303,408
050,39,169,"Ohio","Wayne County",5,81,593,263,330
050,39,169,"Ohio","Wayne County",5,82,526,236,290
050,39,169,"Ohio","Wayne County",5,83,466,206,260
050,39,169,"Ohio","Wayne County",5,84,411,181,230
050,39,169,"Ohio","Wayne County",5,85,2470,953,1517
050,39,171,"Ohio","Williams County",1,0,422,218,204
050,39,171,"Ohio","Williams County",1,1,437,228,209
050,39,171,"Ohio","Williams County",1,2,414,202,212
050,39,171,"Ohio","Williams County",1,3,433,225,208
050,39,171,"Ohio","Williams County",1,4,443,239,204
050,39,171,"Ohio","Williams County",1,5,458,230,228
050,39,171,"Ohio","Williams County",1,6,451,224,227
050,39,171,"Ohio","Williams County",1,7,436,212,224
050,39,171,"Ohio","Williams County",1,8,462,239,223
050,39,171,"Ohio","Williams County",1,9,450,231,219
050,39,171,"Ohio","Williams County",1,10,444,214,230
050,39,171,"Ohio","Williams County",1,11,462,218,244
050,39,171,"Ohio","Williams County",1,12,510,260,250
050,39,171,"Ohio","Williams County",1,13,522,261,261
050,39,171,"Ohio","Williams County",1,14,506,249,257
050,39,171,"Ohio","Williams County",1,15,499,262,237
050,39,171,"Ohio","Williams County",1,16,522,276,246
050,39,171,"Ohio","Williams County",1,17,533,266,267
050,39,171,"Ohio","Williams County",1,18,468,245,223
050,39,171,"Ohio","Williams County",1,19,359,199,160
050,39,171,"Ohio","Williams County",1,20,394,224,170
050,39,171,"Ohio","Williams County",1,21,434,232,202
050,39,171,"Ohio","Williams County",1,22,404,215,189
050,39,171,"Ohio","Williams County",1,23,419,219,200
050,39,171,"Ohio","Williams County",1,24,410,207,203
050,39,171,"Ohio","Williams County",1,25,425,217,208
050,39,171,"Ohio","Williams County",1,26,426,225,201
050,39,171,"Ohio","Williams County",1,27,422,228,194
050,39,171,"Ohio","Williams County",1,28,454,250,204
050,39,171,"Ohio","Williams County",1,29,467,237,230
050,39,171,"Ohio","Williams County",1,30,443,217,226
050,39,171,"Ohio","Williams County",1,31,412,214,198
050,39,171,"Ohio","Williams County",1,32,401,201,200
050,39,171,"Ohio","Williams County",1,33,431,230,201
050,39,171,"Ohio","Williams County",1,34,465,250,215
050,39,171,"Ohio","Williams County",1,35,455,260,195
050,39,171,"Ohio","Williams County",1,36,452,233,219
050,39,171,"Ohio","Williams County",1,37,426,218,208
050,39,171,"Ohio","Williams County",1,38,461,244,217
050,39,171,"Ohio","Williams County",1,39,474,247,227
050,39,171,"Ohio","Williams County",1,40,471,248,223
050,39,171,"Ohio","Williams County",1,41,459,231,228
050,39,171,"Ohio","Williams County",1,42,445,228,217
050,39,171,"Ohio","Williams County",1,43,417,208,209
050,39,171,"Ohio","Williams County",1,44,415,225,190
050,39,171,"Ohio","Williams County",1,45,437,242,195
050,39,171,"Ohio","Williams County",1,46,410,221,189
050,39,171,"Ohio","Williams County",1,47,413,205,208
050,39,171,"Ohio","Williams County",1,48,458,224,234
050,39,171,"Ohio","Williams County",1,49,486,246,240
050,39,171,"Ohio","Williams County",1,50,432,220,212
050,39,171,"Ohio","Williams County",1,51,449,224,225
050,39,171,"Ohio","Williams County",1,52,442,223,219
050,39,171,"Ohio","Williams County",1,53,436,229,207
050,39,171,"Ohio","Williams County",1,54,459,240,219
050,39,171,"Ohio","Williams County",1,55,517,271,246
050,39,171,"Ohio","Williams County",1,56,521,254,267
050,39,171,"Ohio","Williams County",1,57,535,253,282
050,39,171,"Ohio","Williams County",1,58,536,265,271
050,39,171,"Ohio","Williams County",1,59,559,286,273
050,39,171,"Ohio","Williams County",1,60,607,301,306
050,39,171,"Ohio","Williams County",1,61,568,282,286
050,39,171,"Ohio","Williams County",1,62,563,282,281
050,39,171,"Ohio","Williams County",1,63,547,284,263
050,39,171,"Ohio","Williams County",1,64,527,277,250
050,39,171,"Ohio","Williams County",1,65,526,257,269
050,39,171,"Ohio","Williams County",1,66,489,233,256
050,39,171,"Ohio","Williams County",1,67,457,219,238
050,39,171,"Ohio","Williams County",1,68,446,220,226
050,39,171,"Ohio","Williams County",1,69,387,189,198
050,39,171,"Ohio","Williams County",1,70,365,177,188
050,39,171,"Ohio","Williams County",1,71,368,174,194
050,39,171,"Ohio","Williams County",1,72,376,184,192
050,39,171,"Ohio","Williams County",1,73,374,185,189
050,39,171,"Ohio","Williams County",1,74,271,123,148
050,39,171,"Ohio","Williams County",1,75,274,124,150
050,39,171,"Ohio","Williams County",1,76,284,124,160
050,39,171,"Ohio","Williams County",1,77,278,114,164
050,39,171,"Ohio","Williams County",1,78,247,101,146
050,39,171,"Ohio","Williams County",1,79,251,104,147
050,39,171,"Ohio","Williams County",1,80,188,88,100
050,39,171,"Ohio","Williams County",1,81,194,101,93
050,39,171,"Ohio","Williams County",1,82,172,81,91
050,39,171,"Ohio","Williams County",1,83,153,68,85
050,39,171,"Ohio","Williams County",1,84,153,68,85
050,39,171,"Ohio","Williams County",1,85,836,278,558
050,39,171,"Ohio","Williams County",2,0,425,217,208
050,39,171,"Ohio","Williams County",2,1,429,223,206
050,39,171,"Ohio","Williams County",2,2,419,208,211
050,39,171,"Ohio","Williams County",2,3,426,218,208
050,39,171,"Ohio","Williams County",2,4,444,239,205
050,39,171,"Ohio","Williams County",2,5,454,233,221
050,39,171,"Ohio","Williams County",2,6,451,223,228
050,39,171,"Ohio","Williams County",2,7,439,214,225
050,39,171,"Ohio","Williams County",2,8,454,232,222
050,39,171,"Ohio","Williams County",2,9,450,231,219
050,39,171,"Ohio","Williams County",2,10,443,216,227
050,39,171,"Ohio","Williams County",2,11,454,215,239
050,39,171,"Ohio","Williams County",2,12,498,250,248
050,39,171,"Ohio","Williams County",2,13,516,259,257
050,39,171,"Ohio","Williams County",2,14,510,252,258
050,39,171,"Ohio","Williams County",2,15,501,259,242
050,39,171,"Ohio","Williams County",2,16,516,272,244
050,39,171,"Ohio","Williams County",2,17,527,267,260
050,39,171,"Ohio","Williams County",2,18,461,243,218
050,39,171,"Ohio","Williams County",2,19,367,199,168
050,39,171,"Ohio","Williams County",2,20,395,223,172
050,39,171,"Ohio","Williams County",2,21,426,231,195
050,39,171,"Ohio","Williams County",2,22,412,217,195
050,39,171,"Ohio","Williams County",2,23,415,216,199
050,39,171,"Ohio","Williams County",2,24,415,213,202
050,39,171,"Ohio","Williams County",2,25,422,215,207
050,39,171,"Ohio","Williams County",2,26,424,224,200
050,39,171,"Ohio","Williams County",2,27,423,230,193
050,39,171,"Ohio","Williams County",2,28,447,244,203
050,39,171,"Ohio","Williams County",2,29,464,241,223
050,39,171,"Ohio","Williams County",2,30,450,222,228
050,39,171,"Ohio","Williams County",2,31,422,216,206
050,39,171,"Ohio","Williams County",2,32,401,205,196
050,39,171,"Ohio","Williams County",2,33,423,223,200
050,39,171,"Ohio","Williams County",2,34,454,245,209
050,39,171,"Ohio","Williams County",2,35,463,261,202
050,39,171,"Ohio","Williams County",2,36,453,239,214
050,39,171,"Ohio","Williams County",2,37,429,220,209
050,39,171,"Ohio","Williams County",2,38,454,239,215
050,39,171,"Ohio","Williams County",2,39,469,245,224
050,39,171,"Ohio","Williams County",2,40,471,249,222
050,39,171,"Ohio","Williams County",2,41,459,233,226
050,39,171,"Ohio","Williams County",2,42,444,226,218
050,39,171,"Ohio","Williams County",2,43,428,216,212
050,39,171,"Ohio","Williams County",2,44,410,218,192
050,39,171,"Ohio","Williams County",2,45,431,238,193
050,39,171,"Ohio","Williams County",2,46,415,223,192
050,39,171,"Ohio","Williams County",2,47,410,209,201
050,39,171,"Ohio","Williams County",2,48,446,219,227
050,39,171,"Ohio","Williams County",2,49,485,246,239
050,39,171,"Ohio","Williams County",2,50,442,224,218
050,39,171,"Ohio","Williams County",2,51,444,223,221
050,39,171,"Ohio","Williams County",2,52,442,223,219
050,39,171,"Ohio","Williams County",2,53,436,227,209
050,39,171,"Ohio","Williams County",2,54,450,235,215
050,39,171,"Ohio","Williams County",2,55,502,263,239
050,39,171,"Ohio","Williams County",2,56,517,256,261
050,39,171,"Ohio","Williams County",2,57,534,254,280
050,39,171,"Ohio","Williams County",2,58,536,261,275
050,39,171,"Ohio","Williams County",2,59,557,283,274
050,39,171,"Ohio","Williams County",2,60,593,295,298
050,39,171,"Ohio","Williams County",2,61,577,286,291
050,39,171,"Ohio","Williams County",2,62,564,281,283
050,39,171,"Ohio","Williams County",2,63,556,286,270
050,39,171,"Ohio","Williams County",2,64,531,279,252
050,39,171,"Ohio","Williams County",2,65,526,261,265
050,39,171,"Ohio","Williams County",2,66,499,237,262
050,39,171,"Ohio","Williams County",2,67,461,220,241
050,39,171,"Ohio","Williams County",2,68,443,218,225
050,39,171,"Ohio","Williams County",2,69,404,199,205
050,39,171,"Ohio","Williams County",2,70,369,177,192
050,39,171,"Ohio","Williams County",2,71,367,173,194
050,39,171,"Ohio","Williams County",2,72,367,179,188
050,39,171,"Ohio","Williams County",2,73,395,195,200
050,39,171,"Ohio","Williams County",2,74,274,128,146
050,39,171,"Ohio","Williams County",2,75,270,123,147
050,39,171,"Ohio","Williams County",2,76,283,124,159
050,39,171,"Ohio","Williams County",2,77,281,116,165
050,39,171,"Ohio","Williams County",2,78,245,102,143
050,39,171,"Ohio","Williams County",2,79,247,100,147
050,39,171,"Ohio","Williams County",2,80,201,91,110
050,39,171,"Ohio","Williams County",2,81,192,97,95
050,39,171,"Ohio","Williams County",2,82,177,85,92
050,39,171,"Ohio","Williams County",2,83,157,71,86
050,39,171,"Ohio","Williams County",2,84,148,68,80
050,39,171,"Ohio","Williams County",2,85,847,284,563
050,39,171,"Ohio","Williams County",3,0,385,223,162
050,39,171,"Ohio","Williams County",3,1,417,215,202
050,39,171,"Ohio","Williams County",3,2,429,219,210
050,39,171,"Ohio","Williams County",3,3,424,212,212
050,39,171,"Ohio","Williams County",3,4,437,217,220
050,39,171,"Ohio","Williams County",3,5,421,229,192
050,39,171,"Ohio","Williams County",3,6,442,224,218
050,39,171,"Ohio","Williams County",3,7,449,225,224
050,39,171,"Ohio","Williams County",3,8,428,212,216
050,39,171,"Ohio","Williams County",3,9,465,242,223
050,39,171,"Ohio","Williams County",3,10,452,227,225
050,39,171,"Ohio","Williams County",3,11,435,216,219
050,39,171,"Ohio","Williams County",3,12,443,213,230
050,39,171,"Ohio","Williams County",3,13,495,247,248
050,39,171,"Ohio","Williams County",3,14,496,251,245
050,39,171,"Ohio","Williams County",3,15,500,256,244
050,39,171,"Ohio","Williams County",3,16,483,248,235
050,39,171,"Ohio","Williams County",3,17,521,274,247
050,39,171,"Ohio","Williams County",3,18,451,242,209
050,39,171,"Ohio","Williams County",3,19,388,203,185
050,39,171,"Ohio","Williams County",3,20,392,217,175
050,39,171,"Ohio","Williams County",3,21,413,236,177
050,39,171,"Ohio","Williams County",3,22,434,222,212
050,39,171,"Ohio","Williams County",3,23,421,225,196
050,39,171,"Ohio","Williams County",3,24,442,238,204
050,39,171,"Ohio","Williams County",3,25,401,202,199
050,39,171,"Ohio","Williams County",3,26,423,215,208
050,39,171,"Ohio","Williams County",3,27,424,225,199
050,39,171,"Ohio","Williams County",3,28,409,209,200
050,39,171,"Ohio","Williams County",3,29,455,253,202
050,39,171,"Ohio","Williams County",3,30,458,237,221
050,39,171,"Ohio","Williams County",3,31,447,222,225
050,39,171,"Ohio","Williams County",3,32,423,215,208
050,39,171,"Ohio","Williams County",3,33,394,201,193
050,39,171,"Ohio","Williams County",3,34,433,224,209
050,39,171,"Ohio","Williams County",3,35,451,244,207
050,39,171,"Ohio","Williams County",3,36,482,270,212
050,39,171,"Ohio","Williams County",3,37,440,235,205
050,39,171,"Ohio","Williams County",3,38,431,218,213
050,39,171,"Ohio","Williams County",3,39,455,232,223
050,39,171,"Ohio","Williams County",3,40,471,248,223
050,39,171,"Ohio","Williams County",3,41,464,240,224
050,39,171,"Ohio","Williams County",3,42,447,226,221
050,39,171,"Ohio","Williams County",3,43,443,227,216
050,39,171,"Ohio","Williams County",3,44,431,222,209
050,39,171,"Ohio","Williams County",3,45,412,220,192
050,39,171,"Ohio","Williams County",3,46,421,224,197
050,39,171,"Ohio","Williams County",3,47,413,229,184
050,39,171,"Ohio","Williams County",3,48,404,202,202
050,39,171,"Ohio","Williams County",3,49,454,227,227
050,39,171,"Ohio","Williams County",3,50,465,229,236
050,39,171,"Ohio","Williams County",3,51,452,226,226
050,39,171,"Ohio","Williams County",3,52,445,227,218
050,39,171,"Ohio","Williams County",3,53,437,220,217
050,39,171,"Ohio","Williams County",3,54,426,215,211
050,39,171,"Ohio","Williams County",3,55,453,233,220
050,39,171,"Ohio","Williams County",3,56,498,263,235
050,39,171,"Ohio","Williams County",3,57,512,255,257
050,39,171,"Ohio","Williams County",3,58,526,251,275
050,39,171,"Ohio","Williams County",3,59,529,253,276
050,39,171,"Ohio","Williams County",3,60,540,273,267
050,39,171,"Ohio","Williams County",3,61,584,290,294
050,39,171,"Ohio","Williams County",3,62,568,279,289
050,39,171,"Ohio","Williams County",3,63,556,275,281
050,39,171,"Ohio","Williams County",3,64,546,283,263
050,39,171,"Ohio","Williams County",3,65,511,266,245
050,39,171,"Ohio","Williams County",3,66,520,258,262
050,39,171,"Ohio","Williams County",3,67,487,226,261
050,39,171,"Ohio","Williams County",3,68,450,215,235
050,39,171,"Ohio","Williams County",3,69,438,214,224
050,39,171,"Ohio","Williams County",3,70,389,186,203
050,39,171,"Ohio","Williams County",3,71,366,176,190
050,39,171,"Ohio","Williams County",3,72,353,168,185
050,39,171,"Ohio","Williams County",3,73,358,175,183
050,39,171,"Ohio","Williams County",3,74,373,182,191
050,39,171,"Ohio","Williams County",3,75,264,125,139
050,39,171,"Ohio","Williams County",3,76,260,115,145
050,39,171,"Ohio","Williams County",3,77,264,115,149
050,39,171,"Ohio","Williams County",3,78,269,110,159
050,39,171,"Ohio","Williams County",3,79,226,90,136
050,39,171,"Ohio","Williams County",3,80,230,96,134
050,39,171,"Ohio","Williams County",3,81,189,80,109
050,39,171,"Ohio","Williams County",3,82,176,85,91
050,39,171,"Ohio","Williams County",3,83,164,80,84
050,39,171,"Ohio","Williams County",3,84,143,68,75
050,39,171,"Ohio","Williams County",3,85,847,280,567
050,39,171,"Ohio","Williams County",4,0,384,222,162
050,39,171,"Ohio","Williams County",4,1,396,218,178
050,39,171,"Ohio","Williams County",4,2,417,212,205
050,39,171,"Ohio","Williams County",4,3,439,224,215
050,39,171,"Ohio","Williams County",4,4,429,211,218
050,39,171,"Ohio","Williams County",4,5,430,208,222
050,39,171,"Ohio","Williams County",4,6,428,229,199
050,39,171,"Ohio","Williams County",4,7,454,227,227
050,39,171,"Ohio","Williams County",4,8,475,247,228
050,39,171,"Ohio","Williams County",4,9,436,219,217
050,39,171,"Ohio","Williams County",4,10,457,237,220
050,39,171,"Ohio","Williams County",4,11,452,234,218
050,39,171,"Ohio","Williams County",4,12,436,222,214
050,39,171,"Ohio","Williams County",4,13,447,214,233
050,39,171,"Ohio","Williams County",4,14,494,246,248
050,39,171,"Ohio","Williams County",4,15,499,251,248
050,39,171,"Ohio","Williams County",4,16,503,256,247
050,39,171,"Ohio","Williams County",4,17,480,244,236
050,39,171,"Ohio","Williams County",4,18,450,253,197
050,39,171,"Ohio","Williams County",4,19,361,198,163
050,39,171,"Ohio","Williams County",4,20,403,212,191
050,39,171,"Ohio","Williams County",4,21,406,220,186
050,39,171,"Ohio","Williams County",4,22,423,233,190
050,39,171,"Ohio","Williams County",4,23,435,228,207
050,39,171,"Ohio","Williams County",4,24,438,241,197
050,39,171,"Ohio","Williams County",4,25,431,227,204
050,39,171,"Ohio","Williams County",4,26,386,199,187
050,39,171,"Ohio","Williams County",4,27,429,215,214
050,39,171,"Ohio","Williams County",4,28,428,220,208
050,39,171,"Ohio","Williams County",4,29,430,224,206
050,39,171,"Ohio","Williams County",4,30,459,247,212
050,39,171,"Ohio","Williams County",4,31,463,239,224
050,39,171,"Ohio","Williams County",4,32,447,228,219
050,39,171,"Ohio","Williams County",4,33,431,212,219
050,39,171,"Ohio","Williams County",4,34,403,207,196
050,39,171,"Ohio","Williams County",4,35,439,226,213
050,39,171,"Ohio","Williams County",4,36,456,237,219
050,39,171,"Ohio","Williams County",4,37,478,267,211
050,39,171,"Ohio","Williams County",4,38,441,234,207
050,39,171,"Ohio","Williams County",4,39,423,208,215
050,39,171,"Ohio","Williams County",4,40,460,239,221
050,39,171,"Ohio","Williams County",4,41,467,247,220
050,39,171,"Ohio","Williams County",4,42,464,235,229
050,39,171,"Ohio","Williams County",4,43,451,220,231
050,39,171,"Ohio","Williams County",4,44,441,225,216
050,39,171,"Ohio","Williams County",4,45,420,220,200
050,39,171,"Ohio","Williams County",4,46,406,209,197
050,39,171,"Ohio","Williams County",4,47,420,228,192
050,39,171,"Ohio","Williams County",4,48,403,220,183
050,39,171,"Ohio","Williams County",4,49,408,210,198
050,39,171,"Ohio","Williams County",4,50,444,220,224
050,39,171,"Ohio","Williams County",4,51,467,232,235
050,39,171,"Ohio","Williams County",4,52,450,227,223
050,39,171,"Ohio","Williams County",4,53,436,217,219
050,39,171,"Ohio","Williams County",4,54,432,215,217
050,39,171,"Ohio","Williams County",4,55,435,217,218
050,39,171,"Ohio","Williams County",4,56,432,222,210
050,39,171,"Ohio","Williams County",4,57,508,268,240
050,39,171,"Ohio","Williams County",4,58,517,255,262
050,39,171,"Ohio","Williams County",4,59,530,254,276
050,39,171,"Ohio","Williams County",4,60,515,244,271
050,39,171,"Ohio","Williams County",4,61,531,265,266
050,39,171,"Ohio","Williams County",4,62,578,281,297
050,39,171,"Ohio","Williams County",4,63,563,276,287
050,39,171,"Ohio","Williams County",4,64,534,262,272
050,39,171,"Ohio","Williams County",4,65,526,267,259
050,39,171,"Ohio","Williams County",4,66,509,260,249
050,39,171,"Ohio","Williams County",4,67,495,247,248
050,39,171,"Ohio","Williams County",4,68,490,230,260
050,39,171,"Ohio","Williams County",4,69,438,209,229
050,39,171,"Ohio","Williams County",4,70,419,203,216
050,39,171,"Ohio","Williams County",4,71,376,180,196
050,39,171,"Ohio","Williams County",4,72,356,169,187
050,39,171,"Ohio","Williams County",4,73,345,163,182
050,39,171,"Ohio","Williams County",4,74,341,164,177
050,39,171,"Ohio","Williams County",4,75,362,175,187
050,39,171,"Ohio","Williams County",4,76,265,120,145
050,39,171,"Ohio","Williams County",4,77,246,107,139
050,39,171,"Ohio","Williams County",4,78,256,117,139
050,39,171,"Ohio","Williams County",4,79,255,105,150
050,39,171,"Ohio","Williams County",4,80,207,78,129
050,39,171,"Ohio","Williams County",4,81,215,86,129
050,39,171,"Ohio","Williams County",4,82,177,70,107
050,39,171,"Ohio","Williams County",4,83,168,80,88
050,39,171,"Ohio","Williams County",4,84,147,71,76
050,39,171,"Ohio","Williams County",4,85,827,286,541
050,39,171,"Ohio","Williams County",5,0,399,227,172
050,39,171,"Ohio","Williams County",5,1,370,208,162
050,39,171,"Ohio","Williams County",5,2,379,209,170
050,39,171,"Ohio","Williams County",5,3,423,210,213
050,39,171,"Ohio","Williams County",5,4,434,226,208
050,39,171,"Ohio","Williams County",5,5,433,218,215
050,39,171,"Ohio","Williams County",5,6,435,209,226
050,39,171,"Ohio","Williams County",5,7,423,223,200
050,39,171,"Ohio","Williams County",5,8,467,241,226
050,39,171,"Ohio","Williams County",5,9,460,233,227
050,39,171,"Ohio","Williams County",5,10,436,224,212
050,39,171,"Ohio","Williams County",5,11,448,234,214
050,39,171,"Ohio","Williams County",5,12,451,234,217
050,39,171,"Ohio","Williams County",5,13,450,235,215
050,39,171,"Ohio","Williams County",5,14,459,213,246
050,39,171,"Ohio","Williams County",5,15,496,244,252
050,39,171,"Ohio","Williams County",5,16,507,264,243
050,39,171,"Ohio","Williams County",5,17,514,263,251
050,39,171,"Ohio","Williams County",5,18,419,226,193
050,39,171,"Ohio","Williams County",5,19,370,207,163
050,39,171,"Ohio","Williams County",5,20,406,222,184
050,39,171,"Ohio","Williams County",5,21,432,221,211
050,39,171,"Ohio","Williams County",5,22,421,219,202
050,39,171,"Ohio","Williams County",5,23,417,223,194
050,39,171,"Ohio","Williams County",5,24,450,242,208
050,39,171,"Ohio","Williams County",5,25,422,229,193
050,39,171,"Ohio","Williams County",5,26,423,230,193
050,39,171,"Ohio","Williams County",5,27,392,201,191
050,39,171,"Ohio","Williams County",5,28,443,216,227
050,39,171,"Ohio","Williams County",5,29,438,226,212
050,39,171,"Ohio","Williams County",5,30,399,211,188
050,39,171,"Ohio","Williams County",5,31,461,238,223
050,39,171,"Ohio","Williams County",5,32,470,238,232
050,39,171,"Ohio","Williams County",5,33,458,237,221
050,39,171,"Ohio","Williams County",5,34,428,206,222
050,39,171,"Ohio","Williams County",5,35,407,209,198
050,39,171,"Ohio","Williams County",5,36,453,233,220
050,39,171,"Ohio","Williams County",5,37,450,233,217
050,39,171,"Ohio","Williams County",5,38,477,264,213
050,39,171,"Ohio","Williams County",5,39,436,230,206
050,39,171,"Ohio","Williams County",5,40,426,210,216
050,39,171,"Ohio","Williams County",5,41,460,238,222
050,39,171,"Ohio","Williams County",5,42,463,241,222
050,39,171,"Ohio","Williams County",5,43,467,241,226
050,39,171,"Ohio","Williams County",5,44,442,212,230
050,39,171,"Ohio","Williams County",5,45,452,231,221
050,39,171,"Ohio","Williams County",5,46,416,206,210
050,39,171,"Ohio","Williams County",5,47,420,220,200
050,39,171,"Ohio","Williams County",5,48,413,218,195
050,39,171,"Ohio","Williams County",5,49,423,230,193
050,39,171,"Ohio","Williams County",5,50,406,208,198
050,39,171,"Ohio","Williams County",5,51,439,222,217
050,39,171,"Ohio","Williams County",5,52,455,225,230
050,39,171,"Ohio","Williams County",5,53,454,227,227
050,39,171,"Ohio","Williams County",5,54,427,214,213
050,39,171,"Ohio","Williams County",5,55,434,218,216
050,39,171,"Ohio","Williams County",5,56,426,211,215
050,39,171,"Ohio","Williams County",5,57,434,219,215
050,39,171,"Ohio","Williams County",5,58,507,264,243
050,39,171,"Ohio","Williams County",5,59,502,253,249
050,39,171,"Ohio","Williams County",5,60,516,249,267
050,39,171,"Ohio","Williams County",5,61,507,241,266
050,39,171,"Ohio","Williams County",5,62,536,265,271
050,39,171,"Ohio","Williams County",5,63,575,282,293
050,39,171,"Ohio","Williams County",5,64,554,264,290
050,39,171,"Ohio","Williams County",5,65,524,253,271
050,39,171,"Ohio","Williams County",5,66,513,261,252
050,39,171,"Ohio","Williams County",5,67,498,254,244
050,39,171,"Ohio","Williams County",5,68,497,247,250
050,39,171,"Ohio","Williams County",5,69,476,222,254
050,39,171,"Ohio","Williams County",5,70,422,198,224
050,39,171,"Ohio","Williams County",5,71,416,202,214
050,39,171,"Ohio","Williams County",5,72,363,178,185
050,39,171,"Ohio","Williams County",5,73,351,168,183
050,39,171,"Ohio","Williams County",5,74,331,151,180
050,39,171,"Ohio","Williams County",5,75,327,157,170
050,39,171,"Ohio","Williams County",5,76,355,169,186
050,39,171,"Ohio","Williams County",5,77,251,115,136
050,39,171,"Ohio","Williams County",5,78,231,101,130
050,39,171,"Ohio","Williams County",5,79,239,105,134
050,39,171,"Ohio","Williams County",5,80,226,92,134
050,39,171,"Ohio","Williams County",5,81,188,67,121
050,39,171,"Ohio","Williams County",5,82,202,76,126
050,39,171,"Ohio","Williams County",5,83,177,69,108
050,39,171,"Ohio","Williams County",5,84,154,74,80
050,39,171,"Ohio","Williams County",5,85,840,304,536
050,39,173,"Ohio","Wood County",1,0,1254,638,616
050,39,173,"Ohio","Wood County",1,1,1299,635,664
050,39,173,"Ohio","Wood County",1,2,1393,701,692
050,39,173,"Ohio","Wood County",1,3,1414,691,723
050,39,173,"Ohio","Wood County",1,4,1459,726,733
050,39,173,"Ohio","Wood County",1,5,1469,748,721
050,39,173,"Ohio","Wood County",1,6,1513,781,732
050,39,173,"Ohio","Wood County",1,7,1443,757,686
050,39,173,"Ohio","Wood County",1,8,1463,755,708
050,39,173,"Ohio","Wood County",1,9,1464,764,700
050,39,173,"Ohio","Wood County",1,10,1568,836,732
050,39,173,"Ohio","Wood County",1,11,1618,841,777
050,39,173,"Ohio","Wood County",1,12,1623,811,812
050,39,173,"Ohio","Wood County",1,13,1614,810,804
050,39,173,"Ohio","Wood County",1,14,1580,838,742
050,39,173,"Ohio","Wood County",1,15,1678,891,787
050,39,173,"Ohio","Wood County",1,16,1688,874,814
050,39,173,"Ohio","Wood County",1,17,1558,811,747
050,39,173,"Ohio","Wood County",1,18,2472,1142,1330
050,39,173,"Ohio","Wood County",1,19,3916,1837,2079
050,39,173,"Ohio","Wood County",1,20,3768,1783,1985
050,39,173,"Ohio","Wood County",1,21,3732,1876,1856
050,39,173,"Ohio","Wood County",1,22,3435,1635,1800
050,39,173,"Ohio","Wood County",1,23,2748,1354,1394
050,39,173,"Ohio","Wood County",1,24,2120,1116,1004
050,39,173,"Ohio","Wood County",1,25,1941,1007,934
050,39,173,"Ohio","Wood County",1,26,1807,947,860
050,39,173,"Ohio","Wood County",1,27,1677,882,795
050,39,173,"Ohio","Wood County",1,28,1624,823,801
050,39,173,"Ohio","Wood County",1,29,1620,863,757
050,39,173,"Ohio","Wood County",1,30,1525,785,740
050,39,173,"Ohio","Wood County",1,31,1540,778,762
050,39,173,"Ohio","Wood County",1,32,1537,777,760
050,39,173,"Ohio","Wood County",1,33,1471,763,708
050,39,173,"Ohio","Wood County",1,34,1512,788,724
050,39,173,"Ohio","Wood County",1,35,1528,788,740
050,39,173,"Ohio","Wood County",1,36,1540,801,739
050,39,173,"Ohio","Wood County",1,37,1527,780,747
050,39,173,"Ohio","Wood County",1,38,1586,826,760
050,39,173,"Ohio","Wood County",1,39,1565,803,762
050,39,173,"Ohio","Wood County",1,40,1507,783,724
050,39,173,"Ohio","Wood County",1,41,1486,767,719
050,39,173,"Ohio","Wood County",1,42,1494,766,728
050,39,173,"Ohio","Wood County",1,43,1450,733,717
050,39,173,"Ohio","Wood County",1,44,1395,689,706
050,39,173,"Ohio","Wood County",1,45,1435,774,661
050,39,173,"Ohio","Wood County",1,46,1409,742,667
050,39,173,"Ohio","Wood County",1,47,1496,756,740
050,39,173,"Ohio","Wood County",1,48,1510,750,760
050,39,173,"Ohio","Wood County",1,49,1635,823,812
050,39,173,"Ohio","Wood County",1,50,1553,776,777
050,39,173,"Ohio","Wood County",1,51,1435,713,722
050,39,173,"Ohio","Wood County",1,52,1407,720,687
050,39,173,"Ohio","Wood County",1,53,1455,746,709
050,39,173,"Ohio","Wood County",1,54,1489,728,761
050,39,173,"Ohio","Wood County",1,55,1562,778,784
050,39,173,"Ohio","Wood County",1,56,1565,767,798
050,39,173,"Ohio","Wood County",1,57,1603,775,828
050,39,173,"Ohio","Wood County",1,58,1660,799,861
050,39,173,"Ohio","Wood County",1,59,1605,794,811
050,39,173,"Ohio","Wood County",1,60,1604,806,798
050,39,173,"Ohio","Wood County",1,61,1625,817,808
050,39,173,"Ohio","Wood County",1,62,1656,823,833
050,39,173,"Ohio","Wood County",1,63,1629,784,845
050,39,173,"Ohio","Wood County",1,64,1594,773,821
050,39,173,"Ohio","Wood County",1,65,1502,715,787
050,39,173,"Ohio","Wood County",1,66,1454,712,742
050,39,173,"Ohio","Wood County",1,67,1408,702,706
050,39,173,"Ohio","Wood County",1,68,1395,676,719
050,39,173,"Ohio","Wood County",1,69,1291,609,682
050,39,173,"Ohio","Wood County",1,70,1269,624,645
050,39,173,"Ohio","Wood County",1,71,1187,569,618
050,39,173,"Ohio","Wood County",1,72,1181,547,634
050,39,173,"Ohio","Wood County",1,73,1176,525,651
050,39,173,"Ohio","Wood County",1,74,780,363,417
050,39,173,"Ohio","Wood County",1,75,771,371,400
050,39,173,"Ohio","Wood County",1,76,746,338,408
050,39,173,"Ohio","Wood County",1,77,747,316,431
050,39,173,"Ohio","Wood County",1,78,625,281,344
050,39,173,"Ohio","Wood County",1,79,575,243,332
050,39,173,"Ohio","Wood County",1,80,519,214,305
050,39,173,"Ohio","Wood County",1,81,487,187,300
050,39,173,"Ohio","Wood County",1,82,443,185,258
050,39,173,"Ohio","Wood County",1,83,413,174,239
050,39,173,"Ohio","Wood County",1,84,373,145,228
050,39,173,"Ohio","Wood County",1,85,2357,845,1512
050,39,173,"Ohio","Wood County",2,0,1256,632,624
050,39,173,"Ohio","Wood County",2,1,1290,635,655
050,39,173,"Ohio","Wood County",2,2,1375,686,689
050,39,173,"Ohio","Wood County",2,3,1411,694,717
050,39,173,"Ohio","Wood County",2,4,1461,725,736
050,39,173,"Ohio","Wood County",2,5,1473,746,727
050,39,173,"Ohio","Wood County",2,6,1503,776,727
050,39,173,"Ohio","Wood County",2,7,1461,767,694
050,39,173,"Ohio","Wood County",2,8,1457,756,701
050,39,173,"Ohio","Wood County",2,9,1467,763,704
050,39,173,"Ohio","Wood County",2,10,1544,816,728
050,39,173,"Ohio","Wood County",2,11,1601,838,763
050,39,173,"Ohio","Wood County",2,12,1629,823,806
050,39,173,"Ohio","Wood County",2,13,1611,809,802
050,39,173,"Ohio","Wood County",2,14,1593,835,758
050,39,173,"Ohio","Wood County",2,15,1663,882,781
050,39,173,"Ohio","Wood County",2,16,1685,880,805
050,39,173,"Ohio","Wood County",2,17,1587,830,757
050,39,173,"Ohio","Wood County",2,18,2461,1135,1326
050,39,173,"Ohio","Wood County",2,19,3900,1829,2071
050,39,173,"Ohio","Wood County",2,20,3803,1798,2005
050,39,173,"Ohio","Wood County",2,21,3716,1860,1856
050,39,173,"Ohio","Wood County",2,22,3417,1639,1778
050,39,173,"Ohio","Wood County",2,23,2748,1351,1397
050,39,173,"Ohio","Wood County",2,24,2107,1098,1009
050,39,173,"Ohio","Wood County",2,25,1956,1007,949
050,39,173,"Ohio","Wood County",2,26,1800,946,854
050,39,173,"Ohio","Wood County",2,27,1670,876,794
050,39,173,"Ohio","Wood County",2,28,1638,842,796
050,39,173,"Ohio","Wood County",2,29,1616,851,765
050,39,173,"Ohio","Wood County",2,30,1562,812,750
050,39,173,"Ohio","Wood County",2,31,1537,778,759
050,39,173,"Ohio","Wood County",2,32,1535,774,761
050,39,173,"Ohio","Wood County",2,33,1490,767,723
050,39,173,"Ohio","Wood County",2,34,1502,780,722
050,39,173,"Ohio","Wood County",2,35,1543,801,742
050,39,173,"Ohio","Wood County",2,36,1527,792,735
050,39,173,"Ohio","Wood County",2,37,1533,788,745
050,39,173,"Ohio","Wood County",2,38,1577,815,762
050,39,173,"Ohio","Wood County",2,39,1567,807,760
050,39,173,"Ohio","Wood County",2,40,1533,793,740
050,39,173,"Ohio","Wood County",2,41,1494,770,724
050,39,173,"Ohio","Wood County",2,42,1486,765,721
050,39,173,"Ohio","Wood County",2,43,1469,744,725
050,39,173,"Ohio","Wood County",2,44,1397,698,699
050,39,173,"Ohio","Wood County",2,45,1431,756,675
050,39,173,"Ohio","Wood County",2,46,1411,747,664
050,39,173,"Ohio","Wood County",2,47,1470,752,718
050,39,173,"Ohio","Wood County",2,48,1503,751,752
050,39,173,"Ohio","Wood County",2,49,1611,811,800
050,39,173,"Ohio","Wood County",2,50,1571,789,782
050,39,173,"Ohio","Wood County",2,51,1454,725,729
050,39,173,"Ohio","Wood County",2,52,1406,714,692
050,39,173,"Ohio","Wood County",2,53,1439,732,707
050,39,173,"Ohio","Wood County",2,54,1474,732,742
050,39,173,"Ohio","Wood County",2,55,1546,765,781
050,39,173,"Ohio","Wood County",2,56,1570,773,797
050,39,173,"Ohio","Wood County",2,57,1600,776,824
050,39,173,"Ohio","Wood County",2,58,1637,789,848
050,39,173,"Ohio","Wood County",2,59,1618,797,821
050,39,173,"Ohio","Wood County",2,60,1597,799,798
050,39,173,"Ohio","Wood County",2,61,1606,807,799
050,39,173,"Ohio","Wood County",2,62,1643,820,823
050,39,173,"Ohio","Wood County",2,63,1642,799,843
050,39,173,"Ohio","Wood County",2,64,1592,771,821
050,39,173,"Ohio","Wood County",2,65,1515,723,792
050,39,173,"Ohio","Wood County",2,66,1461,712,749
050,39,173,"Ohio","Wood County",2,67,1407,695,712
050,39,173,"Ohio","Wood County",2,68,1377,670,707
050,39,173,"Ohio","Wood County",2,69,1320,625,695
050,39,173,"Ohio","Wood County",2,70,1262,617,645
050,39,173,"Ohio","Wood County",2,71,1199,577,622
050,39,173,"Ohio","Wood County",2,72,1159,539,620
050,39,173,"Ohio","Wood County",2,73,1230,554,676
050,39,173,"Ohio","Wood County",2,74,817,373,444
050,39,173,"Ohio","Wood County",2,75,764,364,400
050,39,173,"Ohio","Wood County",2,76,740,339,401
050,39,173,"Ohio","Wood County",2,77,757,324,433
050,39,173,"Ohio","Wood County",2,78,633,281,352
050,39,173,"Ohio","Wood County",2,79,578,247,331
050,39,173,"Ohio","Wood County",2,80,527,217,310
050,39,173,"Ohio","Wood County",2,81,484,186,298
050,39,173,"Ohio","Wood County",2,82,452,186,266
050,39,173,"Ohio","Wood County",2,83,405,167,238
050,39,173,"Ohio","Wood County",2,84,378,148,230
050,39,173,"Ohio","Wood County",2,85,2319,828,1491
050,39,173,"Ohio","Wood County",3,0,1211,603,608
050,39,173,"Ohio","Wood County",3,1,1261,648,613
050,39,173,"Ohio","Wood County",3,2,1344,662,682
050,39,173,"Ohio","Wood County",3,3,1392,666,726
050,39,173,"Ohio","Wood County",3,4,1457,715,742
050,39,173,"Ohio","Wood County",3,5,1441,712,729
050,39,173,"Ohio","Wood County",3,6,1498,758,740
050,39,173,"Ohio","Wood County",3,7,1509,781,728
050,39,173,"Ohio","Wood County",3,8,1451,752,699
050,39,173,"Ohio","Wood County",3,9,1471,767,704
050,39,173,"Ohio","Wood County",3,10,1446,750,696
050,39,173,"Ohio","Wood County",3,11,1548,805,743
050,39,173,"Ohio","Wood County",3,12,1634,855,779
050,39,173,"Ohio","Wood County",3,13,1664,836,828
050,39,173,"Ohio","Wood County",3,14,1619,815,804
050,39,173,"Ohio","Wood County",3,15,1619,849,770
050,39,173,"Ohio","Wood County",3,16,1673,876,797
050,39,173,"Ohio","Wood County",3,17,1679,885,794
050,39,173,"Ohio","Wood County",3,18,2061,982,1079
050,39,173,"Ohio","Wood County",3,19,2834,1355,1479
050,39,173,"Ohio","Wood County",3,20,3236,1530,1706
050,39,173,"Ohio","Wood County",3,21,3594,1803,1791
050,39,173,"Ohio","Wood County",3,22,3340,1649,1691
050,39,173,"Ohio","Wood County",3,23,2733,1391,1342
050,39,173,"Ohio","Wood County",3,24,2109,1063,1046
050,39,173,"Ohio","Wood County",3,25,1984,1000,984
050,39,173,"Ohio","Wood County",3,26,1750,935,815
050,39,173,"Ohio","Wood County",3,27,1729,909,820
050,39,173,"Ohio","Wood County",3,28,1628,886,742
050,39,173,"Ohio","Wood County",3,29,1586,813,773
050,39,173,"Ohio","Wood County",3,30,1601,830,771
050,39,173,"Ohio","Wood County",3,31,1569,806,763
050,39,173,"Ohio","Wood County",3,32,1537,774,763
050,39,173,"Ohio","Wood County",3,33,1541,774,767
050,39,173,"Ohio","Wood County",3,34,1514,796,718
050,39,173,"Ohio","Wood County",3,35,1548,798,750
050,39,173,"Ohio","Wood County",3,36,1549,791,758
050,39,173,"Ohio","Wood County",3,37,1533,794,739
050,39,173,"Ohio","Wood County",3,38,1543,799,744
050,39,173,"Ohio","Wood County",3,39,1574,817,757
050,39,173,"Ohio","Wood County",3,40,1580,819,761
050,39,173,"Ohio","Wood County",3,41,1561,809,752
050,39,173,"Ohio","Wood County",3,42,1475,759,716
050,39,173,"Ohio","Wood County",3,43,1471,757,714
050,39,173,"Ohio","Wood County",3,44,1476,762,714
050,39,173,"Ohio","Wood County",3,45,1394,699,695
050,39,173,"Ohio","Wood County",3,46,1444,763,681
050,39,173,"Ohio","Wood County",3,47,1413,749,664
050,39,173,"Ohio","Wood County",3,48,1482,750,732
050,39,173,"Ohio","Wood County",3,49,1511,748,763
050,39,173,"Ohio","Wood County",3,50,1602,809,793
050,39,173,"Ohio","Wood County",3,51,1560,786,774
050,39,173,"Ohio","Wood County",3,52,1434,712,722
050,39,173,"Ohio","Wood County",3,53,1407,704,703
050,39,173,"Ohio","Wood County",3,54,1418,724,694
050,39,173,"Ohio","Wood County",3,55,1467,730,737
050,39,173,"Ohio","Wood County",3,56,1540,770,770
050,39,173,"Ohio","Wood County",3,57,1551,764,787
050,39,173,"Ohio","Wood County",3,58,1587,776,811
050,39,173,"Ohio","Wood County",3,59,1598,771,827
050,39,173,"Ohio","Wood County",3,60,1613,790,823
050,39,173,"Ohio","Wood County",3,61,1600,801,799
050,39,173,"Ohio","Wood County",3,62,1593,789,804
050,39,173,"Ohio","Wood County",3,63,1610,803,807
050,39,173,"Ohio","Wood County",3,64,1607,777,830
050,39,173,"Ohio","Wood County",3,65,1573,758,815
050,39,173,"Ohio","Wood County",3,66,1490,709,781
050,39,173,"Ohio","Wood County",3,67,1441,700,741
050,39,173,"Ohio","Wood County",3,68,1351,662,689
050,39,173,"Ohio","Wood County",3,69,1370,666,704
050,39,173,"Ohio","Wood County",3,70,1287,614,673
050,39,173,"Ohio","Wood County",3,71,1220,591,629
050,39,173,"Ohio","Wood County",3,72,1168,548,620
050,39,173,"Ohio","Wood County",3,73,1137,526,611
050,39,173,"Ohio","Wood County",3,74,1191,535,656
050,39,173,"Ohio","Wood County",3,75,771,349,422
050,39,173,"Ohio","Wood County",3,76,739,339,400
050,39,173,"Ohio","Wood County",3,77,710,323,387
050,39,173,"Ohio","Wood County",3,78,731,308,423
050,39,173,"Ohio","Wood County",3,79,605,263,342
050,39,173,"Ohio","Wood County",3,80,537,233,304
050,39,173,"Ohio","Wood County",3,81,501,203,298
050,39,173,"Ohio","Wood County",3,82,437,165,272
050,39,173,"Ohio","Wood County",3,83,416,163,253
050,39,173,"Ohio","Wood County",3,84,380,157,223
050,39,173,"Ohio","Wood County",3,85,2251,797,1454
050,39,173,"Ohio","Wood County",4,0,1239,636,603
050,39,173,"Ohio","Wood County",4,1,1258,607,651
050,39,173,"Ohio","Wood County",4,2,1308,673,635
050,39,173,"Ohio","Wood County",4,3,1369,690,679
050,39,173,"Ohio","Wood County",4,4,1445,681,764
050,39,173,"Ohio","Wood County",4,5,1480,716,764
050,39,173,"Ohio","Wood County",4,6,1487,735,752
050,39,173,"Ohio","Wood County",4,7,1532,786,746
050,39,173,"Ohio","Wood County",4,8,1527,784,743
050,39,173,"Ohio","Wood County",4,9,1442,763,679
050,39,173,"Ohio","Wood County",4,10,1463,757,706
050,39,173,"Ohio","Wood County",4,11,1476,763,713
050,39,173,"Ohio","Wood County",4,12,1569,821,748
050,39,173,"Ohio","Wood County",4,13,1641,863,778
050,39,173,"Ohio","Wood County",4,14,1658,826,832
050,39,173,"Ohio","Wood County",4,15,1641,828,813
050,39,173,"Ohio","Wood County",4,16,1588,821,767
050,39,173,"Ohio","Wood County",4,17,1654,856,798
050,39,173,"Ohio","Wood County",4,18,2297,1094,1203
050,39,173,"Ohio","Wood County",4,19,3319,1582,1737
050,39,173,"Ohio","Wood County",4,20,3363,1591,1772
050,39,173,"Ohio","Wood County",4,21,3675,1817,1858
050,39,173,"Ohio","Wood County",4,22,3479,1685,1794
050,39,173,"Ohio","Wood County",4,23,2729,1389,1340
050,39,173,"Ohio","Wood County",4,24,2082,1102,980
050,39,173,"Ohio","Wood County",4,25,1974,986,988
050,39,173,"Ohio","Wood County",4,26,1743,905,838
050,39,173,"Ohio","Wood County",4,27,1634,851,783
050,39,173,"Ohio","Wood County",4,28,1681,880,801
050,39,173,"Ohio","Wood County",4,29,1640,870,770
050,39,173,"Ohio","Wood County",4,30,1545,804,741
050,39,173,"Ohio","Wood County",4,31,1605,822,783
050,39,173,"Ohio","Wood County",4,32,1593,807,786
050,39,173,"Ohio","Wood County",4,33,1541,768,773
050,39,173,"Ohio","Wood County",4,34,1556,788,768
050,39,173,"Ohio","Wood County",4,35,1536,802,734
050,39,173,"Ohio","Wood County",4,36,1572,809,763
050,39,173,"Ohio","Wood County",4,37,1575,814,761
050,39,173,"Ohio","Wood County",4,38,1560,807,753
050,39,173,"Ohio","Wood County",4,39,1555,806,749
050,39,173,"Ohio","Wood County",4,40,1575,823,752
050,39,173,"Ohio","Wood County",4,41,1591,809,782
050,39,173,"Ohio","Wood County",4,42,1557,821,736
050,39,173,"Ohio","Wood County",4,43,1485,766,719
050,39,173,"Ohio","Wood County",4,44,1455,757,698
050,39,173,"Ohio","Wood County",4,45,1487,772,715
050,39,173,"Ohio","Wood County",4,46,1395,697,698
050,39,173,"Ohio","Wood County",4,47,1438,758,680
050,39,173,"Ohio","Wood County",4,48,1396,739,657
050,39,173,"Ohio","Wood County",4,49,1476,751,725
050,39,173,"Ohio","Wood County",4,50,1514,754,760
050,39,173,"Ohio","Wood County",4,51,1578,790,788
050,39,173,"Ohio","Wood County",4,52,1542,778,764
050,39,173,"Ohio","Wood County",4,53,1437,712,725
050,39,173,"Ohio","Wood County",4,54,1413,714,699
050,39,173,"Ohio","Wood County",4,55,1430,724,706
050,39,173,"Ohio","Wood County",4,56,1433,714,719
050,39,173,"Ohio","Wood County",4,57,1536,764,772
050,39,173,"Ohio","Wood County",4,58,1539,752,787
050,39,173,"Ohio","Wood County",4,59,1560,772,788
050,39,173,"Ohio","Wood County",4,60,1578,767,811
050,39,173,"Ohio","Wood County",4,61,1603,773,830
050,39,173,"Ohio","Wood County",4,62,1572,784,788
050,39,173,"Ohio","Wood County",4,63,1561,767,794
050,39,173,"Ohio","Wood County",4,64,1589,795,794
050,39,173,"Ohio","Wood County",4,65,1577,764,813
050,39,173,"Ohio","Wood County",4,66,1540,734,806
050,39,173,"Ohio","Wood County",4,67,1443,675,768
050,39,173,"Ohio","Wood County",4,68,1420,680,740
050,39,173,"Ohio","Wood County",4,69,1325,646,679
050,39,173,"Ohio","Wood County",4,70,1342,655,687
050,39,173,"Ohio","Wood County",4,71,1245,588,657
050,39,173,"Ohio","Wood County",4,72,1197,570,627
050,39,173,"Ohio","Wood County",4,73,1132,533,599
050,39,173,"Ohio","Wood County",4,74,1125,525,600
050,39,173,"Ohio","Wood County",4,75,1153,516,637
050,39,173,"Ohio","Wood County",4,76,754,334,420
050,39,173,"Ohio","Wood County",4,77,723,328,395
050,39,173,"Ohio","Wood County",4,78,689,314,375
050,39,173,"Ohio","Wood County",4,79,688,283,405
050,39,173,"Ohio","Wood County",4,80,567,243,324
050,39,173,"Ohio","Wood County",4,81,511,215,296
050,39,173,"Ohio","Wood County",4,82,456,193,263
050,39,173,"Ohio","Wood County",4,83,389,138,251
050,39,173,"Ohio","Wood County",4,84,385,150,235
050,39,173,"Ohio","Wood County",4,85,2210,773,1437
050,39,173,"Ohio","Wood County",5,0,1249,649,600
050,39,173,"Ohio","Wood County",5,1,1254,623,631
050,39,173,"Ohio","Wood County",5,2,1293,628,665
050,39,173,"Ohio","Wood County",5,3,1296,657,639
050,39,173,"Ohio","Wood County",5,4,1402,706,696
050,39,173,"Ohio","Wood County",5,5,1455,699,756
050,39,173,"Ohio","Wood County",5,6,1490,738,752
050,39,173,"Ohio","Wood County",5,7,1490,737,753
050,39,173,"Ohio","Wood County",5,8,1530,790,740
050,39,173,"Ohio","Wood County",5,9,1542,773,769
050,39,173,"Ohio","Wood County",5,10,1445,755,690
050,39,173,"Ohio","Wood County",5,11,1476,762,714
050,39,173,"Ohio","Wood County",5,12,1455,745,710
050,39,173,"Ohio","Wood County",5,13,1584,828,756
050,39,173,"Ohio","Wood County",5,14,1677,884,793
050,39,173,"Ohio","Wood County",5,15,1669,831,838
050,39,173,"Ohio","Wood County",5,16,1646,827,819
050,39,173,"Ohio","Wood County",5,17,1605,826,779
050,39,173,"Ohio","Wood County",5,18,2399,1112,1287
050,39,173,"Ohio","Wood County",5,19,3623,1717,1906
050,39,173,"Ohio","Wood County",5,20,3621,1718,1903
050,39,173,"Ohio","Wood County",5,21,3550,1759,1791
050,39,173,"Ohio","Wood County",5,22,3443,1657,1786
050,39,173,"Ohio","Wood County",5,23,2857,1435,1422
050,39,173,"Ohio","Wood County",5,24,2067,1099,968
050,39,173,"Ohio","Wood County",5,25,1926,989,937
050,39,173,"Ohio","Wood County",5,26,1824,934,890
050,39,173,"Ohio","Wood County",5,27,1663,860,803
050,39,173,"Ohio","Wood County",5,28,1645,854,791
050,39,173,"Ohio","Wood County",5,29,1653,874,779
050,39,173,"Ohio","Wood County",5,30,1625,871,754
050,39,173,"Ohio","Wood County",5,31,1556,805,751
050,39,173,"Ohio","Wood County",5,32,1594,818,776
050,39,173,"Ohio","Wood County",5,33,1585,805,780
050,39,173,"Ohio","Wood County",5,34,1521,758,763
050,39,173,"Ohio","Wood County",5,35,1531,771,760
050,39,173,"Ohio","Wood County",5,36,1538,801,737
050,39,173,"Ohio","Wood County",5,37,1566,800,766
050,39,173,"Ohio","Wood County",5,38,1588,807,781
050,39,173,"Ohio","Wood County",5,39,1568,812,756
050,39,173,"Ohio","Wood County",5,40,1543,809,734
050,39,173,"Ohio","Wood County",5,41,1596,841,755
050,39,173,"Ohio","Wood County",5,42,1582,806,776
050,39,173,"Ohio","Wood County",5,43,1583,841,742
050,39,173,"Ohio","Wood County",5,44,1475,755,720
050,39,173,"Ohio","Wood County",5,45,1450,750,700
050,39,173,"Ohio","Wood County",5,46,1485,772,713
050,39,173,"Ohio","Wood County",5,47,1374,681,693
050,39,173,"Ohio","Wood County",5,48,1444,767,677
050,39,173,"Ohio","Wood County",5,49,1396,732,664
050,39,173,"Ohio","Wood County",5,50,1489,759,730
050,39,173,"Ohio","Wood County",5,51,1533,759,774
050,39,173,"Ohio","Wood County",5,52,1574,792,782
050,39,173,"Ohio","Wood County",5,53,1517,766,751
050,39,173,"Ohio","Wood County",5,54,1435,710,725
050,39,173,"Ohio","Wood County",5,55,1410,706,704
050,39,173,"Ohio","Wood County",5,56,1432,726,706
050,39,173,"Ohio","Wood County",5,57,1427,716,711
050,39,173,"Ohio","Wood County",5,58,1520,751,769
050,39,173,"Ohio","Wood County",5,59,1533,752,781
050,39,173,"Ohio","Wood County",5,60,1548,770,778
050,39,173,"Ohio","Wood County",5,61,1568,760,808
050,39,173,"Ohio","Wood County",5,62,1570,752,818
050,39,173,"Ohio","Wood County",5,63,1550,759,791
050,39,173,"Ohio","Wood County",5,64,1571,770,801
050,39,173,"Ohio","Wood County",5,65,1561,778,783
050,39,173,"Ohio","Wood County",5,66,1555,756,799
050,39,173,"Ohio","Wood County",5,67,1523,716,807
050,39,173,"Ohio","Wood County",5,68,1423,660,763
050,39,173,"Ohio","Wood County",5,69,1387,667,720
050,39,173,"Ohio","Wood County",5,70,1305,634,671
050,39,173,"Ohio","Wood County",5,71,1316,643,673
050,39,173,"Ohio","Wood County",5,72,1227,574,653
050,39,173,"Ohio","Wood County",5,73,1165,558,607
050,39,173,"Ohio","Wood County",5,74,1111,523,588
050,39,173,"Ohio","Wood County",5,75,1081,510,571
050,39,173,"Ohio","Wood County",5,76,1129,494,635
050,39,173,"Ohio","Wood County",5,77,736,321,415
050,39,173,"Ohio","Wood County",5,78,696,320,376
050,39,173,"Ohio","Wood County",5,79,645,287,358
050,39,173,"Ohio","Wood County",5,80,652,268,384
050,39,173,"Ohio","Wood County",5,81,539,224,315
050,39,173,"Ohio","Wood County",5,82,482,207,275
050,39,173,"Ohio","Wood County",5,83,428,171,257
050,39,173,"Ohio","Wood County",5,84,360,126,234
050,39,173,"Ohio","Wood County",5,85,2223,769,1454
050,39,175,"Ohio","Wyandot County",1,0,221,113,108
050,39,175,"Ohio","Wyandot County",1,1,224,112,112
050,39,175,"Ohio","Wyandot County",1,2,232,110,122
050,39,175,"Ohio","Wyandot County",1,3,261,133,128
050,39,175,"Ohio","Wyandot County",1,4,264,134,130
050,39,175,"Ohio","Wyandot County",1,5,256,134,122
050,39,175,"Ohio","Wyandot County",1,6,273,143,130
050,39,175,"Ohio","Wyandot County",1,7,278,143,135
050,39,175,"Ohio","Wyandot County",1,8,268,124,144
050,39,175,"Ohio","Wyandot County",1,9,254,123,131
050,39,175,"Ohio","Wyandot County",1,10,294,146,148
050,39,175,"Ohio","Wyandot County",1,11,299,173,126
050,39,175,"Ohio","Wyandot County",1,12,304,157,147
050,39,175,"Ohio","Wyandot County",1,13,297,148,149
050,39,175,"Ohio","Wyandot County",1,14,311,161,150
050,39,175,"Ohio","Wyandot County",1,15,294,152,142
050,39,175,"Ohio","Wyandot County",1,16,313,165,148
050,39,175,"Ohio","Wyandot County",1,17,301,153,148
050,39,175,"Ohio","Wyandot County",1,18,265,142,123
050,39,175,"Ohio","Wyandot County",1,19,202,107,95
050,39,175,"Ohio","Wyandot County",1,20,206,109,97
050,39,175,"Ohio","Wyandot County",1,21,226,124,102
050,39,175,"Ohio","Wyandot County",1,22,237,128,109
050,39,175,"Ohio","Wyandot County",1,23,219,117,102
050,39,175,"Ohio","Wyandot County",1,24,256,145,111
050,39,175,"Ohio","Wyandot County",1,25,250,124,126
050,39,175,"Ohio","Wyandot County",1,26,237,121,116
050,39,175,"Ohio","Wyandot County",1,27,230,126,104
050,39,175,"Ohio","Wyandot County",1,28,246,131,115
050,39,175,"Ohio","Wyandot County",1,29,231,116,115
050,39,175,"Ohio","Wyandot County",1,30,249,133,116
050,39,175,"Ohio","Wyandot County",1,31,220,108,112
050,39,175,"Ohio","Wyandot County",1,32,242,117,125
050,39,175,"Ohio","Wyandot County",1,33,245,122,123
050,39,175,"Ohio","Wyandot County",1,34,257,124,133
050,39,175,"Ohio","Wyandot County",1,35,244,124,120
050,39,175,"Ohio","Wyandot County",1,36,244,113,131
050,39,175,"Ohio","Wyandot County",1,37,272,138,134
050,39,175,"Ohio","Wyandot County",1,38,282,152,130
050,39,175,"Ohio","Wyandot County",1,39,280,140,140
050,39,175,"Ohio","Wyandot County",1,40,287,144,143
050,39,175,"Ohio","Wyandot County",1,41,261,135,126
050,39,175,"Ohio","Wyandot County",1,42,258,129,129
050,39,175,"Ohio","Wyandot County",1,43,245,130,115
050,39,175,"Ohio","Wyandot County",1,44,259,134,125
050,39,175,"Ohio","Wyandot County",1,45,263,134,129
050,39,175,"Ohio","Wyandot County",1,46,269,135,134
050,39,175,"Ohio","Wyandot County",1,47,262,130,132
050,39,175,"Ohio","Wyandot County",1,48,289,148,141
050,39,175,"Ohio","Wyandot County",1,49,308,161,147
050,39,175,"Ohio","Wyandot County",1,50,275,140,135
050,39,175,"Ohio","Wyandot County",1,51,252,127,125
050,39,175,"Ohio","Wyandot County",1,52,247,121,126
050,39,175,"Ohio","Wyandot County",1,53,279,139,140
050,39,175,"Ohio","Wyandot County",1,54,293,146,147
050,39,175,"Ohio","Wyandot County",1,55,347,180,167
050,39,175,"Ohio","Wyandot County",1,56,316,167,149
050,39,175,"Ohio","Wyandot County",1,57,305,158,147
050,39,175,"Ohio","Wyandot County",1,58,317,167,150
050,39,175,"Ohio","Wyandot County",1,59,324,160,164
050,39,175,"Ohio","Wyandot County",1,60,327,161,166
050,39,175,"Ohio","Wyandot County",1,61,331,164,167
050,39,175,"Ohio","Wyandot County",1,62,325,162,163
050,39,175,"Ohio","Wyandot County",1,63,296,143,153
050,39,175,"Ohio","Wyandot County",1,64,307,148,159
050,39,175,"Ohio","Wyandot County",1,65,298,150,148
050,39,175,"Ohio","Wyandot County",1,66,297,153,144
050,39,175,"Ohio","Wyandot County",1,67,284,138,146
050,39,175,"Ohio","Wyandot County",1,68,265,121,144
050,39,175,"Ohio","Wyandot County",1,69,231,109,122
050,39,175,"Ohio","Wyandot County",1,70,244,120,124
050,39,175,"Ohio","Wyandot County",1,71,244,113,131
050,39,175,"Ohio","Wyandot County",1,72,245,108,137
050,39,175,"Ohio","Wyandot County",1,73,219,107,112
050,39,175,"Ohio","Wyandot County",1,74,165,84,81
050,39,175,"Ohio","Wyandot County",1,75,163,79,84
050,39,175,"Ohio","Wyandot County",1,76,158,73,85
050,39,175,"Ohio","Wyandot County",1,77,167,81,86
050,39,175,"Ohio","Wyandot County",1,78,152,74,78
050,39,175,"Ohio","Wyandot County",1,79,136,63,73
050,39,175,"Ohio","Wyandot County",1,80,103,48,55
050,39,175,"Ohio","Wyandot County",1,81,125,45,80
050,39,175,"Ohio","Wyandot County",1,82,128,57,71
050,39,175,"Ohio","Wyandot County",1,83,103,46,57
050,39,175,"Ohio","Wyandot County",1,84,96,37,59
050,39,175,"Ohio","Wyandot County",1,85,547,166,381
050,39,175,"Ohio","Wyandot County",2,0,206,107,99
050,39,175,"Ohio","Wyandot County",2,1,222,110,112
050,39,175,"Ohio","Wyandot County",2,2,232,112,120
050,39,175,"Ohio","Wyandot County",2,3,253,126,127
050,39,175,"Ohio","Wyandot County",2,4,264,135,129
050,39,175,"Ohio","Wyandot County",2,5,261,137,124
050,39,175,"Ohio","Wyandot County",2,6,270,142,128
050,39,175,"Ohio","Wyandot County",2,7,278,142,136
050,39,175,"Ohio","Wyandot County",2,8,269,127,142
050,39,175,"Ohio","Wyandot County",2,9,258,125,133
050,39,175,"Ohio","Wyandot County",2,10,284,141,143
050,39,175,"Ohio","Wyandot County",2,11,295,163,132
050,39,175,"Ohio","Wyandot County",2,12,304,161,143
050,39,175,"Ohio","Wyandot County",2,13,296,146,150
050,39,175,"Ohio","Wyandot County",2,14,307,157,150
050,39,175,"Ohio","Wyandot County",2,15,297,154,143
050,39,175,"Ohio","Wyandot County",2,16,307,162,145
050,39,175,"Ohio","Wyandot County",2,17,306,156,150
050,39,175,"Ohio","Wyandot County",2,18,260,137,123
050,39,175,"Ohio","Wyandot County",2,19,205,107,98
050,39,175,"Ohio","Wyandot County",2,20,211,112,99
050,39,175,"Ohio","Wyandot County",2,21,227,123,104
050,39,175,"Ohio","Wyandot County",2,22,237,128,109
050,39,175,"Ohio","Wyandot County",2,23,224,120,104
050,39,175,"Ohio","Wyandot County",2,24,247,139,108
050,39,175,"Ohio","Wyandot County",2,25,249,129,120
050,39,175,"Ohio","Wyandot County",2,26,239,121,118
050,39,175,"Ohio","Wyandot County",2,27,233,126,107
050,39,175,"Ohio","Wyandot County",2,28,241,128,113
050,39,175,"Ohio","Wyandot County",2,29,237,122,115
050,39,175,"Ohio","Wyandot County",2,30,246,128,118
050,39,175,"Ohio","Wyandot County",2,31,227,115,112
050,39,175,"Ohio","Wyandot County",2,32,233,112,121
050,39,175,"Ohio","Wyandot County",2,33,245,122,123
050,39,175,"Ohio","Wyandot County",2,34,255,123,132
050,39,175,"Ohio","Wyandot County",2,35,247,123,124
050,39,175,"Ohio","Wyandot County",2,36,240,113,127
050,39,175,"Ohio","Wyandot County",2,37,266,133,133
050,39,175,"Ohio","Wyandot County",2,38,279,148,131
050,39,175,"Ohio","Wyandot County",2,39,280,143,137
050,39,175,"Ohio","Wyandot County",2,40,289,147,142
050,39,175,"Ohio","Wyandot County",2,41,268,137,131
050,39,175,"Ohio","Wyandot County",2,42,257,129,128
050,39,175,"Ohio","Wyandot County",2,43,250,130,120
050,39,175,"Ohio","Wyandot County",2,44,253,132,121
050,39,175,"Ohio","Wyandot County",2,45,263,135,128
050,39,175,"Ohio","Wyandot County",2,46,264,133,131
050,39,175,"Ohio","Wyandot County",2,47,264,132,132
050,39,175,"Ohio","Wyandot County",2,48,284,145,139
050,39,175,"Ohio","Wyandot County",2,49,305,159,146
050,39,175,"Ohio","Wyandot County",2,50,284,145,139
050,39,175,"Ohio","Wyandot County",2,51,256,130,126
050,39,175,"Ohio","Wyandot County",2,52,247,123,124
050,39,175,"Ohio","Wyandot County",2,53,271,134,137
050,39,175,"Ohio","Wyandot County",2,54,291,147,144
050,39,175,"Ohio","Wyandot County",2,55,336,172,164
050,39,175,"Ohio","Wyandot County",2,56,325,171,154
050,39,175,"Ohio","Wyandot County",2,57,309,161,148
050,39,175,"Ohio","Wyandot County",2,58,314,165,149
050,39,175,"Ohio","Wyandot County",2,59,325,163,162
050,39,175,"Ohio","Wyandot County",2,60,324,158,166
050,39,175,"Ohio","Wyandot County",2,61,328,162,166
050,39,175,"Ohio","Wyandot County",2,62,321,159,162
050,39,175,"Ohio","Wyandot County",2,63,305,149,156
050,39,175,"Ohio","Wyandot County",2,64,302,146,156
050,39,175,"Ohio","Wyandot County",2,65,300,149,151
050,39,175,"Ohio","Wyandot County",2,66,299,152,147
050,39,175,"Ohio","Wyandot County",2,67,284,139,145
050,39,175,"Ohio","Wyandot County",2,68,268,123,145
050,39,175,"Ohio","Wyandot County",2,69,242,113,129
050,39,175,"Ohio","Wyandot County",2,70,241,118,123
050,39,175,"Ohio","Wyandot County",2,71,243,114,129
050,39,175,"Ohio","Wyandot County",2,72,239,105,134
050,39,175,"Ohio","Wyandot County",2,73,235,113,122
050,39,175,"Ohio","Wyandot County",2,74,167,83,84
050,39,175,"Ohio","Wyandot County",2,75,163,80,83
050,39,175,"Ohio","Wyandot County",2,76,159,75,84
050,39,175,"Ohio","Wyandot County",2,77,164,77,87
050,39,175,"Ohio","Wyandot County",2,78,150,73,77
050,39,175,"Ohio","Wyandot County",2,79,138,65,73
050,39,175,"Ohio","Wyandot County",2,80,109,51,58
050,39,175,"Ohio","Wyandot County",2,81,121,46,75
050,39,175,"Ohio","Wyandot County",2,82,125,54,71
050,39,175,"Ohio","Wyandot County",2,83,106,47,59
050,39,175,"Ohio","Wyandot County",2,84,98,39,59
050,39,175,"Ohio","Wyandot County",2,85,541,165,376
050,39,175,"Ohio","Wyandot County",3,0,210,115,95
050,39,175,"Ohio","Wyandot County",3,1,201,100,101
050,39,175,"Ohio","Wyandot County",3,2,223,109,114
050,39,175,"Ohio","Wyandot County",3,3,225,109,116
050,39,175,"Ohio","Wyandot County",3,4,252,127,125
050,39,175,"Ohio","Wyandot County",3,5,263,133,130
050,39,175,"Ohio","Wyandot County",3,6,252,132,120
050,39,175,"Ohio","Wyandot County",3,7,273,144,129
050,39,175,"Ohio","Wyandot County",3,8,274,139,135
050,39,175,"Ohio","Wyandot County",3,9,268,130,138
050,39,175,"Ohio","Wyandot County",3,10,265,129,136
050,39,175,"Ohio","Wyandot County",3,11,283,143,140
050,39,175,"Ohio","Wyandot County",3,12,291,162,129
050,39,175,"Ohio","Wyandot County",3,13,309,162,147
050,39,175,"Ohio","Wyandot County",3,14,300,149,151
050,39,175,"Ohio","Wyandot County",3,15,320,167,153
050,39,175,"Ohio","Wyandot County",3,16,297,156,141
050,39,175,"Ohio","Wyandot County",3,17,306,160,146
050,39,175,"Ohio","Wyandot County",3,18,247,129,118
050,39,175,"Ohio","Wyandot County",3,19,202,106,96
050,39,175,"Ohio","Wyandot County",3,20,230,116,114
050,39,175,"Ohio","Wyandot County",3,21,234,122,112
050,39,175,"Ohio","Wyandot County",3,22,219,115,104
050,39,175,"Ohio","Wyandot County",3,23,227,123,104
050,39,175,"Ohio","Wyandot County",3,24,219,125,94
050,39,175,"Ohio","Wyandot County",3,25,234,125,109
050,39,175,"Ohio","Wyandot County",3,26,255,133,122
050,39,175,"Ohio","Wyandot County",3,27,247,124,123
050,39,175,"Ohio","Wyandot County",3,28,238,132,106
050,39,175,"Ohio","Wyandot County",3,29,250,136,114
050,39,175,"Ohio","Wyandot County",3,30,227,114,113
050,39,175,"Ohio","Wyandot County",3,31,236,120,116
050,39,175,"Ohio","Wyandot County",3,32,236,120,116
050,39,175,"Ohio","Wyandot County",3,33,230,107,123
050,39,175,"Ohio","Wyandot County",3,34,235,115,120
050,39,175,"Ohio","Wyandot County",3,35,259,126,133
050,39,175,"Ohio","Wyandot County",3,36,240,118,122
050,39,175,"Ohio","Wyandot County",3,37,239,116,123
050,39,175,"Ohio","Wyandot County",3,38,272,137,135
050,39,175,"Ohio","Wyandot County",3,39,284,148,136
050,39,175,"Ohio","Wyandot County",3,40,286,143,143
050,39,175,"Ohio","Wyandot County",3,41,286,148,138
050,39,175,"Ohio","Wyandot County",3,42,268,135,133
050,39,175,"Ohio","Wyandot County",3,43,255,124,131
050,39,175,"Ohio","Wyandot County",3,44,240,128,112
050,39,175,"Ohio","Wyandot County",3,45,256,137,119
050,39,175,"Ohio","Wyandot County",3,46,259,130,129
050,39,175,"Ohio","Wyandot County",3,47,260,131,129
050,39,175,"Ohio","Wyandot County",3,48,255,124,131
050,39,175,"Ohio","Wyandot County",3,49,289,148,141
050,39,175,"Ohio","Wyandot County",3,50,295,155,140
050,39,175,"Ohio","Wyandot County",3,51,285,143,142
050,39,175,"Ohio","Wyandot County",3,52,259,132,127
050,39,175,"Ohio","Wyandot County",3,53,251,127,124
050,39,175,"Ohio","Wyandot County",3,54,288,148,140
050,39,175,"Ohio","Wyandot County",3,55,294,144,150
050,39,175,"Ohio","Wyandot County",3,56,327,165,162
050,39,175,"Ohio","Wyandot County",3,57,321,166,155
050,39,175,"Ohio","Wyandot County",3,58,306,156,150
050,39,175,"Ohio","Wyandot County",3,59,318,170,148
050,39,175,"Ohio","Wyandot County",3,60,316,153,163
050,39,175,"Ohio","Wyandot County",3,61,319,154,165
050,39,175,"Ohio","Wyandot County",3,62,324,158,166
050,39,175,"Ohio","Wyandot County",3,63,314,156,158
050,39,175,"Ohio","Wyandot County",3,64,301,146,155
050,39,175,"Ohio","Wyandot County",3,65,305,147,158
050,39,175,"Ohio","Wyandot County",3,66,297,145,152
050,39,175,"Ohio","Wyandot County",3,67,286,143,143
050,39,175,"Ohio","Wyandot County",3,68,281,136,145
050,39,175,"Ohio","Wyandot County",3,69,263,119,144
050,39,175,"Ohio","Wyandot County",3,70,237,113,124
050,39,175,"Ohio","Wyandot County",3,71,230,115,115
050,39,175,"Ohio","Wyandot County",3,72,231,106,125
050,39,175,"Ohio","Wyandot County",3,73,233,102,131
050,39,175,"Ohio","Wyandot County",3,74,230,106,124
050,39,175,"Ohio","Wyandot County",3,75,159,80,79
050,39,175,"Ohio","Wyandot County",3,76,168,85,83
050,39,175,"Ohio","Wyandot County",3,77,146,63,83
050,39,175,"Ohio","Wyandot County",3,78,159,72,87
050,39,175,"Ohio","Wyandot County",3,79,144,72,72
050,39,175,"Ohio","Wyandot County",3,80,131,61,70
050,39,175,"Ohio","Wyandot County",3,81,112,46,66
050,39,175,"Ohio","Wyandot County",3,82,102,43,59
050,39,175,"Ohio","Wyandot County",3,83,104,41,63
050,39,175,"Ohio","Wyandot County",3,84,101,45,56
050,39,175,"Ohio","Wyandot County",3,85,526,160,366
050,39,175,"Ohio","Wyandot County",4,0,207,101,106
050,39,175,"Ohio","Wyandot County",4,1,221,114,107
050,39,175,"Ohio","Wyandot County",4,2,211,102,109
050,39,175,"Ohio","Wyandot County",4,3,242,122,120
050,39,175,"Ohio","Wyandot County",4,4,227,114,113
050,39,175,"Ohio","Wyandot County",4,5,259,133,126
050,39,175,"Ohio","Wyandot County",4,6,265,137,128
050,39,175,"Ohio","Wyandot County",4,7,253,132,121
050,39,175,"Ohio","Wyandot County",4,8,275,143,132
050,39,175,"Ohio","Wyandot County",4,9,272,137,135
050,39,175,"Ohio","Wyandot County",4,10,274,129,145
050,39,175,"Ohio","Wyandot County",4,11,260,131,129
050,39,175,"Ohio","Wyandot County",4,12,289,148,141
050,39,175,"Ohio","Wyandot County",4,13,293,161,132
050,39,175,"Ohio","Wyandot County",4,14,305,156,149
050,39,175,"Ohio","Wyandot County",4,15,295,145,150
050,39,175,"Ohio","Wyandot County",4,16,315,163,152
050,39,175,"Ohio","Wyandot County",4,17,296,154,142
050,39,175,"Ohio","Wyandot County",4,18,258,146,112
050,39,175,"Ohio","Wyandot County",4,19,186,97,89
050,39,175,"Ohio","Wyandot County",4,20,219,113,106
050,39,175,"Ohio","Wyandot County",4,21,218,118,100
050,39,175,"Ohio","Wyandot County",4,22,238,127,111
050,39,175,"Ohio","Wyandot County",4,23,218,107,111
050,39,175,"Ohio","Wyandot County",4,24,218,116,102
050,39,175,"Ohio","Wyandot County",4,25,236,130,106
050,39,175,"Ohio","Wyandot County",4,26,239,129,110
050,39,175,"Ohio","Wyandot County",4,27,263,139,124
050,39,175,"Ohio","Wyandot County",4,28,260,131,129
050,39,175,"Ohio","Wyandot County",4,29,247,135,112
050,39,175,"Ohio","Wyandot County",4,30,245,128,117
050,39,175,"Ohio","Wyandot County",4,31,233,118,115
050,39,175,"Ohio","Wyandot County",4,32,226,115,111
050,39,175,"Ohio","Wyandot County",4,33,242,121,121
050,39,175,"Ohio","Wyandot County",4,34,231,108,123
050,39,175,"Ohio","Wyandot County",4,35,236,114,122
050,39,175,"Ohio","Wyandot County",4,36,260,124,136
050,39,175,"Ohio","Wyandot County",4,37,242,119,123
050,39,175,"Ohio","Wyandot County",4,38,230,113,117
050,39,175,"Ohio","Wyandot County",4,39,266,134,132
050,39,175,"Ohio","Wyandot County",4,40,286,145,141
050,39,175,"Ohio","Wyandot County",4,41,285,139,146
050,39,175,"Ohio","Wyandot County",4,42,296,155,141
050,39,175,"Ohio","Wyandot County",4,43,264,134,130
050,39,175,"Ohio","Wyandot County",4,44,247,119,128
050,39,175,"Ohio","Wyandot County",4,45,250,131,119
050,39,175,"Ohio","Wyandot County",4,46,255,133,122
050,39,175,"Ohio","Wyandot County",4,47,268,143,125
050,39,175,"Ohio","Wyandot County",4,48,247,130,117
050,39,175,"Ohio","Wyandot County",4,49,250,120,130
050,39,175,"Ohio","Wyandot County",4,50,286,143,143
050,39,175,"Ohio","Wyandot County",4,51,294,151,143
050,39,175,"Ohio","Wyandot County",4,52,280,141,139
050,39,175,"Ohio","Wyandot County",4,53,255,129,126
050,39,175,"Ohio","Wyandot County",4,54,253,132,121
050,39,175,"Ohio","Wyandot County",4,55,296,154,142
050,39,175,"Ohio","Wyandot County",4,56,283,137,146
050,39,175,"Ohio","Wyandot County",4,57,329,165,164
050,39,175,"Ohio","Wyandot County",4,58,315,160,155
050,39,175,"Ohio","Wyandot County",4,59,304,154,150
050,39,175,"Ohio","Wyandot County",4,60,306,160,146
050,39,175,"Ohio","Wyandot County",4,61,309,149,160
050,39,175,"Ohio","Wyandot County",4,62,308,146,162
050,39,175,"Ohio","Wyandot County",4,63,312,149,163
050,39,175,"Ohio","Wyandot County",4,64,307,151,156
050,39,175,"Ohio","Wyandot County",4,65,298,143,155
050,39,175,"Ohio","Wyandot County",4,66,304,149,155
050,39,175,"Ohio","Wyandot County",4,67,279,133,146
050,39,175,"Ohio","Wyandot County",4,68,288,142,146
050,39,175,"Ohio","Wyandot County",4,69,277,133,144
050,39,175,"Ohio","Wyandot County",4,70,257,118,139
050,39,175,"Ohio","Wyandot County",4,71,230,114,116
050,39,175,"Ohio","Wyandot County",4,72,214,107,107
050,39,175,"Ohio","Wyandot County",4,73,218,98,120
050,39,175,"Ohio","Wyandot County",4,74,234,100,134
050,39,175,"Ohio","Wyandot County",4,75,215,97,118
050,39,175,"Ohio","Wyandot County",4,76,162,83,79
050,39,175,"Ohio","Wyandot County",4,77,149,73,76
050,39,175,"Ohio","Wyandot County",4,78,143,60,83
050,39,175,"Ohio","Wyandot County",4,79,151,69,82
050,39,175,"Ohio","Wyandot County",4,80,131,64,67
050,39,175,"Ohio","Wyandot County",4,81,135,56,79
050,39,175,"Ohio","Wyandot County",4,82,103,46,57
050,39,175,"Ohio","Wyandot County",4,83,76,29,47
050,39,175,"Ohio","Wyandot County",4,84,98,37,61
050,39,175,"Ohio","Wyandot County",4,85,535,170,365
050,39,175,"Ohio","Wyandot County",5,0,207,104,103
050,39,175,"Ohio","Wyandot County",5,1,221,108,113
050,39,175,"Ohio","Wyandot County",5,2,221,109,112
050,39,175,"Ohio","Wyandot County",5,3,225,105,120
050,39,175,"Ohio","Wyandot County",5,4,244,119,125
050,39,175,"Ohio","Wyandot County",5,5,227,118,109
050,39,175,"Ohio","Wyandot County",5,6,257,132,125
050,39,175,"Ohio","Wyandot County",5,7,260,135,125
050,39,175,"Ohio","Wyandot County",5,8,253,127,126
050,39,175,"Ohio","Wyandot County",5,9,266,135,131
050,39,175,"Ohio","Wyandot County",5,10,277,138,139
050,39,175,"Ohio","Wyandot County",5,11,271,131,140
050,39,175,"Ohio","Wyandot County",5,12,255,129,126
050,39,175,"Ohio","Wyandot County",5,13,299,150,149
050,39,175,"Ohio","Wyandot County",5,14,292,158,134
050,39,175,"Ohio","Wyandot County",5,15,309,154,155
050,39,175,"Ohio","Wyandot County",5,16,292,139,153
050,39,175,"Ohio","Wyandot County",5,17,313,164,149
050,39,175,"Ohio","Wyandot County",5,18,246,138,108
050,39,175,"Ohio","Wyandot County",5,19,199,112,87
050,39,175,"Ohio","Wyandot County",5,20,215,113,102
050,39,175,"Ohio","Wyandot County",5,21,240,124,116
050,39,175,"Ohio","Wyandot County",5,22,249,136,113
050,39,175,"Ohio","Wyandot County",5,23,241,120,121
050,39,175,"Ohio","Wyandot County",5,24,212,107,105
050,39,175,"Ohio","Wyandot County",5,25,223,123,100
050,39,175,"Ohio","Wyandot County",5,26,225,123,102
050,39,175,"Ohio","Wyandot County",5,27,239,126,113
050,39,175,"Ohio","Wyandot County",5,28,240,126,114
050,39,175,"Ohio","Wyandot County",5,29,267,131,136
050,39,175,"Ohio","Wyandot County",5,30,248,130,118
050,39,175,"Ohio","Wyandot County",5,31,241,123,118
050,39,175,"Ohio","Wyandot County",5,32,232,121,111
050,39,175,"Ohio","Wyandot County",5,33,237,121,116
050,39,175,"Ohio","Wyandot County",5,34,242,120,122
050,39,175,"Ohio","Wyandot County",5,35,230,108,122
050,39,175,"Ohio","Wyandot County",5,36,246,117,129
050,39,175,"Ohio","Wyandot County",5,37,257,125,132
050,39,175,"Ohio","Wyandot County",5,38,248,125,123
050,39,175,"Ohio","Wyandot County",5,39,235,115,120
050,39,175,"Ohio","Wyandot County",5,40,268,139,129
050,39,175,"Ohio","Wyandot County",5,41,282,143,139
050,39,175,"Ohio","Wyandot County",5,42,280,139,141
050,39,175,"Ohio","Wyandot County",5,43,295,151,144
050,39,175,"Ohio","Wyandot County",5,44,262,133,129
050,39,175,"Ohio","Wyandot County",5,45,242,119,123
050,39,175,"Ohio","Wyandot County",5,46,244,128,116
050,39,175,"Ohio","Wyandot County",5,47,261,134,127
050,39,175,"Ohio","Wyandot County",5,48,266,139,127
050,39,175,"Ohio","Wyandot County",5,49,249,130,119
050,39,175,"Ohio","Wyandot County",5,50,251,127,124
050,39,175,"Ohio","Wyandot County",5,51,275,139,136
050,39,175,"Ohio","Wyandot County",5,52,297,153,144
050,39,175,"Ohio","Wyandot County",5,53,268,136,132
050,39,175,"Ohio","Wyandot County",5,54,255,130,125
050,39,175,"Ohio","Wyandot County",5,55,249,128,121
050,39,175,"Ohio","Wyandot County",5,56,296,154,142
050,39,175,"Ohio","Wyandot County",5,57,286,141,145
050,39,175,"Ohio","Wyandot County",5,58,324,159,165
050,39,175,"Ohio","Wyandot County",5,59,315,161,154
050,39,175,"Ohio","Wyandot County",5,60,295,149,146
050,39,175,"Ohio","Wyandot County",5,61,303,155,148
050,39,175,"Ohio","Wyandot County",5,62,294,139,155
050,39,175,"Ohio","Wyandot County",5,63,296,139,157
050,39,175,"Ohio","Wyandot County",5,64,311,150,161
050,39,175,"Ohio","Wyandot County",5,65,301,149,152
050,39,175,"Ohio","Wyandot County",5,66,294,138,156
050,39,175,"Ohio","Wyandot County",5,67,291,144,147
050,39,175,"Ohio","Wyandot County",5,68,282,131,151
050,39,175,"Ohio","Wyandot County",5,69,288,139,149
050,39,175,"Ohio","Wyandot County",5,70,270,132,138
050,39,175,"Ohio","Wyandot County",5,71,253,119,134
050,39,175,"Ohio","Wyandot County",5,72,221,106,115
050,39,175,"Ohio","Wyandot County",5,73,207,100,107
050,39,175,"Ohio","Wyandot County",5,74,215,95,120
050,39,175,"Ohio","Wyandot County",5,75,225,96,129
050,39,175,"Ohio","Wyandot County",5,76,216,100,116
050,39,175,"Ohio","Wyandot County",5,77,146,73,73
050,39,175,"Ohio","Wyandot County",5,78,148,71,77
050,39,175,"Ohio","Wyandot County",5,79,138,56,82
050,39,175,"Ohio","Wyandot County",5,80,139,63,76
050,39,175,"Ohio","Wyandot County",5,81,133,59,74
050,39,175,"Ohio","Wyandot County",5,82,126,58,68
050,39,175,"Ohio","Wyandot County",5,83,77,30,47
050,39,175,"Ohio","Wyandot County",5,84,69,26,43
050,39,175,"Ohio","Wyandot County",5,85,553,178,375

