"SUMLEV","STATE","COUNTY","STNAME","CTYNAME","YEAR","AGE","TOT_POP","TOT_MALE","TOT_FEMALE"
050,26,001,"Michigan","Alcona County",1,0,77,39,38
050,26,001,"Michigan","Alcona County",1,1,61,28,33
050,26,001,"Michigan","Alcona County",1,2,59,33,26
050,26,001,"Michigan","Alcona County",1,3,71,34,37
050,26,001,"Michigan","Alcona County",1,4,68,34,34
050,26,001,"Michigan","Alcona County",1,5,52,27,25
050,26,001,"Michigan","Alcona County",1,6,69,34,35
050,26,001,"Michigan","Alcona County",1,7,73,36,37
050,26,001,"Michigan","Alcona County",1,8,76,37,39
050,26,001,"Michigan","Alcona County",1,9,65,32,33
050,26,001,"Michigan","Alcona County",1,10,65,33,32
050,26,001,"Michigan","Alcona County",1,11,82,37,45
050,26,001,"Michigan","Alcona County",1,12,67,28,39
050,26,001,"Michigan","Alcona County",1,13,78,38,40
050,26,001,"Michigan","Alcona County",1,14,94,53,41
050,26,001,"Michigan","Alcona County",1,15,79,41,38
050,26,001,"Michigan","Alcona County",1,16,78,36,42
050,26,001,"Michigan","Alcona County",1,17,101,51,50
050,26,001,"Michigan","Alcona County",1,18,62,37,25
050,26,001,"Michigan","Alcona County",1,19,57,31,26
050,26,001,"Michigan","Alcona County",1,20,58,32,26
050,26,001,"Michigan","Alcona County",1,21,61,35,26
050,26,001,"Michigan","Alcona County",1,22,86,44,42
050,26,001,"Michigan","Alcona County",1,23,75,38,37
050,26,001,"Michigan","Alcona County",1,24,78,42,36
050,26,001,"Michigan","Alcona County",1,25,80,40,40
050,26,001,"Michigan","Alcona County",1,26,74,42,32
050,26,001,"Michigan","Alcona County",1,27,78,41,37
050,26,001,"Michigan","Alcona County",1,28,92,48,44
050,26,001,"Michigan","Alcona County",1,29,83,43,40
050,26,001,"Michigan","Alcona County",1,30,65,36,29
050,26,001,"Michigan","Alcona County",1,31,70,41,29
050,26,001,"Michigan","Alcona County",1,32,70,35,35
050,26,001,"Michigan","Alcona County",1,33,69,35,34
050,26,001,"Michigan","Alcona County",1,34,62,31,31
050,26,001,"Michigan","Alcona County",1,35,71,36,35
050,26,001,"Michigan","Alcona County",1,36,60,29,31
050,26,001,"Michigan","Alcona County",1,37,80,37,43
050,26,001,"Michigan","Alcona County",1,38,96,46,50
050,26,001,"Michigan","Alcona County",1,39,82,48,34
050,26,001,"Michigan","Alcona County",1,40,74,34,40
050,26,001,"Michigan","Alcona County",1,41,84,33,51
050,26,001,"Michigan","Alcona County",1,42,83,44,39
050,26,001,"Michigan","Alcona County",1,43,75,41,34
050,26,001,"Michigan","Alcona County",1,44,79,40,39
050,26,001,"Michigan","Alcona County",1,45,80,32,48
050,26,001,"Michigan","Alcona County",1,46,73,32,41
050,26,001,"Michigan","Alcona County",1,47,89,40,49
050,26,001,"Michigan","Alcona County",1,48,103,53,50
050,26,001,"Michigan","Alcona County",1,49,124,64,60
050,26,001,"Michigan","Alcona County",1,50,113,56,57
050,26,001,"Michigan","Alcona County",1,51,126,68,58
050,26,001,"Michigan","Alcona County",1,52,129,70,59
050,26,001,"Michigan","Alcona County",1,53,145,74,71
050,26,001,"Michigan","Alcona County",1,54,148,75,73
050,26,001,"Michigan","Alcona County",1,55,161,78,83
050,26,001,"Michigan","Alcona County",1,56,162,75,87
050,26,001,"Michigan","Alcona County",1,57,182,81,101
050,26,001,"Michigan","Alcona County",1,58,207,105,102
050,26,001,"Michigan","Alcona County",1,59,181,98,83
050,26,001,"Michigan","Alcona County",1,60,209,102,107
050,26,001,"Michigan","Alcona County",1,61,223,102,121
050,26,001,"Michigan","Alcona County",1,62,266,129,137
050,26,001,"Michigan","Alcona County",1,63,257,136,121
050,26,001,"Michigan","Alcona County",1,64,225,117,108
050,26,001,"Michigan","Alcona County",1,65,247,139,108
050,26,001,"Michigan","Alcona County",1,66,230,117,113
050,26,001,"Michigan","Alcona County",1,67,210,101,109
050,26,001,"Michigan","Alcona County",1,68,204,104,100
050,26,001,"Michigan","Alcona County",1,69,207,104,103
050,26,001,"Michigan","Alcona County",1,70,206,111,95
050,26,001,"Michigan","Alcona County",1,71,197,108,89
050,26,001,"Michigan","Alcona County",1,72,200,110,90
050,26,001,"Michigan","Alcona County",1,73,194,101,93
050,26,001,"Michigan","Alcona County",1,74,155,77,78
050,26,001,"Michigan","Alcona County",1,75,154,72,82
050,26,001,"Michigan","Alcona County",1,76,159,79,80
050,26,001,"Michigan","Alcona County",1,77,170,87,83
050,26,001,"Michigan","Alcona County",1,78,155,81,74
050,26,001,"Michigan","Alcona County",1,79,136,69,67
050,26,001,"Michigan","Alcona County",1,80,135,75,60
050,26,001,"Michigan","Alcona County",1,81,130,68,62
050,26,001,"Michigan","Alcona County",1,82,93,52,41
050,26,001,"Michigan","Alcona County",1,83,69,35,34
050,26,001,"Michigan","Alcona County",1,84,77,38,39
050,26,001,"Michigan","Alcona County",1,85,319,132,187
050,26,001,"Michigan","Alcona County",2,0,83,43,40
050,26,001,"Michigan","Alcona County",2,1,65,31,34
050,26,001,"Michigan","Alcona County",2,2,61,32,29
050,26,001,"Michigan","Alcona County",2,3,68,34,34
050,26,001,"Michigan","Alcona County",2,4,69,34,35
050,26,001,"Michigan","Alcona County",2,5,57,29,28
050,26,001,"Michigan","Alcona County",2,6,66,33,33
050,26,001,"Michigan","Alcona County",2,7,72,35,37
050,26,001,"Michigan","Alcona County",2,8,74,36,38
050,26,001,"Michigan","Alcona County",2,9,68,34,34
050,26,001,"Michigan","Alcona County",2,10,66,33,33
050,26,001,"Michigan","Alcona County",2,11,77,36,41
050,26,001,"Michigan","Alcona County",2,12,70,29,41
050,26,001,"Michigan","Alcona County",2,13,77,37,40
050,26,001,"Michigan","Alcona County",2,14,90,50,40
050,26,001,"Michigan","Alcona County",2,15,82,43,39
050,26,001,"Michigan","Alcona County",2,16,79,38,41
050,26,001,"Michigan","Alcona County",2,17,95,48,47
050,26,001,"Michigan","Alcona County",2,18,67,38,29
050,26,001,"Michigan","Alcona County",2,19,56,31,25
050,26,001,"Michigan","Alcona County",2,20,60,33,27
050,26,001,"Michigan","Alcona County",2,21,62,34,28
050,26,001,"Michigan","Alcona County",2,22,83,42,41
050,26,001,"Michigan","Alcona County",2,23,79,41,38
050,26,001,"Michigan","Alcona County",2,24,78,42,36
050,26,001,"Michigan","Alcona County",2,25,80,41,39
050,26,001,"Michigan","Alcona County",2,26,75,41,34
050,26,001,"Michigan","Alcona County",2,27,80,43,37
050,26,001,"Michigan","Alcona County",2,28,92,49,43
050,26,001,"Michigan","Alcona County",2,29,84,43,41
050,26,001,"Michigan","Alcona County",2,30,71,38,33
050,26,001,"Michigan","Alcona County",2,31,68,40,28
050,26,001,"Michigan","Alcona County",2,32,70,36,34
050,26,001,"Michigan","Alcona County",2,33,69,35,34
050,26,001,"Michigan","Alcona County",2,34,65,33,32
050,26,001,"Michigan","Alcona County",2,35,68,34,34
050,26,001,"Michigan","Alcona County",2,36,62,30,32
050,26,001,"Michigan","Alcona County",2,37,76,35,41
050,26,001,"Michigan","Alcona County",2,38,90,43,47
050,26,001,"Michigan","Alcona County",2,39,87,48,39
050,26,001,"Michigan","Alcona County",2,40,77,38,39
050,26,001,"Michigan","Alcona County",2,41,82,34,48
050,26,001,"Michigan","Alcona County",2,42,82,41,41
050,26,001,"Michigan","Alcona County",2,43,80,43,37
050,26,001,"Michigan","Alcona County",2,44,77,40,37
050,26,001,"Michigan","Alcona County",2,45,81,34,47
050,26,001,"Michigan","Alcona County",2,46,73,32,41
050,26,001,"Michigan","Alcona County",2,47,86,39,47
050,26,001,"Michigan","Alcona County",2,48,100,50,50
050,26,001,"Michigan","Alcona County",2,49,122,62,60
050,26,001,"Michigan","Alcona County",2,50,118,59,59
050,26,001,"Michigan","Alcona County",2,51,124,66,58
050,26,001,"Michigan","Alcona County",2,52,128,70,58
050,26,001,"Michigan","Alcona County",2,53,140,72,68
050,26,001,"Michigan","Alcona County",2,54,149,75,74
050,26,001,"Michigan","Alcona County",2,55,161,78,83
050,26,001,"Michigan","Alcona County",2,56,162,76,86
050,26,001,"Michigan","Alcona County",2,57,178,81,97
050,26,001,"Michigan","Alcona County",2,58,203,101,102
050,26,001,"Michigan","Alcona County",2,59,191,102,89
050,26,001,"Michigan","Alcona County",2,60,205,102,103
050,26,001,"Michigan","Alcona County",2,61,220,103,117
050,26,001,"Michigan","Alcona County",2,62,259,124,135
050,26,001,"Michigan","Alcona County",2,63,263,137,126
050,26,001,"Michigan","Alcona County",2,64,234,124,110
050,26,001,"Michigan","Alcona County",2,65,241,135,106
050,26,001,"Michigan","Alcona County",2,66,237,123,114
050,26,001,"Michigan","Alcona County",2,67,215,106,109
050,26,001,"Michigan","Alcona County",2,68,204,104,100
050,26,001,"Michigan","Alcona County",2,69,207,104,103
050,26,001,"Michigan","Alcona County",2,70,205,109,96
050,26,001,"Michigan","Alcona County",2,71,199,108,91
050,26,001,"Michigan","Alcona County",2,72,195,108,87
050,26,001,"Michigan","Alcona County",2,73,204,107,97
050,26,001,"Michigan","Alcona County",2,74,153,77,76
050,26,001,"Michigan","Alcona County",2,75,152,72,80
050,26,001,"Michigan","Alcona County",2,76,154,75,79
050,26,001,"Michigan","Alcona County",2,77,169,87,82
050,26,001,"Michigan","Alcona County",2,78,155,81,74
050,26,001,"Michigan","Alcona County",2,79,137,71,66
050,26,001,"Michigan","Alcona County",2,80,134,73,61
050,26,001,"Michigan","Alcona County",2,81,129,68,61
050,26,001,"Michigan","Alcona County",2,82,100,54,46
050,26,001,"Michigan","Alcona County",2,83,71,36,35
050,26,001,"Michigan","Alcona County",2,84,73,36,37
050,26,001,"Michigan","Alcona County",2,85,322,132,190
050,26,001,"Michigan","Alcona County",3,0,65,27,38
050,26,001,"Michigan","Alcona County",3,1,87,42,45
050,26,001,"Michigan","Alcona County",3,2,70,32,38
050,26,001,"Michigan","Alcona County",3,3,64,33,31
050,26,001,"Michigan","Alcona County",3,4,67,37,30
050,26,001,"Michigan","Alcona County",3,5,75,36,39
050,26,001,"Michigan","Alcona County",3,6,59,27,32
050,26,001,"Michigan","Alcona County",3,7,66,33,33
050,26,001,"Michigan","Alcona County",3,8,70,35,35
050,26,001,"Michigan","Alcona County",3,9,85,43,42
050,26,001,"Michigan","Alcona County",3,10,71,37,34
050,26,001,"Michigan","Alcona County",3,11,66,34,32
050,26,001,"Michigan","Alcona County",3,12,73,36,37
050,26,001,"Michigan","Alcona County",3,13,66,25,41
050,26,001,"Michigan","Alcona County",3,14,79,40,39
050,26,001,"Michigan","Alcona County",3,15,92,53,39
050,26,001,"Michigan","Alcona County",3,16,83,42,41
050,26,001,"Michigan","Alcona County",3,17,88,38,50
050,26,001,"Michigan","Alcona County",3,18,80,41,39
050,26,001,"Michigan","Alcona County",3,19,53,29,24
050,26,001,"Michigan","Alcona County",3,20,56,29,27
050,26,001,"Michigan","Alcona County",3,21,57,31,26
050,26,001,"Michigan","Alcona County",3,22,73,43,30
050,26,001,"Michigan","Alcona County",3,23,82,45,37
050,26,001,"Michigan","Alcona County",3,24,74,43,31
050,26,001,"Michigan","Alcona County",3,25,81,41,40
050,26,001,"Michigan","Alcona County",3,26,88,46,42
050,26,001,"Michigan","Alcona County",3,27,87,44,43
050,26,001,"Michigan","Alcona County",3,28,83,44,39
050,26,001,"Michigan","Alcona County",3,29,88,45,43
050,26,001,"Michigan","Alcona County",3,30,89,50,39
050,26,001,"Michigan","Alcona County",3,31,70,37,33
050,26,001,"Michigan","Alcona County",3,32,73,45,28
050,26,001,"Michigan","Alcona County",3,33,74,38,36
050,26,001,"Michigan","Alcona County",3,34,73,37,36
050,26,001,"Michigan","Alcona County",3,35,63,33,30
050,26,001,"Michigan","Alcona County",3,36,72,39,33
050,26,001,"Michigan","Alcona County",3,37,67,31,36
050,26,001,"Michigan","Alcona County",3,38,79,36,43
050,26,001,"Michigan","Alcona County",3,39,94,46,48
050,26,001,"Michigan","Alcona County",3,40,85,47,38
050,26,001,"Michigan","Alcona County",3,41,85,43,42
050,26,001,"Michigan","Alcona County",3,42,78,33,45
050,26,001,"Michigan","Alcona County",3,43,79,38,41
050,26,001,"Michigan","Alcona County",3,44,88,46,42
050,26,001,"Michigan","Alcona County",3,45,83,45,38
050,26,001,"Michigan","Alcona County",3,46,83,33,50
050,26,001,"Michigan","Alcona County",3,47,76,33,43
050,26,001,"Michigan","Alcona County",3,48,93,42,51
050,26,001,"Michigan","Alcona County",3,49,96,47,49
050,26,001,"Michigan","Alcona County",3,50,128,65,63
050,26,001,"Michigan","Alcona County",3,51,123,60,63
050,26,001,"Michigan","Alcona County",3,52,132,71,61
050,26,001,"Michigan","Alcona County",3,53,138,73,65
050,26,001,"Michigan","Alcona County",3,54,146,71,75
050,26,001,"Michigan","Alcona County",3,55,157,81,76
050,26,001,"Michigan","Alcona County",3,56,170,80,90
050,26,001,"Michigan","Alcona County",3,57,162,80,82
050,26,001,"Michigan","Alcona County",3,58,179,81,98
050,26,001,"Michigan","Alcona County",3,59,209,99,110
050,26,001,"Michigan","Alcona County",3,60,213,110,103
050,26,001,"Michigan","Alcona County",3,61,225,112,113
050,26,001,"Michigan","Alcona County",3,62,245,122,123
050,26,001,"Michigan","Alcona County",3,63,274,132,142
050,26,001,"Michigan","Alcona County",3,64,280,146,134
050,26,001,"Michigan","Alcona County",3,65,238,126,112
050,26,001,"Michigan","Alcona County",3,66,241,135,106
050,26,001,"Michigan","Alcona County",3,67,234,124,110
050,26,001,"Michigan","Alcona County",3,68,211,104,107
050,26,001,"Michigan","Alcona County",3,69,202,102,100
050,26,001,"Michigan","Alcona County",3,70,205,106,99
050,26,001,"Michigan","Alcona County",3,71,195,102,93
050,26,001,"Michigan","Alcona County",3,72,194,103,91
050,26,001,"Michigan","Alcona County",3,73,193,103,90
050,26,001,"Michigan","Alcona County",3,74,199,106,93
050,26,001,"Michigan","Alcona County",3,75,145,73,72
050,26,001,"Michigan","Alcona County",3,76,148,71,77
050,26,001,"Michigan","Alcona County",3,77,145,72,73
050,26,001,"Michigan","Alcona County",3,78,155,80,75
050,26,001,"Michigan","Alcona County",3,79,134,72,62
050,26,001,"Michigan","Alcona County",3,80,126,64,62
050,26,001,"Michigan","Alcona County",3,81,125,68,57
050,26,001,"Michigan","Alcona County",3,82,118,65,53
050,26,001,"Michigan","Alcona County",3,83,90,49,41
050,26,001,"Michigan","Alcona County",3,84,62,30,32
050,26,001,"Michigan","Alcona County",3,85,326,143,183
050,26,001,"Michigan","Alcona County",4,0,68,25,43
050,26,001,"Michigan","Alcona County",4,1,80,29,51
050,26,001,"Michigan","Alcona County",4,2,87,42,45
050,26,001,"Michigan","Alcona County",4,3,72,31,41
050,26,001,"Michigan","Alcona County",4,4,61,31,30
050,26,001,"Michigan","Alcona County",4,5,67,36,31
050,26,001,"Michigan","Alcona County",4,6,76,33,43
050,26,001,"Michigan","Alcona County",4,7,68,33,35
050,26,001,"Michigan","Alcona County",4,8,65,33,32
050,26,001,"Michigan","Alcona County",4,9,72,35,37
050,26,001,"Michigan","Alcona County",4,10,81,42,39
050,26,001,"Michigan","Alcona County",4,11,76,41,35
050,26,001,"Michigan","Alcona County",4,12,67,34,33
050,26,001,"Michigan","Alcona County",4,13,79,39,40
050,26,001,"Michigan","Alcona County",4,14,62,25,37
050,26,001,"Michigan","Alcona County",4,15,78,39,39
050,26,001,"Michigan","Alcona County",4,16,93,51,42
050,26,001,"Michigan","Alcona County",4,17,86,41,45
050,26,001,"Michigan","Alcona County",4,18,68,34,34
050,26,001,"Michigan","Alcona County",4,19,61,29,32
050,26,001,"Michigan","Alcona County",4,20,52,28,24
050,26,001,"Michigan","Alcona County",4,21,62,33,29
050,26,001,"Michigan","Alcona County",4,22,59,32,27
050,26,001,"Michigan","Alcona County",4,23,79,38,41
050,26,001,"Michigan","Alcona County",4,24,77,41,36
050,26,001,"Michigan","Alcona County",4,25,78,47,31
050,26,001,"Michigan","Alcona County",4,26,80,42,38
050,26,001,"Michigan","Alcona County",4,27,87,46,41
050,26,001,"Michigan","Alcona County",4,28,91,46,45
050,26,001,"Michigan","Alcona County",4,29,85,47,38
050,26,001,"Michigan","Alcona County",4,30,93,45,48
050,26,001,"Michigan","Alcona County",4,31,101,54,47
050,26,001,"Michigan","Alcona County",4,32,70,38,32
050,26,001,"Michigan","Alcona County",4,33,71,40,31
050,26,001,"Michigan","Alcona County",4,34,83,41,42
050,26,001,"Michigan","Alcona County",4,35,78,39,39
050,26,001,"Michigan","Alcona County",4,36,70,35,35
050,26,001,"Michigan","Alcona County",4,37,75,38,37
050,26,001,"Michigan","Alcona County",4,38,70,32,38
050,26,001,"Michigan","Alcona County",4,39,83,44,39
050,26,001,"Michigan","Alcona County",4,40,93,44,49
050,26,001,"Michigan","Alcona County",4,41,94,56,38
050,26,001,"Michigan","Alcona County",4,42,87,45,42
050,26,001,"Michigan","Alcona County",4,43,76,31,45
050,26,001,"Michigan","Alcona County",4,44,95,46,49
050,26,001,"Michigan","Alcona County",4,45,85,47,38
050,26,001,"Michigan","Alcona County",4,46,85,48,37
050,26,001,"Michigan","Alcona County",4,47,82,32,50
050,26,001,"Michigan","Alcona County",4,48,78,34,44
050,26,001,"Michigan","Alcona County",4,49,100,44,56
050,26,001,"Michigan","Alcona County",4,50,101,44,57
050,26,001,"Michigan","Alcona County",4,51,131,67,64
050,26,001,"Michigan","Alcona County",4,52,131,62,69
050,26,001,"Michigan","Alcona County",4,53,145,76,69
050,26,001,"Michigan","Alcona County",4,54,142,72,70
050,26,001,"Michigan","Alcona County",4,55,158,77,81
050,26,001,"Michigan","Alcona County",4,56,171,85,86
050,26,001,"Michigan","Alcona County",4,57,176,79,97
050,26,001,"Michigan","Alcona County",4,58,170,81,89
050,26,001,"Michigan","Alcona County",4,59,182,83,99
050,26,001,"Michigan","Alcona County",4,60,223,111,112
050,26,001,"Michigan","Alcona County",4,61,229,121,108
050,26,001,"Michigan","Alcona County",4,62,241,119,122
050,26,001,"Michigan","Alcona County",4,63,261,134,127
050,26,001,"Michigan","Alcona County",4,64,279,133,146
050,26,001,"Michigan","Alcona County",4,65,275,144,131
050,26,001,"Michigan","Alcona County",4,66,247,132,115
050,26,001,"Michigan","Alcona County",4,67,233,133,100
050,26,001,"Michigan","Alcona County",4,68,236,123,113
050,26,001,"Michigan","Alcona County",4,69,223,115,108
050,26,001,"Michigan","Alcona County",4,70,199,101,98
050,26,001,"Michigan","Alcona County",4,71,199,105,94
050,26,001,"Michigan","Alcona County",4,72,189,99,90
050,26,001,"Michigan","Alcona County",4,73,188,98,90
050,26,001,"Michigan","Alcona County",4,74,191,103,88
050,26,001,"Michigan","Alcona County",4,75,191,104,87
050,26,001,"Michigan","Alcona County",4,76,139,68,71
050,26,001,"Michigan","Alcona County",4,77,134,63,71
050,26,001,"Michigan","Alcona County",4,78,136,69,67
050,26,001,"Michigan","Alcona County",4,79,134,68,66
050,26,001,"Michigan","Alcona County",4,80,124,64,60
050,26,001,"Michigan","Alcona County",4,81,122,64,58
050,26,001,"Michigan","Alcona County",4,82,111,62,49
050,26,001,"Michigan","Alcona County",4,83,109,58,51
050,26,001,"Michigan","Alcona County",4,84,80,42,38
050,26,001,"Michigan","Alcona County",4,85,311,141,170
050,26,001,"Michigan","Alcona County",5,0,62,24,38
050,26,001,"Michigan","Alcona County",5,1,67,31,36
050,26,001,"Michigan","Alcona County",5,2,84,36,48
050,26,001,"Michigan","Alcona County",5,3,87,39,48
050,26,001,"Michigan","Alcona County",5,4,76,35,41
050,26,001,"Michigan","Alcona County",5,5,66,35,31
050,26,001,"Michigan","Alcona County",5,6,73,36,37
050,26,001,"Michigan","Alcona County",5,7,75,35,40
050,26,001,"Michigan","Alcona County",5,8,65,35,30
050,26,001,"Michigan","Alcona County",5,9,71,34,37
050,26,001,"Michigan","Alcona County",5,10,76,37,39
050,26,001,"Michigan","Alcona County",5,11,78,39,39
050,26,001,"Michigan","Alcona County",5,12,77,39,38
050,26,001,"Michigan","Alcona County",5,13,71,35,36
050,26,001,"Michigan","Alcona County",5,14,77,37,40
050,26,001,"Michigan","Alcona County",5,15,67,26,41
050,26,001,"Michigan","Alcona County",5,16,82,43,39
050,26,001,"Michigan","Alcona County",5,17,89,50,39
050,26,001,"Michigan","Alcona County",5,18,68,35,33
050,26,001,"Michigan","Alcona County",5,19,54,28,26
050,26,001,"Michigan","Alcona County",5,20,67,34,33
050,26,001,"Michigan","Alcona County",5,21,51,27,24
050,26,001,"Michigan","Alcona County",5,22,72,35,37
050,26,001,"Michigan","Alcona County",5,23,66,33,33
050,26,001,"Michigan","Alcona County",5,24,81,38,43
050,26,001,"Michigan","Alcona County",5,25,82,44,38
050,26,001,"Michigan","Alcona County",5,26,72,42,30
050,26,001,"Michigan","Alcona County",5,27,76,42,34
050,26,001,"Michigan","Alcona County",5,28,86,45,41
050,26,001,"Michigan","Alcona County",5,29,80,42,38
050,26,001,"Michigan","Alcona County",5,30,93,46,47
050,26,001,"Michigan","Alcona County",5,31,94,46,48
050,26,001,"Michigan","Alcona County",5,32,101,53,48
050,26,001,"Michigan","Alcona County",5,33,78,40,38
050,26,001,"Michigan","Alcona County",5,34,75,43,32
050,26,001,"Michigan","Alcona County",5,35,84,40,44
050,26,001,"Michigan","Alcona County",5,36,90,44,46
050,26,001,"Michigan","Alcona County",5,37,74,40,34
050,26,001,"Michigan","Alcona County",5,38,74,35,39
050,26,001,"Michigan","Alcona County",5,39,77,40,37
050,26,001,"Michigan","Alcona County",5,40,91,52,39
050,26,001,"Michigan","Alcona County",5,41,87,38,49
050,26,001,"Michigan","Alcona County",5,42,95,52,43
050,26,001,"Michigan","Alcona County",5,43,90,46,44
050,26,001,"Michigan","Alcona County",5,44,82,35,47
050,26,001,"Michigan","Alcona County",5,45,96,50,46
050,26,001,"Michigan","Alcona County",5,46,90,53,37
050,26,001,"Michigan","Alcona County",5,47,90,50,40
050,26,001,"Michigan","Alcona County",5,48,85,30,55
050,26,001,"Michigan","Alcona County",5,49,79,34,45
050,26,001,"Michigan","Alcona County",5,50,103,45,58
050,26,001,"Michigan","Alcona County",5,51,110,47,63
050,26,001,"Michigan","Alcona County",5,52,135,67,68
050,26,001,"Michigan","Alcona County",5,53,130,61,69
050,26,001,"Michigan","Alcona County",5,54,149,79,70
050,26,001,"Michigan","Alcona County",5,55,151,79,72
050,26,001,"Michigan","Alcona County",5,56,163,79,84
050,26,001,"Michigan","Alcona County",5,57,176,86,90
050,26,001,"Michigan","Alcona County",5,58,176,80,96
050,26,001,"Michigan","Alcona County",5,59,180,84,96
050,26,001,"Michigan","Alcona County",5,60,192,89,103
050,26,001,"Michigan","Alcona County",5,61,234,117,117
050,26,001,"Michigan","Alcona County",5,62,246,129,117
050,26,001,"Michigan","Alcona County",5,63,264,130,134
050,26,001,"Michigan","Alcona County",5,64,276,141,135
050,26,001,"Michigan","Alcona County",5,65,298,148,150
050,26,001,"Michigan","Alcona County",5,66,274,144,130
050,26,001,"Michigan","Alcona County",5,67,258,140,118
050,26,001,"Michigan","Alcona County",5,68,226,127,99
050,26,001,"Michigan","Alcona County",5,69,247,126,121
050,26,001,"Michigan","Alcona County",5,70,218,113,105
050,26,001,"Michigan","Alcona County",5,71,190,92,98
050,26,001,"Michigan","Alcona County",5,72,190,100,90
050,26,001,"Michigan","Alcona County",5,73,184,93,91
050,26,001,"Michigan","Alcona County",5,74,188,98,90
050,26,001,"Michigan","Alcona County",5,75,185,98,87
050,26,001,"Michigan","Alcona County",5,76,186,99,87
050,26,001,"Michigan","Alcona County",5,77,127,63,64
050,26,001,"Michigan","Alcona County",5,78,127,59,68
050,26,001,"Michigan","Alcona County",5,79,115,59,56
050,26,001,"Michigan","Alcona County",5,80,123,60,63
050,26,001,"Michigan","Alcona County",5,81,117,59,58
050,26,001,"Michigan","Alcona County",5,82,108,58,50
050,26,001,"Michigan","Alcona County",5,83,98,54,44
050,26,001,"Michigan","Alcona County",5,84,99,53,46
050,26,001,"Michigan","Alcona County",5,85,323,147,176
050,26,003,"Michigan","Alger County",1,0,56,28,28
050,26,003,"Michigan","Alger County",1,1,54,28,26
050,26,003,"Michigan","Alger County",1,2,62,30,32
050,26,003,"Michigan","Alger County",1,3,68,29,39
050,26,003,"Michigan","Alger County",1,4,74,36,38
050,26,003,"Michigan","Alger County",1,5,76,33,43
050,26,003,"Michigan","Alger County",1,6,66,33,33
050,26,003,"Michigan","Alger County",1,7,71,31,40
050,26,003,"Michigan","Alger County",1,8,62,30,32
050,26,003,"Michigan","Alger County",1,9,67,33,34
050,26,003,"Michigan","Alger County",1,10,79,45,34
050,26,003,"Michigan","Alger County",1,11,94,56,38
050,26,003,"Michigan","Alger County",1,12,78,36,42
050,26,003,"Michigan","Alger County",1,13,85,44,41
050,26,003,"Michigan","Alger County",1,14,92,48,44
050,26,003,"Michigan","Alger County",1,15,86,45,41
050,26,003,"Michigan","Alger County",1,16,80,38,42
050,26,003,"Michigan","Alger County",1,17,87,48,39
050,26,003,"Michigan","Alger County",1,18,83,42,41
050,26,003,"Michigan","Alger County",1,19,72,39,33
050,26,003,"Michigan","Alger County",1,20,84,57,27
050,26,003,"Michigan","Alger County",1,21,88,53,35
050,26,003,"Michigan","Alger County",1,22,101,65,36
050,26,003,"Michigan","Alger County",1,23,103,78,25
050,26,003,"Michigan","Alger County",1,24,95,73,22
050,26,003,"Michigan","Alger County",1,25,103,75,28
050,26,003,"Michigan","Alger County",1,26,95,69,26
050,26,003,"Michigan","Alger County",1,27,108,76,32
050,26,003,"Michigan","Alger County",1,28,87,61,26
050,26,003,"Michigan","Alger County",1,29,106,69,37
050,26,003,"Michigan","Alger County",1,30,114,83,31
050,26,003,"Michigan","Alger County",1,31,105,69,36
050,26,003,"Michigan","Alger County",1,32,100,64,36
050,26,003,"Michigan","Alger County",1,33,105,65,40
050,26,003,"Michigan","Alger County",1,34,114,76,38
050,26,003,"Michigan","Alger County",1,35,100,66,34
050,26,003,"Michigan","Alger County",1,36,107,74,33
050,26,003,"Michigan","Alger County",1,37,112,73,39
050,26,003,"Michigan","Alger County",1,38,105,68,37
050,26,003,"Michigan","Alger County",1,39,111,70,41
050,26,003,"Michigan","Alger County",1,40,98,56,42
050,26,003,"Michigan","Alger County",1,41,106,68,38
050,26,003,"Michigan","Alger County",1,42,97,53,44
050,26,003,"Michigan","Alger County",1,43,91,53,38
050,26,003,"Michigan","Alger County",1,44,95,61,34
050,26,003,"Michigan","Alger County",1,45,104,61,43
050,26,003,"Michigan","Alger County",1,46,94,51,43
050,26,003,"Michigan","Alger County",1,47,87,49,38
050,26,003,"Michigan","Alger County",1,48,102,68,34
050,26,003,"Michigan","Alger County",1,49,99,60,39
050,26,003,"Michigan","Alger County",1,50,93,49,44
050,26,003,"Michigan","Alger County",1,51,95,52,43
050,26,003,"Michigan","Alger County",1,52,107,51,56
050,26,003,"Michigan","Alger County",1,53,123,64,59
050,26,003,"Michigan","Alger County",1,54,116,59,57
050,26,003,"Michigan","Alger County",1,55,131,69,62
050,26,003,"Michigan","Alger County",1,56,131,70,61
050,26,003,"Michigan","Alger County",1,57,147,83,64
050,26,003,"Michigan","Alger County",1,58,153,84,69
050,26,003,"Michigan","Alger County",1,59,139,68,71
050,26,003,"Michigan","Alger County",1,60,174,86,88
050,26,003,"Michigan","Alger County",1,61,162,70,92
050,26,003,"Michigan","Alger County",1,62,155,77,78
050,26,003,"Michigan","Alger County",1,63,164,90,74
050,26,003,"Michigan","Alger County",1,64,180,91,89
050,26,003,"Michigan","Alger County",1,65,154,72,82
050,26,003,"Michigan","Alger County",1,66,159,83,76
050,26,003,"Michigan","Alger County",1,67,165,85,80
050,26,003,"Michigan","Alger County",1,68,159,89,70
050,26,003,"Michigan","Alger County",1,69,139,68,71
050,26,003,"Michigan","Alger County",1,70,147,74,73
050,26,003,"Michigan","Alger County",1,71,140,79,61
050,26,003,"Michigan","Alger County",1,72,129,71,58
050,26,003,"Michigan","Alger County",1,73,129,70,59
050,26,003,"Michigan","Alger County",1,74,80,44,36
050,26,003,"Michigan","Alger County",1,75,80,42,38
050,26,003,"Michigan","Alger County",1,76,89,47,42
050,26,003,"Michigan","Alger County",1,77,90,48,42
050,26,003,"Michigan","Alger County",1,78,69,36,33
050,26,003,"Michigan","Alger County",1,79,60,36,24
050,26,003,"Michigan","Alger County",1,80,69,34,35
050,26,003,"Michigan","Alger County",1,81,47,24,23
050,26,003,"Michigan","Alger County",1,82,54,27,27
050,26,003,"Michigan","Alger County",1,83,52,23,29
050,26,003,"Michigan","Alger County",1,84,46,20,26
050,26,003,"Michigan","Alger County",1,85,201,69,132
050,26,003,"Michigan","Alger County",2,0,64,32,32
050,26,003,"Michigan","Alger County",2,1,53,28,25
050,26,003,"Michigan","Alger County",2,2,61,30,31
050,26,003,"Michigan","Alger County",2,3,68,30,38
050,26,003,"Michigan","Alger County",2,4,73,35,38
050,26,003,"Michigan","Alger County",2,5,75,33,42
050,26,003,"Michigan","Alger County",2,6,70,34,36
050,26,003,"Michigan","Alger County",2,7,70,33,37
050,26,003,"Michigan","Alger County",2,8,65,32,33
050,26,003,"Michigan","Alger County",2,9,67,32,35
050,26,003,"Michigan","Alger County",2,10,77,43,34
050,26,003,"Michigan","Alger County",2,11,90,54,36
050,26,003,"Michigan","Alger County",2,12,84,42,42
050,26,003,"Michigan","Alger County",2,13,83,41,42
050,26,003,"Michigan","Alger County",2,14,89,47,42
050,26,003,"Michigan","Alger County",2,15,87,45,42
050,26,003,"Michigan","Alger County",2,16,82,40,42
050,26,003,"Michigan","Alger County",2,17,84,45,39
050,26,003,"Michigan","Alger County",2,18,80,40,40
050,26,003,"Michigan","Alger County",2,19,74,41,33
050,26,003,"Michigan","Alger County",2,20,86,57,29
050,26,003,"Michigan","Alger County",2,21,87,54,33
050,26,003,"Michigan","Alger County",2,22,100,65,35
050,26,003,"Michigan","Alger County",2,23,104,77,27
050,26,003,"Michigan","Alger County",2,24,95,72,23
050,26,003,"Michigan","Alger County",2,25,103,76,27
050,26,003,"Michigan","Alger County",2,26,98,70,28
050,26,003,"Michigan","Alger County",2,27,104,74,30
050,26,003,"Michigan","Alger County",2,28,91,63,28
050,26,003,"Michigan","Alger County",2,29,105,70,35
050,26,003,"Michigan","Alger County",2,30,115,82,33
050,26,003,"Michigan","Alger County",2,31,105,70,35
050,26,003,"Michigan","Alger County",2,32,102,64,38
050,26,003,"Michigan","Alger County",2,33,103,64,39
050,26,003,"Michigan","Alger County",2,34,113,75,38
050,26,003,"Michigan","Alger County",2,35,102,66,36
050,26,003,"Michigan","Alger County",2,36,107,73,34
050,26,003,"Michigan","Alger County",2,37,110,72,38
050,26,003,"Michigan","Alger County",2,38,107,69,38
050,26,003,"Michigan","Alger County",2,39,109,70,39
050,26,003,"Michigan","Alger County",2,40,98,57,41
050,26,003,"Michigan","Alger County",2,41,109,69,40
050,26,003,"Michigan","Alger County",2,42,94,51,43
050,26,003,"Michigan","Alger County",2,43,94,54,40
050,26,003,"Michigan","Alger County",2,44,95,61,34
050,26,003,"Michigan","Alger County",2,45,103,61,42
050,26,003,"Michigan","Alger County",2,46,92,50,42
050,26,003,"Michigan","Alger County",2,47,89,50,39
050,26,003,"Michigan","Alger County",2,48,100,65,35
050,26,003,"Michigan","Alger County",2,49,99,61,38
050,26,003,"Michigan","Alger County",2,50,95,52,43
050,26,003,"Michigan","Alger County",2,51,95,51,44
050,26,003,"Michigan","Alger County",2,52,102,50,52
050,26,003,"Michigan","Alger County",2,53,119,61,58
050,26,003,"Michigan","Alger County",2,54,117,60,57
050,26,003,"Michigan","Alger County",2,55,124,65,59
050,26,003,"Michigan","Alger County",2,56,135,72,63
050,26,003,"Michigan","Alger County",2,57,143,79,64
050,26,003,"Michigan","Alger County",2,58,153,84,69
050,26,003,"Michigan","Alger County",2,59,146,74,72
050,26,003,"Michigan","Alger County",2,60,167,83,84
050,26,003,"Michigan","Alger County",2,61,160,71,89
050,26,003,"Michigan","Alger County",2,62,156,76,80
050,26,003,"Michigan","Alger County",2,63,163,86,77
050,26,003,"Michigan","Alger County",2,64,174,88,86
050,26,003,"Michigan","Alger County",2,65,158,74,84
050,26,003,"Michigan","Alger County",2,66,158,80,78
050,26,003,"Michigan","Alger County",2,67,164,85,79
050,26,003,"Michigan","Alger County",2,68,159,88,71
050,26,003,"Michigan","Alger County",2,69,145,74,71
050,26,003,"Michigan","Alger County",2,70,146,73,73
050,26,003,"Michigan","Alger County",2,71,143,77,66
050,26,003,"Michigan","Alger County",2,72,129,73,56
050,26,003,"Michigan","Alger County",2,73,134,73,61
050,26,003,"Michigan","Alger County",2,74,86,46,40
050,26,003,"Michigan","Alger County",2,75,78,41,37
050,26,003,"Michigan","Alger County",2,76,85,45,40
050,26,003,"Michigan","Alger County",2,77,93,50,43
050,26,003,"Michigan","Alger County",2,78,71,37,34
050,26,003,"Michigan","Alger County",2,79,62,36,26
050,26,003,"Michigan","Alger County",2,80,66,35,31
050,26,003,"Michigan","Alger County",2,81,49,25,24
050,26,003,"Michigan","Alger County",2,82,54,27,27
050,26,003,"Michigan","Alger County",2,83,50,24,26
050,26,003,"Michigan","Alger County",2,84,47,20,27
050,26,003,"Michigan","Alger County",2,85,201,70,131
050,26,003,"Michigan","Alger County",3,0,64,39,25
050,26,003,"Michigan","Alger County",3,1,73,35,38
050,26,003,"Michigan","Alger County",3,2,60,35,25
050,26,003,"Michigan","Alger County",3,3,65,31,34
050,26,003,"Michigan","Alger County",3,4,64,26,38
050,26,003,"Michigan","Alger County",3,5,71,33,38
050,26,003,"Michigan","Alger County",3,6,74,34,40
050,26,003,"Michigan","Alger County",3,7,72,35,37
050,26,003,"Michigan","Alger County",3,8,70,36,34
050,26,003,"Michigan","Alger County",3,9,62,29,33
050,26,003,"Michigan","Alger County",3,10,68,33,35
050,26,003,"Michigan","Alger County",3,11,71,39,32
050,26,003,"Michigan","Alger County",3,12,88,53,35
050,26,003,"Michigan","Alger County",3,13,82,42,40
050,26,003,"Michigan","Alger County",3,14,81,42,39
050,26,003,"Michigan","Alger County",3,15,87,49,38
050,26,003,"Michigan","Alger County",3,16,86,49,37
050,26,003,"Michigan","Alger County",3,17,84,44,40
050,26,003,"Michigan","Alger County",3,18,80,47,33
050,26,003,"Michigan","Alger County",3,19,76,43,33
050,26,003,"Michigan","Alger County",3,20,86,51,35
050,26,003,"Michigan","Alger County",3,21,90,56,34
050,26,003,"Michigan","Alger County",3,22,95,58,37
050,26,003,"Michigan","Alger County",3,23,112,73,39
050,26,003,"Michigan","Alger County",3,24,109,79,30
050,26,003,"Michigan","Alger County",3,25,100,74,26
050,26,003,"Michigan","Alger County",3,26,92,71,21
050,26,003,"Michigan","Alger County",3,27,105,75,30
050,26,003,"Michigan","Alger County",3,28,95,67,28
050,26,003,"Michigan","Alger County",3,29,103,72,31
050,26,003,"Michigan","Alger County",3,30,110,74,36
050,26,003,"Michigan","Alger County",3,31,102,70,32
050,26,003,"Michigan","Alger County",3,32,99,66,33
050,26,003,"Michigan","Alger County",3,33,99,62,37
050,26,003,"Michigan","Alger County",3,34,104,64,40
050,26,003,"Michigan","Alger County",3,35,103,66,37
050,26,003,"Michigan","Alger County",3,36,101,69,32
050,26,003,"Michigan","Alger County",3,37,99,62,37
050,26,003,"Michigan","Alger County",3,38,113,75,38
050,26,003,"Michigan","Alger County",3,39,111,73,38
050,26,003,"Michigan","Alger County",3,40,90,54,36
050,26,003,"Michigan","Alger County",3,41,109,69,40
050,26,003,"Michigan","Alger County",3,42,91,51,40
050,26,003,"Michigan","Alger County",3,43,95,51,44
050,26,003,"Michigan","Alger County",3,44,105,60,45
050,26,003,"Michigan","Alger County",3,45,88,52,36
050,26,003,"Michigan","Alger County",3,46,89,50,39
050,26,003,"Michigan","Alger County",3,47,95,54,41
050,26,003,"Michigan","Alger County",3,48,90,51,39
050,26,003,"Michigan","Alger County",3,49,91,55,36
050,26,003,"Michigan","Alger County",3,50,106,68,38
050,26,003,"Michigan","Alger County",3,51,98,50,48
050,26,003,"Michigan","Alger County",3,52,97,52,45
050,26,003,"Michigan","Alger County",3,53,107,57,50
050,26,003,"Michigan","Alger County",3,54,113,53,60
050,26,003,"Michigan","Alger County",3,55,115,62,53
050,26,003,"Michigan","Alger County",3,56,130,69,61
050,26,003,"Michigan","Alger County",3,57,128,64,64
050,26,003,"Michigan","Alger County",3,58,145,80,65
050,26,003,"Michigan","Alger County",3,59,150,81,69
050,26,003,"Michigan","Alger County",3,60,157,83,74
050,26,003,"Michigan","Alger County",3,61,154,74,80
050,26,003,"Michigan","Alger County",3,62,170,82,88
050,26,003,"Michigan","Alger County",3,63,147,68,79
050,26,003,"Michigan","Alger County",3,64,161,85,76
050,26,003,"Michigan","Alger County",3,65,175,91,84
050,26,003,"Michigan","Alger County",3,66,158,75,83
050,26,003,"Michigan","Alger County",3,67,159,81,78
050,26,003,"Michigan","Alger County",3,68,164,84,80
050,26,003,"Michigan","Alger County",3,69,148,83,65
050,26,003,"Michigan","Alger County",3,70,149,76,73
050,26,003,"Michigan","Alger County",3,71,142,69,73
050,26,003,"Michigan","Alger County",3,72,138,77,61
050,26,003,"Michigan","Alger County",3,73,123,69,54
050,26,003,"Michigan","Alger County",3,74,132,72,60
050,26,003,"Michigan","Alger County",3,75,76,41,35
050,26,003,"Michigan","Alger County",3,76,75,39,36
050,26,003,"Michigan","Alger County",3,77,85,48,37
050,26,003,"Michigan","Alger County",3,78,86,44,42
050,26,003,"Michigan","Alger County",3,79,63,36,27
050,26,003,"Michigan","Alger County",3,80,60,34,26
050,26,003,"Michigan","Alger County",3,81,59,33,26
050,26,003,"Michigan","Alger County",3,82,47,26,21
050,26,003,"Michigan","Alger County",3,83,50,21,29
050,26,003,"Michigan","Alger County",3,84,45,23,22
050,26,003,"Michigan","Alger County",3,85,213,74,139
050,26,003,"Michigan","Alger County",4,0,74,36,38
050,26,003,"Michigan","Alger County",4,1,60,35,25
050,26,003,"Michigan","Alger County",4,2,75,34,41
050,26,003,"Michigan","Alger County",4,3,61,35,26
050,26,003,"Michigan","Alger County",4,4,66,32,34
050,26,003,"Michigan","Alger County",4,5,65,25,40
050,26,003,"Michigan","Alger County",4,6,75,37,38
050,26,003,"Michigan","Alger County",4,7,75,35,40
050,26,003,"Michigan","Alger County",4,8,67,34,33
050,26,003,"Michigan","Alger County",4,9,72,37,35
050,26,003,"Michigan","Alger County",4,10,60,27,33
050,26,003,"Michigan","Alger County",4,11,71,34,37
050,26,003,"Michigan","Alger County",4,12,68,38,30
050,26,003,"Michigan","Alger County",4,13,87,53,34
050,26,003,"Michigan","Alger County",4,14,82,41,41
050,26,003,"Michigan","Alger County",4,15,69,37,32
050,26,003,"Michigan","Alger County",4,16,86,50,36
050,26,003,"Michigan","Alger County",4,17,82,48,34
050,26,003,"Michigan","Alger County",4,18,67,36,31
050,26,003,"Michigan","Alger County",4,19,63,41,22
050,26,003,"Michigan","Alger County",4,20,88,56,32
050,26,003,"Michigan","Alger County",4,21,95,60,35
050,26,003,"Michigan","Alger County",4,22,102,61,41
050,26,003,"Michigan","Alger County",4,23,106,66,40
050,26,003,"Michigan","Alger County",4,24,106,73,33
050,26,003,"Michigan","Alger County",4,25,122,87,35
050,26,003,"Michigan","Alger County",4,26,96,66,30
050,26,003,"Michigan","Alger County",4,27,111,85,26
050,26,003,"Michigan","Alger County",4,28,107,76,31
050,26,003,"Michigan","Alger County",4,29,106,72,34
050,26,003,"Michigan","Alger County",4,30,103,74,29
050,26,003,"Michigan","Alger County",4,31,108,69,39
050,26,003,"Michigan","Alger County",4,32,100,65,35
050,26,003,"Michigan","Alger County",4,33,107,71,36
050,26,003,"Michigan","Alger County",4,34,109,72,37
050,26,003,"Michigan","Alger County",4,35,99,58,41
050,26,003,"Michigan","Alger County",4,36,108,71,37
050,26,003,"Michigan","Alger County",4,37,99,65,34
050,26,003,"Michigan","Alger County",4,38,102,63,39
050,26,003,"Michigan","Alger County",4,39,121,81,40
050,26,003,"Michigan","Alger County",4,40,105,69,36
050,26,003,"Michigan","Alger County",4,41,101,65,36
050,26,003,"Michigan","Alger County",4,42,95,55,40
050,26,003,"Michigan","Alger County",4,43,94,53,41
050,26,003,"Michigan","Alger County",4,44,95,57,38
050,26,003,"Michigan","Alger County",4,45,100,57,43
050,26,003,"Michigan","Alger County",4,46,80,46,34
050,26,003,"Michigan","Alger County",4,47,93,51,42
050,26,003,"Michigan","Alger County",4,48,100,58,42
050,26,003,"Michigan","Alger County",4,49,86,45,41
050,26,003,"Michigan","Alger County",4,50,95,61,34
050,26,003,"Michigan","Alger County",4,51,98,64,34
050,26,003,"Michigan","Alger County",4,52,99,50,49
050,26,003,"Michigan","Alger County",4,53,99,59,40
050,26,003,"Michigan","Alger County",4,54,97,49,48
050,26,003,"Michigan","Alger County",4,55,114,54,60
050,26,003,"Michigan","Alger County",4,56,129,72,57
050,26,003,"Michigan","Alger County",4,57,126,67,59
050,26,003,"Michigan","Alger County",4,58,125,61,64
050,26,003,"Michigan","Alger County",4,59,143,77,66
050,26,003,"Michigan","Alger County",4,60,152,82,70
050,26,003,"Michigan","Alger County",4,61,160,83,77
050,26,003,"Michigan","Alger County",4,62,160,78,82
050,26,003,"Michigan","Alger County",4,63,172,79,93
050,26,003,"Michigan","Alger County",4,64,145,71,74
050,26,003,"Michigan","Alger County",4,65,165,83,82
050,26,003,"Michigan","Alger County",4,66,172,89,83
050,26,003,"Michigan","Alger County",4,67,162,76,86
050,26,003,"Michigan","Alger County",4,68,156,79,77
050,26,003,"Michigan","Alger County",4,69,151,76,75
050,26,003,"Michigan","Alger County",4,70,148,85,63
050,26,003,"Michigan","Alger County",4,71,141,70,71
050,26,003,"Michigan","Alger County",4,72,135,68,67
050,26,003,"Michigan","Alger County",4,73,137,75,62
050,26,003,"Michigan","Alger County",4,74,119,68,51
050,26,003,"Michigan","Alger County",4,75,127,70,57
050,26,003,"Michigan","Alger County",4,76,72,40,32
050,26,003,"Michigan","Alger County",4,77,75,40,35
050,26,003,"Michigan","Alger County",4,78,77,41,36
050,26,003,"Michigan","Alger County",4,79,78,43,35
050,26,003,"Michigan","Alger County",4,80,58,31,27
050,26,003,"Michigan","Alger County",4,81,50,31,19
050,26,003,"Michigan","Alger County",4,82,53,31,22
050,26,003,"Michigan","Alger County",4,83,41,21,20
050,26,003,"Michigan","Alger County",4,84,48,22,26
050,26,003,"Michigan","Alger County",4,85,225,83,142
050,26,003,"Michigan","Alger County",5,0,67,34,33
050,26,003,"Michigan","Alger County",5,1,75,38,37
050,26,003,"Michigan","Alger County",5,2,59,35,24
050,26,003,"Michigan","Alger County",5,3,77,35,42
050,26,003,"Michigan","Alger County",5,4,60,33,27
050,26,003,"Michigan","Alger County",5,5,67,33,34
050,26,003,"Michigan","Alger County",5,6,64,26,38
050,26,003,"Michigan","Alger County",5,7,74,37,37
050,26,003,"Michigan","Alger County",5,8,70,33,37
050,26,003,"Michigan","Alger County",5,9,68,34,34
050,26,003,"Michigan","Alger County",5,10,73,38,35
050,26,003,"Michigan","Alger County",5,11,56,26,30
050,26,003,"Michigan","Alger County",5,12,74,36,38
050,26,003,"Michigan","Alger County",5,13,69,38,31
050,26,003,"Michigan","Alger County",5,14,89,56,33
050,26,003,"Michigan","Alger County",5,15,78,39,39
050,26,003,"Michigan","Alger County",5,16,72,38,34
050,26,003,"Michigan","Alger County",5,17,81,47,34
050,26,003,"Michigan","Alger County",5,18,72,41,31
050,26,003,"Michigan","Alger County",5,19,62,40,22
050,26,003,"Michigan","Alger County",5,20,81,56,25
050,26,003,"Michigan","Alger County",5,21,94,61,33
050,26,003,"Michigan","Alger County",5,22,112,70,42
050,26,003,"Michigan","Alger County",5,23,112,71,41
050,26,003,"Michigan","Alger County",5,24,120,72,48
050,26,003,"Michigan","Alger County",5,25,109,71,38
050,26,003,"Michigan","Alger County",5,26,116,83,33
050,26,003,"Michigan","Alger County",5,27,106,74,32
050,26,003,"Michigan","Alger County",5,28,109,81,28
050,26,003,"Michigan","Alger County",5,29,115,86,29
050,26,003,"Michigan","Alger County",5,30,104,73,31
050,26,003,"Michigan","Alger County",5,31,103,64,39
050,26,003,"Michigan","Alger County",5,32,109,64,45
050,26,003,"Michigan","Alger County",5,33,98,64,34
050,26,003,"Michigan","Alger County",5,34,116,77,39
050,26,003,"Michigan","Alger County",5,35,100,63,37
050,26,003,"Michigan","Alger County",5,36,99,62,37
050,26,003,"Michigan","Alger County",5,37,104,66,38
050,26,003,"Michigan","Alger County",5,38,104,69,35
050,26,003,"Michigan","Alger County",5,39,98,66,32
050,26,003,"Michigan","Alger County",5,40,112,70,42
050,26,003,"Michigan","Alger County",5,41,112,76,36
050,26,003,"Michigan","Alger County",5,42,82,50,32
050,26,003,"Michigan","Alger County",5,43,96,56,40
050,26,003,"Michigan","Alger County",5,44,101,59,42
050,26,003,"Michigan","Alger County",5,45,94,56,38
050,26,003,"Michigan","Alger County",5,46,85,47,38
050,26,003,"Michigan","Alger County",5,47,83,48,35
050,26,003,"Michigan","Alger County",5,48,99,59,40
050,26,003,"Michigan","Alger County",5,49,96,53,43
050,26,003,"Michigan","Alger County",5,50,89,51,38
050,26,003,"Michigan","Alger County",5,51,93,58,35
050,26,003,"Michigan","Alger County",5,52,94,59,35
050,26,003,"Michigan","Alger County",5,53,105,54,51
050,26,003,"Michigan","Alger County",5,54,98,57,41
050,26,003,"Michigan","Alger County",5,55,102,49,53
050,26,003,"Michigan","Alger County",5,56,118,61,57
050,26,003,"Michigan","Alger County",5,57,122,67,55
050,26,003,"Michigan","Alger County",5,58,121,64,57
050,26,003,"Michigan","Alger County",5,59,121,60,61
050,26,003,"Michigan","Alger County",5,60,154,84,70
050,26,003,"Michigan","Alger County",5,61,138,71,67
050,26,003,"Michigan","Alger County",5,62,163,89,74
050,26,003,"Michigan","Alger County",5,63,159,74,85
050,26,003,"Michigan","Alger County",5,64,175,81,94
050,26,003,"Michigan","Alger County",5,65,143,72,71
050,26,003,"Michigan","Alger County",5,66,160,78,82
050,26,003,"Michigan","Alger County",5,67,172,89,83
050,26,003,"Michigan","Alger County",5,68,163,77,86
050,26,003,"Michigan","Alger County",5,69,153,80,73
050,26,003,"Michigan","Alger County",5,70,154,81,73
050,26,003,"Michigan","Alger County",5,71,140,79,61
050,26,003,"Michigan","Alger County",5,72,139,71,68
050,26,003,"Michigan","Alger County",5,73,135,65,70
050,26,003,"Michigan","Alger County",5,74,130,72,58
050,26,003,"Michigan","Alger County",5,75,113,64,49
050,26,003,"Michigan","Alger County",5,76,119,65,54
050,26,003,"Michigan","Alger County",5,77,74,42,32
050,26,003,"Michigan","Alger County",5,78,69,34,35
050,26,003,"Michigan","Alger County",5,79,70,41,29
050,26,003,"Michigan","Alger County",5,80,76,42,34
050,26,003,"Michigan","Alger County",5,81,47,27,20
050,26,003,"Michigan","Alger County",5,82,48,30,18
050,26,003,"Michigan","Alger County",5,83,45,25,20
050,26,003,"Michigan","Alger County",5,84,38,20,18
050,26,003,"Michigan","Alger County",5,85,241,95,146
050,26,005,"Michigan","Allegan County",1,0,1411,725,686
050,26,005,"Michigan","Allegan County",1,1,1386,700,686
050,26,005,"Michigan","Allegan County",1,2,1438,747,691
050,26,005,"Michigan","Allegan County",1,3,1513,747,766
050,26,005,"Michigan","Allegan County",1,4,1564,806,758
050,26,005,"Michigan","Allegan County",1,5,1562,807,755
050,26,005,"Michigan","Allegan County",1,6,1537,797,740
050,26,005,"Michigan","Allegan County",1,7,1529,777,752
050,26,005,"Michigan","Allegan County",1,8,1641,839,802
050,26,005,"Michigan","Allegan County",1,9,1615,814,801
050,26,005,"Michigan","Allegan County",1,10,1671,845,826
050,26,005,"Michigan","Allegan County",1,11,1724,882,842
050,26,005,"Michigan","Allegan County",1,12,1750,944,806
050,26,005,"Michigan","Allegan County",1,13,1832,949,883
050,26,005,"Michigan","Allegan County",1,14,1773,891,882
050,26,005,"Michigan","Allegan County",1,15,1705,861,844
050,26,005,"Michigan","Allegan County",1,16,1726,883,843
050,26,005,"Michigan","Allegan County",1,17,1676,819,857
050,26,005,"Michigan","Allegan County",1,18,1400,760,640
050,26,005,"Michigan","Allegan County",1,19,1173,655,518
050,26,005,"Michigan","Allegan County",1,20,1270,664,606
050,26,005,"Michigan","Allegan County",1,21,1315,677,638
050,26,005,"Michigan","Allegan County",1,22,1335,690,645
050,26,005,"Michigan","Allegan County",1,23,1354,688,666
050,26,005,"Michigan","Allegan County",1,24,1332,683,649
050,26,005,"Michigan","Allegan County",1,25,1369,686,683
050,26,005,"Michigan","Allegan County",1,26,1378,704,674
050,26,005,"Michigan","Allegan County",1,27,1401,727,674
050,26,005,"Michigan","Allegan County",1,28,1445,723,722
050,26,005,"Michigan","Allegan County",1,29,1447,704,743
050,26,005,"Michigan","Allegan County",1,30,1472,765,707
050,26,005,"Michigan","Allegan County",1,31,1458,730,728
050,26,005,"Michigan","Allegan County",1,32,1389,701,688
050,26,005,"Michigan","Allegan County",1,33,1457,697,760
050,26,005,"Michigan","Allegan County",1,34,1520,754,766
050,26,005,"Michigan","Allegan County",1,35,1509,761,748
050,26,005,"Michigan","Allegan County",1,36,1471,758,713
050,26,005,"Michigan","Allegan County",1,37,1464,743,721
050,26,005,"Michigan","Allegan County",1,38,1520,761,759
050,26,005,"Michigan","Allegan County",1,39,1561,794,767
050,26,005,"Michigan","Allegan County",1,40,1466,750,716
050,26,005,"Michigan","Allegan County",1,41,1407,737,670
050,26,005,"Michigan","Allegan County",1,42,1412,717,695
050,26,005,"Michigan","Allegan County",1,43,1437,720,717
050,26,005,"Michigan","Allegan County",1,44,1370,699,671
050,26,005,"Michigan","Allegan County",1,45,1379,686,693
050,26,005,"Michigan","Allegan County",1,46,1360,700,660
050,26,005,"Michigan","Allegan County",1,47,1394,717,677
050,26,005,"Michigan","Allegan County",1,48,1476,763,713
050,26,005,"Michigan","Allegan County",1,49,1594,796,798
050,26,005,"Michigan","Allegan County",1,50,1595,808,787
050,26,005,"Michigan","Allegan County",1,51,1574,783,791
050,26,005,"Michigan","Allegan County",1,52,1570,765,805
050,26,005,"Michigan","Allegan County",1,53,1629,836,793
050,26,005,"Michigan","Allegan County",1,54,1596,847,749
050,26,005,"Michigan","Allegan County",1,55,1718,875,843
050,26,005,"Michigan","Allegan County",1,56,1835,935,900
050,26,005,"Michigan","Allegan County",1,57,1820,925,895
050,26,005,"Michigan","Allegan County",1,58,1756,909,847
050,26,005,"Michigan","Allegan County",1,59,1850,934,916
050,26,005,"Michigan","Allegan County",1,60,1803,898,905
050,26,005,"Michigan","Allegan County",1,61,1794,923,871
050,26,005,"Michigan","Allegan County",1,62,1788,910,878
050,26,005,"Michigan","Allegan County",1,63,1708,889,819
050,26,005,"Michigan","Allegan County",1,64,1638,823,815
050,26,005,"Michigan","Allegan County",1,65,1585,767,818
050,26,005,"Michigan","Allegan County",1,66,1480,741,739
050,26,005,"Michigan","Allegan County",1,67,1479,730,749
050,26,005,"Michigan","Allegan County",1,68,1450,728,722
050,26,005,"Michigan","Allegan County",1,69,1303,649,654
050,26,005,"Michigan","Allegan County",1,70,1242,598,644
050,26,005,"Michigan","Allegan County",1,71,1161,561,600
050,26,005,"Michigan","Allegan County",1,72,1126,552,574
050,26,005,"Michigan","Allegan County",1,73,1091,547,544
050,26,005,"Michigan","Allegan County",1,74,776,377,399
050,26,005,"Michigan","Allegan County",1,75,828,393,435
050,26,005,"Michigan","Allegan County",1,76,819,403,416
050,26,005,"Michigan","Allegan County",1,77,816,402,414
050,26,005,"Michigan","Allegan County",1,78,698,296,402
050,26,005,"Michigan","Allegan County",1,79,594,262,332
050,26,005,"Michigan","Allegan County",1,80,501,226,275
050,26,005,"Michigan","Allegan County",1,81,480,211,269
050,26,005,"Michigan","Allegan County",1,82,437,196,241
050,26,005,"Michigan","Allegan County",1,83,391,167,224
050,26,005,"Michigan","Allegan County",1,84,333,153,180
050,26,005,"Michigan","Allegan County",1,85,1862,672,1190
050,26,005,"Michigan","Allegan County",2,0,1351,684,667
050,26,005,"Michigan","Allegan County",2,1,1392,708,684
050,26,005,"Michigan","Allegan County",2,2,1432,738,694
050,26,005,"Michigan","Allegan County",2,3,1495,749,746
050,26,005,"Michigan","Allegan County",2,4,1564,799,765
050,26,005,"Michigan","Allegan County",2,5,1566,807,759
050,26,005,"Michigan","Allegan County",2,6,1547,799,748
050,26,005,"Michigan","Allegan County",2,7,1536,785,751
050,26,005,"Michigan","Allegan County",2,8,1604,819,785
050,26,005,"Michigan","Allegan County",2,9,1616,817,799
050,26,005,"Michigan","Allegan County",2,10,1655,836,819
050,26,005,"Michigan","Allegan County",2,11,1711,872,839
050,26,005,"Michigan","Allegan County",2,12,1761,938,823
050,26,005,"Michigan","Allegan County",2,13,1814,949,865
050,26,005,"Michigan","Allegan County",2,14,1786,908,878
050,26,005,"Michigan","Allegan County",2,15,1722,867,855
050,26,005,"Michigan","Allegan County",2,16,1722,877,845
050,26,005,"Michigan","Allegan County",2,17,1682,835,847
050,26,005,"Michigan","Allegan County",2,18,1398,745,653
050,26,005,"Michigan","Allegan County",2,19,1165,644,521
050,26,005,"Michigan","Allegan County",2,20,1287,681,606
050,26,005,"Michigan","Allegan County",2,21,1323,686,637
050,26,005,"Michigan","Allegan County",2,22,1348,693,655
050,26,005,"Michigan","Allegan County",2,23,1362,694,668
050,26,005,"Michigan","Allegan County",2,24,1347,690,657
050,26,005,"Michigan","Allegan County",2,25,1369,692,677
050,26,005,"Michigan","Allegan County",2,26,1380,701,679
050,26,005,"Michigan","Allegan County",2,27,1396,719,677
050,26,005,"Michigan","Allegan County",2,28,1430,721,709
050,26,005,"Michigan","Allegan County",2,29,1448,711,737
050,26,005,"Michigan","Allegan County",2,30,1483,762,721
050,26,005,"Michigan","Allegan County",2,31,1464,743,721
050,26,005,"Michigan","Allegan County",2,32,1414,710,704
050,26,005,"Michigan","Allegan County",2,33,1448,701,747
050,26,005,"Michigan","Allegan County",2,34,1508,741,767
050,26,005,"Michigan","Allegan County",2,35,1525,767,758
050,26,005,"Michigan","Allegan County",2,36,1469,753,716
050,26,005,"Michigan","Allegan County",2,37,1472,750,722
050,26,005,"Michigan","Allegan County",2,38,1515,763,752
050,26,005,"Michigan","Allegan County",2,39,1551,787,764
050,26,005,"Michigan","Allegan County",2,40,1502,771,731
050,26,005,"Michigan","Allegan County",2,41,1423,740,683
050,26,005,"Michigan","Allegan County",2,42,1408,718,690
050,26,005,"Michigan","Allegan County",2,43,1440,727,713
050,26,005,"Michigan","Allegan County",2,44,1375,699,676
050,26,005,"Michigan","Allegan County",2,45,1383,692,691
050,26,005,"Michigan","Allegan County",2,46,1360,694,666
050,26,005,"Michigan","Allegan County",2,47,1375,704,671
050,26,005,"Michigan","Allegan County",2,48,1451,751,700
050,26,005,"Michigan","Allegan County",2,49,1568,792,776
050,26,005,"Michigan","Allegan County",2,50,1599,806,793
050,26,005,"Michigan","Allegan County",2,51,1578,787,791
050,26,005,"Michigan","Allegan County",2,52,1569,768,801
050,26,005,"Michigan","Allegan County",2,53,1620,821,799
050,26,005,"Michigan","Allegan County",2,54,1602,844,758
050,26,005,"Michigan","Allegan County",2,55,1688,867,821
050,26,005,"Michigan","Allegan County",2,56,1813,924,889
050,26,005,"Michigan","Allegan County",2,57,1823,927,896
050,26,005,"Michigan","Allegan County",2,58,1770,910,860
050,26,005,"Michigan","Allegan County",2,59,1838,934,904
050,26,005,"Michigan","Allegan County",2,60,1810,906,904
050,26,005,"Michigan","Allegan County",2,61,1792,913,879
050,26,005,"Michigan","Allegan County",2,62,1793,916,877
050,26,005,"Michigan","Allegan County",2,63,1745,904,841
050,26,005,"Michigan","Allegan County",2,64,1643,833,810
050,26,005,"Michigan","Allegan County",2,65,1604,785,819
050,26,005,"Michigan","Allegan County",2,66,1512,750,762
050,26,005,"Michigan","Allegan County",2,67,1472,728,744
050,26,005,"Michigan","Allegan County",2,68,1446,724,722
050,26,005,"Michigan","Allegan County",2,69,1349,674,675
050,26,005,"Michigan","Allegan County",2,70,1248,610,638
050,26,005,"Michigan","Allegan County",2,71,1180,569,611
050,26,005,"Michigan","Allegan County",2,72,1114,540,574
050,26,005,"Michigan","Allegan County",2,73,1148,574,574
050,26,005,"Michigan","Allegan County",2,74,797,391,406
050,26,005,"Michigan","Allegan County",2,75,818,389,429
050,26,005,"Michigan","Allegan County",2,76,811,396,415
050,26,005,"Michigan","Allegan County",2,77,830,407,423
050,26,005,"Michigan","Allegan County",2,78,709,311,398
050,26,005,"Michigan","Allegan County",2,79,603,260,343
050,26,005,"Michigan","Allegan County",2,80,511,230,281
050,26,005,"Michigan","Allegan County",2,81,471,207,264
050,26,005,"Michigan","Allegan County",2,82,444,195,249
050,26,005,"Michigan","Allegan County",2,83,387,163,224
050,26,005,"Michigan","Allegan County",2,84,338,150,188
050,26,005,"Michigan","Allegan County",2,85,1851,668,1183
050,26,005,"Michigan","Allegan County",3,0,1219,640,579
050,26,005,"Michigan","Allegan County",3,1,1364,684,680
050,26,005,"Michigan","Allegan County",3,2,1424,730,694
050,26,005,"Michigan","Allegan County",3,3,1451,737,714
050,26,005,"Michigan","Allegan County",3,4,1482,749,733
050,26,005,"Michigan","Allegan County",3,5,1557,790,767
050,26,005,"Michigan","Allegan County",3,6,1577,811,766
050,26,005,"Michigan","Allegan County",3,7,1594,807,787
050,26,005,"Michigan","Allegan County",3,8,1562,799,763
050,26,005,"Michigan","Allegan County",3,9,1599,827,772
050,26,005,"Michigan","Allegan County",3,10,1609,816,793
050,26,005,"Michigan","Allegan County",3,11,1667,850,817
050,26,005,"Michigan","Allegan County",3,12,1703,874,829
050,26,005,"Michigan","Allegan County",3,13,1760,929,831
050,26,005,"Michigan","Allegan County",3,14,1763,920,843
050,26,005,"Michigan","Allegan County",3,15,1762,890,872
050,26,005,"Michigan","Allegan County",3,16,1712,850,862
050,26,005,"Michigan","Allegan County",3,17,1742,888,854
050,26,005,"Michigan","Allegan County",3,18,1430,742,688
050,26,005,"Michigan","Allegan County",3,19,1146,607,539
050,26,005,"Michigan","Allegan County",3,20,1260,692,568
050,26,005,"Michigan","Allegan County",3,21,1333,696,637
050,26,005,"Michigan","Allegan County",3,22,1388,707,681
050,26,005,"Michigan","Allegan County",3,23,1349,699,650
050,26,005,"Michigan","Allegan County",3,24,1379,714,665
050,26,005,"Michigan","Allegan County",3,25,1358,698,660
050,26,005,"Michigan","Allegan County",3,26,1407,723,684
050,26,005,"Michigan","Allegan County",3,27,1425,712,713
050,26,005,"Michigan","Allegan County",3,28,1446,742,704
050,26,005,"Michigan","Allegan County",3,29,1477,752,725
050,26,005,"Michigan","Allegan County",3,30,1459,725,734
050,26,005,"Michigan","Allegan County",3,31,1564,799,765
050,26,005,"Michigan","Allegan County",3,32,1480,758,722
050,26,005,"Michigan","Allegan County",3,33,1436,725,711
050,26,005,"Michigan","Allegan County",3,34,1448,702,746
050,26,005,"Michigan","Allegan County",3,35,1522,738,784
050,26,005,"Michigan","Allegan County",3,36,1550,778,772
050,26,005,"Michigan","Allegan County",3,37,1512,771,741
050,26,005,"Michigan","Allegan County",3,38,1486,749,737
050,26,005,"Michigan","Allegan County",3,39,1513,760,753
050,26,005,"Michigan","Allegan County",3,40,1550,781,769
050,26,005,"Michigan","Allegan County",3,41,1506,777,729
050,26,005,"Michigan","Allegan County",3,42,1446,756,690
050,26,005,"Michigan","Allegan County",3,43,1433,729,704
050,26,005,"Michigan","Allegan County",3,44,1447,738,709
050,26,005,"Michigan","Allegan County",3,45,1356,690,666
050,26,005,"Michigan","Allegan County",3,46,1394,705,689
050,26,005,"Michigan","Allegan County",3,47,1353,693,660
050,26,005,"Michigan","Allegan County",3,48,1382,717,665
050,26,005,"Michigan","Allegan County",3,49,1455,766,689
050,26,005,"Michigan","Allegan County",3,50,1572,802,770
050,26,005,"Michigan","Allegan County",3,51,1594,798,796
050,26,005,"Michigan","Allegan County",3,52,1569,777,792
050,26,005,"Michigan","Allegan County",3,53,1581,779,802
050,26,005,"Michigan","Allegan County",3,54,1622,829,793
050,26,005,"Michigan","Allegan County",3,55,1580,835,745
050,26,005,"Michigan","Allegan County",3,56,1678,861,817
050,26,005,"Michigan","Allegan County",3,57,1785,919,866
050,26,005,"Michigan","Allegan County",3,58,1797,899,898
050,26,005,"Michigan","Allegan County",3,59,1781,912,869
050,26,005,"Michigan","Allegan County",3,60,1815,926,889
050,26,005,"Michigan","Allegan County",3,61,1809,904,905
050,26,005,"Michigan","Allegan County",3,62,1772,894,878
050,26,005,"Michigan","Allegan County",3,63,1772,915,857
050,26,005,"Michigan","Allegan County",3,64,1725,884,841
050,26,005,"Michigan","Allegan County",3,65,1637,816,821
050,26,005,"Michigan","Allegan County",3,66,1581,774,807
050,26,005,"Michigan","Allegan County",3,67,1472,727,745
050,26,005,"Michigan","Allegan County",3,68,1440,713,727
050,26,005,"Michigan","Allegan County",3,69,1428,710,718
050,26,005,"Michigan","Allegan County",3,70,1337,661,676
050,26,005,"Michigan","Allegan County",3,71,1221,594,627
050,26,005,"Michigan","Allegan County",3,72,1141,538,603
050,26,005,"Michigan","Allegan County",3,73,1087,532,555
050,26,005,"Michigan","Allegan County",3,74,1121,566,555
050,26,005,"Michigan","Allegan County",3,75,783,373,410
050,26,005,"Michigan","Allegan County",3,76,789,369,420
050,26,005,"Michigan","Allegan County",3,77,780,386,394
050,26,005,"Michigan","Allegan County",3,78,810,386,424
050,26,005,"Michigan","Allegan County",3,79,661,289,372
050,26,005,"Michigan","Allegan County",3,80,575,251,324
050,26,005,"Michigan","Allegan County",3,81,471,212,259
050,26,005,"Michigan","Allegan County",3,82,443,199,244
050,26,005,"Michigan","Allegan County",3,83,410,172,238
050,26,005,"Michigan","Allegan County",3,84,356,145,211
050,26,005,"Michigan","Allegan County",3,85,1836,675,1161
050,26,005,"Michigan","Allegan County",4,0,1267,679,588
050,26,005,"Michigan","Allegan County",4,1,1261,645,616
050,26,005,"Michigan","Allegan County",4,2,1393,710,683
050,26,005,"Michigan","Allegan County",4,3,1416,730,686
050,26,005,"Michigan","Allegan County",4,4,1482,738,744
050,26,005,"Michigan","Allegan County",4,5,1505,754,751
050,26,005,"Michigan","Allegan County",4,6,1542,796,746
050,26,005,"Michigan","Allegan County",4,7,1570,825,745
050,26,005,"Michigan","Allegan County",4,8,1601,808,793
050,26,005,"Michigan","Allegan County",4,9,1597,824,773
050,26,005,"Michigan","Allegan County",4,10,1626,820,806
050,26,005,"Michigan","Allegan County",4,11,1646,826,820
050,26,005,"Michigan","Allegan County",4,12,1660,856,804
050,26,005,"Michigan","Allegan County",4,13,1730,891,839
050,26,005,"Michigan","Allegan County",4,14,1751,933,818
050,26,005,"Michigan","Allegan County",4,15,1784,938,846
050,26,005,"Michigan","Allegan County",4,16,1741,887,854
050,26,005,"Michigan","Allegan County",4,17,1718,855,863
050,26,005,"Michigan","Allegan County",4,18,1469,785,684
050,26,005,"Michigan","Allegan County",4,19,1099,563,536
050,26,005,"Michigan","Allegan County",4,20,1191,631,560
050,26,005,"Michigan","Allegan County",4,21,1263,690,573
050,26,005,"Michigan","Allegan County",4,22,1403,719,684
050,26,005,"Michigan","Allegan County",4,23,1404,715,689
050,26,005,"Michigan","Allegan County",4,24,1341,681,660
050,26,005,"Michigan","Allegan County",4,25,1401,725,676
050,26,005,"Michigan","Allegan County",4,26,1348,707,641
050,26,005,"Michigan","Allegan County",4,27,1388,715,673
050,26,005,"Michigan","Allegan County",4,28,1425,718,707
050,26,005,"Michigan","Allegan County",4,29,1465,747,718
050,26,005,"Michigan","Allegan County",4,30,1496,750,746
050,26,005,"Michigan","Allegan County",4,31,1503,756,747
050,26,005,"Michigan","Allegan County",4,32,1592,802,790
050,26,005,"Michigan","Allegan County",4,33,1524,797,727
050,26,005,"Michigan","Allegan County",4,34,1445,722,723
050,26,005,"Michigan","Allegan County",4,35,1491,714,777
050,26,005,"Michigan","Allegan County",4,36,1541,748,793
050,26,005,"Michigan","Allegan County",4,37,1580,796,784
050,26,005,"Michigan","Allegan County",4,38,1516,779,737
050,26,005,"Michigan","Allegan County",4,39,1480,747,733
050,26,005,"Michigan","Allegan County",4,40,1551,803,748
050,26,005,"Michigan","Allegan County",4,41,1574,794,780
050,26,005,"Michigan","Allegan County",4,42,1501,768,733
050,26,005,"Michigan","Allegan County",4,43,1438,746,692
050,26,005,"Michigan","Allegan County",4,44,1420,721,699
050,26,005,"Michigan","Allegan County",4,45,1463,739,724
050,26,005,"Michigan","Allegan County",4,46,1348,685,663
050,26,005,"Michigan","Allegan County",4,47,1398,709,689
050,26,005,"Michigan","Allegan County",4,48,1342,683,659
050,26,005,"Michigan","Allegan County",4,49,1383,715,668
050,26,005,"Michigan","Allegan County",4,50,1462,761,701
050,26,005,"Michigan","Allegan County",4,51,1547,783,764
050,26,005,"Michigan","Allegan County",4,52,1570,783,787
050,26,005,"Michigan","Allegan County",4,53,1573,786,787
050,26,005,"Michigan","Allegan County",4,54,1579,785,794
050,26,005,"Michigan","Allegan County",4,55,1605,802,803
050,26,005,"Michigan","Allegan County",4,56,1573,831,742
050,26,005,"Michigan","Allegan County",4,57,1655,857,798
050,26,005,"Michigan","Allegan County",4,58,1786,911,875
050,26,005,"Michigan","Allegan County",4,59,1825,914,911
050,26,005,"Michigan","Allegan County",4,60,1791,917,874
050,26,005,"Michigan","Allegan County",4,61,1795,907,888
050,26,005,"Michigan","Allegan County",4,62,1772,875,897
050,26,005,"Michigan","Allegan County",4,63,1752,887,865
050,26,005,"Michigan","Allegan County",4,64,1734,890,844
050,26,005,"Michigan","Allegan County",4,65,1721,869,852
050,26,005,"Michigan","Allegan County",4,66,1596,790,806
050,26,005,"Michigan","Allegan County",4,67,1575,757,818
050,26,005,"Michigan","Allegan County",4,68,1458,714,744
050,26,005,"Michigan","Allegan County",4,69,1418,704,714
050,26,005,"Michigan","Allegan County",4,70,1414,697,717
050,26,005,"Michigan","Allegan County",4,71,1322,655,667
050,26,005,"Michigan","Allegan County",4,72,1205,578,627
050,26,005,"Michigan","Allegan County",4,73,1109,518,591
050,26,005,"Michigan","Allegan County",4,74,1064,525,539
050,26,005,"Michigan","Allegan County",4,75,1093,542,551
050,26,005,"Michigan","Allegan County",4,76,747,351,396
050,26,005,"Michigan","Allegan County",4,77,745,348,397
050,26,005,"Michigan","Allegan County",4,78,768,365,403
050,26,005,"Michigan","Allegan County",4,79,765,374,391
050,26,005,"Michigan","Allegan County",4,80,632,280,352
050,26,005,"Michigan","Allegan County",4,81,527,228,299
050,26,005,"Michigan","Allegan County",4,82,450,204,246
050,26,005,"Michigan","Allegan County",4,83,398,175,223
050,26,005,"Michigan","Allegan County",4,84,379,159,220
050,26,005,"Michigan","Allegan County",4,85,1812,672,1140
050,26,005,"Michigan","Allegan County",5,0,1245,660,585
050,26,005,"Michigan","Allegan County",5,1,1267,677,590
050,26,005,"Michigan","Allegan County",5,2,1313,676,637
050,26,005,"Michigan","Allegan County",5,3,1420,707,713
050,26,005,"Michigan","Allegan County",5,4,1435,729,706
050,26,005,"Michigan","Allegan County",5,5,1490,744,746
050,26,005,"Michigan","Allegan County",5,6,1530,758,772
050,26,005,"Michigan","Allegan County",5,7,1563,799,764
050,26,005,"Michigan","Allegan County",5,8,1562,824,738
050,26,005,"Michigan","Allegan County",5,9,1594,817,777
050,26,005,"Michigan","Allegan County",5,10,1604,833,771
050,26,005,"Michigan","Allegan County",5,11,1642,819,823
050,26,005,"Michigan","Allegan County",5,12,1655,842,813
050,26,005,"Michigan","Allegan County",5,13,1660,850,810
050,26,005,"Michigan","Allegan County",5,14,1712,900,812
050,26,005,"Michigan","Allegan County",5,15,1771,939,832
050,26,005,"Michigan","Allegan County",5,16,1762,924,838
050,26,005,"Michigan","Allegan County",5,17,1775,893,882
050,26,005,"Michigan","Allegan County",5,18,1456,760,696
050,26,005,"Michigan","Allegan County",5,19,1163,616,547
050,26,005,"Michigan","Allegan County",5,20,1200,616,584
050,26,005,"Michigan","Allegan County",5,21,1218,658,560
050,26,005,"Michigan","Allegan County",5,22,1318,718,600
050,26,005,"Michigan","Allegan County",5,23,1420,725,695
050,26,005,"Michigan","Allegan County",5,24,1390,693,697
050,26,005,"Michigan","Allegan County",5,25,1378,712,666
050,26,005,"Michigan","Allegan County",5,26,1431,739,692
050,26,005,"Michigan","Allegan County",5,27,1371,702,669
050,26,005,"Michigan","Allegan County",5,28,1426,722,704
050,26,005,"Michigan","Allegan County",5,29,1474,745,729
050,26,005,"Michigan","Allegan County",5,30,1495,758,737
050,26,005,"Michigan","Allegan County",5,31,1543,790,753
050,26,005,"Michigan","Allegan County",5,32,1558,784,774
050,26,005,"Michigan","Allegan County",5,33,1615,820,795
050,26,005,"Michigan","Allegan County",5,34,1551,804,747
050,26,005,"Michigan","Allegan County",5,35,1468,744,724
050,26,005,"Michigan","Allegan County",5,36,1460,699,761
050,26,005,"Michigan","Allegan County",5,37,1545,751,794
050,26,005,"Michigan","Allegan County",5,38,1566,803,763
050,26,005,"Michigan","Allegan County",5,39,1521,785,736
050,26,005,"Michigan","Allegan County",5,40,1483,740,743
050,26,005,"Michigan","Allegan County",5,41,1551,796,755
050,26,005,"Michigan","Allegan County",5,42,1575,796,779
050,26,005,"Michigan","Allegan County",5,43,1512,783,729
050,26,005,"Michigan","Allegan County",5,44,1429,741,688
050,26,005,"Michigan","Allegan County",5,45,1440,730,710
050,26,005,"Michigan","Allegan County",5,46,1456,743,713
050,26,005,"Michigan","Allegan County",5,47,1333,680,653
050,26,005,"Michigan","Allegan County",5,48,1396,712,684
050,26,005,"Michigan","Allegan County",5,49,1362,690,672
050,26,005,"Michigan","Allegan County",5,50,1376,710,666
050,26,005,"Michigan","Allegan County",5,51,1473,765,708
050,26,005,"Michigan","Allegan County",5,52,1558,795,763
050,26,005,"Michigan","Allegan County",5,53,1580,794,786
050,26,005,"Michigan","Allegan County",5,54,1593,795,798
050,26,005,"Michigan","Allegan County",5,55,1573,781,792
050,26,005,"Michigan","Allegan County",5,56,1603,800,803
050,26,005,"Michigan","Allegan County",5,57,1582,833,749
050,26,005,"Michigan","Allegan County",5,58,1673,861,812
050,26,005,"Michigan","Allegan County",5,59,1778,910,868
050,26,005,"Michigan","Allegan County",5,60,1814,915,899
050,26,005,"Michigan","Allegan County",5,61,1778,908,870
050,26,005,"Michigan","Allegan County",5,62,1816,917,899
050,26,005,"Michigan","Allegan County",5,63,1768,880,888
050,26,005,"Michigan","Allegan County",5,64,1745,885,860
050,26,005,"Michigan","Allegan County",5,65,1735,890,845
050,26,005,"Michigan","Allegan County",5,66,1713,859,854
050,26,005,"Michigan","Allegan County",5,67,1585,769,816
050,26,005,"Michigan","Allegan County",5,68,1537,736,801
050,26,005,"Michigan","Allegan County",5,69,1443,709,734
050,26,005,"Michigan","Allegan County",5,70,1402,690,712
050,26,005,"Michigan","Allegan County",5,71,1382,682,700
050,26,005,"Michigan","Allegan County",5,72,1294,628,666
050,26,005,"Michigan","Allegan County",5,73,1164,556,608
050,26,005,"Michigan","Allegan County",5,74,1088,513,575
050,26,005,"Michigan","Allegan County",5,75,1040,508,532
050,26,005,"Michigan","Allegan County",5,76,1070,527,543
050,26,005,"Michigan","Allegan County",5,77,713,341,372
050,26,005,"Michigan","Allegan County",5,78,728,333,395
050,26,005,"Michigan","Allegan County",5,79,719,346,373
050,26,005,"Michigan","Allegan County",5,80,736,359,377
050,26,005,"Michigan","Allegan County",5,81,594,259,335
050,26,005,"Michigan","Allegan County",5,82,513,225,288
050,26,005,"Michigan","Allegan County",5,83,421,185,236
050,26,005,"Michigan","Allegan County",5,84,369,161,208
050,26,005,"Michigan","Allegan County",5,85,1879,711,1168
050,26,007,"Michigan","Alpena County",1,0,240,124,116
050,26,007,"Michigan","Alpena County",1,1,267,138,129
050,26,007,"Michigan","Alpena County",1,2,294,148,146
050,26,007,"Michigan","Alpena County",1,3,277,134,143
050,26,007,"Michigan","Alpena County",1,4,285,144,141
050,26,007,"Michigan","Alpena County",1,5,291,141,150
050,26,007,"Michigan","Alpena County",1,6,313,156,157
050,26,007,"Michigan","Alpena County",1,7,284,160,124
050,26,007,"Michigan","Alpena County",1,8,267,134,133
050,26,007,"Michigan","Alpena County",1,9,298,150,148
050,26,007,"Michigan","Alpena County",1,10,307,162,145
050,26,007,"Michigan","Alpena County",1,11,330,181,149
050,26,007,"Michigan","Alpena County",1,12,323,171,152
050,26,007,"Michigan","Alpena County",1,13,329,164,165
050,26,007,"Michigan","Alpena County",1,14,330,167,163
050,26,007,"Michigan","Alpena County",1,15,322,155,167
050,26,007,"Michigan","Alpena County",1,16,325,162,163
050,26,007,"Michigan","Alpena County",1,17,339,172,167
050,26,007,"Michigan","Alpena County",1,18,321,183,138
050,26,007,"Michigan","Alpena County",1,19,254,136,118
050,26,007,"Michigan","Alpena County",1,20,268,138,130
050,26,007,"Michigan","Alpena County",1,21,262,144,118
050,26,007,"Michigan","Alpena County",1,22,268,139,129
050,26,007,"Michigan","Alpena County",1,23,281,143,138
050,26,007,"Michigan","Alpena County",1,24,274,153,121
050,26,007,"Michigan","Alpena County",1,25,299,155,144
050,26,007,"Michigan","Alpena County",1,26,315,165,150
050,26,007,"Michigan","Alpena County",1,27,350,183,167
050,26,007,"Michigan","Alpena County",1,28,324,170,154
050,26,007,"Michigan","Alpena County",1,29,309,150,159
050,26,007,"Michigan","Alpena County",1,30,321,171,150
050,26,007,"Michigan","Alpena County",1,31,311,164,147
050,26,007,"Michigan","Alpena County",1,32,289,146,143
050,26,007,"Michigan","Alpena County",1,33,257,136,121
050,26,007,"Michigan","Alpena County",1,34,301,165,136
050,26,007,"Michigan","Alpena County",1,35,305,181,124
050,26,007,"Michigan","Alpena County",1,36,313,156,157
050,26,007,"Michigan","Alpena County",1,37,337,167,170
050,26,007,"Michigan","Alpena County",1,38,338,167,171
050,26,007,"Michigan","Alpena County",1,39,339,180,159
050,26,007,"Michigan","Alpena County",1,40,354,194,160
050,26,007,"Michigan","Alpena County",1,41,317,160,157
050,26,007,"Michigan","Alpena County",1,42,317,164,153
050,26,007,"Michigan","Alpena County",1,43,284,143,141
050,26,007,"Michigan","Alpena County",1,44,315,150,165
050,26,007,"Michigan","Alpena County",1,45,317,165,152
050,26,007,"Michigan","Alpena County",1,46,299,159,140
050,26,007,"Michigan","Alpena County",1,47,305,154,151
050,26,007,"Michigan","Alpena County",1,48,363,178,185
050,26,007,"Michigan","Alpena County",1,49,369,180,189
050,26,007,"Michigan","Alpena County",1,50,342,165,177
050,26,007,"Michigan","Alpena County",1,51,301,142,159
050,26,007,"Michigan","Alpena County",1,52,336,163,173
050,26,007,"Michigan","Alpena County",1,53,359,171,188
050,26,007,"Michigan","Alpena County",1,54,389,195,194
050,26,007,"Michigan","Alpena County",1,55,447,225,222
050,26,007,"Michigan","Alpena County",1,56,487,236,251
050,26,007,"Michigan","Alpena County",1,57,468,218,250
050,26,007,"Michigan","Alpena County",1,58,498,240,258
050,26,007,"Michigan","Alpena County",1,59,498,247,251
050,26,007,"Michigan","Alpena County",1,60,525,271,254
050,26,007,"Michigan","Alpena County",1,61,536,272,264
050,26,007,"Michigan","Alpena County",1,62,520,260,260
050,26,007,"Michigan","Alpena County",1,63,542,271,271
050,26,007,"Michigan","Alpena County",1,64,479,226,253
050,26,007,"Michigan","Alpena County",1,65,503,253,250
050,26,007,"Michigan","Alpena County",1,66,484,250,234
050,26,007,"Michigan","Alpena County",1,67,440,206,234
050,26,007,"Michigan","Alpena County",1,68,425,207,218
050,26,007,"Michigan","Alpena County",1,69,396,198,198
050,26,007,"Michigan","Alpena County",1,70,367,179,188
050,26,007,"Michigan","Alpena County",1,71,380,186,194
050,26,007,"Michigan","Alpena County",1,72,373,187,186
050,26,007,"Michigan","Alpena County",1,73,366,181,185
050,26,007,"Michigan","Alpena County",1,74,258,124,134
050,26,007,"Michigan","Alpena County",1,75,275,135,140
050,26,007,"Michigan","Alpena County",1,76,280,138,142
050,26,007,"Michigan","Alpena County",1,77,264,131,133
050,26,007,"Michigan","Alpena County",1,78,231,102,129
050,26,007,"Michigan","Alpena County",1,79,210,87,123
050,26,007,"Michigan","Alpena County",1,80,201,86,115
050,26,007,"Michigan","Alpena County",1,81,179,81,98
050,26,007,"Michigan","Alpena County",1,82,159,67,92
050,26,007,"Michigan","Alpena County",1,83,139,62,77
050,26,007,"Michigan","Alpena County",1,84,147,62,85
050,26,007,"Michigan","Alpena County",1,85,811,276,535
050,26,007,"Michigan","Alpena County",2,0,245,119,126
050,26,007,"Michigan","Alpena County",2,1,262,136,126
050,26,007,"Michigan","Alpena County",2,2,285,143,142
050,26,007,"Michigan","Alpena County",2,3,282,138,144
050,26,007,"Michigan","Alpena County",2,4,284,142,142
050,26,007,"Michigan","Alpena County",2,5,291,141,150
050,26,007,"Michigan","Alpena County",2,6,308,152,156
050,26,007,"Michigan","Alpena County",2,7,287,158,129
050,26,007,"Michigan","Alpena County",2,8,270,139,131
050,26,007,"Michigan","Alpena County",2,9,290,147,143
050,26,007,"Michigan","Alpena County",2,10,305,160,145
050,26,007,"Michigan","Alpena County",2,11,318,173,145
050,26,007,"Michigan","Alpena County",2,12,324,174,150
050,26,007,"Michigan","Alpena County",2,13,330,166,164
050,26,007,"Michigan","Alpena County",2,14,328,166,162
050,26,007,"Michigan","Alpena County",2,15,325,158,167
050,26,007,"Michigan","Alpena County",2,16,326,160,166
050,26,007,"Michigan","Alpena County",2,17,338,172,166
050,26,007,"Michigan","Alpena County",2,18,314,177,137
050,26,007,"Michigan","Alpena County",2,19,255,139,116
050,26,007,"Michigan","Alpena County",2,20,265,137,128
050,26,007,"Michigan","Alpena County",2,21,262,143,119
050,26,007,"Michigan","Alpena County",2,22,272,143,129
050,26,007,"Michigan","Alpena County",2,23,281,145,136
050,26,007,"Michigan","Alpena County",2,24,278,152,126
050,26,007,"Michigan","Alpena County",2,25,294,157,137
050,26,007,"Michigan","Alpena County",2,26,314,165,149
050,26,007,"Michigan","Alpena County",2,27,341,179,162
050,26,007,"Michigan","Alpena County",2,28,330,173,157
050,26,007,"Michigan","Alpena County",2,29,312,154,158
050,26,007,"Michigan","Alpena County",2,30,322,168,154
050,26,007,"Michigan","Alpena County",2,31,316,168,148
050,26,007,"Michigan","Alpena County",2,32,294,150,144
050,26,007,"Michigan","Alpena County",2,33,265,139,126
050,26,007,"Michigan","Alpena County",2,34,290,158,132
050,26,007,"Michigan","Alpena County",2,35,306,177,129
050,26,007,"Michigan","Alpena County",2,36,310,161,149
050,26,007,"Michigan","Alpena County",2,37,331,165,166
050,26,007,"Michigan","Alpena County",2,38,337,166,171
050,26,007,"Michigan","Alpena County",2,39,339,178,161
050,26,007,"Michigan","Alpena County",2,40,357,195,162
050,26,007,"Michigan","Alpena County",2,41,326,167,159
050,26,007,"Michigan","Alpena County",2,42,313,162,151
050,26,007,"Michigan","Alpena County",2,43,293,149,144
050,26,007,"Michigan","Alpena County",2,44,309,150,159
050,26,007,"Michigan","Alpena County",2,45,313,160,153
050,26,007,"Michigan","Alpena County",2,46,302,159,143
050,26,007,"Michigan","Alpena County",2,47,302,154,148
050,26,007,"Michigan","Alpena County",2,48,351,174,177
050,26,007,"Michigan","Alpena County",2,49,365,179,186
050,26,007,"Michigan","Alpena County",2,50,351,170,181
050,26,007,"Michigan","Alpena County",2,51,305,144,161
050,26,007,"Michigan","Alpena County",2,52,327,158,169
050,26,007,"Michigan","Alpena County",2,53,355,169,186
050,26,007,"Michigan","Alpena County",2,54,383,190,193
050,26,007,"Michigan","Alpena County",2,55,433,216,217
050,26,007,"Michigan","Alpena County",2,56,478,233,245
050,26,007,"Michigan","Alpena County",2,57,470,221,249
050,26,007,"Michigan","Alpena County",2,58,489,233,256
050,26,007,"Michigan","Alpena County",2,59,499,245,254
050,26,007,"Michigan","Alpena County",2,60,516,264,252
050,26,007,"Michigan","Alpena County",2,61,533,274,259
050,26,007,"Michigan","Alpena County",2,62,524,263,261
050,26,007,"Michigan","Alpena County",2,63,539,268,271
050,26,007,"Michigan","Alpena County",2,64,491,234,257
050,26,007,"Michigan","Alpena County",2,65,498,248,250
050,26,007,"Michigan","Alpena County",2,66,490,252,238
050,26,007,"Michigan","Alpena County",2,67,449,216,233
050,26,007,"Michigan","Alpena County",2,68,427,206,221
050,26,007,"Michigan","Alpena County",2,69,409,204,205
050,26,007,"Michigan","Alpena County",2,70,370,182,188
050,26,007,"Michigan","Alpena County",2,71,378,185,193
050,26,007,"Michigan","Alpena County",2,72,367,181,186
050,26,007,"Michigan","Alpena County",2,73,380,188,192
050,26,007,"Michigan","Alpena County",2,74,268,128,140
050,26,007,"Michigan","Alpena County",2,75,269,130,139
050,26,007,"Michigan","Alpena County",2,76,276,135,141
050,26,007,"Michigan","Alpena County",2,77,272,133,139
050,26,007,"Michigan","Alpena County",2,78,232,105,127
050,26,007,"Michigan","Alpena County",2,79,213,89,124
050,26,007,"Michigan","Alpena County",2,80,199,83,116
050,26,007,"Michigan","Alpena County",2,81,182,83,99
050,26,007,"Michigan","Alpena County",2,82,159,68,91
050,26,007,"Michigan","Alpena County",2,83,140,61,79
050,26,007,"Michigan","Alpena County",2,84,144,63,81
050,26,007,"Michigan","Alpena County",2,85,814,272,542
050,26,007,"Michigan","Alpena County",3,0,281,154,127
050,26,007,"Michigan","Alpena County",3,1,262,123,139
050,26,007,"Michigan","Alpena County",3,2,253,135,118
050,26,007,"Michigan","Alpena County",3,3,283,147,136
050,26,007,"Michigan","Alpena County",3,4,277,137,140
050,26,007,"Michigan","Alpena County",3,5,289,142,147
050,26,007,"Michigan","Alpena County",3,6,310,148,162
050,26,007,"Michigan","Alpena County",3,7,317,159,158
050,26,007,"Michigan","Alpena County",3,8,293,160,133
050,26,007,"Michigan","Alpena County",3,9,284,148,136
050,26,007,"Michigan","Alpena County",3,10,305,155,150
050,26,007,"Michigan","Alpena County",3,11,307,161,146
050,26,007,"Michigan","Alpena County",3,12,316,171,145
050,26,007,"Michigan","Alpena County",3,13,331,177,154
050,26,007,"Michigan","Alpena County",3,14,333,166,167
050,26,007,"Michigan","Alpena County",3,15,333,172,161
050,26,007,"Michigan","Alpena County",3,16,321,157,164
050,26,007,"Michigan","Alpena County",3,17,328,161,167
050,26,007,"Michigan","Alpena County",3,18,311,170,141
050,26,007,"Michigan","Alpena County",3,19,259,143,116
050,26,007,"Michigan","Alpena County",3,20,265,139,126
050,26,007,"Michigan","Alpena County",3,21,263,139,124
050,26,007,"Michigan","Alpena County",3,22,293,162,131
050,26,007,"Michigan","Alpena County",3,23,285,146,139
050,26,007,"Michigan","Alpena County",3,24,281,139,142
050,26,007,"Michigan","Alpena County",3,25,275,151,124
050,26,007,"Michigan","Alpena County",3,26,290,153,137
050,26,007,"Michigan","Alpena County",3,27,304,160,144
050,26,007,"Michigan","Alpena County",3,28,346,182,164
050,26,007,"Michigan","Alpena County",3,29,322,170,152
050,26,007,"Michigan","Alpena County",3,30,324,159,165
050,26,007,"Michigan","Alpena County",3,31,335,169,166
050,26,007,"Michigan","Alpena County",3,32,326,177,149
050,26,007,"Michigan","Alpena County",3,33,304,155,149
050,26,007,"Michigan","Alpena County",3,34,267,138,129
050,26,007,"Michigan","Alpena County",3,35,297,163,134
050,26,007,"Michigan","Alpena County",3,36,317,183,134
050,26,007,"Michigan","Alpena County",3,37,320,169,151
050,26,007,"Michigan","Alpena County",3,38,337,169,168
050,26,007,"Michigan","Alpena County",3,39,334,168,166
050,26,007,"Michigan","Alpena County",3,40,356,193,163
050,26,007,"Michigan","Alpena County",3,41,358,185,173
050,26,007,"Michigan","Alpena County",3,42,328,173,155
050,26,007,"Michigan","Alpena County",3,43,309,162,147
050,26,007,"Michigan","Alpena County",3,44,303,154,149
050,26,007,"Michigan","Alpena County",3,45,295,146,149
050,26,007,"Michigan","Alpena County",3,46,319,159,160
050,26,007,"Michigan","Alpena County",3,47,293,155,138
050,26,007,"Michigan","Alpena County",3,48,317,163,154
050,26,007,"Michigan","Alpena County",3,49,349,175,174
050,26,007,"Michigan","Alpena County",3,50,386,188,198
050,26,007,"Michigan","Alpena County",3,51,347,167,180
050,26,007,"Michigan","Alpena County",3,52,302,141,161
050,26,007,"Michigan","Alpena County",3,53,322,158,164
050,26,007,"Michigan","Alpena County",3,54,353,170,183
050,26,007,"Michigan","Alpena County",3,55,382,185,197
050,26,007,"Michigan","Alpena County",3,56,424,212,212
050,26,007,"Michigan","Alpena County",3,57,462,227,235
050,26,007,"Michigan","Alpena County",3,58,474,227,247
050,26,007,"Michigan","Alpena County",3,59,489,229,260
050,26,007,"Michigan","Alpena County",3,60,490,242,248
050,26,007,"Michigan","Alpena County",3,61,516,261,255
050,26,007,"Michigan","Alpena County",3,62,535,270,265
050,26,007,"Michigan","Alpena County",3,63,540,276,264
050,26,007,"Michigan","Alpena County",3,64,531,262,269
050,26,007,"Michigan","Alpena County",3,65,480,233,247
050,26,007,"Michigan","Alpena County",3,66,484,241,243
050,26,007,"Michigan","Alpena County",3,67,489,252,237
050,26,007,"Michigan","Alpena County",3,68,437,214,223
050,26,007,"Michigan","Alpena County",3,69,432,205,227
050,26,007,"Michigan","Alpena County",3,70,402,198,204
050,26,007,"Michigan","Alpena County",3,71,363,175,188
050,26,007,"Michigan","Alpena County",3,72,362,176,186
050,26,007,"Michigan","Alpena County",3,73,352,168,184
050,26,007,"Michigan","Alpena County",3,74,366,175,191
050,26,007,"Michigan","Alpena County",3,75,261,123,138
050,26,007,"Michigan","Alpena County",3,76,255,124,131
050,26,007,"Michigan","Alpena County",3,77,268,131,137
050,26,007,"Michigan","Alpena County",3,78,258,120,138
050,26,007,"Michigan","Alpena County",3,79,222,99,123
050,26,007,"Michigan","Alpena County",3,80,198,79,119
050,26,007,"Michigan","Alpena County",3,81,198,79,119
050,26,007,"Michigan","Alpena County",3,82,173,86,87
050,26,007,"Michigan","Alpena County",3,83,146,64,82
050,26,007,"Michigan","Alpena County",3,84,129,60,69
050,26,007,"Michigan","Alpena County",3,85,806,276,530
050,26,007,"Michigan","Alpena County",4,0,281,134,147
050,26,007,"Michigan","Alpena County",4,1,293,149,144
050,26,007,"Michigan","Alpena County",4,2,256,119,137
050,26,007,"Michigan","Alpena County",4,3,261,140,121
050,26,007,"Michigan","Alpena County",4,4,284,146,138
050,26,007,"Michigan","Alpena County",4,5,282,138,144
050,26,007,"Michigan","Alpena County",4,6,300,149,151
050,26,007,"Michigan","Alpena County",4,7,306,152,154
050,26,007,"Michigan","Alpena County",4,8,324,158,166
050,26,007,"Michigan","Alpena County",4,9,287,152,135
050,26,007,"Michigan","Alpena County",4,10,298,152,146
050,26,007,"Michigan","Alpena County",4,11,305,156,149
050,26,007,"Michigan","Alpena County",4,12,299,156,143
050,26,007,"Michigan","Alpena County",4,13,312,164,148
050,26,007,"Michigan","Alpena County",4,14,324,175,149
050,26,007,"Michigan","Alpena County",4,15,338,170,168
050,26,007,"Michigan","Alpena County",4,16,336,171,165
050,26,007,"Michigan","Alpena County",4,17,326,160,166
050,26,007,"Michigan","Alpena County",4,18,296,160,136
050,26,007,"Michigan","Alpena County",4,19,248,136,112
050,26,007,"Michigan","Alpena County",4,20,253,132,121
050,26,007,"Michigan","Alpena County",4,21,267,136,131
050,26,007,"Michigan","Alpena County",4,22,279,141,138
050,26,007,"Michigan","Alpena County",4,23,278,168,110
050,26,007,"Michigan","Alpena County",4,24,297,152,145
050,26,007,"Michigan","Alpena County",4,25,279,143,136
050,26,007,"Michigan","Alpena County",4,26,279,145,134
050,26,007,"Michigan","Alpena County",4,27,277,142,135
050,26,007,"Michigan","Alpena County",4,28,290,154,136
050,26,007,"Michigan","Alpena County",4,29,354,182,172
050,26,007,"Michigan","Alpena County",4,30,326,171,155
050,26,007,"Michigan","Alpena County",4,31,327,163,164
050,26,007,"Michigan","Alpena County",4,32,333,160,173
050,26,007,"Michigan","Alpena County",4,33,338,181,157
050,26,007,"Michigan","Alpena County",4,34,312,161,151
050,26,007,"Michigan","Alpena County",4,35,277,144,133
050,26,007,"Michigan","Alpena County",4,36,305,170,135
050,26,007,"Michigan","Alpena County",4,37,315,184,131
050,26,007,"Michigan","Alpena County",4,38,324,168,156
050,26,007,"Michigan","Alpena County",4,39,338,168,170
050,26,007,"Michigan","Alpena County",4,40,344,177,167
050,26,007,"Michigan","Alpena County",4,41,358,189,169
050,26,007,"Michigan","Alpena County",4,42,347,179,168
050,26,007,"Michigan","Alpena County",4,43,332,177,155
050,26,007,"Michigan","Alpena County",4,44,329,165,164
050,26,007,"Michigan","Alpena County",4,45,291,152,139
050,26,007,"Michigan","Alpena County",4,46,298,148,150
050,26,007,"Michigan","Alpena County",4,47,321,161,160
050,26,007,"Michigan","Alpena County",4,48,312,163,149
050,26,007,"Michigan","Alpena County",4,49,316,161,155
050,26,007,"Michigan","Alpena County",4,50,361,185,176
050,26,007,"Michigan","Alpena County",4,51,371,182,189
050,26,007,"Michigan","Alpena County",4,52,340,161,179
050,26,007,"Michigan","Alpena County",4,53,310,150,160
050,26,007,"Michigan","Alpena County",4,54,332,166,166
050,26,007,"Michigan","Alpena County",4,55,351,166,185
050,26,007,"Michigan","Alpena County",4,56,382,184,198
050,26,007,"Michigan","Alpena County",4,57,419,210,209
050,26,007,"Michigan","Alpena County",4,58,459,230,229
050,26,007,"Michigan","Alpena County",4,59,474,223,251
050,26,007,"Michigan","Alpena County",4,60,485,227,258
050,26,007,"Michigan","Alpena County",4,61,494,250,244
050,26,007,"Michigan","Alpena County",4,62,509,256,253
050,26,007,"Michigan","Alpena County",4,63,528,262,266
050,26,007,"Michigan","Alpena County",4,64,535,273,262
050,26,007,"Michigan","Alpena County",4,65,532,266,266
050,26,007,"Michigan","Alpena County",4,66,465,223,242
050,26,007,"Michigan","Alpena County",4,67,483,236,247
050,26,007,"Michigan","Alpena County",4,68,470,246,224
050,26,007,"Michigan","Alpena County",4,69,446,214,232
050,26,007,"Michigan","Alpena County",4,70,425,201,224
050,26,007,"Michigan","Alpena County",4,71,390,192,198
050,26,007,"Michigan","Alpena County",4,72,348,169,179
050,26,007,"Michigan","Alpena County",4,73,352,167,185
050,26,007,"Michigan","Alpena County",4,74,348,165,183
050,26,007,"Michigan","Alpena County",4,75,344,170,174
050,26,007,"Michigan","Alpena County",4,76,248,112,136
050,26,007,"Michigan","Alpena County",4,77,240,117,123
050,26,007,"Michigan","Alpena County",4,78,259,126,133
050,26,007,"Michigan","Alpena County",4,79,253,115,138
050,26,007,"Michigan","Alpena County",4,80,198,85,113
050,26,007,"Michigan","Alpena County",4,81,197,77,120
050,26,007,"Michigan","Alpena County",4,82,185,79,106
050,26,007,"Michigan","Alpena County",4,83,154,81,73
050,26,007,"Michigan","Alpena County",4,84,136,62,74
050,26,007,"Michigan","Alpena County",4,85,758,267,491
050,26,007,"Michigan","Alpena County",5,0,273,130,143
050,26,007,"Michigan","Alpena County",5,1,302,144,158
050,26,007,"Michigan","Alpena County",5,2,299,155,144
050,26,007,"Michigan","Alpena County",5,3,265,124,141
050,26,007,"Michigan","Alpena County",5,4,262,147,115
050,26,007,"Michigan","Alpena County",5,5,290,148,142
050,26,007,"Michigan","Alpena County",5,6,285,137,148
050,26,007,"Michigan","Alpena County",5,7,295,147,148
050,26,007,"Michigan","Alpena County",5,8,299,147,152
050,26,007,"Michigan","Alpena County",5,9,327,161,166
050,26,007,"Michigan","Alpena County",5,10,293,156,137
050,26,007,"Michigan","Alpena County",5,11,301,153,148
050,26,007,"Michigan","Alpena County",5,12,313,161,152
050,26,007,"Michigan","Alpena County",5,13,318,165,153
050,26,007,"Michigan","Alpena County",5,14,312,170,142
050,26,007,"Michigan","Alpena County",5,15,323,176,147
050,26,007,"Michigan","Alpena County",5,16,342,172,170
050,26,007,"Michigan","Alpena County",5,17,342,172,170
050,26,007,"Michigan","Alpena County",5,18,294,158,136
050,26,007,"Michigan","Alpena County",5,19,237,122,115
050,26,007,"Michigan","Alpena County",5,20,264,138,126
050,26,007,"Michigan","Alpena County",5,21,262,130,132
050,26,007,"Michigan","Alpena County",5,22,283,142,141
050,26,007,"Michigan","Alpena County",5,23,290,149,141
050,26,007,"Michigan","Alpena County",5,24,283,164,119
050,26,007,"Michigan","Alpena County",5,25,315,163,152
050,26,007,"Michigan","Alpena County",5,26,284,139,145
050,26,007,"Michigan","Alpena County",5,27,299,157,142
050,26,007,"Michigan","Alpena County",5,28,293,148,145
050,26,007,"Michigan","Alpena County",5,29,303,154,149
050,26,007,"Michigan","Alpena County",5,30,355,184,171
050,26,007,"Michigan","Alpena County",5,31,332,175,157
050,26,007,"Michigan","Alpena County",5,32,327,157,170
050,26,007,"Michigan","Alpena County",5,33,354,170,184
050,26,007,"Michigan","Alpena County",5,34,330,175,155
050,26,007,"Michigan","Alpena County",5,35,313,156,157
050,26,007,"Michigan","Alpena County",5,36,286,150,136
050,26,007,"Michigan","Alpena County",5,37,313,167,146
050,26,007,"Michigan","Alpena County",5,38,310,176,134
050,26,007,"Michigan","Alpena County",5,39,323,165,158
050,26,007,"Michigan","Alpena County",5,40,349,178,171
050,26,007,"Michigan","Alpena County",5,41,350,172,178
050,26,007,"Michigan","Alpena County",5,42,353,188,165
050,26,007,"Michigan","Alpena County",5,43,354,189,165
050,26,007,"Michigan","Alpena County",5,44,346,183,163
050,26,007,"Michigan","Alpena County",5,45,322,168,154
050,26,007,"Michigan","Alpena County",5,46,293,151,142
050,26,007,"Michigan","Alpena County",5,47,288,139,149
050,26,007,"Michigan","Alpena County",5,48,326,165,161
050,26,007,"Michigan","Alpena County",5,49,304,161,143
050,26,007,"Michigan","Alpena County",5,50,319,163,156
050,26,007,"Michigan","Alpena County",5,51,347,173,174
050,26,007,"Michigan","Alpena County",5,52,369,179,190
050,26,007,"Michigan","Alpena County",5,53,342,166,176
050,26,007,"Michigan","Alpena County",5,54,311,152,159
050,26,007,"Michigan","Alpena County",5,55,324,156,168
050,26,007,"Michigan","Alpena County",5,56,349,164,185
050,26,007,"Michigan","Alpena County",5,57,377,178,199
050,26,007,"Michigan","Alpena County",5,58,413,211,202
050,26,007,"Michigan","Alpena County",5,59,472,230,242
050,26,007,"Michigan","Alpena County",5,60,483,231,252
050,26,007,"Michigan","Alpena County",5,61,499,238,261
050,26,007,"Michigan","Alpena County",5,62,487,244,243
050,26,007,"Michigan","Alpena County",5,63,504,249,255
050,26,007,"Michigan","Alpena County",5,64,529,265,264
050,26,007,"Michigan","Alpena County",5,65,534,276,258
050,26,007,"Michigan","Alpena County",5,66,511,249,262
050,26,007,"Michigan","Alpena County",5,67,452,217,235
050,26,007,"Michigan","Alpena County",5,68,468,230,238
050,26,007,"Michigan","Alpena County",5,69,476,248,228
050,26,007,"Michigan","Alpena County",5,70,429,207,222
050,26,007,"Michigan","Alpena County",5,71,417,199,218
050,26,007,"Michigan","Alpena County",5,72,373,185,188
050,26,007,"Michigan","Alpena County",5,73,338,165,173
050,26,007,"Michigan","Alpena County",5,74,347,157,190
050,26,007,"Michigan","Alpena County",5,75,329,157,172
050,26,007,"Michigan","Alpena County",5,76,339,166,173
050,26,007,"Michigan","Alpena County",5,77,233,105,128
050,26,007,"Michigan","Alpena County",5,78,236,111,125
050,26,007,"Michigan","Alpena County",5,79,256,123,133
050,26,007,"Michigan","Alpena County",5,80,238,106,132
050,26,007,"Michigan","Alpena County",5,81,195,81,114
050,26,007,"Michigan","Alpena County",5,82,189,78,111
050,26,007,"Michigan","Alpena County",5,83,162,73,89
050,26,007,"Michigan","Alpena County",5,84,138,78,60
050,26,007,"Michigan","Alpena County",5,85,743,269,474
050,26,009,"Michigan","Antrim County",1,0,185,95,90
050,26,009,"Michigan","Antrim County",1,1,169,84,85
050,26,009,"Michigan","Antrim County",1,2,181,94,87
050,26,009,"Michigan","Antrim County",1,3,180,88,92
050,26,009,"Michigan","Antrim County",1,4,225,104,121
050,26,009,"Michigan","Antrim County",1,5,239,120,119
050,26,009,"Michigan","Antrim County",1,6,212,107,105
050,26,009,"Michigan","Antrim County",1,7,212,111,101
050,26,009,"Michigan","Antrim County",1,8,222,126,96
050,26,009,"Michigan","Antrim County",1,9,208,104,104
050,26,009,"Michigan","Antrim County",1,10,213,113,100
050,26,009,"Michigan","Antrim County",1,11,235,128,107
050,26,009,"Michigan","Antrim County",1,12,268,145,123
050,26,009,"Michigan","Antrim County",1,13,279,140,139
050,26,009,"Michigan","Antrim County",1,14,252,119,133
050,26,009,"Michigan","Antrim County",1,15,298,138,160
050,26,009,"Michigan","Antrim County",1,16,285,140,145
050,26,009,"Michigan","Antrim County",1,17,277,140,137
050,26,009,"Michigan","Antrim County",1,18,240,121,119
050,26,009,"Michigan","Antrim County",1,19,176,90,86
050,26,009,"Michigan","Antrim County",1,20,200,107,93
050,26,009,"Michigan","Antrim County",1,21,189,102,87
050,26,009,"Michigan","Antrim County",1,22,191,94,97
050,26,009,"Michigan","Antrim County",1,23,218,115,103
050,26,009,"Michigan","Antrim County",1,24,208,115,93
050,26,009,"Michigan","Antrim County",1,25,243,120,123
050,26,009,"Michigan","Antrim County",1,26,245,133,112
050,26,009,"Michigan","Antrim County",1,27,225,124,101
050,26,009,"Michigan","Antrim County",1,28,211,111,100
050,26,009,"Michigan","Antrim County",1,29,192,109,83
050,26,009,"Michigan","Antrim County",1,30,204,100,104
050,26,009,"Michigan","Antrim County",1,31,220,102,118
050,26,009,"Michigan","Antrim County",1,32,207,99,108
050,26,009,"Michigan","Antrim County",1,33,211,107,104
050,26,009,"Michigan","Antrim County",1,34,223,119,104
050,26,009,"Michigan","Antrim County",1,35,242,129,113
050,26,009,"Michigan","Antrim County",1,36,243,120,123
050,26,009,"Michigan","Antrim County",1,37,224,116,108
050,26,009,"Michigan","Antrim County",1,38,228,119,109
050,26,009,"Michigan","Antrim County",1,39,219,105,114
050,26,009,"Michigan","Antrim County",1,40,232,119,113
050,26,009,"Michigan","Antrim County",1,41,245,124,121
050,26,009,"Michigan","Antrim County",1,42,253,132,121
050,26,009,"Michigan","Antrim County",1,43,202,113,89
050,26,009,"Michigan","Antrim County",1,44,195,107,88
050,26,009,"Michigan","Antrim County",1,45,204,103,101
050,26,009,"Michigan","Antrim County",1,46,194,100,94
050,26,009,"Michigan","Antrim County",1,47,237,121,116
050,26,009,"Michigan","Antrim County",1,48,248,119,129
050,26,009,"Michigan","Antrim County",1,49,287,147,140
050,26,009,"Michigan","Antrim County",1,50,268,145,123
050,26,009,"Michigan","Antrim County",1,51,281,136,145
050,26,009,"Michigan","Antrim County",1,52,289,131,158
050,26,009,"Michigan","Antrim County",1,53,334,157,177
050,26,009,"Michigan","Antrim County",1,54,347,175,172
050,26,009,"Michigan","Antrim County",1,55,348,170,178
050,26,009,"Michigan","Antrim County",1,56,381,188,193
050,26,009,"Michigan","Antrim County",1,57,391,185,206
050,26,009,"Michigan","Antrim County",1,58,440,221,219
050,26,009,"Michigan","Antrim County",1,59,430,227,203
050,26,009,"Michigan","Antrim County",1,60,420,202,218
050,26,009,"Michigan","Antrim County",1,61,441,219,222
050,26,009,"Michigan","Antrim County",1,62,468,234,234
050,26,009,"Michigan","Antrim County",1,63,478,232,246
050,26,009,"Michigan","Antrim County",1,64,448,216,232
050,26,009,"Michigan","Antrim County",1,65,443,227,216
050,26,009,"Michigan","Antrim County",1,66,451,233,218
050,26,009,"Michigan","Antrim County",1,67,459,236,223
050,26,009,"Michigan","Antrim County",1,68,433,216,217
050,26,009,"Michigan","Antrim County",1,69,362,178,184
050,26,009,"Michigan","Antrim County",1,70,369,186,183
050,26,009,"Michigan","Antrim County",1,71,366,185,181
050,26,009,"Michigan","Antrim County",1,72,381,183,198
050,26,009,"Michigan","Antrim County",1,73,358,172,186
050,26,009,"Michigan","Antrim County",1,74,243,113,130
050,26,009,"Michigan","Antrim County",1,75,267,130,137
050,26,009,"Michigan","Antrim County",1,76,283,145,138
050,26,009,"Michigan","Antrim County",1,77,280,142,138
050,26,009,"Michigan","Antrim County",1,78,220,112,108
050,26,009,"Michigan","Antrim County",1,79,203,101,102
050,26,009,"Michigan","Antrim County",1,80,181,91,90
050,26,009,"Michigan","Antrim County",1,81,151,73,78
050,26,009,"Michigan","Antrim County",1,82,141,68,73
050,26,009,"Michigan","Antrim County",1,83,144,70,74
050,26,009,"Michigan","Antrim County",1,84,135,59,76
050,26,009,"Michigan","Antrim County",1,85,596,233,363
050,26,009,"Michigan","Antrim County",2,0,176,87,89
050,26,009,"Michigan","Antrim County",2,1,171,85,86
050,26,009,"Michigan","Antrim County",2,2,177,90,87
050,26,009,"Michigan","Antrim County",2,3,182,91,91
050,26,009,"Michigan","Antrim County",2,4,216,101,115
050,26,009,"Michigan","Antrim County",2,5,235,115,120
050,26,009,"Michigan","Antrim County",2,6,219,112,107
050,26,009,"Michigan","Antrim County",2,7,213,110,103
050,26,009,"Michigan","Antrim County",2,8,217,121,96
050,26,009,"Michigan","Antrim County",2,9,210,108,102
050,26,009,"Michigan","Antrim County",2,10,212,111,101
050,26,009,"Michigan","Antrim County",2,11,229,124,105
050,26,009,"Michigan","Antrim County",2,12,268,144,124
050,26,009,"Michigan","Antrim County",2,13,277,140,137
050,26,009,"Michigan","Antrim County",2,14,260,124,136
050,26,009,"Michigan","Antrim County",2,15,288,135,153
050,26,009,"Michigan","Antrim County",2,16,288,139,149
050,26,009,"Michigan","Antrim County",2,17,278,139,139
050,26,009,"Michigan","Antrim County",2,18,237,121,116
050,26,009,"Michigan","Antrim County",2,19,181,94,87
050,26,009,"Michigan","Antrim County",2,20,202,106,96
050,26,009,"Michigan","Antrim County",2,21,190,103,87
050,26,009,"Michigan","Antrim County",2,22,193,97,96
050,26,009,"Michigan","Antrim County",2,23,212,111,101
050,26,009,"Michigan","Antrim County",2,24,211,115,96
050,26,009,"Michigan","Antrim County",2,25,239,120,119
050,26,009,"Michigan","Antrim County",2,26,248,132,116
050,26,009,"Michigan","Antrim County",2,27,226,122,104
050,26,009,"Michigan","Antrim County",2,28,214,116,98
050,26,009,"Michigan","Antrim County",2,29,197,110,87
050,26,009,"Michigan","Antrim County",2,30,203,103,100
050,26,009,"Michigan","Antrim County",2,31,216,103,113
050,26,009,"Michigan","Antrim County",2,32,212,101,111
050,26,009,"Michigan","Antrim County",2,33,209,105,104
050,26,009,"Michigan","Antrim County",2,34,224,121,103
050,26,009,"Michigan","Antrim County",2,35,241,127,114
050,26,009,"Michigan","Antrim County",2,36,243,123,120
050,26,009,"Michigan","Antrim County",2,37,228,116,112
050,26,009,"Michigan","Antrim County",2,38,228,119,109
050,26,009,"Michigan","Antrim County",2,39,221,108,113
050,26,009,"Michigan","Antrim County",2,40,233,118,115
050,26,009,"Michigan","Antrim County",2,41,240,121,119
050,26,009,"Michigan","Antrim County",2,42,248,130,118
050,26,009,"Michigan","Antrim County",2,43,219,119,100
050,26,009,"Michigan","Antrim County",2,44,198,107,91
050,26,009,"Michigan","Antrim County",2,45,203,106,97
050,26,009,"Michigan","Antrim County",2,46,196,102,94
050,26,009,"Michigan","Antrim County",2,47,226,115,111
050,26,009,"Michigan","Antrim County",2,48,247,120,127
050,26,009,"Michigan","Antrim County",2,49,281,143,138
050,26,009,"Michigan","Antrim County",2,50,276,148,128
050,26,009,"Michigan","Antrim County",2,51,277,138,139
050,26,009,"Michigan","Antrim County",2,52,289,133,156
050,26,009,"Michigan","Antrim County",2,53,326,152,174
050,26,009,"Michigan","Antrim County",2,54,341,169,172
050,26,009,"Michigan","Antrim County",2,55,350,170,180
050,26,009,"Michigan","Antrim County",2,56,381,187,194
050,26,009,"Michigan","Antrim County",2,57,393,188,205
050,26,009,"Michigan","Antrim County",2,58,429,211,218
050,26,009,"Michigan","Antrim County",2,59,436,228,208
050,26,009,"Michigan","Antrim County",2,60,422,210,212
050,26,009,"Michigan","Antrim County",2,61,438,217,221
050,26,009,"Michigan","Antrim County",2,62,463,230,233
050,26,009,"Michigan","Antrim County",2,63,483,236,247
050,26,009,"Michigan","Antrim County",2,64,456,221,235
050,26,009,"Michigan","Antrim County",2,65,446,226,220
050,26,009,"Michigan","Antrim County",2,66,452,233,219
050,26,009,"Michigan","Antrim County",2,67,458,235,223
050,26,009,"Michigan","Antrim County",2,68,436,218,218
050,26,009,"Michigan","Antrim County",2,69,379,188,191
050,26,009,"Michigan","Antrim County",2,70,365,181,184
050,26,009,"Michigan","Antrim County",2,71,365,183,182
050,26,009,"Michigan","Antrim County",2,72,369,179,190
050,26,009,"Michigan","Antrim County",2,73,382,183,199
050,26,009,"Michigan","Antrim County",2,74,254,119,135
050,26,009,"Michigan","Antrim County",2,75,261,125,136
050,26,009,"Michigan","Antrim County",2,76,271,138,133
050,26,009,"Michigan","Antrim County",2,77,286,146,140
050,26,009,"Michigan","Antrim County",2,78,227,116,111
050,26,009,"Michigan","Antrim County",2,79,204,102,102
050,26,009,"Michigan","Antrim County",2,80,186,93,93
050,26,009,"Michigan","Antrim County",2,81,156,77,79
050,26,009,"Michigan","Antrim County",2,82,142,69,73
050,26,009,"Michigan","Antrim County",2,83,141,68,73
050,26,009,"Michigan","Antrim County",2,84,135,61,74
050,26,009,"Michigan","Antrim County",2,85,601,234,367
050,26,009,"Michigan","Antrim County",3,0,188,87,101
050,26,009,"Michigan","Antrim County",3,1,191,89,102
050,26,009,"Michigan","Antrim County",3,2,183,90,93
050,26,009,"Michigan","Antrim County",3,3,190,100,90
050,26,009,"Michigan","Antrim County",3,4,187,100,87
050,26,009,"Michigan","Antrim County",3,5,217,101,116
050,26,009,"Michigan","Antrim County",3,6,250,124,126
050,26,009,"Michigan","Antrim County",3,7,228,117,111
050,26,009,"Michigan","Antrim County",3,8,214,114,100
050,26,009,"Michigan","Antrim County",3,9,226,123,103
050,26,009,"Michigan","Antrim County",3,10,213,111,102
050,26,009,"Michigan","Antrim County",3,11,215,110,105
050,26,009,"Michigan","Antrim County",3,12,232,124,108
050,26,009,"Michigan","Antrim County",3,13,272,149,123
050,26,009,"Michigan","Antrim County",3,14,279,140,139
050,26,009,"Michigan","Antrim County",3,15,251,122,129
050,26,009,"Michigan","Antrim County",3,16,292,135,157
050,26,009,"Michigan","Antrim County",3,17,288,138,150
050,26,009,"Michigan","Antrim County",3,18,237,133,104
050,26,009,"Michigan","Antrim County",3,19,195,94,101
050,26,009,"Michigan","Antrim County",3,20,208,94,114
050,26,009,"Michigan","Antrim County",3,21,200,104,96
050,26,009,"Michigan","Antrim County",3,22,218,113,105
050,26,009,"Michigan","Antrim County",3,23,198,107,91
050,26,009,"Michigan","Antrim County",3,24,228,121,107
050,26,009,"Michigan","Antrim County",3,25,232,120,112
050,26,009,"Michigan","Antrim County",3,26,258,130,128
050,26,009,"Michigan","Antrim County",3,27,256,140,116
050,26,009,"Michigan","Antrim County",3,28,225,122,103
050,26,009,"Michigan","Antrim County",3,29,221,126,95
050,26,009,"Michigan","Antrim County",3,30,212,119,93
050,26,009,"Michigan","Antrim County",3,31,227,115,112
050,26,009,"Michigan","Antrim County",3,32,229,114,115
050,26,009,"Michigan","Antrim County",3,33,215,97,118
050,26,009,"Michigan","Antrim County",3,34,225,117,108
050,26,009,"Michigan","Antrim County",3,35,243,126,117
050,26,009,"Michigan","Antrim County",3,36,248,132,116
050,26,009,"Michigan","Antrim County",3,37,241,119,122
050,26,009,"Michigan","Antrim County",3,38,234,118,116
050,26,009,"Michigan","Antrim County",3,39,230,121,109
050,26,009,"Michigan","Antrim County",3,40,240,118,122
050,26,009,"Michigan","Antrim County",3,41,241,124,117
050,26,009,"Michigan","Antrim County",3,42,246,127,119
050,26,009,"Michigan","Antrim County",3,43,249,129,120
050,26,009,"Michigan","Antrim County",3,44,232,122,110
050,26,009,"Michigan","Antrim County",3,45,211,108,103
050,26,009,"Michigan","Antrim County",3,46,207,112,95
050,26,009,"Michigan","Antrim County",3,47,212,109,103
050,26,009,"Michigan","Antrim County",3,48,235,117,118
050,26,009,"Michigan","Antrim County",3,49,270,135,135
050,26,009,"Michigan","Antrim County",3,50,281,149,132
050,26,009,"Michigan","Antrim County",3,51,278,151,127
050,26,009,"Michigan","Antrim County",3,52,289,147,142
050,26,009,"Michigan","Antrim County",3,53,286,132,154
050,26,009,"Michigan","Antrim County",3,54,326,149,177
050,26,009,"Michigan","Antrim County",3,55,359,171,188
050,26,009,"Michigan","Antrim County",3,56,369,183,186
050,26,009,"Michigan","Antrim County",3,57,387,195,192
050,26,009,"Michigan","Antrim County",3,58,410,187,223
050,26,009,"Michigan","Antrim County",3,59,437,217,220
050,26,009,"Michigan","Antrim County",3,60,458,239,219
050,26,009,"Michigan","Antrim County",3,61,438,212,226
050,26,009,"Michigan","Antrim County",3,62,456,218,238
050,26,009,"Michigan","Antrim County",3,63,472,239,233
050,26,009,"Michigan","Antrim County",3,64,495,236,259
050,26,009,"Michigan","Antrim County",3,65,466,224,242
050,26,009,"Michigan","Antrim County",3,66,451,229,222
050,26,009,"Michigan","Antrim County",3,67,458,236,222
050,26,009,"Michigan","Antrim County",3,68,460,229,231
050,26,009,"Michigan","Antrim County",3,69,427,217,210
050,26,009,"Michigan","Antrim County",3,70,379,189,190
050,26,009,"Michigan","Antrim County",3,71,344,175,169
050,26,009,"Michigan","Antrim County",3,72,361,181,180
050,26,009,"Michigan","Antrim County",3,73,374,176,198
050,26,009,"Michigan","Antrim County",3,74,376,181,195
050,26,009,"Michigan","Antrim County",3,75,246,116,130
050,26,009,"Michigan","Antrim County",3,76,253,124,129
050,26,009,"Michigan","Antrim County",3,77,256,131,125
050,26,009,"Michigan","Antrim County",3,78,265,132,133
050,26,009,"Michigan","Antrim County",3,79,207,102,105
050,26,009,"Michigan","Antrim County",3,80,191,97,94
050,26,009,"Michigan","Antrim County",3,81,173,87,86
050,26,009,"Michigan","Antrim County",3,82,147,69,78
050,26,009,"Michigan","Antrim County",3,83,129,60,69
050,26,009,"Michigan","Antrim County",3,84,137,68,69
050,26,009,"Michigan","Antrim County",3,85,599,234,365
050,26,009,"Michigan","Antrim County",4,0,196,98,98
050,26,009,"Michigan","Antrim County",4,1,196,96,100
050,26,009,"Michigan","Antrim County",4,2,199,93,106
050,26,009,"Michigan","Antrim County",4,3,191,90,101
050,26,009,"Michigan","Antrim County",4,4,193,99,94
050,26,009,"Michigan","Antrim County",4,5,197,100,97
050,26,009,"Michigan","Antrim County",4,6,225,112,113
050,26,009,"Michigan","Antrim County",4,7,254,122,132
050,26,009,"Michigan","Antrim County",4,8,235,123,112
050,26,009,"Michigan","Antrim County",4,9,221,119,102
050,26,009,"Michigan","Antrim County",4,10,225,125,100
050,26,009,"Michigan","Antrim County",4,11,211,108,103
050,26,009,"Michigan","Antrim County",4,12,206,110,96
050,26,009,"Michigan","Antrim County",4,13,240,126,114
050,26,009,"Michigan","Antrim County",4,14,269,145,124
050,26,009,"Michigan","Antrim County",4,15,283,139,144
050,26,009,"Michigan","Antrim County",4,16,266,129,137
050,26,009,"Michigan","Antrim County",4,17,300,141,159
050,26,009,"Michigan","Antrim County",4,18,240,120,120
050,26,009,"Michigan","Antrim County",4,19,191,111,80
050,26,009,"Michigan","Antrim County",4,20,216,104,112
050,26,009,"Michigan","Antrim County",4,21,205,103,102
050,26,009,"Michigan","Antrim County",4,22,221,116,105
050,26,009,"Michigan","Antrim County",4,23,230,126,104
050,26,009,"Michigan","Antrim County",4,24,205,113,92
050,26,009,"Michigan","Antrim County",4,25,217,119,98
050,26,009,"Michigan","Antrim County",4,26,244,125,119
050,26,009,"Michigan","Antrim County",4,27,237,114,123
050,26,009,"Michigan","Antrim County",4,28,271,145,126
050,26,009,"Michigan","Antrim County",4,29,229,124,105
050,26,009,"Michigan","Antrim County",4,30,231,124,107
050,26,009,"Michigan","Antrim County",4,31,235,127,108
050,26,009,"Michigan","Antrim County",4,32,242,119,123
050,26,009,"Michigan","Antrim County",4,33,246,119,127
050,26,009,"Michigan","Antrim County",4,34,240,115,125
050,26,009,"Michigan","Antrim County",4,35,232,116,116
050,26,009,"Michigan","Antrim County",4,36,238,121,117
050,26,009,"Michigan","Antrim County",4,37,254,135,119
050,26,009,"Michigan","Antrim County",4,38,253,128,125
050,26,009,"Michigan","Antrim County",4,39,254,133,121
050,26,009,"Michigan","Antrim County",4,40,238,125,113
050,26,009,"Michigan","Antrim County",4,41,231,106,125
050,26,009,"Michigan","Antrim County",4,42,248,134,114
050,26,009,"Michigan","Antrim County",4,43,254,128,126
050,26,009,"Michigan","Antrim County",4,44,274,139,135
050,26,009,"Michigan","Antrim County",4,45,230,124,106
050,26,009,"Michigan","Antrim County",4,46,214,109,105
050,26,009,"Michigan","Antrim County",4,47,218,116,102
050,26,009,"Michigan","Antrim County",4,48,222,111,111
050,26,009,"Michigan","Antrim County",4,49,252,138,114
050,26,009,"Michigan","Antrim County",4,50,284,139,145
050,26,009,"Michigan","Antrim County",4,51,295,150,145
050,26,009,"Michigan","Antrim County",4,52,289,157,132
050,26,009,"Michigan","Antrim County",4,53,298,158,140
050,26,009,"Michigan","Antrim County",4,54,297,138,159
050,26,009,"Michigan","Antrim County",4,55,358,163,195
050,26,009,"Michigan","Antrim County",4,56,365,177,188
050,26,009,"Michigan","Antrim County",4,57,378,194,184
050,26,009,"Michigan","Antrim County",4,58,404,207,197
050,26,009,"Michigan","Antrim County",4,59,416,191,225
050,26,009,"Michigan","Antrim County",4,60,453,226,227
050,26,009,"Michigan","Antrim County",4,61,482,257,225
050,26,009,"Michigan","Antrim County",4,62,451,212,239
050,26,009,"Michigan","Antrim County",4,63,459,219,240
050,26,009,"Michigan","Antrim County",4,64,494,251,243
050,26,009,"Michigan","Antrim County",4,65,516,241,275
050,26,009,"Michigan","Antrim County",4,66,460,221,239
050,26,009,"Michigan","Antrim County",4,67,469,236,233
050,26,009,"Michigan","Antrim County",4,68,459,236,223
050,26,009,"Michigan","Antrim County",4,69,452,228,224
050,26,009,"Michigan","Antrim County",4,70,429,218,211
050,26,009,"Michigan","Antrim County",4,71,364,186,178
050,26,009,"Michigan","Antrim County",4,72,340,179,161
050,26,009,"Michigan","Antrim County",4,73,346,173,173
050,26,009,"Michigan","Antrim County",4,74,365,174,191
050,26,009,"Michigan","Antrim County",4,75,373,183,190
050,26,009,"Michigan","Antrim County",4,76,232,109,123
050,26,009,"Michigan","Antrim County",4,77,237,117,120
050,26,009,"Michigan","Antrim County",4,78,237,123,114
050,26,009,"Michigan","Antrim County",4,79,250,121,129
050,26,009,"Michigan","Antrim County",4,80,196,98,98
050,26,009,"Michigan","Antrim County",4,81,183,93,90
050,26,009,"Michigan","Antrim County",4,82,159,82,77
050,26,009,"Michigan","Antrim County",4,83,130,60,70
050,26,009,"Michigan","Antrim County",4,84,119,57,62
050,26,009,"Michigan","Antrim County",4,85,607,252,355
050,26,009,"Michigan","Antrim County",5,0,188,94,94
050,26,009,"Michigan","Antrim County",5,1,217,107,110
050,26,009,"Michigan","Antrim County",5,2,212,110,102
050,26,009,"Michigan","Antrim County",5,3,202,99,103
050,26,009,"Michigan","Antrim County",5,4,203,99,104
050,26,009,"Michigan","Antrim County",5,5,206,101,105
050,26,009,"Michigan","Antrim County",5,6,192,99,93
050,26,009,"Michigan","Antrim County",5,7,235,117,118
050,26,009,"Michigan","Antrim County",5,8,258,124,134
050,26,009,"Michigan","Antrim County",5,9,238,119,119
050,26,009,"Michigan","Antrim County",5,10,220,118,102
050,26,009,"Michigan","Antrim County",5,11,232,129,103
050,26,009,"Michigan","Antrim County",5,12,218,111,107
050,26,009,"Michigan","Antrim County",5,13,210,115,95
050,26,009,"Michigan","Antrim County",5,14,236,119,117
050,26,009,"Michigan","Antrim County",5,15,278,151,127
050,26,009,"Michigan","Antrim County",5,16,285,142,143
050,26,009,"Michigan","Antrim County",5,17,256,123,133
050,26,009,"Michigan","Antrim County",5,18,259,125,134
050,26,009,"Michigan","Antrim County",5,19,184,89,95
050,26,009,"Michigan","Antrim County",5,20,218,115,103
050,26,009,"Michigan","Antrim County",5,21,220,106,114
050,26,009,"Michigan","Antrim County",5,22,217,109,108
050,26,009,"Michigan","Antrim County",5,23,243,128,115
050,26,009,"Michigan","Antrim County",5,24,209,108,101
050,26,009,"Michigan","Antrim County",5,25,188,103,85
050,26,009,"Michigan","Antrim County",5,26,222,114,108
050,26,009,"Michigan","Antrim County",5,27,246,119,127
050,26,009,"Michigan","Antrim County",5,28,244,116,128
050,26,009,"Michigan","Antrim County",5,29,278,141,137
050,26,009,"Michigan","Antrim County",5,30,233,123,110
050,26,009,"Michigan","Antrim County",5,31,251,136,115
050,26,009,"Michigan","Antrim County",5,32,228,122,106
050,26,009,"Michigan","Antrim County",5,33,263,130,133
050,26,009,"Michigan","Antrim County",5,34,256,131,125
050,26,009,"Michigan","Antrim County",5,35,246,114,132
050,26,009,"Michigan","Antrim County",5,36,230,120,110
050,26,009,"Michigan","Antrim County",5,37,249,127,122
050,26,009,"Michigan","Antrim County",5,38,247,135,112
050,26,009,"Michigan","Antrim County",5,39,255,127,128
050,26,009,"Michigan","Antrim County",5,40,256,133,123
050,26,009,"Michigan","Antrim County",5,41,235,120,115
050,26,009,"Michigan","Antrim County",5,42,225,107,118
050,26,009,"Michigan","Antrim County",5,43,250,137,113
050,26,009,"Michigan","Antrim County",5,44,267,132,135
050,26,009,"Michigan","Antrim County",5,45,272,147,125
050,26,009,"Michigan","Antrim County",5,46,238,131,107
050,26,009,"Michigan","Antrim County",5,47,217,114,103
050,26,009,"Michigan","Antrim County",5,48,217,115,102
050,26,009,"Michigan","Antrim County",5,49,225,113,112
050,26,009,"Michigan","Antrim County",5,50,245,131,114
050,26,009,"Michigan","Antrim County",5,51,287,139,148
050,26,009,"Michigan","Antrim County",5,52,303,151,152
050,26,009,"Michigan","Antrim County",5,53,298,160,138
050,26,009,"Michigan","Antrim County",5,54,284,148,136
050,26,009,"Michigan","Antrim County",5,55,301,145,156
050,26,009,"Michigan","Antrim County",5,56,369,171,198
050,26,009,"Michigan","Antrim County",5,57,384,186,198
050,26,009,"Michigan","Antrim County",5,58,395,201,194
050,26,009,"Michigan","Antrim County",5,59,405,212,193
050,26,009,"Michigan","Antrim County",5,60,424,197,227
050,26,009,"Michigan","Antrim County",5,61,469,231,238
050,26,009,"Michigan","Antrim County",5,62,506,266,240
050,26,009,"Michigan","Antrim County",5,63,455,218,237
050,26,009,"Michigan","Antrim County",5,64,482,226,256
050,26,009,"Michigan","Antrim County",5,65,497,255,242
050,26,009,"Michigan","Antrim County",5,66,502,240,262
050,26,009,"Michigan","Antrim County",5,67,468,224,244
050,26,009,"Michigan","Antrim County",5,68,477,242,235
050,26,009,"Michigan","Antrim County",5,69,448,233,215
050,26,009,"Michigan","Antrim County",5,70,437,222,215
050,26,009,"Michigan","Antrim County",5,71,409,212,197
050,26,009,"Michigan","Antrim County",5,72,359,188,171
050,26,009,"Michigan","Antrim County",5,73,335,175,160
050,26,009,"Michigan","Antrim County",5,74,335,170,165
050,26,009,"Michigan","Antrim County",5,75,353,170,183
050,26,009,"Michigan","Antrim County",5,76,360,178,182
050,26,009,"Michigan","Antrim County",5,77,220,99,121
050,26,009,"Michigan","Antrim County",5,78,227,113,114
050,26,009,"Michigan","Antrim County",5,79,229,117,112
050,26,009,"Michigan","Antrim County",5,80,239,111,128
050,26,009,"Michigan","Antrim County",5,81,191,96,95
050,26,009,"Michigan","Antrim County",5,82,171,90,81
050,26,009,"Michigan","Antrim County",5,83,150,77,73
050,26,009,"Michigan","Antrim County",5,84,122,56,66
050,26,009,"Michigan","Antrim County",5,85,599,261,338
050,26,011,"Michigan","Arenac County",1,0,136,68,68
050,26,011,"Michigan","Arenac County",1,1,142,75,67
050,26,011,"Michigan","Arenac County",1,2,128,68,60
050,26,011,"Michigan","Arenac County",1,3,136,70,66
050,26,011,"Michigan","Arenac County",1,4,162,77,85
050,26,011,"Michigan","Arenac County",1,5,165,85,80
050,26,011,"Michigan","Arenac County",1,6,155,82,73
050,26,011,"Michigan","Arenac County",1,7,145,76,69
050,26,011,"Michigan","Arenac County",1,8,158,84,74
050,26,011,"Michigan","Arenac County",1,9,157,85,72
050,26,011,"Michigan","Arenac County",1,10,139,76,63
050,26,011,"Michigan","Arenac County",1,11,159,86,73
050,26,011,"Michigan","Arenac County",1,12,165,91,74
050,26,011,"Michigan","Arenac County",1,13,166,90,76
050,26,011,"Michigan","Arenac County",1,14,158,71,87
050,26,011,"Michigan","Arenac County",1,15,156,76,80
050,26,011,"Michigan","Arenac County",1,16,175,82,93
050,26,011,"Michigan","Arenac County",1,17,170,93,77
050,26,011,"Michigan","Arenac County",1,18,173,94,79
050,26,011,"Michigan","Arenac County",1,19,105,53,52
050,26,011,"Michigan","Arenac County",1,20,112,62,50
050,26,011,"Michigan","Arenac County",1,21,117,62,55
050,26,011,"Michigan","Arenac County",1,22,131,70,61
050,26,011,"Michigan","Arenac County",1,23,142,70,72
050,26,011,"Michigan","Arenac County",1,24,135,70,65
050,26,011,"Michigan","Arenac County",1,25,145,81,64
050,26,011,"Michigan","Arenac County",1,26,135,70,65
050,26,011,"Michigan","Arenac County",1,27,138,70,68
050,26,011,"Michigan","Arenac County",1,28,141,76,65
050,26,011,"Michigan","Arenac County",1,29,177,93,84
050,26,011,"Michigan","Arenac County",1,30,153,79,74
050,26,011,"Michigan","Arenac County",1,31,150,73,77
050,26,011,"Michigan","Arenac County",1,32,146,62,84
050,26,011,"Michigan","Arenac County",1,33,146,72,74
050,26,011,"Michigan","Arenac County",1,34,135,69,66
050,26,011,"Michigan","Arenac County",1,35,148,74,74
050,26,011,"Michigan","Arenac County",1,36,137,65,72
050,26,011,"Michigan","Arenac County",1,37,152,74,78
050,26,011,"Michigan","Arenac County",1,38,150,70,80
050,26,011,"Michigan","Arenac County",1,39,169,82,87
050,26,011,"Michigan","Arenac County",1,40,174,98,76
050,26,011,"Michigan","Arenac County",1,41,165,93,72
050,26,011,"Michigan","Arenac County",1,42,151,75,76
050,26,011,"Michigan","Arenac County",1,43,146,72,74
050,26,011,"Michigan","Arenac County",1,44,152,75,77
050,26,011,"Michigan","Arenac County",1,45,140,67,73
050,26,011,"Michigan","Arenac County",1,46,148,81,67
050,26,011,"Michigan","Arenac County",1,47,164,90,74
050,26,011,"Michigan","Arenac County",1,48,166,87,79
050,26,011,"Michigan","Arenac County",1,49,191,98,93
050,26,011,"Michigan","Arenac County",1,50,183,95,88
050,26,011,"Michigan","Arenac County",1,51,174,86,88
050,26,011,"Michigan","Arenac County",1,52,190,90,100
050,26,011,"Michigan","Arenac County",1,53,181,89,92
050,26,011,"Michigan","Arenac County",1,54,204,105,99
050,26,011,"Michigan","Arenac County",1,55,206,99,107
050,26,011,"Michigan","Arenac County",1,56,235,117,118
050,26,011,"Michigan","Arenac County",1,57,263,127,136
050,26,011,"Michigan","Arenac County",1,58,265,130,135
050,26,011,"Michigan","Arenac County",1,59,293,147,146
050,26,011,"Michigan","Arenac County",1,60,300,156,144
050,26,011,"Michigan","Arenac County",1,61,286,154,132
050,26,011,"Michigan","Arenac County",1,62,316,175,141
050,26,011,"Michigan","Arenac County",1,63,296,150,146
050,26,011,"Michigan","Arenac County",1,64,295,159,136
050,26,011,"Michigan","Arenac County",1,65,274,144,130
050,26,011,"Michigan","Arenac County",1,66,279,153,126
050,26,011,"Michigan","Arenac County",1,67,260,145,115
050,26,011,"Michigan","Arenac County",1,68,273,146,127
050,26,011,"Michigan","Arenac County",1,69,234,117,117
050,26,011,"Michigan","Arenac County",1,70,231,118,113
050,26,011,"Michigan","Arenac County",1,71,236,120,116
050,26,011,"Michigan","Arenac County",1,72,217,116,101
050,26,011,"Michigan","Arenac County",1,73,222,120,102
050,26,011,"Michigan","Arenac County",1,74,144,70,74
050,26,011,"Michigan","Arenac County",1,75,138,65,73
050,26,011,"Michigan","Arenac County",1,76,138,68,70
050,26,011,"Michigan","Arenac County",1,77,144,72,72
050,26,011,"Michigan","Arenac County",1,78,131,68,63
050,26,011,"Michigan","Arenac County",1,79,124,61,63
050,26,011,"Michigan","Arenac County",1,80,104,51,53
050,26,011,"Michigan","Arenac County",1,81,105,53,52
050,26,011,"Michigan","Arenac County",1,82,93,49,44
050,26,011,"Michigan","Arenac County",1,83,75,41,34
050,26,011,"Michigan","Arenac County",1,84,67,32,35
050,26,011,"Michigan","Arenac County",1,85,321,134,187
050,26,011,"Michigan","Arenac County",2,0,134,70,64
050,26,011,"Michigan","Arenac County",2,1,138,73,65
050,26,011,"Michigan","Arenac County",2,2,129,68,61
050,26,011,"Michigan","Arenac County",2,3,133,70,63
050,26,011,"Michigan","Arenac County",2,4,157,75,82
050,26,011,"Michigan","Arenac County",2,5,166,84,82
050,26,011,"Michigan","Arenac County",2,6,159,84,75
050,26,011,"Michigan","Arenac County",2,7,151,80,71
050,26,011,"Michigan","Arenac County",2,8,156,83,73
050,26,011,"Michigan","Arenac County",2,9,157,85,72
050,26,011,"Michigan","Arenac County",2,10,144,78,66
050,26,011,"Michigan","Arenac County",2,11,152,84,68
050,26,011,"Michigan","Arenac County",2,12,164,90,74
050,26,011,"Michigan","Arenac County",2,13,165,90,75
050,26,011,"Michigan","Arenac County",2,14,159,76,83
050,26,011,"Michigan","Arenac County",2,15,158,74,84
050,26,011,"Michigan","Arenac County",2,16,171,81,90
050,26,011,"Michigan","Arenac County",2,17,174,92,82
050,26,011,"Michigan","Arenac County",2,18,167,90,77
050,26,011,"Michigan","Arenac County",2,19,112,58,54
050,26,011,"Michigan","Arenac County",2,20,113,61,52
050,26,011,"Michigan","Arenac County",2,21,118,63,55
050,26,011,"Michigan","Arenac County",2,22,132,69,63
050,26,011,"Michigan","Arenac County",2,23,140,71,69
050,26,011,"Michigan","Arenac County",2,24,138,71,67
050,26,011,"Michigan","Arenac County",2,25,140,77,63
050,26,011,"Michigan","Arenac County",2,26,138,72,66
050,26,011,"Michigan","Arenac County",2,27,134,69,65
050,26,011,"Michigan","Arenac County",2,28,141,74,67
050,26,011,"Michigan","Arenac County",2,29,168,89,79
050,26,011,"Michigan","Arenac County",2,30,160,82,78
050,26,011,"Michigan","Arenac County",2,31,151,76,75
050,26,011,"Michigan","Arenac County",2,32,147,63,84
050,26,011,"Michigan","Arenac County",2,33,145,70,75
050,26,011,"Michigan","Arenac County",2,34,139,70,69
050,26,011,"Michigan","Arenac County",2,35,147,74,73
050,26,011,"Michigan","Arenac County",2,36,137,66,71
050,26,011,"Michigan","Arenac County",2,37,150,73,77
050,26,011,"Michigan","Arenac County",2,38,152,71,81
050,26,011,"Michigan","Arenac County",2,39,163,79,84
050,26,011,"Michigan","Arenac County",2,40,177,95,82
050,26,011,"Michigan","Arenac County",2,41,166,94,72
050,26,011,"Michigan","Arenac County",2,42,153,78,75
050,26,011,"Michigan","Arenac County",2,43,149,73,76
050,26,011,"Michigan","Arenac County",2,44,148,74,74
050,26,011,"Michigan","Arenac County",2,45,144,70,74
050,26,011,"Michigan","Arenac County",2,46,146,78,68
050,26,011,"Michigan","Arenac County",2,47,161,88,73
050,26,011,"Michigan","Arenac County",2,48,164,86,78
050,26,011,"Michigan","Arenac County",2,49,191,98,93
050,26,011,"Michigan","Arenac County",2,50,186,95,91
050,26,011,"Michigan","Arenac County",2,51,176,88,88
050,26,011,"Michigan","Arenac County",2,52,186,88,98
050,26,011,"Michigan","Arenac County",2,53,183,90,93
050,26,011,"Michigan","Arenac County",2,54,196,99,97
050,26,011,"Michigan","Arenac County",2,55,207,101,106
050,26,011,"Michigan","Arenac County",2,56,231,115,116
050,26,011,"Michigan","Arenac County",2,57,255,124,131
050,26,011,"Michigan","Arenac County",2,58,265,130,135
050,26,011,"Michigan","Arenac County",2,59,290,146,144
050,26,011,"Michigan","Arenac County",2,60,299,153,146
050,26,011,"Michigan","Arenac County",2,61,290,156,134
050,26,011,"Michigan","Arenac County",2,62,308,168,140
050,26,011,"Michigan","Arenac County",2,63,303,156,147
050,26,011,"Michigan","Arenac County",2,64,295,158,137
050,26,011,"Michigan","Arenac County",2,65,278,147,131
050,26,011,"Michigan","Arenac County",2,66,278,151,127
050,26,011,"Michigan","Arenac County",2,67,263,146,117
050,26,011,"Michigan","Arenac County",2,68,270,145,125
050,26,011,"Michigan","Arenac County",2,69,244,125,119
050,26,011,"Michigan","Arenac County",2,70,231,118,113
050,26,011,"Michigan","Arenac County",2,71,233,119,114
050,26,011,"Michigan","Arenac County",2,72,217,115,102
050,26,011,"Michigan","Arenac County",2,73,230,123,107
050,26,011,"Michigan","Arenac County",2,74,153,77,76
050,26,011,"Michigan","Arenac County",2,75,139,66,73
050,26,011,"Michigan","Arenac County",2,76,135,66,69
050,26,011,"Michigan","Arenac County",2,77,144,72,72
050,26,011,"Michigan","Arenac County",2,78,131,67,64
050,26,011,"Michigan","Arenac County",2,79,120,60,60
050,26,011,"Michigan","Arenac County",2,80,108,52,56
050,26,011,"Michigan","Arenac County",2,81,102,51,51
050,26,011,"Michigan","Arenac County",2,82,93,50,43
050,26,011,"Michigan","Arenac County",2,83,74,41,33
050,26,011,"Michigan","Arenac County",2,84,68,33,35
050,26,011,"Michigan","Arenac County",2,85,322,135,187
050,26,011,"Michigan","Arenac County",3,0,137,67,70
050,26,011,"Michigan","Arenac County",3,1,142,76,66
050,26,011,"Michigan","Arenac County",3,2,143,72,71
050,26,011,"Michigan","Arenac County",3,3,129,69,60
050,26,011,"Michigan","Arenac County",3,4,140,71,69
050,26,011,"Michigan","Arenac County",3,5,147,70,77
050,26,011,"Michigan","Arenac County",3,6,157,83,74
050,26,011,"Michigan","Arenac County",3,7,161,90,71
050,26,011,"Michigan","Arenac County",3,8,156,77,79
050,26,011,"Michigan","Arenac County",3,9,152,83,69
050,26,011,"Michigan","Arenac County",3,10,163,90,73
050,26,011,"Michigan","Arenac County",3,11,146,75,71
050,26,011,"Michigan","Arenac County",3,12,155,86,69
050,26,011,"Michigan","Arenac County",3,13,170,89,81
050,26,011,"Michigan","Arenac County",3,14,168,86,82
050,26,011,"Michigan","Arenac County",3,15,161,77,84
050,26,011,"Michigan","Arenac County",3,16,151,69,82
050,26,011,"Michigan","Arenac County",3,17,167,81,86
050,26,011,"Michigan","Arenac County",3,18,161,83,78
050,26,011,"Michigan","Arenac County",3,19,130,70,60
050,26,011,"Michigan","Arenac County",3,20,111,61,50
050,26,011,"Michigan","Arenac County",3,21,115,62,53
050,26,011,"Michigan","Arenac County",3,22,120,63,57
050,26,011,"Michigan","Arenac County",3,23,145,74,71
050,26,011,"Michigan","Arenac County",3,24,142,74,68
050,26,011,"Michigan","Arenac County",3,25,141,76,65
050,26,011,"Michigan","Arenac County",3,26,143,76,67
050,26,011,"Michigan","Arenac County",3,27,136,73,63
050,26,011,"Michigan","Arenac County",3,28,134,73,61
050,26,011,"Michigan","Arenac County",3,29,149,78,71
050,26,011,"Michigan","Arenac County",3,30,165,89,76
050,26,011,"Michigan","Arenac County",3,31,168,84,84
050,26,011,"Michigan","Arenac County",3,32,158,82,76
050,26,011,"Michigan","Arenac County",3,33,147,62,85
050,26,011,"Michigan","Arenac County",3,34,151,69,82
050,26,011,"Michigan","Arenac County",3,35,142,70,72
050,26,011,"Michigan","Arenac County",3,36,150,79,71
050,26,011,"Michigan","Arenac County",3,37,135,66,69
050,26,011,"Michigan","Arenac County",3,38,154,73,81
050,26,011,"Michigan","Arenac County",3,39,156,78,78
050,26,011,"Michigan","Arenac County",3,40,166,78,88
050,26,011,"Michigan","Arenac County",3,41,184,102,82
050,26,011,"Michigan","Arenac County",3,42,154,85,69
050,26,011,"Michigan","Arenac County",3,43,150,77,73
050,26,011,"Michigan","Arenac County",3,44,148,71,77
050,26,011,"Michigan","Arenac County",3,45,149,81,68
050,26,011,"Michigan","Arenac County",3,46,136,65,71
050,26,011,"Michigan","Arenac County",3,47,152,80,72
050,26,011,"Michigan","Arenac County",3,48,155,79,76
050,26,011,"Michigan","Arenac County",3,49,165,86,79
050,26,011,"Michigan","Arenac County",3,50,196,102,94
050,26,011,"Michigan","Arenac County",3,51,184,97,87
050,26,011,"Michigan","Arenac County",3,52,193,98,95
050,26,011,"Michigan","Arenac County",3,53,175,86,89
050,26,011,"Michigan","Arenac County",3,54,184,90,94
050,26,011,"Michigan","Arenac County",3,55,194,99,95
050,26,011,"Michigan","Arenac County",3,56,211,102,109
050,26,011,"Michigan","Arenac County",3,57,231,120,111
050,26,011,"Michigan","Arenac County",3,58,265,131,134
050,26,011,"Michigan","Arenac County",3,59,266,131,135
050,26,011,"Michigan","Arenac County",3,60,286,145,141
050,26,011,"Michigan","Arenac County",3,61,304,151,153
050,26,011,"Michigan","Arenac County",3,62,292,153,139
050,26,011,"Michigan","Arenac County",3,63,313,174,139
050,26,011,"Michigan","Arenac County",3,64,317,164,153
050,26,011,"Michigan","Arenac County",3,65,295,158,137
050,26,011,"Michigan","Arenac County",3,66,277,143,134
050,26,011,"Michigan","Arenac County",3,67,276,151,125
050,26,011,"Michigan","Arenac County",3,68,262,151,111
050,26,011,"Michigan","Arenac County",3,69,256,134,122
050,26,011,"Michigan","Arenac County",3,70,240,123,117
050,26,011,"Michigan","Arenac County",3,71,228,116,112
050,26,011,"Michigan","Arenac County",3,72,234,122,112
050,26,011,"Michigan","Arenac County",3,73,216,112,104
050,26,011,"Michigan","Arenac County",3,74,217,116,101
050,26,011,"Michigan","Arenac County",3,75,147,75,72
050,26,011,"Michigan","Arenac County",3,76,132,62,70
050,26,011,"Michigan","Arenac County",3,77,124,62,62
050,26,011,"Michigan","Arenac County",3,78,142,68,74
050,26,011,"Michigan","Arenac County",3,79,125,64,61
050,26,011,"Michigan","Arenac County",3,80,111,55,56
050,26,011,"Michigan","Arenac County",3,81,100,47,53
050,26,011,"Michigan","Arenac County",3,82,97,48,49
050,26,011,"Michigan","Arenac County",3,83,83,46,37
050,26,011,"Michigan","Arenac County",3,84,66,38,28
050,26,011,"Michigan","Arenac County",3,85,320,134,186
050,26,011,"Michigan","Arenac County",4,0,146,79,67
050,26,011,"Michigan","Arenac County",4,1,124,66,58
050,26,011,"Michigan","Arenac County",4,2,145,77,68
050,26,011,"Michigan","Arenac County",4,3,147,78,69
050,26,011,"Michigan","Arenac County",4,4,127,70,57
050,26,011,"Michigan","Arenac County",4,5,135,64,71
050,26,011,"Michigan","Arenac County",4,6,154,75,79
050,26,011,"Michigan","Arenac County",4,7,170,91,79
050,26,011,"Michigan","Arenac County",4,8,158,86,72
050,26,011,"Michigan","Arenac County",4,9,161,77,84
050,26,011,"Michigan","Arenac County",4,10,156,86,70
050,26,011,"Michigan","Arenac County",4,11,174,95,79
050,26,011,"Michigan","Arenac County",4,12,155,79,76
050,26,011,"Michigan","Arenac County",4,13,157,86,71
050,26,011,"Michigan","Arenac County",4,14,184,99,85
050,26,011,"Michigan","Arenac County",4,15,174,87,87
050,26,011,"Michigan","Arenac County",4,16,165,78,87
050,26,011,"Michigan","Arenac County",4,17,167,80,87
050,26,011,"Michigan","Arenac County",4,18,150,78,72
050,26,011,"Michigan","Arenac County",4,19,117,61,56
050,26,011,"Michigan","Arenac County",4,20,126,68,58
050,26,011,"Michigan","Arenac County",4,21,114,63,51
050,26,011,"Michigan","Arenac County",4,22,127,66,61
050,26,011,"Michigan","Arenac County",4,23,117,65,52
050,26,011,"Michigan","Arenac County",4,24,149,77,72
050,26,011,"Michigan","Arenac County",4,25,138,72,66
050,26,011,"Michigan","Arenac County",4,26,146,76,70
050,26,011,"Michigan","Arenac County",4,27,132,73,59
050,26,011,"Michigan","Arenac County",4,28,138,69,69
050,26,011,"Michigan","Arenac County",4,29,120,66,54
050,26,011,"Michigan","Arenac County",4,30,147,67,80
050,26,011,"Michigan","Arenac County",4,31,169,91,78
050,26,011,"Michigan","Arenac County",4,32,174,85,89
050,26,011,"Michigan","Arenac County",4,33,154,81,73
050,26,011,"Michigan","Arenac County",4,34,152,65,87
050,26,011,"Michigan","Arenac County",4,35,159,75,84
050,26,011,"Michigan","Arenac County",4,36,139,70,69
050,26,011,"Michigan","Arenac County",4,37,161,81,80
050,26,011,"Michigan","Arenac County",4,38,136,64,72
050,26,011,"Michigan","Arenac County",4,39,165,79,86
050,26,011,"Michigan","Arenac County",4,40,168,89,79
050,26,011,"Michigan","Arenac County",4,41,173,82,91
050,26,011,"Michigan","Arenac County",4,42,184,105,79
050,26,011,"Michigan","Arenac County",4,43,158,85,73
050,26,011,"Michigan","Arenac County",4,44,152,76,76
050,26,011,"Michigan","Arenac County",4,45,152,73,79
050,26,011,"Michigan","Arenac County",4,46,149,79,70
050,26,011,"Michigan","Arenac County",4,47,141,66,75
050,26,011,"Michigan","Arenac County",4,48,146,79,67
050,26,011,"Michigan","Arenac County",4,49,167,83,84
050,26,011,"Michigan","Arenac County",4,50,167,87,80
050,26,011,"Michigan","Arenac County",4,51,182,101,81
050,26,011,"Michigan","Arenac County",4,52,201,107,94
050,26,011,"Michigan","Arenac County",4,53,187,99,88
050,26,011,"Michigan","Arenac County",4,54,169,79,90
050,26,011,"Michigan","Arenac County",4,55,189,90,99
050,26,011,"Michigan","Arenac County",4,56,195,101,94
050,26,011,"Michigan","Arenac County",4,57,213,102,111
050,26,011,"Michigan","Arenac County",4,58,236,120,116
050,26,011,"Michigan","Arenac County",4,59,272,137,135
050,26,011,"Michigan","Arenac County",4,60,277,135,142
050,26,011,"Michigan","Arenac County",4,61,296,152,144
050,26,011,"Michigan","Arenac County",4,62,316,154,162
050,26,011,"Michigan","Arenac County",4,63,289,147,142
050,26,011,"Michigan","Arenac County",4,64,314,177,137
050,26,011,"Michigan","Arenac County",4,65,314,160,154
050,26,011,"Michigan","Arenac County",4,66,308,162,146
050,26,011,"Michigan","Arenac County",4,67,273,134,139
050,26,011,"Michigan","Arenac County",4,68,281,157,124
050,26,011,"Michigan","Arenac County",4,69,252,150,102
050,26,011,"Michigan","Arenac County",4,70,251,129,122
050,26,011,"Michigan","Arenac County",4,71,241,124,117
050,26,011,"Michigan","Arenac County",4,72,224,117,107
050,26,011,"Michigan","Arenac County",4,73,225,114,111
050,26,011,"Michigan","Arenac County",4,74,208,107,101
050,26,011,"Michigan","Arenac County",4,75,213,115,98
050,26,011,"Michigan","Arenac County",4,76,133,66,67
050,26,011,"Michigan","Arenac County",4,77,135,62,73
050,26,011,"Michigan","Arenac County",4,78,114,56,58
050,26,011,"Michigan","Arenac County",4,79,133,66,67
050,26,011,"Michigan","Arenac County",4,80,120,60,60
050,26,011,"Michigan","Arenac County",4,81,105,51,54
050,26,011,"Michigan","Arenac County",4,82,94,44,50
050,26,011,"Michigan","Arenac County",4,83,89,46,43
050,26,011,"Michigan","Arenac County",4,84,75,41,34
050,26,011,"Michigan","Arenac County",4,85,313,146,167
050,26,011,"Michigan","Arenac County",5,0,130,71,59
050,26,011,"Michigan","Arenac County",5,1,139,77,62
050,26,011,"Michigan","Arenac County",5,2,121,66,55
050,26,011,"Michigan","Arenac County",5,3,149,81,68
050,26,011,"Michigan","Arenac County",5,4,146,80,66
050,26,011,"Michigan","Arenac County",5,5,131,75,56
050,26,011,"Michigan","Arenac County",5,6,134,66,68
050,26,011,"Michigan","Arenac County",5,7,163,80,83
050,26,011,"Michigan","Arenac County",5,8,178,98,80
050,26,011,"Michigan","Arenac County",5,9,167,87,80
050,26,011,"Michigan","Arenac County",5,10,165,86,79
050,26,011,"Michigan","Arenac County",5,11,157,84,73
050,26,011,"Michigan","Arenac County",5,12,183,98,85
050,26,011,"Michigan","Arenac County",5,13,161,84,77
050,26,011,"Michigan","Arenac County",5,14,155,86,69
050,26,011,"Michigan","Arenac County",5,15,190,102,88
050,26,011,"Michigan","Arenac County",5,16,174,86,88
050,26,011,"Michigan","Arenac County",5,17,168,78,90
050,26,011,"Michigan","Arenac County",5,18,146,71,75
050,26,011,"Michigan","Arenac County",5,19,117,60,57
050,26,011,"Michigan","Arenac County",5,20,120,58,62
050,26,011,"Michigan","Arenac County",5,21,133,70,63
050,26,011,"Michigan","Arenac County",5,22,125,65,60
050,26,011,"Michigan","Arenac County",5,23,123,63,60
050,26,011,"Michigan","Arenac County",5,24,125,65,60
050,26,011,"Michigan","Arenac County",5,25,157,82,75
050,26,011,"Michigan","Arenac County",5,26,146,70,76
050,26,011,"Michigan","Arenac County",5,27,148,80,68
050,26,011,"Michigan","Arenac County",5,28,130,71,59
050,26,011,"Michigan","Arenac County",5,29,142,72,70
050,26,011,"Michigan","Arenac County",5,30,127,69,58
050,26,011,"Michigan","Arenac County",5,31,153,73,80
050,26,011,"Michigan","Arenac County",5,32,173,94,79
050,26,011,"Michigan","Arenac County",5,33,170,86,84
050,26,011,"Michigan","Arenac County",5,34,163,86,77
050,26,011,"Michigan","Arenac County",5,35,160,65,95
050,26,011,"Michigan","Arenac County",5,36,157,79,78
050,26,011,"Michigan","Arenac County",5,37,145,71,74
050,26,011,"Michigan","Arenac County",5,38,158,78,80
050,26,011,"Michigan","Arenac County",5,39,135,58,77
050,26,011,"Michigan","Arenac County",5,40,172,82,90
050,26,011,"Michigan","Arenac County",5,41,171,89,82
050,26,011,"Michigan","Arenac County",5,42,169,82,87
050,26,011,"Michigan","Arenac County",5,43,193,109,84
050,26,011,"Michigan","Arenac County",5,44,161,87,74
050,26,011,"Michigan","Arenac County",5,45,156,79,77
050,26,011,"Michigan","Arenac County",5,46,148,70,78
050,26,011,"Michigan","Arenac County",5,47,149,80,69
050,26,011,"Michigan","Arenac County",5,48,142,68,74
050,26,011,"Michigan","Arenac County",5,49,153,80,73
050,26,011,"Michigan","Arenac County",5,50,162,77,85
050,26,011,"Michigan","Arenac County",5,51,159,86,73
050,26,011,"Michigan","Arenac County",5,52,199,115,84
050,26,011,"Michigan","Arenac County",5,53,195,102,93
050,26,011,"Michigan","Arenac County",5,54,182,91,91
050,26,011,"Michigan","Arenac County",5,55,169,79,90
050,26,011,"Michigan","Arenac County",5,56,194,90,104
050,26,011,"Michigan","Arenac County",5,57,192,98,94
050,26,011,"Michigan","Arenac County",5,58,212,105,107
050,26,011,"Michigan","Arenac County",5,59,243,126,117
050,26,011,"Michigan","Arenac County",5,60,266,138,128
050,26,011,"Michigan","Arenac County",5,61,276,139,137
050,26,011,"Michigan","Arenac County",5,62,312,154,158
050,26,011,"Michigan","Arenac County",5,63,313,157,156
050,26,011,"Michigan","Arenac County",5,64,293,147,146
050,26,011,"Michigan","Arenac County",5,65,311,174,137
050,26,011,"Michigan","Arenac County",5,66,313,158,155
050,26,011,"Michigan","Arenac County",5,67,299,157,142
050,26,011,"Michigan","Arenac County",5,68,275,139,136
050,26,011,"Michigan","Arenac County",5,69,274,154,120
050,26,011,"Michigan","Arenac County",5,70,250,145,105
050,26,011,"Michigan","Arenac County",5,71,244,127,117
050,26,011,"Michigan","Arenac County",5,72,235,122,113
050,26,011,"Michigan","Arenac County",5,73,214,109,105
050,26,011,"Michigan","Arenac County",5,74,216,110,106
050,26,011,"Michigan","Arenac County",5,75,195,100,95
050,26,011,"Michigan","Arenac County",5,76,198,106,92
050,26,011,"Michigan","Arenac County",5,77,127,63,64
050,26,011,"Michigan","Arenac County",5,78,123,55,68
050,26,011,"Michigan","Arenac County",5,79,106,52,54
050,26,011,"Michigan","Arenac County",5,80,124,58,66
050,26,011,"Michigan","Arenac County",5,81,109,55,54
050,26,011,"Michigan","Arenac County",5,82,98,48,50
050,26,011,"Michigan","Arenac County",5,83,81,41,40
050,26,011,"Michigan","Arenac County",5,84,80,39,41
050,26,011,"Michigan","Arenac County",5,85,328,163,165
050,26,013,"Michigan","Baraga County",1,0,66,34,32
050,26,013,"Michigan","Baraga County",1,1,65,34,31
050,26,013,"Michigan","Baraga County",1,2,65,41,24
050,26,013,"Michigan","Baraga County",1,3,63,31,32
050,26,013,"Michigan","Baraga County",1,4,60,24,36
050,26,013,"Michigan","Baraga County",1,5,71,27,44
050,26,013,"Michigan","Baraga County",1,6,69,31,38
050,26,013,"Michigan","Baraga County",1,7,66,34,32
050,26,013,"Michigan","Baraga County",1,8,87,49,38
050,26,013,"Michigan","Baraga County",1,9,78,32,46
050,26,013,"Michigan","Baraga County",1,10,76,33,43
050,26,013,"Michigan","Baraga County",1,11,86,47,39
050,26,013,"Michigan","Baraga County",1,12,86,45,41
050,26,013,"Michigan","Baraga County",1,13,87,45,42
050,26,013,"Michigan","Baraga County",1,14,98,50,48
050,26,013,"Michigan","Baraga County",1,15,103,49,54
050,26,013,"Michigan","Baraga County",1,16,90,43,47
050,26,013,"Michigan","Baraga County",1,17,93,46,47
050,26,013,"Michigan","Baraga County",1,18,87,50,37
050,26,013,"Michigan","Baraga County",1,19,82,52,30
050,26,013,"Michigan","Baraga County",1,20,92,59,33
050,26,013,"Michigan","Baraga County",1,21,86,52,34
050,26,013,"Michigan","Baraga County",1,22,96,61,35
050,26,013,"Michigan","Baraga County",1,23,95,63,32
050,26,013,"Michigan","Baraga County",1,24,111,70,41
050,26,013,"Michigan","Baraga County",1,25,103,72,31
050,26,013,"Michigan","Baraga County",1,26,93,67,26
050,26,013,"Michigan","Baraga County",1,27,102,66,36
050,26,013,"Michigan","Baraga County",1,28,112,76,36
050,26,013,"Michigan","Baraga County",1,29,99,64,35
050,26,013,"Michigan","Baraga County",1,30,100,74,26
050,26,013,"Michigan","Baraga County",1,31,96,74,22
050,26,013,"Michigan","Baraga County",1,32,84,52,32
050,26,013,"Michigan","Baraga County",1,33,92,60,32
050,26,013,"Michigan","Baraga County",1,34,79,46,33
050,26,013,"Michigan","Baraga County",1,35,86,52,34
050,26,013,"Michigan","Baraga County",1,36,111,76,35
050,26,013,"Michigan","Baraga County",1,37,107,71,36
050,26,013,"Michigan","Baraga County",1,38,97,58,39
050,26,013,"Michigan","Baraga County",1,39,86,52,34
050,26,013,"Michigan","Baraga County",1,40,89,57,32
050,26,013,"Michigan","Baraga County",1,41,91,56,35
050,26,013,"Michigan","Baraga County",1,42,104,67,37
050,26,013,"Michigan","Baraga County",1,43,92,58,34
050,26,013,"Michigan","Baraga County",1,44,96,60,36
050,26,013,"Michigan","Baraga County",1,45,96,54,42
050,26,013,"Michigan","Baraga County",1,46,92,53,39
050,26,013,"Michigan","Baraga County",1,47,96,52,44
050,26,013,"Michigan","Baraga County",1,48,96,44,52
050,26,013,"Michigan","Baraga County",1,49,113,60,53
050,26,013,"Michigan","Baraga County",1,50,113,60,53
050,26,013,"Michigan","Baraga County",1,51,116,58,58
050,26,013,"Michigan","Baraga County",1,52,112,57,55
050,26,013,"Michigan","Baraga County",1,53,111,57,54
050,26,013,"Michigan","Baraga County",1,54,113,60,53
050,26,013,"Michigan","Baraga County",1,55,121,60,61
050,26,013,"Michigan","Baraga County",1,56,118,62,56
050,26,013,"Michigan","Baraga County",1,57,128,78,50
050,26,013,"Michigan","Baraga County",1,58,132,70,62
050,26,013,"Michigan","Baraga County",1,59,132,67,65
050,26,013,"Michigan","Baraga County",1,60,127,67,60
050,26,013,"Michigan","Baraga County",1,61,124,72,52
050,26,013,"Michigan","Baraga County",1,62,126,63,63
050,26,013,"Michigan","Baraga County",1,63,128,59,69
050,26,013,"Michigan","Baraga County",1,64,125,66,59
050,26,013,"Michigan","Baraga County",1,65,129,71,58
050,26,013,"Michigan","Baraga County",1,66,129,67,62
050,26,013,"Michigan","Baraga County",1,67,140,71,69
050,26,013,"Michigan","Baraga County",1,68,130,68,62
050,26,013,"Michigan","Baraga County",1,69,115,59,56
050,26,013,"Michigan","Baraga County",1,70,105,54,51
050,26,013,"Michigan","Baraga County",1,71,104,57,47
050,26,013,"Michigan","Baraga County",1,72,97,52,45
050,26,013,"Michigan","Baraga County",1,73,113,58,55
050,26,013,"Michigan","Baraga County",1,74,70,36,34
050,26,013,"Michigan","Baraga County",1,75,61,29,32
050,26,013,"Michigan","Baraga County",1,76,74,36,38
050,26,013,"Michigan","Baraga County",1,77,79,39,40
050,26,013,"Michigan","Baraga County",1,78,68,36,32
050,26,013,"Michigan","Baraga County",1,79,62,30,32
050,26,013,"Michigan","Baraga County",1,80,48,25,23
050,26,013,"Michigan","Baraga County",1,81,52,18,34
050,26,013,"Michigan","Baraga County",1,82,39,18,21
050,26,013,"Michigan","Baraga County",1,83,35,15,20
050,26,013,"Michigan","Baraga County",1,84,34,15,19
050,26,013,"Michigan","Baraga County",1,85,172,76,96
050,26,013,"Michigan","Baraga County",2,0,68,31,37
050,26,013,"Michigan","Baraga County",2,1,67,35,32
050,26,013,"Michigan","Baraga County",2,2,65,39,26
050,26,013,"Michigan","Baraga County",2,3,62,33,29
050,26,013,"Michigan","Baraga County",2,4,62,26,36
050,26,013,"Michigan","Baraga County",2,5,68,27,41
050,26,013,"Michigan","Baraga County",2,6,71,31,40
050,26,013,"Michigan","Baraga County",2,7,65,32,33
050,26,013,"Michigan","Baraga County",2,8,82,45,37
050,26,013,"Michigan","Baraga County",2,9,81,36,45
050,26,013,"Michigan","Baraga County",2,10,77,33,44
050,26,013,"Michigan","Baraga County",2,11,82,43,39
050,26,013,"Michigan","Baraga County",2,12,86,45,41
050,26,013,"Michigan","Baraga County",2,13,87,44,43
050,26,013,"Michigan","Baraga County",2,14,95,49,46
050,26,013,"Michigan","Baraga County",2,15,103,50,53
050,26,013,"Michigan","Baraga County",2,16,95,45,50
050,26,013,"Michigan","Baraga County",2,17,90,45,45
050,26,013,"Michigan","Baraga County",2,18,86,48,38
050,26,013,"Michigan","Baraga County",2,19,81,51,30
050,26,013,"Michigan","Baraga County",2,20,90,57,33
050,26,013,"Michigan","Baraga County",2,21,86,54,32
050,26,013,"Michigan","Baraga County",2,22,95,61,34
050,26,013,"Michigan","Baraga County",2,23,98,65,33
050,26,013,"Michigan","Baraga County",2,24,107,70,37
050,26,013,"Michigan","Baraga County",2,25,104,72,32
050,26,013,"Michigan","Baraga County",2,26,93,66,27
050,26,013,"Michigan","Baraga County",2,27,101,67,34
050,26,013,"Michigan","Baraga County",2,28,111,75,36
050,26,013,"Michigan","Baraga County",2,29,101,66,35
050,26,013,"Michigan","Baraga County",2,30,99,72,27
050,26,013,"Michigan","Baraga County",2,31,100,76,24
050,26,013,"Michigan","Baraga County",2,32,83,53,30
050,26,013,"Michigan","Baraga County",2,33,91,58,33
050,26,013,"Michigan","Baraga County",2,34,81,49,32
050,26,013,"Michigan","Baraga County",2,35,85,51,34
050,26,013,"Michigan","Baraga County",2,36,108,74,34
050,26,013,"Michigan","Baraga County",2,37,105,69,36
050,26,013,"Michigan","Baraga County",2,38,98,60,38
050,26,013,"Michigan","Baraga County",2,39,86,51,35
050,26,013,"Michigan","Baraga County",2,40,91,58,33
050,26,013,"Michigan","Baraga County",2,41,90,56,34
050,26,013,"Michigan","Baraga County",2,42,100,65,35
050,26,013,"Michigan","Baraga County",2,43,95,60,35
050,26,013,"Michigan","Baraga County",2,44,95,61,34
050,26,013,"Michigan","Baraga County",2,45,98,56,42
050,26,013,"Michigan","Baraga County",2,46,91,52,39
050,26,013,"Michigan","Baraga County",2,47,95,53,42
050,26,013,"Michigan","Baraga County",2,48,94,44,50
050,26,013,"Michigan","Baraga County",2,49,111,58,53
050,26,013,"Michigan","Baraga County",2,50,113,60,53
050,26,013,"Michigan","Baraga County",2,51,113,57,56
050,26,013,"Michigan","Baraga County",2,52,113,57,56
050,26,013,"Michigan","Baraga County",2,53,110,56,54
050,26,013,"Michigan","Baraga County",2,54,112,58,54
050,26,013,"Michigan","Baraga County",2,55,119,60,59
050,26,013,"Michigan","Baraga County",2,56,119,63,56
050,26,013,"Michigan","Baraga County",2,57,128,75,53
050,26,013,"Michigan","Baraga County",2,58,131,72,59
050,26,013,"Michigan","Baraga County",2,59,134,69,65
050,26,013,"Michigan","Baraga County",2,60,127,67,60
050,26,013,"Michigan","Baraga County",2,61,123,69,54
050,26,013,"Michigan","Baraga County",2,62,125,64,61
050,26,013,"Michigan","Baraga County",2,63,130,61,69
050,26,013,"Michigan","Baraga County",2,64,125,64,61
050,26,013,"Michigan","Baraga County",2,65,129,71,58
050,26,013,"Michigan","Baraga County",2,66,128,68,60
050,26,013,"Michigan","Baraga County",2,67,137,70,67
050,26,013,"Michigan","Baraga County",2,68,132,69,63
050,26,013,"Michigan","Baraga County",2,69,118,61,57
050,26,013,"Michigan","Baraga County",2,70,107,56,51
050,26,013,"Michigan","Baraga County",2,71,105,57,48
050,26,013,"Michigan","Baraga County",2,72,97,52,45
050,26,013,"Michigan","Baraga County",2,73,113,59,54
050,26,013,"Michigan","Baraga County",2,74,74,38,36
050,26,013,"Michigan","Baraga County",2,75,64,31,33
050,26,013,"Michigan","Baraga County",2,76,70,34,36
050,26,013,"Michigan","Baraga County",2,77,79,38,41
050,26,013,"Michigan","Baraga County",2,78,69,36,33
050,26,013,"Michigan","Baraga County",2,79,63,30,33
050,26,013,"Michigan","Baraga County",2,80,50,25,25
050,26,013,"Michigan","Baraga County",2,81,51,20,31
050,26,013,"Michigan","Baraga County",2,82,40,16,24
050,26,013,"Michigan","Baraga County",2,83,36,15,21
050,26,013,"Michigan","Baraga County",2,84,34,14,20
050,26,013,"Michigan","Baraga County",2,85,169,74,95
050,26,013,"Michigan","Baraga County",3,0,86,41,45
050,26,013,"Michigan","Baraga County",3,1,66,28,38
050,26,013,"Michigan","Baraga County",3,2,68,37,31
050,26,013,"Michigan","Baraga County",3,3,74,44,30
050,26,013,"Michigan","Baraga County",3,4,67,37,30
050,26,013,"Michigan","Baraga County",3,5,67,31,36
050,26,013,"Michigan","Baraga County",3,6,75,31,44
050,26,013,"Michigan","Baraga County",3,7,74,32,42
050,26,013,"Michigan","Baraga County",3,8,72,37,35
050,26,013,"Michigan","Baraga County",3,9,80,42,38
050,26,013,"Michigan","Baraga County",3,10,81,38,43
050,26,013,"Michigan","Baraga County",3,11,77,34,43
050,26,013,"Michigan","Baraga County",3,12,80,42,38
050,26,013,"Michigan","Baraga County",3,13,91,49,42
050,26,013,"Michigan","Baraga County",3,14,87,44,43
050,26,013,"Michigan","Baraga County",3,15,100,49,51
050,26,013,"Michigan","Baraga County",3,16,112,55,57
050,26,013,"Michigan","Baraga County",3,17,97,47,50
050,26,013,"Michigan","Baraga County",3,18,83,44,39
050,26,013,"Michigan","Baraga County",3,19,79,47,32
050,26,013,"Michigan","Baraga County",3,20,83,54,29
050,26,013,"Michigan","Baraga County",3,21,90,60,30
050,26,013,"Michigan","Baraga County",3,22,99,65,34
050,26,013,"Michigan","Baraga County",3,23,111,68,43
050,26,013,"Michigan","Baraga County",3,24,109,75,34
050,26,013,"Michigan","Baraga County",3,25,112,71,41
050,26,013,"Michigan","Baraga County",3,26,98,66,32
050,26,013,"Michigan","Baraga County",3,27,103,71,32
050,26,013,"Michigan","Baraga County",3,28,106,72,34
050,26,013,"Michigan","Baraga County",3,29,117,80,37
050,26,013,"Michigan","Baraga County",3,30,103,66,37
050,26,013,"Michigan","Baraga County",3,31,117,85,32
050,26,013,"Michigan","Baraga County",3,32,89,62,27
050,26,013,"Michigan","Baraga County",3,33,90,59,31
050,26,013,"Michigan","Baraga County",3,34,91,56,35
050,26,013,"Michigan","Baraga County",3,35,90,55,35
050,26,013,"Michigan","Baraga County",3,36,106,70,36
050,26,013,"Michigan","Baraga County",3,37,103,67,36
050,26,013,"Michigan","Baraga County",3,38,108,72,36
050,26,013,"Michigan","Baraga County",3,39,88,50,38
050,26,013,"Michigan","Baraga County",3,40,90,56,34
050,26,013,"Michigan","Baraga County",3,41,90,57,33
050,26,013,"Michigan","Baraga County",3,42,97,63,34
050,26,013,"Michigan","Baraga County",3,43,99,61,38
050,26,013,"Michigan","Baraga County",3,44,98,61,37
050,26,013,"Michigan","Baraga County",3,45,97,62,35
050,26,013,"Michigan","Baraga County",3,46,90,49,41
050,26,013,"Michigan","Baraga County",3,47,96,57,39
050,26,013,"Michigan","Baraga County",3,48,84,43,41
050,26,013,"Michigan","Baraga County",3,49,97,49,48
050,26,013,"Michigan","Baraga County",3,50,126,65,61
050,26,013,"Michigan","Baraga County",3,51,110,55,55
050,26,013,"Michigan","Baraga County",3,52,120,61,59
050,26,013,"Michigan","Baraga County",3,53,107,53,54
050,26,013,"Michigan","Baraga County",3,54,112,56,56
050,26,013,"Michigan","Baraga County",3,55,111,57,54
050,26,013,"Michigan","Baraga County",3,56,122,62,60
050,26,013,"Michigan","Baraga County",3,57,124,66,58
050,26,013,"Michigan","Baraga County",3,58,131,74,57
050,26,013,"Michigan","Baraga County",3,59,130,73,57
050,26,013,"Michigan","Baraga County",3,60,135,68,67
050,26,013,"Michigan","Baraga County",3,61,130,68,62
050,26,013,"Michigan","Baraga County",3,62,119,67,52
050,26,013,"Michigan","Baraga County",3,63,129,66,63
050,26,013,"Michigan","Baraga County",3,64,125,60,65
050,26,013,"Michigan","Baraga County",3,65,121,61,60
050,26,013,"Michigan","Baraga County",3,66,121,68,53
050,26,013,"Michigan","Baraga County",3,67,128,68,60
050,26,013,"Michigan","Baraga County",3,68,140,71,69
050,26,013,"Michigan","Baraga County",3,69,134,71,63
050,26,013,"Michigan","Baraga County",3,70,109,57,52
050,26,013,"Michigan","Baraga County",3,71,104,55,49
050,26,013,"Michigan","Baraga County",3,72,104,57,47
050,26,013,"Michigan","Baraga County",3,73,96,51,45
050,26,013,"Michigan","Baraga County",3,74,107,56,51
050,26,013,"Michigan","Baraga County",3,75,72,36,36
050,26,013,"Michigan","Baraga County",3,76,57,27,30
050,26,013,"Michigan","Baraga County",3,77,62,28,34
050,26,013,"Michigan","Baraga County",3,78,72,32,40
050,26,013,"Michigan","Baraga County",3,79,67,33,34
050,26,013,"Michigan","Baraga County",3,80,53,27,26
050,26,013,"Michigan","Baraga County",3,81,51,26,25
050,26,013,"Michigan","Baraga County",3,82,51,19,32
050,26,013,"Michigan","Baraga County",3,83,34,13,21
050,26,013,"Michigan","Baraga County",3,84,34,12,22
050,26,013,"Michigan","Baraga County",3,85,171,69,102
050,26,013,"Michigan","Baraga County",4,0,82,38,44
050,26,013,"Michigan","Baraga County",4,1,93,40,53
050,26,013,"Michigan","Baraga County",4,2,68,31,37
050,26,013,"Michigan","Baraga County",4,3,70,38,32
050,26,013,"Michigan","Baraga County",4,4,82,53,29
050,26,013,"Michigan","Baraga County",4,5,58,28,30
050,26,013,"Michigan","Baraga County",4,6,75,39,36
050,26,013,"Michigan","Baraga County",4,7,78,35,43
050,26,013,"Michigan","Baraga County",4,8,79,38,41
050,26,013,"Michigan","Baraga County",4,9,72,36,36
050,26,013,"Michigan","Baraga County",4,10,79,43,36
050,26,013,"Michigan","Baraga County",4,11,77,33,44
050,26,013,"Michigan","Baraga County",4,12,80,33,47
050,26,013,"Michigan","Baraga County",4,13,86,47,39
050,26,013,"Michigan","Baraga County",4,14,87,47,40
050,26,013,"Michigan","Baraga County",4,15,89,42,47
050,26,013,"Michigan","Baraga County",4,16,98,49,49
050,26,013,"Michigan","Baraga County",4,17,111,55,56
050,26,013,"Michigan","Baraga County",4,18,84,44,40
050,26,013,"Michigan","Baraga County",4,19,73,41,32
050,26,013,"Michigan","Baraga County",4,20,88,56,32
050,26,013,"Michigan","Baraga County",4,21,78,52,26
050,26,013,"Michigan","Baraga County",4,22,105,68,37
050,26,013,"Michigan","Baraga County",4,23,106,75,31
050,26,013,"Michigan","Baraga County",4,24,111,76,35
050,26,013,"Michigan","Baraga County",4,25,105,72,33
050,26,013,"Michigan","Baraga County",4,26,102,56,46
050,26,013,"Michigan","Baraga County",4,27,102,68,34
050,26,013,"Michigan","Baraga County",4,28,102,71,31
050,26,013,"Michigan","Baraga County",4,29,111,73,38
050,26,013,"Michigan","Baraga County",4,30,120,81,39
050,26,013,"Michigan","Baraga County",4,31,113,74,39
050,26,013,"Michigan","Baraga County",4,32,108,75,33
050,26,013,"Michigan","Baraga County",4,33,86,62,24
050,26,013,"Michigan","Baraga County",4,34,91,61,30
050,26,013,"Michigan","Baraga County",4,35,91,55,36
050,26,013,"Michigan","Baraga County",4,36,108,71,37
050,26,013,"Michigan","Baraga County",4,37,96,64,32
050,26,013,"Michigan","Baraga County",4,38,97,63,34
050,26,013,"Michigan","Baraga County",4,39,100,62,38
050,26,013,"Michigan","Baraga County",4,40,93,54,39
050,26,013,"Michigan","Baraga County",4,41,86,51,35
050,26,013,"Michigan","Baraga County",4,42,93,60,33
050,26,013,"Michigan","Baraga County",4,43,93,58,35
050,26,013,"Michigan","Baraga County",4,44,99,62,37
050,26,013,"Michigan","Baraga County",4,45,97,61,36
050,26,013,"Michigan","Baraga County",4,46,95,58,37
050,26,013,"Michigan","Baraga County",4,47,94,50,44
050,26,013,"Michigan","Baraga County",4,48,86,47,39
050,26,013,"Michigan","Baraga County",4,49,92,51,41
050,26,013,"Michigan","Baraga County",4,50,102,55,47
050,26,013,"Michigan","Baraga County",4,51,116,55,61
050,26,013,"Michigan","Baraga County",4,52,111,57,54
050,26,013,"Michigan","Baraga County",4,53,118,58,60
050,26,013,"Michigan","Baraga County",4,54,108,54,54
050,26,013,"Michigan","Baraga County",4,55,113,53,60
050,26,013,"Michigan","Baraga County",4,56,110,56,54
050,26,013,"Michigan","Baraga County",4,57,123,62,61
050,26,013,"Michigan","Baraga County",4,58,127,66,61
050,26,013,"Michigan","Baraga County",4,59,138,80,58
050,26,013,"Michigan","Baraga County",4,60,131,71,60
050,26,013,"Michigan","Baraga County",4,61,135,67,68
050,26,013,"Michigan","Baraga County",4,62,126,65,61
050,26,013,"Michigan","Baraga County",4,63,126,67,59
050,26,013,"Michigan","Baraga County",4,64,131,69,62
050,26,013,"Michigan","Baraga County",4,65,118,58,60
050,26,013,"Michigan","Baraga County",4,66,123,61,62
050,26,013,"Michigan","Baraga County",4,67,115,60,55
050,26,013,"Michigan","Baraga County",4,68,124,64,60
050,26,013,"Michigan","Baraga County",4,69,136,70,66
050,26,013,"Michigan","Baraga County",4,70,131,69,62
050,26,013,"Michigan","Baraga County",4,71,107,58,49
050,26,013,"Michigan","Baraga County",4,72,98,52,46
050,26,013,"Michigan","Baraga County",4,73,101,53,48
050,26,013,"Michigan","Baraga County",4,74,85,46,39
050,26,013,"Michigan","Baraga County",4,75,102,53,49
050,26,013,"Michigan","Baraga County",4,76,68,34,34
050,26,013,"Michigan","Baraga County",4,77,52,24,28
050,26,013,"Michigan","Baraga County",4,78,57,24,33
050,26,013,"Michigan","Baraga County",4,79,69,31,38
050,26,013,"Michigan","Baraga County",4,80,59,31,28
050,26,013,"Michigan","Baraga County",4,81,52,28,24
050,26,013,"Michigan","Baraga County",4,82,45,20,25
050,26,013,"Michigan","Baraga County",4,83,43,16,27
050,26,013,"Michigan","Baraga County",4,84,31,10,21
050,26,013,"Michigan","Baraga County",4,85,183,70,113
050,26,013,"Michigan","Baraga County",5,0,68,31,37
050,26,013,"Michigan","Baraga County",5,1,87,38,49
050,26,013,"Michigan","Baraga County",5,2,94,41,53
050,26,013,"Michigan","Baraga County",5,3,71,33,38
050,26,013,"Michigan","Baraga County",5,4,71,37,34
050,26,013,"Michigan","Baraga County",5,5,83,50,33
050,26,013,"Michigan","Baraga County",5,6,65,32,33
050,26,013,"Michigan","Baraga County",5,7,75,38,37
050,26,013,"Michigan","Baraga County",5,8,79,40,39
050,26,013,"Michigan","Baraga County",5,9,78,33,45
050,26,013,"Michigan","Baraga County",5,10,74,38,36
050,26,013,"Michigan","Baraga County",5,11,77,42,35
050,26,013,"Michigan","Baraga County",5,12,76,33,43
050,26,013,"Michigan","Baraga County",5,13,80,33,47
050,26,013,"Michigan","Baraga County",5,14,81,42,39
050,26,013,"Michigan","Baraga County",5,15,89,48,41
050,26,013,"Michigan","Baraga County",5,16,88,42,46
050,26,013,"Michigan","Baraga County",5,17,98,51,47
050,26,013,"Michigan","Baraga County",5,18,97,54,43
050,26,013,"Michigan","Baraga County",5,19,80,46,34
050,26,013,"Michigan","Baraga County",5,20,83,48,35
050,26,013,"Michigan","Baraga County",5,21,86,54,32
050,26,013,"Michigan","Baraga County",5,22,89,61,28
050,26,013,"Michigan","Baraga County",5,23,111,71,40
050,26,013,"Michigan","Baraga County",5,24,116,84,32
050,26,013,"Michigan","Baraga County",5,25,116,76,40
050,26,013,"Michigan","Baraga County",5,26,103,66,37
050,26,013,"Michigan","Baraga County",5,27,107,60,47
050,26,013,"Michigan","Baraga County",5,28,112,76,36
050,26,013,"Michigan","Baraga County",5,29,103,72,31
050,26,013,"Michigan","Baraga County",5,30,104,68,36
050,26,013,"Michigan","Baraga County",5,31,123,89,34
050,26,013,"Michigan","Baraga County",5,32,95,57,38
050,26,013,"Michigan","Baraga County",5,33,114,82,32
050,26,013,"Michigan","Baraga County",5,34,88,60,28
050,26,013,"Michigan","Baraga County",5,35,92,62,30
050,26,013,"Michigan","Baraga County",5,36,112,74,38
050,26,013,"Michigan","Baraga County",5,37,101,67,34
050,26,013,"Michigan","Baraga County",5,38,89,58,31
050,26,013,"Michigan","Baraga County",5,39,86,53,33
050,26,013,"Michigan","Baraga County",5,40,98,62,36
050,26,013,"Michigan","Baraga County",5,41,89,49,40
050,26,013,"Michigan","Baraga County",5,42,96,57,39
050,26,013,"Michigan","Baraga County",5,43,96,58,38
050,26,013,"Michigan","Baraga County",5,44,95,61,34
050,26,013,"Michigan","Baraga County",5,45,103,64,39
050,26,013,"Michigan","Baraga County",5,46,90,56,34
050,26,013,"Michigan","Baraga County",5,47,101,64,37
050,26,013,"Michigan","Baraga County",5,48,87,39,48
050,26,013,"Michigan","Baraga County",5,49,95,55,40
050,26,013,"Michigan","Baraga County",5,50,100,56,44
050,26,013,"Michigan","Baraga County",5,51,99,52,47
050,26,013,"Michigan","Baraga County",5,52,122,58,64
050,26,013,"Michigan","Baraga County",5,53,107,51,56
050,26,013,"Michigan","Baraga County",5,54,114,55,59
050,26,013,"Michigan","Baraga County",5,55,105,52,53
050,26,013,"Michigan","Baraga County",5,56,119,52,67
050,26,013,"Michigan","Baraga County",5,57,107,55,52
050,26,013,"Michigan","Baraga County",5,58,125,64,61
050,26,013,"Michigan","Baraga County",5,59,127,66,61
050,26,013,"Michigan","Baraga County",5,60,136,82,54
050,26,013,"Michigan","Baraga County",5,61,130,70,60
050,26,013,"Michigan","Baraga County",5,62,136,71,65
050,26,013,"Michigan","Baraga County",5,63,127,68,59
050,26,013,"Michigan","Baraga County",5,64,126,67,59
050,26,013,"Michigan","Baraga County",5,65,128,69,59
050,26,013,"Michigan","Baraga County",5,66,112,53,59
050,26,013,"Michigan","Baraga County",5,67,122,59,63
050,26,013,"Michigan","Baraga County",5,68,117,60,57
050,26,013,"Michigan","Baraga County",5,69,126,63,63
050,26,013,"Michigan","Baraga County",5,70,129,65,64
050,26,013,"Michigan","Baraga County",5,71,131,71,60
050,26,013,"Michigan","Baraga County",5,72,104,56,48
050,26,013,"Michigan","Baraga County",5,73,92,50,42
050,26,013,"Michigan","Baraga County",5,74,97,51,46
050,26,013,"Michigan","Baraga County",5,75,81,44,37
050,26,013,"Michigan","Baraga County",5,76,97,52,45
050,26,013,"Michigan","Baraga County",5,77,64,31,33
050,26,013,"Michigan","Baraga County",5,78,49,19,30
050,26,013,"Michigan","Baraga County",5,79,55,23,32
050,26,013,"Michigan","Baraga County",5,80,62,30,32
050,26,013,"Michigan","Baraga County",5,81,58,31,27
050,26,013,"Michigan","Baraga County",5,82,49,24,25
050,26,013,"Michigan","Baraga County",5,83,37,15,22
050,26,013,"Michigan","Baraga County",5,84,43,14,29
050,26,013,"Michigan","Baraga County",5,85,186,64,122
050,26,015,"Michigan","Barry County",1,0,646,326,320
050,26,015,"Michigan","Barry County",1,1,661,335,326
050,26,015,"Michigan","Barry County",1,2,683,358,325
050,26,015,"Michigan","Barry County",1,3,687,362,325
050,26,015,"Michigan","Barry County",1,4,711,357,354
050,26,015,"Michigan","Barry County",1,5,757,389,368
050,26,015,"Michigan","Barry County",1,6,758,386,372
050,26,015,"Michigan","Barry County",1,7,750,386,364
050,26,015,"Michigan","Barry County",1,8,789,392,397
050,26,015,"Michigan","Barry County",1,9,765,389,376
050,26,015,"Michigan","Barry County",1,10,785,402,383
050,26,015,"Michigan","Barry County",1,11,783,396,387
050,26,015,"Michigan","Barry County",1,12,852,447,405
050,26,015,"Michigan","Barry County",1,13,840,443,397
050,26,015,"Michigan","Barry County",1,14,829,434,395
050,26,015,"Michigan","Barry County",1,15,847,440,407
050,26,015,"Michigan","Barry County",1,16,869,451,418
050,26,015,"Michigan","Barry County",1,17,861,436,425
050,26,015,"Michigan","Barry County",1,18,760,390,370
050,26,015,"Michigan","Barry County",1,19,660,344,316
050,26,015,"Michigan","Barry County",1,20,668,341,327
050,26,015,"Michigan","Barry County",1,21,632,322,310
050,26,015,"Michigan","Barry County",1,22,646,336,310
050,26,015,"Michigan","Barry County",1,23,686,354,332
050,26,015,"Michigan","Barry County",1,24,669,332,337
050,26,015,"Michigan","Barry County",1,25,636,338,298
050,26,015,"Michigan","Barry County",1,26,668,353,315
050,26,015,"Michigan","Barry County",1,27,686,355,331
050,26,015,"Michigan","Barry County",1,28,751,364,387
050,26,015,"Michigan","Barry County",1,29,758,368,390
050,26,015,"Michigan","Barry County",1,30,787,406,381
050,26,015,"Michigan","Barry County",1,31,706,359,347
050,26,015,"Michigan","Barry County",1,32,710,342,368
050,26,015,"Michigan","Barry County",1,33,726,359,367
050,26,015,"Michigan","Barry County",1,34,745,388,357
050,26,015,"Michigan","Barry County",1,35,729,378,351
050,26,015,"Michigan","Barry County",1,36,690,350,340
050,26,015,"Michigan","Barry County",1,37,723,351,372
050,26,015,"Michigan","Barry County",1,38,794,412,382
050,26,015,"Michigan","Barry County",1,39,785,410,375
050,26,015,"Michigan","Barry County",1,40,724,392,332
050,26,015,"Michigan","Barry County",1,41,712,368,344
050,26,015,"Michigan","Barry County",1,42,720,366,354
050,26,015,"Michigan","Barry County",1,43,713,369,344
050,26,015,"Michigan","Barry County",1,44,675,336,339
050,26,015,"Michigan","Barry County",1,45,682,347,335
050,26,015,"Michigan","Barry County",1,46,706,361,345
050,26,015,"Michigan","Barry County",1,47,721,376,345
050,26,015,"Michigan","Barry County",1,48,780,388,392
050,26,015,"Michigan","Barry County",1,49,842,441,401
050,26,015,"Michigan","Barry County",1,50,856,427,429
050,26,015,"Michigan","Barry County",1,51,830,410,420
050,26,015,"Michigan","Barry County",1,52,833,432,401
050,26,015,"Michigan","Barry County",1,53,836,440,396
050,26,015,"Michigan","Barry County",1,54,869,450,419
050,26,015,"Michigan","Barry County",1,55,934,481,453
050,26,015,"Michigan","Barry County",1,56,1031,530,501
050,26,015,"Michigan","Barry County",1,57,1051,538,513
050,26,015,"Michigan","Barry County",1,58,1010,498,512
050,26,015,"Michigan","Barry County",1,59,1022,522,500
050,26,015,"Michigan","Barry County",1,60,970,493,477
050,26,015,"Michigan","Barry County",1,61,984,507,477
050,26,015,"Michigan","Barry County",1,62,970,503,467
050,26,015,"Michigan","Barry County",1,63,949,481,468
050,26,015,"Michigan","Barry County",1,64,917,464,453
050,26,015,"Michigan","Barry County",1,65,875,448,427
050,26,015,"Michigan","Barry County",1,66,855,431,424
050,26,015,"Michigan","Barry County",1,67,795,388,407
050,26,015,"Michigan","Barry County",1,68,780,410,370
050,26,015,"Michigan","Barry County",1,69,705,373,332
050,26,015,"Michigan","Barry County",1,70,700,336,364
050,26,015,"Michigan","Barry County",1,71,671,339,332
050,26,015,"Michigan","Barry County",1,72,671,337,334
050,26,015,"Michigan","Barry County",1,73,674,323,351
050,26,015,"Michigan","Barry County",1,74,467,217,250
050,26,015,"Michigan","Barry County",1,75,462,218,244
050,26,015,"Michigan","Barry County",1,76,426,205,221
050,26,015,"Michigan","Barry County",1,77,429,213,216
050,26,015,"Michigan","Barry County",1,78,396,186,210
050,26,015,"Michigan","Barry County",1,79,358,170,188
050,26,015,"Michigan","Barry County",1,80,329,147,182
050,26,015,"Michigan","Barry County",1,81,284,127,157
050,26,015,"Michigan","Barry County",1,82,259,126,133
050,26,015,"Michigan","Barry County",1,83,245,112,133
050,26,015,"Michigan","Barry County",1,84,197,85,112
050,26,015,"Michigan","Barry County",1,85,1018,368,650
050,26,015,"Michigan","Barry County",2,0,659,330,329
050,26,015,"Michigan","Barry County",2,1,653,331,322
050,26,015,"Michigan","Barry County",2,2,682,355,327
050,26,015,"Michigan","Barry County",2,3,690,363,327
050,26,015,"Michigan","Barry County",2,4,714,363,351
050,26,015,"Michigan","Barry County",2,5,752,383,369
050,26,015,"Michigan","Barry County",2,6,761,388,373
050,26,015,"Michigan","Barry County",2,7,754,386,368
050,26,015,"Michigan","Barry County",2,8,780,392,388
050,26,015,"Michigan","Barry County",2,9,774,392,382
050,26,015,"Michigan","Barry County",2,10,778,398,380
050,26,015,"Michigan","Barry County",2,11,783,399,384
050,26,015,"Michigan","Barry County",2,12,843,440,403
050,26,015,"Michigan","Barry County",2,13,844,446,398
050,26,015,"Michigan","Barry County",2,14,836,438,398
050,26,015,"Michigan","Barry County",2,15,844,440,404
050,26,015,"Michigan","Barry County",2,16,866,449,417
050,26,015,"Michigan","Barry County",2,17,864,441,423
050,26,015,"Michigan","Barry County",2,18,764,395,369
050,26,015,"Michigan","Barry County",2,19,661,342,319
050,26,015,"Michigan","Barry County",2,20,672,343,329
050,26,015,"Michigan","Barry County",2,21,638,325,313
050,26,015,"Michigan","Barry County",2,22,650,334,316
050,26,015,"Michigan","Barry County",2,23,682,349,333
050,26,015,"Michigan","Barry County",2,24,674,338,336
050,26,015,"Michigan","Barry County",2,25,644,340,304
050,26,015,"Michigan","Barry County",2,26,663,352,311
050,26,015,"Michigan","Barry County",2,27,686,357,329
050,26,015,"Michigan","Barry County",2,28,741,366,375
050,26,015,"Michigan","Barry County",2,29,762,371,391
050,26,015,"Michigan","Barry County",2,30,789,402,387
050,26,015,"Michigan","Barry County",2,31,726,368,358
050,26,015,"Michigan","Barry County",2,32,711,346,365
050,26,015,"Michigan","Barry County",2,33,726,360,366
050,26,015,"Michigan","Barry County",2,34,744,383,361
050,26,015,"Michigan","Barry County",2,35,739,383,356
050,26,015,"Michigan","Barry County",2,36,698,356,342
050,26,015,"Michigan","Barry County",2,37,721,355,366
050,26,015,"Michigan","Barry County",2,38,783,401,382
050,26,015,"Michigan","Barry County",2,39,787,411,376
050,26,015,"Michigan","Barry County",2,40,747,401,346
050,26,015,"Michigan","Barry County",2,41,719,375,344
050,26,015,"Michigan","Barry County",2,42,719,367,352
050,26,015,"Michigan","Barry County",2,43,723,373,350
050,26,015,"Michigan","Barry County",2,44,680,342,338
050,26,015,"Michigan","Barry County",2,45,689,347,342
050,26,015,"Michigan","Barry County",2,46,701,357,344
050,26,015,"Michigan","Barry County",2,47,720,374,346
050,26,015,"Michigan","Barry County",2,48,767,386,381
050,26,015,"Michigan","Barry County",2,49,831,430,401
050,26,015,"Michigan","Barry County",2,50,855,433,422
050,26,015,"Michigan","Barry County",2,51,839,413,426
050,26,015,"Michigan","Barry County",2,52,832,426,406
050,26,015,"Michigan","Barry County",2,53,841,440,401
050,26,015,"Michigan","Barry County",2,54,860,447,413
050,26,015,"Michigan","Barry County",2,55,921,474,447
050,26,015,"Michigan","Barry County",2,56,1015,521,494
050,26,015,"Michigan","Barry County",2,57,1053,540,513
050,26,015,"Michigan","Barry County",2,58,1019,508,511
050,26,015,"Michigan","Barry County",2,59,1026,521,505
050,26,015,"Michigan","Barry County",2,60,979,498,481
050,26,015,"Michigan","Barry County",2,61,981,503,478
050,26,015,"Michigan","Barry County",2,62,972,502,470
050,26,015,"Michigan","Barry County",2,63,958,488,470
050,26,015,"Michigan","Barry County",2,64,919,467,452
050,26,015,"Michigan","Barry County",2,65,885,451,434
050,26,015,"Michigan","Barry County",2,66,861,433,428
050,26,015,"Michigan","Barry County",2,67,803,395,408
050,26,015,"Michigan","Barry County",2,68,775,401,374
050,26,015,"Michigan","Barry County",2,69,729,384,345
050,26,015,"Michigan","Barry County",2,70,698,344,354
050,26,015,"Michigan","Barry County",2,71,674,335,339
050,26,015,"Michigan","Barry County",2,72,660,332,328
050,26,015,"Michigan","Barry County",2,73,701,341,360
050,26,015,"Michigan","Barry County",2,74,480,224,256
050,26,015,"Michigan","Barry County",2,75,462,215,247
050,26,015,"Michigan","Barry County",2,76,427,205,222
050,26,015,"Michigan","Barry County",2,77,434,214,220
050,26,015,"Michigan","Barry County",2,78,394,189,205
050,26,015,"Michigan","Barry County",2,79,362,171,191
050,26,015,"Michigan","Barry County",2,80,332,150,182
050,26,015,"Michigan","Barry County",2,81,290,129,161
050,26,015,"Michigan","Barry County",2,82,261,125,136
050,26,015,"Michigan","Barry County",2,83,245,113,132
050,26,015,"Michigan","Barry County",2,84,206,90,116
050,26,015,"Michigan","Barry County",2,85,1015,359,656
050,26,015,"Michigan","Barry County",3,0,614,302,312
050,26,015,"Michigan","Barry County",3,1,694,356,338
050,26,015,"Michigan","Barry County",3,2,687,341,346
050,26,015,"Michigan","Barry County",3,3,692,366,326
050,26,015,"Michigan","Barry County",3,4,741,382,359
050,26,015,"Michigan","Barry County",3,5,742,365,377
050,26,015,"Michigan","Barry County",3,6,771,403,368
050,26,015,"Michigan","Barry County",3,7,761,396,365
050,26,015,"Michigan","Barry County",3,8,779,395,384
050,26,015,"Michigan","Barry County",3,9,774,383,391
050,26,015,"Michigan","Barry County",3,10,769,391,378
050,26,015,"Michigan","Barry County",3,11,783,409,374
050,26,015,"Michigan","Barry County",3,12,802,410,392
050,26,015,"Michigan","Barry County",3,13,861,441,420
050,26,015,"Michigan","Barry County",3,14,861,459,402
050,26,015,"Michigan","Barry County",3,15,829,427,402
050,26,015,"Michigan","Barry County",3,16,852,437,415
050,26,015,"Michigan","Barry County",3,17,859,442,417
050,26,015,"Michigan","Barry County",3,18,787,414,373
050,26,015,"Michigan","Barry County",3,19,639,332,307
050,26,015,"Michigan","Barry County",3,20,678,338,340
050,26,015,"Michigan","Barry County",3,21,674,345,329
050,26,015,"Michigan","Barry County",3,22,640,322,318
050,26,015,"Michigan","Barry County",3,23,636,339,297
050,26,015,"Michigan","Barry County",3,24,670,347,323
050,26,015,"Michigan","Barry County",3,25,655,336,319
050,26,015,"Michigan","Barry County",3,26,652,332,320
050,26,015,"Michigan","Barry County",3,27,680,354,326
050,26,015,"Michigan","Barry County",3,28,703,355,348
050,26,015,"Michigan","Barry County",3,29,769,378,391
050,26,015,"Michigan","Barry County",3,30,814,392,422
050,26,015,"Michigan","Barry County",3,31,803,406,397
050,26,015,"Michigan","Barry County",3,32,751,389,362
050,26,015,"Michigan","Barry County",3,33,763,373,390
050,26,015,"Michigan","Barry County",3,34,754,362,392
050,26,015,"Michigan","Barry County",3,35,774,403,371
050,26,015,"Michigan","Barry County",3,36,753,399,354
050,26,015,"Michigan","Barry County",3,37,703,371,332
050,26,015,"Michigan","Barry County",3,38,746,363,383
050,26,015,"Michigan","Barry County",3,39,797,417,380
050,26,015,"Michigan","Barry County",3,40,778,409,369
050,26,015,"Michigan","Barry County",3,41,749,397,352
050,26,015,"Michigan","Barry County",3,42,737,384,353
050,26,015,"Michigan","Barry County",3,43,730,375,355
050,26,015,"Michigan","Barry County",3,44,735,390,345
050,26,015,"Michigan","Barry County",3,45,689,349,340
050,26,015,"Michigan","Barry County",3,46,685,340,345
050,26,015,"Michigan","Barry County",3,47,713,370,343
050,26,015,"Michigan","Barry County",3,48,725,379,346
050,26,015,"Michigan","Barry County",3,49,788,399,389
050,26,015,"Michigan","Barry County",3,50,851,446,405
050,26,015,"Michigan","Barry County",3,51,848,428,420
050,26,015,"Michigan","Barry County",3,52,841,417,424
050,26,015,"Michigan","Barry County",3,53,838,436,402
050,26,015,"Michigan","Barry County",3,54,833,431,402
050,26,015,"Michigan","Barry County",3,55,863,451,412
050,26,015,"Michigan","Barry County",3,56,920,471,449
050,26,015,"Michigan","Barry County",3,57,1034,527,507
050,26,015,"Michigan","Barry County",3,58,1050,532,518
050,26,015,"Michigan","Barry County",3,59,1022,513,509
050,26,015,"Michigan","Barry County",3,60,1017,518,499
050,26,015,"Michigan","Barry County",3,61,994,509,485
050,26,015,"Michigan","Barry County",3,62,975,500,475
050,26,015,"Michigan","Barry County",3,63,981,502,479
050,26,015,"Michigan","Barry County",3,64,972,490,482
050,26,015,"Michigan","Barry County",3,65,924,477,447
050,26,015,"Michigan","Barry County",3,66,872,442,430
050,26,015,"Michigan","Barry County",3,67,851,423,428
050,26,015,"Michigan","Barry County",3,68,784,387,397
050,26,015,"Michigan","Barry County",3,69,758,396,362
050,26,015,"Michigan","Barry County",3,70,724,380,344
050,26,015,"Michigan","Barry County",3,71,667,327,340
050,26,015,"Michigan","Barry County",3,72,652,321,331
050,26,015,"Michigan","Barry County",3,73,643,320,323
050,26,015,"Michigan","Barry County",3,74,681,327,354
050,26,015,"Michigan","Barry County",3,75,466,223,243
050,26,015,"Michigan","Barry County",3,76,446,213,233
050,26,015,"Michigan","Barry County",3,77,397,185,212
050,26,015,"Michigan","Barry County",3,78,415,204,211
050,26,015,"Michigan","Barry County",3,79,375,176,199
050,26,015,"Michigan","Barry County",3,80,336,155,181
050,26,015,"Michigan","Barry County",3,81,317,140,177
050,26,015,"Michigan","Barry County",3,82,266,121,145
050,26,015,"Michigan","Barry County",3,83,246,115,131
050,26,015,"Michigan","Barry County",3,84,225,105,120
050,26,015,"Michigan","Barry County",3,85,1016,366,650
050,26,015,"Michigan","Barry County",4,0,617,329,288
050,26,015,"Michigan","Barry County",4,1,597,284,313
050,26,015,"Michigan","Barry County",4,2,694,351,343
050,26,015,"Michigan","Barry County",4,3,709,356,353
050,26,015,"Michigan","Barry County",4,4,711,373,338
050,26,015,"Michigan","Barry County",4,5,760,392,368
050,26,015,"Michigan","Barry County",4,6,740,364,376
050,26,015,"Michigan","Barry County",4,7,787,403,384
050,26,015,"Michigan","Barry County",4,8,794,406,388
050,26,015,"Michigan","Barry County",4,9,786,399,387
050,26,015,"Michigan","Barry County",4,10,795,396,399
050,26,015,"Michigan","Barry County",4,11,768,389,379
050,26,015,"Michigan","Barry County",4,12,802,409,393
050,26,015,"Michigan","Barry County",4,13,805,402,403
050,26,015,"Michigan","Barry County",4,14,881,458,423
050,26,015,"Michigan","Barry County",4,15,869,457,412
050,26,015,"Michigan","Barry County",4,16,826,416,410
050,26,015,"Michigan","Barry County",4,17,847,433,414
050,26,015,"Michigan","Barry County",4,18,769,412,357
050,26,015,"Michigan","Barry County",4,19,655,347,308
050,26,015,"Michigan","Barry County",4,20,627,316,311
050,26,015,"Michigan","Barry County",4,21,663,330,333
050,26,015,"Michigan","Barry County",4,22,698,350,348
050,26,015,"Michigan","Barry County",4,23,650,334,316
050,26,015,"Michigan","Barry County",4,24,666,362,304
050,26,015,"Michigan","Barry County",4,25,662,351,311
050,26,015,"Michigan","Barry County",4,26,685,355,330
050,26,015,"Michigan","Barry County",4,27,675,347,328
050,26,015,"Michigan","Barry County",4,28,692,356,336
050,26,015,"Michigan","Barry County",4,29,743,376,367
050,26,015,"Michigan","Barry County",4,30,783,388,395
050,26,015,"Michigan","Barry County",4,31,833,406,427
050,26,015,"Michigan","Barry County",4,32,799,399,400
050,26,015,"Michigan","Barry County",4,33,758,395,363
050,26,015,"Michigan","Barry County",4,34,761,373,388
050,26,015,"Michigan","Barry County",4,35,761,374,387
050,26,015,"Michigan","Barry County",4,36,767,403,364
050,26,015,"Michigan","Barry County",4,37,773,406,367
050,26,015,"Michigan","Barry County",4,38,719,372,347
050,26,015,"Michigan","Barry County",4,39,741,364,377
050,26,015,"Michigan","Barry County",4,40,796,416,380
050,26,015,"Michigan","Barry County",4,41,780,406,374
050,26,015,"Michigan","Barry County",4,42,777,408,369
050,26,015,"Michigan","Barry County",4,43,747,389,358
050,26,015,"Michigan","Barry County",4,44,749,387,362
050,26,015,"Michigan","Barry County",4,45,743,396,347
050,26,015,"Michigan","Barry County",4,46,692,346,346
050,26,015,"Michigan","Barry County",4,47,686,335,351
050,26,015,"Michigan","Barry County",4,48,715,376,339
050,26,015,"Michigan","Barry County",4,49,734,386,348
050,26,015,"Michigan","Barry County",4,50,799,401,398
050,26,015,"Michigan","Barry County",4,51,862,454,408
050,26,015,"Michigan","Barry County",4,52,859,430,429
050,26,015,"Michigan","Barry County",4,53,844,423,421
050,26,015,"Michigan","Barry County",4,54,828,431,397
050,26,015,"Michigan","Barry County",4,55,850,436,414
050,26,015,"Michigan","Barry County",4,56,859,449,410
050,26,015,"Michigan","Barry County",4,57,930,485,445
050,26,015,"Michigan","Barry County",4,58,1029,526,503
050,26,015,"Michigan","Barry County",4,59,1046,544,502
050,26,015,"Michigan","Barry County",4,60,1017,506,511
050,26,015,"Michigan","Barry County",4,61,1028,528,500
050,26,015,"Michigan","Barry County",4,62,985,504,481
050,26,015,"Michigan","Barry County",4,63,973,495,478
050,26,015,"Michigan","Barry County",4,64,974,506,468
050,26,015,"Michigan","Barry County",4,65,947,476,471
050,26,015,"Michigan","Barry County",4,66,911,468,443
050,26,015,"Michigan","Barry County",4,67,869,437,432
050,26,015,"Michigan","Barry County",4,68,837,417,420
050,26,015,"Michigan","Barry County",4,69,780,385,395
050,26,015,"Michigan","Barry County",4,70,748,388,360
050,26,015,"Michigan","Barry County",4,71,709,374,335
050,26,015,"Michigan","Barry County",4,72,641,315,326
050,26,015,"Michigan","Barry County",4,73,633,310,323
050,26,015,"Michigan","Barry County",4,74,620,316,304
050,26,015,"Michigan","Barry County",4,75,656,313,343
050,26,015,"Michigan","Barry County",4,76,445,219,226
050,26,015,"Michigan","Barry County",4,77,423,197,226
050,26,015,"Michigan","Barry County",4,78,371,172,199
050,26,015,"Michigan","Barry County",4,79,394,190,204
050,26,015,"Michigan","Barry County",4,80,348,165,183
050,26,015,"Michigan","Barry County",4,81,325,146,179
050,26,015,"Michigan","Barry County",4,82,294,131,163
050,26,015,"Michigan","Barry County",4,83,244,109,135
050,26,015,"Michigan","Barry County",4,84,224,102,122
050,26,015,"Michigan","Barry County",4,85,1013,377,636
050,26,015,"Michigan","Barry County",5,0,600,320,280
050,26,015,"Michigan","Barry County",5,1,620,327,293
050,26,015,"Michigan","Barry County",5,2,622,304,318
050,26,015,"Michigan","Barry County",5,3,700,352,348
050,26,015,"Michigan","Barry County",5,4,716,370,346
050,26,015,"Michigan","Barry County",5,5,735,392,343
050,26,015,"Michigan","Barry County",5,6,777,403,374
050,26,015,"Michigan","Barry County",5,7,762,363,399
050,26,015,"Michigan","Barry County",5,8,799,409,390
050,26,015,"Michigan","Barry County",5,9,810,416,394
050,26,015,"Michigan","Barry County",5,10,789,403,386
050,26,015,"Michigan","Barry County",5,11,811,400,411
050,26,015,"Michigan","Barry County",5,12,777,399,378
050,26,015,"Michigan","Barry County",5,13,829,438,391
050,26,015,"Michigan","Barry County",5,14,841,426,415
050,26,015,"Michigan","Barry County",5,15,891,449,442
050,26,015,"Michigan","Barry County",5,16,895,473,422
050,26,015,"Michigan","Barry County",5,17,829,412,417
050,26,015,"Michigan","Barry County",5,18,775,403,372
050,26,015,"Michigan","Barry County",5,19,642,344,298
050,26,015,"Michigan","Barry County",5,20,665,353,312
050,26,015,"Michigan","Barry County",5,21,649,332,317
050,26,015,"Michigan","Barry County",5,22,703,341,362
050,26,015,"Michigan","Barry County",5,23,689,364,325
050,26,015,"Michigan","Barry County",5,24,647,338,309
050,26,015,"Michigan","Barry County",5,25,668,363,305
050,26,015,"Michigan","Barry County",5,26,665,349,316
050,26,015,"Michigan","Barry County",5,27,719,373,346
050,26,015,"Michigan","Barry County",5,28,712,376,336
050,26,015,"Michigan","Barry County",5,29,719,360,359
050,26,015,"Michigan","Barry County",5,30,757,389,368
050,26,015,"Michigan","Barry County",5,31,795,404,391
050,26,015,"Michigan","Barry County",5,32,835,407,428
050,26,015,"Michigan","Barry County",5,33,818,408,410
050,26,015,"Michigan","Barry County",5,34,757,383,374
050,26,015,"Michigan","Barry County",5,35,750,367,383
050,26,015,"Michigan","Barry County",5,36,803,398,405
050,26,015,"Michigan","Barry County",5,37,804,418,386
050,26,015,"Michigan","Barry County",5,38,791,408,383
050,26,015,"Michigan","Barry County",5,39,722,369,353
050,26,015,"Michigan","Barry County",5,40,762,377,385
050,26,015,"Michigan","Barry County",5,41,799,418,381
050,26,015,"Michigan","Barry County",5,42,780,402,378
050,26,015,"Michigan","Barry County",5,43,796,420,376
050,26,015,"Michigan","Barry County",5,44,747,385,362
050,26,015,"Michigan","Barry County",5,45,755,386,369
050,26,015,"Michigan","Barry County",5,46,737,395,342
050,26,015,"Michigan","Barry County",5,47,690,353,337
050,26,015,"Michigan","Barry County",5,48,692,335,357
050,26,015,"Michigan","Barry County",5,49,711,374,337
050,26,015,"Michigan","Barry County",5,50,741,390,351
050,26,015,"Michigan","Barry County",5,51,794,401,393
050,26,015,"Michigan","Barry County",5,52,869,453,416
050,26,015,"Michigan","Barry County",5,53,875,446,429
050,26,015,"Michigan","Barry County",5,54,860,427,433
050,26,015,"Michigan","Barry County",5,55,819,428,391
050,26,015,"Michigan","Barry County",5,56,848,437,411
050,26,015,"Michigan","Barry County",5,57,850,438,412
050,26,015,"Michigan","Barry County",5,58,928,480,448
050,26,015,"Michigan","Barry County",5,59,1024,517,507
050,26,015,"Michigan","Barry County",5,60,1037,541,496
050,26,015,"Michigan","Barry County",5,61,1020,510,510
050,26,015,"Michigan","Barry County",5,62,1019,522,497
050,26,015,"Michigan","Barry County",5,63,967,493,474
050,26,015,"Michigan","Barry County",5,64,972,494,478
050,26,015,"Michigan","Barry County",5,65,983,504,479
050,26,015,"Michigan","Barry County",5,66,935,469,466
050,26,015,"Michigan","Barry County",5,67,889,461,428
050,26,015,"Michigan","Barry County",5,68,842,429,413
050,26,015,"Michigan","Barry County",5,69,814,401,413
050,26,015,"Michigan","Barry County",5,70,751,371,380
050,26,015,"Michigan","Barry County",5,71,738,384,354
050,26,015,"Michigan","Barry County",5,72,694,365,329
050,26,015,"Michigan","Barry County",5,73,626,303,323
050,26,015,"Michigan","Barry County",5,74,614,295,319
050,26,015,"Michigan","Barry County",5,75,589,300,289
050,26,015,"Michigan","Barry County",5,76,632,302,330
050,26,015,"Michigan","Barry County",5,77,426,202,224
050,26,015,"Michigan","Barry County",5,78,403,186,217
050,26,015,"Michigan","Barry County",5,79,353,164,189
050,26,015,"Michigan","Barry County",5,80,374,182,192
050,26,015,"Michigan","Barry County",5,81,329,151,178
050,26,015,"Michigan","Barry County",5,82,295,133,162
050,26,015,"Michigan","Barry County",5,83,277,120,157
050,26,015,"Michigan","Barry County",5,84,228,103,125
050,26,015,"Michigan","Barry County",5,85,1036,394,642
050,26,017,"Michigan","Bay County",1,0,933,474,459
050,26,017,"Michigan","Bay County",1,1,982,500,482
050,26,017,"Michigan","Bay County",1,2,997,514,483
050,26,017,"Michigan","Bay County",1,3,1071,525,546
050,26,017,"Michigan","Bay County",1,4,1076,533,543
050,26,017,"Michigan","Bay County",1,5,1052,542,510
050,26,017,"Michigan","Bay County",1,6,1090,572,518
050,26,017,"Michigan","Bay County",1,7,1036,531,505
050,26,017,"Michigan","Bay County",1,8,1070,548,522
050,26,017,"Michigan","Bay County",1,9,1148,623,525
050,26,017,"Michigan","Bay County",1,10,1232,644,588
050,26,017,"Michigan","Bay County",1,11,1274,669,605
050,26,017,"Michigan","Bay County",1,12,1295,667,628
050,26,017,"Michigan","Bay County",1,13,1348,704,644
050,26,017,"Michigan","Bay County",1,14,1294,652,642
050,26,017,"Michigan","Bay County",1,15,1327,671,656
050,26,017,"Michigan","Bay County",1,16,1352,689,663
050,26,017,"Michigan","Bay County",1,17,1349,702,647
050,26,017,"Michigan","Bay County",1,18,1115,596,519
050,26,017,"Michigan","Bay County",1,19,940,508,432
050,26,017,"Michigan","Bay County",1,20,1013,509,504
050,26,017,"Michigan","Bay County",1,21,1095,565,530
050,26,017,"Michigan","Bay County",1,22,1164,580,584
050,26,017,"Michigan","Bay County",1,23,1182,609,573
050,26,017,"Michigan","Bay County",1,24,1247,634,613
050,26,017,"Michigan","Bay County",1,25,1198,599,599
050,26,017,"Michigan","Bay County",1,26,1292,653,639
050,26,017,"Michigan","Bay County",1,27,1291,675,616
050,26,017,"Michigan","Bay County",1,28,1380,710,670
050,26,017,"Michigan","Bay County",1,29,1402,697,705
050,26,017,"Michigan","Bay County",1,30,1320,667,653
050,26,017,"Michigan","Bay County",1,31,1247,634,613
050,26,017,"Michigan","Bay County",1,32,1205,614,591
050,26,017,"Michigan","Bay County",1,33,1178,613,565
050,26,017,"Michigan","Bay County",1,34,1238,636,602
050,26,017,"Michigan","Bay County",1,35,1193,599,594
050,26,017,"Michigan","Bay County",1,36,1161,597,564
050,26,017,"Michigan","Bay County",1,37,1239,633,606
050,26,017,"Michigan","Bay County",1,38,1232,626,606
050,26,017,"Michigan","Bay County",1,39,1259,632,627
050,26,017,"Michigan","Bay County",1,40,1241,605,636
050,26,017,"Michigan","Bay County",1,41,1235,624,611
050,26,017,"Michigan","Bay County",1,42,1257,645,612
050,26,017,"Michigan","Bay County",1,43,1131,584,547
050,26,017,"Michigan","Bay County",1,44,1136,570,566
050,26,017,"Michigan","Bay County",1,45,1161,587,574
050,26,017,"Michigan","Bay County",1,46,1156,588,568
050,26,017,"Michigan","Bay County",1,47,1192,597,595
050,26,017,"Michigan","Bay County",1,48,1270,629,641
050,26,017,"Michigan","Bay County",1,49,1373,673,700
050,26,017,"Michigan","Bay County",1,50,1292,645,647
050,26,017,"Michigan","Bay County",1,51,1302,666,636
050,26,017,"Michigan","Bay County",1,52,1340,698,642
050,26,017,"Michigan","Bay County",1,53,1357,695,662
050,26,017,"Michigan","Bay County",1,54,1407,716,691
050,26,017,"Michigan","Bay County",1,55,1502,766,736
050,26,017,"Michigan","Bay County",1,56,1532,775,757
050,26,017,"Michigan","Bay County",1,57,1557,739,818
050,26,017,"Michigan","Bay County",1,58,1620,761,859
050,26,017,"Michigan","Bay County",1,59,1626,792,834
050,26,017,"Michigan","Bay County",1,60,1625,779,846
050,26,017,"Michigan","Bay County",1,61,1678,829,849
050,26,017,"Michigan","Bay County",1,62,1661,815,846
050,26,017,"Michigan","Bay County",1,63,1589,756,833
050,26,017,"Michigan","Bay County",1,64,1574,764,810
050,26,017,"Michigan","Bay County",1,65,1487,726,761
050,26,017,"Michigan","Bay County",1,66,1467,697,770
050,26,017,"Michigan","Bay County",1,67,1441,704,737
050,26,017,"Michigan","Bay County",1,68,1434,666,768
050,26,017,"Michigan","Bay County",1,69,1268,610,658
050,26,017,"Michigan","Bay County",1,70,1242,601,641
050,26,017,"Michigan","Bay County",1,71,1235,595,640
050,26,017,"Michigan","Bay County",1,72,1225,577,648
050,26,017,"Michigan","Bay County",1,73,1170,562,608
050,26,017,"Michigan","Bay County",1,74,834,393,441
050,26,017,"Michigan","Bay County",1,75,829,383,446
050,26,017,"Michigan","Bay County",1,76,838,390,448
050,26,017,"Michigan","Bay County",1,77,844,391,453
050,26,017,"Michigan","Bay County",1,78,686,314,372
050,26,017,"Michigan","Bay County",1,79,655,298,357
050,26,017,"Michigan","Bay County",1,80,578,258,320
050,26,017,"Michigan","Bay County",1,81,528,231,297
050,26,017,"Michigan","Bay County",1,82,514,232,282
050,26,017,"Michigan","Bay County",1,83,454,189,265
050,26,017,"Michigan","Bay County",1,84,402,160,242
050,26,017,"Michigan","Bay County",1,85,2393,765,1628
050,26,017,"Michigan","Bay County",2,0,957,480,477
050,26,017,"Michigan","Bay County",2,1,966,492,474
050,26,017,"Michigan","Bay County",2,2,995,513,482
050,26,017,"Michigan","Bay County",2,3,1054,524,530
050,26,017,"Michigan","Bay County",2,4,1079,534,545
050,26,017,"Michigan","Bay County",2,5,1059,541,518
050,26,017,"Michigan","Bay County",2,6,1080,566,514
050,26,017,"Michigan","Bay County",2,7,1048,542,506
050,26,017,"Michigan","Bay County",2,8,1060,546,514
050,26,017,"Michigan","Bay County",2,9,1133,605,528
050,26,017,"Michigan","Bay County",2,10,1209,638,571
050,26,017,"Michigan","Bay County",2,11,1262,662,600
050,26,017,"Michigan","Bay County",2,12,1296,671,625
050,26,017,"Michigan","Bay County",2,13,1335,693,642
050,26,017,"Michigan","Bay County",2,14,1309,663,646
050,26,017,"Michigan","Bay County",2,15,1319,668,651
050,26,017,"Michigan","Bay County",2,16,1344,685,659
050,26,017,"Michigan","Bay County",2,17,1348,699,649
050,26,017,"Michigan","Bay County",2,18,1118,599,519
050,26,017,"Michigan","Bay County",2,19,939,502,437
050,26,017,"Michigan","Bay County",2,20,1026,524,502
050,26,017,"Michigan","Bay County",2,21,1084,556,528
050,26,017,"Michigan","Bay County",2,22,1163,583,580
050,26,017,"Michigan","Bay County",2,23,1180,602,578
050,26,017,"Michigan","Bay County",2,24,1230,629,601
050,26,017,"Michigan","Bay County",2,25,1209,607,602
050,26,017,"Michigan","Bay County",2,26,1276,646,630
050,26,017,"Michigan","Bay County",2,27,1289,669,620
050,26,017,"Michigan","Bay County",2,28,1358,702,656
050,26,017,"Michigan","Bay County",2,29,1398,701,697
050,26,017,"Michigan","Bay County",2,30,1351,679,672
050,26,017,"Michigan","Bay County",2,31,1266,642,624
050,26,017,"Michigan","Bay County",2,32,1209,615,594
050,26,017,"Michigan","Bay County",2,33,1184,617,567
050,26,017,"Michigan","Bay County",2,34,1225,631,594
050,26,017,"Michigan","Bay County",2,35,1209,613,596
050,26,017,"Michigan","Bay County",2,36,1161,594,567
050,26,017,"Michigan","Bay County",2,37,1225,628,597
050,26,017,"Michigan","Bay County",2,38,1239,633,606
050,26,017,"Michigan","Bay County",2,39,1251,630,621
050,26,017,"Michigan","Bay County",2,40,1250,614,636
050,26,017,"Michigan","Bay County",2,41,1236,618,618
050,26,017,"Michigan","Bay County",2,42,1242,636,606
050,26,017,"Michigan","Bay County",2,43,1168,600,568
050,26,017,"Michigan","Bay County",2,44,1124,568,556
050,26,017,"Michigan","Bay County",2,45,1157,584,573
050,26,017,"Michigan","Bay County",2,46,1148,582,566
050,26,017,"Michigan","Bay County",2,47,1173,589,584
050,26,017,"Michigan","Bay County",2,48,1246,618,628
050,26,017,"Michigan","Bay County",2,49,1346,660,686
050,26,017,"Michigan","Bay County",2,50,1308,651,657
050,26,017,"Michigan","Bay County",2,51,1295,658,637
050,26,017,"Michigan","Bay County",2,52,1328,690,638
050,26,017,"Michigan","Bay County",2,53,1347,691,656
050,26,017,"Michigan","Bay County",2,54,1389,711,678
050,26,017,"Michigan","Bay County",2,55,1473,751,722
050,26,017,"Michigan","Bay County",2,56,1530,777,753
050,26,017,"Michigan","Bay County",2,57,1553,748,805
050,26,017,"Michigan","Bay County",2,58,1599,751,848
050,26,017,"Michigan","Bay County",2,59,1632,788,844
050,26,017,"Michigan","Bay County",2,60,1617,779,838
050,26,017,"Michigan","Bay County",2,61,1655,811,844
050,26,017,"Michigan","Bay County",2,62,1652,812,840
050,26,017,"Michigan","Bay County",2,63,1625,781,844
050,26,017,"Michigan","Bay County",2,64,1565,758,807
050,26,017,"Michigan","Bay County",2,65,1498,729,769
050,26,017,"Michigan","Bay County",2,66,1472,704,768
050,26,017,"Michigan","Bay County",2,67,1440,698,742
050,26,017,"Michigan","Bay County",2,68,1418,669,749
050,26,017,"Michigan","Bay County",2,69,1316,625,691
050,26,017,"Michigan","Bay County",2,70,1238,598,640
050,26,017,"Michigan","Bay County",2,71,1236,597,639
050,26,017,"Michigan","Bay County",2,72,1201,568,633
050,26,017,"Michigan","Bay County",2,73,1244,594,650
050,26,017,"Michigan","Bay County",2,74,849,399,450
050,26,017,"Michigan","Bay County",2,75,825,383,442
050,26,017,"Michigan","Bay County",2,76,822,379,443
050,26,017,"Michigan","Bay County",2,77,854,394,460
050,26,017,"Michigan","Bay County",2,78,703,320,383
050,26,017,"Michigan","Bay County",2,79,646,291,355
050,26,017,"Michigan","Bay County",2,80,590,266,324
050,26,017,"Michigan","Bay County",2,81,531,235,296
050,26,017,"Michigan","Bay County",2,82,511,229,282
050,26,017,"Michigan","Bay County",2,83,460,191,269
050,26,017,"Michigan","Bay County",2,84,405,161,244
050,26,017,"Michigan","Bay County",2,85,2382,765,1617
050,26,017,"Michigan","Bay County",3,0,896,432,464
050,26,017,"Michigan","Bay County",3,1,1000,506,494
050,26,017,"Michigan","Bay County",3,2,970,503,467
050,26,017,"Michigan","Bay County",3,3,1005,517,488
050,26,017,"Michigan","Bay County",3,4,1055,537,518
050,26,017,"Michigan","Bay County",3,5,1051,517,534
050,26,017,"Michigan","Bay County",3,6,1069,553,516
050,26,017,"Michigan","Bay County",3,7,1071,561,510
050,26,017,"Michigan","Bay County",3,8,1040,541,499
050,26,017,"Michigan","Bay County",3,9,1073,550,523
050,26,017,"Michigan","Bay County",3,10,1128,605,523
050,26,017,"Michigan","Bay County",3,11,1204,649,555
050,26,017,"Michigan","Bay County",3,12,1245,657,588
050,26,017,"Michigan","Bay County",3,13,1269,658,611
050,26,017,"Michigan","Bay County",3,14,1319,686,633
050,26,017,"Michigan","Bay County",3,15,1311,671,640
050,26,017,"Michigan","Bay County",3,16,1303,649,654
050,26,017,"Michigan","Bay County",3,17,1355,698,657
050,26,017,"Michigan","Bay County",3,18,1157,620,537
050,26,017,"Michigan","Bay County",3,19,933,500,433
050,26,017,"Michigan","Bay County",3,20,1045,547,498
050,26,017,"Michigan","Bay County",3,21,1095,559,536
050,26,017,"Michigan","Bay County",3,22,1179,584,595
050,26,017,"Michigan","Bay County",3,23,1214,619,595
050,26,017,"Michigan","Bay County",3,24,1261,644,617
050,26,017,"Michigan","Bay County",3,25,1209,611,598
050,26,017,"Michigan","Bay County",3,26,1239,639,600
050,26,017,"Michigan","Bay County",3,27,1236,623,613
050,26,017,"Michigan","Bay County",3,28,1302,673,629
050,26,017,"Michigan","Bay County",3,29,1305,671,634
050,26,017,"Michigan","Bay County",3,30,1392,690,702
050,26,017,"Michigan","Bay County",3,31,1334,671,663
050,26,017,"Michigan","Bay County",3,32,1245,639,606
050,26,017,"Michigan","Bay County",3,33,1219,628,591
050,26,017,"Michigan","Bay County",3,34,1181,602,579
050,26,017,"Michigan","Bay County",3,35,1231,636,595
050,26,017,"Michigan","Bay County",3,36,1229,626,603
050,26,017,"Michigan","Bay County",3,37,1175,591,584
050,26,017,"Michigan","Bay County",3,38,1207,618,589
050,26,017,"Michigan","Bay County",3,39,1243,636,607
050,26,017,"Michigan","Bay County",3,40,1216,609,607
050,26,017,"Michigan","Bay County",3,41,1244,611,633
050,26,017,"Michigan","Bay County",3,42,1235,617,618
050,26,017,"Michigan","Bay County",3,43,1241,626,615
050,26,017,"Michigan","Bay County",3,44,1170,594,576
050,26,017,"Michigan","Bay County",3,45,1125,562,563
050,26,017,"Michigan","Bay County",3,46,1181,603,578
050,26,017,"Michigan","Bay County",3,47,1134,567,567
050,26,017,"Michigan","Bay County",3,48,1169,590,579
050,26,017,"Michigan","Bay County",3,49,1237,618,619
050,26,017,"Michigan","Bay County",3,50,1348,668,680
050,26,017,"Michigan","Bay County",3,51,1293,650,643
050,26,017,"Michigan","Bay County",3,52,1311,669,642
050,26,017,"Michigan","Bay County",3,53,1321,679,642
050,26,017,"Michigan","Bay County",3,54,1361,702,659
050,26,017,"Michigan","Bay County",3,55,1376,701,675
050,26,017,"Michigan","Bay County",3,56,1470,749,721
050,26,017,"Michigan","Bay County",3,57,1515,751,764
050,26,017,"Michigan","Bay County",3,58,1546,748,798
050,26,017,"Michigan","Bay County",3,59,1580,731,849
050,26,017,"Michigan","Bay County",3,60,1620,776,844
050,26,017,"Michigan","Bay County",3,61,1580,761,819
050,26,017,"Michigan","Bay County",3,62,1637,807,830
050,26,017,"Michigan","Bay County",3,63,1650,813,837
050,26,017,"Michigan","Bay County",3,64,1609,776,833
050,26,017,"Michigan","Bay County",3,65,1547,742,805
050,26,017,"Michigan","Bay County",3,66,1457,711,746
050,26,017,"Michigan","Bay County",3,67,1435,682,753
050,26,017,"Michigan","Bay County",3,68,1402,679,723
050,26,017,"Michigan","Bay County",3,69,1394,655,739
050,26,017,"Michigan","Bay County",3,70,1276,598,678
050,26,017,"Michigan","Bay County",3,71,1203,578,625
050,26,017,"Michigan","Bay County",3,72,1209,577,632
050,26,017,"Michigan","Bay County",3,73,1165,552,613
050,26,017,"Michigan","Bay County",3,74,1201,570,631
050,26,017,"Michigan","Bay County",3,75,823,388,435
050,26,017,"Michigan","Bay County",3,76,770,352,418
050,26,017,"Michigan","Bay County",3,77,777,349,428
050,26,017,"Michigan","Bay County",3,78,813,370,443
050,26,017,"Michigan","Bay County",3,79,651,288,363
050,26,017,"Michigan","Bay County",3,80,604,272,332
050,26,017,"Michigan","Bay County",3,81,541,236,305
050,26,017,"Michigan","Bay County",3,82,476,204,272
050,26,017,"Michigan","Bay County",3,83,454,200,254
050,26,017,"Michigan","Bay County",3,84,411,164,247
050,26,017,"Michigan","Bay County",3,85,2335,762,1573
050,26,017,"Michigan","Bay County",4,0,908,434,474
050,26,017,"Michigan","Bay County",4,1,916,459,457
050,26,017,"Michigan","Bay County",4,2,1014,523,491
050,26,017,"Michigan","Bay County",4,3,993,507,486
050,26,017,"Michigan","Bay County",4,4,1007,525,482
050,26,017,"Michigan","Bay County",4,5,1062,543,519
050,26,017,"Michigan","Bay County",4,6,1048,518,530
050,26,017,"Michigan","Bay County",4,7,1063,541,522
050,26,017,"Michigan","Bay County",4,8,1075,555,520
050,26,017,"Michigan","Bay County",4,9,1043,545,498
050,26,017,"Michigan","Bay County",4,10,1088,555,533
050,26,017,"Michigan","Bay County",4,11,1150,619,531
050,26,017,"Michigan","Bay County",4,12,1212,653,559
050,26,017,"Michigan","Bay County",4,13,1257,655,602
050,26,017,"Michigan","Bay County",4,14,1283,670,613
050,26,017,"Michigan","Bay County",4,15,1325,693,632
050,26,017,"Michigan","Bay County",4,16,1308,658,650
050,26,017,"Michigan","Bay County",4,17,1303,650,653
050,26,017,"Michigan","Bay County",4,18,1174,612,562
050,26,017,"Michigan","Bay County",4,19,908,476,432
050,26,017,"Michigan","Bay County",4,20,995,517,478
050,26,017,"Michigan","Bay County",4,21,1077,573,504
050,26,017,"Michigan","Bay County",4,22,1176,591,585
050,26,017,"Michigan","Bay County",4,23,1193,587,606
050,26,017,"Michigan","Bay County",4,24,1273,637,636
050,26,017,"Michigan","Bay County",4,25,1258,642,616
050,26,017,"Michigan","Bay County",4,26,1245,638,607
050,26,017,"Michigan","Bay County",4,27,1240,643,597
050,26,017,"Michigan","Bay County",4,28,1223,615,608
050,26,017,"Michigan","Bay County",4,29,1294,655,639
050,26,017,"Michigan","Bay County",4,30,1351,702,649
050,26,017,"Michigan","Bay County",4,31,1398,698,700
050,26,017,"Michigan","Bay County",4,32,1320,671,649
050,26,017,"Michigan","Bay County",4,33,1258,640,618
050,26,017,"Michigan","Bay County",4,34,1230,621,609
050,26,017,"Michigan","Bay County",4,35,1182,609,573
050,26,017,"Michigan","Bay County",4,36,1238,644,594
050,26,017,"Michigan","Bay County",4,37,1261,647,614
050,26,017,"Michigan","Bay County",4,38,1146,567,579
050,26,017,"Michigan","Bay County",4,39,1217,620,597
050,26,017,"Michigan","Bay County",4,40,1238,630,608
050,26,017,"Michigan","Bay County",4,41,1224,622,602
050,26,017,"Michigan","Bay County",4,42,1247,618,629
050,26,017,"Michigan","Bay County",4,43,1218,605,613
050,26,017,"Michigan","Bay County",4,44,1238,624,614
050,26,017,"Michigan","Bay County",4,45,1153,591,562
050,26,017,"Michigan","Bay County",4,46,1121,562,559
050,26,017,"Michigan","Bay County",4,47,1152,583,569
050,26,017,"Michigan","Bay County",4,48,1123,564,559
050,26,017,"Michigan","Bay County",4,49,1151,564,587
050,26,017,"Michigan","Bay County",4,50,1237,621,616
050,26,017,"Michigan","Bay County",4,51,1351,683,668
050,26,017,"Michigan","Bay County",4,52,1309,652,657
050,26,017,"Michigan","Bay County",4,53,1290,655,635
050,26,017,"Michigan","Bay County",4,54,1325,684,641
050,26,017,"Michigan","Bay County",4,55,1346,687,659
050,26,017,"Michigan","Bay County",4,56,1363,695,668
050,26,017,"Michigan","Bay County",4,57,1488,747,741
050,26,017,"Michigan","Bay County",4,58,1486,741,745
050,26,017,"Michigan","Bay County",4,59,1540,738,802
050,26,017,"Michigan","Bay County",4,60,1566,725,841
050,26,017,"Michigan","Bay County",4,61,1601,770,831
050,26,017,"Michigan","Bay County",4,62,1550,746,804
050,26,017,"Michigan","Bay County",4,63,1629,799,830
050,26,017,"Michigan","Bay County",4,64,1603,786,817
050,26,017,"Michigan","Bay County",4,65,1604,770,834
050,26,017,"Michigan","Bay County",4,66,1510,720,790
050,26,017,"Michigan","Bay County",4,67,1431,689,742
050,26,017,"Michigan","Bay County",4,68,1408,671,737
050,26,017,"Michigan","Bay County",4,69,1381,667,714
050,26,017,"Michigan","Bay County",4,70,1356,632,724
050,26,017,"Michigan","Bay County",4,71,1238,579,659
050,26,017,"Michigan","Bay County",4,72,1163,550,613
050,26,017,"Michigan","Bay County",4,73,1157,555,602
050,26,017,"Michigan","Bay County",4,74,1128,524,604
050,26,017,"Michigan","Bay County",4,75,1168,553,615
050,26,017,"Michigan","Bay County",4,76,781,370,411
050,26,017,"Michigan","Bay County",4,77,724,328,396
050,26,017,"Michigan","Bay County",4,78,737,323,414
050,26,017,"Michigan","Bay County",4,79,768,346,422
050,26,017,"Michigan","Bay County",4,80,608,262,346
050,26,017,"Michigan","Bay County",4,81,568,250,318
050,26,017,"Michigan","Bay County",4,82,495,214,281
050,26,017,"Michigan","Bay County",4,83,441,176,265
050,26,017,"Michigan","Bay County",4,84,397,166,231
050,26,017,"Michigan","Bay County",4,85,2314,767,1547
050,26,017,"Michigan","Bay County",5,0,860,412,448
050,26,017,"Michigan","Bay County",5,1,952,456,496
050,26,017,"Michigan","Bay County",5,2,899,453,446
050,26,017,"Michigan","Bay County",5,3,1040,528,512
050,26,017,"Michigan","Bay County",5,4,1004,514,490
050,26,017,"Michigan","Bay County",5,5,1018,527,491
050,26,017,"Michigan","Bay County",5,6,1079,563,516
050,26,017,"Michigan","Bay County",5,7,1063,533,530
050,26,017,"Michigan","Bay County",5,8,1075,543,532
050,26,017,"Michigan","Bay County",5,9,1092,566,526
050,26,017,"Michigan","Bay County",5,10,1054,536,518
050,26,017,"Michigan","Bay County",5,11,1094,565,529
050,26,017,"Michigan","Bay County",5,12,1141,613,528
050,26,017,"Michigan","Bay County",5,13,1209,668,541
050,26,017,"Michigan","Bay County",5,14,1248,651,597
050,26,017,"Michigan","Bay County",5,15,1293,683,610
050,26,017,"Michigan","Bay County",5,16,1304,667,637
050,26,017,"Michigan","Bay County",5,17,1317,661,656
050,26,017,"Michigan","Bay County",5,18,1103,575,528
050,26,017,"Michigan","Bay County",5,19,944,489,455
050,26,017,"Michigan","Bay County",5,20,999,513,486
050,26,017,"Michigan","Bay County",5,21,1059,557,502
050,26,017,"Michigan","Bay County",5,22,1160,595,565
050,26,017,"Michigan","Bay County",5,23,1206,601,605
050,26,017,"Michigan","Bay County",5,24,1252,637,615
050,26,017,"Michigan","Bay County",5,25,1252,628,624
050,26,017,"Michigan","Bay County",5,26,1250,653,597
050,26,017,"Michigan","Bay County",5,27,1219,613,606
050,26,017,"Michigan","Bay County",5,28,1260,653,607
050,26,017,"Michigan","Bay County",5,29,1244,633,611
050,26,017,"Michigan","Bay County",5,30,1288,655,633
050,26,017,"Michigan","Bay County",5,31,1371,700,671
050,26,017,"Michigan","Bay County",5,32,1388,702,686
050,26,017,"Michigan","Bay County",5,33,1350,686,664
050,26,017,"Michigan","Bay County",5,34,1273,644,629
050,26,017,"Michigan","Bay County",5,35,1219,624,595
050,26,017,"Michigan","Bay County",5,36,1197,619,578
050,26,017,"Michigan","Bay County",5,37,1230,651,579
050,26,017,"Michigan","Bay County",5,38,1229,621,608
050,26,017,"Michigan","Bay County",5,39,1154,575,579
050,26,017,"Michigan","Bay County",5,40,1213,621,592
050,26,017,"Michigan","Bay County",5,41,1253,641,612
050,26,017,"Michigan","Bay County",5,42,1228,625,603
050,26,017,"Michigan","Bay County",5,43,1239,615,624
050,26,017,"Michigan","Bay County",5,44,1222,600,622
050,26,017,"Michigan","Bay County",5,45,1236,615,621
050,26,017,"Michigan","Bay County",5,46,1153,596,557
050,26,017,"Michigan","Bay County",5,47,1131,558,573
050,26,017,"Michigan","Bay County",5,48,1151,591,560
050,26,017,"Michigan","Bay County",5,49,1125,563,562
050,26,017,"Michigan","Bay County",5,50,1179,580,599
050,26,017,"Michigan","Bay County",5,51,1232,623,609
050,26,017,"Michigan","Bay County",5,52,1377,690,687
050,26,017,"Michigan","Bay County",5,53,1307,643,664
050,26,017,"Michigan","Bay County",5,54,1293,657,636
050,26,017,"Michigan","Bay County",5,55,1322,676,646
050,26,017,"Michigan","Bay County",5,56,1329,675,654
050,26,017,"Michigan","Bay County",5,57,1377,695,682
050,26,017,"Michigan","Bay County",5,58,1491,748,743
050,26,017,"Michigan","Bay County",5,59,1466,726,740
050,26,017,"Michigan","Bay County",5,60,1525,732,793
050,26,017,"Michigan","Bay County",5,61,1542,711,831
050,26,017,"Michigan","Bay County",5,62,1587,758,829
050,26,017,"Michigan","Bay County",5,63,1543,741,802
050,26,017,"Michigan","Bay County",5,64,1607,782,825
050,26,017,"Michigan","Bay County",5,65,1585,769,816
050,26,017,"Michigan","Bay County",5,66,1586,761,825
050,26,017,"Michigan","Bay County",5,67,1488,694,794
050,26,017,"Michigan","Bay County",5,68,1429,690,739
050,26,017,"Michigan","Bay County",5,69,1402,671,731
050,26,017,"Michigan","Bay County",5,70,1349,643,706
050,26,017,"Michigan","Bay County",5,71,1318,610,708
050,26,017,"Michigan","Bay County",5,72,1212,557,655
050,26,017,"Michigan","Bay County",5,73,1131,538,593
050,26,017,"Michigan","Bay County",5,74,1135,541,594
050,26,017,"Michigan","Bay County",5,75,1111,512,599
050,26,017,"Michigan","Bay County",5,76,1122,533,589
050,26,017,"Michigan","Bay County",5,77,750,352,398
050,26,017,"Michigan","Bay County",5,78,691,311,380
050,26,017,"Michigan","Bay County",5,79,695,301,394
050,26,017,"Michigan","Bay County",5,80,716,318,398
050,26,017,"Michigan","Bay County",5,81,573,240,333
050,26,017,"Michigan","Bay County",5,82,529,231,298
050,26,017,"Michigan","Bay County",5,83,463,192,271
050,26,017,"Michigan","Bay County",5,84,384,140,244
050,26,017,"Michigan","Bay County",5,85,2314,781,1533
050,26,019,"Michigan","Benzie County",1,0,142,72,70
050,26,019,"Michigan","Benzie County",1,1,149,78,71
050,26,019,"Michigan","Benzie County",1,2,162,84,78
050,26,019,"Michigan","Benzie County",1,3,178,100,78
050,26,019,"Michigan","Benzie County",1,4,165,84,81
050,26,019,"Michigan","Benzie County",1,5,178,95,83
050,26,019,"Michigan","Benzie County",1,6,183,108,75
050,26,019,"Michigan","Benzie County",1,7,174,98,76
050,26,019,"Michigan","Benzie County",1,8,176,90,86
050,26,019,"Michigan","Benzie County",1,9,158,76,82
050,26,019,"Michigan","Benzie County",1,10,172,85,87
050,26,019,"Michigan","Benzie County",1,11,180,97,83
050,26,019,"Michigan","Benzie County",1,12,188,91,97
050,26,019,"Michigan","Benzie County",1,13,201,99,102
050,26,019,"Michigan","Benzie County",1,14,207,108,99
050,26,019,"Michigan","Benzie County",1,15,181,93,88
050,26,019,"Michigan","Benzie County",1,16,204,105,99
050,26,019,"Michigan","Benzie County",1,17,205,113,92
050,26,019,"Michigan","Benzie County",1,18,177,96,81
050,26,019,"Michigan","Benzie County",1,19,142,73,69
050,26,019,"Michigan","Benzie County",1,20,143,78,65
050,26,019,"Michigan","Benzie County",1,21,162,81,81
050,26,019,"Michigan","Benzie County",1,22,160,83,77
050,26,019,"Michigan","Benzie County",1,23,159,75,84
050,26,019,"Michigan","Benzie County",1,24,157,78,79
050,26,019,"Michigan","Benzie County",1,25,135,76,59
050,26,019,"Michigan","Benzie County",1,26,151,90,61
050,26,019,"Michigan","Benzie County",1,27,178,88,90
050,26,019,"Michigan","Benzie County",1,28,196,98,98
050,26,019,"Michigan","Benzie County",1,29,174,94,80
050,26,019,"Michigan","Benzie County",1,30,208,104,104
050,26,019,"Michigan","Benzie County",1,31,182,85,97
050,26,019,"Michigan","Benzie County",1,32,179,88,91
050,26,019,"Michigan","Benzie County",1,33,185,97,88
050,26,019,"Michigan","Benzie County",1,34,202,98,104
050,26,019,"Michigan","Benzie County",1,35,190,106,84
050,26,019,"Michigan","Benzie County",1,36,199,110,89
050,26,019,"Michigan","Benzie County",1,37,205,105,100
050,26,019,"Michigan","Benzie County",1,38,207,111,96
050,26,019,"Michigan","Benzie County",1,39,208,106,102
050,26,019,"Michigan","Benzie County",1,40,188,92,96
050,26,019,"Michigan","Benzie County",1,41,182,83,99
050,26,019,"Michigan","Benzie County",1,42,201,95,106
050,26,019,"Michigan","Benzie County",1,43,187,100,87
050,26,019,"Michigan","Benzie County",1,44,166,74,92
050,26,019,"Michigan","Benzie County",1,45,154,82,72
050,26,019,"Michigan","Benzie County",1,46,171,88,83
050,26,019,"Michigan","Benzie County",1,47,170,76,94
050,26,019,"Michigan","Benzie County",1,48,204,105,99
050,26,019,"Michigan","Benzie County",1,49,226,108,118
050,26,019,"Michigan","Benzie County",1,50,221,107,114
050,26,019,"Michigan","Benzie County",1,51,205,107,98
050,26,019,"Michigan","Benzie County",1,52,205,103,102
050,26,019,"Michigan","Benzie County",1,53,209,108,101
050,26,019,"Michigan","Benzie County",1,54,229,105,124
050,26,019,"Michigan","Benzie County",1,55,274,135,139
050,26,019,"Michigan","Benzie County",1,56,292,139,153
050,26,019,"Michigan","Benzie County",1,57,292,147,145
050,26,019,"Michigan","Benzie County",1,58,324,162,162
050,26,019,"Michigan","Benzie County",1,59,315,143,172
050,26,019,"Michigan","Benzie County",1,60,286,135,151
050,26,019,"Michigan","Benzie County",1,61,303,159,144
050,26,019,"Michigan","Benzie County",1,62,341,179,162
050,26,019,"Michigan","Benzie County",1,63,349,175,174
050,26,019,"Michigan","Benzie County",1,64,355,162,193
050,26,019,"Michigan","Benzie County",1,65,330,166,164
050,26,019,"Michigan","Benzie County",1,66,327,168,159
050,26,019,"Michigan","Benzie County",1,67,314,166,148
050,26,019,"Michigan","Benzie County",1,68,283,137,146
050,26,019,"Michigan","Benzie County",1,69,275,137,138
050,26,019,"Michigan","Benzie County",1,70,260,131,129
050,26,019,"Michigan","Benzie County",1,71,261,137,124
050,26,019,"Michigan","Benzie County",1,72,290,151,139
050,26,019,"Michigan","Benzie County",1,73,308,164,144
050,26,019,"Michigan","Benzie County",1,74,202,100,102
050,26,019,"Michigan","Benzie County",1,75,189,80,109
050,26,019,"Michigan","Benzie County",1,76,198,93,105
050,26,019,"Michigan","Benzie County",1,77,203,105,98
050,26,019,"Michigan","Benzie County",1,78,172,79,93
050,26,019,"Michigan","Benzie County",1,79,145,66,79
050,26,019,"Michigan","Benzie County",1,80,118,57,61
050,26,019,"Michigan","Benzie County",1,81,118,59,59
050,26,019,"Michigan","Benzie County",1,82,114,43,71
050,26,019,"Michigan","Benzie County",1,83,113,54,59
050,26,019,"Michigan","Benzie County",1,84,104,50,54
050,26,019,"Michigan","Benzie County",1,85,489,187,302
050,26,019,"Michigan","Benzie County",2,0,144,76,68
050,26,019,"Michigan","Benzie County",2,1,146,76,70
050,26,019,"Michigan","Benzie County",2,2,160,82,78
050,26,019,"Michigan","Benzie County",2,3,175,96,79
050,26,019,"Michigan","Benzie County",2,4,172,90,82
050,26,019,"Michigan","Benzie County",2,5,175,93,82
050,26,019,"Michigan","Benzie County",2,6,183,106,77
050,26,019,"Michigan","Benzie County",2,7,175,99,76
050,26,019,"Michigan","Benzie County",2,8,176,92,84
050,26,019,"Michigan","Benzie County",2,9,164,80,84
050,26,019,"Michigan","Benzie County",2,10,170,84,86
050,26,019,"Michigan","Benzie County",2,11,175,92,83
050,26,019,"Michigan","Benzie County",2,12,188,94,94
050,26,019,"Michigan","Benzie County",2,13,197,98,99
050,26,019,"Michigan","Benzie County",2,14,204,107,97
050,26,019,"Michigan","Benzie County",2,15,186,96,90
050,26,019,"Michigan","Benzie County",2,16,197,101,96
050,26,019,"Michigan","Benzie County",2,17,205,112,93
050,26,019,"Michigan","Benzie County",2,18,174,96,78
050,26,019,"Michigan","Benzie County",2,19,143,76,67
050,26,019,"Michigan","Benzie County",2,20,148,80,68
050,26,019,"Michigan","Benzie County",2,21,158,81,77
050,26,019,"Michigan","Benzie County",2,22,160,81,79
050,26,019,"Michigan","Benzie County",2,23,161,78,83
050,26,019,"Michigan","Benzie County",2,24,158,78,80
050,26,019,"Michigan","Benzie County",2,25,141,79,62
050,26,019,"Michigan","Benzie County",2,26,149,89,60
050,26,019,"Michigan","Benzie County",2,27,175,90,85
050,26,019,"Michigan","Benzie County",2,28,193,97,96
050,26,019,"Michigan","Benzie County",2,29,183,97,86
050,26,019,"Michigan","Benzie County",2,30,203,104,99
050,26,019,"Michigan","Benzie County",2,31,188,89,99
050,26,019,"Michigan","Benzie County",2,32,182,88,94
050,26,019,"Michigan","Benzie County",2,33,183,95,88
050,26,019,"Michigan","Benzie County",2,34,199,98,101
050,26,019,"Michigan","Benzie County",2,35,195,106,89
050,26,019,"Michigan","Benzie County",2,36,197,110,87
050,26,019,"Michigan","Benzie County",2,37,206,108,98
050,26,019,"Michigan","Benzie County",2,38,211,111,100
050,26,019,"Michigan","Benzie County",2,39,208,108,100
050,26,019,"Michigan","Benzie County",2,40,197,98,99
050,26,019,"Michigan","Benzie County",2,41,186,86,100
050,26,019,"Michigan","Benzie County",2,42,197,93,104
050,26,019,"Michigan","Benzie County",2,43,193,100,93
050,26,019,"Michigan","Benzie County",2,44,166,77,89
050,26,019,"Michigan","Benzie County",2,45,160,83,77
050,26,019,"Michigan","Benzie County",2,46,169,87,82
050,26,019,"Michigan","Benzie County",2,47,170,79,91
050,26,019,"Michigan","Benzie County",2,48,197,98,99
050,26,019,"Michigan","Benzie County",2,49,222,108,114
050,26,019,"Michigan","Benzie County",2,50,222,106,116
050,26,019,"Michigan","Benzie County",2,51,208,106,102
050,26,019,"Michigan","Benzie County",2,52,205,104,101
050,26,019,"Michigan","Benzie County",2,53,208,106,102
050,26,019,"Michigan","Benzie County",2,54,223,105,118
050,26,019,"Michigan","Benzie County",2,55,266,128,138
050,26,019,"Michigan","Benzie County",2,56,289,138,151
050,26,019,"Michigan","Benzie County",2,57,292,144,148
050,26,019,"Michigan","Benzie County",2,58,313,155,158
050,26,019,"Michigan","Benzie County",2,59,318,147,171
050,26,019,"Michigan","Benzie County",2,60,293,137,156
050,26,019,"Michigan","Benzie County",2,61,300,153,147
050,26,019,"Michigan","Benzie County",2,62,333,174,159
050,26,019,"Michigan","Benzie County",2,63,352,176,176
050,26,019,"Michigan","Benzie County",2,64,355,165,190
050,26,019,"Michigan","Benzie County",2,65,340,167,173
050,26,019,"Michigan","Benzie County",2,66,332,171,161
050,26,019,"Michigan","Benzie County",2,67,317,166,151
050,26,019,"Michigan","Benzie County",2,68,288,143,145
050,26,019,"Michigan","Benzie County",2,69,279,137,142
050,26,019,"Michigan","Benzie County",2,70,261,133,128
050,26,019,"Michigan","Benzie County",2,71,256,132,124
050,26,019,"Michigan","Benzie County",2,72,279,146,133
050,26,019,"Michigan","Benzie County",2,73,317,169,148
050,26,019,"Michigan","Benzie County",2,74,211,107,104
050,26,019,"Michigan","Benzie County",2,75,192,84,108
050,26,019,"Michigan","Benzie County",2,76,192,88,104
050,26,019,"Michigan","Benzie County",2,77,203,103,100
050,26,019,"Michigan","Benzie County",2,78,172,82,90
050,26,019,"Michigan","Benzie County",2,79,150,68,82
050,26,019,"Michigan","Benzie County",2,80,122,59,63
050,26,019,"Michigan","Benzie County",2,81,116,58,58
050,26,019,"Michigan","Benzie County",2,82,114,46,68
050,26,019,"Michigan","Benzie County",2,83,112,51,61
050,26,019,"Michigan","Benzie County",2,84,102,49,53
050,26,019,"Michigan","Benzie County",2,85,494,186,308
050,26,019,"Michigan","Benzie County",3,0,134,69,65
050,26,019,"Michigan","Benzie County",3,1,152,82,70
050,26,019,"Michigan","Benzie County",3,2,149,79,70
050,26,019,"Michigan","Benzie County",3,3,162,84,78
050,26,019,"Michigan","Benzie County",3,4,187,102,85
050,26,019,"Michigan","Benzie County",3,5,179,90,89
050,26,019,"Michigan","Benzie County",3,6,172,88,84
050,26,019,"Michigan","Benzie County",3,7,174,98,76
050,26,019,"Michigan","Benzie County",3,8,183,108,75
050,26,019,"Michigan","Benzie County",3,9,178,92,86
050,26,019,"Michigan","Benzie County",3,10,185,88,97
050,26,019,"Michigan","Benzie County",3,11,172,85,87
050,26,019,"Michigan","Benzie County",3,12,176,93,83
050,26,019,"Michigan","Benzie County",3,13,188,95,93
050,26,019,"Michigan","Benzie County",3,14,202,99,103
050,26,019,"Michigan","Benzie County",3,15,203,107,96
050,26,019,"Michigan","Benzie County",3,16,194,98,96
050,26,019,"Michigan","Benzie County",3,17,204,106,98
050,26,019,"Michigan","Benzie County",3,18,187,103,84
050,26,019,"Michigan","Benzie County",3,19,145,79,66
050,26,019,"Michigan","Benzie County",3,20,152,76,76
050,26,019,"Michigan","Benzie County",3,21,158,86,72
050,26,019,"Michigan","Benzie County",3,22,151,74,77
050,26,019,"Michigan","Benzie County",3,23,165,77,88
050,26,019,"Michigan","Benzie County",3,24,155,88,67
050,26,019,"Michigan","Benzie County",3,25,155,81,74
050,26,019,"Michigan","Benzie County",3,26,156,89,67
050,26,019,"Michigan","Benzie County",3,27,160,87,73
050,26,019,"Michigan","Benzie County",3,28,177,94,83
050,26,019,"Michigan","Benzie County",3,29,200,97,103
050,26,019,"Michigan","Benzie County",3,30,189,99,90
050,26,019,"Michigan","Benzie County",3,31,210,109,101
050,26,019,"Michigan","Benzie County",3,32,199,97,102
050,26,019,"Michigan","Benzie County",3,33,188,91,97
050,26,019,"Michigan","Benzie County",3,34,188,102,86
050,26,019,"Michigan","Benzie County",3,35,206,101,105
050,26,019,"Michigan","Benzie County",3,36,210,113,97
050,26,019,"Michigan","Benzie County",3,37,201,111,90
050,26,019,"Michigan","Benzie County",3,38,213,114,99
050,26,019,"Michigan","Benzie County",3,39,208,111,97
050,26,019,"Michigan","Benzie County",3,40,217,112,105
050,26,019,"Michigan","Benzie County",3,41,207,108,99
050,26,019,"Michigan","Benzie County",3,42,192,85,107
050,26,019,"Michigan","Benzie County",3,43,195,92,103
050,26,019,"Michigan","Benzie County",3,44,189,98,91
050,26,019,"Michigan","Benzie County",3,45,174,85,89
050,26,019,"Michigan","Benzie County",3,46,164,81,83
050,26,019,"Michigan","Benzie County",3,47,171,90,81
050,26,019,"Michigan","Benzie County",3,48,172,79,93
050,26,019,"Michigan","Benzie County",3,49,201,99,102
050,26,019,"Michigan","Benzie County",3,50,226,115,111
050,26,019,"Michigan","Benzie County",3,51,211,101,110
050,26,019,"Michigan","Benzie County",3,52,210,107,103
050,26,019,"Michigan","Benzie County",3,53,204,102,102
050,26,019,"Michigan","Benzie County",3,54,217,109,108
050,26,019,"Michigan","Benzie County",3,55,233,108,125
050,26,019,"Michigan","Benzie County",3,56,276,135,141
050,26,019,"Michigan","Benzie County",3,57,303,143,160
050,26,019,"Michigan","Benzie County",3,58,305,149,156
050,26,019,"Michigan","Benzie County",3,59,331,169,162
050,26,019,"Michigan","Benzie County",3,60,323,156,167
050,26,019,"Michigan","Benzie County",3,61,319,152,167
050,26,019,"Michigan","Benzie County",3,62,316,166,150
050,26,019,"Michigan","Benzie County",3,63,341,180,161
050,26,019,"Michigan","Benzie County",3,64,359,186,173
050,26,019,"Michigan","Benzie County",3,65,353,159,194
050,26,019,"Michigan","Benzie County",3,66,347,179,168
050,26,019,"Michigan","Benzie County",3,67,332,170,162
050,26,019,"Michigan","Benzie County",3,68,312,164,148
050,26,019,"Michigan","Benzie County",3,69,289,142,147
050,26,019,"Michigan","Benzie County",3,70,281,139,142
050,26,019,"Michigan","Benzie County",3,71,253,132,121
050,26,019,"Michigan","Benzie County",3,72,249,126,123
050,26,019,"Michigan","Benzie County",3,73,275,140,135
050,26,019,"Michigan","Benzie County",3,74,307,163,144
050,26,019,"Michigan","Benzie County",3,75,208,103,105
050,26,019,"Michigan","Benzie County",3,76,187,81,106
050,26,019,"Michigan","Benzie County",3,77,179,83,96
050,26,019,"Michigan","Benzie County",3,78,192,99,93
050,26,019,"Michigan","Benzie County",3,79,168,80,88
050,26,019,"Michigan","Benzie County",3,80,139,66,73
050,26,019,"Michigan","Benzie County",3,81,120,63,57
050,26,019,"Michigan","Benzie County",3,82,106,50,56
050,26,019,"Michigan","Benzie County",3,83,107,43,64
050,26,019,"Michigan","Benzie County",3,84,99,43,56
050,26,019,"Michigan","Benzie County",3,85,511,201,310
050,26,019,"Michigan","Benzie County",4,0,144,72,72
050,26,019,"Michigan","Benzie County",4,1,147,77,70
050,26,019,"Michigan","Benzie County",4,2,154,87,67
050,26,019,"Michigan","Benzie County",4,3,150,81,69
050,26,019,"Michigan","Benzie County",4,4,141,75,66
050,26,019,"Michigan","Benzie County",4,5,189,104,85
050,26,019,"Michigan","Benzie County",4,6,169,91,78
050,26,019,"Michigan","Benzie County",4,7,176,94,82
050,26,019,"Michigan","Benzie County",4,8,183,107,76
050,26,019,"Michigan","Benzie County",4,9,184,102,82
050,26,019,"Michigan","Benzie County",4,10,178,92,86
050,26,019,"Michigan","Benzie County",4,11,175,89,86
050,26,019,"Michigan","Benzie County",4,12,177,79,98
050,26,019,"Michigan","Benzie County",4,13,176,97,79
050,26,019,"Michigan","Benzie County",4,14,179,89,90
050,26,019,"Michigan","Benzie County",4,15,198,101,97
050,26,019,"Michigan","Benzie County",4,16,205,113,92
050,26,019,"Michigan","Benzie County",4,17,195,95,100
050,26,019,"Michigan","Benzie County",4,18,175,95,80
050,26,019,"Michigan","Benzie County",4,19,146,76,70
050,26,019,"Michigan","Benzie County",4,20,156,85,71
050,26,019,"Michigan","Benzie County",4,21,171,87,84
050,26,019,"Michigan","Benzie County",4,22,157,82,75
050,26,019,"Michigan","Benzie County",4,23,165,80,85
050,26,019,"Michigan","Benzie County",4,24,166,87,79
050,26,019,"Michigan","Benzie County",4,25,156,87,69
050,26,019,"Michigan","Benzie County",4,26,157,77,80
050,26,019,"Michigan","Benzie County",4,27,152,87,65
050,26,019,"Michigan","Benzie County",4,28,161,90,71
050,26,019,"Michigan","Benzie County",4,29,189,101,88
050,26,019,"Michigan","Benzie County",4,30,200,95,105
050,26,019,"Michigan","Benzie County",4,31,198,103,95
050,26,019,"Michigan","Benzie County",4,32,213,114,99
050,26,019,"Michigan","Benzie County",4,33,202,99,103
050,26,019,"Michigan","Benzie County",4,34,187,96,91
050,26,019,"Michigan","Benzie County",4,35,197,102,95
050,26,019,"Michigan","Benzie County",4,36,216,106,110
050,26,019,"Michigan","Benzie County",4,37,214,112,102
050,26,019,"Michigan","Benzie County",4,38,208,115,93
050,26,019,"Michigan","Benzie County",4,39,216,121,95
050,26,019,"Michigan","Benzie County",4,40,216,112,104
050,26,019,"Michigan","Benzie County",4,41,218,112,106
050,26,019,"Michigan","Benzie County",4,42,203,107,96
050,26,019,"Michigan","Benzie County",4,43,194,85,109
050,26,019,"Michigan","Benzie County",4,44,188,92,96
050,26,019,"Michigan","Benzie County",4,45,197,97,100
050,26,019,"Michigan","Benzie County",4,46,173,81,92
050,26,019,"Michigan","Benzie County",4,47,165,81,84
050,26,019,"Michigan","Benzie County",4,48,169,88,81
050,26,019,"Michigan","Benzie County",4,49,174,82,92
050,26,019,"Michigan","Benzie County",4,50,205,101,104
050,26,019,"Michigan","Benzie County",4,51,224,113,111
050,26,019,"Michigan","Benzie County",4,52,235,117,118
050,26,019,"Michigan","Benzie County",4,53,221,115,106
050,26,019,"Michigan","Benzie County",4,54,212,104,108
050,26,019,"Michigan","Benzie County",4,55,226,109,117
050,26,019,"Michigan","Benzie County",4,56,233,112,121
050,26,019,"Michigan","Benzie County",4,57,284,138,146
050,26,019,"Michigan","Benzie County",4,58,309,150,159
050,26,019,"Michigan","Benzie County",4,59,299,141,158
050,26,019,"Michigan","Benzie County",4,60,335,171,164
050,26,019,"Michigan","Benzie County",4,61,329,155,174
050,26,019,"Michigan","Benzie County",4,62,321,158,163
050,26,019,"Michigan","Benzie County",4,63,330,182,148
050,26,019,"Michigan","Benzie County",4,64,350,185,165
050,26,019,"Michigan","Benzie County",4,65,370,186,184
050,26,019,"Michigan","Benzie County",4,66,354,164,190
050,26,019,"Michigan","Benzie County",4,67,346,177,169
050,26,019,"Michigan","Benzie County",4,68,336,177,159
050,26,019,"Michigan","Benzie County",4,69,316,162,154
050,26,019,"Michigan","Benzie County",4,70,284,140,144
050,26,019,"Michigan","Benzie County",4,71,272,135,137
050,26,019,"Michigan","Benzie County",4,72,254,131,123
050,26,019,"Michigan","Benzie County",4,73,246,122,124
050,26,019,"Michigan","Benzie County",4,74,276,142,134
050,26,019,"Michigan","Benzie County",4,75,298,155,143
050,26,019,"Michigan","Benzie County",4,76,194,95,99
050,26,019,"Michigan","Benzie County",4,77,177,77,100
050,26,019,"Michigan","Benzie County",4,78,167,79,88
050,26,019,"Michigan","Benzie County",4,79,184,96,88
050,26,019,"Michigan","Benzie County",4,80,159,73,86
050,26,019,"Michigan","Benzie County",4,81,131,64,67
050,26,019,"Michigan","Benzie County",4,82,110,58,52
050,26,019,"Michigan","Benzie County",4,83,100,46,54
050,26,019,"Michigan","Benzie County",4,84,97,39,58
050,26,019,"Michigan","Benzie County",4,85,524,206,318
050,26,019,"Michigan","Benzie County",5,0,138,69,69
050,26,019,"Michigan","Benzie County",5,1,167,78,89
050,26,019,"Michigan","Benzie County",5,2,154,83,71
050,26,019,"Michigan","Benzie County",5,3,164,95,69
050,26,019,"Michigan","Benzie County",5,4,150,75,75
050,26,019,"Michigan","Benzie County",5,5,145,76,69
050,26,019,"Michigan","Benzie County",5,6,193,111,82
050,26,019,"Michigan","Benzie County",5,7,173,98,75
050,26,019,"Michigan","Benzie County",5,8,181,98,83
050,26,019,"Michigan","Benzie County",5,9,183,101,82
050,26,019,"Michigan","Benzie County",5,10,172,96,76
050,26,019,"Michigan","Benzie County",5,11,180,93,87
050,26,019,"Michigan","Benzie County",5,12,193,91,102
050,26,019,"Michigan","Benzie County",5,13,186,82,104
050,26,019,"Michigan","Benzie County",5,14,162,86,76
050,26,019,"Michigan","Benzie County",5,15,192,94,98
050,26,019,"Michigan","Benzie County",5,16,191,94,97
050,26,019,"Michigan","Benzie County",5,17,200,111,89
050,26,019,"Michigan","Benzie County",5,18,156,78,78
050,26,019,"Michigan","Benzie County",5,19,131,70,61
050,26,019,"Michigan","Benzie County",5,20,160,79,81
050,26,019,"Michigan","Benzie County",5,21,168,88,80
050,26,019,"Michigan","Benzie County",5,22,162,78,84
050,26,019,"Michigan","Benzie County",5,23,160,81,79
050,26,019,"Michigan","Benzie County",5,24,174,90,84
050,26,019,"Michigan","Benzie County",5,25,156,83,73
050,26,019,"Michigan","Benzie County",5,26,144,73,71
050,26,019,"Michigan","Benzie County",5,27,160,82,78
050,26,019,"Michigan","Benzie County",5,28,162,92,70
050,26,019,"Michigan","Benzie County",5,29,154,96,58
050,26,019,"Michigan","Benzie County",5,30,184,90,94
050,26,019,"Michigan","Benzie County",5,31,208,96,112
050,26,019,"Michigan","Benzie County",5,32,206,103,103
050,26,019,"Michigan","Benzie County",5,33,207,107,100
050,26,019,"Michigan","Benzie County",5,34,203,96,107
050,26,019,"Michigan","Benzie County",5,35,202,109,93
050,26,019,"Michigan","Benzie County",5,36,188,96,92
050,26,019,"Michigan","Benzie County",5,37,212,101,111
050,26,019,"Michigan","Benzie County",5,38,211,110,101
050,26,019,"Michigan","Benzie County",5,39,210,114,96
050,26,019,"Michigan","Benzie County",5,40,222,125,97
050,26,019,"Michigan","Benzie County",5,41,218,112,106
050,26,019,"Michigan","Benzie County",5,42,219,108,111
050,26,019,"Michigan","Benzie County",5,43,203,107,96
050,26,019,"Michigan","Benzie County",5,44,205,91,114
050,26,019,"Michigan","Benzie County",5,45,207,99,108
050,26,019,"Michigan","Benzie County",5,46,195,100,95
050,26,019,"Michigan","Benzie County",5,47,173,81,92
050,26,019,"Michigan","Benzie County",5,48,165,81,84
050,26,019,"Michigan","Benzie County",5,49,183,97,86
050,26,019,"Michigan","Benzie County",5,50,177,88,89
050,26,019,"Michigan","Benzie County",5,51,204,99,105
050,26,019,"Michigan","Benzie County",5,52,232,121,111
050,26,019,"Michigan","Benzie County",5,53,243,120,123
050,26,019,"Michigan","Benzie County",5,54,229,119,110
050,26,019,"Michigan","Benzie County",5,55,224,115,109
050,26,019,"Michigan","Benzie County",5,56,225,110,115
050,26,019,"Michigan","Benzie County",5,57,239,112,127
050,26,019,"Michigan","Benzie County",5,58,278,136,142
050,26,019,"Michigan","Benzie County",5,59,312,143,169
050,26,019,"Michigan","Benzie County",5,60,301,142,159
050,26,019,"Michigan","Benzie County",5,61,349,176,173
050,26,019,"Michigan","Benzie County",5,62,339,157,182
050,26,019,"Michigan","Benzie County",5,63,333,164,169
050,26,019,"Michigan","Benzie County",5,64,332,181,151
050,26,019,"Michigan","Benzie County",5,65,364,189,175
050,26,019,"Michigan","Benzie County",5,66,375,188,187
050,26,019,"Michigan","Benzie County",5,67,354,163,191
050,26,019,"Michigan","Benzie County",5,68,345,178,167
050,26,019,"Michigan","Benzie County",5,69,334,173,161
050,26,019,"Michigan","Benzie County",5,70,316,163,153
050,26,019,"Michigan","Benzie County",5,71,276,133,143
050,26,019,"Michigan","Benzie County",5,72,267,128,139
050,26,019,"Michigan","Benzie County",5,73,250,125,125
050,26,019,"Michigan","Benzie County",5,74,247,128,119
050,26,019,"Michigan","Benzie County",5,75,269,139,130
050,26,019,"Michigan","Benzie County",5,76,292,154,138
050,26,019,"Michigan","Benzie County",5,77,186,93,93
050,26,019,"Michigan","Benzie County",5,78,171,73,98
050,26,019,"Michigan","Benzie County",5,79,160,75,85
050,26,019,"Michigan","Benzie County",5,80,175,91,84
050,26,019,"Michigan","Benzie County",5,81,156,75,81
050,26,019,"Michigan","Benzie County",5,82,118,57,61
050,26,019,"Michigan","Benzie County",5,83,105,56,49
050,26,019,"Michigan","Benzie County",5,84,93,41,52
050,26,019,"Michigan","Benzie County",5,85,539,208,331
050,26,021,"Michigan","Berrien County",1,0,1638,836,802
050,26,021,"Michigan","Berrien County",1,1,1674,850,824
050,26,021,"Michigan","Berrien County",1,2,1695,885,810
050,26,021,"Michigan","Berrien County",1,3,1772,911,861
050,26,021,"Michigan","Berrien County",1,4,1784,891,893
050,26,021,"Michigan","Berrien County",1,5,1846,954,892
050,26,021,"Michigan","Berrien County",1,6,1905,987,918
050,26,021,"Michigan","Berrien County",1,7,1846,899,947
050,26,021,"Michigan","Berrien County",1,8,1853,929,924
050,26,021,"Michigan","Berrien County",1,9,1913,1012,901
050,26,021,"Michigan","Berrien County",1,10,1921,988,933
050,26,021,"Michigan","Berrien County",1,11,1943,999,944
050,26,021,"Michigan","Berrien County",1,12,1965,984,981
050,26,021,"Michigan","Berrien County",1,13,2041,1056,985
050,26,021,"Michigan","Berrien County",1,14,2067,1056,1011
050,26,021,"Michigan","Berrien County",1,15,2027,1038,989
050,26,021,"Michigan","Berrien County",1,16,1996,1015,981
050,26,021,"Michigan","Berrien County",1,17,1946,994,952
050,26,021,"Michigan","Berrien County",1,18,1832,952,880
050,26,021,"Michigan","Berrien County",1,19,1735,892,843
050,26,021,"Michigan","Berrien County",1,20,1803,912,891
050,26,021,"Michigan","Berrien County",1,21,1794,904,890
050,26,021,"Michigan","Berrien County",1,22,1718,854,864
050,26,021,"Michigan","Berrien County",1,23,1694,831,863
050,26,021,"Michigan","Berrien County",1,24,1652,821,831
050,26,021,"Michigan","Berrien County",1,25,1680,853,827
050,26,021,"Michigan","Berrien County",1,26,1757,886,871
050,26,021,"Michigan","Berrien County",1,27,1848,938,910
050,26,021,"Michigan","Berrien County",1,28,1872,953,919
050,26,021,"Michigan","Berrien County",1,29,1859,922,937
050,26,021,"Michigan","Berrien County",1,30,1819,930,889
050,26,021,"Michigan","Berrien County",1,31,1759,903,856
050,26,021,"Michigan","Berrien County",1,32,1677,827,850
050,26,021,"Michigan","Berrien County",1,33,1718,837,881
050,26,021,"Michigan","Berrien County",1,34,1815,883,932
050,26,021,"Michigan","Berrien County",1,35,1821,894,927
050,26,021,"Michigan","Berrien County",1,36,1823,901,922
050,26,021,"Michigan","Berrien County",1,37,1820,874,946
050,26,021,"Michigan","Berrien County",1,38,1885,924,961
050,26,021,"Michigan","Berrien County",1,39,1857,914,943
050,26,021,"Michigan","Berrien County",1,40,1796,890,906
050,26,021,"Michigan","Berrien County",1,41,1784,883,901
050,26,021,"Michigan","Berrien County",1,42,1797,913,884
050,26,021,"Michigan","Berrien County",1,43,1709,872,837
050,26,021,"Michigan","Berrien County",1,44,1690,888,802
050,26,021,"Michigan","Berrien County",1,45,1717,849,868
050,26,021,"Michigan","Berrien County",1,46,1671,818,853
050,26,021,"Michigan","Berrien County",1,47,1746,879,867
050,26,021,"Michigan","Berrien County",1,48,1918,978,940
050,26,021,"Michigan","Berrien County",1,49,1993,1003,990
050,26,021,"Michigan","Berrien County",1,50,1986,995,991
050,26,021,"Michigan","Berrien County",1,51,1950,961,989
050,26,021,"Michigan","Berrien County",1,52,1906,908,998
050,26,021,"Michigan","Berrien County",1,53,2009,969,1040
050,26,021,"Michigan","Berrien County",1,54,1978,1006,972
050,26,021,"Michigan","Berrien County",1,55,2103,1050,1053
050,26,021,"Michigan","Berrien County",1,56,2186,1084,1102
050,26,021,"Michigan","Berrien County",1,57,2262,1100,1162
050,26,021,"Michigan","Berrien County",1,58,2344,1194,1150
050,26,021,"Michigan","Berrien County",1,59,2368,1178,1190
050,26,021,"Michigan","Berrien County",1,60,2273,1107,1166
050,26,021,"Michigan","Berrien County",1,61,2293,1129,1164
050,26,021,"Michigan","Berrien County",1,62,2284,1124,1160
050,26,021,"Michigan","Berrien County",1,63,2242,1077,1165
050,26,021,"Michigan","Berrien County",1,64,2239,1092,1147
050,26,021,"Michigan","Berrien County",1,65,2213,1062,1151
050,26,021,"Michigan","Berrien County",1,66,2114,1033,1081
050,26,021,"Michigan","Berrien County",1,67,2064,1000,1064
050,26,021,"Michigan","Berrien County",1,68,1991,961,1030
050,26,021,"Michigan","Berrien County",1,69,1829,854,975
050,26,021,"Michigan","Berrien County",1,70,1772,819,953
050,26,021,"Michigan","Berrien County",1,71,1707,790,917
050,26,021,"Michigan","Berrien County",1,72,1744,822,922
050,26,021,"Michigan","Berrien County",1,73,1669,799,870
050,26,021,"Michigan","Berrien County",1,74,1174,537,637
050,26,021,"Michigan","Berrien County",1,75,1241,591,650
050,26,021,"Michigan","Berrien County",1,76,1237,579,658
050,26,021,"Michigan","Berrien County",1,77,1212,544,668
050,26,021,"Michigan","Berrien County",1,78,1015,467,548
050,26,021,"Michigan","Berrien County",1,79,895,421,474
050,26,021,"Michigan","Berrien County",1,80,823,371,452
050,26,021,"Michigan","Berrien County",1,81,822,359,463
050,26,021,"Michigan","Berrien County",1,82,759,327,432
050,26,021,"Michigan","Berrien County",1,83,643,250,393
050,26,021,"Michigan","Berrien County",1,84,577,239,338
050,26,021,"Michigan","Berrien County",1,85,3503,1277,2226
050,26,021,"Michigan","Berrien County",2,0,1623,832,791
050,26,021,"Michigan","Berrien County",2,1,1670,846,824
050,26,021,"Michigan","Berrien County",2,2,1699,880,819
050,26,021,"Michigan","Berrien County",2,3,1745,902,843
050,26,021,"Michigan","Berrien County",2,4,1782,898,884
050,26,021,"Michigan","Berrien County",2,5,1832,941,891
050,26,021,"Michigan","Berrien County",2,6,1892,981,911
050,26,021,"Michigan","Berrien County",2,7,1862,918,944
050,26,021,"Michigan","Berrien County",2,8,1844,921,923
050,26,021,"Michigan","Berrien County",2,9,1895,990,905
050,26,021,"Michigan","Berrien County",2,10,1915,992,923
050,26,021,"Michigan","Berrien County",2,11,1927,989,938
050,26,021,"Michigan","Berrien County",2,12,1975,996,979
050,26,021,"Michigan","Berrien County",2,13,2026,1041,985
050,26,021,"Michigan","Berrien County",2,14,2062,1057,1005
050,26,021,"Michigan","Berrien County",2,15,2034,1040,994
050,26,021,"Michigan","Berrien County",2,16,2002,1019,983
050,26,021,"Michigan","Berrien County",2,17,1958,1001,957
050,26,021,"Michigan","Berrien County",2,18,1824,945,879
050,26,021,"Michigan","Berrien County",2,19,1722,886,836
050,26,021,"Michigan","Berrien County",2,20,1820,921,899
050,26,021,"Michigan","Berrien County",2,21,1803,912,891
050,26,021,"Michigan","Berrien County",2,22,1725,856,869
050,26,021,"Michigan","Berrien County",2,23,1698,838,860
050,26,021,"Michigan","Berrien County",2,24,1660,826,834
050,26,021,"Michigan","Berrien County",2,25,1668,843,825
050,26,021,"Michigan","Berrien County",2,26,1742,879,863
050,26,021,"Michigan","Berrien County",2,27,1822,922,900
050,26,021,"Michigan","Berrien County",2,28,1870,951,919
050,26,021,"Michigan","Berrien County",2,29,1864,932,932
050,26,021,"Michigan","Berrien County",2,30,1843,938,905
050,26,021,"Michigan","Berrien County",2,31,1765,905,860
050,26,021,"Michigan","Berrien County",2,32,1691,843,848
050,26,021,"Michigan","Berrien County",2,33,1707,835,872
050,26,021,"Michigan","Berrien County",2,34,1793,876,917
050,26,021,"Michigan","Berrien County",2,35,1835,900,935
050,26,021,"Michigan","Berrien County",2,36,1808,892,916
050,26,021,"Michigan","Berrien County",2,37,1827,883,944
050,26,021,"Michigan","Berrien County",2,38,1878,917,961
050,26,021,"Michigan","Berrien County",2,39,1857,914,943
050,26,021,"Michigan","Berrien County",2,40,1820,902,918
050,26,021,"Michigan","Berrien County",2,41,1782,886,896
050,26,021,"Michigan","Berrien County",2,42,1779,897,882
050,26,021,"Michigan","Berrien County",2,43,1741,887,854
050,26,021,"Michigan","Berrien County",2,44,1684,879,805
050,26,021,"Michigan","Berrien County",2,45,1723,862,861
050,26,021,"Michigan","Berrien County",2,46,1672,821,851
050,26,021,"Michigan","Berrien County",2,47,1720,858,862
050,26,021,"Michigan","Berrien County",2,48,1874,952,922
050,26,021,"Michigan","Berrien County",2,49,1985,1006,979
050,26,021,"Michigan","Berrien County",2,50,1993,1000,993
050,26,021,"Michigan","Berrien County",2,51,1947,965,982
050,26,021,"Michigan","Berrien County",2,52,1915,919,996
050,26,021,"Michigan","Berrien County",2,53,1985,955,1030
050,26,021,"Michigan","Berrien County",2,54,1979,991,988
050,26,021,"Michigan","Berrien County",2,55,2063,1034,1029
050,26,021,"Michigan","Berrien County",2,56,2176,1079,1097
050,26,021,"Michigan","Berrien County",2,57,2245,1096,1149
050,26,021,"Michigan","Berrien County",2,58,2319,1169,1150
050,26,021,"Michigan","Berrien County",2,59,2358,1179,1179
050,26,021,"Michigan","Berrien County",2,60,2289,1122,1167
050,26,021,"Michigan","Berrien County",2,61,2275,1119,1156
050,26,021,"Michigan","Berrien County",2,62,2279,1122,1157
050,26,021,"Michigan","Berrien County",2,63,2263,1092,1171
050,26,021,"Michigan","Berrien County",2,64,2225,1083,1142
050,26,021,"Michigan","Berrien County",2,65,2218,1067,1151
050,26,021,"Michigan","Berrien County",2,66,2135,1039,1096
050,26,021,"Michigan","Berrien County",2,67,2061,1000,1061
050,26,021,"Michigan","Berrien County",2,68,1986,957,1029
050,26,021,"Michigan","Berrien County",2,69,1869,879,990
050,26,021,"Michigan","Berrien County",2,70,1765,822,943
050,26,021,"Michigan","Berrien County",2,71,1718,794,924
050,26,021,"Michigan","Berrien County",2,72,1700,794,906
050,26,021,"Michigan","Berrien County",2,73,1758,843,915
050,26,021,"Michigan","Berrien County",2,74,1208,562,646
050,26,021,"Michigan","Berrien County",2,75,1223,578,645
050,26,021,"Michigan","Berrien County",2,76,1221,575,646
050,26,021,"Michigan","Berrien County",2,77,1232,560,672
050,26,021,"Michigan","Berrien County",2,78,1032,471,561
050,26,021,"Michigan","Berrien County",2,79,905,424,481
050,26,021,"Michigan","Berrien County",2,80,825,374,451
050,26,021,"Michigan","Berrien County",2,81,800,346,454
050,26,021,"Michigan","Berrien County",2,82,771,331,440
050,26,021,"Michigan","Berrien County",2,83,661,264,397
050,26,021,"Michigan","Berrien County",2,84,577,232,345
050,26,021,"Michigan","Berrien County",2,85,3476,1273,2203
050,26,021,"Michigan","Berrien County",3,0,1519,763,756
050,26,021,"Michigan","Berrien County",3,1,1627,859,768
050,26,021,"Michigan","Berrien County",3,2,1653,845,808
050,26,021,"Michigan","Berrien County",3,3,1678,889,789
050,26,021,"Michigan","Berrien County",3,4,1738,892,846
050,26,021,"Michigan","Berrien County",3,5,1787,903,884
050,26,021,"Michigan","Berrien County",3,6,1836,936,900
050,26,021,"Michigan","Berrien County",3,7,1876,975,901
050,26,021,"Michigan","Berrien County",3,8,1821,897,924
050,26,021,"Michigan","Berrien County",3,9,1840,928,912
050,26,021,"Michigan","Berrien County",3,10,1854,955,899
050,26,021,"Michigan","Berrien County",3,11,1927,996,931
050,26,021,"Michigan","Berrien County",3,12,1915,981,934
050,26,021,"Michigan","Berrien County",3,13,1978,985,993
050,26,021,"Michigan","Berrien County",3,14,2005,1018,987
050,26,021,"Michigan","Berrien County",3,15,2068,1076,992
050,26,021,"Michigan","Berrien County",3,16,2009,1023,986
050,26,021,"Michigan","Berrien County",3,17,2012,1028,984
050,26,021,"Michigan","Berrien County",3,18,1856,966,890
050,26,021,"Michigan","Berrien County",3,19,1653,858,795
050,26,021,"Michigan","Berrien County",3,20,1760,889,871
050,26,021,"Michigan","Berrien County",3,21,1814,923,891
050,26,021,"Michigan","Berrien County",3,22,1768,865,903
050,26,021,"Michigan","Berrien County",3,23,1698,844,854
050,26,021,"Michigan","Berrien County",3,24,1663,853,810
050,26,021,"Michigan","Berrien County",3,25,1616,808,808
050,26,021,"Michigan","Berrien County",3,26,1667,860,807
050,26,021,"Michigan","Berrien County",3,27,1711,860,851
050,26,021,"Michigan","Berrien County",3,28,1803,909,894
050,26,021,"Michigan","Berrien County",3,29,1864,946,918
050,26,021,"Michigan","Berrien County",3,30,1873,937,936
050,26,021,"Michigan","Berrien County",3,31,1825,936,889
050,26,021,"Michigan","Berrien County",3,32,1759,894,865
050,26,021,"Michigan","Berrien County",3,33,1717,858,859
050,26,021,"Michigan","Berrien County",3,34,1701,813,888
050,26,021,"Michigan","Berrien County",3,35,1805,884,921
050,26,021,"Michigan","Berrien County",3,36,1823,894,929
050,26,021,"Michigan","Berrien County",3,37,1807,889,918
050,26,021,"Michigan","Berrien County",3,38,1840,891,949
050,26,021,"Michigan","Berrien County",3,39,1861,909,952
050,26,021,"Michigan","Berrien County",3,40,1820,887,933
050,26,021,"Michigan","Berrien County",3,41,1825,901,924
050,26,021,"Michigan","Berrien County",3,42,1785,886,899
050,26,021,"Michigan","Berrien County",3,43,1756,885,871
050,26,021,"Michigan","Berrien County",3,44,1737,878,859
050,26,021,"Michigan","Berrien County",3,45,1681,869,812
050,26,021,"Michigan","Berrien County",3,46,1703,850,853
050,26,021,"Michigan","Berrien County",3,47,1652,811,841
050,26,021,"Michigan","Berrien County",3,48,1689,843,846
050,26,021,"Michigan","Berrien County",3,49,1852,935,917
050,26,021,"Michigan","Berrien County",3,50,2003,998,1005
050,26,021,"Michigan","Berrien County",3,51,1975,997,978
050,26,021,"Michigan","Berrien County",3,52,1947,952,995
050,26,021,"Michigan","Berrien County",3,53,1913,919,994
050,26,021,"Michigan","Berrien County",3,54,1984,947,1037
050,26,021,"Michigan","Berrien County",3,55,1965,1002,963
050,26,021,"Michigan","Berrien County",3,56,2048,1016,1032
050,26,021,"Michigan","Berrien County",3,57,2191,1082,1109
050,26,021,"Michigan","Berrien County",3,58,2246,1098,1148
050,26,021,"Michigan","Berrien County",3,59,2310,1153,1157
050,26,021,"Michigan","Berrien County",3,60,2351,1157,1194
050,26,021,"Michigan","Berrien County",3,61,2249,1101,1148
050,26,021,"Michigan","Berrien County",3,62,2251,1117,1134
050,26,021,"Michigan","Berrien County",3,63,2257,1098,1159
050,26,021,"Michigan","Berrien County",3,64,2232,1067,1165
050,26,021,"Michigan","Berrien County",3,65,2224,1088,1136
050,26,021,"Michigan","Berrien County",3,66,2178,1044,1134
050,26,021,"Michigan","Berrien County",3,67,2110,1032,1078
050,26,021,"Michigan","Berrien County",3,68,2056,981,1075
050,26,021,"Michigan","Berrien County",3,69,1936,939,997
050,26,021,"Michigan","Berrien County",3,70,1837,850,987
050,26,021,"Michigan","Berrien County",3,71,1755,822,933
050,26,021,"Michigan","Berrien County",3,72,1676,769,907
050,26,021,"Michigan","Berrien County",3,73,1661,764,897
050,26,021,"Michigan","Berrien County",3,74,1711,818,893
050,26,021,"Michigan","Berrien County",3,75,1164,533,631
050,26,021,"Michigan","Berrien County",3,76,1170,552,618
050,26,021,"Michigan","Berrien County",3,77,1175,552,623
050,26,021,"Michigan","Berrien County",3,78,1178,519,659
050,26,021,"Michigan","Berrien County",3,79,988,444,544
050,26,021,"Michigan","Berrien County",3,80,845,393,452
050,26,021,"Michigan","Berrien County",3,81,768,342,426
050,26,021,"Michigan","Berrien County",3,82,749,316,433
050,26,021,"Michigan","Berrien County",3,83,728,307,421
050,26,021,"Michigan","Berrien County",3,84,583,229,354
050,26,021,"Michigan","Berrien County",3,85,3411,1235,2176
050,26,021,"Michigan","Berrien County",4,0,1596,828,768
050,26,021,"Michigan","Berrien County",4,1,1511,778,733
050,26,021,"Michigan","Berrien County",4,2,1672,872,800
050,26,021,"Michigan","Berrien County",4,3,1647,844,803
050,26,021,"Michigan","Berrien County",4,4,1696,897,799
050,26,021,"Michigan","Berrien County",4,5,1727,880,847
050,26,021,"Michigan","Berrien County",4,6,1802,924,878
050,26,021,"Michigan","Berrien County",4,7,1816,916,900
050,26,021,"Michigan","Berrien County",4,8,1866,954,912
050,26,021,"Michigan","Berrien County",4,9,1845,903,942
050,26,021,"Michigan","Berrien County",4,10,1829,928,901
050,26,021,"Michigan","Berrien County",4,11,1855,953,902
050,26,021,"Michigan","Berrien County",4,12,1918,995,923
050,26,021,"Michigan","Berrien County",4,13,1898,972,926
050,26,021,"Michigan","Berrien County",4,14,1950,976,974
050,26,021,"Michigan","Berrien County",4,15,2019,1025,994
050,26,021,"Michigan","Berrien County",4,16,2061,1075,986
050,26,021,"Michigan","Berrien County",4,17,2005,1018,987
050,26,021,"Michigan","Berrien County",4,18,1834,935,899
050,26,021,"Michigan","Berrien County",4,19,1643,845,798
050,26,021,"Michigan","Berrien County",4,20,1720,874,846
050,26,021,"Michigan","Berrien County",4,21,1778,918,860
050,26,021,"Michigan","Berrien County",4,22,1764,891,873
050,26,021,"Michigan","Berrien County",4,23,1751,875,876
050,26,021,"Michigan","Berrien County",4,24,1653,826,827
050,26,021,"Michigan","Berrien County",4,25,1634,818,816
050,26,021,"Michigan","Berrien County",4,26,1621,798,823
050,26,021,"Michigan","Berrien County",4,27,1638,839,799
050,26,021,"Michigan","Berrien County",4,28,1671,846,825
050,26,021,"Michigan","Berrien County",4,29,1780,896,884
050,26,021,"Michigan","Berrien County",4,30,1855,928,927
050,26,021,"Michigan","Berrien County",4,31,1912,957,955
050,26,021,"Michigan","Berrien County",4,32,1891,969,922
050,26,021,"Michigan","Berrien County",4,33,1748,901,847
050,26,021,"Michigan","Berrien County",4,34,1713,857,856
050,26,021,"Michigan","Berrien County",4,35,1698,809,889
050,26,021,"Michigan","Berrien County",4,36,1829,899,930
050,26,021,"Michigan","Berrien County",4,37,1844,903,941
050,26,021,"Michigan","Berrien County",4,38,1812,887,925
050,26,021,"Michigan","Berrien County",4,39,1845,892,953
050,26,021,"Michigan","Berrien County",4,40,1848,904,944
050,26,021,"Michigan","Berrien County",4,41,1801,871,930
050,26,021,"Michigan","Berrien County",4,42,1826,901,925
050,26,021,"Michigan","Berrien County",4,43,1761,877,884
050,26,021,"Michigan","Berrien County",4,44,1785,916,869
050,26,021,"Michigan","Berrien County",4,45,1722,868,854
050,26,021,"Michigan","Berrien County",4,46,1665,854,811
050,26,021,"Michigan","Berrien County",4,47,1671,818,853
050,26,021,"Michigan","Berrien County",4,48,1636,786,850
050,26,021,"Michigan","Berrien County",4,49,1693,847,846
050,26,021,"Michigan","Berrien County",4,50,1874,940,934
050,26,021,"Michigan","Berrien County",4,51,2001,987,1014
050,26,021,"Michigan","Berrien County",4,52,2001,1001,1000
050,26,021,"Michigan","Berrien County",4,53,1922,942,980
050,26,021,"Michigan","Berrien County",4,54,1900,922,978
050,26,021,"Michigan","Berrien County",4,55,1984,950,1034
050,26,021,"Michigan","Berrien County",4,56,1928,982,946
050,26,021,"Michigan","Berrien County",4,57,2053,1026,1027
050,26,021,"Michigan","Berrien County",4,58,2189,1087,1102
050,26,021,"Michigan","Berrien County",4,59,2248,1100,1148
050,26,021,"Michigan","Berrien County",4,60,2276,1138,1138
050,26,021,"Michigan","Berrien County",4,61,2361,1151,1210
050,26,021,"Michigan","Berrien County",4,62,2237,1101,1136
050,26,021,"Michigan","Berrien County",4,63,2241,1103,1138
050,26,021,"Michigan","Berrien County",4,64,2241,1095,1146
050,26,021,"Michigan","Berrien County",4,65,2213,1045,1168
050,26,021,"Michigan","Berrien County",4,66,2213,1078,1135
050,26,021,"Michigan","Berrien County",4,67,2169,1038,1131
050,26,021,"Michigan","Berrien County",4,68,2073,1018,1055
050,26,021,"Michigan","Berrien County",4,69,1996,952,1044
050,26,021,"Michigan","Berrien County",4,70,1900,913,987
050,26,021,"Michigan","Berrien County",4,71,1791,826,965
050,26,021,"Michigan","Berrien County",4,72,1698,794,904
050,26,021,"Michigan","Berrien County",4,73,1619,735,884
050,26,021,"Michigan","Berrien County",4,74,1648,751,897
050,26,021,"Michigan","Berrien County",4,75,1648,775,873
050,26,021,"Michigan","Berrien County",4,76,1136,513,623
050,26,021,"Michigan","Berrien County",4,77,1126,532,594
050,26,021,"Michigan","Berrien County",4,78,1138,533,605
050,26,021,"Michigan","Berrien County",4,79,1128,499,629
050,26,021,"Michigan","Berrien County",4,80,944,415,529
050,26,021,"Michigan","Berrien County",4,81,773,354,419
050,26,021,"Michigan","Berrien County",4,82,725,310,415
050,26,021,"Michigan","Berrien County",4,83,696,288,408
050,26,021,"Michigan","Berrien County",4,84,655,280,375
050,26,021,"Michigan","Berrien County",4,85,3335,1162,2173
050,26,021,"Michigan","Berrien County",5,0,1569,811,758
050,26,021,"Michigan","Berrien County",5,1,1597,847,750
050,26,021,"Michigan","Berrien County",5,2,1519,773,746
050,26,021,"Michigan","Berrien County",5,3,1670,863,807
050,26,021,"Michigan","Berrien County",5,4,1653,845,808
050,26,021,"Michigan","Berrien County",5,5,1689,895,794
050,26,021,"Michigan","Berrien County",5,6,1712,873,839
050,26,021,"Michigan","Berrien County",5,7,1792,920,872
050,26,021,"Michigan","Berrien County",5,8,1836,935,901
050,26,021,"Michigan","Berrien County",5,9,1830,931,899
050,26,021,"Michigan","Berrien County",5,10,1839,904,935
050,26,021,"Michigan","Berrien County",5,11,1808,918,890
050,26,021,"Michigan","Berrien County",5,12,1841,953,888
050,26,021,"Michigan","Berrien County",5,13,1889,984,905
050,26,021,"Michigan","Berrien County",5,14,1910,985,925
050,26,021,"Michigan","Berrien County",5,15,1967,984,983
050,26,021,"Michigan","Berrien County",5,16,2010,1028,982
050,26,021,"Michigan","Berrien County",5,17,2050,1068,982
050,26,021,"Michigan","Berrien County",5,18,1829,946,883
050,26,021,"Michigan","Berrien County",5,19,1653,840,813
050,26,021,"Michigan","Berrien County",5,20,1699,862,837
050,26,021,"Michigan","Berrien County",5,21,1743,881,862
050,26,021,"Michigan","Berrien County",5,22,1719,857,862
050,26,021,"Michigan","Berrien County",5,23,1730,885,845
050,26,021,"Michigan","Berrien County",5,24,1750,885,865
050,26,021,"Michigan","Berrien County",5,25,1598,806,792
050,26,021,"Michigan","Berrien County",5,26,1612,826,786
050,26,021,"Michigan","Berrien County",5,27,1608,782,826
050,26,021,"Michigan","Berrien County",5,28,1621,833,788
050,26,021,"Michigan","Berrien County",5,29,1679,853,826
050,26,021,"Michigan","Berrien County",5,30,1760,895,865
050,26,021,"Michigan","Berrien County",5,31,1869,938,931
050,26,021,"Michigan","Berrien County",5,32,1923,957,966
050,26,021,"Michigan","Berrien County",5,33,1908,979,929
050,26,021,"Michigan","Berrien County",5,34,1746,892,854
050,26,021,"Michigan","Berrien County",5,35,1720,864,856
050,26,021,"Michigan","Berrien County",5,36,1701,816,885
050,26,021,"Michigan","Berrien County",5,37,1844,908,936
050,26,021,"Michigan","Berrien County",5,38,1827,905,922
050,26,021,"Michigan","Berrien County",5,39,1823,901,922
050,26,021,"Michigan","Berrien County",5,40,1842,883,959
050,26,021,"Michigan","Berrien County",5,41,1874,930,944
050,26,021,"Michigan","Berrien County",5,42,1795,861,934
050,26,021,"Michigan","Berrien County",5,43,1812,891,921
050,26,021,"Michigan","Berrien County",5,44,1772,881,891
050,26,021,"Michigan","Berrien County",5,45,1772,913,859
050,26,021,"Michigan","Berrien County",5,46,1697,865,832
050,26,021,"Michigan","Berrien County",5,47,1661,853,808
050,26,021,"Michigan","Berrien County",5,48,1659,806,853
050,26,021,"Michigan","Berrien County",5,49,1587,760,827
050,26,021,"Michigan","Berrien County",5,50,1690,838,852
050,26,021,"Michigan","Berrien County",5,51,1853,918,935
050,26,021,"Michigan","Berrien County",5,52,1999,974,1025
050,26,021,"Michigan","Berrien County",5,53,1968,990,978
050,26,021,"Michigan","Berrien County",5,54,1911,928,983
050,26,021,"Michigan","Berrien County",5,55,1904,934,970
050,26,021,"Michigan","Berrien County",5,56,1983,944,1039
050,26,021,"Michigan","Berrien County",5,57,1934,980,954
050,26,021,"Michigan","Berrien County",5,58,2040,1022,1018
050,26,021,"Michigan","Berrien County",5,59,2169,1065,1104
050,26,021,"Michigan","Berrien County",5,60,2224,1078,1146
050,26,021,"Michigan","Berrien County",5,61,2260,1127,1133
050,26,021,"Michigan","Berrien County",5,62,2322,1128,1194
050,26,021,"Michigan","Berrien County",5,63,2240,1087,1153
050,26,021,"Michigan","Berrien County",5,64,2241,1114,1127
050,26,021,"Michigan","Berrien County",5,65,2205,1058,1147
050,26,021,"Michigan","Berrien County",5,66,2187,1033,1154
050,26,021,"Michigan","Berrien County",5,67,2201,1077,1124
050,26,021,"Michigan","Berrien County",5,68,2156,1031,1125
050,26,021,"Michigan","Berrien County",5,69,2047,1006,1041
050,26,021,"Michigan","Berrien County",5,70,1968,940,1028
050,26,021,"Michigan","Berrien County",5,71,1882,896,986
050,26,021,"Michigan","Berrien County",5,72,1732,793,939
050,26,021,"Michigan","Berrien County",5,73,1634,759,875
050,26,021,"Michigan","Berrien County",5,74,1616,726,890
050,26,021,"Michigan","Berrien County",5,75,1581,711,870
050,26,021,"Michigan","Berrien County",5,76,1610,756,854
050,26,021,"Michigan","Berrien County",5,77,1094,491,603
050,26,021,"Michigan","Berrien County",5,78,1093,512,581
050,26,021,"Michigan","Berrien County",5,79,1085,511,574
050,26,021,"Michigan","Berrien County",5,80,1095,479,616
050,26,021,"Michigan","Berrien County",5,81,883,386,497
050,26,021,"Michigan","Berrien County",5,82,743,334,409
050,26,021,"Michigan","Berrien County",5,83,671,280,391
050,26,021,"Michigan","Berrien County",5,84,622,258,364
050,26,021,"Michigan","Berrien County",5,85,3404,1191,2213
050,26,023,"Michigan","Branch County",1,0,582,302,280
050,26,023,"Michigan","Branch County",1,1,568,291,277
050,26,023,"Michigan","Branch County",1,2,533,293,240
050,26,023,"Michigan","Branch County",1,3,553,277,276
050,26,023,"Michigan","Branch County",1,4,544,257,287
050,26,023,"Michigan","Branch County",1,5,546,295,251
050,26,023,"Michigan","Branch County",1,6,552,288,264
050,26,023,"Michigan","Branch County",1,7,547,290,257
050,26,023,"Michigan","Branch County",1,8,535,269,266
050,26,023,"Michigan","Branch County",1,9,585,292,293
050,26,023,"Michigan","Branch County",1,10,598,305,293
050,26,023,"Michigan","Branch County",1,11,629,331,298
050,26,023,"Michigan","Branch County",1,12,633,317,316
050,26,023,"Michigan","Branch County",1,13,688,337,351
050,26,023,"Michigan","Branch County",1,14,626,318,308
050,26,023,"Michigan","Branch County",1,15,605,302,303
050,26,023,"Michigan","Branch County",1,16,613,312,301
050,26,023,"Michigan","Branch County",1,17,613,321,292
050,26,023,"Michigan","Branch County",1,18,522,275,247
050,26,023,"Michigan","Branch County",1,19,438,240,198
050,26,023,"Michigan","Branch County",1,20,452,251,201
050,26,023,"Michigan","Branch County",1,21,470,261,209
050,26,023,"Michigan","Branch County",1,22,479,276,203
050,26,023,"Michigan","Branch County",1,23,493,265,228
050,26,023,"Michigan","Branch County",1,24,489,263,226
050,26,023,"Michigan","Branch County",1,25,537,275,262
050,26,023,"Michigan","Branch County",1,26,528,285,243
050,26,023,"Michigan","Branch County",1,27,533,293,240
050,26,023,"Michigan","Branch County",1,28,539,289,250
050,26,023,"Michigan","Branch County",1,29,553,299,254
050,26,023,"Michigan","Branch County",1,30,534,295,239
050,26,023,"Michigan","Branch County",1,31,499,265,234
050,26,023,"Michigan","Branch County",1,32,480,261,219
050,26,023,"Michigan","Branch County",1,33,506,270,236
050,26,023,"Michigan","Branch County",1,34,551,288,263
050,26,023,"Michigan","Branch County",1,35,556,300,256
050,26,023,"Michigan","Branch County",1,36,576,325,251
050,26,023,"Michigan","Branch County",1,37,564,306,258
050,26,023,"Michigan","Branch County",1,38,562,310,252
050,26,023,"Michigan","Branch County",1,39,594,345,249
050,26,023,"Michigan","Branch County",1,40,548,332,216
050,26,023,"Michigan","Branch County",1,41,518,285,233
050,26,023,"Michigan","Branch County",1,42,524,285,239
050,26,023,"Michigan","Branch County",1,43,486,259,227
050,26,023,"Michigan","Branch County",1,44,496,285,211
050,26,023,"Michigan","Branch County",1,45,503,288,215
050,26,023,"Michigan","Branch County",1,46,517,304,213
050,26,023,"Michigan","Branch County",1,47,530,303,227
050,26,023,"Michigan","Branch County",1,48,573,322,251
050,26,023,"Michigan","Branch County",1,49,591,308,283
050,26,023,"Michigan","Branch County",1,50,587,315,272
050,26,023,"Michigan","Branch County",1,51,539,292,247
050,26,023,"Michigan","Branch County",1,52,549,321,228
050,26,023,"Michigan","Branch County",1,53,546,294,252
050,26,023,"Michigan","Branch County",1,54,539,286,253
050,26,023,"Michigan","Branch County",1,55,601,322,279
050,26,023,"Michigan","Branch County",1,56,634,336,298
050,26,023,"Michigan","Branch County",1,57,667,349,318
050,26,023,"Michigan","Branch County",1,58,678,360,318
050,26,023,"Michigan","Branch County",1,59,684,340,344
050,26,023,"Michigan","Branch County",1,60,660,337,323
050,26,023,"Michigan","Branch County",1,61,668,333,335
050,26,023,"Michigan","Branch County",1,62,683,334,349
050,26,023,"Michigan","Branch County",1,63,665,346,319
050,26,023,"Michigan","Branch County",1,64,604,313,291
050,26,023,"Michigan","Branch County",1,65,602,317,285
050,26,023,"Michigan","Branch County",1,66,592,299,293
050,26,023,"Michigan","Branch County",1,67,577,306,271
050,26,023,"Michigan","Branch County",1,68,549,289,260
050,26,023,"Michigan","Branch County",1,69,498,249,249
050,26,023,"Michigan","Branch County",1,70,460,222,238
050,26,023,"Michigan","Branch County",1,71,449,216,233
050,26,023,"Michigan","Branch County",1,72,485,229,256
050,26,023,"Michigan","Branch County",1,73,461,227,234
050,26,023,"Michigan","Branch County",1,74,331,151,180
050,26,023,"Michigan","Branch County",1,75,324,140,184
050,26,023,"Michigan","Branch County",1,76,335,159,176
050,26,023,"Michigan","Branch County",1,77,309,138,171
050,26,023,"Michigan","Branch County",1,78,280,127,153
050,26,023,"Michigan","Branch County",1,79,269,125,144
050,26,023,"Michigan","Branch County",1,80,238,109,129
050,26,023,"Michigan","Branch County",1,81,209,87,122
050,26,023,"Michigan","Branch County",1,82,200,89,111
050,26,023,"Michigan","Branch County",1,83,170,73,97
050,26,023,"Michigan","Branch County",1,84,169,69,100
050,26,023,"Michigan","Branch County",1,85,771,257,514
050,26,023,"Michigan","Branch County",2,0,594,298,296
050,26,023,"Michigan","Branch County",2,1,567,292,275
050,26,023,"Michigan","Branch County",2,2,541,293,248
050,26,023,"Michigan","Branch County",2,3,542,277,265
050,26,023,"Michigan","Branch County",2,4,548,264,284
050,26,023,"Michigan","Branch County",2,5,546,286,260
050,26,023,"Michigan","Branch County",2,6,551,291,260
050,26,023,"Michigan","Branch County",2,7,548,289,259
050,26,023,"Michigan","Branch County",2,8,542,275,267
050,26,023,"Michigan","Branch County",2,9,572,287,285
050,26,023,"Michigan","Branch County",2,10,593,302,291
050,26,023,"Michigan","Branch County",2,11,622,325,297
050,26,023,"Michigan","Branch County",2,12,638,323,315
050,26,023,"Michigan","Branch County",2,13,676,333,343
050,26,023,"Michigan","Branch County",2,14,640,321,319
050,26,023,"Michigan","Branch County",2,15,610,306,304
050,26,023,"Michigan","Branch County",2,16,613,311,302
050,26,023,"Michigan","Branch County",2,17,612,317,295
050,26,023,"Michigan","Branch County",2,18,519,277,242
050,26,023,"Michigan","Branch County",2,19,434,235,199
050,26,023,"Michigan","Branch County",2,20,464,256,208
050,26,023,"Michigan","Branch County",2,21,474,265,209
050,26,023,"Michigan","Branch County",2,22,483,275,208
050,26,023,"Michigan","Branch County",2,23,489,267,222
050,26,023,"Michigan","Branch County",2,24,491,264,227
050,26,023,"Michigan","Branch County",2,25,526,274,252
050,26,023,"Michigan","Branch County",2,26,531,284,247
050,26,023,"Michigan","Branch County",2,27,534,291,243
050,26,023,"Michigan","Branch County",2,28,535,287,248
050,26,023,"Michigan","Branch County",2,29,553,300,253
050,26,023,"Michigan","Branch County",2,30,541,295,246
050,26,023,"Michigan","Branch County",2,31,510,278,232
050,26,023,"Michigan","Branch County",2,32,484,260,224
050,26,023,"Michigan","Branch County",2,33,503,269,234
050,26,023,"Michigan","Branch County",2,34,542,285,257
050,26,023,"Michigan","Branch County",2,35,554,297,257
050,26,023,"Michigan","Branch County",2,36,569,321,248
050,26,023,"Michigan","Branch County",2,37,567,312,255
050,26,023,"Michigan","Branch County",2,38,561,308,253
050,26,023,"Michigan","Branch County",2,39,586,339,247
050,26,023,"Michigan","Branch County",2,40,560,333,227
050,26,023,"Michigan","Branch County",2,41,524,297,227
050,26,023,"Michigan","Branch County",2,42,515,280,235
050,26,023,"Michigan","Branch County",2,43,495,264,231
050,26,023,"Michigan","Branch County",2,44,491,277,214
050,26,023,"Michigan","Branch County",2,45,503,287,216
050,26,023,"Michigan","Branch County",2,46,513,300,213
050,26,023,"Michigan","Branch County",2,47,524,301,223
050,26,023,"Michigan","Branch County",2,48,560,315,245
050,26,023,"Michigan","Branch County",2,49,588,312,276
050,26,023,"Michigan","Branch County",2,50,586,312,274
050,26,023,"Michigan","Branch County",2,51,550,299,251
050,26,023,"Michigan","Branch County",2,52,547,316,231
050,26,023,"Michigan","Branch County",2,53,545,298,247
050,26,023,"Michigan","Branch County",2,54,543,290,253
050,26,023,"Michigan","Branch County",2,55,582,310,272
050,26,023,"Michigan","Branch County",2,56,626,337,289
050,26,023,"Michigan","Branch County",2,57,660,345,315
050,26,023,"Michigan","Branch County",2,58,681,361,320
050,26,023,"Michigan","Branch County",2,59,686,344,342
050,26,023,"Michigan","Branch County",2,60,660,333,327
050,26,023,"Michigan","Branch County",2,61,661,332,329
050,26,023,"Michigan","Branch County",2,62,675,331,344
050,26,023,"Michigan","Branch County",2,63,676,348,328
050,26,023,"Michigan","Branch County",2,64,611,315,296
050,26,023,"Michigan","Branch County",2,65,599,314,285
050,26,023,"Michigan","Branch County",2,66,594,301,293
050,26,023,"Michigan","Branch County",2,67,579,304,275
050,26,023,"Michigan","Branch County",2,68,549,288,261
050,26,023,"Michigan","Branch County",2,69,510,257,253
050,26,023,"Michigan","Branch County",2,70,465,225,240
050,26,023,"Michigan","Branch County",2,71,445,211,234
050,26,023,"Michigan","Branch County",2,72,467,222,245
050,26,023,"Michigan","Branch County",2,73,483,232,251
050,26,023,"Michigan","Branch County",2,74,338,158,180
050,26,023,"Michigan","Branch County",2,75,320,136,184
050,26,023,"Michigan","Branch County",2,76,325,152,173
050,26,023,"Michigan","Branch County",2,77,322,144,178
050,26,023,"Michigan","Branch County",2,78,277,123,154
050,26,023,"Michigan","Branch County",2,79,268,124,144
050,26,023,"Michigan","Branch County",2,80,239,109,130
050,26,023,"Michigan","Branch County",2,81,213,91,122
050,26,023,"Michigan","Branch County",2,82,200,86,114
050,26,023,"Michigan","Branch County",2,83,176,76,100
050,26,023,"Michigan","Branch County",2,84,165,68,97
050,26,023,"Michigan","Branch County",2,85,783,264,519
050,26,023,"Michigan","Branch County",3,0,583,316,267
050,26,023,"Michigan","Branch County",3,1,593,300,293
050,26,023,"Michigan","Branch County",3,2,569,303,266
050,26,023,"Michigan","Branch County",3,3,558,295,263
050,26,023,"Michigan","Branch County",3,4,551,278,273
050,26,023,"Michigan","Branch County",3,5,563,261,302
050,26,023,"Michigan","Branch County",3,6,562,294,268
050,26,023,"Michigan","Branch County",3,7,551,289,262
050,26,023,"Michigan","Branch County",3,8,570,292,278
050,26,023,"Michigan","Branch County",3,9,550,281,269
050,26,023,"Michigan","Branch County",3,10,554,276,278
050,26,023,"Michigan","Branch County",3,11,602,311,291
050,26,023,"Michigan","Branch County",3,12,632,336,296
050,26,023,"Michigan","Branch County",3,13,639,313,326
050,26,023,"Michigan","Branch County",3,14,674,332,342
050,26,023,"Michigan","Branch County",3,15,649,331,318
050,26,023,"Michigan","Branch County",3,16,620,313,307
050,26,023,"Michigan","Branch County",3,17,627,314,313
050,26,023,"Michigan","Branch County",3,18,538,295,243
050,26,023,"Michigan","Branch County",3,19,420,224,196
050,26,023,"Michigan","Branch County",3,20,469,255,214
050,26,023,"Michigan","Branch County",3,21,496,275,221
050,26,023,"Michigan","Branch County",3,22,505,278,227
050,26,023,"Michigan","Branch County",3,23,510,278,232
050,26,023,"Michigan","Branch County",3,24,505,275,230
050,26,023,"Michigan","Branch County",3,25,499,268,231
050,26,023,"Michigan","Branch County",3,26,552,293,259
050,26,023,"Michigan","Branch County",3,27,541,294,247
050,26,023,"Michigan","Branch County",3,28,519,276,243
050,26,023,"Michigan","Branch County",3,29,552,301,251
050,26,023,"Michigan","Branch County",3,30,562,298,264
050,26,023,"Michigan","Branch County",3,31,537,290,247
050,26,023,"Michigan","Branch County",3,32,508,280,228
050,26,023,"Michigan","Branch County",3,33,482,257,225
050,26,023,"Michigan","Branch County",3,34,510,287,223
050,26,023,"Michigan","Branch County",3,35,541,286,255
050,26,023,"Michigan","Branch County",3,36,573,310,263
050,26,023,"Michigan","Branch County",3,37,592,338,254
050,26,023,"Michigan","Branch County",3,38,563,299,264
050,26,023,"Michigan","Branch County",3,39,578,329,249
050,26,023,"Michigan","Branch County",3,40,584,339,245
050,26,023,"Michigan","Branch County",3,41,579,345,234
050,26,023,"Michigan","Branch County",3,42,530,303,227
050,26,023,"Michigan","Branch County",3,43,531,285,246
050,26,023,"Michigan","Branch County",3,44,501,276,225
050,26,023,"Michigan","Branch County",3,45,501,281,220
050,26,023,"Michigan","Branch County",3,46,509,302,207
050,26,023,"Michigan","Branch County",3,47,495,291,204
050,26,023,"Michigan","Branch County",3,48,520,304,216
050,26,023,"Michigan","Branch County",3,49,559,309,250
050,26,023,"Michigan","Branch County",3,50,600,322,278
050,26,023,"Michigan","Branch County",3,51,587,313,274
050,26,023,"Michigan","Branch County",3,52,550,294,256
050,26,023,"Michigan","Branch County",3,53,533,303,230
050,26,023,"Michigan","Branch County",3,54,552,302,250
050,26,023,"Michigan","Branch County",3,55,518,272,246
050,26,023,"Michigan","Branch County",3,56,578,313,265
050,26,023,"Michigan","Branch County",3,57,615,311,304
050,26,023,"Michigan","Branch County",3,58,676,354,322
050,26,023,"Michigan","Branch County",3,59,676,352,324
050,26,023,"Michigan","Branch County",3,60,687,342,345
050,26,023,"Michigan","Branch County",3,61,669,342,327
050,26,023,"Michigan","Branch County",3,62,652,328,324
050,26,023,"Michigan","Branch County",3,63,682,335,347
050,26,023,"Michigan","Branch County",3,64,667,340,327
050,26,023,"Michigan","Branch County",3,65,612,318,294
050,26,023,"Michigan","Branch County",3,66,587,299,288
050,26,023,"Michigan","Branch County",3,67,579,301,278
050,26,023,"Michigan","Branch County",3,68,567,291,276
050,26,023,"Michigan","Branch County",3,69,536,279,257
050,26,023,"Michigan","Branch County",3,70,504,250,254
050,26,023,"Michigan","Branch County",3,71,441,211,230
050,26,023,"Michigan","Branch County",3,72,441,206,235
050,26,023,"Michigan","Branch County",3,73,457,215,242
050,26,023,"Michigan","Branch County",3,74,469,232,237
050,26,023,"Michigan","Branch County",3,75,314,141,173
050,26,023,"Michigan","Branch County",3,76,306,135,171
050,26,023,"Michigan","Branch County",3,77,305,142,163
050,26,023,"Michigan","Branch County",3,78,321,141,180
050,26,023,"Michigan","Branch County",3,79,260,118,142
050,26,023,"Michigan","Branch County",3,80,242,110,132
050,26,023,"Michigan","Branch County",3,81,222,101,121
050,26,023,"Michigan","Branch County",3,82,204,85,119
050,26,023,"Michigan","Branch County",3,83,176,75,101
050,26,023,"Michigan","Branch County",3,84,144,60,84
050,26,023,"Michigan","Branch County",3,85,778,260,518
050,26,023,"Michigan","Branch County",4,0,563,287,276
050,26,023,"Michigan","Branch County",4,1,588,323,265
050,26,023,"Michigan","Branch County",4,2,583,297,286
050,26,023,"Michigan","Branch County",4,3,564,302,262
050,26,023,"Michigan","Branch County",4,4,550,301,249
050,26,023,"Michigan","Branch County",4,5,541,274,267
050,26,023,"Michigan","Branch County",4,6,542,260,282
050,26,023,"Michigan","Branch County",4,7,567,291,276
050,26,023,"Michigan","Branch County",4,8,554,293,261
050,26,023,"Michigan","Branch County",4,9,583,297,286
050,26,023,"Michigan","Branch County",4,10,552,288,264
050,26,023,"Michigan","Branch County",4,11,558,281,277
050,26,023,"Michigan","Branch County",4,12,599,309,290
050,26,023,"Michigan","Branch County",4,13,634,333,301
050,26,023,"Michigan","Branch County",4,14,656,325,331
050,26,023,"Michigan","Branch County",4,15,666,324,342
050,26,023,"Michigan","Branch County",4,16,658,331,327
050,26,023,"Michigan","Branch County",4,17,617,304,313
050,26,023,"Michigan","Branch County",4,18,528,277,251
050,26,023,"Michigan","Branch County",4,19,405,220,185
050,26,023,"Michigan","Branch County",4,20,431,226,205
050,26,023,"Michigan","Branch County",4,21,481,257,224
050,26,023,"Michigan","Branch County",4,22,535,285,250
050,26,023,"Michigan","Branch County",4,23,522,284,238
050,26,023,"Michigan","Branch County",4,24,485,248,237
050,26,023,"Michigan","Branch County",4,25,509,276,233
050,26,023,"Michigan","Branch County",4,26,467,250,217
050,26,023,"Michigan","Branch County",4,27,530,280,250
050,26,023,"Michigan","Branch County",4,28,512,268,244
050,26,023,"Michigan","Branch County",4,29,492,252,240
050,26,023,"Michigan","Branch County",4,30,533,287,246
050,26,023,"Michigan","Branch County",4,31,547,280,267
050,26,023,"Michigan","Branch County",4,32,505,264,241
050,26,023,"Michigan","Branch County",4,33,501,275,226
050,26,023,"Michigan","Branch County",4,34,466,242,224
050,26,023,"Michigan","Branch County",4,35,487,261,226
050,26,023,"Michigan","Branch County",4,36,529,276,253
050,26,023,"Michigan","Branch County",4,37,549,287,262
050,26,023,"Michigan","Branch County",4,38,573,315,258
050,26,023,"Michigan","Branch County",4,39,546,289,257
050,26,023,"Michigan","Branch County",4,40,562,311,251
050,26,023,"Michigan","Branch County",4,41,586,330,256
050,26,023,"Michigan","Branch County",4,42,574,338,236
050,26,023,"Michigan","Branch County",4,43,511,281,230
050,26,023,"Michigan","Branch County",4,44,514,268,246
050,26,023,"Michigan","Branch County",4,45,488,262,226
050,26,023,"Michigan","Branch County",4,46,485,257,228
050,26,023,"Michigan","Branch County",4,47,468,259,209
050,26,023,"Michigan","Branch County",4,48,492,281,211
050,26,023,"Michigan","Branch County",4,49,496,283,213
050,26,023,"Michigan","Branch County",4,50,554,297,257
050,26,023,"Michigan","Branch County",4,51,578,306,272
050,26,023,"Michigan","Branch County",4,52,571,300,271
050,26,023,"Michigan","Branch County",4,53,523,283,240
050,26,023,"Michigan","Branch County",4,54,527,291,236
050,26,023,"Michigan","Branch County",4,55,542,292,250
050,26,023,"Michigan","Branch County",4,56,509,264,245
050,26,023,"Michigan","Branch County",4,57,561,286,275
050,26,023,"Michigan","Branch County",4,58,617,319,298
050,26,023,"Michigan","Branch County",4,59,650,326,324
050,26,023,"Michigan","Branch County",4,60,676,347,329
050,26,023,"Michigan","Branch County",4,61,686,340,346
050,26,023,"Michigan","Branch County",4,62,653,328,325
050,26,023,"Michigan","Branch County",4,63,642,322,320
050,26,023,"Michigan","Branch County",4,64,680,330,350
050,26,023,"Michigan","Branch County",4,65,666,343,323
050,26,023,"Michigan","Branch County",4,66,596,298,298
050,26,023,"Michigan","Branch County",4,67,582,300,282
050,26,023,"Michigan","Branch County",4,68,557,283,274
050,26,023,"Michigan","Branch County",4,69,546,277,269
050,26,023,"Michigan","Branch County",4,70,523,267,256
050,26,023,"Michigan","Branch County",4,71,483,240,243
050,26,023,"Michigan","Branch County",4,72,428,200,228
050,26,023,"Michigan","Branch County",4,73,428,200,228
050,26,023,"Michigan","Branch County",4,74,439,212,227
050,26,023,"Michigan","Branch County",4,75,439,217,222
050,26,023,"Michigan","Branch County",4,76,300,142,158
050,26,023,"Michigan","Branch County",4,77,294,130,164
050,26,023,"Michigan","Branch County",4,78,300,136,164
050,26,023,"Michigan","Branch County",4,79,307,136,171
050,26,023,"Michigan","Branch County",4,80,234,102,132
050,26,023,"Michigan","Branch County",4,81,217,100,117
050,26,023,"Michigan","Branch County",4,82,216,95,121
050,26,023,"Michigan","Branch County",4,83,183,76,107
050,26,023,"Michigan","Branch County",4,84,150,58,92
050,26,023,"Michigan","Branch County",4,85,761,254,507
050,26,023,"Michigan","Branch County",5,0,531,269,262
050,26,023,"Michigan","Branch County",5,1,578,297,281
050,26,023,"Michigan","Branch County",5,2,602,328,274
050,26,023,"Michigan","Branch County",5,3,593,306,287
050,26,023,"Michigan","Branch County",5,4,567,305,262
050,26,023,"Michigan","Branch County",5,5,556,298,258
050,26,023,"Michigan","Branch County",5,6,541,274,267
050,26,023,"Michigan","Branch County",5,7,562,272,290
050,26,023,"Michigan","Branch County",5,8,562,289,273
050,26,023,"Michigan","Branch County",5,9,550,282,268
050,26,023,"Michigan","Branch County",5,10,585,306,279
050,26,023,"Michigan","Branch County",5,11,562,303,259
050,26,023,"Michigan","Branch County",5,12,553,281,272
050,26,023,"Michigan","Branch County",5,13,605,312,293
050,26,023,"Michigan","Branch County",5,14,635,337,298
050,26,023,"Michigan","Branch County",5,15,649,322,327
050,26,023,"Michigan","Branch County",5,16,669,327,342
050,26,023,"Michigan","Branch County",5,17,647,325,322
050,26,023,"Michigan","Branch County",5,18,520,272,248
050,26,023,"Michigan","Branch County",5,19,418,225,193
050,26,023,"Michigan","Branch County",5,20,443,237,206
050,26,023,"Michigan","Branch County",5,21,457,241,216
050,26,023,"Michigan","Branch County",5,22,544,300,244
050,26,023,"Michigan","Branch County",5,23,575,312,263
050,26,023,"Michigan","Branch County",5,24,532,300,232
050,26,023,"Michigan","Branch County",5,25,506,273,233
050,26,023,"Michigan","Branch County",5,26,529,290,239
050,26,023,"Michigan","Branch County",5,27,491,273,218
050,26,023,"Michigan","Branch County",5,28,543,293,250
050,26,023,"Michigan","Branch County",5,29,530,287,243
050,26,023,"Michigan","Branch County",5,30,494,257,237
050,26,023,"Michigan","Branch County",5,31,568,312,256
050,26,023,"Michigan","Branch County",5,32,557,303,254
050,26,023,"Michigan","Branch County",5,33,524,283,241
050,26,023,"Michigan","Branch County",5,34,510,284,226
050,26,023,"Michigan","Branch County",5,35,491,261,230
050,26,023,"Michigan","Branch County",5,36,510,281,229
050,26,023,"Michigan","Branch County",5,37,533,290,243
050,26,023,"Michigan","Branch County",5,38,569,308,261
050,26,023,"Michigan","Branch County",5,39,579,329,250
050,26,023,"Michigan","Branch County",5,40,557,302,255
050,26,023,"Michigan","Branch County",5,41,575,319,256
050,26,023,"Michigan","Branch County",5,42,606,351,255
050,26,023,"Michigan","Branch County",5,43,593,353,240
050,26,023,"Michigan","Branch County",5,44,543,316,227
050,26,023,"Michigan","Branch County",5,45,527,285,242
050,26,023,"Michigan","Branch County",5,46,510,283,227
050,26,023,"Michigan","Branch County",5,47,488,259,229
050,26,023,"Michigan","Branch County",5,48,491,275,216
050,26,023,"Michigan","Branch County",5,49,510,291,219
050,26,023,"Michigan","Branch County",5,50,517,303,214
050,26,023,"Michigan","Branch County",5,51,554,308,246
050,26,023,"Michigan","Branch County",5,52,598,318,280
050,26,023,"Michigan","Branch County",5,53,572,306,266
050,26,023,"Michigan","Branch County",5,54,533,297,236
050,26,023,"Michigan","Branch County",5,55,540,298,242
050,26,023,"Michigan","Branch County",5,56,556,305,251
050,26,023,"Michigan","Branch County",5,57,506,255,251
050,26,023,"Michigan","Branch County",5,58,565,302,263
050,26,023,"Michigan","Branch County",5,59,623,327,296
050,26,023,"Michigan","Branch County",5,60,654,327,327
050,26,023,"Michigan","Branch County",5,61,668,350,318
050,26,023,"Michigan","Branch County",5,62,681,341,340
050,26,023,"Michigan","Branch County",5,63,642,329,313
050,26,023,"Michigan","Branch County",5,64,641,322,319
050,26,023,"Michigan","Branch County",5,65,685,332,353
050,26,023,"Michigan","Branch County",5,66,666,334,332
050,26,023,"Michigan","Branch County",5,67,594,307,287
050,26,023,"Michigan","Branch County",5,68,574,292,282
050,26,023,"Michigan","Branch County",5,69,554,278,276
050,26,023,"Michigan","Branch County",5,70,541,271,270
050,26,023,"Michigan","Branch County",5,71,516,264,252
050,26,023,"Michigan","Branch County",5,72,469,231,238
050,26,023,"Michigan","Branch County",5,73,416,193,223
050,26,023,"Michigan","Branch County",5,74,412,197,215
050,26,023,"Michigan","Branch County",5,75,421,203,218
050,26,023,"Michigan","Branch County",5,76,423,216,207
050,26,023,"Michigan","Branch County",5,77,293,136,157
050,26,023,"Michigan","Branch County",5,78,286,126,160
050,26,023,"Michigan","Branch County",5,79,294,135,159
050,26,023,"Michigan","Branch County",5,80,282,123,159
050,26,023,"Michigan","Branch County",5,81,209,92,117
050,26,023,"Michigan","Branch County",5,82,213,93,120
050,26,023,"Michigan","Branch County",5,83,200,86,114
050,26,023,"Michigan","Branch County",5,84,160,62,98
050,26,023,"Michigan","Branch County",5,85,787,262,525
050,26,025,"Michigan","Calhoun County",1,0,1499,775,724
050,26,025,"Michigan","Calhoun County",1,1,1538,786,752
050,26,025,"Michigan","Calhoun County",1,2,1557,792,765
050,26,025,"Michigan","Calhoun County",1,3,1660,852,808
050,26,025,"Michigan","Calhoun County",1,4,1718,878,840
050,26,025,"Michigan","Calhoun County",1,5,1729,896,833
050,26,025,"Michigan","Calhoun County",1,6,1754,909,845
050,26,025,"Michigan","Calhoun County",1,7,1722,902,820
050,26,025,"Michigan","Calhoun County",1,8,1650,856,794
050,26,025,"Michigan","Calhoun County",1,9,1659,861,798
050,26,025,"Michigan","Calhoun County",1,10,1717,889,828
050,26,025,"Michigan","Calhoun County",1,11,1813,924,889
050,26,025,"Michigan","Calhoun County",1,12,1920,978,942
050,26,025,"Michigan","Calhoun County",1,13,1862,955,907
050,26,025,"Michigan","Calhoun County",1,14,1812,953,859
050,26,025,"Michigan","Calhoun County",1,15,1816,965,851
050,26,025,"Michigan","Calhoun County",1,16,1862,987,875
050,26,025,"Michigan","Calhoun County",1,17,1853,1020,833
050,26,025,"Michigan","Calhoun County",1,18,1703,910,793
050,26,025,"Michigan","Calhoun County",1,19,1661,852,809
050,26,025,"Michigan","Calhoun County",1,20,1667,838,829
050,26,025,"Michigan","Calhoun County",1,21,1581,826,755
050,26,025,"Michigan","Calhoun County",1,22,1562,791,771
050,26,025,"Michigan","Calhoun County",1,23,1547,778,769
050,26,025,"Michigan","Calhoun County",1,24,1599,783,816
050,26,025,"Michigan","Calhoun County",1,25,1665,832,833
050,26,025,"Michigan","Calhoun County",1,26,1646,808,838
050,26,025,"Michigan","Calhoun County",1,27,1699,828,871
050,26,025,"Michigan","Calhoun County",1,28,1749,873,876
050,26,025,"Michigan","Calhoun County",1,29,1777,857,920
050,26,025,"Michigan","Calhoun County",1,30,1758,853,905
050,26,025,"Michigan","Calhoun County",1,31,1582,772,810
050,26,025,"Michigan","Calhoun County",1,32,1578,782,796
050,26,025,"Michigan","Calhoun County",1,33,1521,745,776
050,26,025,"Michigan","Calhoun County",1,34,1593,758,835
050,26,025,"Michigan","Calhoun County",1,35,1589,766,823
050,26,025,"Michigan","Calhoun County",1,36,1537,782,755
050,26,025,"Michigan","Calhoun County",1,37,1634,811,823
050,26,025,"Michigan","Calhoun County",1,38,1700,845,855
050,26,025,"Michigan","Calhoun County",1,39,1707,835,872
050,26,025,"Michigan","Calhoun County",1,40,1678,825,853
050,26,025,"Michigan","Calhoun County",1,41,1635,794,841
050,26,025,"Michigan","Calhoun County",1,42,1565,796,769
050,26,025,"Michigan","Calhoun County",1,43,1535,755,780
050,26,025,"Michigan","Calhoun County",1,44,1453,703,750
050,26,025,"Michigan","Calhoun County",1,45,1462,730,732
050,26,025,"Michigan","Calhoun County",1,46,1559,765,794
050,26,025,"Michigan","Calhoun County",1,47,1591,776,815
050,26,025,"Michigan","Calhoun County",1,48,1673,823,850
050,26,025,"Michigan","Calhoun County",1,49,1765,882,883
050,26,025,"Michigan","Calhoun County",1,50,1751,870,881
050,26,025,"Michigan","Calhoun County",1,51,1720,857,863
050,26,025,"Michigan","Calhoun County",1,52,1681,826,855
050,26,025,"Michigan","Calhoun County",1,53,1631,826,805
050,26,025,"Michigan","Calhoun County",1,54,1673,842,831
050,26,025,"Michigan","Calhoun County",1,55,1764,887,877
050,26,025,"Michigan","Calhoun County",1,56,1830,909,921
050,26,025,"Michigan","Calhoun County",1,57,1896,957,939
050,26,025,"Michigan","Calhoun County",1,58,1920,941,979
050,26,025,"Michigan","Calhoun County",1,59,1957,952,1005
050,26,025,"Michigan","Calhoun County",1,60,1891,946,945
050,26,025,"Michigan","Calhoun County",1,61,1916,936,980
050,26,025,"Michigan","Calhoun County",1,62,1871,923,948
050,26,025,"Michigan","Calhoun County",1,63,1838,897,941
050,26,025,"Michigan","Calhoun County",1,64,1745,839,906
050,26,025,"Michigan","Calhoun County",1,65,1715,800,915
050,26,025,"Michigan","Calhoun County",1,66,1685,799,886
050,26,025,"Michigan","Calhoun County",1,67,1716,827,889
050,26,025,"Michigan","Calhoun County",1,68,1623,796,827
050,26,025,"Michigan","Calhoun County",1,69,1418,676,742
050,26,025,"Michigan","Calhoun County",1,70,1397,659,738
050,26,025,"Michigan","Calhoun County",1,71,1387,641,746
050,26,025,"Michigan","Calhoun County",1,72,1374,649,725
050,26,025,"Michigan","Calhoun County",1,73,1386,657,729
050,26,025,"Michigan","Calhoun County",1,74,882,411,471
050,26,025,"Michigan","Calhoun County",1,75,866,398,468
050,26,025,"Michigan","Calhoun County",1,76,867,395,472
050,26,025,"Michigan","Calhoun County",1,77,906,393,513
050,26,025,"Michigan","Calhoun County",1,78,792,334,458
050,26,025,"Michigan","Calhoun County",1,79,678,295,383
050,26,025,"Michigan","Calhoun County",1,80,637,269,368
050,26,025,"Michigan","Calhoun County",1,81,616,268,348
050,26,025,"Michigan","Calhoun County",1,82,554,248,306
050,26,025,"Michigan","Calhoun County",1,83,495,195,300
050,26,025,"Michigan","Calhoun County",1,84,456,179,277
050,26,025,"Michigan","Calhoun County",1,85,2651,946,1705
050,26,025,"Michigan","Calhoun County",2,0,1514,767,747
050,26,025,"Michigan","Calhoun County",2,1,1530,780,750
050,26,025,"Michigan","Calhoun County",2,2,1559,792,767
050,26,025,"Michigan","Calhoun County",2,3,1633,836,797
050,26,025,"Michigan","Calhoun County",2,4,1711,875,836
050,26,025,"Michigan","Calhoun County",2,5,1726,895,831
050,26,025,"Michigan","Calhoun County",2,6,1749,908,841
050,26,025,"Michigan","Calhoun County",2,7,1724,899,825
050,26,025,"Michigan","Calhoun County",2,8,1663,866,797
050,26,025,"Michigan","Calhoun County",2,9,1651,855,796
050,26,025,"Michigan","Calhoun County",2,10,1703,884,819
050,26,025,"Michigan","Calhoun County",2,11,1786,914,872
050,26,025,"Michigan","Calhoun County",2,12,1900,969,931
050,26,025,"Michigan","Calhoun County",2,13,1872,961,911
050,26,025,"Michigan","Calhoun County",2,14,1825,954,871
050,26,025,"Michigan","Calhoun County",2,15,1832,976,856
050,26,025,"Michigan","Calhoun County",2,16,1853,985,868
050,26,025,"Michigan","Calhoun County",2,17,1860,1016,844
050,26,025,"Michigan","Calhoun County",2,18,1689,903,786
050,26,025,"Michigan","Calhoun County",2,19,1646,851,795
050,26,025,"Michigan","Calhoun County",2,20,1686,849,837
050,26,025,"Michigan","Calhoun County",2,21,1581,823,758
050,26,025,"Michigan","Calhoun County",2,22,1569,799,770
050,26,025,"Michigan","Calhoun County",2,23,1546,779,767
050,26,025,"Michigan","Calhoun County",2,24,1590,784,806
050,26,025,"Michigan","Calhoun County",2,25,1656,821,835
050,26,025,"Michigan","Calhoun County",2,26,1659,814,845
050,26,025,"Michigan","Calhoun County",2,27,1681,822,859
050,26,025,"Michigan","Calhoun County",2,28,1735,859,876
050,26,025,"Michigan","Calhoun County",2,29,1771,860,911
050,26,025,"Michigan","Calhoun County",2,30,1764,855,909
050,26,025,"Michigan","Calhoun County",2,31,1623,791,832
050,26,025,"Michigan","Calhoun County",2,32,1577,777,800
050,26,025,"Michigan","Calhoun County",2,33,1530,754,776
050,26,025,"Michigan","Calhoun County",2,34,1578,756,822
050,26,025,"Michigan","Calhoun County",2,35,1601,770,831
050,26,025,"Michigan","Calhoun County",2,36,1545,774,771
050,26,025,"Michigan","Calhoun County",2,37,1607,802,805
050,26,025,"Michigan","Calhoun County",2,38,1685,836,849
050,26,025,"Michigan","Calhoun County",2,39,1699,832,867
050,26,025,"Michigan","Calhoun County",2,40,1696,833,863
050,26,025,"Michigan","Calhoun County",2,41,1638,796,842
050,26,025,"Michigan","Calhoun County",2,42,1574,790,784
050,26,025,"Michigan","Calhoun County",2,43,1553,771,782
050,26,025,"Michigan","Calhoun County",2,44,1450,706,744
050,26,025,"Michigan","Calhoun County",2,45,1473,730,743
050,26,025,"Michigan","Calhoun County",2,46,1530,752,778
050,26,025,"Michigan","Calhoun County",2,47,1572,765,807
050,26,025,"Michigan","Calhoun County",2,48,1651,811,840
050,26,025,"Michigan","Calhoun County",2,49,1751,870,881
050,26,025,"Michigan","Calhoun County",2,50,1759,876,883
050,26,025,"Michigan","Calhoun County",2,51,1725,857,868
050,26,025,"Michigan","Calhoun County",2,52,1687,832,855
050,26,025,"Michigan","Calhoun County",2,53,1641,826,815
050,26,025,"Michigan","Calhoun County",2,54,1652,832,820
050,26,025,"Michigan","Calhoun County",2,55,1739,874,865
050,26,025,"Michigan","Calhoun County",2,56,1806,897,909
050,26,025,"Michigan","Calhoun County",2,57,1879,941,938
050,26,025,"Michigan","Calhoun County",2,58,1898,933,965
050,26,025,"Michigan","Calhoun County",2,59,1957,956,1001
050,26,025,"Michigan","Calhoun County",2,60,1902,943,959
050,26,025,"Michigan","Calhoun County",2,61,1897,933,964
050,26,025,"Michigan","Calhoun County",2,62,1870,919,951
050,26,025,"Michigan","Calhoun County",2,63,1852,907,945
050,26,025,"Michigan","Calhoun County",2,64,1745,843,902
050,26,025,"Michigan","Calhoun County",2,65,1712,804,908
050,26,025,"Michigan","Calhoun County",2,66,1691,797,894
050,26,025,"Michigan","Calhoun County",2,67,1695,813,882
050,26,025,"Michigan","Calhoun County",2,68,1628,790,838
050,26,025,"Michigan","Calhoun County",2,69,1469,704,765
050,26,025,"Michigan","Calhoun County",2,70,1391,661,730
050,26,025,"Michigan","Calhoun County",2,71,1376,637,739
050,26,025,"Michigan","Calhoun County",2,72,1346,638,708
050,26,025,"Michigan","Calhoun County",2,73,1448,685,763
050,26,025,"Michigan","Calhoun County",2,74,937,440,497
050,26,025,"Michigan","Calhoun County",2,75,872,403,469
050,26,025,"Michigan","Calhoun County",2,76,849,386,463
050,26,025,"Michigan","Calhoun County",2,77,910,400,510
050,26,025,"Michigan","Calhoun County",2,78,793,340,453
050,26,025,"Michigan","Calhoun County",2,79,690,294,396
050,26,025,"Michigan","Calhoun County",2,80,636,271,365
050,26,025,"Michigan","Calhoun County",2,81,603,261,342
050,26,025,"Michigan","Calhoun County",2,82,565,250,315
050,26,025,"Michigan","Calhoun County",2,83,500,202,298
050,26,025,"Michigan","Calhoun County",2,84,449,175,274
050,26,025,"Michigan","Calhoun County",2,85,2634,951,1683
050,26,025,"Michigan","Calhoun County",3,0,1473,744,729
050,26,025,"Michigan","Calhoun County",3,1,1499,765,734
050,26,025,"Michigan","Calhoun County",3,2,1540,787,753
050,26,025,"Michigan","Calhoun County",3,3,1561,803,758
050,26,025,"Michigan","Calhoun County",3,4,1656,845,811
050,26,025,"Michigan","Calhoun County",3,5,1713,868,845
050,26,025,"Michigan","Calhoun County",3,6,1736,893,843
050,26,025,"Michigan","Calhoun County",3,7,1745,905,840
050,26,025,"Michigan","Calhoun County",3,8,1726,912,814
050,26,025,"Michigan","Calhoun County",3,9,1683,869,814
050,26,025,"Michigan","Calhoun County",3,10,1664,854,810
050,26,025,"Michigan","Calhoun County",3,11,1719,896,823
050,26,025,"Michigan","Calhoun County",3,12,1788,914,874
050,26,025,"Michigan","Calhoun County",3,13,1930,981,949
050,26,025,"Michigan","Calhoun County",3,14,1873,973,900
050,26,025,"Michigan","Calhoun County",3,15,1864,991,873
050,26,025,"Michigan","Calhoun County",3,16,1845,985,860
050,26,025,"Michigan","Calhoun County",3,17,1872,1015,857
050,26,025,"Michigan","Calhoun County",3,18,1672,882,790
050,26,025,"Michigan","Calhoun County",3,19,1605,860,745
050,26,025,"Michigan","Calhoun County",3,20,1695,858,837
050,26,025,"Michigan","Calhoun County",3,21,1647,833,814
050,26,025,"Michigan","Calhoun County",3,22,1586,811,775
050,26,025,"Michigan","Calhoun County",3,23,1552,778,774
050,26,025,"Michigan","Calhoun County",3,24,1548,767,781
050,26,025,"Michigan","Calhoun County",3,25,1611,778,833
050,26,025,"Michigan","Calhoun County",3,26,1627,804,823
050,26,025,"Michigan","Calhoun County",3,27,1683,821,862
050,26,025,"Michigan","Calhoun County",3,28,1712,835,877
050,26,025,"Michigan","Calhoun County",3,29,1727,860,867
050,26,025,"Michigan","Calhoun County",3,30,1775,856,919
050,26,025,"Michigan","Calhoun County",3,31,1755,862,893
050,26,025,"Michigan","Calhoun County",3,32,1621,798,823
050,26,025,"Michigan","Calhoun County",3,33,1585,783,802
050,26,025,"Michigan","Calhoun County",3,34,1550,763,787
050,26,025,"Michigan","Calhoun County",3,35,1616,772,844
050,26,025,"Michigan","Calhoun County",3,36,1626,780,846
050,26,025,"Michigan","Calhoun County",3,37,1538,776,762
050,26,025,"Michigan","Calhoun County",3,38,1603,800,803
050,26,025,"Michigan","Calhoun County",3,39,1715,851,864
050,26,025,"Michigan","Calhoun County",3,40,1721,839,882
050,26,025,"Michigan","Calhoun County",3,41,1691,844,847
050,26,025,"Michigan","Calhoun County",3,42,1642,793,849
050,26,025,"Michigan","Calhoun County",3,43,1586,783,803
050,26,025,"Michigan","Calhoun County",3,44,1560,771,789
050,26,025,"Michigan","Calhoun County",3,45,1446,709,737
050,26,025,"Michigan","Calhoun County",3,46,1494,752,742
050,26,025,"Michigan","Calhoun County",3,47,1534,759,775
050,26,025,"Michigan","Calhoun County",3,48,1572,771,801
050,26,025,"Michigan","Calhoun County",3,49,1637,797,840
050,26,025,"Michigan","Calhoun County",3,50,1760,884,876
050,26,025,"Michigan","Calhoun County",3,51,1721,858,863
050,26,025,"Michigan","Calhoun County",3,52,1700,838,862
050,26,025,"Michigan","Calhoun County",3,53,1680,829,851
050,26,025,"Michigan","Calhoun County",3,54,1639,828,811
050,26,025,"Michigan","Calhoun County",3,55,1641,830,811
050,26,025,"Michigan","Calhoun County",3,56,1705,854,851
050,26,025,"Michigan","Calhoun County",3,57,1799,893,906
050,26,025,"Michigan","Calhoun County",3,58,1858,929,929
050,26,025,"Michigan","Calhoun County",3,59,1871,927,944
050,26,025,"Michigan","Calhoun County",3,60,1906,910,996
050,26,025,"Michigan","Calhoun County",3,61,1867,930,937
050,26,025,"Michigan","Calhoun County",3,62,1874,907,967
050,26,025,"Michigan","Calhoun County",3,63,1817,894,923
050,26,025,"Michigan","Calhoun County",3,64,1804,875,929
050,26,025,"Michigan","Calhoun County",3,65,1694,805,889
050,26,025,"Michigan","Calhoun County",3,66,1658,769,889
050,26,025,"Michigan","Calhoun County",3,67,1639,770,869
050,26,025,"Michigan","Calhoun County",3,68,1650,772,878
050,26,025,"Michigan","Calhoun County",3,69,1590,762,828
050,26,025,"Michigan","Calhoun County",3,70,1409,675,734
050,26,025,"Michigan","Calhoun County",3,71,1324,626,698
050,26,025,"Michigan","Calhoun County",3,72,1334,620,714
050,26,025,"Michigan","Calhoun County",3,73,1294,609,685
050,26,025,"Michigan","Calhoun County",3,74,1381,658,723
050,26,025,"Michigan","Calhoun County",3,75,890,409,481
050,26,025,"Michigan","Calhoun County",3,76,838,385,453
050,26,025,"Michigan","Calhoun County",3,77,802,360,442
050,26,025,"Michigan","Calhoun County",3,78,864,370,494
050,26,025,"Michigan","Calhoun County",3,79,737,305,432
050,26,025,"Michigan","Calhoun County",3,80,645,274,371
050,26,025,"Michigan","Calhoun County",3,81,587,247,340
050,26,025,"Michigan","Calhoun County",3,82,570,249,321
050,26,025,"Michigan","Calhoun County",3,83,496,211,285
050,26,025,"Michigan","Calhoun County",3,84,459,187,272
050,26,025,"Michigan","Calhoun County",3,85,2556,891,1665
050,26,025,"Michigan","Calhoun County",4,0,1517,810,707
050,26,025,"Michigan","Calhoun County",4,1,1517,767,750
050,26,025,"Michigan","Calhoun County",4,2,1498,772,726
050,26,025,"Michigan","Calhoun County",4,3,1537,767,770
050,26,025,"Michigan","Calhoun County",4,4,1571,820,751
050,26,025,"Michigan","Calhoun County",4,5,1655,840,815
050,26,025,"Michigan","Calhoun County",4,6,1694,866,828
050,26,025,"Michigan","Calhoun County",4,7,1741,903,838
050,26,025,"Michigan","Calhoun County",4,8,1754,909,845
050,26,025,"Michigan","Calhoun County",4,9,1728,921,807
050,26,025,"Michigan","Calhoun County",4,10,1678,876,802
050,26,025,"Michigan","Calhoun County",4,11,1628,843,785
050,26,025,"Michigan","Calhoun County",4,12,1713,875,838
050,26,025,"Michigan","Calhoun County",4,13,1802,921,881
050,26,025,"Michigan","Calhoun County",4,14,1941,993,948
050,26,025,"Michigan","Calhoun County",4,15,1910,1020,890
050,26,025,"Michigan","Calhoun County",4,16,1858,987,871
050,26,025,"Michigan","Calhoun County",4,17,1886,1010,876
050,26,025,"Michigan","Calhoun County",4,18,1684,893,791
050,26,025,"Michigan","Calhoun County",4,19,1561,830,731
050,26,025,"Michigan","Calhoun County",4,20,1610,852,758
050,26,025,"Michigan","Calhoun County",4,21,1632,848,784
050,26,025,"Michigan","Calhoun County",4,22,1654,818,836
050,26,025,"Michigan","Calhoun County",4,23,1501,752,749
050,26,025,"Michigan","Calhoun County",4,24,1573,784,789
050,26,025,"Michigan","Calhoun County",4,25,1552,781,771
050,26,025,"Michigan","Calhoun County",4,26,1597,788,809
050,26,025,"Michigan","Calhoun County",4,27,1632,795,837
050,26,025,"Michigan","Calhoun County",4,28,1631,807,824
050,26,025,"Michigan","Calhoun County",4,29,1700,838,862
050,26,025,"Michigan","Calhoun County",4,30,1766,870,896
050,26,025,"Michigan","Calhoun County",4,31,1797,862,935
050,26,025,"Michigan","Calhoun County",4,32,1772,880,892
050,26,025,"Michigan","Calhoun County",4,33,1657,835,822
050,26,025,"Michigan","Calhoun County",4,34,1621,796,825
050,26,025,"Michigan","Calhoun County",4,35,1573,791,782
050,26,025,"Michigan","Calhoun County",4,36,1640,798,842
050,26,025,"Michigan","Calhoun County",4,37,1622,790,832
050,26,025,"Michigan","Calhoun County",4,38,1567,797,770
050,26,025,"Michigan","Calhoun County",4,39,1578,789,789
050,26,025,"Michigan","Calhoun County",4,40,1687,833,854
050,26,025,"Michigan","Calhoun County",4,41,1723,852,871
050,26,025,"Michigan","Calhoun County",4,42,1698,842,856
050,26,025,"Michigan","Calhoun County",4,43,1640,806,834
050,26,025,"Michigan","Calhoun County",4,44,1585,785,800
050,26,025,"Michigan","Calhoun County",4,45,1577,770,807
050,26,025,"Michigan","Calhoun County",4,46,1456,717,739
050,26,025,"Michigan","Calhoun County",4,47,1499,762,737
050,26,025,"Michigan","Calhoun County",4,48,1544,753,791
050,26,025,"Michigan","Calhoun County",4,49,1539,757,782
050,26,025,"Michigan","Calhoun County",4,50,1627,800,827
050,26,025,"Michigan","Calhoun County",4,51,1756,889,867
050,26,025,"Michigan","Calhoun County",4,52,1700,847,853
050,26,025,"Michigan","Calhoun County",4,53,1691,831,860
050,26,025,"Michigan","Calhoun County",4,54,1653,811,842
050,26,025,"Michigan","Calhoun County",4,55,1639,819,820
050,26,025,"Michigan","Calhoun County",4,56,1622,815,807
050,26,025,"Michigan","Calhoun County",4,57,1687,841,846
050,26,025,"Michigan","Calhoun County",4,58,1771,875,896
050,26,025,"Michigan","Calhoun County",4,59,1840,926,914
050,26,025,"Michigan","Calhoun County",4,60,1820,897,923
050,26,025,"Michigan","Calhoun County",4,61,1856,879,977
050,26,025,"Michigan","Calhoun County",4,62,1830,909,921
050,26,025,"Michigan","Calhoun County",4,63,1864,908,956
050,26,025,"Michigan","Calhoun County",4,64,1778,870,908
050,26,025,"Michigan","Calhoun County",4,65,1766,853,913
050,26,025,"Michigan","Calhoun County",4,66,1654,789,865
050,26,025,"Michigan","Calhoun County",4,67,1622,750,872
050,26,025,"Michigan","Calhoun County",4,68,1572,723,849
050,26,025,"Michigan","Calhoun County",4,69,1603,750,853
050,26,025,"Michigan","Calhoun County",4,70,1558,748,810
050,26,025,"Michigan","Calhoun County",4,71,1345,633,712
050,26,025,"Michigan","Calhoun County",4,72,1293,610,683
050,26,025,"Michigan","Calhoun County",4,73,1286,592,694
050,26,025,"Michigan","Calhoun County",4,74,1224,578,646
050,26,025,"Michigan","Calhoun County",4,75,1334,614,720
050,26,025,"Michigan","Calhoun County",4,76,849,390,459
050,26,025,"Michigan","Calhoun County",4,77,805,362,443
050,26,025,"Michigan","Calhoun County",4,78,741,328,413
050,26,025,"Michigan","Calhoun County",4,79,824,348,476
050,26,025,"Michigan","Calhoun County",4,80,684,279,405
050,26,025,"Michigan","Calhoun County",4,81,604,256,348
050,26,025,"Michigan","Calhoun County",4,82,546,231,315
050,26,025,"Michigan","Calhoun County",4,83,512,214,298
050,26,025,"Michigan","Calhoun County",4,84,465,203,262
050,26,025,"Michigan","Calhoun County",4,85,2507,871,1636
050,26,025,"Michigan","Calhoun County",5,0,1495,795,700
050,26,025,"Michigan","Calhoun County",5,1,1515,817,698
050,26,025,"Michigan","Calhoun County",5,2,1488,759,729
050,26,025,"Michigan","Calhoun County",5,3,1543,780,763
050,26,025,"Michigan","Calhoun County",5,4,1555,798,757
050,26,025,"Michigan","Calhoun County",5,5,1580,830,750
050,26,025,"Michigan","Calhoun County",5,6,1653,821,832
050,26,025,"Michigan","Calhoun County",5,7,1723,884,839
050,26,025,"Michigan","Calhoun County",5,8,1719,896,823
050,26,025,"Michigan","Calhoun County",5,9,1745,903,842
050,26,025,"Michigan","Calhoun County",5,10,1704,910,794
050,26,025,"Michigan","Calhoun County",5,11,1696,884,812
050,26,025,"Michigan","Calhoun County",5,12,1651,853,798
050,26,025,"Michigan","Calhoun County",5,13,1702,858,844
050,26,025,"Michigan","Calhoun County",5,14,1823,944,879
050,26,025,"Michigan","Calhoun County",5,15,1997,1045,952
050,26,025,"Michigan","Calhoun County",5,16,1913,1026,887
050,26,025,"Michigan","Calhoun County",5,17,1882,1017,865
050,26,025,"Michigan","Calhoun County",5,18,1627,868,759
050,26,025,"Michigan","Calhoun County",5,19,1470,778,692
050,26,025,"Michigan","Calhoun County",5,20,1524,786,738
050,26,025,"Michigan","Calhoun County",5,21,1567,842,725
050,26,025,"Michigan","Calhoun County",5,22,1642,846,796
050,26,025,"Michigan","Calhoun County",5,23,1613,786,827
050,26,025,"Michigan","Calhoun County",5,24,1571,791,780
050,26,025,"Michigan","Calhoun County",5,25,1616,799,817
050,26,025,"Michigan","Calhoun County",5,26,1575,797,778
050,26,025,"Michigan","Calhoun County",5,27,1624,790,834
050,26,025,"Michigan","Calhoun County",5,28,1632,796,836
050,26,025,"Michigan","Calhoun County",5,29,1619,793,826
050,26,025,"Michigan","Calhoun County",5,30,1718,832,886
050,26,025,"Michigan","Calhoun County",5,31,1784,891,893
050,26,025,"Michigan","Calhoun County",5,32,1792,861,931
050,26,025,"Michigan","Calhoun County",5,33,1773,869,904
050,26,025,"Michigan","Calhoun County",5,34,1676,831,845
050,26,025,"Michigan","Calhoun County",5,35,1641,809,832
050,26,025,"Michigan","Calhoun County",5,36,1590,806,784
050,26,025,"Michigan","Calhoun County",5,37,1635,791,844
050,26,025,"Michigan","Calhoun County",5,38,1639,797,842
050,26,025,"Michigan","Calhoun County",5,39,1557,801,756
050,26,025,"Michigan","Calhoun County",5,40,1584,791,793
050,26,025,"Michigan","Calhoun County",5,41,1671,821,850
050,26,025,"Michigan","Calhoun County",5,42,1735,845,890
050,26,025,"Michigan","Calhoun County",5,43,1714,844,870
050,26,025,"Michigan","Calhoun County",5,44,1650,811,839
050,26,025,"Michigan","Calhoun County",5,45,1588,776,812
050,26,025,"Michigan","Calhoun County",5,46,1586,767,819
050,26,025,"Michigan","Calhoun County",5,47,1466,715,751
050,26,025,"Michigan","Calhoun County",5,48,1478,743,735
050,26,025,"Michigan","Calhoun County",5,49,1530,741,789
050,26,025,"Michigan","Calhoun County",5,50,1562,759,803
050,26,025,"Michigan","Calhoun County",5,51,1625,800,825
050,26,025,"Michigan","Calhoun County",5,52,1765,890,875
050,26,025,"Michigan","Calhoun County",5,53,1699,843,856
050,26,025,"Michigan","Calhoun County",5,54,1695,832,863
050,26,025,"Michigan","Calhoun County",5,55,1637,803,834
050,26,025,"Michigan","Calhoun County",5,56,1626,797,829
050,26,025,"Michigan","Calhoun County",5,57,1620,813,807
050,26,025,"Michigan","Calhoun County",5,58,1677,827,850
050,26,025,"Michigan","Calhoun County",5,59,1763,883,880
050,26,025,"Michigan","Calhoun County",5,60,1815,900,915
050,26,025,"Michigan","Calhoun County",5,61,1813,900,913
050,26,025,"Michigan","Calhoun County",5,62,1849,868,981
050,26,025,"Michigan","Calhoun County",5,63,1820,895,925
050,26,025,"Michigan","Calhoun County",5,64,1835,893,942
050,26,025,"Michigan","Calhoun County",5,65,1746,842,904
050,26,025,"Michigan","Calhoun County",5,66,1729,843,886
050,26,025,"Michigan","Calhoun County",5,67,1629,777,852
050,26,025,"Michigan","Calhoun County",5,68,1574,715,859
050,26,025,"Michigan","Calhoun County",5,69,1537,699,838
050,26,025,"Michigan","Calhoun County",5,70,1582,748,834
050,26,025,"Michigan","Calhoun County",5,71,1504,718,786
050,26,025,"Michigan","Calhoun County",5,72,1324,623,701
050,26,025,"Michigan","Calhoun County",5,73,1256,587,669
050,26,025,"Michigan","Calhoun County",5,74,1237,565,672
050,26,025,"Michigan","Calhoun County",5,75,1167,541,626
050,26,025,"Michigan","Calhoun County",5,76,1291,590,701
050,26,025,"Michigan","Calhoun County",5,77,811,362,449
050,26,025,"Michigan","Calhoun County",5,78,743,330,413
050,26,025,"Michigan","Calhoun County",5,79,708,313,395
050,26,025,"Michigan","Calhoun County",5,80,776,330,446
050,26,025,"Michigan","Calhoun County",5,81,644,258,386
050,26,025,"Michigan","Calhoun County",5,82,564,244,320
050,26,025,"Michigan","Calhoun County",5,83,478,195,283
050,26,025,"Michigan","Calhoun County",5,84,485,205,280
050,26,025,"Michigan","Calhoun County",5,85,2509,892,1617
050,26,027,"Michigan","Cass County",1,0,459,233,226
050,26,027,"Michigan","Cass County",1,1,465,236,229
050,26,027,"Michigan","Cass County",1,2,488,262,226
050,26,027,"Michigan","Cass County",1,3,496,250,246
050,26,027,"Michigan","Cass County",1,4,540,283,257
050,26,027,"Michigan","Cass County",1,5,555,299,256
050,26,027,"Michigan","Cass County",1,6,558,287,271
050,26,027,"Michigan","Cass County",1,7,561,292,269
050,26,027,"Michigan","Cass County",1,8,583,321,262
050,26,027,"Michigan","Cass County",1,9,579,309,270
050,26,027,"Michigan","Cass County",1,10,640,330,310
050,26,027,"Michigan","Cass County",1,11,670,358,312
050,26,027,"Michigan","Cass County",1,12,695,363,332
050,26,027,"Michigan","Cass County",1,13,680,346,334
050,26,027,"Michigan","Cass County",1,14,686,362,324
050,26,027,"Michigan","Cass County",1,15,661,359,302
050,26,027,"Michigan","Cass County",1,16,694,361,333
050,26,027,"Michigan","Cass County",1,17,665,331,334
050,26,027,"Michigan","Cass County",1,18,660,328,332
050,26,027,"Michigan","Cass County",1,19,634,310,324
050,26,027,"Michigan","Cass County",1,20,549,272,277
050,26,027,"Michigan","Cass County",1,21,514,254,260
050,26,027,"Michigan","Cass County",1,22,526,271,255
050,26,027,"Michigan","Cass County",1,23,567,307,260
050,26,027,"Michigan","Cass County",1,24,554,305,249
050,26,027,"Michigan","Cass County",1,25,527,266,261
050,26,027,"Michigan","Cass County",1,26,503,256,247
050,26,027,"Michigan","Cass County",1,27,496,263,233
050,26,027,"Michigan","Cass County",1,28,532,281,251
050,26,027,"Michigan","Cass County",1,29,559,281,278
050,26,027,"Michigan","Cass County",1,30,531,278,253
050,26,027,"Michigan","Cass County",1,31,494,259,235
050,26,027,"Michigan","Cass County",1,32,530,276,254
050,26,027,"Michigan","Cass County",1,33,502,249,253
050,26,027,"Michigan","Cass County",1,34,540,271,269
050,26,027,"Michigan","Cass County",1,35,545,271,274
050,26,027,"Michigan","Cass County",1,36,552,288,264
050,26,027,"Michigan","Cass County",1,37,614,306,308
050,26,027,"Michigan","Cass County",1,38,584,300,284
050,26,027,"Michigan","Cass County",1,39,607,307,300
050,26,027,"Michigan","Cass County",1,40,611,308,303
050,26,027,"Michigan","Cass County",1,41,601,294,307
050,26,027,"Michigan","Cass County",1,42,568,309,259
050,26,027,"Michigan","Cass County",1,43,533,268,265
050,26,027,"Michigan","Cass County",1,44,567,277,290
050,26,027,"Michigan","Cass County",1,45,574,292,282
050,26,027,"Michigan","Cass County",1,46,554,262,292
050,26,027,"Michigan","Cass County",1,47,618,307,311
050,26,027,"Michigan","Cass County",1,48,674,355,319
050,26,027,"Michigan","Cass County",1,49,773,414,359
050,26,027,"Michigan","Cass County",1,50,721,374,347
050,26,027,"Michigan","Cass County",1,51,657,333,324
050,26,027,"Michigan","Cass County",1,52,672,338,334
050,26,027,"Michigan","Cass County",1,53,739,373,366
050,26,027,"Michigan","Cass County",1,54,745,370,375
050,26,027,"Michigan","Cass County",1,55,785,378,407
050,26,027,"Michigan","Cass County",1,56,818,415,403
050,26,027,"Michigan","Cass County",1,57,857,450,407
050,26,027,"Michigan","Cass County",1,58,822,409,413
050,26,027,"Michigan","Cass County",1,59,803,394,409
050,26,027,"Michigan","Cass County",1,60,780,410,370
050,26,027,"Michigan","Cass County",1,61,804,437,367
050,26,027,"Michigan","Cass County",1,62,839,424,415
050,26,027,"Michigan","Cass County",1,63,813,400,413
050,26,027,"Michigan","Cass County",1,64,777,392,385
050,26,027,"Michigan","Cass County",1,65,743,370,373
050,26,027,"Michigan","Cass County",1,66,799,401,398
050,26,027,"Michigan","Cass County",1,67,789,402,387
050,26,027,"Michigan","Cass County",1,68,738,366,372
050,26,027,"Michigan","Cass County",1,69,687,348,339
050,26,027,"Michigan","Cass County",1,70,675,318,357
050,26,027,"Michigan","Cass County",1,71,675,310,365
050,26,027,"Michigan","Cass County",1,72,671,326,345
050,26,027,"Michigan","Cass County",1,73,680,346,334
050,26,027,"Michigan","Cass County",1,74,444,221,223
050,26,027,"Michigan","Cass County",1,75,447,228,219
050,26,027,"Michigan","Cass County",1,76,449,212,237
050,26,027,"Michigan","Cass County",1,77,456,208,248
050,26,027,"Michigan","Cass County",1,78,409,183,226
050,26,027,"Michigan","Cass County",1,79,324,141,183
050,26,027,"Michigan","Cass County",1,80,283,141,142
050,26,027,"Michigan","Cass County",1,81,266,124,142
050,26,027,"Michigan","Cass County",1,82,213,98,115
050,26,027,"Michigan","Cass County",1,83,218,104,114
050,26,027,"Michigan","Cass County",1,84,197,92,105
050,26,027,"Michigan","Cass County",1,85,934,372,562
050,26,027,"Michigan","Cass County",2,0,461,223,238
050,26,027,"Michigan","Cass County",2,1,463,233,230
050,26,027,"Michigan","Cass County",2,2,485,258,227
050,26,027,"Michigan","Cass County",2,3,495,254,241
050,26,027,"Michigan","Cass County",2,4,529,276,253
050,26,027,"Michigan","Cass County",2,5,550,294,256
050,26,027,"Michigan","Cass County",2,6,555,290,265
050,26,027,"Michigan","Cass County",2,7,562,294,268
050,26,027,"Michigan","Cass County",2,8,578,315,263
050,26,027,"Michigan","Cass County",2,9,583,312,271
050,26,027,"Michigan","Cass County",2,10,626,326,300
050,26,027,"Michigan","Cass County",2,11,658,351,307
050,26,027,"Michigan","Cass County",2,12,687,363,324
050,26,027,"Michigan","Cass County",2,13,684,351,333
050,26,027,"Michigan","Cass County",2,14,681,357,324
050,26,027,"Michigan","Cass County",2,15,671,360,311
050,26,027,"Michigan","Cass County",2,16,691,362,329
050,26,027,"Michigan","Cass County",2,17,676,341,335
050,26,027,"Michigan","Cass County",2,18,646,326,320
050,26,027,"Michigan","Cass County",2,19,638,310,328
050,26,027,"Michigan","Cass County",2,20,553,275,278
050,26,027,"Michigan","Cass County",2,21,512,251,261
050,26,027,"Michigan","Cass County",2,22,522,264,258
050,26,027,"Michigan","Cass County",2,23,562,302,260
050,26,027,"Michigan","Cass County",2,24,548,300,248
050,26,027,"Michigan","Cass County",2,25,527,271,256
050,26,027,"Michigan","Cass County",2,26,507,256,251
050,26,027,"Michigan","Cass County",2,27,497,263,234
050,26,027,"Michigan","Cass County",2,28,522,276,246
050,26,027,"Michigan","Cass County",2,29,558,283,275
050,26,027,"Michigan","Cass County",2,30,537,277,260
050,26,027,"Michigan","Cass County",2,31,502,262,240
050,26,027,"Michigan","Cass County",2,32,520,270,250
050,26,027,"Michigan","Cass County",2,33,513,258,255
050,26,027,"Michigan","Cass County",2,34,531,264,267
050,26,027,"Michigan","Cass County",2,35,548,273,275
050,26,027,"Michigan","Cass County",2,36,550,283,267
050,26,027,"Michigan","Cass County",2,37,602,303,299
050,26,027,"Michigan","Cass County",2,38,594,302,292
050,26,027,"Michigan","Cass County",2,39,602,306,296
050,26,027,"Michigan","Cass County",2,40,615,311,304
050,26,027,"Michigan","Cass County",2,41,603,300,303
050,26,027,"Michigan","Cass County",2,42,573,305,268
050,26,027,"Michigan","Cass County",2,43,545,280,265
050,26,027,"Michigan","Cass County",2,44,554,273,281
050,26,027,"Michigan","Cass County",2,45,573,289,284
050,26,027,"Michigan","Cass County",2,46,561,271,290
050,26,027,"Michigan","Cass County",2,47,603,298,305
050,26,027,"Michigan","Cass County",2,48,664,347,317
050,26,027,"Michigan","Cass County",2,49,754,401,353
050,26,027,"Michigan","Cass County",2,50,738,385,353
050,26,027,"Michigan","Cass County",2,51,667,341,326
050,26,027,"Michigan","Cass County",2,52,666,336,330
050,26,027,"Michigan","Cass County",2,53,721,362,359
050,26,027,"Michigan","Cass County",2,54,741,371,370
050,26,027,"Michigan","Cass County",2,55,778,379,399
050,26,027,"Michigan","Cass County",2,56,812,408,404
050,26,027,"Michigan","Cass County",2,57,846,441,405
050,26,027,"Michigan","Cass County",2,58,828,416,412
050,26,027,"Michigan","Cass County",2,59,811,400,411
050,26,027,"Michigan","Cass County",2,60,779,404,375
050,26,027,"Michigan","Cass County",2,61,793,426,367
050,26,027,"Michigan","Cass County",2,62,831,428,403
050,26,027,"Michigan","Cass County",2,63,827,410,417
050,26,027,"Michigan","Cass County",2,64,774,385,389
050,26,027,"Michigan","Cass County",2,65,751,375,376
050,26,027,"Michigan","Cass County",2,66,785,393,392
050,26,027,"Michigan","Cass County",2,67,785,401,384
050,26,027,"Michigan","Cass County",2,68,746,373,373
050,26,027,"Michigan","Cass County",2,69,703,352,351
050,26,027,"Michigan","Cass County",2,70,674,323,351
050,26,027,"Michigan","Cass County",2,71,667,309,358
050,26,027,"Michigan","Cass County",2,72,662,318,344
050,26,027,"Michigan","Cass County",2,73,710,356,354
050,26,027,"Michigan","Cass County",2,74,462,229,233
050,26,027,"Michigan","Cass County",2,75,442,225,217
050,26,027,"Michigan","Cass County",2,76,444,214,230
050,26,027,"Michigan","Cass County",2,77,462,209,253
050,26,027,"Michigan","Cass County",2,78,410,181,229
050,26,027,"Michigan","Cass County",2,79,339,149,190
050,26,027,"Michigan","Cass County",2,80,283,139,144
050,26,027,"Michigan","Cass County",2,81,266,125,141
050,26,027,"Michigan","Cass County",2,82,222,104,118
050,26,027,"Michigan","Cass County",2,83,217,104,113
050,26,027,"Michigan","Cass County",2,84,199,92,107
050,26,027,"Michigan","Cass County",2,85,947,374,573
050,26,027,"Michigan","Cass County",3,0,445,219,226
050,26,027,"Michigan","Cass County",3,1,489,233,256
050,26,027,"Michigan","Cass County",3,2,481,247,234
050,26,027,"Michigan","Cass County",3,3,493,259,234
050,26,027,"Michigan","Cass County",3,4,522,271,251
050,26,027,"Michigan","Cass County",3,5,529,282,247
050,26,027,"Michigan","Cass County",3,6,559,302,257
050,26,027,"Michigan","Cass County",3,7,563,287,276
050,26,027,"Michigan","Cass County",3,8,582,304,278
050,26,027,"Michigan","Cass County",3,9,585,316,269
050,26,027,"Michigan","Cass County",3,10,587,315,272
050,26,027,"Michigan","Cass County",3,11,628,326,302
050,26,027,"Michigan","Cass County",3,12,653,356,297
050,26,027,"Michigan","Cass County",3,13,711,363,348
050,26,027,"Michigan","Cass County",3,14,674,349,325
050,26,027,"Michigan","Cass County",3,15,680,349,331
050,26,027,"Michigan","Cass County",3,16,675,363,312
050,26,027,"Michigan","Cass County",3,17,690,369,321
050,26,027,"Michigan","Cass County",3,18,625,323,302
050,26,027,"Michigan","Cass County",3,19,616,302,314
050,26,027,"Michigan","Cass County",3,20,557,291,266
050,26,027,"Michigan","Cass County",3,21,515,255,260
050,26,027,"Michigan","Cass County",3,22,497,244,253
050,26,027,"Michigan","Cass County",3,23,544,287,257
050,26,027,"Michigan","Cass County",3,24,511,264,247
050,26,027,"Michigan","Cass County",3,25,549,295,254
050,26,027,"Michigan","Cass County",3,26,535,274,261
050,26,027,"Michigan","Cass County",3,27,525,280,245
050,26,027,"Michigan","Cass County",3,28,504,261,243
050,26,027,"Michigan","Cass County",3,29,527,272,255
050,26,027,"Michigan","Cass County",3,30,563,286,277
050,26,027,"Michigan","Cass County",3,31,573,294,279
050,26,027,"Michigan","Cass County",3,32,520,263,257
050,26,027,"Michigan","Cass County",3,33,547,281,266
050,26,027,"Michigan","Cass County",3,34,480,246,234
050,26,027,"Michigan","Cass County",3,35,563,285,278
050,26,027,"Michigan","Cass County",3,36,553,280,273
050,26,027,"Michigan","Cass County",3,37,542,271,271
050,26,027,"Michigan","Cass County",3,38,619,314,305
050,26,027,"Michigan","Cass County",3,39,603,305,298
050,26,027,"Michigan","Cass County",3,40,620,313,307
050,26,027,"Michigan","Cass County",3,41,627,311,316
050,26,027,"Michigan","Cass County",3,42,605,301,304
050,26,027,"Michigan","Cass County",3,43,579,304,275
050,26,027,"Michigan","Cass County",3,44,556,280,276
050,26,027,"Michigan","Cass County",3,45,558,280,278
050,26,027,"Michigan","Cass County",3,46,590,302,288
050,26,027,"Michigan","Cass County",3,47,553,268,285
050,26,027,"Michigan","Cass County",3,48,600,298,302
050,26,027,"Michigan","Cass County",3,49,678,359,319
050,26,027,"Michigan","Cass County",3,50,751,405,346
050,26,027,"Michigan","Cass County",3,51,729,373,356
050,26,027,"Michigan","Cass County",3,52,691,349,342
050,26,027,"Michigan","Cass County",3,53,659,325,334
050,26,027,"Michigan","Cass County",3,54,726,364,362
050,26,027,"Michigan","Cass County",3,55,740,371,369
050,26,027,"Michigan","Cass County",3,56,784,379,405
050,26,027,"Michigan","Cass County",3,57,820,419,401
050,26,027,"Michigan","Cass County",3,58,857,448,409
050,26,027,"Michigan","Cass County",3,59,812,408,404
050,26,027,"Michigan","Cass County",3,60,808,399,409
050,26,027,"Michigan","Cass County",3,61,772,395,377
050,26,027,"Michigan","Cass County",3,62,794,427,367
050,26,027,"Michigan","Cass County",3,63,807,405,402
050,26,027,"Michigan","Cass County",3,64,812,394,418
050,26,027,"Michigan","Cass County",3,65,774,384,390
050,26,027,"Michigan","Cass County",3,66,743,366,377
050,26,027,"Michigan","Cass County",3,67,771,382,389
050,26,027,"Michigan","Cass County",3,68,770,393,377
050,26,027,"Michigan","Cass County",3,69,728,363,365
050,26,027,"Michigan","Cass County",3,70,678,343,335
050,26,027,"Michigan","Cass County",3,71,659,314,345
050,26,027,"Michigan","Cass County",3,72,647,296,351
050,26,027,"Michigan","Cass County",3,73,627,296,331
050,26,027,"Michigan","Cass County",3,74,697,350,347
050,26,027,"Michigan","Cass County",3,75,429,217,212
050,26,027,"Michigan","Cass County",3,76,421,216,205
050,26,027,"Michigan","Cass County",3,77,430,200,230
050,26,027,"Michigan","Cass County",3,78,442,196,246
050,26,027,"Michigan","Cass County",3,79,378,166,212
050,26,027,"Michigan","Cass County",3,80,316,140,176
050,26,027,"Michigan","Cass County",3,81,262,124,138
050,26,027,"Michigan","Cass County",3,82,245,117,128
050,26,027,"Michigan","Cass County",3,83,214,99,115
050,26,027,"Michigan","Cass County",3,84,191,86,105
050,26,027,"Michigan","Cass County",3,85,963,385,578
050,26,027,"Michigan","Cass County",4,0,470,245,225
050,26,027,"Michigan","Cass County",4,1,499,259,240
050,26,027,"Michigan","Cass County",4,2,492,234,258
050,26,027,"Michigan","Cass County",4,3,487,253,234
050,26,027,"Michigan","Cass County",4,4,507,258,249
050,26,027,"Michigan","Cass County",4,5,525,276,249
050,26,027,"Michigan","Cass County",4,6,547,286,261
050,26,027,"Michigan","Cass County",4,7,566,304,262
050,26,027,"Michigan","Cass County",4,8,577,295,282
050,26,027,"Michigan","Cass County",4,9,570,296,274
050,26,027,"Michigan","Cass County",4,10,585,322,263
050,26,027,"Michigan","Cass County",4,11,599,320,279
050,26,027,"Michigan","Cass County",4,12,631,331,300
050,26,027,"Michigan","Cass County",4,13,651,347,304
050,26,027,"Michigan","Cass County",4,14,702,359,343
050,26,027,"Michigan","Cass County",4,15,663,338,325
050,26,027,"Michigan","Cass County",4,16,692,356,336
050,26,027,"Michigan","Cass County",4,17,660,354,306
050,26,027,"Michigan","Cass County",4,18,653,351,302
050,26,027,"Michigan","Cass County",4,19,586,293,293
050,26,027,"Michigan","Cass County",4,20,519,266,253
050,26,027,"Michigan","Cass County",4,21,516,262,254
050,26,027,"Michigan","Cass County",4,22,498,249,249
050,26,027,"Michigan","Cass County",4,23,516,255,261
050,26,027,"Michigan","Cass County",4,24,546,286,260
050,26,027,"Michigan","Cass County",4,25,498,252,246
050,26,027,"Michigan","Cass County",4,26,531,277,254
050,26,027,"Michigan","Cass County",4,27,548,290,258
050,26,027,"Michigan","Cass County",4,28,510,279,231
050,26,027,"Michigan","Cass County",4,29,518,261,257
050,26,027,"Michigan","Cass County",4,30,526,263,263
050,26,027,"Michigan","Cass County",4,31,597,304,293
050,26,027,"Michigan","Cass County",4,32,576,289,287
050,26,027,"Michigan","Cass County",4,33,553,278,275
050,26,027,"Michigan","Cass County",4,34,550,285,265
050,26,027,"Michigan","Cass County",4,35,500,258,242
050,26,027,"Michigan","Cass County",4,36,562,291,271
050,26,027,"Michigan","Cass County",4,37,573,294,279
050,26,027,"Michigan","Cass County",4,38,550,274,276
050,26,027,"Michigan","Cass County",4,39,610,307,303
050,26,027,"Michigan","Cass County",4,40,606,308,298
050,26,027,"Michigan","Cass County",4,41,640,320,320
050,26,027,"Michigan","Cass County",4,42,616,301,315
050,26,027,"Michigan","Cass County",4,43,616,305,311
050,26,027,"Michigan","Cass County",4,44,582,310,272
050,26,027,"Michigan","Cass County",4,45,565,283,282
050,26,027,"Michigan","Cass County",4,46,564,288,276
050,26,027,"Michigan","Cass County",4,47,591,305,286
050,26,027,"Michigan","Cass County",4,48,563,277,286
050,26,027,"Michigan","Cass County",4,49,598,291,307
050,26,027,"Michigan","Cass County",4,50,679,356,323
050,26,027,"Michigan","Cass County",4,51,746,403,343
050,26,027,"Michigan","Cass County",4,52,726,364,362
050,26,027,"Michigan","Cass County",4,53,695,355,340
050,26,027,"Michigan","Cass County",4,54,668,326,342
050,26,027,"Michigan","Cass County",4,55,743,374,369
050,26,027,"Michigan","Cass County",4,56,742,374,368
050,26,027,"Michigan","Cass County",4,57,779,380,399
050,26,027,"Michigan","Cass County",4,58,836,430,406
050,26,027,"Michigan","Cass County",4,59,846,443,403
050,26,027,"Michigan","Cass County",4,60,812,404,408
050,26,027,"Michigan","Cass County",4,61,798,401,397
050,26,027,"Michigan","Cass County",4,62,764,385,379
050,26,027,"Michigan","Cass County",4,63,796,434,362
050,26,027,"Michigan","Cass County",4,64,798,401,397
050,26,027,"Michigan","Cass County",4,65,802,390,412
050,26,027,"Michigan","Cass County",4,66,775,392,383
050,26,027,"Michigan","Cass County",4,67,729,358,371
050,26,027,"Michigan","Cass County",4,68,768,379,389
050,26,027,"Michigan","Cass County",4,69,754,380,374
050,26,027,"Michigan","Cass County",4,70,700,345,355
050,26,027,"Michigan","Cass County",4,71,659,335,324
050,26,027,"Michigan","Cass County",4,72,650,310,340
050,26,027,"Michigan","Cass County",4,73,628,288,340
050,26,027,"Michigan","Cass County",4,74,595,282,313
050,26,027,"Michigan","Cass County",4,75,671,335,336
050,26,027,"Michigan","Cass County",4,76,422,209,213
050,26,027,"Michigan","Cass County",4,77,409,207,202
050,26,027,"Michigan","Cass County",4,78,421,188,233
050,26,027,"Michigan","Cass County",4,79,399,175,224
050,26,027,"Michigan","Cass County",4,80,355,158,197
050,26,027,"Michigan","Cass County",4,81,292,124,168
050,26,027,"Michigan","Cass County",4,82,231,110,121
050,26,027,"Michigan","Cass County",4,83,225,107,118
050,26,027,"Michigan","Cass County",4,84,194,88,106
050,26,027,"Michigan","Cass County",4,85,970,394,576
050,26,027,"Michigan","Cass County",5,0,440,231,209
050,26,027,"Michigan","Cass County",5,1,461,258,203
050,26,027,"Michigan","Cass County",5,2,491,252,239
050,26,027,"Michigan","Cass County",5,3,489,231,258
050,26,027,"Michigan","Cass County",5,4,506,266,240
050,26,027,"Michigan","Cass County",5,5,538,277,261
050,26,027,"Michigan","Cass County",5,6,534,293,241
050,26,027,"Michigan","Cass County",5,7,548,294,254
050,26,027,"Michigan","Cass County",5,8,591,308,283
050,26,027,"Michigan","Cass County",5,9,586,305,281
050,26,027,"Michigan","Cass County",5,10,600,307,293
050,26,027,"Michigan","Cass County",5,11,608,337,271
050,26,027,"Michigan","Cass County",5,12,604,318,286
050,26,027,"Michigan","Cass County",5,13,631,329,302
050,26,027,"Michigan","Cass County",5,14,643,349,294
050,26,027,"Michigan","Cass County",5,15,720,377,343
050,26,027,"Michigan","Cass County",5,16,657,337,320
050,26,027,"Michigan","Cass County",5,17,689,363,326
050,26,027,"Michigan","Cass County",5,18,652,357,295
050,26,027,"Michigan","Cass County",5,19,654,331,323
050,26,027,"Michigan","Cass County",5,20,533,283,250
050,26,027,"Michigan","Cass County",5,21,513,250,263
050,26,027,"Michigan","Cass County",5,22,546,272,274
050,26,027,"Michigan","Cass County",5,23,542,288,254
050,26,027,"Michigan","Cass County",5,24,500,256,244
050,26,027,"Michigan","Cass County",5,25,549,278,271
050,26,027,"Michigan","Cass County",5,26,502,258,244
050,26,027,"Michigan","Cass County",5,27,555,298,257
050,26,027,"Michigan","Cass County",5,28,539,271,268
050,26,027,"Michigan","Cass County",5,29,556,306,250
050,26,027,"Michigan","Cass County",5,30,540,274,266
050,26,027,"Michigan","Cass County",5,31,539,273,266
050,26,027,"Michigan","Cass County",5,32,594,298,296
050,26,027,"Michigan","Cass County",5,33,583,288,295
050,26,027,"Michigan","Cass County",5,34,555,276,279
050,26,027,"Michigan","Cass County",5,35,544,291,253
050,26,027,"Michigan","Cass County",5,36,513,260,253
050,26,027,"Michigan","Cass County",5,37,553,283,270
050,26,027,"Michigan","Cass County",5,38,586,311,275
050,26,027,"Michigan","Cass County",5,39,549,270,279
050,26,027,"Michigan","Cass County",5,40,616,307,309
050,26,027,"Michigan","Cass County",5,41,611,309,302
050,26,027,"Michigan","Cass County",5,42,642,313,329
050,26,027,"Michigan","Cass County",5,43,610,302,308
050,26,027,"Michigan","Cass County",5,44,618,305,313
050,26,027,"Michigan","Cass County",5,45,579,304,275
050,26,027,"Michigan","Cass County",5,46,585,294,291
050,26,027,"Michigan","Cass County",5,47,576,295,281
050,26,027,"Michigan","Cass County",5,48,597,298,299
050,26,027,"Michigan","Cass County",5,49,572,285,287
050,26,027,"Michigan","Cass County",5,50,601,300,301
050,26,027,"Michigan","Cass County",5,51,668,347,321
050,26,027,"Michigan","Cass County",5,52,745,400,345
050,26,027,"Michigan","Cass County",5,53,735,373,362
050,26,027,"Michigan","Cass County",5,54,712,364,348
050,26,027,"Michigan","Cass County",5,55,657,324,333
050,26,027,"Michigan","Cass County",5,56,739,369,370
050,26,027,"Michigan","Cass County",5,57,723,367,356
050,26,027,"Michigan","Cass County",5,58,779,386,393
050,26,027,"Michigan","Cass County",5,59,827,424,403
050,26,027,"Michigan","Cass County",5,60,844,444,400
050,26,027,"Michigan","Cass County",5,61,810,404,406
050,26,027,"Michigan","Cass County",5,62,792,394,398
050,26,027,"Michigan","Cass County",5,63,763,386,377
050,26,027,"Michigan","Cass County",5,64,798,422,376
050,26,027,"Michigan","Cass County",5,65,779,395,384
050,26,027,"Michigan","Cass County",5,66,801,391,410
050,26,027,"Michigan","Cass County",5,67,772,389,383
050,26,027,"Michigan","Cass County",5,68,717,349,368
050,26,027,"Michigan","Cass County",5,69,746,363,383
050,26,027,"Michigan","Cass County",5,70,732,368,364
050,26,027,"Michigan","Cass County",5,71,674,335,339
050,26,027,"Michigan","Cass County",5,72,646,327,319
050,26,027,"Michigan","Cass County",5,73,628,294,334
050,26,027,"Michigan","Cass County",5,74,605,280,325
050,26,027,"Michigan","Cass County",5,75,574,272,302
050,26,027,"Michigan","Cass County",5,76,647,318,329
050,26,027,"Michigan","Cass County",5,77,406,194,212
050,26,027,"Michigan","Cass County",5,78,399,193,206
050,26,027,"Michigan","Cass County",5,79,389,173,216
050,26,027,"Michigan","Cass County",5,80,372,166,206
050,26,027,"Michigan","Cass County",5,81,335,144,191
050,26,027,"Michigan","Cass County",5,82,260,111,149
050,26,027,"Michigan","Cass County",5,83,219,103,116
050,26,027,"Michigan","Cass County",5,84,209,99,110
050,26,027,"Michigan","Cass County",5,85,1000,420,580
050,26,029,"Michigan","Charlevoix County",1,0,231,120,111
050,26,029,"Michigan","Charlevoix County",1,1,219,116,103
050,26,029,"Michigan","Charlevoix County",1,2,223,115,108
050,26,029,"Michigan","Charlevoix County",1,3,228,111,117
050,26,029,"Michigan","Charlevoix County",1,4,232,109,123
050,26,029,"Michigan","Charlevoix County",1,5,224,109,115
050,26,029,"Michigan","Charlevoix County",1,6,216,100,116
050,26,029,"Michigan","Charlevoix County",1,7,251,125,126
050,26,029,"Michigan","Charlevoix County",1,8,259,131,128
050,26,029,"Michigan","Charlevoix County",1,9,283,156,127
050,26,029,"Michigan","Charlevoix County",1,10,274,141,133
050,26,029,"Michigan","Charlevoix County",1,11,272,134,138
050,26,029,"Michigan","Charlevoix County",1,12,290,143,147
050,26,029,"Michigan","Charlevoix County",1,13,321,154,167
050,26,029,"Michigan","Charlevoix County",1,14,313,165,148
050,26,029,"Michigan","Charlevoix County",1,15,300,157,143
050,26,029,"Michigan","Charlevoix County",1,16,333,172,161
050,26,029,"Michigan","Charlevoix County",1,17,321,169,152
050,26,029,"Michigan","Charlevoix County",1,18,278,147,131
050,26,029,"Michigan","Charlevoix County",1,19,206,106,100
050,26,029,"Michigan","Charlevoix County",1,20,248,131,117
050,26,029,"Michigan","Charlevoix County",1,21,253,120,133
050,26,029,"Michigan","Charlevoix County",1,22,245,120,125
050,26,029,"Michigan","Charlevoix County",1,23,281,150,131
050,26,029,"Michigan","Charlevoix County",1,24,266,138,128
050,26,029,"Michigan","Charlevoix County",1,25,258,132,126
050,26,029,"Michigan","Charlevoix County",1,26,255,131,124
050,26,029,"Michigan","Charlevoix County",1,27,251,132,119
050,26,029,"Michigan","Charlevoix County",1,28,253,128,125
050,26,029,"Michigan","Charlevoix County",1,29,274,138,136
050,26,029,"Michigan","Charlevoix County",1,30,253,127,126
050,26,029,"Michigan","Charlevoix County",1,31,240,114,126
050,26,029,"Michigan","Charlevoix County",1,32,260,142,118
050,26,029,"Michigan","Charlevoix County",1,33,261,141,120
050,26,029,"Michigan","Charlevoix County",1,34,270,134,136
050,26,029,"Michigan","Charlevoix County",1,35,272,137,135
050,26,029,"Michigan","Charlevoix County",1,36,280,151,129
050,26,029,"Michigan","Charlevoix County",1,37,290,144,146
050,26,029,"Michigan","Charlevoix County",1,38,297,147,150
050,26,029,"Michigan","Charlevoix County",1,39,267,131,136
050,26,029,"Michigan","Charlevoix County",1,40,282,150,132
050,26,029,"Michigan","Charlevoix County",1,41,265,138,127
050,26,029,"Michigan","Charlevoix County",1,42,260,136,124
050,26,029,"Michigan","Charlevoix County",1,43,272,141,131
050,26,029,"Michigan","Charlevoix County",1,44,241,119,122
050,26,029,"Michigan","Charlevoix County",1,45,254,128,126
050,26,029,"Michigan","Charlevoix County",1,46,237,116,121
050,26,029,"Michigan","Charlevoix County",1,47,246,120,126
050,26,029,"Michigan","Charlevoix County",1,48,271,142,129
050,26,029,"Michigan","Charlevoix County",1,49,316,151,165
050,26,029,"Michigan","Charlevoix County",1,50,320,161,159
050,26,029,"Michigan","Charlevoix County",1,51,337,175,162
050,26,029,"Michigan","Charlevoix County",1,52,359,182,177
050,26,029,"Michigan","Charlevoix County",1,53,354,169,185
050,26,029,"Michigan","Charlevoix County",1,54,339,178,161
050,26,029,"Michigan","Charlevoix County",1,55,363,201,162
050,26,029,"Michigan","Charlevoix County",1,56,443,232,211
050,26,029,"Michigan","Charlevoix County",1,57,444,228,216
050,26,029,"Michigan","Charlevoix County",1,58,442,216,226
050,26,029,"Michigan","Charlevoix County",1,59,454,218,236
050,26,029,"Michigan","Charlevoix County",1,60,461,230,231
050,26,029,"Michigan","Charlevoix County",1,61,479,225,254
050,26,029,"Michigan","Charlevoix County",1,62,492,228,264
050,26,029,"Michigan","Charlevoix County",1,63,506,241,265
050,26,029,"Michigan","Charlevoix County",1,64,493,244,249
050,26,029,"Michigan","Charlevoix County",1,65,446,222,224
050,26,029,"Michigan","Charlevoix County",1,66,450,220,230
050,26,029,"Michigan","Charlevoix County",1,67,448,218,230
050,26,029,"Michigan","Charlevoix County",1,68,455,225,230
050,26,029,"Michigan","Charlevoix County",1,69,399,201,198
050,26,029,"Michigan","Charlevoix County",1,70,355,182,173
050,26,029,"Michigan","Charlevoix County",1,71,368,179,189
050,26,029,"Michigan","Charlevoix County",1,72,381,187,194
050,26,029,"Michigan","Charlevoix County",1,73,386,180,206
050,26,029,"Michigan","Charlevoix County",1,74,283,141,142
050,26,029,"Michigan","Charlevoix County",1,75,257,125,132
050,26,029,"Michigan","Charlevoix County",1,76,269,127,142
050,26,029,"Michigan","Charlevoix County",1,77,285,135,150
050,26,029,"Michigan","Charlevoix County",1,78,231,120,111
050,26,029,"Michigan","Charlevoix County",1,79,198,103,95
050,26,029,"Michigan","Charlevoix County",1,80,172,87,85
050,26,029,"Michigan","Charlevoix County",1,81,155,72,83
050,26,029,"Michigan","Charlevoix County",1,82,140,70,70
050,26,029,"Michigan","Charlevoix County",1,83,123,56,67
050,26,029,"Michigan","Charlevoix County",1,84,117,51,66
050,26,029,"Michigan","Charlevoix County",1,85,660,261,399
050,26,029,"Michigan","Charlevoix County",2,0,231,118,113
050,26,029,"Michigan","Charlevoix County",2,1,218,114,104
050,26,029,"Michigan","Charlevoix County",2,2,222,115,107
050,26,029,"Michigan","Charlevoix County",2,3,226,112,114
050,26,029,"Michigan","Charlevoix County",2,4,234,111,123
050,26,029,"Michigan","Charlevoix County",2,5,228,110,118
050,26,029,"Michigan","Charlevoix County",2,6,221,103,118
050,26,029,"Michigan","Charlevoix County",2,7,242,119,123
050,26,029,"Michigan","Charlevoix County",2,8,254,128,126
050,26,029,"Michigan","Charlevoix County",2,9,275,147,128
050,26,029,"Michigan","Charlevoix County",2,10,277,145,132
050,26,029,"Michigan","Charlevoix County",2,11,270,134,136
050,26,029,"Michigan","Charlevoix County",2,12,286,141,145
050,26,029,"Michigan","Charlevoix County",2,13,312,152,160
050,26,029,"Michigan","Charlevoix County",2,14,311,161,150
050,26,029,"Michigan","Charlevoix County",2,15,300,157,143
050,26,029,"Michigan","Charlevoix County",2,16,326,169,157
050,26,029,"Michigan","Charlevoix County",2,17,322,168,154
050,26,029,"Michigan","Charlevoix County",2,18,272,144,128
050,26,029,"Michigan","Charlevoix County",2,19,210,108,102
050,26,029,"Michigan","Charlevoix County",2,20,248,130,118
050,26,029,"Michigan","Charlevoix County",2,21,247,120,127
050,26,029,"Michigan","Charlevoix County",2,22,250,120,130
050,26,029,"Michigan","Charlevoix County",2,23,278,146,132
050,26,029,"Michigan","Charlevoix County",2,24,269,140,129
050,26,029,"Michigan","Charlevoix County",2,25,260,133,127
050,26,029,"Michigan","Charlevoix County",2,26,255,131,124
050,26,029,"Michigan","Charlevoix County",2,27,250,131,119
050,26,029,"Michigan","Charlevoix County",2,28,253,130,123
050,26,029,"Michigan","Charlevoix County",2,29,270,136,134
050,26,029,"Michigan","Charlevoix County",2,30,261,131,130
050,26,029,"Michigan","Charlevoix County",2,31,245,119,126
050,26,029,"Michigan","Charlevoix County",2,32,257,136,121
050,26,029,"Michigan","Charlevoix County",2,33,260,140,120
050,26,029,"Michigan","Charlevoix County",2,34,269,138,131
050,26,029,"Michigan","Charlevoix County",2,35,274,139,135
050,26,029,"Michigan","Charlevoix County",2,36,275,146,129
050,26,029,"Michigan","Charlevoix County",2,37,289,147,142
050,26,029,"Michigan","Charlevoix County",2,38,296,148,148
050,26,029,"Michigan","Charlevoix County",2,39,271,133,138
050,26,029,"Michigan","Charlevoix County",2,40,281,147,134
050,26,029,"Michigan","Charlevoix County",2,41,267,140,127
050,26,029,"Michigan","Charlevoix County",2,42,257,135,122
050,26,029,"Michigan","Charlevoix County",2,43,272,143,129
050,26,029,"Michigan","Charlevoix County",2,44,247,124,123
050,26,029,"Michigan","Charlevoix County",2,45,253,128,125
050,26,029,"Michigan","Charlevoix County",2,46,239,117,122
050,26,029,"Michigan","Charlevoix County",2,47,241,118,123
050,26,029,"Michigan","Charlevoix County",2,48,267,137,130
050,26,029,"Michigan","Charlevoix County",2,49,311,153,158
050,26,029,"Michigan","Charlevoix County",2,50,319,160,159
050,26,029,"Michigan","Charlevoix County",2,51,332,172,160
050,26,029,"Michigan","Charlevoix County",2,52,351,178,173
050,26,029,"Michigan","Charlevoix County",2,53,354,171,183
050,26,029,"Michigan","Charlevoix County",2,54,342,176,166
050,26,029,"Michigan","Charlevoix County",2,55,357,194,163
050,26,029,"Michigan","Charlevoix County",2,56,427,225,202
050,26,029,"Michigan","Charlevoix County",2,57,445,231,214
050,26,029,"Michigan","Charlevoix County",2,58,444,219,225
050,26,029,"Michigan","Charlevoix County",2,59,459,222,237
050,26,029,"Michigan","Charlevoix County",2,60,461,227,234
050,26,029,"Michigan","Charlevoix County",2,61,473,224,249
050,26,029,"Michigan","Charlevoix County",2,62,490,228,262
050,26,029,"Michigan","Charlevoix County",2,63,514,243,271
050,26,029,"Michigan","Charlevoix County",2,64,492,242,250
050,26,029,"Michigan","Charlevoix County",2,65,458,228,230
050,26,029,"Michigan","Charlevoix County",2,66,449,221,228
050,26,029,"Michigan","Charlevoix County",2,67,448,219,229
050,26,029,"Michigan","Charlevoix County",2,68,451,223,228
050,26,029,"Michigan","Charlevoix County",2,69,415,208,207
050,26,029,"Michigan","Charlevoix County",2,70,359,185,174
050,26,029,"Michigan","Charlevoix County",2,71,365,178,187
050,26,029,"Michigan","Charlevoix County",2,72,367,181,186
050,26,029,"Michigan","Charlevoix County",2,73,403,191,212
050,26,029,"Michigan","Charlevoix County",2,74,286,139,147
050,26,029,"Michigan","Charlevoix County",2,75,260,126,134
050,26,029,"Michigan","Charlevoix County",2,76,263,124,139
050,26,029,"Michigan","Charlevoix County",2,77,289,138,151
050,26,029,"Michigan","Charlevoix County",2,78,236,119,117
050,26,029,"Michigan","Charlevoix County",2,79,204,106,98
050,26,029,"Michigan","Charlevoix County",2,80,178,92,86
050,26,029,"Michigan","Charlevoix County",2,81,156,74,82
050,26,029,"Michigan","Charlevoix County",2,82,142,70,72
050,26,029,"Michigan","Charlevoix County",2,83,125,57,68
050,26,029,"Michigan","Charlevoix County",2,84,113,49,64
050,26,029,"Michigan","Charlevoix County",2,85,665,264,401
050,26,029,"Michigan","Charlevoix County",3,0,220,120,100
050,26,029,"Michigan","Charlevoix County",3,1,227,121,106
050,26,029,"Michigan","Charlevoix County",3,2,218,116,102
050,26,029,"Michigan","Charlevoix County",3,3,225,119,106
050,26,029,"Michigan","Charlevoix County",3,4,225,111,114
050,26,029,"Michigan","Charlevoix County",3,5,247,116,131
050,26,029,"Michigan","Charlevoix County",3,6,233,114,119
050,26,029,"Michigan","Charlevoix County",3,7,231,114,117
050,26,029,"Michigan","Charlevoix County",3,8,238,120,118
050,26,029,"Michigan","Charlevoix County",3,9,247,124,123
050,26,029,"Michigan","Charlevoix County",3,10,274,150,124
050,26,029,"Michigan","Charlevoix County",3,11,284,148,136
050,26,029,"Michigan","Charlevoix County",3,12,265,128,137
050,26,029,"Michigan","Charlevoix County",3,13,281,142,139
050,26,029,"Michigan","Charlevoix County",3,14,313,153,160
050,26,029,"Michigan","Charlevoix County",3,15,319,165,154
050,26,029,"Michigan","Charlevoix County",3,16,307,167,140
050,26,029,"Michigan","Charlevoix County",3,17,332,169,163
050,26,029,"Michigan","Charlevoix County",3,18,268,146,122
050,26,029,"Michigan","Charlevoix County",3,19,215,116,99
050,26,029,"Michigan","Charlevoix County",3,20,239,126,113
050,26,029,"Michigan","Charlevoix County",3,21,242,124,118
050,26,029,"Michigan","Charlevoix County",3,22,263,129,134
050,26,029,"Michigan","Charlevoix County",3,23,253,124,129
050,26,029,"Michigan","Charlevoix County",3,24,276,148,128
050,26,029,"Michigan","Charlevoix County",3,25,271,146,125
050,26,029,"Michigan","Charlevoix County",3,26,256,138,118
050,26,029,"Michigan","Charlevoix County",3,27,282,143,139
050,26,029,"Michigan","Charlevoix County",3,28,256,139,117
050,26,029,"Michigan","Charlevoix County",3,29,263,134,129
050,26,029,"Michigan","Charlevoix County",3,30,274,137,137
050,26,029,"Michigan","Charlevoix County",3,31,272,135,137
050,26,029,"Michigan","Charlevoix County",3,32,253,125,128
050,26,029,"Michigan","Charlevoix County",3,33,273,142,131
050,26,029,"Michigan","Charlevoix County",3,34,271,150,121
050,26,029,"Michigan","Charlevoix County",3,35,260,131,129
050,26,029,"Michigan","Charlevoix County",3,36,284,151,133
050,26,029,"Michigan","Charlevoix County",3,37,277,141,136
050,26,029,"Michigan","Charlevoix County",3,38,290,150,140
050,26,029,"Michigan","Charlevoix County",3,39,298,146,152
050,26,029,"Michigan","Charlevoix County",3,40,284,139,145
050,26,029,"Michigan","Charlevoix County",3,41,278,144,134
050,26,029,"Michigan","Charlevoix County",3,42,261,141,120
050,26,029,"Michigan","Charlevoix County",3,43,249,134,115
050,26,029,"Michigan","Charlevoix County",3,44,274,145,129
050,26,029,"Michigan","Charlevoix County",3,45,254,126,128
050,26,029,"Michigan","Charlevoix County",3,46,249,122,127
050,26,029,"Michigan","Charlevoix County",3,47,236,116,120
050,26,029,"Michigan","Charlevoix County",3,48,234,119,115
050,26,029,"Michigan","Charlevoix County",3,49,274,141,133
050,26,029,"Michigan","Charlevoix County",3,50,314,152,162
050,26,029,"Michigan","Charlevoix County",3,51,313,153,160
050,26,029,"Michigan","Charlevoix County",3,52,337,177,160
050,26,029,"Michigan","Charlevoix County",3,53,366,183,183
050,26,029,"Michigan","Charlevoix County",3,54,364,174,190
050,26,029,"Michigan","Charlevoix County",3,55,353,186,167
050,26,029,"Michigan","Charlevoix County",3,56,365,195,170
050,26,029,"Michigan","Charlevoix County",3,57,432,230,202
050,26,029,"Michigan","Charlevoix County",3,58,457,238,219
050,26,029,"Michigan","Charlevoix County",3,59,451,226,225
050,26,029,"Michigan","Charlevoix County",3,60,475,236,239
050,26,029,"Michigan","Charlevoix County",3,61,464,224,240
050,26,029,"Michigan","Charlevoix County",3,62,478,226,252
050,26,029,"Michigan","Charlevoix County",3,63,503,229,274
050,26,029,"Michigan","Charlevoix County",3,64,522,242,280
050,26,029,"Michigan","Charlevoix County",3,65,488,231,257
050,26,029,"Michigan","Charlevoix County",3,66,468,234,234
050,26,029,"Michigan","Charlevoix County",3,67,455,226,229
050,26,029,"Michigan","Charlevoix County",3,68,461,229,232
050,26,029,"Michigan","Charlevoix County",3,69,444,217,227
050,26,029,"Michigan","Charlevoix County",3,70,406,203,203
050,26,029,"Michigan","Charlevoix County",3,71,368,189,179
050,26,029,"Michigan","Charlevoix County",3,72,367,187,180
050,26,029,"Michigan","Charlevoix County",3,73,357,171,186
050,26,029,"Michigan","Charlevoix County",3,74,396,186,210
050,26,029,"Michigan","Charlevoix County",3,75,272,130,142
050,26,029,"Michigan","Charlevoix County",3,76,254,125,129
050,26,029,"Michigan","Charlevoix County",3,77,257,121,136
050,26,029,"Michigan","Charlevoix County",3,78,264,129,135
050,26,029,"Michigan","Charlevoix County",3,79,221,111,110
050,26,029,"Michigan","Charlevoix County",3,80,186,94,92
050,26,029,"Michigan","Charlevoix County",3,81,168,85,83
050,26,029,"Michigan","Charlevoix County",3,82,140,67,73
050,26,029,"Michigan","Charlevoix County",3,83,134,61,73
050,26,029,"Michigan","Charlevoix County",3,84,115,51,64
050,26,029,"Michigan","Charlevoix County",3,85,669,270,399
050,26,029,"Michigan","Charlevoix County",4,0,208,113,95
050,26,029,"Michigan","Charlevoix County",4,1,239,140,99
050,26,029,"Michigan","Charlevoix County",4,2,211,113,98
050,26,029,"Michigan","Charlevoix County",4,3,226,120,106
050,26,029,"Michigan","Charlevoix County",4,4,230,119,111
050,26,029,"Michigan","Charlevoix County",4,5,230,111,119
050,26,029,"Michigan","Charlevoix County",4,6,255,120,135
050,26,029,"Michigan","Charlevoix County",4,7,234,114,120
050,26,029,"Michigan","Charlevoix County",4,8,232,114,118
050,26,029,"Michigan","Charlevoix County",4,9,239,121,118
050,26,029,"Michigan","Charlevoix County",4,10,243,125,118
050,26,029,"Michigan","Charlevoix County",4,11,277,150,127
050,26,029,"Michigan","Charlevoix County",4,12,280,145,135
050,26,029,"Michigan","Charlevoix County",4,13,266,132,134
050,26,029,"Michigan","Charlevoix County",4,14,277,140,137
050,26,029,"Michigan","Charlevoix County",4,15,311,150,161
050,26,029,"Michigan","Charlevoix County",4,16,321,163,158
050,26,029,"Michigan","Charlevoix County",4,17,299,160,139
050,26,029,"Michigan","Charlevoix County",4,18,280,147,133
050,26,029,"Michigan","Charlevoix County",4,19,191,107,84
050,26,029,"Michigan","Charlevoix County",4,20,251,135,116
050,26,029,"Michigan","Charlevoix County",4,21,217,111,106
050,26,029,"Michigan","Charlevoix County",4,22,262,134,128
050,26,029,"Michigan","Charlevoix County",4,23,268,139,129
050,26,029,"Michigan","Charlevoix County",4,24,256,129,127
050,26,029,"Michigan","Charlevoix County",4,25,274,146,128
050,26,029,"Michigan","Charlevoix County",4,26,250,129,121
050,26,029,"Michigan","Charlevoix County",4,27,242,129,113
050,26,029,"Michigan","Charlevoix County",4,28,270,140,130
050,26,029,"Michigan","Charlevoix County",4,29,258,143,115
050,26,029,"Michigan","Charlevoix County",4,30,267,133,134
050,26,029,"Michigan","Charlevoix County",4,31,277,140,137
050,26,029,"Michigan","Charlevoix County",4,32,271,142,129
050,26,029,"Michigan","Charlevoix County",4,33,253,125,128
050,26,029,"Michigan","Charlevoix County",4,34,283,148,135
050,26,029,"Michigan","Charlevoix County",4,35,279,153,126
050,26,029,"Michigan","Charlevoix County",4,36,275,139,136
050,26,029,"Michigan","Charlevoix County",4,37,286,158,128
050,26,029,"Michigan","Charlevoix County",4,38,274,143,131
050,26,029,"Michigan","Charlevoix County",4,39,278,139,139
050,26,029,"Michigan","Charlevoix County",4,40,304,144,160
050,26,029,"Michigan","Charlevoix County",4,41,281,136,145
050,26,029,"Michigan","Charlevoix County",4,42,277,146,131
050,26,029,"Michigan","Charlevoix County",4,43,261,137,124
050,26,029,"Michigan","Charlevoix County",4,44,253,136,117
050,26,029,"Michigan","Charlevoix County",4,45,273,144,129
050,26,029,"Michigan","Charlevoix County",4,46,249,116,133
050,26,029,"Michigan","Charlevoix County",4,47,252,123,129
050,26,029,"Michigan","Charlevoix County",4,48,235,111,124
050,26,029,"Michigan","Charlevoix County",4,49,239,117,122
050,26,029,"Michigan","Charlevoix County",4,50,288,151,137
050,26,029,"Michigan","Charlevoix County",4,51,335,166,169
050,26,029,"Michigan","Charlevoix County",4,52,311,155,156
050,26,029,"Michigan","Charlevoix County",4,53,350,182,168
050,26,029,"Michigan","Charlevoix County",4,54,364,179,185
050,26,029,"Michigan","Charlevoix County",4,55,368,175,193
050,26,029,"Michigan","Charlevoix County",4,56,351,183,168
050,26,029,"Michigan","Charlevoix County",4,57,382,206,176
050,26,029,"Michigan","Charlevoix County",4,58,432,221,211
050,26,029,"Michigan","Charlevoix County",4,59,465,240,225
050,26,029,"Michigan","Charlevoix County",4,60,469,234,235
050,26,029,"Michigan","Charlevoix County",4,61,478,231,247
050,26,029,"Michigan","Charlevoix County",4,62,469,228,241
050,26,029,"Michigan","Charlevoix County",4,63,490,232,258
050,26,029,"Michigan","Charlevoix County",4,64,507,232,275
050,26,029,"Michigan","Charlevoix County",4,65,529,249,280
050,26,029,"Michigan","Charlevoix County",4,66,487,231,256
050,26,029,"Michigan","Charlevoix County",4,67,460,230,230
050,26,029,"Michigan","Charlevoix County",4,68,459,233,226
050,26,029,"Michigan","Charlevoix County",4,69,466,226,240
050,26,029,"Michigan","Charlevoix County",4,70,435,211,224
050,26,029,"Michigan","Charlevoix County",4,71,407,204,203
050,26,029,"Michigan","Charlevoix County",4,72,361,186,175
050,26,029,"Michigan","Charlevoix County",4,73,365,178,187
050,26,029,"Michigan","Charlevoix County",4,74,356,169,187
050,26,029,"Michigan","Charlevoix County",4,75,384,178,206
050,26,029,"Michigan","Charlevoix County",4,76,265,129,136
050,26,029,"Michigan","Charlevoix County",4,77,250,121,129
050,26,029,"Michigan","Charlevoix County",4,78,250,115,135
050,26,029,"Michigan","Charlevoix County",4,79,249,123,126
050,26,029,"Michigan","Charlevoix County",4,80,212,108,104
050,26,029,"Michigan","Charlevoix County",4,81,175,84,91
050,26,029,"Michigan","Charlevoix County",4,82,148,73,75
050,26,029,"Michigan","Charlevoix County",4,83,131,56,75
050,26,029,"Michigan","Charlevoix County",4,84,116,49,67
050,26,029,"Michigan","Charlevoix County",4,85,645,266,379
050,26,029,"Michigan","Charlevoix County",5,0,205,110,95
050,26,029,"Michigan","Charlevoix County",5,1,202,106,96
050,26,029,"Michigan","Charlevoix County",5,2,245,137,108
050,26,029,"Michigan","Charlevoix County",5,3,221,114,107
050,26,029,"Michigan","Charlevoix County",5,4,224,120,104
050,26,029,"Michigan","Charlevoix County",5,5,233,125,108
050,26,029,"Michigan","Charlevoix County",5,6,228,109,119
050,26,029,"Michigan","Charlevoix County",5,7,263,124,139
050,26,029,"Michigan","Charlevoix County",5,8,246,125,121
050,26,029,"Michigan","Charlevoix County",5,9,217,116,101
050,26,029,"Michigan","Charlevoix County",5,10,243,123,120
050,26,029,"Michigan","Charlevoix County",5,11,247,123,124
050,26,029,"Michigan","Charlevoix County",5,12,286,158,128
050,26,029,"Michigan","Charlevoix County",5,13,294,158,136
050,26,029,"Michigan","Charlevoix County",5,14,268,138,130
050,26,029,"Michigan","Charlevoix County",5,15,277,142,135
050,26,029,"Michigan","Charlevoix County",5,16,313,151,162
050,26,029,"Michigan","Charlevoix County",5,17,326,165,161
050,26,029,"Michigan","Charlevoix County",5,18,258,140,118
050,26,029,"Michigan","Charlevoix County",5,19,218,119,99
050,26,029,"Michigan","Charlevoix County",5,20,234,135,99
050,26,029,"Michigan","Charlevoix County",5,21,252,136,116
050,26,029,"Michigan","Charlevoix County",5,22,235,118,117
050,26,029,"Michigan","Charlevoix County",5,23,262,136,126
050,26,029,"Michigan","Charlevoix County",5,24,246,127,119
050,26,029,"Michigan","Charlevoix County",5,25,225,109,116
050,26,029,"Michigan","Charlevoix County",5,26,257,136,121
050,26,029,"Michigan","Charlevoix County",5,27,228,118,110
050,26,029,"Michigan","Charlevoix County",5,28,238,118,120
050,26,029,"Michigan","Charlevoix County",5,29,270,140,130
050,26,029,"Michigan","Charlevoix County",5,30,258,136,122
050,26,029,"Michigan","Charlevoix County",5,31,281,143,138
050,26,029,"Michigan","Charlevoix County",5,32,279,142,137
050,26,029,"Michigan","Charlevoix County",5,33,275,140,135
050,26,029,"Michigan","Charlevoix County",5,34,259,133,126
050,26,029,"Michigan","Charlevoix County",5,35,285,146,139
050,26,029,"Michigan","Charlevoix County",5,36,285,161,124
050,26,029,"Michigan","Charlevoix County",5,37,268,133,135
050,26,029,"Michigan","Charlevoix County",5,38,289,159,130
050,26,029,"Michigan","Charlevoix County",5,39,284,147,137
050,26,029,"Michigan","Charlevoix County",5,40,286,143,143
050,26,029,"Michigan","Charlevoix County",5,41,309,150,159
050,26,029,"Michigan","Charlevoix County",5,42,279,131,148
050,26,029,"Michigan","Charlevoix County",5,43,284,151,133
050,26,029,"Michigan","Charlevoix County",5,44,267,139,128
050,26,029,"Michigan","Charlevoix County",5,45,256,139,117
050,26,029,"Michigan","Charlevoix County",5,46,270,142,128
050,26,029,"Michigan","Charlevoix County",5,47,254,118,136
050,26,029,"Michigan","Charlevoix County",5,48,255,122,133
050,26,029,"Michigan","Charlevoix County",5,49,239,113,126
050,26,029,"Michigan","Charlevoix County",5,50,241,119,122
050,26,029,"Michigan","Charlevoix County",5,51,291,156,135
050,26,029,"Michigan","Charlevoix County",5,52,336,166,170
050,26,029,"Michigan","Charlevoix County",5,53,327,161,166
050,26,029,"Michigan","Charlevoix County",5,54,348,180,168
050,26,029,"Michigan","Charlevoix County",5,55,359,178,181
050,26,029,"Michigan","Charlevoix County",5,56,375,178,197
050,26,029,"Michigan","Charlevoix County",5,57,353,181,172
050,26,029,"Michigan","Charlevoix County",5,58,390,205,185
050,26,029,"Michigan","Charlevoix County",5,59,443,229,214
050,26,029,"Michigan","Charlevoix County",5,60,473,238,235
050,26,029,"Michigan","Charlevoix County",5,61,464,224,240
050,26,029,"Michigan","Charlevoix County",5,62,491,237,254
050,26,029,"Michigan","Charlevoix County",5,63,483,237,246
050,26,029,"Michigan","Charlevoix County",5,64,485,226,259
050,26,029,"Michigan","Charlevoix County",5,65,502,233,269
050,26,029,"Michigan","Charlevoix County",5,66,535,257,278
050,26,029,"Michigan","Charlevoix County",5,67,492,238,254
050,26,029,"Michigan","Charlevoix County",5,68,447,223,224
050,26,029,"Michigan","Charlevoix County",5,69,454,231,223
050,26,029,"Michigan","Charlevoix County",5,70,460,220,240
050,26,029,"Michigan","Charlevoix County",5,71,424,205,219
050,26,029,"Michigan","Charlevoix County",5,72,399,204,195
050,26,029,"Michigan","Charlevoix County",5,73,348,174,174
050,26,029,"Michigan","Charlevoix County",5,74,358,172,186
050,26,029,"Michigan","Charlevoix County",5,75,348,165,183
050,26,029,"Michigan","Charlevoix County",5,76,368,172,196
050,26,029,"Michigan","Charlevoix County",5,77,260,124,136
050,26,029,"Michigan","Charlevoix County",5,78,235,111,124
050,26,029,"Michigan","Charlevoix County",5,79,238,108,130
050,26,029,"Michigan","Charlevoix County",5,80,240,119,121
050,26,029,"Michigan","Charlevoix County",5,81,201,103,98
050,26,029,"Michigan","Charlevoix County",5,82,157,78,79
050,26,029,"Michigan","Charlevoix County",5,83,142,64,78
050,26,029,"Michigan","Charlevoix County",5,84,115,47,68
050,26,029,"Michigan","Charlevoix County",5,85,654,272,382
050,26,031,"Michigan","Cheboygan County",1,0,181,94,87
050,26,031,"Michigan","Cheboygan County",1,1,184,95,89
050,26,031,"Michigan","Cheboygan County",1,2,231,116,115
050,26,031,"Michigan","Cheboygan County",1,3,203,102,101
050,26,031,"Michigan","Cheboygan County",1,4,197,92,105
050,26,031,"Michigan","Cheboygan County",1,5,227,113,114
050,26,031,"Michigan","Cheboygan County",1,6,204,110,94
050,26,031,"Michigan","Cheboygan County",1,7,203,108,95
050,26,031,"Michigan","Cheboygan County",1,8,219,115,104
050,26,031,"Michigan","Cheboygan County",1,9,208,109,99
050,26,031,"Michigan","Cheboygan County",1,10,225,119,106
050,26,031,"Michigan","Cheboygan County",1,11,219,127,92
050,26,031,"Michigan","Cheboygan County",1,12,239,125,114
050,26,031,"Michigan","Cheboygan County",1,13,280,139,141
050,26,031,"Michigan","Cheboygan County",1,14,267,137,130
050,26,031,"Michigan","Cheboygan County",1,15,263,130,133
050,26,031,"Michigan","Cheboygan County",1,16,293,150,143
050,26,031,"Michigan","Cheboygan County",1,17,281,144,137
050,26,031,"Michigan","Cheboygan County",1,18,242,131,111
050,26,031,"Michigan","Cheboygan County",1,19,192,107,85
050,26,031,"Michigan","Cheboygan County",1,20,213,118,95
050,26,031,"Michigan","Cheboygan County",1,21,218,119,99
050,26,031,"Michigan","Cheboygan County",1,22,240,124,116
050,26,031,"Michigan","Cheboygan County",1,23,254,132,122
050,26,031,"Michigan","Cheboygan County",1,24,251,128,123
050,26,031,"Michigan","Cheboygan County",1,25,258,137,121
050,26,031,"Michigan","Cheboygan County",1,26,239,121,118
050,26,031,"Michigan","Cheboygan County",1,27,239,131,108
050,26,031,"Michigan","Cheboygan County",1,28,258,135,123
050,26,031,"Michigan","Cheboygan County",1,29,242,115,127
050,26,031,"Michigan","Cheboygan County",1,30,245,120,125
050,26,031,"Michigan","Cheboygan County",1,31,247,124,123
050,26,031,"Michigan","Cheboygan County",1,32,222,109,113
050,26,031,"Michigan","Cheboygan County",1,33,212,107,105
050,26,031,"Michigan","Cheboygan County",1,34,233,119,114
050,26,031,"Michigan","Cheboygan County",1,35,263,138,125
050,26,031,"Michigan","Cheboygan County",1,36,265,138,127
050,26,031,"Michigan","Cheboygan County",1,37,246,118,128
050,26,031,"Michigan","Cheboygan County",1,38,232,118,114
050,26,031,"Michigan","Cheboygan County",1,39,249,124,125
050,26,031,"Michigan","Cheboygan County",1,40,267,140,127
050,26,031,"Michigan","Cheboygan County",1,41,272,139,133
050,26,031,"Michigan","Cheboygan County",1,42,258,133,125
050,26,031,"Michigan","Cheboygan County",1,43,241,124,117
050,26,031,"Michigan","Cheboygan County",1,44,269,120,149
050,26,031,"Michigan","Cheboygan County",1,45,270,132,138
050,26,031,"Michigan","Cheboygan County",1,46,266,127,139
050,26,031,"Michigan","Cheboygan County",1,47,290,144,146
050,26,031,"Michigan","Cheboygan County",1,48,314,168,146
050,26,031,"Michigan","Cheboygan County",1,49,326,166,160
050,26,031,"Michigan","Cheboygan County",1,50,340,172,168
050,26,031,"Michigan","Cheboygan County",1,51,361,193,168
050,26,031,"Michigan","Cheboygan County",1,52,343,175,168
050,26,031,"Michigan","Cheboygan County",1,53,374,186,188
050,26,031,"Michigan","Cheboygan County",1,54,345,170,175
050,26,031,"Michigan","Cheboygan County",1,55,356,185,171
050,26,031,"Michigan","Cheboygan County",1,56,377,191,186
050,26,031,"Michigan","Cheboygan County",1,57,394,180,214
050,26,031,"Michigan","Cheboygan County",1,58,436,204,232
050,26,031,"Michigan","Cheboygan County",1,59,464,225,239
050,26,031,"Michigan","Cheboygan County",1,60,458,233,225
050,26,031,"Michigan","Cheboygan County",1,61,522,257,265
050,26,031,"Michigan","Cheboygan County",1,62,502,241,261
050,26,031,"Michigan","Cheboygan County",1,63,506,252,254
050,26,031,"Michigan","Cheboygan County",1,64,509,249,260
050,26,031,"Michigan","Cheboygan County",1,65,499,243,256
050,26,031,"Michigan","Cheboygan County",1,66,516,244,272
050,26,031,"Michigan","Cheboygan County",1,67,493,264,229
050,26,031,"Michigan","Cheboygan County",1,68,471,252,219
050,26,031,"Michigan","Cheboygan County",1,69,436,225,211
050,26,031,"Michigan","Cheboygan County",1,70,423,217,206
050,26,031,"Michigan","Cheboygan County",1,71,396,189,207
050,26,031,"Michigan","Cheboygan County",1,72,402,195,207
050,26,031,"Michigan","Cheboygan County",1,73,403,207,196
050,26,031,"Michigan","Cheboygan County",1,74,300,151,149
050,26,031,"Michigan","Cheboygan County",1,75,297,158,139
050,26,031,"Michigan","Cheboygan County",1,76,290,138,152
050,26,031,"Michigan","Cheboygan County",1,77,292,150,142
050,26,031,"Michigan","Cheboygan County",1,78,249,116,133
050,26,031,"Michigan","Cheboygan County",1,79,217,99,118
050,26,031,"Michigan","Cheboygan County",1,80,188,91,97
050,26,031,"Michigan","Cheboygan County",1,81,185,95,90
050,26,031,"Michigan","Cheboygan County",1,82,160,71,89
050,26,031,"Michigan","Cheboygan County",1,83,141,66,75
050,26,031,"Michigan","Cheboygan County",1,84,130,60,70
050,26,031,"Michigan","Cheboygan County",1,85,654,264,390
050,26,031,"Michigan","Cheboygan County",2,0,171,90,81
050,26,031,"Michigan","Cheboygan County",2,1,183,96,87
050,26,031,"Michigan","Cheboygan County",2,2,217,110,107
050,26,031,"Michigan","Cheboygan County",2,3,209,105,104
050,26,031,"Michigan","Cheboygan County",2,4,202,96,106
050,26,031,"Michigan","Cheboygan County",2,5,221,108,113
050,26,031,"Michigan","Cheboygan County",2,6,210,111,99
050,26,031,"Michigan","Cheboygan County",2,7,204,109,95
050,26,031,"Michigan","Cheboygan County",2,8,215,114,101
050,26,031,"Michigan","Cheboygan County",2,9,211,112,99
050,26,031,"Michigan","Cheboygan County",2,10,220,118,102
050,26,031,"Michigan","Cheboygan County",2,11,220,123,97
050,26,031,"Michigan","Cheboygan County",2,12,240,129,111
050,26,031,"Michigan","Cheboygan County",2,13,272,136,136
050,26,031,"Michigan","Cheboygan County",2,14,270,137,133
050,26,031,"Michigan","Cheboygan County",2,15,265,133,132
050,26,031,"Michigan","Cheboygan County",2,16,287,146,141
050,26,031,"Michigan","Cheboygan County",2,17,285,147,138
050,26,031,"Michigan","Cheboygan County",2,18,240,129,111
050,26,031,"Michigan","Cheboygan County",2,19,194,107,87
050,26,031,"Michigan","Cheboygan County",2,20,216,121,95
050,26,031,"Michigan","Cheboygan County",2,21,218,118,100
050,26,031,"Michigan","Cheboygan County",2,22,242,127,115
050,26,031,"Michigan","Cheboygan County",2,23,251,131,120
050,26,031,"Michigan","Cheboygan County",2,24,255,132,123
050,26,031,"Michigan","Cheboygan County",2,25,258,135,123
050,26,031,"Michigan","Cheboygan County",2,26,248,127,121
050,26,031,"Michigan","Cheboygan County",2,27,243,130,113
050,26,031,"Michigan","Cheboygan County",2,28,254,133,121
050,26,031,"Michigan","Cheboygan County",2,29,249,122,127
050,26,031,"Michigan","Cheboygan County",2,30,246,121,125
050,26,031,"Michigan","Cheboygan County",2,31,247,126,121
050,26,031,"Michigan","Cheboygan County",2,32,229,113,116
050,26,031,"Michigan","Cheboygan County",2,33,214,106,108
050,26,031,"Michigan","Cheboygan County",2,34,229,116,113
050,26,031,"Michigan","Cheboygan County",2,35,257,132,125
050,26,031,"Michigan","Cheboygan County",2,36,263,137,126
050,26,031,"Michigan","Cheboygan County",2,37,251,124,127
050,26,031,"Michigan","Cheboygan County",2,38,236,119,117
050,26,031,"Michigan","Cheboygan County",2,39,247,123,124
050,26,031,"Michigan","Cheboygan County",2,40,266,138,128
050,26,031,"Michigan","Cheboygan County",2,41,272,142,130
050,26,031,"Michigan","Cheboygan County",2,42,259,134,125
050,26,031,"Michigan","Cheboygan County",2,43,248,127,121
050,26,031,"Michigan","Cheboygan County",2,44,263,120,143
050,26,031,"Michigan","Cheboygan County",2,45,272,130,142
050,26,031,"Michigan","Cheboygan County",2,46,266,128,138
050,26,031,"Michigan","Cheboygan County",2,47,285,141,144
050,26,031,"Michigan","Cheboygan County",2,48,309,162,147
050,26,031,"Michigan","Cheboygan County",2,49,327,169,158
050,26,031,"Michigan","Cheboygan County",2,50,341,173,168
050,26,031,"Michigan","Cheboygan County",2,51,356,189,167
050,26,031,"Michigan","Cheboygan County",2,52,346,177,169
050,26,031,"Michigan","Cheboygan County",2,53,368,185,183
050,26,031,"Michigan","Cheboygan County",2,54,348,170,178
050,26,031,"Michigan","Cheboygan County",2,55,354,183,171
050,26,031,"Michigan","Cheboygan County",2,56,375,189,186
050,26,031,"Michigan","Cheboygan County",2,57,393,185,208
050,26,031,"Michigan","Cheboygan County",2,58,428,198,230
050,26,031,"Michigan","Cheboygan County",2,59,460,221,239
050,26,031,"Michigan","Cheboygan County",2,60,462,233,229
050,26,031,"Michigan","Cheboygan County",2,61,508,253,255
050,26,031,"Michigan","Cheboygan County",2,62,504,245,259
050,26,031,"Michigan","Cheboygan County",2,63,512,254,258
050,26,031,"Michigan","Cheboygan County",2,64,508,253,255
050,26,031,"Michigan","Cheboygan County",2,65,505,246,259
050,26,031,"Michigan","Cheboygan County",2,66,513,246,267
050,26,031,"Michigan","Cheboygan County",2,67,498,260,238
050,26,031,"Michigan","Cheboygan County",2,68,469,250,219
050,26,031,"Michigan","Cheboygan County",2,69,446,232,214
050,26,031,"Michigan","Cheboygan County",2,70,419,216,203
050,26,031,"Michigan","Cheboygan County",2,71,402,197,205
050,26,031,"Michigan","Cheboygan County",2,72,388,187,201
050,26,031,"Michigan","Cheboygan County",2,73,426,216,210
050,26,031,"Michigan","Cheboygan County",2,74,305,154,151
050,26,031,"Michigan","Cheboygan County",2,75,295,156,139
050,26,031,"Michigan","Cheboygan County",2,76,280,136,144
050,26,031,"Michigan","Cheboygan County",2,77,298,150,148
050,26,031,"Michigan","Cheboygan County",2,78,250,120,130
050,26,031,"Michigan","Cheboygan County",2,79,214,99,115
050,26,031,"Michigan","Cheboygan County",2,80,192,92,100
050,26,031,"Michigan","Cheboygan County",2,81,183,92,91
050,26,031,"Michigan","Cheboygan County",2,82,164,75,89
050,26,031,"Michigan","Cheboygan County",2,83,139,64,75
050,26,031,"Michigan","Cheboygan County",2,84,132,61,71
050,26,031,"Michigan","Cheboygan County",2,85,650,266,384
050,26,031,"Michigan","Cheboygan County",3,0,186,98,88
050,26,031,"Michigan","Cheboygan County",3,1,172,87,85
050,26,031,"Michigan","Cheboygan County",3,2,185,102,83
050,26,031,"Michigan","Cheboygan County",3,3,215,106,109
050,26,031,"Michigan","Cheboygan County",3,4,214,106,108
050,26,031,"Michigan","Cheboygan County",3,5,207,99,108
050,26,031,"Michigan","Cheboygan County",3,6,232,114,118
050,26,031,"Michigan","Cheboygan County",3,7,203,110,93
050,26,031,"Michigan","Cheboygan County",3,8,212,114,98
050,26,031,"Michigan","Cheboygan County",3,9,232,122,110
050,26,031,"Michigan","Cheboygan County",3,10,212,113,99
050,26,031,"Michigan","Cheboygan County",3,11,230,118,112
050,26,031,"Michigan","Cheboygan County",3,12,225,126,99
050,26,031,"Michigan","Cheboygan County",3,13,234,127,107
050,26,031,"Michigan","Cheboygan County",3,14,270,141,129
050,26,031,"Michigan","Cheboygan County",3,15,261,136,125
050,26,031,"Michigan","Cheboygan County",3,16,272,137,135
050,26,031,"Michigan","Cheboygan County",3,17,288,155,133
050,26,031,"Michigan","Cheboygan County",3,18,240,126,114
050,26,031,"Michigan","Cheboygan County",3,19,191,103,88
050,26,031,"Michigan","Cheboygan County",3,20,225,128,97
050,26,031,"Michigan","Cheboygan County",3,21,214,111,103
050,26,031,"Michigan","Cheboygan County",3,22,247,133,114
050,26,031,"Michigan","Cheboygan County",3,23,246,125,121
050,26,031,"Michigan","Cheboygan County",3,24,264,135,129
050,26,031,"Michigan","Cheboygan County",3,25,255,129,126
050,26,031,"Michigan","Cheboygan County",3,26,264,146,118
050,26,031,"Michigan","Cheboygan County",3,27,250,134,116
050,26,031,"Michigan","Cheboygan County",3,28,245,128,117
050,26,031,"Michigan","Cheboygan County",3,29,259,139,120
050,26,031,"Michigan","Cheboygan County",3,30,242,116,126
050,26,031,"Michigan","Cheboygan County",3,31,255,128,127
050,26,031,"Michigan","Cheboygan County",3,32,251,131,120
050,26,031,"Michigan","Cheboygan County",3,33,230,112,118
050,26,031,"Michigan","Cheboygan County",3,34,237,119,118
050,26,031,"Michigan","Cheboygan County",3,35,241,128,113
050,26,031,"Michigan","Cheboygan County",3,36,253,126,127
050,26,031,"Michigan","Cheboygan County",3,37,270,144,126
050,26,031,"Michigan","Cheboygan County",3,38,265,130,135
050,26,031,"Michigan","Cheboygan County",3,39,239,119,120
050,26,031,"Michigan","Cheboygan County",3,40,263,134,129
050,26,031,"Michigan","Cheboygan County",3,41,279,147,132
050,26,031,"Michigan","Cheboygan County",3,42,275,146,129
050,26,031,"Michigan","Cheboygan County",3,43,262,139,123
050,26,031,"Michigan","Cheboygan County",3,44,253,128,125
050,26,031,"Michigan","Cheboygan County",3,45,262,119,143
050,26,031,"Michigan","Cheboygan County",3,46,281,137,144
050,26,031,"Michigan","Cheboygan County",3,47,267,126,141
050,26,031,"Michigan","Cheboygan County",3,48,282,137,145
050,26,031,"Michigan","Cheboygan County",3,49,315,164,151
050,26,031,"Michigan","Cheboygan County",3,50,332,171,161
050,26,031,"Michigan","Cheboygan County",3,51,352,176,176
050,26,031,"Michigan","Cheboygan County",3,52,359,191,168
050,26,031,"Michigan","Cheboygan County",3,53,360,185,175
050,26,031,"Michigan","Cheboygan County",3,54,379,183,196
050,26,031,"Michigan","Cheboygan County",3,55,378,194,184
050,26,031,"Michigan","Cheboygan County",3,56,365,180,185
050,26,031,"Michigan","Cheboygan County",3,57,396,201,195
050,26,031,"Michigan","Cheboygan County",3,58,416,190,226
050,26,031,"Michigan","Cheboygan County",3,59,430,197,233
050,26,031,"Michigan","Cheboygan County",3,60,482,236,246
050,26,031,"Michigan","Cheboygan County",3,61,481,250,231
050,26,031,"Michigan","Cheboygan County",3,62,514,260,254
050,26,031,"Michigan","Cheboygan County",3,63,521,252,269
050,26,031,"Michigan","Cheboygan County",3,64,504,249,255
050,26,031,"Michigan","Cheboygan County",3,65,532,268,264
050,26,031,"Michigan","Cheboygan County",3,66,507,251,256
050,26,031,"Michigan","Cheboygan County",3,67,529,254,275
050,26,031,"Michigan","Cheboygan County",3,68,489,250,239
050,26,031,"Michigan","Cheboygan County",3,69,465,242,223
050,26,031,"Michigan","Cheboygan County",3,70,425,226,199
050,26,031,"Michigan","Cheboygan County",3,71,413,214,199
050,26,031,"Michigan","Cheboygan County",3,72,383,185,198
050,26,031,"Michigan","Cheboygan County",3,73,378,179,199
050,26,031,"Michigan","Cheboygan County",3,74,399,202,197
050,26,031,"Michigan","Cheboygan County",3,75,297,149,148
050,26,031,"Michigan","Cheboygan County",3,76,278,142,136
050,26,031,"Michigan","Cheboygan County",3,77,264,129,135
050,26,031,"Michigan","Cheboygan County",3,78,282,142,140
050,26,031,"Michigan","Cheboygan County",3,79,218,111,107
050,26,031,"Michigan","Cheboygan County",3,80,202,93,109
050,26,031,"Michigan","Cheboygan County",3,81,174,83,91
050,26,031,"Michigan","Cheboygan County",3,82,161,77,84
050,26,031,"Michigan","Cheboygan County",3,83,148,69,79
050,26,031,"Michigan","Cheboygan County",3,84,120,56,64
050,26,031,"Michigan","Cheboygan County",3,85,649,265,384
050,26,031,"Michigan","Cheboygan County",4,0,205,121,84
050,26,031,"Michigan","Cheboygan County",4,1,195,107,88
050,26,031,"Michigan","Cheboygan County",4,2,188,91,97
050,26,031,"Michigan","Cheboygan County",4,3,181,101,80
050,26,031,"Michigan","Cheboygan County",4,4,215,108,107
050,26,031,"Michigan","Cheboygan County",4,5,215,109,106
050,26,031,"Michigan","Cheboygan County",4,6,212,110,102
050,26,031,"Michigan","Cheboygan County",4,7,240,118,122
050,26,031,"Michigan","Cheboygan County",4,8,208,105,103
050,26,031,"Michigan","Cheboygan County",4,9,218,122,96
050,26,031,"Michigan","Cheboygan County",4,10,232,126,106
050,26,031,"Michigan","Cheboygan County",4,11,218,116,102
050,26,031,"Michigan","Cheboygan County",4,12,231,122,109
050,26,031,"Michigan","Cheboygan County",4,13,225,125,100
050,26,031,"Michigan","Cheboygan County",4,14,251,137,114
050,26,031,"Michigan","Cheboygan County",4,15,282,150,132
050,26,031,"Michigan","Cheboygan County",4,16,264,132,132
050,26,031,"Michigan","Cheboygan County",4,17,290,154,136
050,26,031,"Michigan","Cheboygan County",4,18,251,134,117
050,26,031,"Michigan","Cheboygan County",4,19,189,103,86
050,26,031,"Michigan","Cheboygan County",4,20,220,119,101
050,26,031,"Michigan","Cheboygan County",4,21,218,119,99
050,26,031,"Michigan","Cheboygan County",4,22,241,122,119
050,26,031,"Michigan","Cheboygan County",4,23,264,144,120
050,26,031,"Michigan","Cheboygan County",4,24,252,136,116
050,26,031,"Michigan","Cheboygan County",4,25,253,132,121
050,26,031,"Michigan","Cheboygan County",4,26,272,139,133
050,26,031,"Michigan","Cheboygan County",4,27,274,146,128
050,26,031,"Michigan","Cheboygan County",4,28,247,133,114
050,26,031,"Michigan","Cheboygan County",4,29,242,134,108
050,26,031,"Michigan","Cheboygan County",4,30,268,139,129
050,26,031,"Michigan","Cheboygan County",4,31,266,132,134
050,26,031,"Michigan","Cheboygan County",4,32,258,134,124
050,26,031,"Michigan","Cheboygan County",4,33,258,134,124
050,26,031,"Michigan","Cheboygan County",4,34,245,117,128
050,26,031,"Michigan","Cheboygan County",4,35,251,136,115
050,26,031,"Michigan","Cheboygan County",4,36,249,130,119
050,26,031,"Michigan","Cheboygan County",4,37,262,123,139
050,26,031,"Michigan","Cheboygan County",4,38,267,139,128
050,26,031,"Michigan","Cheboygan County",4,39,273,135,138
050,26,031,"Michigan","Cheboygan County",4,40,250,130,120
050,26,031,"Michigan","Cheboygan County",4,41,268,134,134
050,26,031,"Michigan","Cheboygan County",4,42,292,156,136
050,26,031,"Michigan","Cheboygan County",4,43,285,150,135
050,26,031,"Michigan","Cheboygan County",4,44,271,144,127
050,26,031,"Michigan","Cheboygan County",4,45,260,131,129
050,26,031,"Michigan","Cheboygan County",4,46,269,121,148
050,26,031,"Michigan","Cheboygan County",4,47,290,136,154
050,26,031,"Michigan","Cheboygan County",4,48,266,126,140
050,26,031,"Michigan","Cheboygan County",4,49,284,144,140
050,26,031,"Michigan","Cheboygan County",4,50,305,155,150
050,26,031,"Michigan","Cheboygan County",4,51,342,179,163
050,26,031,"Michigan","Cheboygan County",4,52,359,177,182
050,26,031,"Michigan","Cheboygan County",4,53,369,196,173
050,26,031,"Michigan","Cheboygan County",4,54,347,175,172
050,26,031,"Michigan","Cheboygan County",4,55,387,192,195
050,26,031,"Michigan","Cheboygan County",4,56,391,194,197
050,26,031,"Michigan","Cheboygan County",4,57,381,187,194
050,26,031,"Michigan","Cheboygan County",4,58,407,212,195
050,26,031,"Michigan","Cheboygan County",4,59,418,187,231
050,26,031,"Michigan","Cheboygan County",4,60,426,199,227
050,26,031,"Michigan","Cheboygan County",4,61,494,245,249
050,26,031,"Michigan","Cheboygan County",4,62,491,254,237
050,26,031,"Michigan","Cheboygan County",4,63,513,256,257
050,26,031,"Michigan","Cheboygan County",4,64,539,266,273
050,26,031,"Michigan","Cheboygan County",4,65,512,248,264
050,26,031,"Michigan","Cheboygan County",4,66,534,270,264
050,26,031,"Michigan","Cheboygan County",4,67,518,266,252
050,26,031,"Michigan","Cheboygan County",4,68,537,253,284
050,26,031,"Michigan","Cheboygan County",4,69,483,240,243
050,26,031,"Michigan","Cheboygan County",4,70,461,243,218
050,26,031,"Michigan","Cheboygan County",4,71,423,228,195
050,26,031,"Michigan","Cheboygan County",4,72,403,211,192
050,26,031,"Michigan","Cheboygan County",4,73,379,182,197
050,26,031,"Michigan","Cheboygan County",4,74,357,164,193
050,26,031,"Michigan","Cheboygan County",4,75,393,197,196
050,26,031,"Michigan","Cheboygan County",4,76,273,133,140
050,26,031,"Michigan","Cheboygan County",4,77,245,123,122
050,26,031,"Michigan","Cheboygan County",4,78,254,125,129
050,26,031,"Michigan","Cheboygan County",4,79,253,129,124
050,26,031,"Michigan","Cheboygan County",4,80,199,105,94
050,26,031,"Michigan","Cheboygan County",4,81,179,86,93
050,26,031,"Michigan","Cheboygan County",4,82,157,76,81
050,26,031,"Michigan","Cheboygan County",4,83,148,77,71
050,26,031,"Michigan","Cheboygan County",4,84,129,57,72
050,26,031,"Michigan","Cheboygan County",4,85,633,254,379
050,26,031,"Michigan","Cheboygan County",5,0,189,112,77
050,26,031,"Michigan","Cheboygan County",5,1,218,124,94
050,26,031,"Michigan","Cheboygan County",5,2,197,108,89
050,26,031,"Michigan","Cheboygan County",5,3,185,92,93
050,26,031,"Michigan","Cheboygan County",5,4,188,104,84
050,26,031,"Michigan","Cheboygan County",5,5,226,112,114
050,26,031,"Michigan","Cheboygan County",5,6,225,111,114
050,26,031,"Michigan","Cheboygan County",5,7,210,112,98
050,26,031,"Michigan","Cheboygan County",5,8,233,117,116
050,26,031,"Michigan","Cheboygan County",5,9,210,101,109
050,26,031,"Michigan","Cheboygan County",5,10,218,120,98
050,26,031,"Michigan","Cheboygan County",5,11,229,127,102
050,26,031,"Michigan","Cheboygan County",5,12,212,113,99
050,26,031,"Michigan","Cheboygan County",5,13,223,116,107
050,26,031,"Michigan","Cheboygan County",5,14,231,127,104
050,26,031,"Michigan","Cheboygan County",5,15,240,126,114
050,26,031,"Michigan","Cheboygan County",5,16,275,142,133
050,26,031,"Michigan","Cheboygan County",5,17,269,143,126
050,26,031,"Michigan","Cheboygan County",5,18,252,138,114
050,26,031,"Michigan","Cheboygan County",5,19,195,105,90
050,26,031,"Michigan","Cheboygan County",5,20,217,122,95
050,26,031,"Michigan","Cheboygan County",5,21,226,118,108
050,26,031,"Michigan","Cheboygan County",5,22,241,131,110
050,26,031,"Michigan","Cheboygan County",5,23,251,129,122
050,26,031,"Michigan","Cheboygan County",5,24,299,154,145
050,26,031,"Michigan","Cheboygan County",5,25,259,142,117
050,26,031,"Michigan","Cheboygan County",5,26,261,136,125
050,26,031,"Michigan","Cheboygan County",5,27,274,145,129
050,26,031,"Michigan","Cheboygan County",5,28,281,149,132
050,26,031,"Michigan","Cheboygan County",5,29,254,144,110
050,26,031,"Michigan","Cheboygan County",5,30,246,130,116
050,26,031,"Michigan","Cheboygan County",5,31,280,146,134
050,26,031,"Michigan","Cheboygan County",5,32,288,138,150
050,26,031,"Michigan","Cheboygan County",5,33,245,125,120
050,26,031,"Michigan","Cheboygan County",5,34,261,137,124
050,26,031,"Michigan","Cheboygan County",5,35,248,116,132
050,26,031,"Michigan","Cheboygan County",5,36,257,144,113
050,26,031,"Michigan","Cheboygan County",5,37,264,131,133
050,26,031,"Michigan","Cheboygan County",5,38,268,132,136
050,26,031,"Michigan","Cheboygan County",5,39,254,132,122
050,26,031,"Michigan","Cheboygan County",5,40,282,142,140
050,26,031,"Michigan","Cheboygan County",5,41,255,135,120
050,26,031,"Michigan","Cheboygan County",5,42,277,135,142
050,26,031,"Michigan","Cheboygan County",5,43,302,161,141
050,26,031,"Michigan","Cheboygan County",5,44,296,160,136
050,26,031,"Michigan","Cheboygan County",5,45,278,149,129
050,26,031,"Michigan","Cheboygan County",5,46,275,140,135
050,26,031,"Michigan","Cheboygan County",5,47,277,130,147
050,26,031,"Michigan","Cheboygan County",5,48,289,131,158
050,26,031,"Michigan","Cheboygan County",5,49,264,124,140
050,26,031,"Michigan","Cheboygan County",5,50,295,146,149
050,26,031,"Michigan","Cheboygan County",5,51,316,161,155
050,26,031,"Michigan","Cheboygan County",5,52,344,178,166
050,26,031,"Michigan","Cheboygan County",5,53,374,187,187
050,26,031,"Michigan","Cheboygan County",5,54,372,189,183
050,26,031,"Michigan","Cheboygan County",5,55,347,177,170
050,26,031,"Michigan","Cheboygan County",5,56,397,195,202
050,26,031,"Michigan","Cheboygan County",5,57,400,200,200
050,26,031,"Michigan","Cheboygan County",5,58,368,171,197
050,26,031,"Michigan","Cheboygan County",5,59,407,207,200
050,26,031,"Michigan","Cheboygan County",5,60,416,185,231
050,26,031,"Michigan","Cheboygan County",5,61,445,213,232
050,26,031,"Michigan","Cheboygan County",5,62,493,245,248
050,26,031,"Michigan","Cheboygan County",5,63,500,260,240
050,26,031,"Michigan","Cheboygan County",5,64,504,254,250
050,26,031,"Michigan","Cheboygan County",5,65,549,268,281
050,26,031,"Michigan","Cheboygan County",5,66,498,245,253
050,26,031,"Michigan","Cheboygan County",5,67,534,277,257
050,26,031,"Michigan","Cheboygan County",5,68,516,262,254
050,26,031,"Michigan","Cheboygan County",5,69,537,244,293
050,26,031,"Michigan","Cheboygan County",5,70,477,240,237
050,26,031,"Michigan","Cheboygan County",5,71,456,241,215
050,26,031,"Michigan","Cheboygan County",5,72,415,222,193
050,26,031,"Michigan","Cheboygan County",5,73,402,208,194
050,26,031,"Michigan","Cheboygan County",5,74,357,166,191
050,26,031,"Michigan","Cheboygan County",5,75,354,167,187
050,26,031,"Michigan","Cheboygan County",5,76,361,180,181
050,26,031,"Michigan","Cheboygan County",5,77,250,120,130
050,26,031,"Michigan","Cheboygan County",5,78,239,119,120
050,26,031,"Michigan","Cheboygan County",5,79,228,115,113
050,26,031,"Michigan","Cheboygan County",5,80,235,122,113
050,26,031,"Michigan","Cheboygan County",5,81,181,99,82
050,26,031,"Michigan","Cheboygan County",5,82,168,83,85
050,26,031,"Michigan","Cheboygan County",5,83,140,73,67
050,26,031,"Michigan","Cheboygan County",5,84,134,69,65
050,26,031,"Michigan","Cheboygan County",5,85,645,259,386
050,26,033,"Michigan","Chippewa County",1,0,306,155,151
050,26,033,"Michigan","Chippewa County",1,1,324,160,164
050,26,033,"Michigan","Chippewa County",1,2,304,154,150
050,26,033,"Michigan","Chippewa County",1,3,340,168,172
050,26,033,"Michigan","Chippewa County",1,4,375,181,194
050,26,033,"Michigan","Chippewa County",1,5,366,184,182
050,26,033,"Michigan","Chippewa County",1,6,386,183,203
050,26,033,"Michigan","Chippewa County",1,7,370,180,190
050,26,033,"Michigan","Chippewa County",1,8,357,186,171
050,26,033,"Michigan","Chippewa County",1,9,383,206,177
050,26,033,"Michigan","Chippewa County",1,10,388,195,193
050,26,033,"Michigan","Chippewa County",1,11,398,212,186
050,26,033,"Michigan","Chippewa County",1,12,373,204,169
050,26,033,"Michigan","Chippewa County",1,13,403,222,181
050,26,033,"Michigan","Chippewa County",1,14,417,211,206
050,26,033,"Michigan","Chippewa County",1,15,384,191,193
050,26,033,"Michigan","Chippewa County",1,16,400,202,198
050,26,033,"Michigan","Chippewa County",1,17,387,203,184
050,26,033,"Michigan","Chippewa County",1,18,490,263,227
050,26,033,"Michigan","Chippewa County",1,19,640,342,298
050,26,033,"Michigan","Chippewa County",1,20,682,367,315
050,26,033,"Michigan","Chippewa County",1,21,671,390,281
050,26,033,"Michigan","Chippewa County",1,22,679,347,332
050,26,033,"Michigan","Chippewa County",1,23,661,352,309
050,26,033,"Michigan","Chippewa County",1,24,557,319,238
050,26,033,"Michigan","Chippewa County",1,25,496,308,188
050,26,033,"Michigan","Chippewa County",1,26,490,316,174
050,26,033,"Michigan","Chippewa County",1,27,478,297,181
050,26,033,"Michigan","Chippewa County",1,28,474,305,169
050,26,033,"Michigan","Chippewa County",1,29,502,331,171
050,26,033,"Michigan","Chippewa County",1,30,525,325,200
050,26,033,"Michigan","Chippewa County",1,31,471,299,172
050,26,033,"Michigan","Chippewa County",1,32,451,304,147
050,26,033,"Michigan","Chippewa County",1,33,466,306,160
050,26,033,"Michigan","Chippewa County",1,34,454,293,161
050,26,033,"Michigan","Chippewa County",1,35,502,317,185
050,26,033,"Michigan","Chippewa County",1,36,466,298,168
050,26,033,"Michigan","Chippewa County",1,37,480,302,178
050,26,033,"Michigan","Chippewa County",1,38,502,314,188
050,26,033,"Michigan","Chippewa County",1,39,494,316,178
050,26,033,"Michigan","Chippewa County",1,40,479,313,166
050,26,033,"Michigan","Chippewa County",1,41,481,292,189
050,26,033,"Michigan","Chippewa County",1,42,464,272,192
050,26,033,"Michigan","Chippewa County",1,43,440,270,170
050,26,033,"Michigan","Chippewa County",1,44,420,265,155
050,26,033,"Michigan","Chippewa County",1,45,417,260,157
050,26,033,"Michigan","Chippewa County",1,46,425,271,154
050,26,033,"Michigan","Chippewa County",1,47,438,276,162
050,26,033,"Michigan","Chippewa County",1,48,471,280,191
050,26,033,"Michigan","Chippewa County",1,49,458,271,187
050,26,033,"Michigan","Chippewa County",1,50,445,274,171
050,26,033,"Michigan","Chippewa County",1,51,446,274,172
050,26,033,"Michigan","Chippewa County",1,52,427,253,174
050,26,033,"Michigan","Chippewa County",1,53,447,254,193
050,26,033,"Michigan","Chippewa County",1,54,441,231,210
050,26,033,"Michigan","Chippewa County",1,55,502,278,224
050,26,033,"Michigan","Chippewa County",1,56,475,264,211
050,26,033,"Michigan","Chippewa County",1,57,515,270,245
050,26,033,"Michigan","Chippewa County",1,58,513,266,247
050,26,033,"Michigan","Chippewa County",1,59,488,250,238
050,26,033,"Michigan","Chippewa County",1,60,491,261,230
050,26,033,"Michigan","Chippewa County",1,61,519,274,245
050,26,033,"Michigan","Chippewa County",1,62,517,266,251
050,26,033,"Michigan","Chippewa County",1,63,482,235,247
050,26,033,"Michigan","Chippewa County",1,64,497,265,232
050,26,033,"Michigan","Chippewa County",1,65,500,250,250
050,26,033,"Michigan","Chippewa County",1,66,486,238,248
050,26,033,"Michigan","Chippewa County",1,67,450,227,223
050,26,033,"Michigan","Chippewa County",1,68,408,209,199
050,26,033,"Michigan","Chippewa County",1,69,401,199,202
050,26,033,"Michigan","Chippewa County",1,70,401,200,201
050,26,033,"Michigan","Chippewa County",1,71,388,197,191
050,26,033,"Michigan","Chippewa County",1,72,397,198,199
050,26,033,"Michigan","Chippewa County",1,73,367,186,181
050,26,033,"Michigan","Chippewa County",1,74,247,130,117
050,26,033,"Michigan","Chippewa County",1,75,251,131,120
050,26,033,"Michigan","Chippewa County",1,76,265,142,123
050,26,033,"Michigan","Chippewa County",1,77,277,127,150
050,26,033,"Michigan","Chippewa County",1,78,215,88,127
050,26,033,"Michigan","Chippewa County",1,79,196,88,108
050,26,033,"Michigan","Chippewa County",1,80,224,103,121
050,26,033,"Michigan","Chippewa County",1,81,191,86,105
050,26,033,"Michigan","Chippewa County",1,82,161,76,85
050,26,033,"Michigan","Chippewa County",1,83,123,60,63
050,26,033,"Michigan","Chippewa County",1,84,145,63,82
050,26,033,"Michigan","Chippewa County",1,85,700,279,421
050,26,033,"Michigan","Chippewa County",2,0,308,160,148
050,26,033,"Michigan","Chippewa County",2,1,316,157,159
050,26,033,"Michigan","Chippewa County",2,2,310,156,154
050,26,033,"Michigan","Chippewa County",2,3,330,163,167
050,26,033,"Michigan","Chippewa County",2,4,367,178,189
050,26,033,"Michigan","Chippewa County",2,5,370,184,186
050,26,033,"Michigan","Chippewa County",2,6,385,184,201
050,26,033,"Michigan","Chippewa County",2,7,376,180,196
050,26,033,"Michigan","Chippewa County",2,8,362,187,175
050,26,033,"Michigan","Chippewa County",2,9,375,200,175
050,26,033,"Michigan","Chippewa County",2,10,390,199,191
050,26,033,"Michigan","Chippewa County",2,11,393,207,186
050,26,033,"Michigan","Chippewa County",2,12,382,207,175
050,26,033,"Michigan","Chippewa County",2,13,391,215,176
050,26,033,"Michigan","Chippewa County",2,14,414,213,201
050,26,033,"Michigan","Chippewa County",2,15,395,197,198
050,26,033,"Michigan","Chippewa County",2,16,399,201,198
050,26,033,"Michigan","Chippewa County",2,17,391,203,188
050,26,033,"Michigan","Chippewa County",2,18,486,258,228
050,26,033,"Michigan","Chippewa County",2,19,637,344,293
050,26,033,"Michigan","Chippewa County",2,20,689,367,322
050,26,033,"Michigan","Chippewa County",2,21,669,388,281
050,26,033,"Michigan","Chippewa County",2,22,672,346,326
050,26,033,"Michigan","Chippewa County",2,23,655,347,308
050,26,033,"Michigan","Chippewa County",2,24,551,317,234
050,26,033,"Michigan","Chippewa County",2,25,496,305,191
050,26,033,"Michigan","Chippewa County",2,26,493,315,178
050,26,033,"Michigan","Chippewa County",2,27,479,301,178
050,26,033,"Michigan","Chippewa County",2,28,480,308,172
050,26,033,"Michigan","Chippewa County",2,29,504,332,172
050,26,033,"Michigan","Chippewa County",2,30,527,329,198
050,26,033,"Michigan","Chippewa County",2,31,481,302,179
050,26,033,"Michigan","Chippewa County",2,32,454,300,154
050,26,033,"Michigan","Chippewa County",2,33,463,306,157
050,26,033,"Michigan","Chippewa County",2,34,452,291,161
050,26,033,"Michigan","Chippewa County",2,35,491,312,179
050,26,033,"Michigan","Chippewa County",2,36,472,301,171
050,26,033,"Michigan","Chippewa County",2,37,476,300,176
050,26,033,"Michigan","Chippewa County",2,38,502,314,188
050,26,033,"Michigan","Chippewa County",2,39,493,315,178
050,26,033,"Michigan","Chippewa County",2,40,485,316,169
050,26,033,"Michigan","Chippewa County",2,41,475,292,183
050,26,033,"Michigan","Chippewa County",2,42,463,274,189
050,26,033,"Michigan","Chippewa County",2,43,444,270,174
050,26,033,"Michigan","Chippewa County",2,44,423,268,155
050,26,033,"Michigan","Chippewa County",2,45,415,257,158
050,26,033,"Michigan","Chippewa County",2,46,422,267,155
050,26,033,"Michigan","Chippewa County",2,47,434,273,161
050,26,033,"Michigan","Chippewa County",2,48,459,275,184
050,26,033,"Michigan","Chippewa County",2,49,460,272,188
050,26,033,"Michigan","Chippewa County",2,50,454,276,178
050,26,033,"Michigan","Chippewa County",2,51,447,275,172
050,26,033,"Michigan","Chippewa County",2,52,429,256,173
050,26,033,"Michigan","Chippewa County",2,53,438,251,187
050,26,033,"Michigan","Chippewa County",2,54,437,233,204
050,26,033,"Michigan","Chippewa County",2,55,488,267,221
050,26,033,"Michigan","Chippewa County",2,56,480,266,214
050,26,033,"Michigan","Chippewa County",2,57,506,267,239
050,26,033,"Michigan","Chippewa County",2,58,508,263,245
050,26,033,"Michigan","Chippewa County",2,59,500,256,244
050,26,033,"Michigan","Chippewa County",2,60,491,260,231
050,26,033,"Michigan","Chippewa County",2,61,511,269,242
050,26,033,"Michigan","Chippewa County",2,62,519,269,250
050,26,033,"Michigan","Chippewa County",2,63,493,245,248
050,26,033,"Michigan","Chippewa County",2,64,492,256,236
050,26,033,"Michigan","Chippewa County",2,65,497,252,245
050,26,033,"Michigan","Chippewa County",2,66,489,239,250
050,26,033,"Michigan","Chippewa County",2,67,454,228,226
050,26,033,"Michigan","Chippewa County",2,68,413,213,200
050,26,033,"Michigan","Chippewa County",2,69,405,203,202
050,26,033,"Michigan","Chippewa County",2,70,396,196,200
050,26,033,"Michigan","Chippewa County",2,71,391,198,193
050,26,033,"Michigan","Chippewa County",2,72,389,195,194
050,26,033,"Michigan","Chippewa County",2,73,390,199,191
050,26,033,"Michigan","Chippewa County",2,74,256,133,123
050,26,033,"Michigan","Chippewa County",2,75,251,131,120
050,26,033,"Michigan","Chippewa County",2,76,256,135,121
050,26,033,"Michigan","Chippewa County",2,77,277,131,146
050,26,033,"Michigan","Chippewa County",2,78,224,95,129
050,26,033,"Michigan","Chippewa County",2,79,194,85,109
050,26,033,"Michigan","Chippewa County",2,80,218,100,118
050,26,033,"Michigan","Chippewa County",2,81,195,88,107
050,26,033,"Michigan","Chippewa County",2,82,165,77,88
050,26,033,"Michigan","Chippewa County",2,83,128,61,67
050,26,033,"Michigan","Chippewa County",2,84,137,60,77
050,26,033,"Michigan","Chippewa County",2,85,713,286,427
050,26,033,"Michigan","Chippewa County",3,0,295,161,134
050,26,033,"Michigan","Chippewa County",3,1,316,166,150
050,26,033,"Michigan","Chippewa County",3,2,310,159,151
050,26,033,"Michigan","Chippewa County",3,3,321,158,163
050,26,033,"Michigan","Chippewa County",3,4,345,177,168
050,26,033,"Michigan","Chippewa County",3,5,357,174,183
050,26,033,"Michigan","Chippewa County",3,6,380,190,190
050,26,033,"Michigan","Chippewa County",3,7,377,178,199
050,26,033,"Michigan","Chippewa County",3,8,384,184,200
050,26,033,"Michigan","Chippewa County",3,9,358,185,173
050,26,033,"Michigan","Chippewa County",3,10,372,197,175
050,26,033,"Michigan","Chippewa County",3,11,373,192,181
050,26,033,"Michigan","Chippewa County",3,12,398,210,188
050,26,033,"Michigan","Chippewa County",3,13,384,210,174
050,26,033,"Michigan","Chippewa County",3,14,404,218,186
050,26,033,"Michigan","Chippewa County",3,15,407,213,194
050,26,033,"Michigan","Chippewa County",3,16,410,204,206
050,26,033,"Michigan","Chippewa County",3,17,406,207,199
050,26,033,"Michigan","Chippewa County",3,18,476,244,232
050,26,033,"Michigan","Chippewa County",3,19,612,335,277
050,26,033,"Michigan","Chippewa County",3,20,656,341,315
050,26,033,"Michigan","Chippewa County",3,21,670,379,291
050,26,033,"Michigan","Chippewa County",3,22,635,320,315
050,26,033,"Michigan","Chippewa County",3,23,650,336,314
050,26,033,"Michigan","Chippewa County",3,24,512,283,229
050,26,033,"Michigan","Chippewa County",3,25,447,256,191
050,26,033,"Michigan","Chippewa County",3,26,472,296,176
050,26,033,"Michigan","Chippewa County",3,27,464,291,173
050,26,033,"Michigan","Chippewa County",3,28,450,280,170
050,26,033,"Michigan","Chippewa County",3,29,462,293,169
050,26,033,"Michigan","Chippewa County",3,30,469,299,170
050,26,033,"Michigan","Chippewa County",3,31,470,276,194
050,26,033,"Michigan","Chippewa County",3,32,441,269,172
050,26,033,"Michigan","Chippewa County",3,33,431,275,156
050,26,033,"Michigan","Chippewa County",3,34,419,260,159
050,26,033,"Michigan","Chippewa County",3,35,439,268,171
050,26,033,"Michigan","Chippewa County",3,36,447,272,175
050,26,033,"Michigan","Chippewa County",3,37,443,273,170
050,26,033,"Michigan","Chippewa County",3,38,479,292,187
050,26,033,"Michigan","Chippewa County",3,39,486,300,186
050,26,033,"Michigan","Chippewa County",3,40,483,297,186
050,26,033,"Michigan","Chippewa County",3,41,453,274,179
050,26,033,"Michigan","Chippewa County",3,42,435,253,182
050,26,033,"Michigan","Chippewa County",3,43,440,247,193
050,26,033,"Michigan","Chippewa County",3,44,435,258,177
050,26,033,"Michigan","Chippewa County",3,45,386,232,154
050,26,033,"Michigan","Chippewa County",3,46,401,244,157
050,26,033,"Michigan","Chippewa County",3,47,404,245,159
050,26,033,"Michigan","Chippewa County",3,48,410,251,159
050,26,033,"Michigan","Chippewa County",3,49,434,249,185
050,26,033,"Michigan","Chippewa County",3,50,453,270,183
050,26,033,"Michigan","Chippewa County",3,51,453,269,184
050,26,033,"Michigan","Chippewa County",3,52,425,251,174
050,26,033,"Michigan","Chippewa County",3,53,414,236,178
050,26,033,"Michigan","Chippewa County",3,54,404,219,185
050,26,033,"Michigan","Chippewa County",3,55,439,229,210
050,26,033,"Michigan","Chippewa County",3,56,465,255,210
050,26,033,"Michigan","Chippewa County",3,57,465,250,215
050,26,033,"Michigan","Chippewa County",3,58,491,255,236
050,26,033,"Michigan","Chippewa County",3,59,496,249,247
050,26,033,"Michigan","Chippewa County",3,60,492,251,241
050,26,033,"Michigan","Chippewa County",3,61,493,253,240
050,26,033,"Michigan","Chippewa County",3,62,520,274,246
050,26,033,"Michigan","Chippewa County",3,63,505,263,242
050,26,033,"Michigan","Chippewa County",3,64,500,244,256
050,26,033,"Michigan","Chippewa County",3,65,482,244,238
050,26,033,"Michigan","Chippewa County",3,66,491,246,245
050,26,033,"Michigan","Chippewa County",3,67,478,234,244
050,26,033,"Michigan","Chippewa County",3,68,437,216,221
050,26,033,"Michigan","Chippewa County",3,69,400,203,197
050,26,033,"Michigan","Chippewa County",3,70,391,196,195
050,26,033,"Michigan","Chippewa County",3,71,372,185,187
050,26,033,"Michigan","Chippewa County",3,72,385,191,194
050,26,033,"Michigan","Chippewa County",3,73,373,182,191
050,26,033,"Michigan","Chippewa County",3,74,380,194,186
050,26,033,"Michigan","Chippewa County",3,75,255,128,127
050,26,033,"Michigan","Chippewa County",3,76,248,132,116
050,26,033,"Michigan","Chippewa County",3,77,232,116,116
050,26,033,"Michigan","Chippewa County",3,78,255,121,134
050,26,033,"Michigan","Chippewa County",3,79,206,89,117
050,26,033,"Michigan","Chippewa County",3,80,184,76,108
050,26,033,"Michigan","Chippewa County",3,81,189,84,105
050,26,033,"Michigan","Chippewa County",3,82,174,79,95
050,26,033,"Michigan","Chippewa County",3,83,155,70,85
050,26,033,"Michigan","Chippewa County",3,84,121,53,68
050,26,033,"Michigan","Chippewa County",3,85,718,290,428
050,26,033,"Michigan","Chippewa County",4,0,284,150,134
050,26,033,"Michigan","Chippewa County",4,1,329,189,140
050,26,033,"Michigan","Chippewa County",4,2,327,176,151
050,26,033,"Michigan","Chippewa County",4,3,319,165,154
050,26,033,"Michigan","Chippewa County",4,4,332,157,175
050,26,033,"Michigan","Chippewa County",4,5,340,167,173
050,26,033,"Michigan","Chippewa County",4,6,359,176,183
050,26,033,"Michigan","Chippewa County",4,7,388,200,188
050,26,033,"Michigan","Chippewa County",4,8,388,187,201
050,26,033,"Michigan","Chippewa County",4,9,371,183,188
050,26,033,"Michigan","Chippewa County",4,10,364,195,169
050,26,033,"Michigan","Chippewa County",4,11,365,195,170
050,26,033,"Michigan","Chippewa County",4,12,387,198,189
050,26,033,"Michigan","Chippewa County",4,13,393,207,186
050,26,033,"Michigan","Chippewa County",4,14,392,212,180
050,26,033,"Michigan","Chippewa County",4,15,401,215,186
050,26,033,"Michigan","Chippewa County",4,16,403,207,196
050,26,033,"Michigan","Chippewa County",4,17,421,212,209
050,26,033,"Michigan","Chippewa County",4,18,496,259,237
050,26,033,"Michigan","Chippewa County",4,19,590,323,267
050,26,033,"Michigan","Chippewa County",4,20,648,352,296
050,26,033,"Michigan","Chippewa County",4,21,650,371,279
050,26,033,"Michigan","Chippewa County",4,22,683,357,326
050,26,033,"Michigan","Chippewa County",4,23,642,333,309
050,26,033,"Michigan","Chippewa County",4,24,546,312,234
050,26,033,"Michigan","Chippewa County",4,25,453,262,191
050,26,033,"Michigan","Chippewa County",4,26,465,278,187
050,26,033,"Michigan","Chippewa County",4,27,461,298,163
050,26,033,"Michigan","Chippewa County",4,28,476,308,168
050,26,033,"Michigan","Chippewa County",4,29,481,307,174
050,26,033,"Michigan","Chippewa County",4,30,478,311,167
050,26,033,"Michigan","Chippewa County",4,31,476,302,174
050,26,033,"Michigan","Chippewa County",4,32,477,281,196
050,26,033,"Michigan","Chippewa County",4,33,482,293,189
050,26,033,"Michigan","Chippewa County",4,34,443,280,163
050,26,033,"Michigan","Chippewa County",4,35,443,274,169
050,26,033,"Michigan","Chippewa County",4,36,441,268,173
050,26,033,"Michigan","Chippewa County",4,37,452,276,176
050,26,033,"Michigan","Chippewa County",4,38,472,296,176
050,26,033,"Michigan","Chippewa County",4,39,490,309,181
050,26,033,"Michigan","Chippewa County",4,40,490,306,184
050,26,033,"Michigan","Chippewa County",4,41,485,291,194
050,26,033,"Michigan","Chippewa County",4,42,449,281,168
050,26,033,"Michigan","Chippewa County",4,43,444,262,182
050,26,033,"Michigan","Chippewa County",4,44,450,262,188
050,26,033,"Michigan","Chippewa County",4,45,436,261,175
050,26,033,"Michigan","Chippewa County",4,46,395,242,153
050,26,033,"Michigan","Chippewa County",4,47,421,259,162
050,26,033,"Michigan","Chippewa County",4,48,396,235,161
050,26,033,"Michigan","Chippewa County",4,49,400,251,149
050,26,033,"Michigan","Chippewa County",4,50,451,266,185
050,26,033,"Michigan","Chippewa County",4,51,458,276,182
050,26,033,"Michigan","Chippewa County",4,52,453,264,189
050,26,033,"Michigan","Chippewa County",4,53,427,251,176
050,26,033,"Michigan","Chippewa County",4,54,402,221,181
050,26,033,"Michigan","Chippewa County",4,55,413,234,179
050,26,033,"Michigan","Chippewa County",4,56,455,242,213
050,26,033,"Michigan","Chippewa County",4,57,471,260,211
050,26,033,"Michigan","Chippewa County",4,58,467,248,219
050,26,033,"Michigan","Chippewa County",4,59,499,258,241
050,26,033,"Michigan","Chippewa County",4,60,496,248,248
050,26,033,"Michigan","Chippewa County",4,61,482,241,241
050,26,033,"Michigan","Chippewa County",4,62,495,250,245
050,26,033,"Michigan","Chippewa County",4,63,513,265,248
050,26,033,"Michigan","Chippewa County",4,64,495,262,233
050,26,033,"Michigan","Chippewa County",4,65,487,239,248
050,26,033,"Michigan","Chippewa County",4,66,477,239,238
050,26,033,"Michigan","Chippewa County",4,67,503,244,259
050,26,033,"Michigan","Chippewa County",4,68,476,235,241
050,26,033,"Michigan","Chippewa County",4,69,429,208,221
050,26,033,"Michigan","Chippewa County",4,70,379,192,187
050,26,033,"Michigan","Chippewa County",4,71,378,188,190
050,26,033,"Michigan","Chippewa County",4,72,370,182,188
050,26,033,"Michigan","Chippewa County",4,73,371,179,192
050,26,033,"Michigan","Chippewa County",4,74,357,175,182
050,26,033,"Michigan","Chippewa County",4,75,371,195,176
050,26,033,"Michigan","Chippewa County",4,76,243,124,119
050,26,033,"Michigan","Chippewa County",4,77,234,124,110
050,26,033,"Michigan","Chippewa County",4,78,213,110,103
050,26,033,"Michigan","Chippewa County",4,79,231,111,120
050,26,033,"Michigan","Chippewa County",4,80,197,83,114
050,26,033,"Michigan","Chippewa County",4,81,167,63,104
050,26,033,"Michigan","Chippewa County",4,82,171,77,94
050,26,033,"Michigan","Chippewa County",4,83,160,71,89
050,26,033,"Michigan","Chippewa County",4,84,144,62,82
050,26,033,"Michigan","Chippewa County",4,85,698,281,417
050,26,033,"Michigan","Chippewa County",5,0,286,151,135
050,26,033,"Michigan","Chippewa County",5,1,301,157,144
050,26,033,"Michigan","Chippewa County",5,2,334,190,144
050,26,033,"Michigan","Chippewa County",5,3,321,173,148
050,26,033,"Michigan","Chippewa County",5,4,328,166,162
050,26,033,"Michigan","Chippewa County",5,5,333,164,169
050,26,033,"Michigan","Chippewa County",5,6,353,174,179
050,26,033,"Michigan","Chippewa County",5,7,357,180,177
050,26,033,"Michigan","Chippewa County",5,8,388,201,187
050,26,033,"Michigan","Chippewa County",5,9,390,191,199
050,26,033,"Michigan","Chippewa County",5,10,378,189,189
050,26,033,"Michigan","Chippewa County",5,11,372,200,172
050,26,033,"Michigan","Chippewa County",5,12,367,195,172
050,26,033,"Michigan","Chippewa County",5,13,397,199,198
050,26,033,"Michigan","Chippewa County",5,14,385,201,184
050,26,033,"Michigan","Chippewa County",5,15,389,214,175
050,26,033,"Michigan","Chippewa County",5,16,398,214,184
050,26,033,"Michigan","Chippewa County",5,17,414,217,197
050,26,033,"Michigan","Chippewa County",5,18,492,258,234
050,26,033,"Michigan","Chippewa County",5,19,619,346,273
050,26,033,"Michigan","Chippewa County",5,20,650,344,306
050,26,033,"Michigan","Chippewa County",5,21,662,390,272
050,26,033,"Michigan","Chippewa County",5,22,654,332,322
050,26,033,"Michigan","Chippewa County",5,23,656,350,306
050,26,033,"Michigan","Chippewa County",5,24,520,301,219
050,26,033,"Michigan","Chippewa County",5,25,498,292,206
050,26,033,"Michigan","Chippewa County",5,26,462,267,195
050,26,033,"Michigan","Chippewa County",5,27,451,270,181
050,26,033,"Michigan","Chippewa County",5,28,472,307,165
050,26,033,"Michigan","Chippewa County",5,29,503,320,183
050,26,033,"Michigan","Chippewa County",5,30,498,315,183
050,26,033,"Michigan","Chippewa County",5,31,456,288,168
050,26,033,"Michigan","Chippewa County",5,32,469,292,177
050,26,033,"Michigan","Chippewa County",5,33,502,300,202
050,26,033,"Michigan","Chippewa County",5,34,470,278,192
050,26,033,"Michigan","Chippewa County",5,35,460,284,176
050,26,033,"Michigan","Chippewa County",5,36,448,277,171
050,26,033,"Michigan","Chippewa County",5,37,437,260,177
050,26,033,"Michigan","Chippewa County",5,38,466,288,178
050,26,033,"Michigan","Chippewa County",5,39,473,299,174
050,26,033,"Michigan","Chippewa County",5,40,497,318,179
050,26,033,"Michigan","Chippewa County",5,41,481,293,188
050,26,033,"Michigan","Chippewa County",5,42,471,279,192
050,26,033,"Michigan","Chippewa County",5,43,442,273,169
050,26,033,"Michigan","Chippewa County",5,44,455,274,181
050,26,033,"Michigan","Chippewa County",5,45,437,244,193
050,26,033,"Michigan","Chippewa County",5,46,440,265,175
050,26,033,"Michigan","Chippewa County",5,47,403,246,157
050,26,033,"Michigan","Chippewa County",5,48,410,247,163
050,26,033,"Michigan","Chippewa County",5,49,385,219,166
050,26,033,"Michigan","Chippewa County",5,50,412,265,147
050,26,033,"Michigan","Chippewa County",5,51,448,266,182
050,26,033,"Michigan","Chippewa County",5,52,444,261,183
050,26,033,"Michigan","Chippewa County",5,53,444,256,188
050,26,033,"Michigan","Chippewa County",5,54,413,236,177
050,26,033,"Michigan","Chippewa County",5,55,404,224,180
050,26,033,"Michigan","Chippewa County",5,56,414,230,184
050,26,033,"Michigan","Chippewa County",5,57,456,234,222
050,26,033,"Michigan","Chippewa County",5,58,462,253,209
050,26,033,"Michigan","Chippewa County",5,59,477,251,226
050,26,033,"Michigan","Chippewa County",5,60,491,254,237
050,26,033,"Michigan","Chippewa County",5,61,487,240,247
050,26,033,"Michigan","Chippewa County",5,62,488,243,245
050,26,033,"Michigan","Chippewa County",5,63,475,233,242
050,26,033,"Michigan","Chippewa County",5,64,512,263,249
050,26,033,"Michigan","Chippewa County",5,65,482,251,231
050,26,033,"Michigan","Chippewa County",5,66,480,234,246
050,26,033,"Michigan","Chippewa County",5,67,480,241,239
050,26,033,"Michigan","Chippewa County",5,68,497,244,253
050,26,033,"Michigan","Chippewa County",5,69,461,226,235
050,26,033,"Michigan","Chippewa County",5,70,423,204,219
050,26,033,"Michigan","Chippewa County",5,71,373,186,187
050,26,033,"Michigan","Chippewa County",5,72,371,184,187
050,26,033,"Michigan","Chippewa County",5,73,352,167,185
050,26,033,"Michigan","Chippewa County",5,74,364,179,185
050,26,033,"Michigan","Chippewa County",5,75,343,167,176
050,26,033,"Michigan","Chippewa County",5,76,367,195,172
050,26,033,"Michigan","Chippewa County",5,77,226,113,113
050,26,033,"Michigan","Chippewa County",5,78,217,118,99
050,26,033,"Michigan","Chippewa County",5,79,197,104,93
050,26,033,"Michigan","Chippewa County",5,80,224,105,119
050,26,033,"Michigan","Chippewa County",5,81,176,70,106
050,26,033,"Michigan","Chippewa County",5,82,151,58,93
050,26,033,"Michigan","Chippewa County",5,83,157,69,88
050,26,033,"Michigan","Chippewa County",5,84,150,64,86
050,26,033,"Michigan","Chippewa County",5,85,716,293,423
050,26,035,"Michigan","Clare County",1,0,303,157,146
050,26,035,"Michigan","Clare County",1,1,300,160,140
050,26,035,"Michigan","Clare County",1,2,340,177,163
050,26,035,"Michigan","Clare County",1,3,324,165,159
050,26,035,"Michigan","Clare County",1,4,338,163,175
050,26,035,"Michigan","Clare County",1,5,346,169,177
050,26,035,"Michigan","Clare County",1,6,342,176,166
050,26,035,"Michigan","Clare County",1,7,331,166,165
050,26,035,"Michigan","Clare County",1,8,324,172,152
050,26,035,"Michigan","Clare County",1,9,322,169,153
050,26,035,"Michigan","Clare County",1,10,344,169,175
050,26,035,"Michigan","Clare County",1,11,373,175,198
050,26,035,"Michigan","Clare County",1,12,376,207,169
050,26,035,"Michigan","Clare County",1,13,386,214,172
050,26,035,"Michigan","Clare County",1,14,360,190,170
050,26,035,"Michigan","Clare County",1,15,356,178,178
050,26,035,"Michigan","Clare County",1,16,368,177,191
050,26,035,"Michigan","Clare County",1,17,337,169,168
050,26,035,"Michigan","Clare County",1,18,315,177,138
050,26,035,"Michigan","Clare County",1,19,251,139,112
050,26,035,"Michigan","Clare County",1,20,256,144,112
050,26,035,"Michigan","Clare County",1,21,294,155,139
050,26,035,"Michigan","Clare County",1,22,281,147,134
050,26,035,"Michigan","Clare County",1,23,310,169,141
050,26,035,"Michigan","Clare County",1,24,321,165,156
050,26,035,"Michigan","Clare County",1,25,320,168,152
050,26,035,"Michigan","Clare County",1,26,302,162,140
050,26,035,"Michigan","Clare County",1,27,305,138,167
050,26,035,"Michigan","Clare County",1,28,329,161,168
050,26,035,"Michigan","Clare County",1,29,345,170,175
050,26,035,"Michigan","Clare County",1,30,353,189,164
050,26,035,"Michigan","Clare County",1,31,313,158,155
050,26,035,"Michigan","Clare County",1,32,330,159,171
050,26,035,"Michigan","Clare County",1,33,336,173,163
050,26,035,"Michigan","Clare County",1,34,295,154,141
050,26,035,"Michigan","Clare County",1,35,283,130,153
050,26,035,"Michigan","Clare County",1,36,298,162,136
050,26,035,"Michigan","Clare County",1,37,312,158,154
050,26,035,"Michigan","Clare County",1,38,305,150,155
050,26,035,"Michigan","Clare County",1,39,319,166,153
050,26,035,"Michigan","Clare County",1,40,313,160,153
050,26,035,"Michigan","Clare County",1,41,304,157,147
050,26,035,"Michigan","Clare County",1,42,308,154,154
050,26,035,"Michigan","Clare County",1,43,323,160,163
050,26,035,"Michigan","Clare County",1,44,309,149,160
050,26,035,"Michigan","Clare County",1,45,343,179,164
050,26,035,"Michigan","Clare County",1,46,368,191,177
050,26,035,"Michigan","Clare County",1,47,324,175,149
050,26,035,"Michigan","Clare County",1,48,336,171,165
050,26,035,"Michigan","Clare County",1,49,382,195,187
050,26,035,"Michigan","Clare County",1,50,379,181,198
050,26,035,"Michigan","Clare County",1,51,375,188,187
050,26,035,"Michigan","Clare County",1,52,400,214,186
050,26,035,"Michigan","Clare County",1,53,423,211,212
050,26,035,"Michigan","Clare County",1,54,415,205,210
050,26,035,"Michigan","Clare County",1,55,439,218,221
050,26,035,"Michigan","Clare County",1,56,453,229,224
050,26,035,"Michigan","Clare County",1,57,492,239,253
050,26,035,"Michigan","Clare County",1,58,559,286,273
050,26,035,"Michigan","Clare County",1,59,518,245,273
050,26,035,"Michigan","Clare County",1,60,517,252,265
050,26,035,"Michigan","Clare County",1,61,535,267,268
050,26,035,"Michigan","Clare County",1,62,573,292,281
050,26,035,"Michigan","Clare County",1,63,546,297,249
050,26,035,"Michigan","Clare County",1,64,560,278,282
050,26,035,"Michigan","Clare County",1,65,551,280,271
050,26,035,"Michigan","Clare County",1,66,509,246,263
050,26,035,"Michigan","Clare County",1,67,530,257,273
050,26,035,"Michigan","Clare County",1,68,548,262,286
050,26,035,"Michigan","Clare County",1,69,468,218,250
050,26,035,"Michigan","Clare County",1,70,398,193,205
050,26,035,"Michigan","Clare County",1,71,447,230,217
050,26,035,"Michigan","Clare County",1,72,440,224,216
050,26,035,"Michigan","Clare County",1,73,430,216,214
050,26,035,"Michigan","Clare County",1,74,301,150,151
050,26,035,"Michigan","Clare County",1,75,305,149,156
050,26,035,"Michigan","Clare County",1,76,312,154,158
050,26,035,"Michigan","Clare County",1,77,288,153,135
050,26,035,"Michigan","Clare County",1,78,240,125,115
050,26,035,"Michigan","Clare County",1,79,212,102,110
050,26,035,"Michigan","Clare County",1,80,190,86,104
050,26,035,"Michigan","Clare County",1,81,195,95,100
050,26,035,"Michigan","Clare County",1,82,168,88,80
050,26,035,"Michigan","Clare County",1,83,155,68,87
050,26,035,"Michigan","Clare County",1,84,127,62,65
050,26,035,"Michigan","Clare County",1,85,612,256,356
050,26,035,"Michigan","Clare County",2,0,289,145,144
050,26,035,"Michigan","Clare County",2,1,301,162,139
050,26,035,"Michigan","Clare County",2,2,330,173,157
050,26,035,"Michigan","Clare County",2,3,323,165,158
050,26,035,"Michigan","Clare County",2,4,332,161,171
050,26,035,"Michigan","Clare County",2,5,345,168,177
050,26,035,"Michigan","Clare County",2,6,346,177,169
050,26,035,"Michigan","Clare County",2,7,330,167,163
050,26,035,"Michigan","Clare County",2,8,325,170,155
050,26,035,"Michigan","Clare County",2,9,325,170,155
050,26,035,"Michigan","Clare County",2,10,339,168,171
050,26,035,"Michigan","Clare County",2,11,365,175,190
050,26,035,"Michigan","Clare County",2,12,375,199,176
050,26,035,"Michigan","Clare County",2,13,380,212,168
050,26,035,"Michigan","Clare County",2,14,365,196,169
050,26,035,"Michigan","Clare County",2,15,358,181,177
050,26,035,"Michigan","Clare County",2,16,364,177,187
050,26,035,"Michigan","Clare County",2,17,347,174,173
050,26,035,"Michigan","Clare County",2,18,304,167,137
050,26,035,"Michigan","Clare County",2,19,250,138,112
050,26,035,"Michigan","Clare County",2,20,260,145,115
050,26,035,"Michigan","Clare County",2,21,287,153,134
050,26,035,"Michigan","Clare County",2,22,291,153,138
050,26,035,"Michigan","Clare County",2,23,306,166,140
050,26,035,"Michigan","Clare County",2,24,317,167,150
050,26,035,"Michigan","Clare County",2,25,316,165,151
050,26,035,"Michigan","Clare County",2,26,301,160,141
050,26,035,"Michigan","Clare County",2,27,303,145,158
050,26,035,"Michigan","Clare County",2,28,323,157,166
050,26,035,"Michigan","Clare County",2,29,343,170,173
050,26,035,"Michigan","Clare County",2,30,352,184,168
050,26,035,"Michigan","Clare County",2,31,321,163,158
050,26,035,"Michigan","Clare County",2,32,324,159,165
050,26,035,"Michigan","Clare County",2,33,336,171,165
050,26,035,"Michigan","Clare County",2,34,303,157,146
050,26,035,"Michigan","Clare County",2,35,288,137,151
050,26,035,"Michigan","Clare County",2,36,292,153,139
050,26,035,"Michigan","Clare County",2,37,310,159,151
050,26,035,"Michigan","Clare County",2,38,308,151,157
050,26,035,"Michigan","Clare County",2,39,314,161,153
050,26,035,"Michigan","Clare County",2,40,320,166,154
050,26,035,"Michigan","Clare County",2,41,307,156,151
050,26,035,"Michigan","Clare County",2,42,305,153,152
050,26,035,"Michigan","Clare County",2,43,319,158,161
050,26,035,"Michigan","Clare County",2,44,309,149,160
050,26,035,"Michigan","Clare County",2,45,338,173,165
050,26,035,"Michigan","Clare County",2,46,361,189,172
050,26,035,"Michigan","Clare County",2,47,332,178,154
050,26,035,"Michigan","Clare County",2,48,332,172,160
050,26,035,"Michigan","Clare County",2,49,373,189,184
050,26,035,"Michigan","Clare County",2,50,380,185,195
050,26,035,"Michigan","Clare County",2,51,376,186,190
050,26,035,"Michigan","Clare County",2,52,393,208,185
050,26,035,"Michigan","Clare County",2,53,415,208,207
050,26,035,"Michigan","Clare County",2,54,414,203,211
050,26,035,"Michigan","Clare County",2,55,436,217,219
050,26,035,"Michigan","Clare County",2,56,455,229,226
050,26,035,"Michigan","Clare County",2,57,486,238,248
050,26,035,"Michigan","Clare County",2,58,547,277,270
050,26,035,"Michigan","Clare County",2,59,533,256,277
050,26,035,"Michigan","Clare County",2,60,517,251,266
050,26,035,"Michigan","Clare County",2,61,536,268,268
050,26,035,"Michigan","Clare County",2,62,565,288,277
050,26,035,"Michigan","Clare County",2,63,558,298,260
050,26,035,"Michigan","Clare County",2,64,556,282,274
050,26,035,"Michigan","Clare County",2,65,553,279,274
050,26,035,"Michigan","Clare County",2,66,522,255,267
050,26,035,"Michigan","Clare County",2,67,526,255,271
050,26,035,"Michigan","Clare County",2,68,540,259,281
050,26,035,"Michigan","Clare County",2,69,488,229,259
050,26,035,"Michigan","Clare County",2,70,414,199,215
050,26,035,"Michigan","Clare County",2,71,434,220,214
050,26,035,"Michigan","Clare County",2,72,435,222,213
050,26,035,"Michigan","Clare County",2,73,457,230,227
050,26,035,"Michigan","Clare County",2,74,313,158,155
050,26,035,"Michigan","Clare County",2,75,302,148,154
050,26,035,"Michigan","Clare County",2,76,303,149,154
050,26,035,"Michigan","Clare County",2,77,296,154,142
050,26,035,"Michigan","Clare County",2,78,244,128,116
050,26,035,"Michigan","Clare County",2,79,216,105,111
050,26,035,"Michigan","Clare County",2,80,189,86,103
050,26,035,"Michigan","Clare County",2,81,191,91,100
050,26,035,"Michigan","Clare County",2,82,172,89,83
050,26,035,"Michigan","Clare County",2,83,155,70,85
050,26,035,"Michigan","Clare County",2,84,129,60,69
050,26,035,"Michigan","Clare County",2,85,613,259,354
050,26,035,"Michigan","Clare County",3,0,309,157,152
050,26,035,"Michigan","Clare County",3,1,285,140,145
050,26,035,"Michigan","Clare County",3,2,316,165,151
050,26,035,"Michigan","Clare County",3,3,317,158,159
050,26,035,"Michigan","Clare County",3,4,337,161,176
050,26,035,"Michigan","Clare County",3,5,334,165,169
050,26,035,"Michigan","Clare County",3,6,332,162,170
050,26,035,"Michigan","Clare County",3,7,341,176,165
050,26,035,"Michigan","Clare County",3,8,331,173,158
050,26,035,"Michigan","Clare County",3,9,340,180,160
050,26,035,"Michigan","Clare County",3,10,337,178,159
050,26,035,"Michigan","Clare County",3,11,348,180,168
050,26,035,"Michigan","Clare County",3,12,361,170,191
050,26,035,"Michigan","Clare County",3,13,384,200,184
050,26,035,"Michigan","Clare County",3,14,380,208,172
050,26,035,"Michigan","Clare County",3,15,366,194,172
050,26,035,"Michigan","Clare County",3,16,364,176,188
050,26,035,"Michigan","Clare County",3,17,369,193,176
050,26,035,"Michigan","Clare County",3,18,294,149,145
050,26,035,"Michigan","Clare County",3,19,244,136,108
050,26,035,"Michigan","Clare County",3,20,264,144,120
050,26,035,"Michigan","Clare County",3,21,295,158,137
050,26,035,"Michigan","Clare County",3,22,298,162,136
050,26,035,"Michigan","Clare County",3,23,285,155,130
050,26,035,"Michigan","Clare County",3,24,301,162,139
050,26,035,"Michigan","Clare County",3,25,321,168,153
050,26,035,"Michigan","Clare County",3,26,318,164,154
050,26,035,"Michigan","Clare County",3,27,310,156,154
050,26,035,"Michigan","Clare County",3,28,320,161,159
050,26,035,"Michigan","Clare County",3,29,338,162,176
050,26,035,"Michigan","Clare County",3,30,346,177,169
050,26,035,"Michigan","Clare County",3,31,370,192,178
050,26,035,"Michigan","Clare County",3,32,331,173,158
050,26,035,"Michigan","Clare County",3,33,312,149,163
050,26,035,"Michigan","Clare County",3,34,328,164,164
050,26,035,"Michigan","Clare County",3,35,310,159,151
050,26,035,"Michigan","Clare County",3,36,298,147,151
050,26,035,"Michigan","Clare County",3,37,294,149,145
050,26,035,"Michigan","Clare County",3,38,302,149,153
050,26,035,"Michigan","Clare County",3,39,314,157,157
050,26,035,"Michigan","Clare County",3,40,329,168,161
050,26,035,"Michigan","Clare County",3,41,320,167,153
050,26,035,"Michigan","Clare County",3,42,314,159,155
050,26,035,"Michigan","Clare County",3,43,307,155,152
050,26,035,"Michigan","Clare County",3,44,315,151,164
050,26,035,"Michigan","Clare County",3,45,306,146,160
050,26,035,"Michigan","Clare County",3,46,338,173,165
050,26,035,"Michigan","Clare County",3,47,369,199,170
050,26,035,"Michigan","Clare County",3,48,345,181,164
050,26,035,"Michigan","Clare County",3,49,331,168,163
050,26,035,"Michigan","Clare County",3,50,408,209,199
050,26,035,"Michigan","Clare County",3,51,394,192,202
050,26,035,"Michigan","Clare County",3,52,383,191,192
050,26,035,"Michigan","Clare County",3,53,402,210,192
050,26,035,"Michigan","Clare County",3,54,431,217,214
050,26,035,"Michigan","Clare County",3,55,430,212,218
050,26,035,"Michigan","Clare County",3,56,439,222,217
050,26,035,"Michigan","Clare County",3,57,471,235,236
050,26,035,"Michigan","Clare County",3,58,503,242,261
050,26,035,"Michigan","Clare County",3,59,576,297,279
050,26,035,"Michigan","Clare County",3,60,538,254,284
050,26,035,"Michigan","Clare County",3,61,532,258,274
050,26,035,"Michigan","Clare County",3,62,544,267,277
050,26,035,"Michigan","Clare County",3,63,596,304,292
050,26,035,"Michigan","Clare County",3,64,563,293,270
050,26,035,"Michigan","Clare County",3,65,575,293,282
050,26,035,"Michigan","Clare County",3,66,573,291,282
050,26,035,"Michigan","Clare County",3,67,515,257,258
050,26,035,"Michigan","Clare County",3,68,520,250,270
050,26,035,"Michigan","Clare County",3,69,543,263,280
050,26,035,"Michigan","Clare County",3,70,486,229,257
050,26,035,"Michigan","Clare County",3,71,402,196,206
050,26,035,"Michigan","Clare County",3,72,420,212,208
050,26,035,"Michigan","Clare County",3,73,410,207,203
050,26,035,"Michigan","Clare County",3,74,443,225,218
050,26,035,"Michigan","Clare County",3,75,308,158,150
050,26,035,"Michigan","Clare County",3,76,290,138,152
050,26,035,"Michigan","Clare County",3,77,274,133,141
050,26,035,"Michigan","Clare County",3,78,279,145,134
050,26,035,"Michigan","Clare County",3,79,236,120,116
050,26,035,"Michigan","Clare County",3,80,194,93,101
050,26,035,"Michigan","Clare County",3,81,173,78,95
050,26,035,"Michigan","Clare County",3,82,158,76,82
050,26,035,"Michigan","Clare County",3,83,163,83,80
050,26,035,"Michigan","Clare County",3,84,128,57,71
050,26,035,"Michigan","Clare County",3,85,613,239,374
050,26,035,"Michigan","Clare County",4,0,305,153,152
050,26,035,"Michigan","Clare County",4,1,310,152,158
050,26,035,"Michigan","Clare County",4,2,296,150,146
050,26,035,"Michigan","Clare County",4,3,319,157,162
050,26,035,"Michigan","Clare County",4,4,310,163,147
050,26,035,"Michigan","Clare County",4,5,334,156,178
050,26,035,"Michigan","Clare County",4,6,320,157,163
050,26,035,"Michigan","Clare County",4,7,341,161,180
050,26,035,"Michigan","Clare County",4,8,343,171,172
050,26,035,"Michigan","Clare County",4,9,343,174,169
050,26,035,"Michigan","Clare County",4,10,341,175,166
050,26,035,"Michigan","Clare County",4,11,341,181,160
050,26,035,"Michigan","Clare County",4,12,355,182,173
050,26,035,"Michigan","Clare County",4,13,368,183,185
050,26,035,"Michigan","Clare County",4,14,389,200,189
050,26,035,"Michigan","Clare County",4,15,388,218,170
050,26,035,"Michigan","Clare County",4,16,367,198,169
050,26,035,"Michigan","Clare County",4,17,374,188,186
050,26,035,"Michigan","Clare County",4,18,305,169,136
050,26,035,"Michigan","Clare County",4,19,231,121,110
050,26,035,"Michigan","Clare County",4,20,246,134,112
050,26,035,"Michigan","Clare County",4,21,275,152,123
050,26,035,"Michigan","Clare County",4,22,317,171,146
050,26,035,"Michigan","Clare County",4,23,312,166,146
050,26,035,"Michigan","Clare County",4,24,286,161,125
050,26,035,"Michigan","Clare County",4,25,284,156,128
050,26,035,"Michigan","Clare County",4,26,327,169,158
050,26,035,"Michigan","Clare County",4,27,313,169,144
050,26,035,"Michigan","Clare County",4,28,316,159,157
050,26,035,"Michigan","Clare County",4,29,315,153,162
050,26,035,"Michigan","Clare County",4,30,326,170,156
050,26,035,"Michigan","Clare County",4,31,328,170,158
050,26,035,"Michigan","Clare County",4,32,376,193,183
050,26,035,"Michigan","Clare County",4,33,346,176,170
050,26,035,"Michigan","Clare County",4,34,324,156,168
050,26,035,"Michigan","Clare County",4,35,333,167,166
050,26,035,"Michigan","Clare County",4,36,304,150,154
050,26,035,"Michigan","Clare County",4,37,293,146,147
050,26,035,"Michigan","Clare County",4,38,293,144,149
050,26,035,"Michigan","Clare County",4,39,302,152,150
050,26,035,"Michigan","Clare County",4,40,321,165,156
050,26,035,"Michigan","Clare County",4,41,315,155,160
050,26,035,"Michigan","Clare County",4,42,332,168,164
050,26,035,"Michigan","Clare County",4,43,329,175,154
050,26,035,"Michigan","Clare County",4,44,319,160,159
050,26,035,"Michigan","Clare County",4,45,326,157,169
050,26,035,"Michigan","Clare County",4,46,314,151,163
050,26,035,"Michigan","Clare County",4,47,345,180,165
050,26,035,"Michigan","Clare County",4,48,376,196,180
050,26,035,"Michigan","Clare County",4,49,343,178,165
050,26,035,"Michigan","Clare County",4,50,339,176,163
050,26,035,"Michigan","Clare County",4,51,418,208,210
050,26,035,"Michigan","Clare County",4,52,412,195,217
050,26,035,"Michigan","Clare County",4,53,390,191,199
050,26,035,"Michigan","Clare County",4,54,405,214,191
050,26,035,"Michigan","Clare County",4,55,456,226,230
050,26,035,"Michigan","Clare County",4,56,438,208,230
050,26,035,"Michigan","Clare County",4,57,458,232,226
050,26,035,"Michigan","Clare County",4,58,482,244,238
050,26,035,"Michigan","Clare County",4,59,521,244,277
050,26,035,"Michigan","Clare County",4,60,598,305,293
050,26,035,"Michigan","Clare County",4,61,559,269,290
050,26,035,"Michigan","Clare County",4,62,570,279,291
050,26,035,"Michigan","Clare County",4,63,560,277,283
050,26,035,"Michigan","Clare County",4,64,611,317,294
050,26,035,"Michigan","Clare County",4,65,576,301,275
050,26,035,"Michigan","Clare County",4,66,595,312,283
050,26,035,"Michigan","Clare County",4,67,566,285,281
050,26,035,"Michigan","Clare County",4,68,515,249,266
050,26,035,"Michigan","Clare County",4,69,513,248,265
050,26,035,"Michigan","Clare County",4,70,514,248,266
050,26,035,"Michigan","Clare County",4,71,484,230,254
050,26,035,"Michigan","Clare County",4,72,391,192,199
050,26,035,"Michigan","Clare County",4,73,410,204,206
050,26,035,"Michigan","Clare County",4,74,391,194,197
050,26,035,"Michigan","Clare County",4,75,419,212,207
050,26,035,"Michigan","Clare County",4,76,297,148,149
050,26,035,"Michigan","Clare County",4,77,258,118,140
050,26,035,"Michigan","Clare County",4,78,256,118,138
050,26,035,"Michigan","Clare County",4,79,269,142,127
050,26,035,"Michigan","Clare County",4,80,221,112,109
050,26,035,"Michigan","Clare County",4,81,172,87,85
050,26,035,"Michigan","Clare County",4,82,138,64,74
050,26,035,"Michigan","Clare County",4,83,150,74,76
050,26,035,"Michigan","Clare County",4,84,149,76,73
050,26,035,"Michigan","Clare County",4,85,590,225,365
050,26,035,"Michigan","Clare County",5,0,300,151,149
050,26,035,"Michigan","Clare County",5,1,315,146,169
050,26,035,"Michigan","Clare County",5,2,316,151,165
050,26,035,"Michigan","Clare County",5,3,306,152,154
050,26,035,"Michigan","Clare County",5,4,331,155,176
050,26,035,"Michigan","Clare County",5,5,301,154,147
050,26,035,"Michigan","Clare County",5,6,335,155,180
050,26,035,"Michigan","Clare County",5,7,318,165,153
050,26,035,"Michigan","Clare County",5,8,338,162,176
050,26,035,"Michigan","Clare County",5,9,335,166,169
050,26,035,"Michigan","Clare County",5,10,343,185,158
050,26,035,"Michigan","Clare County",5,11,342,174,168
050,26,035,"Michigan","Clare County",5,12,340,180,160
050,26,035,"Michigan","Clare County",5,13,342,177,165
050,26,035,"Michigan","Clare County",5,14,370,176,194
050,26,035,"Michigan","Clare County",5,15,395,199,196
050,26,035,"Michigan","Clare County",5,16,378,212,166
050,26,035,"Michigan","Clare County",5,17,385,214,171
050,26,035,"Michigan","Clare County",5,18,309,161,148
050,26,035,"Michigan","Clare County",5,19,243,137,106
050,26,035,"Michigan","Clare County",5,20,244,127,117
050,26,035,"Michigan","Clare County",5,21,261,144,117
050,26,035,"Michigan","Clare County",5,22,289,155,134
050,26,035,"Michigan","Clare County",5,23,320,162,158
050,26,035,"Michigan","Clare County",5,24,291,149,142
050,26,035,"Michigan","Clare County",5,25,293,168,125
050,26,035,"Michigan","Clare County",5,26,296,164,132
050,26,035,"Michigan","Clare County",5,27,326,166,160
050,26,035,"Michigan","Clare County",5,28,305,165,140
050,26,035,"Michigan","Clare County",5,29,309,152,157
050,26,035,"Michigan","Clare County",5,30,306,152,154
050,26,035,"Michigan","Clare County",5,31,326,172,154
050,26,035,"Michigan","Clare County",5,32,344,173,171
050,26,035,"Michigan","Clare County",5,33,376,187,189
050,26,035,"Michigan","Clare County",5,34,332,163,169
050,26,035,"Michigan","Clare County",5,35,344,168,176
050,26,035,"Michigan","Clare County",5,36,335,167,168
050,26,035,"Michigan","Clare County",5,37,309,154,155
050,26,035,"Michigan","Clare County",5,38,296,155,141
050,26,035,"Michigan","Clare County",5,39,292,145,147
050,26,035,"Michigan","Clare County",5,40,301,152,149
050,26,035,"Michigan","Clare County",5,41,317,157,160
050,26,035,"Michigan","Clare County",5,42,324,163,161
050,26,035,"Michigan","Clare County",5,43,340,173,167
050,26,035,"Michigan","Clare County",5,44,345,182,163
050,26,035,"Michigan","Clare County",5,45,329,158,171
050,26,035,"Michigan","Clare County",5,46,316,155,161
050,26,035,"Michigan","Clare County",5,47,309,146,163
050,26,035,"Michigan","Clare County",5,48,345,176,169
050,26,035,"Michigan","Clare County",5,49,373,191,182
050,26,035,"Michigan","Clare County",5,50,356,188,168
050,26,035,"Michigan","Clare County",5,51,338,174,164
050,26,035,"Michigan","Clare County",5,52,431,212,219
050,26,035,"Michigan","Clare County",5,53,425,204,221
050,26,035,"Michigan","Clare County",5,54,384,191,193
050,26,035,"Michigan","Clare County",5,55,421,218,203
050,26,035,"Michigan","Clare County",5,56,457,221,236
050,26,035,"Michigan","Clare County",5,57,457,219,238
050,26,035,"Michigan","Clare County",5,58,464,233,231
050,26,035,"Michigan","Clare County",5,59,486,243,243
050,26,035,"Michigan","Clare County",5,60,528,246,282
050,26,035,"Michigan","Clare County",5,61,604,299,305
050,26,035,"Michigan","Clare County",5,62,564,274,290
050,26,035,"Michigan","Clare County",5,63,593,296,297
050,26,035,"Michigan","Clare County",5,64,574,283,291
050,26,035,"Michigan","Clare County",5,65,620,321,299
050,26,035,"Michigan","Clare County",5,66,573,299,274
050,26,035,"Michigan","Clare County",5,67,594,308,286
050,26,035,"Michigan","Clare County",5,68,558,279,279
050,26,035,"Michigan","Clare County",5,69,517,256,261
050,26,035,"Michigan","Clare County",5,70,492,237,255
050,26,035,"Michigan","Clare County",5,71,509,245,264
050,26,035,"Michigan","Clare County",5,72,474,221,253
050,26,035,"Michigan","Clare County",5,73,385,187,198
050,26,035,"Michigan","Clare County",5,74,390,190,200
050,26,035,"Michigan","Clare County",5,75,375,181,194
050,26,035,"Michigan","Clare County",5,76,403,197,206
050,26,035,"Michigan","Clare County",5,77,267,133,134
050,26,035,"Michigan","Clare County",5,78,238,108,130
050,26,035,"Michigan","Clare County",5,79,243,110,133
050,26,035,"Michigan","Clare County",5,80,245,126,119
050,26,035,"Michigan","Clare County",5,81,197,101,96
050,26,035,"Michigan","Clare County",5,82,141,75,66
050,26,035,"Michigan","Clare County",5,83,132,61,71
050,26,035,"Michigan","Clare County",5,84,131,67,64
050,26,035,"Michigan","Clare County",5,85,615,243,372
050,26,037,"Michigan","Clinton County",1,0,804,412,392
050,26,037,"Michigan","Clinton County",1,1,833,424,409
050,26,037,"Michigan","Clinton County",1,2,852,439,413
050,26,037,"Michigan","Clinton County",1,3,906,471,435
050,26,037,"Michigan","Clinton County",1,4,912,455,457
050,26,037,"Michigan","Clinton County",1,5,923,445,478
050,26,037,"Michigan","Clinton County",1,6,933,470,463
050,26,037,"Michigan","Clinton County",1,7,958,481,477
050,26,037,"Michigan","Clinton County",1,8,979,510,469
050,26,037,"Michigan","Clinton County",1,9,976,495,481
050,26,037,"Michigan","Clinton County",1,10,959,465,494
050,26,037,"Michigan","Clinton County",1,11,995,492,503
050,26,037,"Michigan","Clinton County",1,12,1037,515,522
050,26,037,"Michigan","Clinton County",1,13,1054,531,523
050,26,037,"Michigan","Clinton County",1,14,1094,548,546
050,26,037,"Michigan","Clinton County",1,15,1112,571,541
050,26,037,"Michigan","Clinton County",1,16,1137,568,569
050,26,037,"Michigan","Clinton County",1,17,1068,543,525
050,26,037,"Michigan","Clinton County",1,18,944,506,438
050,26,037,"Michigan","Clinton County",1,19,760,387,373
050,26,037,"Michigan","Clinton County",1,20,828,423,405
050,26,037,"Michigan","Clinton County",1,21,944,462,482
050,26,037,"Michigan","Clinton County",1,22,945,459,486
050,26,037,"Michigan","Clinton County",1,23,972,510,462
050,26,037,"Michigan","Clinton County",1,24,963,492,471
050,26,037,"Michigan","Clinton County",1,25,866,460,406
050,26,037,"Michigan","Clinton County",1,26,913,472,441
050,26,037,"Michigan","Clinton County",1,27,874,468,406
050,26,037,"Michigan","Clinton County",1,28,947,480,467
050,26,037,"Michigan","Clinton County",1,29,1013,509,504
050,26,037,"Michigan","Clinton County",1,30,973,466,507
050,26,037,"Michigan","Clinton County",1,31,934,439,495
050,26,037,"Michigan","Clinton County",1,32,944,474,470
050,26,037,"Michigan","Clinton County",1,33,955,474,481
050,26,037,"Michigan","Clinton County",1,34,1008,489,519
050,26,037,"Michigan","Clinton County",1,35,987,493,494
050,26,037,"Michigan","Clinton County",1,36,991,503,488
050,26,037,"Michigan","Clinton County",1,37,1035,530,505
050,26,037,"Michigan","Clinton County",1,38,1003,504,499
050,26,037,"Michigan","Clinton County",1,39,1048,516,532
050,26,037,"Michigan","Clinton County",1,40,1026,505,521
050,26,037,"Michigan","Clinton County",1,41,1057,528,529
050,26,037,"Michigan","Clinton County",1,42,1018,518,500
050,26,037,"Michigan","Clinton County",1,43,958,479,479
050,26,037,"Michigan","Clinton County",1,44,957,485,472
050,26,037,"Michigan","Clinton County",1,45,935,469,466
050,26,037,"Michigan","Clinton County",1,46,875,439,436
050,26,037,"Michigan","Clinton County",1,47,912,433,479
050,26,037,"Michigan","Clinton County",1,48,981,472,509
050,26,037,"Michigan","Clinton County",1,49,1119,539,580
050,26,037,"Michigan","Clinton County",1,50,1096,535,561
050,26,037,"Michigan","Clinton County",1,51,1132,565,567
050,26,037,"Michigan","Clinton County",1,52,1109,554,555
050,26,037,"Michigan","Clinton County",1,53,1089,547,542
050,26,037,"Michigan","Clinton County",1,54,1102,541,561
050,26,037,"Michigan","Clinton County",1,55,1187,590,597
050,26,037,"Michigan","Clinton County",1,56,1213,607,606
050,26,037,"Michigan","Clinton County",1,57,1185,598,587
050,26,037,"Michigan","Clinton County",1,58,1166,574,592
050,26,037,"Michigan","Clinton County",1,59,1115,564,551
050,26,037,"Michigan","Clinton County",1,60,1101,582,519
050,26,037,"Michigan","Clinton County",1,61,1116,571,545
050,26,037,"Michigan","Clinton County",1,62,1107,543,564
050,26,037,"Michigan","Clinton County",1,63,1097,535,562
050,26,037,"Michigan","Clinton County",1,64,1110,545,565
050,26,037,"Michigan","Clinton County",1,65,1022,498,524
050,26,037,"Michigan","Clinton County",1,66,1017,487,530
050,26,037,"Michigan","Clinton County",1,67,980,473,507
050,26,037,"Michigan","Clinton County",1,68,956,476,480
050,26,037,"Michigan","Clinton County",1,69,869,432,437
050,26,037,"Michigan","Clinton County",1,70,791,380,411
050,26,037,"Michigan","Clinton County",1,71,793,375,418
050,26,037,"Michigan","Clinton County",1,72,791,389,402
050,26,037,"Michigan","Clinton County",1,73,762,375,387
050,26,037,"Michigan","Clinton County",1,74,543,248,295
050,26,037,"Michigan","Clinton County",1,75,536,254,282
050,26,037,"Michigan","Clinton County",1,76,530,259,271
050,26,037,"Michigan","Clinton County",1,77,544,278,266
050,26,037,"Michigan","Clinton County",1,78,489,235,254
050,26,037,"Michigan","Clinton County",1,79,403,177,226
050,26,037,"Michigan","Clinton County",1,80,376,158,218
050,26,037,"Michigan","Clinton County",1,81,331,151,180
050,26,037,"Michigan","Clinton County",1,82,322,142,180
050,26,037,"Michigan","Clinton County",1,83,261,112,149
050,26,037,"Michigan","Clinton County",1,84,231,98,133
050,26,037,"Michigan","Clinton County",1,85,1441,536,905
050,26,037,"Michigan","Clinton County",2,0,804,413,391
050,26,037,"Michigan","Clinton County",2,1,830,421,409
050,26,037,"Michigan","Clinton County",2,2,852,436,416
050,26,037,"Michigan","Clinton County",2,3,892,462,430
050,26,037,"Michigan","Clinton County",2,4,911,458,453
050,26,037,"Michigan","Clinton County",2,5,923,447,476
050,26,037,"Michigan","Clinton County",2,6,935,464,471
050,26,037,"Michigan","Clinton County",2,7,952,478,474
050,26,037,"Michigan","Clinton County",2,8,967,500,467
050,26,037,"Michigan","Clinton County",2,9,978,500,478
050,26,037,"Michigan","Clinton County",2,10,966,474,492
050,26,037,"Michigan","Clinton County",2,11,982,483,499
050,26,037,"Michigan","Clinton County",2,12,1034,512,522
050,26,037,"Michigan","Clinton County",2,13,1049,526,523
050,26,037,"Michigan","Clinton County",2,14,1082,542,540
050,26,037,"Michigan","Clinton County",2,15,1111,568,543
050,26,037,"Michigan","Clinton County",2,16,1130,568,562
050,26,037,"Michigan","Clinton County",2,17,1086,551,535
050,26,037,"Michigan","Clinton County",2,18,931,494,437
050,26,037,"Michigan","Clinton County",2,19,762,390,372
050,26,037,"Michigan","Clinton County",2,20,844,426,418
050,26,037,"Michigan","Clinton County",2,21,926,454,472
050,26,037,"Michigan","Clinton County",2,22,952,466,486
050,26,037,"Michigan","Clinton County",2,23,965,499,466
050,26,037,"Michigan","Clinton County",2,24,948,493,455
050,26,037,"Michigan","Clinton County",2,25,878,464,414
050,26,037,"Michigan","Clinton County",2,26,892,466,426
050,26,037,"Michigan","Clinton County",2,27,881,466,415
050,26,037,"Michigan","Clinton County",2,28,935,482,453
050,26,037,"Michigan","Clinton County",2,29,998,501,497
050,26,037,"Michigan","Clinton County",2,30,989,479,510
050,26,037,"Michigan","Clinton County",2,31,944,450,494
050,26,037,"Michigan","Clinton County",2,32,950,470,480
050,26,037,"Michigan","Clinton County",2,33,961,477,484
050,26,037,"Michigan","Clinton County",2,34,1001,486,515
050,26,037,"Michigan","Clinton County",2,35,1005,500,505
050,26,037,"Michigan","Clinton County",2,36,992,503,489
050,26,037,"Michigan","Clinton County",2,37,1029,526,503
050,26,037,"Michigan","Clinton County",2,38,1018,514,504
050,26,037,"Michigan","Clinton County",2,39,1038,512,526
050,26,037,"Michigan","Clinton County",2,40,1043,511,532
050,26,037,"Michigan","Clinton County",2,41,1049,524,525
050,26,037,"Michigan","Clinton County",2,42,1020,517,503
050,26,037,"Michigan","Clinton County",2,43,986,496,490
050,26,037,"Michigan","Clinton County",2,44,950,482,468
050,26,037,"Michigan","Clinton County",2,45,947,476,471
050,26,037,"Michigan","Clinton County",2,46,891,446,445
050,26,037,"Michigan","Clinton County",2,47,897,431,466
050,26,037,"Michigan","Clinton County",2,48,959,460,499
050,26,037,"Michigan","Clinton County",2,49,1091,525,566
050,26,037,"Michigan","Clinton County",2,50,1106,539,567
050,26,037,"Michigan","Clinton County",2,51,1120,556,564
050,26,037,"Michigan","Clinton County",2,52,1112,555,557
050,26,037,"Michigan","Clinton County",2,53,1094,549,545
050,26,037,"Michigan","Clinton County",2,54,1093,542,551
050,26,037,"Michigan","Clinton County",2,55,1165,580,585
050,26,037,"Michigan","Clinton County",2,56,1209,607,602
050,26,037,"Michigan","Clinton County",2,57,1186,597,589
050,26,037,"Michigan","Clinton County",2,58,1161,575,586
050,26,037,"Michigan","Clinton County",2,59,1132,569,563
050,26,037,"Michigan","Clinton County",2,60,1098,576,522
050,26,037,"Michigan","Clinton County",2,61,1103,570,533
050,26,037,"Michigan","Clinton County",2,62,1104,547,557
050,26,037,"Michigan","Clinton County",2,63,1108,540,568
050,26,037,"Michigan","Clinton County",2,64,1097,536,561
050,26,037,"Michigan","Clinton County",2,65,1039,508,531
050,26,037,"Michigan","Clinton County",2,66,1022,493,529
050,26,037,"Michigan","Clinton County",2,67,982,473,509
050,26,037,"Michigan","Clinton County",2,68,955,472,483
050,26,037,"Michigan","Clinton County",2,69,895,444,451
050,26,037,"Michigan","Clinton County",2,70,807,391,416
050,26,037,"Michigan","Clinton County",2,71,795,378,417
050,26,037,"Michigan","Clinton County",2,72,780,379,401
050,26,037,"Michigan","Clinton County",2,73,806,397,409
050,26,037,"Michigan","Clinton County",2,74,559,261,298
050,26,037,"Michigan","Clinton County",2,75,530,249,281
050,26,037,"Michigan","Clinton County",2,76,525,253,272
050,26,037,"Michigan","Clinton County",2,77,552,280,272
050,26,037,"Michigan","Clinton County",2,78,482,235,247
050,26,037,"Michigan","Clinton County",2,79,423,190,233
050,26,037,"Michigan","Clinton County",2,80,381,162,219
050,26,037,"Michigan","Clinton County",2,81,335,149,186
050,26,037,"Michigan","Clinton County",2,82,323,145,178
050,26,037,"Michigan","Clinton County",2,83,274,117,157
050,26,037,"Michigan","Clinton County",2,84,229,96,133
050,26,037,"Michigan","Clinton County",2,85,1432,529,903
050,26,037,"Michigan","Clinton County",3,0,704,349,355
050,26,037,"Michigan","Clinton County",3,1,845,450,395
050,26,037,"Michigan","Clinton County",3,2,866,436,430
050,26,037,"Michigan","Clinton County",3,3,878,452,426
050,26,037,"Michigan","Clinton County",3,4,917,478,439
050,26,037,"Michigan","Clinton County",3,5,933,471,462
050,26,037,"Michigan","Clinton County",3,6,911,434,477
050,26,037,"Michigan","Clinton County",3,7,934,470,464
050,26,037,"Michigan","Clinton County",3,8,949,472,477
050,26,037,"Michigan","Clinton County",3,9,959,494,465
050,26,037,"Michigan","Clinton County",3,10,992,506,486
050,26,037,"Michigan","Clinton County",3,11,979,492,487
050,26,037,"Michigan","Clinton County",3,12,963,471,492
050,26,037,"Michigan","Clinton County",3,13,1049,525,524
050,26,037,"Michigan","Clinton County",3,14,1043,523,520
050,26,037,"Michigan","Clinton County",3,15,1080,554,526
050,26,037,"Michigan","Clinton County",3,16,1116,559,557
050,26,037,"Michigan","Clinton County",3,17,1143,588,555
050,26,037,"Michigan","Clinton County",3,18,930,491,439
050,26,037,"Michigan","Clinton County",3,19,754,393,361
050,26,037,"Michigan","Clinton County",3,20,870,436,434
050,26,037,"Michigan","Clinton County",3,21,941,472,469
050,26,037,"Michigan","Clinton County",3,22,1019,498,521
050,26,037,"Michigan","Clinton County",3,23,981,495,486
050,26,037,"Michigan","Clinton County",3,24,950,497,453
050,26,037,"Michigan","Clinton County",3,25,926,477,449
050,26,037,"Michigan","Clinton County",3,26,919,484,435
050,26,037,"Michigan","Clinton County",3,27,900,453,447
050,26,037,"Michigan","Clinton County",3,28,924,496,428
050,26,037,"Michigan","Clinton County",3,29,945,487,458
050,26,037,"Michigan","Clinton County",3,30,981,493,488
050,26,037,"Michigan","Clinton County",3,31,956,461,495
050,26,037,"Michigan","Clinton County",3,32,972,466,506
050,26,037,"Michigan","Clinton County",3,33,977,485,492
050,26,037,"Michigan","Clinton County",3,34,990,493,497
050,26,037,"Michigan","Clinton County",3,35,1020,495,525
050,26,037,"Michigan","Clinton County",3,36,1008,503,505
050,26,037,"Michigan","Clinton County",3,37,998,517,481
050,26,037,"Michigan","Clinton County",3,38,1047,535,512
050,26,037,"Michigan","Clinton County",3,39,1020,512,508
050,26,037,"Michigan","Clinton County",3,40,1033,510,523
050,26,037,"Michigan","Clinton County",3,41,1046,523,523
050,26,037,"Michigan","Clinton County",3,42,1050,532,518
050,26,037,"Michigan","Clinton County",3,43,1029,517,512
050,26,037,"Michigan","Clinton County",3,44,982,491,491
050,26,037,"Michigan","Clinton County",3,45,959,482,477
050,26,037,"Michigan","Clinton County",3,46,952,474,478
050,26,037,"Michigan","Clinton County",3,47,898,448,450
050,26,037,"Michigan","Clinton County",3,48,896,436,460
050,26,037,"Michigan","Clinton County",3,49,985,456,529
050,26,037,"Michigan","Clinton County",3,50,1078,518,560
050,26,037,"Michigan","Clinton County",3,51,1124,538,586
050,26,037,"Michigan","Clinton County",3,52,1134,570,564
050,26,037,"Michigan","Clinton County",3,53,1105,555,550
050,26,037,"Michigan","Clinton County",3,54,1078,545,533
050,26,037,"Michigan","Clinton County",3,55,1079,532,547
050,26,037,"Michigan","Clinton County",3,56,1163,589,574
050,26,037,"Michigan","Clinton County",3,57,1205,601,604
050,26,037,"Michigan","Clinton County",3,58,1170,583,587
050,26,037,"Michigan","Clinton County",3,59,1170,568,602
050,26,037,"Michigan","Clinton County",3,60,1121,568,553
050,26,037,"Michigan","Clinton County",3,61,1082,571,511
050,26,037,"Michigan","Clinton County",3,62,1099,563,536
050,26,037,"Michigan","Clinton County",3,63,1072,533,539
050,26,037,"Michigan","Clinton County",3,64,1083,524,559
050,26,037,"Michigan","Clinton County",3,65,1090,533,557
050,26,037,"Michigan","Clinton County",3,66,1026,502,524
050,26,037,"Michigan","Clinton County",3,67,1008,479,529
050,26,037,"Michigan","Clinton County",3,68,965,462,503
050,26,037,"Michigan","Clinton County",3,69,928,460,468
050,26,037,"Michigan","Clinton County",3,70,876,428,448
050,26,037,"Michigan","Clinton County",3,71,790,383,407
050,26,037,"Michigan","Clinton County",3,72,775,366,409
050,26,037,"Michigan","Clinton County",3,73,763,367,396
050,26,037,"Michigan","Clinton County",3,74,796,389,407
050,26,037,"Michigan","Clinton County",3,75,537,246,291
050,26,037,"Michigan","Clinton County",3,76,521,245,276
050,26,037,"Michigan","Clinton County",3,77,488,239,249
050,26,037,"Michigan","Clinton County",3,78,523,253,270
050,26,037,"Michigan","Clinton County",3,79,461,216,245
050,26,037,"Michigan","Clinton County",3,80,412,188,224
050,26,037,"Michigan","Clinton County",3,81,353,149,204
050,26,037,"Michigan","Clinton County",3,82,318,138,180
050,26,037,"Michigan","Clinton County",3,83,312,142,170
050,26,037,"Michigan","Clinton County",3,84,230,99,131
050,26,037,"Michigan","Clinton County",3,85,1410,509,901
050,26,037,"Michigan","Clinton County",4,0,714,348,366
050,26,037,"Michigan","Clinton County",4,1,763,387,376
050,26,037,"Michigan","Clinton County",4,2,851,454,397
050,26,037,"Michigan","Clinton County",4,3,874,447,427
050,26,037,"Michigan","Clinton County",4,4,893,458,435
050,26,037,"Michigan","Clinton County",4,5,935,486,449
050,26,037,"Michigan","Clinton County",4,6,947,472,475
050,26,037,"Michigan","Clinton County",4,7,919,443,476
050,26,037,"Michigan","Clinton County",4,8,949,470,479
050,26,037,"Michigan","Clinton County",4,9,958,469,489
050,26,037,"Michigan","Clinton County",4,10,988,499,489
050,26,037,"Michigan","Clinton County",4,11,983,495,488
050,26,037,"Michigan","Clinton County",4,12,984,495,489
050,26,037,"Michigan","Clinton County",4,13,1023,507,516
050,26,037,"Michigan","Clinton County",4,14,1044,522,522
050,26,037,"Michigan","Clinton County",4,15,1044,530,514
050,26,037,"Michigan","Clinton County",4,16,1094,545,549
050,26,037,"Michigan","Clinton County",4,17,1116,565,551
050,26,037,"Michigan","Clinton County",4,18,958,514,444
050,26,037,"Michigan","Clinton County",4,19,710,378,332
050,26,037,"Michigan","Clinton County",4,20,835,429,406
050,26,037,"Michigan","Clinton County",4,21,914,448,466
050,26,037,"Michigan","Clinton County",4,22,990,491,499
050,26,037,"Michigan","Clinton County",4,23,990,493,497
050,26,037,"Michigan","Clinton County",4,24,932,470,462
050,26,037,"Michigan","Clinton County",4,25,919,476,443
050,26,037,"Michigan","Clinton County",4,26,919,479,440
050,26,037,"Michigan","Clinton County",4,27,903,465,438
050,26,037,"Michigan","Clinton County",4,28,911,459,452
050,26,037,"Michigan","Clinton County",4,29,907,489,418
050,26,037,"Michigan","Clinton County",4,30,993,496,497
050,26,037,"Michigan","Clinton County",4,31,994,490,504
050,26,037,"Michigan","Clinton County",4,32,1001,496,505
050,26,037,"Michigan","Clinton County",4,33,996,476,520
050,26,037,"Michigan","Clinton County",4,34,997,498,499
050,26,037,"Michigan","Clinton County",4,35,995,490,505
050,26,037,"Michigan","Clinton County",4,36,1040,499,541
050,26,037,"Michigan","Clinton County",4,37,992,496,496
050,26,037,"Michigan","Clinton County",4,38,1022,529,493
050,26,037,"Michigan","Clinton County",4,39,1078,546,532
050,26,037,"Michigan","Clinton County",4,40,1033,525,508
050,26,037,"Michigan","Clinton County",4,41,1059,523,536
050,26,037,"Michigan","Clinton County",4,42,1076,540,536
050,26,037,"Michigan","Clinton County",4,43,1053,530,523
050,26,037,"Michigan","Clinton County",4,44,1015,510,505
050,26,037,"Michigan","Clinton County",4,45,983,492,491
050,26,037,"Michigan","Clinton County",4,46,968,491,477
050,26,037,"Michigan","Clinton County",4,47,954,478,476
050,26,037,"Michigan","Clinton County",4,48,902,448,454
050,26,037,"Michigan","Clinton County",4,49,889,421,468
050,26,037,"Michigan","Clinton County",4,50,985,459,526
050,26,037,"Michigan","Clinton County",4,51,1088,539,549
050,26,037,"Michigan","Clinton County",4,52,1139,547,592
050,26,037,"Michigan","Clinton County",4,53,1132,560,572
050,26,037,"Michigan","Clinton County",4,54,1094,553,541
050,26,037,"Michigan","Clinton County",4,55,1084,545,539
050,26,037,"Michigan","Clinton County",4,56,1085,536,549
050,26,037,"Michigan","Clinton County",4,57,1164,590,574
050,26,037,"Michigan","Clinton County",4,58,1199,590,609
050,26,037,"Michigan","Clinton County",4,59,1172,573,599
050,26,037,"Michigan","Clinton County",4,60,1149,553,596
050,26,037,"Michigan","Clinton County",4,61,1094,546,548
050,26,037,"Michigan","Clinton County",4,62,1052,557,495
050,26,037,"Michigan","Clinton County",4,63,1093,565,528
050,26,037,"Michigan","Clinton County",4,64,1054,524,530
050,26,037,"Michigan","Clinton County",4,65,1060,512,548
050,26,037,"Michigan","Clinton County",4,66,1086,529,557
050,26,037,"Michigan","Clinton County",4,67,1016,493,523
050,26,037,"Michigan","Clinton County",4,68,991,475,516
050,26,037,"Michigan","Clinton County",4,69,934,450,484
050,26,037,"Michigan","Clinton County",4,70,911,443,468
050,26,037,"Michigan","Clinton County",4,71,861,426,435
050,26,037,"Michigan","Clinton County",4,72,792,379,413
050,26,037,"Michigan","Clinton County",4,73,752,353,399
050,26,037,"Michigan","Clinton County",4,74,747,355,392
050,26,037,"Michigan","Clinton County",4,75,761,374,387
050,26,037,"Michigan","Clinton County",4,76,530,239,291
050,26,037,"Michigan","Clinton County",4,77,490,230,260
050,26,037,"Michigan","Clinton County",4,78,465,221,244
050,26,037,"Michigan","Clinton County",4,79,508,240,268
050,26,037,"Michigan","Clinton County",4,80,452,215,237
050,26,037,"Michigan","Clinton County",4,81,394,181,213
050,26,037,"Michigan","Clinton County",4,82,335,142,193
050,26,037,"Michigan","Clinton County",4,83,299,132,167
050,26,037,"Michigan","Clinton County",4,84,271,124,147
050,26,037,"Michigan","Clinton County",4,85,1406,498,908
050,26,037,"Michigan","Clinton County",5,0,671,329,342
050,26,037,"Michigan","Clinton County",5,1,733,364,369
050,26,037,"Michigan","Clinton County",5,2,788,403,385
050,26,037,"Michigan","Clinton County",5,3,865,457,408
050,26,037,"Michigan","Clinton County",5,4,885,453,432
050,26,037,"Michigan","Clinton County",5,5,931,494,437
050,26,037,"Michigan","Clinton County",5,6,934,477,457
050,26,037,"Michigan","Clinton County",5,7,950,476,474
050,26,037,"Michigan","Clinton County",5,8,946,465,481
050,26,037,"Michigan","Clinton County",5,9,959,469,490
050,26,037,"Michigan","Clinton County",5,10,963,480,483
050,26,037,"Michigan","Clinton County",5,11,1003,492,511
050,26,037,"Michigan","Clinton County",5,12,1006,510,496
050,26,037,"Michigan","Clinton County",5,13,987,501,486
050,26,037,"Michigan","Clinton County",5,14,1010,498,512
050,26,037,"Michigan","Clinton County",5,15,1031,519,512
050,26,037,"Michigan","Clinton County",5,16,1037,530,507
050,26,037,"Michigan","Clinton County",5,17,1078,544,534
050,26,037,"Michigan","Clinton County",5,18,937,490,447
050,26,037,"Michigan","Clinton County",5,19,747,402,345
050,26,037,"Michigan","Clinton County",5,20,801,420,381
050,26,037,"Michigan","Clinton County",5,21,877,443,434
050,26,037,"Michigan","Clinton County",5,22,995,481,514
050,26,037,"Michigan","Clinton County",5,23,1001,511,490
050,26,037,"Michigan","Clinton County",5,24,1006,477,529
050,26,037,"Michigan","Clinton County",5,25,907,459,448
050,26,037,"Michigan","Clinton County",5,26,885,473,412
050,26,037,"Michigan","Clinton County",5,27,927,482,445
050,26,037,"Michigan","Clinton County",5,28,888,455,433
050,26,037,"Michigan","Clinton County",5,29,893,445,448
050,26,037,"Michigan","Clinton County",5,30,924,496,428
050,26,037,"Michigan","Clinton County",5,31,1016,505,511
050,26,037,"Michigan","Clinton County",5,32,1006,506,500
050,26,037,"Michigan","Clinton County",5,33,1040,511,529
050,26,037,"Michigan","Clinton County",5,34,1011,466,545
050,26,037,"Michigan","Clinton County",5,35,975,478,497
050,26,037,"Michigan","Clinton County",5,36,1043,513,530
050,26,037,"Michigan","Clinton County",5,37,1045,511,534
050,26,037,"Michigan","Clinton County",5,38,1022,507,515
050,26,037,"Michigan","Clinton County",5,39,1038,549,489
050,26,037,"Michigan","Clinton County",5,40,1074,528,546
050,26,037,"Michigan","Clinton County",5,41,1056,535,521
050,26,037,"Michigan","Clinton County",5,42,1050,518,532
050,26,037,"Michigan","Clinton County",5,43,1083,540,543
050,26,037,"Michigan","Clinton County",5,44,1046,529,517
050,26,037,"Michigan","Clinton County",5,45,1030,516,514
050,26,037,"Michigan","Clinton County",5,46,983,496,487
050,26,037,"Michigan","Clinton County",5,47,959,481,478
050,26,037,"Michigan","Clinton County",5,48,958,491,467
050,26,037,"Michigan","Clinton County",5,49,890,441,449
050,26,037,"Michigan","Clinton County",5,50,881,425,456
050,26,037,"Michigan","Clinton County",5,51,985,457,528
050,26,037,"Michigan","Clinton County",5,52,1088,531,557
050,26,037,"Michigan","Clinton County",5,53,1128,547,581
050,26,037,"Michigan","Clinton County",5,54,1130,562,568
050,26,037,"Michigan","Clinton County",5,55,1068,546,522
050,26,037,"Michigan","Clinton County",5,56,1096,549,547
050,26,037,"Michigan","Clinton County",5,57,1070,521,549
050,26,037,"Michigan","Clinton County",5,58,1154,581,573
050,26,037,"Michigan","Clinton County",5,59,1200,586,614
050,26,037,"Michigan","Clinton County",5,60,1145,569,576
050,26,037,"Michigan","Clinton County",5,61,1130,542,588
050,26,037,"Michigan","Clinton County",5,62,1068,527,541
050,26,037,"Michigan","Clinton County",5,63,1057,562,495
050,26,037,"Michigan","Clinton County",5,64,1100,564,536
050,26,037,"Michigan","Clinton County",5,65,1037,514,523
050,26,037,"Michigan","Clinton County",5,66,1049,510,539
050,26,037,"Michigan","Clinton County",5,67,1055,513,542
050,26,037,"Michigan","Clinton County",5,68,990,482,508
050,26,037,"Michigan","Clinton County",5,69,965,454,511
050,26,037,"Michigan","Clinton County",5,70,916,436,480
050,26,037,"Michigan","Clinton County",5,71,891,435,456
050,26,037,"Michigan","Clinton County",5,72,847,411,436
050,26,037,"Michigan","Clinton County",5,73,777,380,397
050,26,037,"Michigan","Clinton County",5,74,741,349,392
050,26,037,"Michigan","Clinton County",5,75,718,340,378
050,26,037,"Michigan","Clinton County",5,76,758,367,391
050,26,037,"Michigan","Clinton County",5,77,509,231,278
050,26,037,"Michigan","Clinton County",5,78,483,217,266
050,26,037,"Michigan","Clinton County",5,79,458,213,245
050,26,037,"Michigan","Clinton County",5,80,496,236,260
050,26,037,"Michigan","Clinton County",5,81,433,207,226
050,26,037,"Michigan","Clinton County",5,82,379,178,201
050,26,037,"Michigan","Clinton County",5,83,317,137,180
050,26,037,"Michigan","Clinton County",5,84,264,116,148
050,26,037,"Michigan","Clinton County",5,85,1447,518,929
050,26,039,"Michigan","Crawford County",1,0,96,48,48
050,26,039,"Michigan","Crawford County",1,1,112,55,57
050,26,039,"Michigan","Crawford County",1,2,121,63,58
050,26,039,"Michigan","Crawford County",1,3,121,65,56
050,26,039,"Michigan","Crawford County",1,4,117,60,57
050,26,039,"Michigan","Crawford County",1,5,134,70,64
050,26,039,"Michigan","Crawford County",1,6,121,64,57
050,26,039,"Michigan","Crawford County",1,7,117,66,51
050,26,039,"Michigan","Crawford County",1,8,128,68,60
050,26,039,"Michigan","Crawford County",1,9,119,63,56
050,26,039,"Michigan","Crawford County",1,10,122,68,54
050,26,039,"Michigan","Crawford County",1,11,137,71,66
050,26,039,"Michigan","Crawford County",1,12,136,73,63
050,26,039,"Michigan","Crawford County",1,13,154,85,69
050,26,039,"Michigan","Crawford County",1,14,145,78,67
050,26,039,"Michigan","Crawford County",1,15,134,67,67
050,26,039,"Michigan","Crawford County",1,16,136,73,63
050,26,039,"Michigan","Crawford County",1,17,141,74,67
050,26,039,"Michigan","Crawford County",1,18,114,60,54
050,26,039,"Michigan","Crawford County",1,19,99,48,51
050,26,039,"Michigan","Crawford County",1,20,102,48,54
050,26,039,"Michigan","Crawford County",1,21,102,48,54
050,26,039,"Michigan","Crawford County",1,22,103,58,45
050,26,039,"Michigan","Crawford County",1,23,122,67,55
050,26,039,"Michigan","Crawford County",1,24,118,59,59
050,26,039,"Michigan","Crawford County",1,25,114,52,62
050,26,039,"Michigan","Crawford County",1,26,120,60,60
050,26,039,"Michigan","Crawford County",1,27,136,68,68
050,26,039,"Michigan","Crawford County",1,28,134,67,67
050,26,039,"Michigan","Crawford County",1,29,141,74,67
050,26,039,"Michigan","Crawford County",1,30,130,65,65
050,26,039,"Michigan","Crawford County",1,31,102,57,45
050,26,039,"Michigan","Crawford County",1,32,104,58,46
050,26,039,"Michigan","Crawford County",1,33,112,58,54
050,26,039,"Michigan","Crawford County",1,34,138,66,72
050,26,039,"Michigan","Crawford County",1,35,133,66,67
050,26,039,"Michigan","Crawford County",1,36,136,74,62
050,26,039,"Michigan","Crawford County",1,37,119,61,58
050,26,039,"Michigan","Crawford County",1,38,142,76,66
050,26,039,"Michigan","Crawford County",1,39,150,76,74
050,26,039,"Michigan","Crawford County",1,40,133,71,62
050,26,039,"Michigan","Crawford County",1,41,135,64,71
050,26,039,"Michigan","Crawford County",1,42,124,60,64
050,26,039,"Michigan","Crawford County",1,43,110,59,51
050,26,039,"Michigan","Crawford County",1,44,115,52,63
050,26,039,"Michigan","Crawford County",1,45,105,48,57
050,26,039,"Michigan","Crawford County",1,46,117,54,63
050,26,039,"Michigan","Crawford County",1,47,136,69,67
050,26,039,"Michigan","Crawford County",1,48,147,78,69
050,26,039,"Michigan","Crawford County",1,49,172,90,82
050,26,039,"Michigan","Crawford County",1,50,166,93,73
050,26,039,"Michigan","Crawford County",1,51,191,94,97
050,26,039,"Michigan","Crawford County",1,52,193,99,94
050,26,039,"Michigan","Crawford County",1,53,166,88,78
050,26,039,"Michigan","Crawford County",1,54,184,91,93
050,26,039,"Michigan","Crawford County",1,55,209,106,103
050,26,039,"Michigan","Crawford County",1,56,226,122,104
050,26,039,"Michigan","Crawford County",1,57,236,122,114
050,26,039,"Michigan","Crawford County",1,58,261,132,129
050,26,039,"Michigan","Crawford County",1,59,264,137,127
050,26,039,"Michigan","Crawford County",1,60,243,119,124
050,26,039,"Michigan","Crawford County",1,61,271,145,126
050,26,039,"Michigan","Crawford County",1,62,259,140,119
050,26,039,"Michigan","Crawford County",1,63,249,129,120
050,26,039,"Michigan","Crawford County",1,64,226,119,107
050,26,039,"Michigan","Crawford County",1,65,232,126,106
050,26,039,"Michigan","Crawford County",1,66,231,123,108
050,26,039,"Michigan","Crawford County",1,67,230,124,106
050,26,039,"Michigan","Crawford County",1,68,205,110,95
050,26,039,"Michigan","Crawford County",1,69,197,98,99
050,26,039,"Michigan","Crawford County",1,70,211,119,92
050,26,039,"Michigan","Crawford County",1,71,192,110,82
050,26,039,"Michigan","Crawford County",1,72,198,99,99
050,26,039,"Michigan","Crawford County",1,73,186,89,97
050,26,039,"Michigan","Crawford County",1,74,136,63,73
050,26,039,"Michigan","Crawford County",1,75,144,67,77
050,26,039,"Michigan","Crawford County",1,76,139,64,75
050,26,039,"Michigan","Crawford County",1,77,149,75,74
050,26,039,"Michigan","Crawford County",1,78,117,58,59
050,26,039,"Michigan","Crawford County",1,79,98,50,48
050,26,039,"Michigan","Crawford County",1,80,101,57,44
050,26,039,"Michigan","Crawford County",1,81,92,46,46
050,26,039,"Michigan","Crawford County",1,82,67,35,32
050,26,039,"Michigan","Crawford County",1,83,71,30,41
050,26,039,"Michigan","Crawford County",1,84,64,28,36
050,26,039,"Michigan","Crawford County",1,85,331,146,185
050,26,039,"Michigan","Crawford County",2,0,108,57,51
050,26,039,"Michigan","Crawford County",2,1,109,54,55
050,26,039,"Michigan","Crawford County",2,2,117,60,57
050,26,039,"Michigan","Crawford County",2,3,119,64,55
050,26,039,"Michigan","Crawford County",2,4,119,61,58
050,26,039,"Michigan","Crawford County",2,5,131,68,63
050,26,039,"Michigan","Crawford County",2,6,123,66,57
050,26,039,"Michigan","Crawford County",2,7,121,68,53
050,26,039,"Michigan","Crawford County",2,8,122,65,57
050,26,039,"Michigan","Crawford County",2,9,123,66,57
050,26,039,"Michigan","Crawford County",2,10,123,67,56
050,26,039,"Michigan","Crawford County",2,11,133,71,62
050,26,039,"Michigan","Crawford County",2,12,139,74,65
050,26,039,"Michigan","Crawford County",2,13,150,84,66
050,26,039,"Michigan","Crawford County",2,14,146,79,67
050,26,039,"Michigan","Crawford County",2,15,136,69,67
050,26,039,"Michigan","Crawford County",2,16,134,71,63
050,26,039,"Michigan","Crawford County",2,17,136,73,63
050,26,039,"Michigan","Crawford County",2,18,113,60,53
050,26,039,"Michigan","Crawford County",2,19,96,47,49
050,26,039,"Michigan","Crawford County",2,20,103,49,54
050,26,039,"Michigan","Crawford County",2,21,104,49,55
050,26,039,"Michigan","Crawford County",2,22,106,58,48
050,26,039,"Michigan","Crawford County",2,23,120,66,54
050,26,039,"Michigan","Crawford County",2,24,117,59,58
050,26,039,"Michigan","Crawford County",2,25,115,53,62
050,26,039,"Michigan","Crawford County",2,26,119,59,60
050,26,039,"Michigan","Crawford County",2,27,132,66,66
050,26,039,"Michigan","Crawford County",2,28,134,66,68
050,26,039,"Michigan","Crawford County",2,29,137,72,65
050,26,039,"Michigan","Crawford County",2,30,133,68,65
050,26,039,"Michigan","Crawford County",2,31,110,61,49
050,26,039,"Michigan","Crawford County",2,32,105,59,46
050,26,039,"Michigan","Crawford County",2,33,112,59,53
050,26,039,"Michigan","Crawford County",2,34,133,65,68
050,26,039,"Michigan","Crawford County",2,35,136,66,70
050,26,039,"Michigan","Crawford County",2,36,135,72,63
050,26,039,"Michigan","Crawford County",2,37,125,66,59
050,26,039,"Michigan","Crawford County",2,38,138,74,64
050,26,039,"Michigan","Crawford County",2,39,148,76,72
050,26,039,"Michigan","Crawford County",2,40,137,72,65
050,26,039,"Michigan","Crawford County",2,41,135,65,70
050,26,039,"Michigan","Crawford County",2,42,127,61,66
050,26,039,"Michigan","Crawford County",2,43,114,60,54
050,26,039,"Michigan","Crawford County",2,44,112,53,59
050,26,039,"Michigan","Crawford County",2,45,108,50,58
050,26,039,"Michigan","Crawford County",2,46,110,50,60
050,26,039,"Michigan","Crawford County",2,47,131,66,65
050,26,039,"Michigan","Crawford County",2,48,143,74,69
050,26,039,"Michigan","Crawford County",2,49,168,88,80
050,26,039,"Michigan","Crawford County",2,50,169,94,75
050,26,039,"Michigan","Crawford County",2,51,185,94,91
050,26,039,"Michigan","Crawford County",2,52,193,98,95
050,26,039,"Michigan","Crawford County",2,53,173,92,81
050,26,039,"Michigan","Crawford County",2,54,181,91,90
050,26,039,"Michigan","Crawford County",2,55,204,104,100
050,26,039,"Michigan","Crawford County",2,56,223,120,103
050,26,039,"Michigan","Crawford County",2,57,234,124,110
050,26,039,"Michigan","Crawford County",2,58,253,128,125
050,26,039,"Michigan","Crawford County",2,59,264,135,129
050,26,039,"Michigan","Crawford County",2,60,249,125,124
050,26,039,"Michigan","Crawford County",2,61,265,138,127
050,26,039,"Michigan","Crawford County",2,62,265,144,121
050,26,039,"Michigan","Crawford County",2,63,251,131,120
050,26,039,"Michigan","Crawford County",2,64,232,121,111
050,26,039,"Michigan","Crawford County",2,65,233,126,107
050,26,039,"Michigan","Crawford County",2,66,232,123,109
050,26,039,"Michigan","Crawford County",2,67,228,122,106
050,26,039,"Michigan","Crawford County",2,68,209,112,97
050,26,039,"Michigan","Crawford County",2,69,198,101,97
050,26,039,"Michigan","Crawford County",2,70,206,113,93
050,26,039,"Michigan","Crawford County",2,71,197,112,85
050,26,039,"Michigan","Crawford County",2,72,190,98,92
050,26,039,"Michigan","Crawford County",2,73,199,96,103
050,26,039,"Michigan","Crawford County",2,74,138,64,74
050,26,039,"Michigan","Crawford County",2,75,143,67,76
050,26,039,"Michigan","Crawford County",2,76,137,63,74
050,26,039,"Michigan","Crawford County",2,77,147,73,74
050,26,039,"Michigan","Crawford County",2,78,121,60,61
050,26,039,"Michigan","Crawford County",2,79,100,50,50
050,26,039,"Michigan","Crawford County",2,80,99,55,44
050,26,039,"Michigan","Crawford County",2,81,94,48,46
050,26,039,"Michigan","Crawford County",2,82,70,37,33
050,26,039,"Michigan","Crawford County",2,83,72,32,40
050,26,039,"Michigan","Crawford County",2,84,60,26,34
050,26,039,"Michigan","Crawford County",2,85,333,149,184
050,26,039,"Michigan","Crawford County",3,0,109,55,54
050,26,039,"Michigan","Crawford County",3,1,114,61,53
050,26,039,"Michigan","Crawford County",3,2,114,50,64
050,26,039,"Michigan","Crawford County",3,3,126,73,53
050,26,039,"Michigan","Crawford County",3,4,120,65,55
050,26,039,"Michigan","Crawford County",3,5,125,64,61
050,26,039,"Michigan","Crawford County",3,6,130,67,63
050,26,039,"Michigan","Crawford County",3,7,125,68,57
050,26,039,"Michigan","Crawford County",3,8,125,64,61
050,26,039,"Michigan","Crawford County",3,9,125,74,51
050,26,039,"Michigan","Crawford County",3,10,133,71,62
050,26,039,"Michigan","Crawford County",3,11,131,69,62
050,26,039,"Michigan","Crawford County",3,12,137,75,62
050,26,039,"Michigan","Crawford County",3,13,144,77,67
050,26,039,"Michigan","Crawford County",3,14,158,87,71
050,26,039,"Michigan","Crawford County",3,15,155,86,69
050,26,039,"Michigan","Crawford County",3,16,138,70,68
050,26,039,"Michigan","Crawford County",3,17,141,75,66
050,26,039,"Michigan","Crawford County",3,18,117,68,49
050,26,039,"Michigan","Crawford County",3,19,96,49,47
050,26,039,"Michigan","Crawford County",3,20,104,54,50
050,26,039,"Michigan","Crawford County",3,21,103,45,58
050,26,039,"Michigan","Crawford County",3,22,116,48,68
050,26,039,"Michigan","Crawford County",3,23,117,64,53
050,26,039,"Michigan","Crawford County",3,24,122,70,52
050,26,039,"Michigan","Crawford County",3,25,124,68,56
050,26,039,"Michigan","Crawford County",3,26,118,61,57
050,26,039,"Michigan","Crawford County",3,27,120,59,61
050,26,039,"Michigan","Crawford County",3,28,139,70,69
050,26,039,"Michigan","Crawford County",3,29,148,73,75
050,26,039,"Michigan","Crawford County",3,30,145,73,72
050,26,039,"Michigan","Crawford County",3,31,144,76,68
050,26,039,"Michigan","Crawford County",3,32,131,77,54
050,26,039,"Michigan","Crawford County",3,33,112,61,51
050,26,039,"Michigan","Crawford County",3,34,127,63,64
050,26,039,"Michigan","Crawford County",3,35,132,63,69
050,26,039,"Michigan","Crawford County",3,36,147,72,75
050,26,039,"Michigan","Crawford County",3,37,145,75,70
050,26,039,"Michigan","Crawford County",3,38,125,64,61
050,26,039,"Michigan","Crawford County",3,39,138,72,66
050,26,039,"Michigan","Crawford County",3,40,148,79,69
050,26,039,"Michigan","Crawford County",3,41,144,76,68
050,26,039,"Michigan","Crawford County",3,42,139,68,71
050,26,039,"Michigan","Crawford County",3,43,129,60,69
050,26,039,"Michigan","Crawford County",3,44,119,64,55
050,26,039,"Michigan","Crawford County",3,45,120,58,62
050,26,039,"Michigan","Crawford County",3,46,110,51,59
050,26,039,"Michigan","Crawford County",3,47,122,61,61
050,26,039,"Michigan","Crawford County",3,48,138,65,73
050,26,039,"Michigan","Crawford County",3,49,149,77,72
050,26,039,"Michigan","Crawford County",3,50,175,93,82
050,26,039,"Michigan","Crawford County",3,51,176,97,79
050,26,039,"Michigan","Crawford County",3,52,192,96,96
050,26,039,"Michigan","Crawford County",3,53,189,92,97
050,26,039,"Michigan","Crawford County",3,54,187,102,85
050,26,039,"Michigan","Crawford County",3,55,189,93,96
050,26,039,"Michigan","Crawford County",3,56,207,104,103
050,26,039,"Michigan","Crawford County",3,57,222,123,99
050,26,039,"Michigan","Crawford County",3,58,236,121,115
050,26,039,"Michigan","Crawford County",3,59,261,132,129
050,26,039,"Michigan","Crawford County",3,60,268,139,129
050,26,039,"Michigan","Crawford County",3,61,253,125,128
050,26,039,"Michigan","Crawford County",3,62,275,144,131
050,26,039,"Michigan","Crawford County",3,63,265,143,122
050,26,039,"Michigan","Crawford County",3,64,259,137,122
050,26,039,"Michigan","Crawford County",3,65,227,118,109
050,26,039,"Michigan","Crawford County",3,66,235,124,111
050,26,039,"Michigan","Crawford County",3,67,233,120,113
050,26,039,"Michigan","Crawford County",3,68,232,121,111
050,26,039,"Michigan","Crawford County",3,69,210,110,100
050,26,039,"Michigan","Crawford County",3,70,195,99,96
050,26,039,"Michigan","Crawford County",3,71,208,113,95
050,26,039,"Michigan","Crawford County",3,72,196,111,85
050,26,039,"Michigan","Crawford County",3,73,186,95,91
050,26,039,"Michigan","Crawford County",3,74,181,89,92
050,26,039,"Michigan","Crawford County",3,75,134,61,73
050,26,039,"Michigan","Crawford County",3,76,132,64,68
050,26,039,"Michigan","Crawford County",3,77,130,58,72
050,26,039,"Michigan","Crawford County",3,78,138,70,68
050,26,039,"Michigan","Crawford County",3,79,114,56,58
050,26,039,"Michigan","Crawford County",3,80,97,49,48
050,26,039,"Michigan","Crawford County",3,81,90,44,46
050,26,039,"Michigan","Crawford County",3,82,85,47,38
050,26,039,"Michigan","Crawford County",3,83,72,36,36
050,26,039,"Michigan","Crawford County",3,84,63,28,35
050,26,039,"Michigan","Crawford County",3,85,327,139,188
050,26,039,"Michigan","Crawford County",4,0,109,56,53
050,26,039,"Michigan","Crawford County",4,1,128,66,62
050,26,039,"Michigan","Crawford County",4,2,115,63,52
050,26,039,"Michigan","Crawford County",4,3,126,57,69
050,26,039,"Michigan","Crawford County",4,4,116,69,47
050,26,039,"Michigan","Crawford County",4,5,129,69,60
050,26,039,"Michigan","Crawford County",4,6,127,64,63
050,26,039,"Michigan","Crawford County",4,7,142,74,68
050,26,039,"Michigan","Crawford County",4,8,125,70,55
050,26,039,"Michigan","Crawford County",4,9,137,67,70
050,26,039,"Michigan","Crawford County",4,10,126,67,59
050,26,039,"Michigan","Crawford County",4,11,134,71,63
050,26,039,"Michigan","Crawford County",4,12,137,69,68
050,26,039,"Michigan","Crawford County",4,13,138,79,59
050,26,039,"Michigan","Crawford County",4,14,137,72,65
050,26,039,"Michigan","Crawford County",4,15,168,96,72
050,26,039,"Michigan","Crawford County",4,16,153,85,68
050,26,039,"Michigan","Crawford County",4,17,140,72,68
050,26,039,"Michigan","Crawford County",4,18,129,69,60
050,26,039,"Michigan","Crawford County",4,19,86,52,34
050,26,039,"Michigan","Crawford County",4,20,99,48,51
050,26,039,"Michigan","Crawford County",4,21,101,48,53
050,26,039,"Michigan","Crawford County",4,22,104,44,60
050,26,039,"Michigan","Crawford County",4,23,117,49,68
050,26,039,"Michigan","Crawford County",4,24,124,73,51
050,26,039,"Michigan","Crawford County",4,25,145,83,62
050,26,039,"Michigan","Crawford County",4,26,124,71,53
050,26,039,"Michigan","Crawford County",4,27,128,62,66
050,26,039,"Michigan","Crawford County",4,28,121,59,62
050,26,039,"Michigan","Crawford County",4,29,140,69,71
050,26,039,"Michigan","Crawford County",4,30,157,71,86
050,26,039,"Michigan","Crawford County",4,31,145,79,66
050,26,039,"Michigan","Crawford County",4,32,152,80,72
050,26,039,"Michigan","Crawford County",4,33,133,71,62
050,26,039,"Michigan","Crawford County",4,34,121,66,55
050,26,039,"Michigan","Crawford County",4,35,128,63,65
050,26,039,"Michigan","Crawford County",4,36,139,63,76
050,26,039,"Michigan","Crawford County",4,37,161,80,81
050,26,039,"Michigan","Crawford County",4,38,143,74,69
050,26,039,"Michigan","Crawford County",4,39,124,67,57
050,26,039,"Michigan","Crawford County",4,40,131,67,64
050,26,039,"Michigan","Crawford County",4,41,148,78,70
050,26,039,"Michigan","Crawford County",4,42,151,85,66
050,26,039,"Michigan","Crawford County",4,43,145,70,75
050,26,039,"Michigan","Crawford County",4,44,130,62,68
050,26,039,"Michigan","Crawford County",4,45,113,65,48
050,26,039,"Michigan","Crawford County",4,46,126,61,65
050,26,039,"Michigan","Crawford County",4,47,122,58,64
050,26,039,"Michigan","Crawford County",4,48,123,62,61
050,26,039,"Michigan","Crawford County",4,49,136,64,72
050,26,039,"Michigan","Crawford County",4,50,153,81,72
050,26,039,"Michigan","Crawford County",4,51,183,95,88
050,26,039,"Michigan","Crawford County",4,52,172,94,78
050,26,039,"Michigan","Crawford County",4,53,194,102,92
050,26,039,"Michigan","Crawford County",4,54,200,99,101
050,26,039,"Michigan","Crawford County",4,55,191,102,89
050,26,039,"Michigan","Crawford County",4,56,193,90,103
050,26,039,"Michigan","Crawford County",4,57,205,105,100
050,26,039,"Michigan","Crawford County",4,58,227,126,101
050,26,039,"Michigan","Crawford County",4,59,241,130,111
050,26,039,"Michigan","Crawford County",4,60,274,141,133
050,26,039,"Michigan","Crawford County",4,61,267,139,128
050,26,039,"Michigan","Crawford County",4,62,256,126,130
050,26,039,"Michigan","Crawford County",4,63,284,153,131
050,26,039,"Michigan","Crawford County",4,64,275,149,126
050,26,039,"Michigan","Crawford County",4,65,260,138,122
050,26,039,"Michigan","Crawford County",4,66,224,113,111
050,26,039,"Michigan","Crawford County",4,67,240,122,118
050,26,039,"Michigan","Crawford County",4,68,235,119,116
050,26,039,"Michigan","Crawford County",4,69,231,124,107
050,26,039,"Michigan","Crawford County",4,70,209,113,96
050,26,039,"Michigan","Crawford County",4,71,182,93,89
050,26,039,"Michigan","Crawford County",4,72,205,112,93
050,26,039,"Michigan","Crawford County",4,73,194,107,87
050,26,039,"Michigan","Crawford County",4,74,177,90,87
050,26,039,"Michigan","Crawford County",4,75,180,90,90
050,26,039,"Michigan","Crawford County",4,76,120,57,63
050,26,039,"Michigan","Crawford County",4,77,130,61,69
050,26,039,"Michigan","Crawford County",4,78,123,56,67
050,26,039,"Michigan","Crawford County",4,79,120,56,64
050,26,039,"Michigan","Crawford County",4,80,109,54,55
050,26,039,"Michigan","Crawford County",4,81,91,39,52
050,26,039,"Michigan","Crawford County",4,82,78,39,39
050,26,039,"Michigan","Crawford County",4,83,90,46,44
050,26,039,"Michigan","Crawford County",4,84,59,32,27
050,26,039,"Michigan","Crawford County",4,85,329,138,191
050,26,039,"Michigan","Crawford County",5,0,107,55,52
050,26,039,"Michigan","Crawford County",5,1,116,60,56
050,26,039,"Michigan","Crawford County",5,2,122,63,59
050,26,039,"Michigan","Crawford County",5,3,104,56,48
050,26,039,"Michigan","Crawford County",5,4,132,59,73
050,26,039,"Michigan","Crawford County",5,5,118,66,52
050,26,039,"Michigan","Crawford County",5,6,129,64,65
050,26,039,"Michigan","Crawford County",5,7,132,67,65
050,26,039,"Michigan","Crawford County",5,8,143,72,71
050,26,039,"Michigan","Crawford County",5,9,133,69,64
050,26,039,"Michigan","Crawford County",5,10,137,69,68
050,26,039,"Michigan","Crawford County",5,11,129,73,56
050,26,039,"Michigan","Crawford County",5,12,136,69,67
050,26,039,"Michigan","Crawford County",5,13,134,64,70
050,26,039,"Michigan","Crawford County",5,14,145,85,60
050,26,039,"Michigan","Crawford County",5,15,138,71,67
050,26,039,"Michigan","Crawford County",5,16,166,97,69
050,26,039,"Michigan","Crawford County",5,17,145,82,63
050,26,039,"Michigan","Crawford County",5,18,116,61,55
050,26,039,"Michigan","Crawford County",5,19,103,53,50
050,26,039,"Michigan","Crawford County",5,20,93,52,41
050,26,039,"Michigan","Crawford County",5,21,98,44,54
050,26,039,"Michigan","Crawford County",5,22,101,51,50
050,26,039,"Michigan","Crawford County",5,23,104,47,57
050,26,039,"Michigan","Crawford County",5,24,132,56,76
050,26,039,"Michigan","Crawford County",5,25,137,81,56
050,26,039,"Michigan","Crawford County",5,26,145,82,63
050,26,039,"Michigan","Crawford County",5,27,117,63,54
050,26,039,"Michigan","Crawford County",5,28,127,62,65
050,26,039,"Michigan","Crawford County",5,29,116,52,64
050,26,039,"Michigan","Crawford County",5,30,135,69,66
050,26,039,"Michigan","Crawford County",5,31,161,76,85
050,26,039,"Michigan","Crawford County",5,32,153,80,73
050,26,039,"Michigan","Crawford County",5,33,153,78,75
050,26,039,"Michigan","Crawford County",5,34,137,74,63
050,26,039,"Michigan","Crawford County",5,35,127,69,58
050,26,039,"Michigan","Crawford County",5,36,125,63,62
050,26,039,"Michigan","Crawford County",5,37,141,66,75
050,26,039,"Michigan","Crawford County",5,38,162,75,87
050,26,039,"Michigan","Crawford County",5,39,141,72,69
050,26,039,"Michigan","Crawford County",5,40,130,73,57
050,26,039,"Michigan","Crawford County",5,41,143,72,71
050,26,039,"Michigan","Crawford County",5,42,158,85,73
050,26,039,"Michigan","Crawford County",5,43,155,82,73
050,26,039,"Michigan","Crawford County",5,44,153,74,79
050,26,039,"Michigan","Crawford County",5,45,125,64,61
050,26,039,"Michigan","Crawford County",5,46,111,65,46
050,26,039,"Michigan","Crawford County",5,47,133,65,68
050,26,039,"Michigan","Crawford County",5,48,132,59,73
050,26,039,"Michigan","Crawford County",5,49,123,64,59
050,26,039,"Michigan","Crawford County",5,50,146,73,73
050,26,039,"Michigan","Crawford County",5,51,155,80,75
050,26,039,"Michigan","Crawford County",5,52,186,96,90
050,26,039,"Michigan","Crawford County",5,53,185,101,84
050,26,039,"Michigan","Crawford County",5,54,191,107,84
050,26,039,"Michigan","Crawford County",5,55,199,94,105
050,26,039,"Michigan","Crawford County",5,56,188,104,84
050,26,039,"Michigan","Crawford County",5,57,202,96,106
050,26,039,"Michigan","Crawford County",5,58,217,108,109
050,26,039,"Michigan","Crawford County",5,59,224,124,100
050,26,039,"Michigan","Crawford County",5,60,250,128,122
050,26,039,"Michigan","Crawford County",5,61,287,145,142
050,26,039,"Michigan","Crawford County",5,62,283,151,132
050,26,039,"Michigan","Crawford County",5,63,251,127,124
050,26,039,"Michigan","Crawford County",5,64,300,159,141
050,26,039,"Michigan","Crawford County",5,65,272,144,128
050,26,039,"Michigan","Crawford County",5,66,262,136,126
050,26,039,"Michigan","Crawford County",5,67,220,109,111
050,26,039,"Michigan","Crawford County",5,68,250,122,128
050,26,039,"Michigan","Crawford County",5,69,235,121,114
050,26,039,"Michigan","Crawford County",5,70,231,124,107
050,26,039,"Michigan","Crawford County",5,71,215,116,99
050,26,039,"Michigan","Crawford County",5,72,175,89,86
050,26,039,"Michigan","Crawford County",5,73,194,106,88
050,26,039,"Michigan","Crawford County",5,74,189,103,86
050,26,039,"Michigan","Crawford County",5,75,174,91,83
050,26,039,"Michigan","Crawford County",5,76,168,84,84
050,26,039,"Michigan","Crawford County",5,77,117,51,66
050,26,039,"Michigan","Crawford County",5,78,118,55,63
050,26,039,"Michigan","Crawford County",5,79,109,46,63
050,26,039,"Michigan","Crawford County",5,80,112,52,60
050,26,039,"Michigan","Crawford County",5,81,107,46,61
050,26,039,"Michigan","Crawford County",5,82,76,33,43
050,26,039,"Michigan","Crawford County",5,83,81,38,43
050,26,039,"Michigan","Crawford County",5,84,82,45,37
050,26,039,"Michigan","Crawford County",5,85,334,141,193
050,26,041,"Michigan","Delta County",1,0,333,174,159
050,26,041,"Michigan","Delta County",1,1,326,171,155
050,26,041,"Michigan","Delta County",1,2,357,182,175
050,26,041,"Michigan","Delta County",1,3,378,196,182
050,26,041,"Michigan","Delta County",1,4,385,194,191
050,26,041,"Michigan","Delta County",1,5,420,219,201
050,26,041,"Michigan","Delta County",1,6,390,203,187
050,26,041,"Michigan","Delta County",1,7,396,203,193
050,26,041,"Michigan","Delta County",1,8,395,193,202
050,26,041,"Michigan","Delta County",1,9,410,221,189
050,26,041,"Michigan","Delta County",1,10,424,228,196
050,26,041,"Michigan","Delta County",1,11,419,221,198
050,26,041,"Michigan","Delta County",1,12,418,204,214
050,26,041,"Michigan","Delta County",1,13,431,218,213
050,26,041,"Michigan","Delta County",1,14,440,230,210
050,26,041,"Michigan","Delta County",1,15,440,234,206
050,26,041,"Michigan","Delta County",1,16,462,236,226
050,26,041,"Michigan","Delta County",1,17,452,228,224
050,26,041,"Michigan","Delta County",1,18,399,210,189
050,26,041,"Michigan","Delta County",1,19,317,166,151
050,26,041,"Michigan","Delta County",1,20,342,175,167
050,26,041,"Michigan","Delta County",1,21,370,196,174
050,26,041,"Michigan","Delta County",1,22,350,184,166
050,26,041,"Michigan","Delta County",1,23,336,177,159
050,26,041,"Michigan","Delta County",1,24,340,170,170
050,26,041,"Michigan","Delta County",1,25,357,173,184
050,26,041,"Michigan","Delta County",1,26,362,182,180
050,26,041,"Michigan","Delta County",1,27,350,180,170
050,26,041,"Michigan","Delta County",1,28,385,197,188
050,26,041,"Michigan","Delta County",1,29,377,183,194
050,26,041,"Michigan","Delta County",1,30,365,186,179
050,26,041,"Michigan","Delta County",1,31,343,171,172
050,26,041,"Michigan","Delta County",1,32,340,181,159
050,26,041,"Michigan","Delta County",1,33,335,172,163
050,26,041,"Michigan","Delta County",1,34,346,169,177
050,26,041,"Michigan","Delta County",1,35,367,187,180
050,26,041,"Michigan","Delta County",1,36,399,198,201
050,26,041,"Michigan","Delta County",1,37,422,223,199
050,26,041,"Michigan","Delta County",1,38,408,216,192
050,26,041,"Michigan","Delta County",1,39,433,226,207
050,26,041,"Michigan","Delta County",1,40,426,216,210
050,26,041,"Michigan","Delta County",1,41,414,209,205
050,26,041,"Michigan","Delta County",1,42,426,235,191
050,26,041,"Michigan","Delta County",1,43,398,220,178
050,26,041,"Michigan","Delta County",1,44,384,200,184
050,26,041,"Michigan","Delta County",1,45,381,188,193
050,26,041,"Michigan","Delta County",1,46,382,182,200
050,26,041,"Michigan","Delta County",1,47,411,209,202
050,26,041,"Michigan","Delta County",1,48,451,235,216
050,26,041,"Michigan","Delta County",1,49,446,232,214
050,26,041,"Michigan","Delta County",1,50,449,232,217
050,26,041,"Michigan","Delta County",1,51,456,238,218
050,26,041,"Michigan","Delta County",1,52,460,237,223
050,26,041,"Michigan","Delta County",1,53,480,236,244
050,26,041,"Michigan","Delta County",1,54,478,238,240
050,26,041,"Michigan","Delta County",1,55,508,253,255
050,26,041,"Michigan","Delta County",1,56,553,274,279
050,26,041,"Michigan","Delta County",1,57,565,281,284
050,26,041,"Michigan","Delta County",1,58,582,312,270
050,26,041,"Michigan","Delta County",1,59,607,321,286
050,26,041,"Michigan","Delta County",1,60,613,313,300
050,26,041,"Michigan","Delta County",1,61,607,296,311
050,26,041,"Michigan","Delta County",1,62,637,313,324
050,26,041,"Michigan","Delta County",1,63,629,315,314
050,26,041,"Michigan","Delta County",1,64,646,316,330
050,26,041,"Michigan","Delta County",1,65,667,335,332
050,26,041,"Michigan","Delta County",1,66,630,319,311
050,26,041,"Michigan","Delta County",1,67,622,317,305
050,26,041,"Michigan","Delta County",1,68,615,290,325
050,26,041,"Michigan","Delta County",1,69,549,265,284
050,26,041,"Michigan","Delta County",1,70,567,276,291
050,26,041,"Michigan","Delta County",1,71,537,266,271
050,26,041,"Michigan","Delta County",1,72,502,266,236
050,26,041,"Michigan","Delta County",1,73,483,246,237
050,26,041,"Michigan","Delta County",1,74,327,160,167
050,26,041,"Michigan","Delta County",1,75,324,159,165
050,26,041,"Michigan","Delta County",1,76,333,160,173
050,26,041,"Michigan","Delta County",1,77,319,139,180
050,26,041,"Michigan","Delta County",1,78,285,136,149
050,26,041,"Michigan","Delta County",1,79,273,137,136
050,26,041,"Michigan","Delta County",1,80,233,114,119
050,26,041,"Michigan","Delta County",1,81,235,110,125
050,26,041,"Michigan","Delta County",1,82,227,94,133
050,26,041,"Michigan","Delta County",1,83,196,92,104
050,26,041,"Michigan","Delta County",1,84,163,71,92
050,26,041,"Michigan","Delta County",1,85,1108,367,741
050,26,041,"Michigan","Delta County",2,0,327,171,156
050,26,041,"Michigan","Delta County",2,1,324,169,155
050,26,041,"Michigan","Delta County",2,2,350,179,171
050,26,041,"Michigan","Delta County",2,3,373,193,180
050,26,041,"Michigan","Delta County",2,4,386,196,190
050,26,041,"Michigan","Delta County",2,5,411,213,198
050,26,041,"Michigan","Delta County",2,6,393,206,187
050,26,041,"Michigan","Delta County",2,7,393,202,191
050,26,041,"Michigan","Delta County",2,8,393,195,198
050,26,041,"Michigan","Delta County",2,9,407,216,191
050,26,041,"Michigan","Delta County",2,10,422,228,194
050,26,041,"Michigan","Delta County",2,11,419,220,199
050,26,041,"Michigan","Delta County",2,12,421,209,212
050,26,041,"Michigan","Delta County",2,13,429,216,213
050,26,041,"Michigan","Delta County",2,14,438,226,212
050,26,041,"Michigan","Delta County",2,15,442,234,208
050,26,041,"Michigan","Delta County",2,16,462,238,224
050,26,041,"Michigan","Delta County",2,17,456,232,224
050,26,041,"Michigan","Delta County",2,18,394,207,187
050,26,041,"Michigan","Delta County",2,19,317,166,151
050,26,041,"Michigan","Delta County",2,20,347,179,168
050,26,041,"Michigan","Delta County",2,21,367,193,174
050,26,041,"Michigan","Delta County",2,22,359,188,171
050,26,041,"Michigan","Delta County",2,23,343,181,162
050,26,041,"Michigan","Delta County",2,24,340,171,169
050,26,041,"Michigan","Delta County",2,25,353,173,180
050,26,041,"Michigan","Delta County",2,26,359,181,178
050,26,041,"Michigan","Delta County",2,27,352,182,170
050,26,041,"Michigan","Delta County",2,28,375,191,184
050,26,041,"Michigan","Delta County",2,29,378,185,193
050,26,041,"Michigan","Delta County",2,30,373,188,185
050,26,041,"Michigan","Delta County",2,31,346,174,172
050,26,041,"Michigan","Delta County",2,32,342,178,164
050,26,041,"Michigan","Delta County",2,33,336,173,163
050,26,041,"Michigan","Delta County",2,34,345,171,174
050,26,041,"Michigan","Delta County",2,35,368,187,181
050,26,041,"Michigan","Delta County",2,36,393,197,196
050,26,041,"Michigan","Delta County",2,37,415,218,197
050,26,041,"Michigan","Delta County",2,38,414,219,195
050,26,041,"Michigan","Delta County",2,39,426,224,202
050,26,041,"Michigan","Delta County",2,40,432,220,212
050,26,041,"Michigan","Delta County",2,41,417,212,205
050,26,041,"Michigan","Delta County",2,42,422,228,194
050,26,041,"Michigan","Delta County",2,43,411,227,184
050,26,041,"Michigan","Delta County",2,44,384,202,182
050,26,041,"Michigan","Delta County",2,45,387,194,193
050,26,041,"Michigan","Delta County",2,46,382,183,199
050,26,041,"Michigan","Delta County",2,47,404,203,201
050,26,041,"Michigan","Delta County",2,48,437,228,209
050,26,041,"Michigan","Delta County",2,49,451,235,216
050,26,041,"Michigan","Delta County",2,50,451,232,219
050,26,041,"Michigan","Delta County",2,51,450,233,217
050,26,041,"Michigan","Delta County",2,52,458,236,222
050,26,041,"Michigan","Delta County",2,53,476,236,240
050,26,041,"Michigan","Delta County",2,54,476,237,239
050,26,041,"Michigan","Delta County",2,55,501,248,253
050,26,041,"Michigan","Delta County",2,56,542,269,273
050,26,041,"Michigan","Delta County",2,57,561,279,282
050,26,041,"Michigan","Delta County",2,58,576,304,272
050,26,041,"Michigan","Delta County",2,59,604,321,283
050,26,041,"Michigan","Delta County",2,60,603,309,294
050,26,041,"Michigan","Delta County",2,61,605,300,305
050,26,041,"Michigan","Delta County",2,62,628,307,321
050,26,041,"Michigan","Delta County",2,63,635,316,319
050,26,041,"Michigan","Delta County",2,64,637,313,324
050,26,041,"Michigan","Delta County",2,65,661,330,331
050,26,041,"Michigan","Delta County",2,66,641,325,316
050,26,041,"Michigan","Delta County",2,67,624,318,306
050,26,041,"Michigan","Delta County",2,68,613,295,318
050,26,041,"Michigan","Delta County",2,69,568,270,298
050,26,041,"Michigan","Delta County",2,70,558,271,287
050,26,041,"Michigan","Delta County",2,71,545,270,275
050,26,041,"Michigan","Delta County",2,72,497,257,240
050,26,041,"Michigan","Delta County",2,73,510,262,248
050,26,041,"Michigan","Delta County",2,74,338,167,171
050,26,041,"Michigan","Delta County",2,75,327,160,167
050,26,041,"Michigan","Delta County",2,76,328,159,169
050,26,041,"Michigan","Delta County",2,77,327,146,181
050,26,041,"Michigan","Delta County",2,78,285,132,153
050,26,041,"Michigan","Delta County",2,79,273,136,137
050,26,041,"Michigan","Delta County",2,80,241,119,122
050,26,041,"Michigan","Delta County",2,81,233,111,122
050,26,041,"Michigan","Delta County",2,82,223,95,128
050,26,041,"Michigan","Delta County",2,83,199,91,108
050,26,041,"Michigan","Delta County",2,84,167,74,93
050,26,041,"Michigan","Delta County",2,85,1094,361,733
050,26,041,"Michigan","Delta County",3,0,343,185,158
050,26,041,"Michigan","Delta County",3,1,322,171,151
050,26,041,"Michigan","Delta County",3,2,330,174,156
050,26,041,"Michigan","Delta County",3,3,353,178,175
050,26,041,"Michigan","Delta County",3,4,372,193,179
050,26,041,"Michigan","Delta County",3,5,395,203,192
050,26,041,"Michigan","Delta County",3,6,414,212,202
050,26,041,"Michigan","Delta County",3,7,392,203,189
050,26,041,"Michigan","Delta County",3,8,404,210,194
050,26,041,"Michigan","Delta County",3,9,391,192,199
050,26,041,"Michigan","Delta County",3,10,402,214,188
050,26,041,"Michigan","Delta County",3,11,426,227,199
050,26,041,"Michigan","Delta County",3,12,420,218,202
050,26,041,"Michigan","Delta County",3,13,427,216,211
050,26,041,"Michigan","Delta County",3,14,431,216,215
050,26,041,"Michigan","Delta County",3,15,442,223,219
050,26,041,"Michigan","Delta County",3,16,449,232,217
050,26,041,"Michigan","Delta County",3,17,466,246,220
050,26,041,"Michigan","Delta County",3,18,389,199,190
050,26,041,"Michigan","Delta County",3,19,311,166,145
050,26,041,"Michigan","Delta County",3,20,355,181,174
050,26,041,"Michigan","Delta County",3,21,354,184,170
050,26,041,"Michigan","Delta County",3,22,386,198,188
050,26,041,"Michigan","Delta County",3,23,374,199,175
050,26,041,"Michigan","Delta County",3,24,337,182,155
050,26,041,"Michigan","Delta County",3,25,335,172,163
050,26,041,"Michigan","Delta County",3,26,377,189,188
050,26,041,"Michigan","Delta County",3,27,353,184,169
050,26,041,"Michigan","Delta County",3,28,372,198,174
050,26,041,"Michigan","Delta County",3,29,380,190,190
050,26,041,"Michigan","Delta County",3,30,384,191,193
050,26,041,"Michigan","Delta County",3,31,376,194,182
050,26,041,"Michigan","Delta County",3,32,354,174,180
050,26,041,"Michigan","Delta County",3,33,354,183,171
050,26,041,"Michigan","Delta County",3,34,350,180,170
050,26,041,"Michigan","Delta County",3,35,354,178,176
050,26,041,"Michigan","Delta County",3,36,369,185,184
050,26,041,"Michigan","Delta County",3,37,394,194,200
050,26,041,"Michigan","Delta County",3,38,415,216,199
050,26,041,"Michigan","Delta County",3,39,423,222,201
050,26,041,"Michigan","Delta County",3,40,413,210,203
050,26,041,"Michigan","Delta County",3,41,433,219,214
050,26,041,"Michigan","Delta County",3,42,427,215,212
050,26,041,"Michigan","Delta County",3,43,416,228,188
050,26,041,"Michigan","Delta County",3,44,411,225,186
050,26,041,"Michigan","Delta County",3,45,383,203,180
050,26,041,"Michigan","Delta County",3,46,384,193,191
050,26,041,"Michigan","Delta County",3,47,400,199,201
050,26,041,"Michigan","Delta County",3,48,396,197,199
050,26,041,"Michigan","Delta County",3,49,455,240,215
050,26,041,"Michigan","Delta County",3,50,457,234,223
050,26,041,"Michigan","Delta County",3,51,443,227,216
050,26,041,"Michigan","Delta County",3,52,458,236,222
050,26,041,"Michigan","Delta County",3,53,460,236,224
050,26,041,"Michigan","Delta County",3,54,478,242,236
050,26,041,"Michigan","Delta County",3,55,466,233,233
050,26,041,"Michigan","Delta County",3,56,517,260,257
050,26,041,"Michigan","Delta County",3,57,529,254,275
050,26,041,"Michigan","Delta County",3,58,576,286,290
050,26,041,"Michigan","Delta County",3,59,584,305,279
050,26,041,"Michigan","Delta County",3,60,602,318,284
050,26,041,"Michigan","Delta County",3,61,612,316,296
050,26,041,"Michigan","Delta County",3,62,611,311,300
050,26,041,"Michigan","Delta County",3,63,633,309,324
050,26,041,"Michigan","Delta County",3,64,637,307,330
050,26,041,"Michigan","Delta County",3,65,626,310,316
050,26,041,"Michigan","Delta County",3,66,654,331,323
050,26,041,"Michigan","Delta County",3,67,635,321,314
050,26,041,"Michigan","Delta County",3,68,604,304,300
050,26,041,"Michigan","Delta County",3,69,596,285,311
050,26,041,"Michigan","Delta County",3,70,557,267,290
050,26,041,"Michigan","Delta County",3,71,548,265,283
050,26,041,"Michigan","Delta County",3,72,527,257,270
050,26,041,"Michigan","Delta County",3,73,482,246,236
050,26,041,"Michigan","Delta County",3,74,488,247,241
050,26,041,"Michigan","Delta County",3,75,328,160,168
050,26,041,"Michigan","Delta County",3,76,319,156,163
050,26,041,"Michigan","Delta County",3,77,308,147,161
050,26,041,"Michigan","Delta County",3,78,306,135,171
050,26,041,"Michigan","Delta County",3,79,274,124,150
050,26,041,"Michigan","Delta County",3,80,260,126,134
050,26,041,"Michigan","Delta County",3,81,232,115,117
050,26,041,"Michigan","Delta County",3,82,202,100,102
050,26,041,"Michigan","Delta County",3,83,202,88,114
050,26,041,"Michigan","Delta County",3,84,184,83,101
050,26,041,"Michigan","Delta County",3,85,1037,344,693
050,26,041,"Michigan","Delta County",4,0,333,181,152
050,26,041,"Michigan","Delta County",4,1,355,192,163
050,26,041,"Michigan","Delta County",4,2,320,159,161
050,26,041,"Michigan","Delta County",4,3,331,173,158
050,26,041,"Michigan","Delta County",4,4,350,173,177
050,26,041,"Michigan","Delta County",4,5,369,192,177
050,26,041,"Michigan","Delta County",4,6,376,190,186
050,26,041,"Michigan","Delta County",4,7,424,217,207
050,26,041,"Michigan","Delta County",4,8,396,208,188
050,26,041,"Michigan","Delta County",4,9,396,205,191
050,26,041,"Michigan","Delta County",4,10,393,192,201
050,26,041,"Michigan","Delta County",4,11,407,214,193
050,26,041,"Michigan","Delta County",4,12,434,229,205
050,26,041,"Michigan","Delta County",4,13,429,220,209
050,26,041,"Michigan","Delta County",4,14,425,217,208
050,26,041,"Michigan","Delta County",4,15,435,217,218
050,26,041,"Michigan","Delta County",4,16,441,220,221
050,26,041,"Michigan","Delta County",4,17,455,242,213
050,26,041,"Michigan","Delta County",4,18,390,211,179
050,26,041,"Michigan","Delta County",4,19,292,157,135
050,26,041,"Michigan","Delta County",4,20,321,167,154
050,26,041,"Michigan","Delta County",4,21,366,185,181
050,26,041,"Michigan","Delta County",4,22,370,184,186
050,26,041,"Michigan","Delta County",4,23,394,204,190
050,26,041,"Michigan","Delta County",4,24,373,194,179
050,26,041,"Michigan","Delta County",4,25,343,184,159
050,26,041,"Michigan","Delta County",4,26,342,169,173
050,26,041,"Michigan","Delta County",4,27,366,183,183
050,26,041,"Michigan","Delta County",4,28,341,180,161
050,26,041,"Michigan","Delta County",4,29,361,194,167
050,26,041,"Michigan","Delta County",4,30,371,194,177
050,26,041,"Michigan","Delta County",4,31,399,195,204
050,26,041,"Michigan","Delta County",4,32,398,207,191
050,26,041,"Michigan","Delta County",4,33,362,177,185
050,26,041,"Michigan","Delta County",4,34,365,193,172
050,26,041,"Michigan","Delta County",4,35,359,185,174
050,26,041,"Michigan","Delta County",4,36,350,172,178
050,26,041,"Michigan","Delta County",4,37,362,180,182
050,26,041,"Michigan","Delta County",4,38,415,207,208
050,26,041,"Michigan","Delta County",4,39,422,219,203
050,26,041,"Michigan","Delta County",4,40,422,221,201
050,26,041,"Michigan","Delta County",4,41,424,216,208
050,26,041,"Michigan","Delta County",4,42,442,223,219
050,26,041,"Michigan","Delta County",4,43,422,215,207
050,26,041,"Michigan","Delta County",4,44,425,236,189
050,26,041,"Michigan","Delta County",4,45,395,219,176
050,26,041,"Michigan","Delta County",4,46,376,202,174
050,26,041,"Michigan","Delta County",4,47,394,200,194
050,26,041,"Michigan","Delta County",4,48,407,199,208
050,26,041,"Michigan","Delta County",4,49,403,200,203
050,26,041,"Michigan","Delta County",4,50,455,241,214
050,26,041,"Michigan","Delta County",4,51,456,240,216
050,26,041,"Michigan","Delta County",4,52,451,231,220
050,26,041,"Michigan","Delta County",4,53,460,240,220
050,26,041,"Michigan","Delta County",4,54,463,243,220
050,26,041,"Michigan","Delta County",4,55,482,239,243
050,26,041,"Michigan","Delta County",4,56,461,235,226
050,26,041,"Michigan","Delta County",4,57,517,259,258
050,26,041,"Michigan","Delta County",4,58,539,259,280
050,26,041,"Michigan","Delta County",4,59,574,288,286
050,26,041,"Michigan","Delta County",4,60,594,307,287
050,26,041,"Michigan","Delta County",4,61,607,322,285
050,26,041,"Michigan","Delta County",4,62,615,322,293
050,26,041,"Michigan","Delta County",4,63,610,310,300
050,26,041,"Michigan","Delta County",4,64,643,312,331
050,26,041,"Michigan","Delta County",4,65,640,305,335
050,26,041,"Michigan","Delta County",4,66,619,308,311
050,26,041,"Michigan","Delta County",4,67,655,329,326
050,26,041,"Michigan","Delta County",4,68,638,323,315
050,26,041,"Michigan","Delta County",4,69,592,293,299
050,26,041,"Michigan","Delta County",4,70,585,279,306
050,26,041,"Michigan","Delta County",4,71,557,267,290
050,26,041,"Michigan","Delta County",4,72,522,249,273
050,26,041,"Michigan","Delta County",4,73,504,241,263
050,26,041,"Michigan","Delta County",4,74,470,241,229
050,26,041,"Michigan","Delta County",4,75,474,240,234
050,26,041,"Michigan","Delta County",4,76,323,159,164
050,26,041,"Michigan","Delta County",4,77,302,146,156
050,26,041,"Michigan","Delta County",4,78,293,140,153
050,26,041,"Michigan","Delta County",4,79,289,122,167
050,26,041,"Michigan","Delta County",4,80,256,113,143
050,26,041,"Michigan","Delta County",4,81,253,122,131
050,26,041,"Michigan","Delta County",4,82,212,107,105
050,26,041,"Michigan","Delta County",4,83,176,86,90
050,26,041,"Michigan","Delta County",4,84,194,83,111
050,26,041,"Michigan","Delta County",4,85,1059,363,696
050,26,041,"Michigan","Delta County",5,0,313,172,141
050,26,041,"Michigan","Delta County",5,1,325,176,149
050,26,041,"Michigan","Delta County",5,2,362,194,168
050,26,041,"Michigan","Delta County",5,3,334,168,166
050,26,041,"Michigan","Delta County",5,4,327,171,156
050,26,041,"Michigan","Delta County",5,5,353,177,176
050,26,041,"Michigan","Delta County",5,6,379,194,185
050,26,041,"Michigan","Delta County",5,7,382,190,192
050,26,041,"Michigan","Delta County",5,8,425,218,207
050,26,041,"Michigan","Delta County",5,9,397,209,188
050,26,041,"Michigan","Delta County",5,10,421,215,206
050,26,041,"Michigan","Delta County",5,11,390,192,198
050,26,041,"Michigan","Delta County",5,12,406,212,194
050,26,041,"Michigan","Delta County",5,13,436,228,208
050,26,041,"Michigan","Delta County",5,14,418,217,201
050,26,041,"Michigan","Delta County",5,15,433,221,212
050,26,041,"Michigan","Delta County",5,16,448,227,221
050,26,041,"Michigan","Delta County",5,17,440,221,219
050,26,041,"Michigan","Delta County",5,18,385,209,176
050,26,041,"Michigan","Delta County",5,19,321,180,141
050,26,041,"Michigan","Delta County",5,20,321,164,157
050,26,041,"Michigan","Delta County",5,21,349,186,163
050,26,041,"Michigan","Delta County",5,22,382,184,198
050,26,041,"Michigan","Delta County",5,23,392,200,192
050,26,041,"Michigan","Delta County",5,24,384,193,191
050,26,041,"Michigan","Delta County",5,25,362,192,170
050,26,041,"Michigan","Delta County",5,26,346,186,160
050,26,041,"Michigan","Delta County",5,27,349,173,176
050,26,041,"Michigan","Delta County",5,28,373,189,184
050,26,041,"Michigan","Delta County",5,29,348,183,165
050,26,041,"Michigan","Delta County",5,30,365,195,170
050,26,041,"Michigan","Delta County",5,31,375,196,179
050,26,041,"Michigan","Delta County",5,32,409,200,209
050,26,041,"Michigan","Delta County",5,33,397,205,192
050,26,041,"Michigan","Delta County",5,34,374,184,190
050,26,041,"Michigan","Delta County",5,35,377,200,177
050,26,041,"Michigan","Delta County",5,36,361,180,181
050,26,041,"Michigan","Delta County",5,37,353,173,180
050,26,041,"Michigan","Delta County",5,38,370,187,183
050,26,041,"Michigan","Delta County",5,39,415,207,208
050,26,041,"Michigan","Delta County",5,40,423,219,204
050,26,041,"Michigan","Delta County",5,41,435,220,215
050,26,041,"Michigan","Delta County",5,42,416,211,205
050,26,041,"Michigan","Delta County",5,43,440,226,214
050,26,041,"Michigan","Delta County",5,44,434,220,214
050,26,041,"Michigan","Delta County",5,45,428,240,188
050,26,041,"Michigan","Delta County",5,46,406,225,181
050,26,041,"Michigan","Delta County",5,47,385,205,180
050,26,041,"Michigan","Delta County",5,48,407,207,200
050,26,041,"Michigan","Delta County",5,49,410,200,210
050,26,041,"Michigan","Delta County",5,50,409,202,207
050,26,041,"Michigan","Delta County",5,51,450,235,215
050,26,041,"Michigan","Delta County",5,52,464,245,219
050,26,041,"Michigan","Delta County",5,53,454,237,217
050,26,041,"Michigan","Delta County",5,54,460,243,217
050,26,041,"Michigan","Delta County",5,55,468,241,227
050,26,041,"Michigan","Delta County",5,56,489,244,245
050,26,041,"Michigan","Delta County",5,57,457,230,227
050,26,041,"Michigan","Delta County",5,58,519,258,261
050,26,041,"Michigan","Delta County",5,59,536,256,280
050,26,041,"Michigan","Delta County",5,60,572,281,291
050,26,041,"Michigan","Delta County",5,61,593,304,289
050,26,041,"Michigan","Delta County",5,62,617,327,290
050,26,041,"Michigan","Delta County",5,63,609,316,293
050,26,041,"Michigan","Delta County",5,64,614,308,306
050,26,041,"Michigan","Delta County",5,65,636,307,329
050,26,041,"Michigan","Delta County",5,66,629,301,328
050,26,041,"Michigan","Delta County",5,67,611,306,305
050,26,041,"Michigan","Delta County",5,68,643,320,323
050,26,041,"Michigan","Delta County",5,69,620,312,308
050,26,041,"Michigan","Delta County",5,70,580,288,292
050,26,041,"Michigan","Delta County",5,71,580,278,302
050,26,041,"Michigan","Delta County",5,72,537,256,281
050,26,041,"Michigan","Delta County",5,73,505,236,269
050,26,041,"Michigan","Delta County",5,74,491,232,259
050,26,041,"Michigan","Delta County",5,75,459,233,226
050,26,041,"Michigan","Delta County",5,76,459,235,224
050,26,041,"Michigan","Delta County",5,77,305,148,157
050,26,041,"Michigan","Delta County",5,78,287,135,152
050,26,041,"Michigan","Delta County",5,79,278,129,149
050,26,041,"Michigan","Delta County",5,80,269,109,160
050,26,041,"Michigan","Delta County",5,81,251,109,142
050,26,041,"Michigan","Delta County",5,82,223,110,113
050,26,041,"Michigan","Delta County",5,83,188,96,92
050,26,041,"Michigan","Delta County",5,84,161,79,82
050,26,041,"Michigan","Delta County",5,85,1086,375,711
050,26,043,"Michigan","Dickinson County",1,0,256,131,125
050,26,043,"Michigan","Dickinson County",1,1,245,123,122
050,26,043,"Michigan","Dickinson County",1,2,253,142,111
050,26,043,"Michigan","Dickinson County",1,3,305,157,148
050,26,043,"Michigan","Dickinson County",1,4,295,149,146
050,26,043,"Michigan","Dickinson County",1,5,242,125,117
050,26,043,"Michigan","Dickinson County",1,6,298,159,139
050,26,043,"Michigan","Dickinson County",1,7,305,160,145
050,26,043,"Michigan","Dickinson County",1,8,272,135,137
050,26,043,"Michigan","Dickinson County",1,9,279,147,132
050,26,043,"Michigan","Dickinson County",1,10,263,129,134
050,26,043,"Michigan","Dickinson County",1,11,289,148,141
050,26,043,"Michigan","Dickinson County",1,12,324,174,150
050,26,043,"Michigan","Dickinson County",1,13,318,173,145
050,26,043,"Michigan","Dickinson County",1,14,318,170,148
050,26,043,"Michigan","Dickinson County",1,15,312,162,150
050,26,043,"Michigan","Dickinson County",1,16,317,170,147
050,26,043,"Michigan","Dickinson County",1,17,323,164,159
050,26,043,"Michigan","Dickinson County",1,18,280,143,137
050,26,043,"Michigan","Dickinson County",1,19,231,115,116
050,26,043,"Michigan","Dickinson County",1,20,227,121,106
050,26,043,"Michigan","Dickinson County",1,21,253,135,118
050,26,043,"Michigan","Dickinson County",1,22,284,162,122
050,26,043,"Michigan","Dickinson County",1,23,272,143,129
050,26,043,"Michigan","Dickinson County",1,24,269,147,122
050,26,043,"Michigan","Dickinson County",1,25,272,162,110
050,26,043,"Michigan","Dickinson County",1,26,259,142,117
050,26,043,"Michigan","Dickinson County",1,27,288,154,134
050,26,043,"Michigan","Dickinson County",1,28,269,135,134
050,26,043,"Michigan","Dickinson County",1,29,284,147,137
050,26,043,"Michigan","Dickinson County",1,30,259,134,125
050,26,043,"Michigan","Dickinson County",1,31,236,130,106
050,26,043,"Michigan","Dickinson County",1,32,249,127,122
050,26,043,"Michigan","Dickinson County",1,33,275,140,135
050,26,043,"Michigan","Dickinson County",1,34,306,152,154
050,26,043,"Michigan","Dickinson County",1,35,298,153,145
050,26,043,"Michigan","Dickinson County",1,36,294,157,137
050,26,043,"Michigan","Dickinson County",1,37,301,157,144
050,26,043,"Michigan","Dickinson County",1,38,333,166,167
050,26,043,"Michigan","Dickinson County",1,39,310,152,158
050,26,043,"Michigan","Dickinson County",1,40,307,152,155
050,26,043,"Michigan","Dickinson County",1,41,257,130,127
050,26,043,"Michigan","Dickinson County",1,42,263,130,133
050,26,043,"Michigan","Dickinson County",1,43,262,134,128
050,26,043,"Michigan","Dickinson County",1,44,249,129,120
050,26,043,"Michigan","Dickinson County",1,45,260,133,127
050,26,043,"Michigan","Dickinson County",1,46,264,138,126
050,26,043,"Michigan","Dickinson County",1,47,278,143,135
050,26,043,"Michigan","Dickinson County",1,48,301,146,155
050,26,043,"Michigan","Dickinson County",1,49,318,149,169
050,26,043,"Michigan","Dickinson County",1,50,308,161,147
050,26,043,"Michigan","Dickinson County",1,51,323,165,158
050,26,043,"Michigan","Dickinson County",1,52,333,172,161
050,26,043,"Michigan","Dickinson County",1,53,364,197,167
050,26,043,"Michigan","Dickinson County",1,54,364,189,175
050,26,043,"Michigan","Dickinson County",1,55,382,196,186
050,26,043,"Michigan","Dickinson County",1,56,424,223,201
050,26,043,"Michigan","Dickinson County",1,57,417,209,208
050,26,043,"Michigan","Dickinson County",1,58,412,202,210
050,26,043,"Michigan","Dickinson County",1,59,425,203,222
050,26,043,"Michigan","Dickinson County",1,60,450,213,237
050,26,043,"Michigan","Dickinson County",1,61,437,217,220
050,26,043,"Michigan","Dickinson County",1,62,456,230,226
050,26,043,"Michigan","Dickinson County",1,63,467,241,226
050,26,043,"Michigan","Dickinson County",1,64,473,241,232
050,26,043,"Michigan","Dickinson County",1,65,423,216,207
050,26,043,"Michigan","Dickinson County",1,66,397,199,198
050,26,043,"Michigan","Dickinson County",1,67,385,195,190
050,26,043,"Michigan","Dickinson County",1,68,365,192,173
050,26,043,"Michigan","Dickinson County",1,69,315,159,156
050,26,043,"Michigan","Dickinson County",1,70,307,160,147
050,26,043,"Michigan","Dickinson County",1,71,325,170,155
050,26,043,"Michigan","Dickinson County",1,72,355,178,177
050,26,043,"Michigan","Dickinson County",1,73,333,172,161
050,26,043,"Michigan","Dickinson County",1,74,203,97,106
050,26,043,"Michigan","Dickinson County",1,75,207,98,109
050,26,043,"Michigan","Dickinson County",1,76,218,103,115
050,26,043,"Michigan","Dickinson County",1,77,214,107,107
050,26,043,"Michigan","Dickinson County",1,78,192,84,108
050,26,043,"Michigan","Dickinson County",1,79,189,91,98
050,26,043,"Michigan","Dickinson County",1,80,167,76,91
050,26,043,"Michigan","Dickinson County",1,81,152,71,81
050,26,043,"Michigan","Dickinson County",1,82,129,62,67
050,26,043,"Michigan","Dickinson County",1,83,114,56,58
050,26,043,"Michigan","Dickinson County",1,84,100,41,59
050,26,043,"Michigan","Dickinson County",1,85,808,320,488
050,26,043,"Michigan","Dickinson County",2,0,250,133,117
050,26,043,"Michigan","Dickinson County",2,1,245,124,121
050,26,043,"Michigan","Dickinson County",2,2,253,138,115
050,26,043,"Michigan","Dickinson County",2,3,292,153,139
050,26,043,"Michigan","Dickinson County",2,4,296,150,146
050,26,043,"Michigan","Dickinson County",2,5,254,130,124
050,26,043,"Michigan","Dickinson County",2,6,284,151,133
050,26,043,"Michigan","Dickinson County",2,7,301,159,142
050,26,043,"Michigan","Dickinson County",2,8,278,140,138
050,26,043,"Michigan","Dickinson County",2,9,275,144,131
050,26,043,"Michigan","Dickinson County",2,10,263,131,132
050,26,043,"Michigan","Dickinson County",2,11,282,143,139
050,26,043,"Michigan","Dickinson County",2,12,316,167,149
050,26,043,"Michigan","Dickinson County",2,13,320,174,146
050,26,043,"Michigan","Dickinson County",2,14,318,172,146
050,26,043,"Michigan","Dickinson County",2,15,315,165,150
050,26,043,"Michigan","Dickinson County",2,16,316,169,147
050,26,043,"Michigan","Dickinson County",2,17,320,166,154
050,26,043,"Michigan","Dickinson County",2,18,272,140,132
050,26,043,"Michigan","Dickinson County",2,19,230,114,116
050,26,043,"Michigan","Dickinson County",2,20,231,121,110
050,26,043,"Michigan","Dickinson County",2,21,250,136,114
050,26,043,"Michigan","Dickinson County",2,22,280,156,124
050,26,043,"Michigan","Dickinson County",2,23,277,149,128
050,26,043,"Michigan","Dickinson County",2,24,270,146,124
050,26,043,"Michigan","Dickinson County",2,25,272,157,115
050,26,043,"Michigan","Dickinson County",2,26,267,149,118
050,26,043,"Michigan","Dickinson County",2,27,282,151,131
050,26,043,"Michigan","Dickinson County",2,28,277,142,135
050,26,043,"Michigan","Dickinson County",2,29,282,146,136
050,26,043,"Michigan","Dickinson County",2,30,266,137,129
050,26,043,"Michigan","Dickinson County",2,31,241,131,110
050,26,043,"Michigan","Dickinson County",2,32,245,126,119
050,26,043,"Michigan","Dickinson County",2,33,268,138,130
050,26,043,"Michigan","Dickinson County",2,34,296,148,148
050,26,043,"Michigan","Dickinson County",2,35,301,153,148
050,26,043,"Michigan","Dickinson County",2,36,291,154,137
050,26,043,"Michigan","Dickinson County",2,37,300,158,142
050,26,043,"Michigan","Dickinson County",2,38,327,164,163
050,26,043,"Michigan","Dickinson County",2,39,314,156,158
050,26,043,"Michigan","Dickinson County",2,40,312,155,157
050,26,043,"Michigan","Dickinson County",2,41,268,134,134
050,26,043,"Michigan","Dickinson County",2,42,260,129,131
050,26,043,"Michigan","Dickinson County",2,43,263,134,129
050,26,043,"Michigan","Dickinson County",2,44,249,128,121
050,26,043,"Michigan","Dickinson County",2,45,258,133,125
050,26,043,"Michigan","Dickinson County",2,46,262,136,126
050,26,043,"Michigan","Dickinson County",2,47,273,140,133
050,26,043,"Michigan","Dickinson County",2,48,295,145,150
050,26,043,"Michigan","Dickinson County",2,49,317,150,167
050,26,043,"Michigan","Dickinson County",2,50,313,160,153
050,26,043,"Michigan","Dickinson County",2,51,320,163,157
050,26,043,"Michigan","Dickinson County",2,52,326,168,158
050,26,043,"Michigan","Dickinson County",2,53,356,190,166
050,26,043,"Michigan","Dickinson County",2,54,362,190,172
050,26,043,"Michigan","Dickinson County",2,55,380,195,185
050,26,043,"Michigan","Dickinson County",2,56,414,218,196
050,26,043,"Michigan","Dickinson County",2,57,413,210,203
050,26,043,"Michigan","Dickinson County",2,58,411,203,208
050,26,043,"Michigan","Dickinson County",2,59,422,203,219
050,26,043,"Michigan","Dickinson County",2,60,444,211,233
050,26,043,"Michigan","Dickinson County",2,61,437,214,223
050,26,043,"Michigan","Dickinson County",2,62,448,224,224
050,26,043,"Michigan","Dickinson County",2,63,471,242,229
050,26,043,"Michigan","Dickinson County",2,64,466,237,229
050,26,043,"Michigan","Dickinson County",2,65,433,220,213
050,26,043,"Michigan","Dickinson County",2,66,408,205,203
050,26,043,"Michigan","Dickinson County",2,67,385,194,191
050,26,043,"Michigan","Dickinson County",2,68,368,192,176
050,26,043,"Michigan","Dickinson County",2,69,326,166,160
050,26,043,"Michigan","Dickinson County",2,70,304,156,148
050,26,043,"Michigan","Dickinson County",2,71,322,168,154
050,26,043,"Michigan","Dickinson County",2,72,338,171,167
050,26,043,"Michigan","Dickinson County",2,73,353,183,170
050,26,043,"Michigan","Dickinson County",2,74,217,107,110
050,26,043,"Michigan","Dickinson County",2,75,205,98,107
050,26,043,"Michigan","Dickinson County",2,76,210,99,111
050,26,043,"Michigan","Dickinson County",2,77,213,105,108
050,26,043,"Michigan","Dickinson County",2,78,194,88,106
050,26,043,"Michigan","Dickinson County",2,79,185,86,99
050,26,043,"Michigan","Dickinson County",2,80,173,80,93
050,26,043,"Michigan","Dickinson County",2,81,155,71,84
050,26,043,"Michigan","Dickinson County",2,82,134,66,68
050,26,043,"Michigan","Dickinson County",2,83,117,57,60
050,26,043,"Michigan","Dickinson County",2,84,102,44,58
050,26,043,"Michigan","Dickinson County",2,85,805,317,488
050,26,043,"Michigan","Dickinson County",3,0,236,120,116
050,26,043,"Michigan","Dickinson County",3,1,252,138,114
050,26,043,"Michigan","Dickinson County",3,2,247,127,120
050,26,043,"Michigan","Dickinson County",3,3,267,140,127
050,26,043,"Michigan","Dickinson County",3,4,285,150,135
050,26,043,"Michigan","Dickinson County",3,5,301,149,152
050,26,043,"Michigan","Dickinson County",3,6,257,126,131
050,26,043,"Michigan","Dickinson County",3,7,287,152,135
050,26,043,"Michigan","Dickinson County",3,8,300,159,141
050,26,043,"Michigan","Dickinson County",3,9,280,148,132
050,26,043,"Michigan","Dickinson County",3,10,283,140,143
050,26,043,"Michigan","Dickinson County",3,11,272,134,138
050,26,043,"Michigan","Dickinson County",3,12,293,151,142
050,26,043,"Michigan","Dickinson County",3,13,315,169,146
050,26,043,"Michigan","Dickinson County",3,14,327,176,151
050,26,043,"Michigan","Dickinson County",3,15,314,172,142
050,26,043,"Michigan","Dickinson County",3,16,313,164,149
050,26,043,"Michigan","Dickinson County",3,17,305,166,139
050,26,043,"Michigan","Dickinson County",3,18,270,151,119
050,26,043,"Michigan","Dickinson County",3,19,221,108,113
050,26,043,"Michigan","Dickinson County",3,20,236,121,115
050,26,043,"Michigan","Dickinson County",3,21,247,134,113
050,26,043,"Michigan","Dickinson County",3,22,262,139,123
050,26,043,"Michigan","Dickinson County",3,23,278,157,121
050,26,043,"Michigan","Dickinson County",3,24,268,142,126
050,26,043,"Michigan","Dickinson County",3,25,258,138,120
050,26,043,"Michigan","Dickinson County",3,26,278,154,124
050,26,043,"Michigan","Dickinson County",3,27,274,148,126
050,26,043,"Michigan","Dickinson County",3,28,278,148,130
050,26,043,"Michigan","Dickinson County",3,29,274,129,145
050,26,043,"Michigan","Dickinson County",3,30,269,140,129
050,26,043,"Michigan","Dickinson County",3,31,286,146,140
050,26,043,"Michigan","Dickinson County",3,32,260,142,118
050,26,043,"Michigan","Dickinson County",3,33,252,135,117
050,26,043,"Michigan","Dickinson County",3,34,286,151,135
050,26,043,"Michigan","Dickinson County",3,35,300,150,150
050,26,043,"Michigan","Dickinson County",3,36,311,159,152
050,26,043,"Michigan","Dickinson County",3,37,296,158,138
050,26,043,"Michigan","Dickinson County",3,38,298,153,145
050,26,043,"Michigan","Dickinson County",3,39,321,159,162
050,26,043,"Michigan","Dickinson County",3,40,326,168,158
050,26,043,"Michigan","Dickinson County",3,41,313,149,164
050,26,043,"Michigan","Dickinson County",3,42,262,129,133
050,26,043,"Michigan","Dickinson County",3,43,268,132,136
050,26,043,"Michigan","Dickinson County",3,44,267,136,131
050,26,043,"Michigan","Dickinson County",3,45,254,134,120
050,26,043,"Michigan","Dickinson County",3,46,258,135,123
050,26,043,"Michigan","Dickinson County",3,47,266,139,127
050,26,043,"Michigan","Dickinson County",3,48,273,137,136
050,26,043,"Michigan","Dickinson County",3,49,293,142,151
050,26,043,"Michigan","Dickinson County",3,50,317,152,165
050,26,043,"Michigan","Dickinson County",3,51,306,156,150
050,26,043,"Michigan","Dickinson County",3,52,305,156,149
050,26,043,"Michigan","Dickinson County",3,53,322,171,151
050,26,043,"Michigan","Dickinson County",3,54,362,191,171
050,26,043,"Michigan","Dickinson County",3,55,364,187,177
050,26,043,"Michigan","Dickinson County",3,56,385,201,184
050,26,043,"Michigan","Dickinson County",3,57,414,215,199
050,26,043,"Michigan","Dickinson County",3,58,407,211,196
050,26,043,"Michigan","Dickinson County",3,59,402,195,207
050,26,043,"Michigan","Dickinson County",3,60,432,205,227
050,26,043,"Michigan","Dickinson County",3,61,429,208,221
050,26,043,"Michigan","Dickinson County",3,62,434,213,221
050,26,043,"Michigan","Dickinson County",3,63,443,227,216
050,26,043,"Michigan","Dickinson County",3,64,465,233,232
050,26,043,"Michigan","Dickinson County",3,65,449,226,223
050,26,043,"Michigan","Dickinson County",3,66,435,222,213
050,26,043,"Michigan","Dickinson County",3,67,397,196,201
050,26,043,"Michigan","Dickinson County",3,68,380,192,188
050,26,043,"Michigan","Dickinson County",3,69,357,187,170
050,26,043,"Michigan","Dickinson County",3,70,322,166,156
050,26,043,"Michigan","Dickinson County",3,71,302,153,149
050,26,043,"Michigan","Dickinson County",3,72,310,164,146
050,26,043,"Michigan","Dickinson County",3,73,328,164,164
050,26,043,"Michigan","Dickinson County",3,74,350,180,170
050,26,043,"Michigan","Dickinson County",3,75,211,104,107
050,26,043,"Michigan","Dickinson County",3,76,197,99,98
050,26,043,"Michigan","Dickinson County",3,77,197,91,106
050,26,043,"Michigan","Dickinson County",3,78,205,93,112
050,26,043,"Michigan","Dickinson County",3,79,177,78,99
050,26,043,"Michigan","Dickinson County",3,80,169,76,93
050,26,043,"Michigan","Dickinson County",3,81,167,73,94
050,26,043,"Michigan","Dickinson County",3,82,137,63,74
050,26,043,"Michigan","Dickinson County",3,83,124,61,63
050,26,043,"Michigan","Dickinson County",3,84,108,51,57
050,26,043,"Michigan","Dickinson County",3,85,773,301,472
050,26,043,"Michigan","Dickinson County",4,0,230,112,118
050,26,043,"Michigan","Dickinson County",4,1,236,122,114
050,26,043,"Michigan","Dickinson County",4,2,249,137,112
050,26,043,"Michigan","Dickinson County",4,3,252,132,120
050,26,043,"Michigan","Dickinson County",4,4,285,153,132
050,26,043,"Michigan","Dickinson County",4,5,293,152,141
050,26,043,"Michigan","Dickinson County",4,6,318,160,158
050,26,043,"Michigan","Dickinson County",4,7,266,133,133
050,26,043,"Michigan","Dickinson County",4,8,296,160,136
050,26,043,"Michigan","Dickinson County",4,9,307,162,145
050,26,043,"Michigan","Dickinson County",4,10,302,158,144
050,26,043,"Michigan","Dickinson County",4,11,284,142,142
050,26,043,"Michigan","Dickinson County",4,12,270,134,136
050,26,043,"Michigan","Dickinson County",4,13,300,151,149
050,26,043,"Michigan","Dickinson County",4,14,317,171,146
050,26,043,"Michigan","Dickinson County",4,15,326,176,150
050,26,043,"Michigan","Dickinson County",4,16,321,173,148
050,26,043,"Michigan","Dickinson County",4,17,318,169,149
050,26,043,"Michigan","Dickinson County",4,18,260,146,114
050,26,043,"Michigan","Dickinson County",4,19,215,116,99
050,26,043,"Michigan","Dickinson County",4,20,223,114,109
050,26,043,"Michigan","Dickinson County",4,21,244,128,116
050,26,043,"Michigan","Dickinson County",4,22,269,135,134
050,26,043,"Michigan","Dickinson County",4,23,278,151,127
050,26,043,"Michigan","Dickinson County",4,24,273,156,117
050,26,043,"Michigan","Dickinson County",4,25,260,139,121
050,26,043,"Michigan","Dickinson County",4,26,251,136,115
050,26,043,"Michigan","Dickinson County",4,27,273,152,121
050,26,043,"Michigan","Dickinson County",4,28,280,150,130
050,26,043,"Michigan","Dickinson County",4,29,288,145,143
050,26,043,"Michigan","Dickinson County",4,30,282,132,150
050,26,043,"Michigan","Dickinson County",4,31,280,144,136
050,26,043,"Michigan","Dickinson County",4,32,289,147,142
050,26,043,"Michigan","Dickinson County",4,33,266,146,120
050,26,043,"Michigan","Dickinson County",4,34,263,144,119
050,26,043,"Michigan","Dickinson County",4,35,283,154,129
050,26,043,"Michigan","Dickinson County",4,36,322,157,165
050,26,043,"Michigan","Dickinson County",4,37,316,159,157
050,26,043,"Michigan","Dickinson County",4,38,303,158,145
050,26,043,"Michigan","Dickinson County",4,39,298,157,141
050,26,043,"Michigan","Dickinson County",4,40,328,163,165
050,26,043,"Michigan","Dickinson County",4,41,330,171,159
050,26,043,"Michigan","Dickinson County",4,42,319,152,167
050,26,043,"Michigan","Dickinson County",4,43,259,124,135
050,26,043,"Michigan","Dickinson County",4,44,284,138,146
050,26,043,"Michigan","Dickinson County",4,45,273,142,131
050,26,043,"Michigan","Dickinson County",4,46,269,141,128
050,26,043,"Michigan","Dickinson County",4,47,257,135,122
050,26,043,"Michigan","Dickinson County",4,48,276,141,135
050,26,043,"Michigan","Dickinson County",4,49,279,141,138
050,26,043,"Michigan","Dickinson County",4,50,296,146,150
050,26,043,"Michigan","Dickinson County",4,51,323,153,170
050,26,043,"Michigan","Dickinson County",4,52,296,153,143
050,26,043,"Michigan","Dickinson County",4,53,307,149,158
050,26,043,"Michigan","Dickinson County",4,54,318,166,152
050,26,043,"Michigan","Dickinson County",4,55,371,195,176
050,26,043,"Michigan","Dickinson County",4,56,369,192,177
050,26,043,"Michigan","Dickinson County",4,57,377,199,178
050,26,043,"Michigan","Dickinson County",4,58,414,214,200
050,26,043,"Michigan","Dickinson County",4,59,399,210,189
050,26,043,"Michigan","Dickinson County",4,60,401,191,210
050,26,043,"Michigan","Dickinson County",4,61,420,201,219
050,26,043,"Michigan","Dickinson County",4,62,425,201,224
050,26,043,"Michigan","Dickinson County",4,63,428,212,216
050,26,043,"Michigan","Dickinson County",4,64,436,222,214
050,26,043,"Michigan","Dickinson County",4,65,452,225,227
050,26,043,"Michigan","Dickinson County",4,66,452,225,227
050,26,043,"Michigan","Dickinson County",4,67,431,223,208
050,26,043,"Michigan","Dickinson County",4,68,396,195,201
050,26,043,"Michigan","Dickinson County",4,69,375,194,181
050,26,043,"Michigan","Dickinson County",4,70,355,187,168
050,26,043,"Michigan","Dickinson County",4,71,316,159,157
050,26,043,"Michigan","Dickinson County",4,72,289,145,144
050,26,043,"Michigan","Dickinson County",4,73,304,157,147
050,26,043,"Michigan","Dickinson County",4,74,320,158,162
050,26,043,"Michigan","Dickinson County",4,75,336,169,167
050,26,043,"Michigan","Dickinson County",4,76,205,104,101
050,26,043,"Michigan","Dickinson County",4,77,186,92,94
050,26,043,"Michigan","Dickinson County",4,78,193,87,106
050,26,043,"Michigan","Dickinson County",4,79,188,86,102
050,26,043,"Michigan","Dickinson County",4,80,171,73,98
050,26,043,"Michigan","Dickinson County",4,81,164,70,94
050,26,043,"Michigan","Dickinson County",4,82,151,68,83
050,26,043,"Michigan","Dickinson County",4,83,131,60,71
050,26,043,"Michigan","Dickinson County",4,84,114,57,57
050,26,043,"Michigan","Dickinson County",4,85,774,313,461
050,26,043,"Michigan","Dickinson County",5,0,207,100,107
050,26,043,"Michigan","Dickinson County",5,1,261,126,135
050,26,043,"Michigan","Dickinson County",5,2,234,118,116
050,26,043,"Michigan","Dickinson County",5,3,257,136,121
050,26,043,"Michigan","Dickinson County",5,4,263,139,124
050,26,043,"Michigan","Dickinson County",5,5,279,151,128
050,26,043,"Michigan","Dickinson County",5,6,296,153,143
050,26,043,"Michigan","Dickinson County",5,7,316,160,156
050,26,043,"Michigan","Dickinson County",5,8,265,135,130
050,26,043,"Michigan","Dickinson County",5,9,306,169,137
050,26,043,"Michigan","Dickinson County",5,10,311,163,148
050,26,043,"Michigan","Dickinson County",5,11,301,154,147
050,26,043,"Michigan","Dickinson County",5,12,290,142,148
050,26,043,"Michigan","Dickinson County",5,13,285,144,141
050,26,043,"Michigan","Dickinson County",5,14,303,150,153
050,26,043,"Michigan","Dickinson County",5,15,319,176,143
050,26,043,"Michigan","Dickinson County",5,16,332,180,152
050,26,043,"Michigan","Dickinson County",5,17,315,172,143
050,26,043,"Michigan","Dickinson County",5,18,258,137,121
050,26,043,"Michigan","Dickinson County",5,19,201,107,94
050,26,043,"Michigan","Dickinson County",5,20,223,123,100
050,26,043,"Michigan","Dickinson County",5,21,225,119,106
050,26,043,"Michigan","Dickinson County",5,22,272,135,137
050,26,043,"Michigan","Dickinson County",5,23,268,140,128
050,26,043,"Michigan","Dickinson County",5,24,286,156,130
050,26,043,"Michigan","Dickinson County",5,25,269,152,117
050,26,043,"Michigan","Dickinson County",5,26,272,146,126
050,26,043,"Michigan","Dickinson County",5,27,249,131,118
050,26,043,"Michigan","Dickinson County",5,28,275,149,126
050,26,043,"Michigan","Dickinson County",5,29,280,144,136
050,26,043,"Michigan","Dickinson County",5,30,297,152,145
050,26,043,"Michigan","Dickinson County",5,31,290,139,151
050,26,043,"Michigan","Dickinson County",5,32,273,142,131
050,26,043,"Michigan","Dickinson County",5,33,294,151,143
050,26,043,"Michigan","Dickinson County",5,34,272,155,117
050,26,043,"Michigan","Dickinson County",5,35,273,146,127
050,26,043,"Michigan","Dickinson County",5,36,288,155,133
050,26,043,"Michigan","Dickinson County",5,37,327,158,169
050,26,043,"Michigan","Dickinson County",5,38,325,158,167
050,26,043,"Michigan","Dickinson County",5,39,311,162,149
050,26,043,"Michigan","Dickinson County",5,40,312,164,148
050,26,043,"Michigan","Dickinson County",5,41,319,157,162
050,26,043,"Michigan","Dickinson County",5,42,340,178,162
050,26,043,"Michigan","Dickinson County",5,43,328,158,170
050,26,043,"Michigan","Dickinson County",5,44,264,125,139
050,26,043,"Michigan","Dickinson County",5,45,280,140,140
050,26,043,"Michigan","Dickinson County",5,46,270,142,128
050,26,043,"Michigan","Dickinson County",5,47,269,141,128
050,26,043,"Michigan","Dickinson County",5,48,256,132,124
050,26,043,"Michigan","Dickinson County",5,49,277,142,135
050,26,043,"Michigan","Dickinson County",5,50,281,140,141
050,26,043,"Michigan","Dickinson County",5,51,295,140,155
050,26,043,"Michigan","Dickinson County",5,52,314,151,163
050,26,043,"Michigan","Dickinson County",5,53,298,154,144
050,26,043,"Michigan","Dickinson County",5,54,308,151,157
050,26,043,"Michigan","Dickinson County",5,55,336,175,161
050,26,043,"Michigan","Dickinson County",5,56,382,208,174
050,26,043,"Michigan","Dickinson County",5,57,369,189,180
050,26,043,"Michigan","Dickinson County",5,58,374,200,174
050,26,043,"Michigan","Dickinson County",5,59,406,209,197
050,26,043,"Michigan","Dickinson County",5,60,404,207,197
050,26,043,"Michigan","Dickinson County",5,61,390,184,206
050,26,043,"Michigan","Dickinson County",5,62,408,193,215
050,26,043,"Michigan","Dickinson County",5,63,430,210,220
050,26,043,"Michigan","Dickinson County",5,64,424,208,216
050,26,043,"Michigan","Dickinson County",5,65,424,211,213
050,26,043,"Michigan","Dickinson County",5,66,454,225,229
050,26,043,"Michigan","Dickinson County",5,67,438,218,220
050,26,043,"Michigan","Dickinson County",5,68,425,218,207
050,26,043,"Michigan","Dickinson County",5,69,388,197,191
050,26,043,"Michigan","Dickinson County",5,70,377,196,181
050,26,043,"Michigan","Dickinson County",5,71,353,181,172
050,26,043,"Michigan","Dickinson County",5,72,307,152,155
050,26,043,"Michigan","Dickinson County",5,73,278,134,144
050,26,043,"Michigan","Dickinson County",5,74,299,154,145
050,26,043,"Michigan","Dickinson County",5,75,314,155,159
050,26,043,"Michigan","Dickinson County",5,76,320,166,154
050,26,043,"Michigan","Dickinson County",5,77,194,95,99
050,26,043,"Michigan","Dickinson County",5,78,184,88,96
050,26,043,"Michigan","Dickinson County",5,79,174,78,96
050,26,043,"Michigan","Dickinson County",5,80,184,82,102
050,26,043,"Michigan","Dickinson County",5,81,168,65,103
050,26,043,"Michigan","Dickinson County",5,82,148,64,84
050,26,043,"Michigan","Dickinson County",5,83,146,68,78
050,26,043,"Michigan","Dickinson County",5,84,124,55,69
050,26,043,"Michigan","Dickinson County",5,85,781,324,457
050,26,045,"Michigan","Eaton County",1,0,1062,537,525
050,26,045,"Michigan","Eaton County",1,1,1080,531,549
050,26,045,"Michigan","Eaton County",1,2,1182,615,567
050,26,045,"Michigan","Eaton County",1,3,1208,636,572
050,26,045,"Michigan","Eaton County",1,4,1207,643,564
050,26,045,"Michigan","Eaton County",1,5,1244,637,607
050,26,045,"Michigan","Eaton County",1,6,1253,631,622
050,26,045,"Michigan","Eaton County",1,7,1253,656,597
050,26,045,"Michigan","Eaton County",1,8,1297,672,625
050,26,045,"Michigan","Eaton County",1,9,1295,656,639
050,26,045,"Michigan","Eaton County",1,10,1290,650,640
050,26,045,"Michigan","Eaton County",1,11,1296,650,646
050,26,045,"Michigan","Eaton County",1,12,1334,670,664
050,26,045,"Michigan","Eaton County",1,13,1269,631,638
050,26,045,"Michigan","Eaton County",1,14,1309,660,649
050,26,045,"Michigan","Eaton County",1,15,1350,723,627
050,26,045,"Michigan","Eaton County",1,16,1399,731,668
050,26,045,"Michigan","Eaton County",1,17,1424,726,698
050,26,045,"Michigan","Eaton County",1,18,1311,695,616
050,26,045,"Michigan","Eaton County",1,19,1238,646,592
050,26,045,"Michigan","Eaton County",1,20,1272,677,595
050,26,045,"Michigan","Eaton County",1,21,1214,650,564
050,26,045,"Michigan","Eaton County",1,22,1315,653,662
050,26,045,"Michigan","Eaton County",1,23,1388,654,734
050,26,045,"Michigan","Eaton County",1,24,1409,693,716
050,26,045,"Michigan","Eaton County",1,25,1378,722,656
050,26,045,"Michigan","Eaton County",1,26,1362,708,654
050,26,045,"Michigan","Eaton County",1,27,1420,721,699
050,26,045,"Michigan","Eaton County",1,28,1454,732,722
050,26,045,"Michigan","Eaton County",1,29,1456,759,697
050,26,045,"Michigan","Eaton County",1,30,1389,687,702
050,26,045,"Michigan","Eaton County",1,31,1359,660,699
050,26,045,"Michigan","Eaton County",1,32,1369,682,687
050,26,045,"Michigan","Eaton County",1,33,1357,690,667
050,26,045,"Michigan","Eaton County",1,34,1447,761,686
050,26,045,"Michigan","Eaton County",1,35,1398,729,669
050,26,045,"Michigan","Eaton County",1,36,1411,725,686
050,26,045,"Michigan","Eaton County",1,37,1362,690,672
050,26,045,"Michigan","Eaton County",1,38,1374,691,683
050,26,045,"Michigan","Eaton County",1,39,1415,690,725
050,26,045,"Michigan","Eaton County",1,40,1357,679,678
050,26,045,"Michigan","Eaton County",1,41,1297,666,631
050,26,045,"Michigan","Eaton County",1,42,1367,696,671
050,26,045,"Michigan","Eaton County",1,43,1261,627,634
050,26,045,"Michigan","Eaton County",1,44,1177,595,582
050,26,045,"Michigan","Eaton County",1,45,1170,577,593
050,26,045,"Michigan","Eaton County",1,46,1180,575,605
050,26,045,"Michigan","Eaton County",1,47,1234,608,626
050,26,045,"Michigan","Eaton County",1,48,1297,650,647
050,26,045,"Michigan","Eaton County",1,49,1387,690,697
050,26,045,"Michigan","Eaton County",1,50,1361,684,677
050,26,045,"Michigan","Eaton County",1,51,1380,695,685
050,26,045,"Michigan","Eaton County",1,52,1403,669,734
050,26,045,"Michigan","Eaton County",1,53,1412,683,729
050,26,045,"Michigan","Eaton County",1,54,1437,681,756
050,26,045,"Michigan","Eaton County",1,55,1525,695,830
050,26,045,"Michigan","Eaton County",1,56,1567,769,798
050,26,045,"Michigan","Eaton County",1,57,1576,773,803
050,26,045,"Michigan","Eaton County",1,58,1612,796,816
050,26,045,"Michigan","Eaton County",1,59,1618,784,834
050,26,045,"Michigan","Eaton County",1,60,1618,795,823
050,26,045,"Michigan","Eaton County",1,61,1634,802,832
050,26,045,"Michigan","Eaton County",1,62,1619,775,844
050,26,045,"Michigan","Eaton County",1,63,1538,748,790
050,26,045,"Michigan","Eaton County",1,64,1514,751,763
050,26,045,"Michigan","Eaton County",1,65,1461,716,745
050,26,045,"Michigan","Eaton County",1,66,1410,673,737
050,26,045,"Michigan","Eaton County",1,67,1374,676,698
050,26,045,"Michigan","Eaton County",1,68,1410,681,729
050,26,045,"Michigan","Eaton County",1,69,1300,630,670
050,26,045,"Michigan","Eaton County",1,70,1210,591,619
050,26,045,"Michigan","Eaton County",1,71,1212,568,644
050,26,045,"Michigan","Eaton County",1,72,1234,587,647
050,26,045,"Michigan","Eaton County",1,73,1210,578,632
050,26,045,"Michigan","Eaton County",1,74,842,385,457
050,26,045,"Michigan","Eaton County",1,75,850,398,452
050,26,045,"Michigan","Eaton County",1,76,877,412,465
050,26,045,"Michigan","Eaton County",1,77,812,370,442
050,26,045,"Michigan","Eaton County",1,78,688,294,394
050,26,045,"Michigan","Eaton County",1,79,579,265,314
050,26,045,"Michigan","Eaton County",1,80,486,215,271
050,26,045,"Michigan","Eaton County",1,81,493,214,279
050,26,045,"Michigan","Eaton County",1,82,452,194,258
050,26,045,"Michigan","Eaton County",1,83,400,158,242
050,26,045,"Michigan","Eaton County",1,84,373,159,214
050,26,045,"Michigan","Eaton County",1,85,2101,765,1336
050,26,045,"Michigan","Eaton County",2,0,1079,551,528
050,26,045,"Michigan","Eaton County",2,1,1080,537,543
050,26,045,"Michigan","Eaton County",2,2,1169,602,567
050,26,045,"Michigan","Eaton County",2,3,1200,633,567
050,26,045,"Michigan","Eaton County",2,4,1213,643,570
050,26,045,"Michigan","Eaton County",2,5,1241,641,600
050,26,045,"Michigan","Eaton County",2,6,1258,638,620
050,26,045,"Michigan","Eaton County",2,7,1256,655,601
050,26,045,"Michigan","Eaton County",2,8,1282,664,618
050,26,045,"Michigan","Eaton County",2,9,1298,659,639
050,26,045,"Michigan","Eaton County",2,10,1290,650,640
050,26,045,"Michigan","Eaton County",2,11,1290,646,644
050,26,045,"Michigan","Eaton County",2,12,1327,665,662
050,26,045,"Michigan","Eaton County",2,13,1284,640,644
050,26,045,"Michigan","Eaton County",2,14,1296,652,644
050,26,045,"Michigan","Eaton County",2,15,1337,708,629
050,26,045,"Michigan","Eaton County",2,16,1390,732,658
050,26,045,"Michigan","Eaton County",2,17,1410,725,685
050,26,045,"Michigan","Eaton County",2,18,1297,679,618
050,26,045,"Michigan","Eaton County",2,19,1233,646,587
050,26,045,"Michigan","Eaton County",2,20,1278,681,597
050,26,045,"Michigan","Eaton County",2,21,1228,650,578
050,26,045,"Michigan","Eaton County",2,22,1295,650,645
050,26,045,"Michigan","Eaton County",2,23,1381,657,724
050,26,045,"Michigan","Eaton County",2,24,1403,687,716
050,26,045,"Michigan","Eaton County",2,25,1387,715,672
050,26,045,"Michigan","Eaton County",2,26,1369,709,660
050,26,045,"Michigan","Eaton County",2,27,1409,718,691
050,26,045,"Michigan","Eaton County",2,28,1453,735,718
050,26,045,"Michigan","Eaton County",2,29,1456,749,707
050,26,045,"Michigan","Eaton County",2,30,1423,708,715
050,26,045,"Michigan","Eaton County",2,31,1362,662,700
050,26,045,"Michigan","Eaton County",2,32,1359,673,686
050,26,045,"Michigan","Eaton County",2,33,1357,689,668
050,26,045,"Michigan","Eaton County",2,34,1420,742,678
050,26,045,"Michigan","Eaton County",2,35,1420,745,675
050,26,045,"Michigan","Eaton County",2,36,1400,725,675
050,26,045,"Michigan","Eaton County",2,37,1377,699,678
050,26,045,"Michigan","Eaton County",2,38,1375,690,685
050,26,045,"Michigan","Eaton County",2,39,1401,689,712
050,26,045,"Michigan","Eaton County",2,40,1375,686,689
050,26,045,"Michigan","Eaton County",2,41,1314,671,643
050,26,045,"Michigan","Eaton County",2,42,1343,685,658
050,26,045,"Michigan","Eaton County",2,43,1292,649,643
050,26,045,"Michigan","Eaton County",2,44,1189,600,589
050,26,045,"Michigan","Eaton County",2,45,1185,589,596
050,26,045,"Michigan","Eaton County",2,46,1177,575,602
050,26,045,"Michigan","Eaton County",2,47,1222,602,620
050,26,045,"Michigan","Eaton County",2,48,1280,639,641
050,26,045,"Michigan","Eaton County",2,49,1370,682,688
050,26,045,"Michigan","Eaton County",2,50,1365,683,682
050,26,045,"Michigan","Eaton County",2,51,1373,691,682
050,26,045,"Michigan","Eaton County",2,52,1386,671,715
050,26,045,"Michigan","Eaton County",2,53,1407,678,729
050,26,045,"Michigan","Eaton County",2,54,1427,678,749
050,26,045,"Michigan","Eaton County",2,55,1505,691,814
050,26,045,"Michigan","Eaton County",2,56,1561,752,809
050,26,045,"Michigan","Eaton County",2,57,1574,774,800
050,26,045,"Michigan","Eaton County",2,58,1599,791,808
050,26,045,"Michigan","Eaton County",2,59,1618,788,830
050,26,045,"Michigan","Eaton County",2,60,1608,789,819
050,26,045,"Michigan","Eaton County",2,61,1623,795,828
050,26,045,"Michigan","Eaton County",2,62,1612,774,838
050,26,045,"Michigan","Eaton County",2,63,1569,759,810
050,26,045,"Michigan","Eaton County",2,64,1506,740,766
050,26,045,"Michigan","Eaton County",2,65,1475,726,749
050,26,045,"Michigan","Eaton County",2,66,1417,677,740
050,26,045,"Michigan","Eaton County",2,67,1371,667,704
050,26,045,"Michigan","Eaton County",2,68,1380,668,712
050,26,045,"Michigan","Eaton County",2,69,1331,642,689
050,26,045,"Michigan","Eaton County",2,70,1225,600,625
050,26,045,"Michigan","Eaton County",2,71,1209,569,640
050,26,045,"Michigan","Eaton County",2,72,1204,570,634
050,26,045,"Michigan","Eaton County",2,73,1271,607,664
050,26,045,"Michigan","Eaton County",2,74,873,401,472
050,26,045,"Michigan","Eaton County",2,75,847,394,453
050,26,045,"Michigan","Eaton County",2,76,849,398,451
050,26,045,"Michigan","Eaton County",2,77,839,385,454
050,26,045,"Michigan","Eaton County",2,78,697,302,395
050,26,045,"Michigan","Eaton County",2,79,598,272,326
050,26,045,"Michigan","Eaton County",2,80,498,223,275
050,26,045,"Michigan","Eaton County",2,81,491,212,279
050,26,045,"Michigan","Eaton County",2,82,455,195,260
050,26,045,"Michigan","Eaton County",2,83,402,159,243
050,26,045,"Michigan","Eaton County",2,84,369,157,212
050,26,045,"Michigan","Eaton County",2,85,2111,767,1344
050,26,045,"Michigan","Eaton County",3,0,1059,530,529
050,26,045,"Michigan","Eaton County",3,1,1120,555,565
050,26,045,"Michigan","Eaton County",3,2,1091,538,553
050,26,045,"Michigan","Eaton County",3,3,1197,616,581
050,26,045,"Michigan","Eaton County",3,4,1205,656,549
050,26,045,"Michigan","Eaton County",3,5,1223,644,579
050,26,045,"Michigan","Eaton County",3,6,1260,646,614
050,26,045,"Michigan","Eaton County",3,7,1251,636,615
050,26,045,"Michigan","Eaton County",3,8,1246,640,606
050,26,045,"Michigan","Eaton County",3,9,1290,669,621
050,26,045,"Michigan","Eaton County",3,10,1275,643,632
050,26,045,"Michigan","Eaton County",3,11,1259,642,617
050,26,045,"Michigan","Eaton County",3,12,1312,665,647
050,26,045,"Michigan","Eaton County",3,13,1326,667,659
050,26,045,"Michigan","Eaton County",3,14,1304,641,663
050,26,045,"Michigan","Eaton County",3,15,1305,661,644
050,26,045,"Michigan","Eaton County",3,16,1348,722,626
050,26,045,"Michigan","Eaton County",3,17,1377,713,664
050,26,045,"Michigan","Eaton County",3,18,1277,653,624
050,26,045,"Michigan","Eaton County",3,19,1181,616,565
050,26,045,"Michigan","Eaton County",3,20,1259,655,604
050,26,045,"Michigan","Eaton County",3,21,1239,644,595
050,26,045,"Michigan","Eaton County",3,22,1248,647,601
050,26,045,"Michigan","Eaton County",3,23,1284,644,640
050,26,045,"Michigan","Eaton County",3,24,1414,699,715
050,26,045,"Michigan","Eaton County",3,25,1394,680,714
050,26,045,"Michigan","Eaton County",3,26,1380,706,674
050,26,045,"Michigan","Eaton County",3,27,1360,697,663
050,26,045,"Michigan","Eaton County",3,28,1397,695,702
050,26,045,"Michigan","Eaton County",3,29,1467,743,724
050,26,045,"Michigan","Eaton County",3,30,1478,753,725
050,26,045,"Michigan","Eaton County",3,31,1424,714,710
050,26,045,"Michigan","Eaton County",3,32,1369,682,687
050,26,045,"Michigan","Eaton County",3,33,1345,677,668
050,26,045,"Michigan","Eaton County",3,34,1400,716,684
050,26,045,"Michigan","Eaton County",3,35,1438,762,676
050,26,045,"Michigan","Eaton County",3,36,1429,749,680
050,26,045,"Michigan","Eaton County",3,37,1383,704,679
050,26,045,"Michigan","Eaton County",3,38,1365,680,685
050,26,045,"Michigan","Eaton County",3,39,1373,683,690
050,26,045,"Michigan","Eaton County",3,40,1438,708,730
050,26,045,"Michigan","Eaton County",3,41,1358,693,665
050,26,045,"Michigan","Eaton County",3,42,1299,666,633
050,26,045,"Michigan","Eaton County",3,43,1350,683,667
050,26,045,"Michigan","Eaton County",3,44,1296,661,635
050,26,045,"Michigan","Eaton County",3,45,1202,607,595
050,26,045,"Michigan","Eaton County",3,46,1195,595,600
050,26,045,"Michigan","Eaton County",3,47,1209,603,606
050,26,045,"Michigan","Eaton County",3,48,1207,595,612
050,26,045,"Michigan","Eaton County",3,49,1282,642,640
050,26,045,"Michigan","Eaton County",3,50,1369,692,677
050,26,045,"Michigan","Eaton County",3,51,1379,694,685
050,26,045,"Michigan","Eaton County",3,52,1382,693,689
050,26,045,"Michigan","Eaton County",3,53,1344,656,688
050,26,045,"Michigan","Eaton County",3,54,1407,676,731
050,26,045,"Michigan","Eaton County",3,55,1409,674,735
050,26,045,"Michigan","Eaton County",3,56,1488,687,801
050,26,045,"Michigan","Eaton County",3,57,1547,748,799
050,26,045,"Michigan","Eaton County",3,58,1568,774,794
050,26,045,"Michigan","Eaton County",3,59,1587,776,811
050,26,045,"Michigan","Eaton County",3,60,1578,773,805
050,26,045,"Michigan","Eaton County",3,61,1610,784,826
050,26,045,"Michigan","Eaton County",3,62,1596,780,816
050,26,045,"Michigan","Eaton County",3,63,1585,753,832
050,26,045,"Michigan","Eaton County",3,64,1548,742,806
050,26,045,"Michigan","Eaton County",3,65,1464,717,747
050,26,045,"Michigan","Eaton County",3,66,1436,701,735
050,26,045,"Michigan","Eaton County",3,67,1380,656,724
050,26,045,"Michigan","Eaton County",3,68,1335,638,697
050,26,045,"Michigan","Eaton County",3,69,1353,648,705
050,26,045,"Michigan","Eaton County",3,70,1299,632,667
050,26,045,"Michigan","Eaton County",3,71,1207,583,624
050,26,045,"Michigan","Eaton County",3,72,1153,552,601
050,26,045,"Michigan","Eaton County",3,73,1179,566,613
050,26,045,"Michigan","Eaton County",3,74,1260,582,678
050,26,045,"Michigan","Eaton County",3,75,829,379,450
050,26,045,"Michigan","Eaton County",3,76,804,363,441
050,26,045,"Michigan","Eaton County",3,77,818,388,430
050,26,045,"Michigan","Eaton County",3,78,807,369,438
050,26,045,"Michigan","Eaton County",3,79,661,288,373
050,26,045,"Michigan","Eaton County",3,80,562,257,305
050,26,045,"Michigan","Eaton County",3,81,461,193,268
050,26,045,"Michigan","Eaton County",3,82,470,203,267
050,26,045,"Michigan","Eaton County",3,83,413,166,247
050,26,045,"Michigan","Eaton County",3,84,349,147,202
050,26,045,"Michigan","Eaton County",3,85,2083,772,1311
050,26,045,"Michigan","Eaton County",4,0,1102,526,576
050,26,045,"Michigan","Eaton County",4,1,1090,556,534
050,26,045,"Michigan","Eaton County",4,2,1117,556,561
050,26,045,"Michigan","Eaton County",4,3,1136,584,552
050,26,045,"Michigan","Eaton County",4,4,1214,618,596
050,26,045,"Michigan","Eaton County",4,5,1208,646,562
050,26,045,"Michigan","Eaton County",4,6,1213,646,567
050,26,045,"Michigan","Eaton County",4,7,1258,643,615
050,26,045,"Michigan","Eaton County",4,8,1289,655,634
050,26,045,"Michigan","Eaton County",4,9,1245,636,609
050,26,045,"Michigan","Eaton County",4,10,1272,662,610
050,26,045,"Michigan","Eaton County",4,11,1275,649,626
050,26,045,"Michigan","Eaton County",4,12,1275,646,629
050,26,045,"Michigan","Eaton County",4,13,1325,667,658
050,26,045,"Michigan","Eaton County",4,14,1337,668,669
050,26,045,"Michigan","Eaton County",4,15,1317,660,657
050,26,045,"Michigan","Eaton County",4,16,1321,676,645
050,26,045,"Michigan","Eaton County",4,17,1329,708,621
050,26,045,"Michigan","Eaton County",4,18,1262,660,602
050,26,045,"Michigan","Eaton County",4,19,1158,605,553
050,26,045,"Michigan","Eaton County",4,20,1209,644,565
050,26,045,"Michigan","Eaton County",4,21,1250,636,614
050,26,045,"Michigan","Eaton County",4,22,1274,671,603
050,26,045,"Michigan","Eaton County",4,23,1290,672,618
050,26,045,"Michigan","Eaton County",4,24,1327,702,625
050,26,045,"Michigan","Eaton County",4,25,1408,703,705
050,26,045,"Michigan","Eaton County",4,26,1369,661,708
050,26,045,"Michigan","Eaton County",4,27,1379,701,678
050,26,045,"Michigan","Eaton County",4,28,1403,725,678
050,26,045,"Michigan","Eaton County",4,29,1375,687,688
050,26,045,"Michigan","Eaton County",4,30,1459,730,729
050,26,045,"Michigan","Eaton County",4,31,1482,765,717
050,26,045,"Michigan","Eaton County",4,32,1411,701,710
050,26,045,"Michigan","Eaton County",4,33,1383,673,710
050,26,045,"Michigan","Eaton County",4,34,1336,666,670
050,26,045,"Michigan","Eaton County",4,35,1417,720,697
050,26,045,"Michigan","Eaton County",4,36,1465,768,697
050,26,045,"Michigan","Eaton County",4,37,1441,745,696
050,26,045,"Michigan","Eaton County",4,38,1403,709,694
050,26,045,"Michigan","Eaton County",4,39,1357,674,683
050,26,045,"Michigan","Eaton County",4,40,1362,677,685
050,26,045,"Michigan","Eaton County",4,41,1420,700,720
050,26,045,"Michigan","Eaton County",4,42,1364,704,660
050,26,045,"Michigan","Eaton County",4,43,1292,658,634
050,26,045,"Michigan","Eaton County",4,44,1366,690,676
050,26,045,"Michigan","Eaton County",4,45,1299,661,638
050,26,045,"Michigan","Eaton County",4,46,1205,609,596
050,26,045,"Michigan","Eaton County",4,47,1180,592,588
050,26,045,"Michigan","Eaton County",4,48,1199,586,613
050,26,045,"Michigan","Eaton County",4,49,1225,612,613
050,26,045,"Michigan","Eaton County",4,50,1304,653,651
050,26,045,"Michigan","Eaton County",4,51,1362,695,667
050,26,045,"Michigan","Eaton County",4,52,1347,666,681
050,26,045,"Michigan","Eaton County",4,53,1372,687,685
050,26,045,"Michigan","Eaton County",4,54,1336,646,690
050,26,045,"Michigan","Eaton County",4,55,1400,676,724
050,26,045,"Michigan","Eaton County",4,56,1418,684,734
050,26,045,"Michigan","Eaton County",4,57,1474,670,804
050,26,045,"Michigan","Eaton County",4,58,1530,745,785
050,26,045,"Michigan","Eaton County",4,59,1543,757,786
050,26,045,"Michigan","Eaton County",4,60,1565,760,805
050,26,045,"Michigan","Eaton County",4,61,1567,757,810
050,26,045,"Michigan","Eaton County",4,62,1578,766,812
050,26,045,"Michigan","Eaton County",4,63,1575,772,803
050,26,045,"Michigan","Eaton County",4,64,1582,740,842
050,26,045,"Michigan","Eaton County",4,65,1523,738,785
050,26,045,"Michigan","Eaton County",4,66,1425,696,729
050,26,045,"Michigan","Eaton County",4,67,1413,681,732
050,26,045,"Michigan","Eaton County",4,68,1358,643,715
050,26,045,"Michigan","Eaton County",4,69,1294,621,673
050,26,045,"Michigan","Eaton County",4,70,1302,616,686
050,26,045,"Michigan","Eaton County",4,71,1268,608,660
050,26,045,"Michigan","Eaton County",4,72,1144,558,586
050,26,045,"Michigan","Eaton County",4,73,1141,551,590
050,26,045,"Michigan","Eaton County",4,74,1155,537,618
050,26,045,"Michigan","Eaton County",4,75,1205,554,651
050,26,045,"Michigan","Eaton County",4,76,794,356,438
050,26,045,"Michigan","Eaton County",4,77,766,342,424
050,26,045,"Michigan","Eaton County",4,78,784,369,415
050,26,045,"Michigan","Eaton County",4,79,780,360,420
050,26,045,"Michigan","Eaton County",4,80,617,271,346
050,26,045,"Michigan","Eaton County",4,81,530,231,299
050,26,045,"Michigan","Eaton County",4,82,432,185,247
050,26,045,"Michigan","Eaton County",4,83,444,186,258
050,26,045,"Michigan","Eaton County",4,84,378,147,231
050,26,045,"Michigan","Eaton County",4,85,2055,772,1283
050,26,045,"Michigan","Eaton County",5,0,1075,514,561
050,26,045,"Michigan","Eaton County",5,1,1095,501,594
050,26,045,"Michigan","Eaton County",5,2,1101,553,548
050,26,045,"Michigan","Eaton County",5,3,1122,560,562
050,26,045,"Michigan","Eaton County",5,4,1141,580,561
050,26,045,"Michigan","Eaton County",5,5,1224,619,605
050,26,045,"Michigan","Eaton County",5,6,1232,651,581
050,26,045,"Michigan","Eaton County",5,7,1229,644,585
050,26,045,"Michigan","Eaton County",5,8,1271,647,624
050,26,045,"Michigan","Eaton County",5,9,1296,678,618
050,26,045,"Michigan","Eaton County",5,10,1276,650,626
050,26,045,"Michigan","Eaton County",5,11,1274,656,618
050,26,045,"Michigan","Eaton County",5,12,1307,666,641
050,26,045,"Michigan","Eaton County",5,13,1253,641,612
050,26,045,"Michigan","Eaton County",5,14,1373,686,687
050,26,045,"Michigan","Eaton County",5,15,1346,686,660
050,26,045,"Michigan","Eaton County",5,16,1300,659,641
050,26,045,"Michigan","Eaton County",5,17,1298,652,646
050,26,045,"Michigan","Eaton County",5,18,1201,646,555
050,26,045,"Michigan","Eaton County",5,19,1119,599,520
050,26,045,"Michigan","Eaton County",5,20,1167,615,552
050,26,045,"Michigan","Eaton County",5,21,1165,620,545
050,26,045,"Michigan","Eaton County",5,22,1253,623,630
050,26,045,"Michigan","Eaton County",5,23,1310,686,624
050,26,045,"Michigan","Eaton County",5,24,1331,712,619
050,26,045,"Michigan","Eaton County",5,25,1379,710,669
050,26,045,"Michigan","Eaton County",5,26,1365,669,696
050,26,045,"Michigan","Eaton County",5,27,1389,680,709
050,26,045,"Michigan","Eaton County",5,28,1404,735,669
050,26,045,"Michigan","Eaton County",5,29,1428,725,703
050,26,045,"Michigan","Eaton County",5,30,1359,688,671
050,26,045,"Michigan","Eaton County",5,31,1487,739,748
050,26,045,"Michigan","Eaton County",5,32,1490,764,726
050,26,045,"Michigan","Eaton County",5,33,1422,702,720
050,26,045,"Michigan","Eaton County",5,34,1393,677,716
050,26,045,"Michigan","Eaton County",5,35,1326,649,677
050,26,045,"Michigan","Eaton County",5,36,1401,723,678
050,26,045,"Michigan","Eaton County",5,37,1481,760,721
050,26,045,"Michigan","Eaton County",5,38,1467,771,696
050,26,045,"Michigan","Eaton County",5,39,1416,717,699
050,26,045,"Michigan","Eaton County",5,40,1362,688,674
050,26,045,"Michigan","Eaton County",5,41,1364,685,679
050,26,045,"Michigan","Eaton County",5,42,1419,709,710
050,26,045,"Michigan","Eaton County",5,43,1364,707,657
050,26,045,"Michigan","Eaton County",5,44,1292,667,625
050,26,045,"Michigan","Eaton County",5,45,1340,677,663
050,26,045,"Michigan","Eaton County",5,46,1295,655,640
050,26,045,"Michigan","Eaton County",5,47,1238,622,616
050,26,045,"Michigan","Eaton County",5,48,1143,575,568
050,26,045,"Michigan","Eaton County",5,49,1190,586,604
050,26,045,"Michigan","Eaton County",5,50,1205,603,602
050,26,045,"Michigan","Eaton County",5,51,1281,654,627
050,26,045,"Michigan","Eaton County",5,52,1352,684,668
050,26,045,"Michigan","Eaton County",5,53,1370,679,691
050,26,045,"Michigan","Eaton County",5,54,1375,691,684
050,26,045,"Michigan","Eaton County",5,55,1327,650,677
050,26,045,"Michigan","Eaton County",5,56,1396,681,715
050,26,045,"Michigan","Eaton County",5,57,1387,665,722
050,26,045,"Michigan","Eaton County",5,58,1462,665,797
050,26,045,"Michigan","Eaton County",5,59,1521,736,785
050,26,045,"Michigan","Eaton County",5,60,1546,764,782
050,26,045,"Michigan","Eaton County",5,61,1538,743,795
050,26,045,"Michigan","Eaton County",5,62,1550,755,795
050,26,045,"Michigan","Eaton County",5,63,1556,761,795
050,26,045,"Michigan","Eaton County",5,64,1554,748,806
050,26,045,"Michigan","Eaton County",5,65,1559,732,827
050,26,045,"Michigan","Eaton County",5,66,1497,713,784
050,26,045,"Michigan","Eaton County",5,67,1400,680,720
050,26,045,"Michigan","Eaton County",5,68,1389,664,725
050,26,045,"Michigan","Eaton County",5,69,1338,634,704
050,26,045,"Michigan","Eaton County",5,70,1247,586,661
050,26,045,"Michigan","Eaton County",5,71,1289,606,683
050,26,045,"Michigan","Eaton County",5,72,1242,598,644
050,26,045,"Michigan","Eaton County",5,73,1134,556,578
050,26,045,"Michigan","Eaton County",5,74,1141,534,607
050,26,045,"Michigan","Eaton County",5,75,1113,512,601
050,26,045,"Michigan","Eaton County",5,76,1150,522,628
050,26,045,"Michigan","Eaton County",5,77,756,343,413
050,26,045,"Michigan","Eaton County",5,78,739,328,411
050,26,045,"Michigan","Eaton County",5,79,742,353,389
050,26,045,"Michigan","Eaton County",5,80,737,342,395
050,26,045,"Michigan","Eaton County",5,81,576,245,331
050,26,045,"Michigan","Eaton County",5,82,506,227,279
050,26,045,"Michigan","Eaton County",5,83,400,163,237
050,26,045,"Michigan","Eaton County",5,84,395,166,229
050,26,045,"Michigan","Eaton County",5,85,2077,778,1299
050,26,047,"Michigan","Emmet County",1,0,284,148,136
050,26,047,"Michigan","Emmet County",1,1,287,154,133
050,26,047,"Michigan","Emmet County",1,2,282,160,122
050,26,047,"Michigan","Emmet County",1,3,320,157,163
050,26,047,"Michigan","Emmet County",1,4,349,178,171
050,26,047,"Michigan","Emmet County",1,5,332,176,156
050,26,047,"Michigan","Emmet County",1,6,339,167,172
050,26,047,"Michigan","Emmet County",1,7,320,163,157
050,26,047,"Michigan","Emmet County",1,8,347,181,166
050,26,047,"Michigan","Emmet County",1,9,359,183,176
050,26,047,"Michigan","Emmet County",1,10,369,195,174
050,26,047,"Michigan","Emmet County",1,11,387,201,186
050,26,047,"Michigan","Emmet County",1,12,421,225,196
050,26,047,"Michigan","Emmet County",1,13,395,225,170
050,26,047,"Michigan","Emmet County",1,14,400,217,183
050,26,047,"Michigan","Emmet County",1,15,402,208,194
050,26,047,"Michigan","Emmet County",1,16,430,205,225
050,26,047,"Michigan","Emmet County",1,17,415,215,200
050,26,047,"Michigan","Emmet County",1,18,393,213,180
050,26,047,"Michigan","Emmet County",1,19,337,173,164
050,26,047,"Michigan","Emmet County",1,20,358,184,174
050,26,047,"Michigan","Emmet County",1,21,371,203,168
050,26,047,"Michigan","Emmet County",1,22,357,195,162
050,26,047,"Michigan","Emmet County",1,23,364,179,185
050,26,047,"Michigan","Emmet County",1,24,377,202,175
050,26,047,"Michigan","Emmet County",1,25,404,211,193
050,26,047,"Michigan","Emmet County",1,26,384,179,205
050,26,047,"Michigan","Emmet County",1,27,381,190,191
050,26,047,"Michigan","Emmet County",1,28,358,179,179
050,26,047,"Michigan","Emmet County",1,29,359,183,176
050,26,047,"Michigan","Emmet County",1,30,397,209,188
050,26,047,"Michigan","Emmet County",1,31,382,203,179
050,26,047,"Michigan","Emmet County",1,32,377,191,186
050,26,047,"Michigan","Emmet County",1,33,375,182,193
050,26,047,"Michigan","Emmet County",1,34,384,192,192
050,26,047,"Michigan","Emmet County",1,35,386,194,192
050,26,047,"Michigan","Emmet County",1,36,395,191,204
050,26,047,"Michigan","Emmet County",1,37,371,178,193
050,26,047,"Michigan","Emmet County",1,38,373,162,211
050,26,047,"Michigan","Emmet County",1,39,371,188,183
050,26,047,"Michigan","Emmet County",1,40,397,211,186
050,26,047,"Michigan","Emmet County",1,41,395,196,199
050,26,047,"Michigan","Emmet County",1,42,352,165,187
050,26,047,"Michigan","Emmet County",1,43,374,182,192
050,26,047,"Michigan","Emmet County",1,44,394,184,210
050,26,047,"Michigan","Emmet County",1,45,396,194,202
050,26,047,"Michigan","Emmet County",1,46,364,195,169
050,26,047,"Michigan","Emmet County",1,47,348,178,170
050,26,047,"Michigan","Emmet County",1,48,426,223,203
050,26,047,"Michigan","Emmet County",1,49,464,253,211
050,26,047,"Michigan","Emmet County",1,50,409,215,194
050,26,047,"Michigan","Emmet County",1,51,413,211,202
050,26,047,"Michigan","Emmet County",1,52,430,212,218
050,26,047,"Michigan","Emmet County",1,53,442,221,221
050,26,047,"Michigan","Emmet County",1,54,445,209,236
050,26,047,"Michigan","Emmet County",1,55,466,228,238
050,26,047,"Michigan","Emmet County",1,56,471,232,239
050,26,047,"Michigan","Emmet County",1,57,475,232,243
050,26,047,"Michigan","Emmet County",1,58,542,273,269
050,26,047,"Michigan","Emmet County",1,59,574,285,289
050,26,047,"Michigan","Emmet County",1,60,578,279,299
050,26,047,"Michigan","Emmet County",1,61,584,280,304
050,26,047,"Michigan","Emmet County",1,62,599,270,329
050,26,047,"Michigan","Emmet County",1,63,589,274,315
050,26,047,"Michigan","Emmet County",1,64,567,278,289
050,26,047,"Michigan","Emmet County",1,65,581,287,294
050,26,047,"Michigan","Emmet County",1,66,558,287,271
050,26,047,"Michigan","Emmet County",1,67,548,264,284
050,26,047,"Michigan","Emmet County",1,68,537,256,281
050,26,047,"Michigan","Emmet County",1,69,493,241,252
050,26,047,"Michigan","Emmet County",1,70,498,250,248
050,26,047,"Michigan","Emmet County",1,71,473,232,241
050,26,047,"Michigan","Emmet County",1,72,446,227,219
050,26,047,"Michigan","Emmet County",1,73,457,224,233
050,26,047,"Michigan","Emmet County",1,74,309,144,165
050,26,047,"Michigan","Emmet County",1,75,284,131,153
050,26,047,"Michigan","Emmet County",1,76,281,139,142
050,26,047,"Michigan","Emmet County",1,77,317,172,145
050,26,047,"Michigan","Emmet County",1,78,255,135,120
050,26,047,"Michigan","Emmet County",1,79,205,101,104
050,26,047,"Michigan","Emmet County",1,80,204,91,113
050,26,047,"Michigan","Emmet County",1,81,202,95,107
050,26,047,"Michigan","Emmet County",1,82,170,78,92
050,26,047,"Michigan","Emmet County",1,83,155,68,87
050,26,047,"Michigan","Emmet County",1,84,161,76,85
050,26,047,"Michigan","Emmet County",1,85,791,276,515
050,26,047,"Michigan","Emmet County",2,0,289,151,138
050,26,047,"Michigan","Emmet County",2,1,289,156,133
050,26,047,"Michigan","Emmet County",2,2,285,159,126
050,26,047,"Michigan","Emmet County",2,3,312,157,155
050,26,047,"Michigan","Emmet County",2,4,340,172,168
050,26,047,"Michigan","Emmet County",2,5,336,175,161
050,26,047,"Michigan","Emmet County",2,6,339,172,167
050,26,047,"Michigan","Emmet County",2,7,325,165,160
050,26,047,"Michigan","Emmet County",2,8,338,175,163
050,26,047,"Michigan","Emmet County",2,9,358,183,175
050,26,047,"Michigan","Emmet County",2,10,370,193,177
050,26,047,"Michigan","Emmet County",2,11,383,200,183
050,26,047,"Michigan","Emmet County",2,12,411,217,194
050,26,047,"Michigan","Emmet County",2,13,400,223,177
050,26,047,"Michigan","Emmet County",2,14,399,218,181
050,26,047,"Michigan","Emmet County",2,15,403,211,192
050,26,047,"Michigan","Emmet County",2,16,424,206,218
050,26,047,"Michigan","Emmet County",2,17,420,215,205
050,26,047,"Michigan","Emmet County",2,18,389,210,179
050,26,047,"Michigan","Emmet County",2,19,336,176,160
050,26,047,"Michigan","Emmet County",2,20,360,185,175
050,26,047,"Michigan","Emmet County",2,21,364,197,167
050,26,047,"Michigan","Emmet County",2,22,363,196,167
050,26,047,"Michigan","Emmet County",2,23,366,188,178
050,26,047,"Michigan","Emmet County",2,24,371,196,175
050,26,047,"Michigan","Emmet County",2,25,398,208,190
050,26,047,"Michigan","Emmet County",2,26,385,185,200
050,26,047,"Michigan","Emmet County",2,27,378,185,193
050,26,047,"Michigan","Emmet County",2,28,359,180,179
050,26,047,"Michigan","Emmet County",2,29,361,183,178
050,26,047,"Michigan","Emmet County",2,30,389,202,187
050,26,047,"Michigan","Emmet County",2,31,388,207,181
050,26,047,"Michigan","Emmet County",2,32,380,194,186
050,26,047,"Michigan","Emmet County",2,33,379,187,192
050,26,047,"Michigan","Emmet County",2,34,379,190,189
050,26,047,"Michigan","Emmet County",2,35,390,196,194
050,26,047,"Michigan","Emmet County",2,36,391,190,201
050,26,047,"Michigan","Emmet County",2,37,381,183,198
050,26,047,"Michigan","Emmet County",2,38,377,169,208
050,26,047,"Michigan","Emmet County",2,39,372,182,190
050,26,047,"Michigan","Emmet County",2,40,395,207,188
050,26,047,"Michigan","Emmet County",2,41,394,199,195
050,26,047,"Michigan","Emmet County",2,42,361,172,189
050,26,047,"Michigan","Emmet County",2,43,374,180,194
050,26,047,"Michigan","Emmet County",2,44,385,180,205
050,26,047,"Michigan","Emmet County",2,45,398,192,206
050,26,047,"Michigan","Emmet County",2,46,373,194,179
050,26,047,"Michigan","Emmet County",2,47,352,182,170
050,26,047,"Michigan","Emmet County",2,48,407,212,195
050,26,047,"Michigan","Emmet County",2,49,456,246,210
050,26,047,"Michigan","Emmet County",2,50,422,224,198
050,26,047,"Michigan","Emmet County",2,51,409,210,199
050,26,047,"Michigan","Emmet County",2,52,425,210,215
050,26,047,"Michigan","Emmet County",2,53,437,218,219
050,26,047,"Michigan","Emmet County",2,54,445,214,231
050,26,047,"Michigan","Emmet County",2,55,462,224,238
050,26,047,"Michigan","Emmet County",2,56,472,232,240
050,26,047,"Michigan","Emmet County",2,57,476,232,244
050,26,047,"Michigan","Emmet County",2,58,525,263,262
050,26,047,"Michigan","Emmet County",2,59,569,283,286
050,26,047,"Michigan","Emmet County",2,60,578,282,296
050,26,047,"Michigan","Emmet County",2,61,582,280,302
050,26,047,"Michigan","Emmet County",2,62,596,272,324
050,26,047,"Michigan","Emmet County",2,63,596,276,320
050,26,047,"Michigan","Emmet County",2,64,570,275,295
050,26,047,"Michigan","Emmet County",2,65,577,284,293
050,26,047,"Michigan","Emmet County",2,66,563,287,276
050,26,047,"Michigan","Emmet County",2,67,548,269,279
050,26,047,"Michigan","Emmet County",2,68,533,253,280
050,26,047,"Michigan","Emmet County",2,69,502,244,258
050,26,047,"Michigan","Emmet County",2,70,494,246,248
050,26,047,"Michigan","Emmet County",2,71,479,237,242
050,26,047,"Michigan","Emmet County",2,72,446,224,222
050,26,047,"Michigan","Emmet County",2,73,477,236,241
050,26,047,"Michigan","Emmet County",2,74,319,152,167
050,26,047,"Michigan","Emmet County",2,75,292,134,158
050,26,047,"Michigan","Emmet County",2,76,277,135,142
050,26,047,"Michigan","Emmet County",2,77,311,163,148
050,26,047,"Michigan","Emmet County",2,78,265,141,124
050,26,047,"Michigan","Emmet County",2,79,215,107,108
050,26,047,"Michigan","Emmet County",2,80,200,92,108
050,26,047,"Michigan","Emmet County",2,81,199,91,108
050,26,047,"Michigan","Emmet County",2,82,176,82,94
050,26,047,"Michigan","Emmet County",2,83,155,69,86
050,26,047,"Michigan","Emmet County",2,84,157,72,85
050,26,047,"Michigan","Emmet County",2,85,792,281,511
050,26,047,"Michigan","Emmet County",3,0,263,127,136
050,26,047,"Michigan","Emmet County",3,1,298,154,144
050,26,047,"Michigan","Emmet County",3,2,295,159,136
050,26,047,"Michigan","Emmet County",3,3,296,157,139
050,26,047,"Michigan","Emmet County",3,4,318,161,157
050,26,047,"Michigan","Emmet County",3,5,344,169,175
050,26,047,"Michigan","Emmet County",3,6,342,179,163
050,26,047,"Michigan","Emmet County",3,7,347,172,175
050,26,047,"Michigan","Emmet County",3,8,336,168,168
050,26,047,"Michigan","Emmet County",3,9,343,174,169
050,26,047,"Michigan","Emmet County",3,10,365,188,177
050,26,047,"Michigan","Emmet County",3,11,376,201,175
050,26,047,"Michigan","Emmet County",3,12,386,208,178
050,26,047,"Michigan","Emmet County",3,13,421,221,200
050,26,047,"Michigan","Emmet County",3,14,399,217,182
050,26,047,"Michigan","Emmet County",3,15,396,216,180
050,26,047,"Michigan","Emmet County",3,16,395,203,192
050,26,047,"Michigan","Emmet County",3,17,441,218,223
050,26,047,"Michigan","Emmet County",3,18,397,211,186
050,26,047,"Michigan","Emmet County",3,19,310,168,142
050,26,047,"Michigan","Emmet County",3,20,353,182,171
050,26,047,"Michigan","Emmet County",3,21,348,181,167
050,26,047,"Michigan","Emmet County",3,22,403,210,193
050,26,047,"Michigan","Emmet County",3,23,389,214,175
050,26,047,"Michigan","Emmet County",3,24,351,180,171
050,26,047,"Michigan","Emmet County",3,25,368,195,173
050,26,047,"Michigan","Emmet County",3,26,380,193,187
050,26,047,"Michigan","Emmet County",3,27,367,178,189
050,26,047,"Michigan","Emmet County",3,28,366,184,182
050,26,047,"Michigan","Emmet County",3,29,368,195,173
050,26,047,"Michigan","Emmet County",3,30,372,187,185
050,26,047,"Michigan","Emmet County",3,31,426,225,201
050,26,047,"Michigan","Emmet County",3,32,401,211,190
050,26,047,"Michigan","Emmet County",3,33,382,194,188
050,26,047,"Michigan","Emmet County",3,34,375,183,192
050,26,047,"Michigan","Emmet County",3,35,401,199,202
050,26,047,"Michigan","Emmet County",3,36,395,202,193
050,26,047,"Michigan","Emmet County",3,37,415,198,217
050,26,047,"Michigan","Emmet County",3,38,390,190,200
050,26,047,"Michigan","Emmet County",3,39,397,183,214
050,26,047,"Michigan","Emmet County",3,40,371,178,193
050,26,047,"Michigan","Emmet County",3,41,415,222,193
050,26,047,"Michigan","Emmet County",3,42,384,188,196
050,26,047,"Michigan","Emmet County",3,43,368,176,192
050,26,047,"Michigan","Emmet County",3,44,380,179,201
050,26,047,"Michigan","Emmet County",3,45,383,182,201
050,26,047,"Michigan","Emmet County",3,46,402,196,206
050,26,047,"Michigan","Emmet County",3,47,368,193,175
050,26,047,"Michigan","Emmet County",3,48,354,184,170
050,26,047,"Michigan","Emmet County",3,49,407,215,192
050,26,047,"Michigan","Emmet County",3,50,473,262,211
050,26,047,"Michigan","Emmet County",3,51,424,230,194
050,26,047,"Michigan","Emmet County",3,52,407,204,203
050,26,047,"Michigan","Emmet County",3,53,425,208,217
050,26,047,"Michigan","Emmet County",3,54,435,216,219
050,26,047,"Michigan","Emmet County",3,55,446,208,238
050,26,047,"Michigan","Emmet County",3,56,475,229,246
050,26,047,"Michigan","Emmet County",3,57,472,230,242
050,26,047,"Michigan","Emmet County",3,58,473,228,245
050,26,047,"Michigan","Emmet County",3,59,533,263,270
050,26,047,"Michigan","Emmet County",3,60,580,289,291
050,26,047,"Michigan","Emmet County",3,61,578,285,293
050,26,047,"Michigan","Emmet County",3,62,592,284,308
050,26,047,"Michigan","Emmet County",3,63,603,278,325
050,26,047,"Michigan","Emmet County",3,64,601,277,324
050,26,047,"Michigan","Emmet County",3,65,587,283,304
050,26,047,"Michigan","Emmet County",3,66,573,284,289
050,26,047,"Michigan","Emmet County",3,67,561,288,273
050,26,047,"Michigan","Emmet County",3,68,550,269,281
050,26,047,"Michigan","Emmet County",3,69,522,248,274
050,26,047,"Michigan","Emmet County",3,70,506,248,258
050,26,047,"Michigan","Emmet County",3,71,492,248,244
050,26,047,"Michigan","Emmet County",3,72,470,226,244
050,26,047,"Michigan","Emmet County",3,73,427,215,212
050,26,047,"Michigan","Emmet County",3,74,464,228,236
050,26,047,"Michigan","Emmet County",3,75,306,139,167
050,26,047,"Michigan","Emmet County",3,76,286,135,151
050,26,047,"Michigan","Emmet County",3,77,261,125,136
050,26,047,"Michigan","Emmet County",3,78,298,158,140
050,26,047,"Michigan","Emmet County",3,79,247,129,118
050,26,047,"Michigan","Emmet County",3,80,202,101,101
050,26,047,"Michigan","Emmet County",3,81,192,86,106
050,26,047,"Michigan","Emmet County",3,82,184,84,100
050,26,047,"Michigan","Emmet County",3,83,156,74,82
050,26,047,"Michigan","Emmet County",3,84,149,65,84
050,26,047,"Michigan","Emmet County",3,85,800,292,508
050,26,047,"Michigan","Emmet County",4,0,253,125,128
050,26,047,"Michigan","Emmet County",4,1,268,126,142
050,26,047,"Michigan","Emmet County",4,2,294,157,137
050,26,047,"Michigan","Emmet County",4,3,306,164,142
050,26,047,"Michigan","Emmet County",4,4,303,158,145
050,26,047,"Michigan","Emmet County",4,5,319,162,157
050,26,047,"Michigan","Emmet County",4,6,339,164,175
050,26,047,"Michigan","Emmet County",4,7,345,180,165
050,26,047,"Michigan","Emmet County",4,8,344,173,171
050,26,047,"Michigan","Emmet County",4,9,339,167,172
050,26,047,"Michigan","Emmet County",4,10,343,170,173
050,26,047,"Michigan","Emmet County",4,11,376,193,183
050,26,047,"Michigan","Emmet County",4,12,381,204,177
050,26,047,"Michigan","Emmet County",4,13,377,199,178
050,26,047,"Michigan","Emmet County",4,14,429,220,209
050,26,047,"Michigan","Emmet County",4,15,391,211,180
050,26,047,"Michigan","Emmet County",4,16,388,215,173
050,26,047,"Michigan","Emmet County",4,17,401,211,190
050,26,047,"Michigan","Emmet County",4,18,402,206,196
050,26,047,"Michigan","Emmet County",4,19,311,166,145
050,26,047,"Michigan","Emmet County",4,20,306,165,141
050,26,047,"Michigan","Emmet County",4,21,352,181,171
050,26,047,"Michigan","Emmet County",4,22,358,179,179
050,26,047,"Michigan","Emmet County",4,23,401,220,181
050,26,047,"Michigan","Emmet County",4,24,368,193,175
050,26,047,"Michigan","Emmet County",4,25,346,173,173
050,26,047,"Michigan","Emmet County",4,26,368,194,174
050,26,047,"Michigan","Emmet County",4,27,385,198,187
050,26,047,"Michigan","Emmet County",4,28,355,167,188
050,26,047,"Michigan","Emmet County",4,29,387,195,192
050,26,047,"Michigan","Emmet County",4,30,350,181,169
050,26,047,"Michigan","Emmet County",4,31,394,208,186
050,26,047,"Michigan","Emmet County",4,32,429,217,212
050,26,047,"Michigan","Emmet County",4,33,411,224,187
050,26,047,"Michigan","Emmet County",4,34,371,185,186
050,26,047,"Michigan","Emmet County",4,35,381,189,192
050,26,047,"Michigan","Emmet County",4,36,395,199,196
050,26,047,"Michigan","Emmet County",4,37,410,208,202
050,26,047,"Michigan","Emmet County",4,38,411,199,212
050,26,047,"Michigan","Emmet County",4,39,379,189,190
050,26,047,"Michigan","Emmet County",4,40,380,172,208
050,26,047,"Michigan","Emmet County",4,41,388,182,206
050,26,047,"Michigan","Emmet County",4,42,415,220,195
050,26,047,"Michigan","Emmet County",4,43,378,186,192
050,26,047,"Michigan","Emmet County",4,44,363,171,192
050,26,047,"Michigan","Emmet County",4,45,381,175,206
050,26,047,"Michigan","Emmet County",4,46,383,183,200
050,26,047,"Michigan","Emmet County",4,47,400,196,204
050,26,047,"Michigan","Emmet County",4,48,380,204,176
050,26,047,"Michigan","Emmet County",4,49,350,184,166
050,26,047,"Michigan","Emmet County",4,50,413,216,197
050,26,047,"Michigan","Emmet County",4,51,470,261,209
050,26,047,"Michigan","Emmet County",4,52,439,238,201
050,26,047,"Michigan","Emmet County",4,53,425,213,212
050,26,047,"Michigan","Emmet County",4,54,433,213,220
050,26,047,"Michigan","Emmet County",4,55,444,225,219
050,26,047,"Michigan","Emmet County",4,56,446,214,232
050,26,047,"Michigan","Emmet County",4,57,469,229,240
050,26,047,"Michigan","Emmet County",4,58,482,235,247
050,26,047,"Michigan","Emmet County",4,59,484,239,245
050,26,047,"Michigan","Emmet County",4,60,536,266,270
050,26,047,"Michigan","Emmet County",4,61,590,288,302
050,26,047,"Michigan","Emmet County",4,62,586,292,294
050,26,047,"Michigan","Emmet County",4,63,579,272,307
050,26,047,"Michigan","Emmet County",4,64,594,279,315
050,26,047,"Michigan","Emmet County",4,65,609,280,329
050,26,047,"Michigan","Emmet County",4,66,588,284,304
050,26,047,"Michigan","Emmet County",4,67,575,285,290
050,26,047,"Michigan","Emmet County",4,68,554,283,271
050,26,047,"Michigan","Emmet County",4,69,541,261,280
050,26,047,"Michigan","Emmet County",4,70,526,251,275
050,26,047,"Michigan","Emmet County",4,71,511,250,261
050,26,047,"Michigan","Emmet County",4,72,478,244,234
050,26,047,"Michigan","Emmet County",4,73,455,221,234
050,26,047,"Michigan","Emmet County",4,74,406,207,199
050,26,047,"Michigan","Emmet County",4,75,446,217,229
050,26,047,"Michigan","Emmet County",4,76,293,134,159
050,26,047,"Michigan","Emmet County",4,77,283,138,145
050,26,047,"Michigan","Emmet County",4,78,250,117,133
050,26,047,"Michigan","Emmet County",4,79,282,140,142
050,26,047,"Michigan","Emmet County",4,80,237,125,112
050,26,047,"Michigan","Emmet County",4,81,200,94,106
050,26,047,"Michigan","Emmet County",4,82,182,77,105
050,26,047,"Michigan","Emmet County",4,83,176,82,94
050,26,047,"Michigan","Emmet County",4,84,156,74,82
050,26,047,"Michigan","Emmet County",4,85,793,302,491
050,26,047,"Michigan","Emmet County",5,0,258,127,131
050,26,047,"Michigan","Emmet County",5,1,251,135,116
050,26,047,"Michigan","Emmet County",5,2,265,123,142
050,26,047,"Michigan","Emmet County",5,3,293,150,143
050,26,047,"Michigan","Emmet County",5,4,315,172,143
050,26,047,"Michigan","Emmet County",5,5,315,168,147
050,26,047,"Michigan","Emmet County",5,6,327,167,160
050,26,047,"Michigan","Emmet County",5,7,346,166,180
050,26,047,"Michigan","Emmet County",5,8,345,181,164
050,26,047,"Michigan","Emmet County",5,9,356,178,178
050,26,047,"Michigan","Emmet County",5,10,340,167,173
050,26,047,"Michigan","Emmet County",5,11,347,178,169
050,26,047,"Michigan","Emmet County",5,12,369,191,178
050,26,047,"Michigan","Emmet County",5,13,372,205,167
050,26,047,"Michigan","Emmet County",5,14,383,205,178
050,26,047,"Michigan","Emmet County",5,15,424,219,205
050,26,047,"Michigan","Emmet County",5,16,384,205,179
050,26,047,"Michigan","Emmet County",5,17,392,220,172
050,26,047,"Michigan","Emmet County",5,18,364,192,172
050,26,047,"Michigan","Emmet County",5,19,333,169,164
050,26,047,"Michigan","Emmet County",5,20,316,174,142
050,26,047,"Michigan","Emmet County",5,21,296,164,132
050,26,047,"Michigan","Emmet County",5,22,366,184,182
050,26,047,"Michigan","Emmet County",5,23,378,189,189
050,26,047,"Michigan","Emmet County",5,24,384,205,179
050,26,047,"Michigan","Emmet County",5,25,354,181,173
050,26,047,"Michigan","Emmet County",5,26,333,159,174
050,26,047,"Michigan","Emmet County",5,27,372,202,170
050,26,047,"Michigan","Emmet County",5,28,385,201,184
050,26,047,"Michigan","Emmet County",5,29,367,175,192
050,26,047,"Michigan","Emmet County",5,30,392,196,196
050,26,047,"Michigan","Emmet County",5,31,358,180,178
050,26,047,"Michigan","Emmet County",5,32,377,201,176
050,26,047,"Michigan","Emmet County",5,33,441,227,214
050,26,047,"Michigan","Emmet County",5,34,411,220,191
050,26,047,"Michigan","Emmet County",5,35,366,190,176
050,26,047,"Michigan","Emmet County",5,36,371,185,186
050,26,047,"Michigan","Emmet County",5,37,406,206,200
050,26,047,"Michigan","Emmet County",5,38,410,209,201
050,26,047,"Michigan","Emmet County",5,39,422,210,212
050,26,047,"Michigan","Emmet County",5,40,372,187,185
050,26,047,"Michigan","Emmet County",5,41,403,188,215
050,26,047,"Michigan","Emmet County",5,42,390,190,200
050,26,047,"Michigan","Emmet County",5,43,430,229,201
050,26,047,"Michigan","Emmet County",5,44,369,181,188
050,26,047,"Michigan","Emmet County",5,45,365,172,193
050,26,047,"Michigan","Emmet County",5,46,388,181,207
050,26,047,"Michigan","Emmet County",5,47,367,173,194
050,26,047,"Michigan","Emmet County",5,48,390,194,196
050,26,047,"Michigan","Emmet County",5,49,377,206,171
050,26,047,"Michigan","Emmet County",5,50,350,187,163
050,26,047,"Michigan","Emmet County",5,51,420,223,197
050,26,047,"Michigan","Emmet County",5,52,463,256,207
050,26,047,"Michigan","Emmet County",5,53,448,238,210
050,26,047,"Michigan","Emmet County",5,54,412,209,203
050,26,047,"Michigan","Emmet County",5,55,434,210,224
050,26,047,"Michigan","Emmet County",5,56,454,227,227
050,26,047,"Michigan","Emmet County",5,57,444,207,237
050,26,047,"Michigan","Emmet County",5,58,479,236,243
050,26,047,"Michigan","Emmet County",5,59,488,239,249
050,26,047,"Michigan","Emmet County",5,60,478,239,239
050,26,047,"Michigan","Emmet County",5,61,542,273,269
050,26,047,"Michigan","Emmet County",5,62,590,292,298
050,26,047,"Michigan","Emmet County",5,63,589,289,300
050,26,047,"Michigan","Emmet County",5,64,578,277,301
050,26,047,"Michigan","Emmet County",5,65,589,275,314
050,26,047,"Michigan","Emmet County",5,66,604,275,329
050,26,047,"Michigan","Emmet County",5,67,581,283,298
050,26,047,"Michigan","Emmet County",5,68,562,274,288
050,26,047,"Michigan","Emmet County",5,69,549,281,268
050,26,047,"Michigan","Emmet County",5,70,539,259,280
050,26,047,"Michigan","Emmet County",5,71,523,247,276
050,26,047,"Michigan","Emmet County",5,72,501,242,259
050,26,047,"Michigan","Emmet County",5,73,471,235,236
050,26,047,"Michigan","Emmet County",5,74,434,213,221
050,26,047,"Michigan","Emmet County",5,75,396,201,195
050,26,047,"Michigan","Emmet County",5,76,445,219,226
050,26,047,"Michigan","Emmet County",5,77,280,128,152
050,26,047,"Michigan","Emmet County",5,78,276,135,141
050,26,047,"Michigan","Emmet County",5,79,233,103,130
050,26,047,"Michigan","Emmet County",5,80,265,132,133
050,26,047,"Michigan","Emmet County",5,81,228,118,110
050,26,047,"Michigan","Emmet County",5,82,181,84,97
050,26,047,"Michigan","Emmet County",5,83,171,74,97
050,26,047,"Michigan","Emmet County",5,84,168,77,91
050,26,047,"Michigan","Emmet County",5,85,823,322,501
050,26,049,"Michigan","Genesee County",1,0,4461,2279,2182
050,26,049,"Michigan","Genesee County",1,1,4568,2332,2236
050,26,049,"Michigan","Genesee County",1,2,4714,2379,2335
050,26,049,"Michigan","Genesee County",1,3,4898,2530,2368
050,26,049,"Michigan","Genesee County",1,4,4888,2501,2387
050,26,049,"Michigan","Genesee County",1,5,4949,2485,2464
050,26,049,"Michigan","Genesee County",1,6,4952,2530,2422
050,26,049,"Michigan","Genesee County",1,7,4919,2490,2429
050,26,049,"Michigan","Genesee County",1,8,5043,2594,2449
050,26,049,"Michigan","Genesee County",1,9,5083,2612,2471
050,26,049,"Michigan","Genesee County",1,10,5220,2706,2514
050,26,049,"Michigan","Genesee County",1,11,5334,2742,2592
050,26,049,"Michigan","Genesee County",1,12,5487,2849,2638
050,26,049,"Michigan","Genesee County",1,13,5514,2839,2675
050,26,049,"Michigan","Genesee County",1,14,5410,2809,2601
050,26,049,"Michigan","Genesee County",1,15,5430,2799,2631
050,26,049,"Michigan","Genesee County",1,16,5569,2822,2747
050,26,049,"Michigan","Genesee County",1,17,5512,2815,2697
050,26,049,"Michigan","Genesee County",1,18,4936,2608,2328
050,26,049,"Michigan","Genesee County",1,19,4312,2273,2039
050,26,049,"Michigan","Genesee County",1,20,4548,2329,2219
050,26,049,"Michigan","Genesee County",1,21,4688,2358,2330
050,26,049,"Michigan","Genesee County",1,22,4808,2377,2431
050,26,049,"Michigan","Genesee County",1,23,5072,2533,2539
050,26,049,"Michigan","Genesee County",1,24,5156,2540,2616
050,26,049,"Michigan","Genesee County",1,25,5093,2525,2568
050,26,049,"Michigan","Genesee County",1,26,5259,2583,2676
050,26,049,"Michigan","Genesee County",1,27,5461,2679,2782
050,26,049,"Michigan","Genesee County",1,28,5558,2703,2855
050,26,049,"Michigan","Genesee County",1,29,5545,2682,2863
050,26,049,"Michigan","Genesee County",1,30,5253,2514,2739
050,26,049,"Michigan","Genesee County",1,31,4841,2371,2470
050,26,049,"Michigan","Genesee County",1,32,4561,2193,2368
050,26,049,"Michigan","Genesee County",1,33,4505,2197,2308
050,26,049,"Michigan","Genesee County",1,34,4649,2305,2344
050,26,049,"Michigan","Genesee County",1,35,4549,2240,2309
050,26,049,"Michigan","Genesee County",1,36,4563,2205,2358
050,26,049,"Michigan","Genesee County",1,37,4635,2191,2444
050,26,049,"Michigan","Genesee County",1,38,4727,2253,2474
050,26,049,"Michigan","Genesee County",1,39,5049,2408,2641
050,26,049,"Michigan","Genesee County",1,40,5023,2452,2571
050,26,049,"Michigan","Genesee County",1,41,4815,2267,2548
050,26,049,"Michigan","Genesee County",1,42,4704,2234,2470
050,26,049,"Michigan","Genesee County",1,43,4713,2360,2353
050,26,049,"Michigan","Genesee County",1,44,4638,2300,2338
050,26,049,"Michigan","Genesee County",1,45,4593,2178,2415
050,26,049,"Michigan","Genesee County",1,46,4750,2241,2509
050,26,049,"Michigan","Genesee County",1,47,5007,2430,2577
050,26,049,"Michigan","Genesee County",1,48,5350,2588,2762
050,26,049,"Michigan","Genesee County",1,49,5728,2758,2970
050,26,049,"Michigan","Genesee County",1,50,5447,2673,2774
050,26,049,"Michigan","Genesee County",1,51,5238,2570,2668
050,26,049,"Michigan","Genesee County",1,52,5188,2511,2677
050,26,049,"Michigan","Genesee County",1,53,5285,2576,2709
050,26,049,"Michigan","Genesee County",1,54,5377,2673,2704
050,26,049,"Michigan","Genesee County",1,55,5686,2747,2939
050,26,049,"Michigan","Genesee County",1,56,5906,2855,3051
050,26,049,"Michigan","Genesee County",1,57,5873,2801,3072
050,26,049,"Michigan","Genesee County",1,58,5895,2822,3073
050,26,049,"Michigan","Genesee County",1,59,5855,2785,3070
050,26,049,"Michigan","Genesee County",1,60,5785,2773,3012
050,26,049,"Michigan","Genesee County",1,61,5928,2842,3086
050,26,049,"Michigan","Genesee County",1,62,6066,2919,3147
050,26,049,"Michigan","Genesee County",1,63,5869,2834,3035
050,26,049,"Michigan","Genesee County",1,64,5510,2647,2863
050,26,049,"Michigan","Genesee County",1,65,5254,2483,2771
050,26,049,"Michigan","Genesee County",1,66,5055,2375,2680
050,26,049,"Michigan","Genesee County",1,67,4817,2208,2609
050,26,049,"Michigan","Genesee County",1,68,4681,2166,2515
050,26,049,"Michigan","Genesee County",1,69,4256,1965,2291
050,26,049,"Michigan","Genesee County",1,70,4125,1928,2197
050,26,049,"Michigan","Genesee County",1,71,3992,1871,2121
050,26,049,"Michigan","Genesee County",1,72,4129,1865,2264
050,26,049,"Michigan","Genesee County",1,73,4109,1844,2265
050,26,049,"Michigan","Genesee County",1,74,2884,1323,1561
050,26,049,"Michigan","Genesee County",1,75,2789,1298,1491
050,26,049,"Michigan","Genesee County",1,76,2814,1290,1524
050,26,049,"Michigan","Genesee County",1,77,2788,1246,1542
050,26,049,"Michigan","Genesee County",1,78,2350,1028,1322
050,26,049,"Michigan","Genesee County",1,79,2020,873,1147
050,26,049,"Michigan","Genesee County",1,80,1840,782,1058
050,26,049,"Michigan","Genesee County",1,81,1782,713,1069
050,26,049,"Michigan","Genesee County",1,82,1627,651,976
050,26,049,"Michigan","Genesee County",1,83,1460,580,880
050,26,049,"Michigan","Genesee County",1,84,1412,548,864
050,26,049,"Michigan","Genesee County",1,85,8085,2849,5236
050,26,049,"Michigan","Genesee County",2,0,4389,2235,2154
050,26,049,"Michigan","Genesee County",2,1,4536,2318,2218
050,26,049,"Michigan","Genesee County",2,2,4701,2377,2324
050,26,049,"Michigan","Genesee County",2,3,4837,2490,2347
050,26,049,"Michigan","Genesee County",2,4,4905,2512,2393
050,26,049,"Michigan","Genesee County",2,5,4938,2492,2446
050,26,049,"Michigan","Genesee County",2,6,4968,2527,2441
050,26,049,"Michigan","Genesee County",2,7,4931,2502,2429
050,26,049,"Michigan","Genesee County",2,8,5007,2565,2442
050,26,049,"Michigan","Genesee County",2,9,5079,2608,2471
050,26,049,"Michigan","Genesee County",2,10,5187,2682,2505
050,26,049,"Michigan","Genesee County",2,11,5292,2725,2567
050,26,049,"Michigan","Genesee County",2,12,5475,2833,2642
050,26,049,"Michigan","Genesee County",2,13,5508,2842,2666
050,26,049,"Michigan","Genesee County",2,14,5439,2817,2622
050,26,049,"Michigan","Genesee County",2,15,5436,2805,2631
050,26,049,"Michigan","Genesee County",2,16,5548,2823,2725
050,26,049,"Michigan","Genesee County",2,17,5527,2818,2709
050,26,049,"Michigan","Genesee County",2,18,4907,2586,2321
050,26,049,"Michigan","Genesee County",2,19,4312,2271,2041
050,26,049,"Michigan","Genesee County",2,20,4594,2355,2239
050,26,049,"Michigan","Genesee County",2,21,4687,2368,2319
050,26,049,"Michigan","Genesee County",2,22,4827,2390,2437
050,26,049,"Michigan","Genesee County",2,23,5061,2512,2549
050,26,049,"Michigan","Genesee County",2,24,5126,2536,2590
050,26,049,"Michigan","Genesee County",2,25,5104,2533,2571
050,26,049,"Michigan","Genesee County",2,26,5238,2578,2660
050,26,049,"Michigan","Genesee County",2,27,5411,2651,2760
050,26,049,"Michigan","Genesee County",2,28,5529,2696,2833
050,26,049,"Michigan","Genesee County",2,29,5526,2672,2854
050,26,049,"Michigan","Genesee County",2,30,5353,2570,2783
050,26,049,"Michigan","Genesee County",2,31,4921,2399,2522
050,26,049,"Michigan","Genesee County",2,32,4623,2231,2392
050,26,049,"Michigan","Genesee County",2,33,4521,2199,2322
050,26,049,"Michigan","Genesee County",2,34,4617,2282,2335
050,26,049,"Michigan","Genesee County",2,35,4603,2269,2334
050,26,049,"Michigan","Genesee County",2,36,4521,2190,2331
050,26,049,"Michigan","Genesee County",2,37,4612,2190,2422
050,26,049,"Michigan","Genesee County",2,38,4720,2239,2481
050,26,049,"Michigan","Genesee County",2,39,4957,2363,2594
050,26,049,"Michigan","Genesee County",2,40,5061,2457,2604
050,26,049,"Michigan","Genesee County",2,41,4859,2307,2552
050,26,049,"Michigan","Genesee County",2,42,4713,2236,2477
050,26,049,"Michigan","Genesee County",2,43,4749,2344,2405
050,26,049,"Michigan","Genesee County",2,44,4604,2291,2313
050,26,049,"Michigan","Genesee County",2,45,4627,2216,2411
050,26,049,"Michigan","Genesee County",2,46,4703,2226,2477
050,26,049,"Michigan","Genesee County",2,47,4931,2375,2556
050,26,049,"Michigan","Genesee County",2,48,5258,2543,2715
050,26,049,"Michigan","Genesee County",2,49,5654,2723,2931
050,26,049,"Michigan","Genesee County",2,50,5518,2697,2821
050,26,049,"Michigan","Genesee County",2,51,5254,2578,2676
050,26,049,"Michigan","Genesee County",2,52,5184,2514,2670
050,26,049,"Michigan","Genesee County",2,53,5248,2553,2695
050,26,049,"Michigan","Genesee County",2,54,5337,2641,2696
050,26,049,"Michigan","Genesee County",2,55,5596,2716,2880
050,26,049,"Michigan","Genesee County",2,56,5854,2827,3027
050,26,049,"Michigan","Genesee County",2,57,5870,2808,3062
050,26,049,"Michigan","Genesee County",2,58,5871,2805,3066
050,26,049,"Michigan","Genesee County",2,59,5878,2800,3078
050,26,049,"Michigan","Genesee County",2,60,5763,2755,3008
050,26,049,"Michigan","Genesee County",2,61,5853,2794,3059
050,26,049,"Michigan","Genesee County",2,62,5996,2884,3112
050,26,049,"Michigan","Genesee County",2,63,5930,2859,3071
050,26,049,"Michigan","Genesee County",2,64,5541,2658,2883
050,26,049,"Michigan","Genesee County",2,65,5291,2504,2787
050,26,049,"Michigan","Genesee County",2,66,5091,2390,2701
050,26,049,"Michigan","Genesee County",2,67,4828,2223,2605
050,26,049,"Michigan","Genesee County",2,68,4654,2140,2514
050,26,049,"Michigan","Genesee County",2,69,4361,2006,2355
050,26,049,"Michigan","Genesee County",2,70,4121,1917,2204
050,26,049,"Michigan","Genesee County",2,71,3989,1865,2124
050,26,049,"Michigan","Genesee County",2,72,4003,1821,2182
050,26,049,"Michigan","Genesee County",2,73,4268,1923,2345
050,26,049,"Michigan","Genesee County",2,74,2963,1347,1616
050,26,049,"Michigan","Genesee County",2,75,2798,1295,1503
050,26,049,"Michigan","Genesee County",2,76,2744,1261,1483
050,26,049,"Michigan","Genesee County",2,77,2814,1257,1557
050,26,049,"Michigan","Genesee County",2,78,2381,1049,1332
050,26,049,"Michigan","Genesee County",2,79,2061,894,1167
050,26,049,"Michigan","Genesee County",2,80,1852,783,1069
050,26,049,"Michigan","Genesee County",2,81,1754,717,1037
050,26,049,"Michigan","Genesee County",2,82,1641,651,990
050,26,049,"Michigan","Genesee County",2,83,1449,576,873
050,26,049,"Michigan","Genesee County",2,84,1382,537,845
050,26,049,"Michigan","Genesee County",2,85,8007,2801,5206
050,26,049,"Michigan","Genesee County",3,0,4293,2198,2095
050,26,049,"Michigan","Genesee County",3,1,4455,2254,2201
050,26,049,"Michigan","Genesee County",3,2,4556,2304,2252
050,26,049,"Michigan","Genesee County",3,3,4679,2370,2309
050,26,049,"Michigan","Genesee County",3,4,4840,2507,2333
050,26,049,"Michigan","Genesee County",3,5,4932,2529,2403
050,26,049,"Michigan","Genesee County",3,6,4915,2493,2422
050,26,049,"Michigan","Genesee County",3,7,4965,2527,2438
050,26,049,"Michigan","Genesee County",3,8,4936,2537,2399
050,26,049,"Michigan","Genesee County",3,9,4967,2551,2416
050,26,049,"Michigan","Genesee County",3,10,5078,2609,2469
050,26,049,"Michigan","Genesee County",3,11,5226,2689,2537
050,26,049,"Michigan","Genesee County",3,12,5294,2711,2583
050,26,049,"Michigan","Genesee County",3,13,5473,2816,2657
050,26,049,"Michigan","Genesee County",3,14,5535,2860,2675
050,26,049,"Michigan","Genesee County",3,15,5450,2798,2652
050,26,049,"Michigan","Genesee County",3,16,5426,2778,2648
050,26,049,"Michigan","Genesee County",3,17,5528,2814,2714
050,26,049,"Michigan","Genesee County",3,18,4867,2552,2315
050,26,049,"Michigan","Genesee County",3,19,4160,2193,1967
050,26,049,"Michigan","Genesee County",3,20,4555,2360,2195
050,26,049,"Michigan","Genesee County",3,21,4781,2442,2339
050,26,049,"Michigan","Genesee County",3,22,4900,2439,2461
050,26,049,"Michigan","Genesee County",3,23,5080,2515,2565
050,26,049,"Michigan","Genesee County",3,24,5136,2572,2564
050,26,049,"Michigan","Genesee County",3,25,5162,2605,2557
050,26,049,"Michigan","Genesee County",3,26,5169,2572,2597
050,26,049,"Michigan","Genesee County",3,27,5228,2560,2668
050,26,049,"Michigan","Genesee County",3,28,5434,2663,2771
050,26,049,"Michigan","Genesee County",3,29,5552,2675,2877
050,26,049,"Michigan","Genesee County",3,30,5579,2703,2876
050,26,049,"Michigan","Genesee County",3,31,5365,2573,2792
050,26,049,"Michigan","Genesee County",3,32,4950,2414,2536
050,26,049,"Michigan","Genesee County",3,33,4681,2262,2419
050,26,049,"Michigan","Genesee County",3,34,4521,2213,2308
050,26,049,"Michigan","Genesee County",3,35,4581,2237,2344
050,26,049,"Michigan","Genesee County",3,36,4582,2256,2326
050,26,049,"Michigan","Genesee County",3,37,4540,2193,2347
050,26,049,"Michigan","Genesee County",3,38,4605,2185,2420
050,26,049,"Michigan","Genesee County",3,39,4725,2255,2470
050,26,049,"Michigan","Genesee County",3,40,4991,2384,2607
050,26,049,"Michigan","Genesee County",3,41,5052,2420,2632
050,26,049,"Michigan","Genesee County",3,42,4857,2308,2549
050,26,049,"Michigan","Genesee County",3,43,4690,2227,2463
050,26,049,"Michigan","Genesee County",3,44,4677,2298,2379
050,26,049,"Michigan","Genesee County",3,45,4622,2287,2335
050,26,049,"Michigan","Genesee County",3,46,4584,2204,2380
050,26,049,"Michigan","Genesee County",3,47,4647,2185,2462
050,26,049,"Michigan","Genesee County",3,48,4882,2358,2524
050,26,049,"Michigan","Genesee County",3,49,5224,2520,2704
050,26,049,"Michigan","Genesee County",3,50,5610,2718,2892
050,26,049,"Michigan","Genesee County",3,51,5477,2670,2807
050,26,049,"Michigan","Genesee County",3,52,5260,2595,2665
050,26,049,"Michigan","Genesee County",3,53,5116,2482,2634
050,26,049,"Michigan","Genesee County",3,54,5230,2539,2691
050,26,049,"Michigan","Genesee County",3,55,5273,2610,2663
050,26,049,"Michigan","Genesee County",3,56,5569,2704,2865
050,26,049,"Michigan","Genesee County",3,57,5788,2790,2998
050,26,049,"Michigan","Genesee County",3,58,5799,2758,3041
050,26,049,"Michigan","Genesee County",3,59,5780,2750,3030
050,26,049,"Michigan","Genesee County",3,60,5766,2743,3023
050,26,049,"Michigan","Genesee County",3,61,5670,2670,3000
050,26,049,"Michigan","Genesee County",3,62,5740,2714,3026
050,26,049,"Michigan","Genesee County",3,63,5890,2805,3085
050,26,049,"Michigan","Genesee County",3,64,5825,2823,3002
050,26,049,"Michigan","Genesee County",3,65,5439,2588,2851
050,26,049,"Michigan","Genesee County",3,66,5168,2419,2749
050,26,049,"Michigan","Genesee County",3,67,4964,2321,2643
050,26,049,"Michigan","Genesee County",3,68,4732,2182,2550
050,26,049,"Michigan","Genesee County",3,69,4538,2079,2459
050,26,049,"Michigan","Genesee County",3,70,4216,1911,2305
050,26,049,"Michigan","Genesee County",3,71,3999,1845,2154
050,26,049,"Michigan","Genesee County",3,72,3856,1789,2067
050,26,049,"Michigan","Genesee County",3,73,3839,1728,2111
050,26,049,"Michigan","Genesee County",3,74,4105,1834,2271
050,26,049,"Michigan","Genesee County",3,75,2865,1289,1576
050,26,049,"Michigan","Genesee County",3,76,2657,1217,1440
050,26,049,"Michigan","Genesee County",3,77,2626,1188,1438
050,26,049,"Michigan","Genesee County",3,78,2651,1170,1481
050,26,049,"Michigan","Genesee County",3,79,2248,989,1259
050,26,049,"Michigan","Genesee County",3,80,1936,821,1115
050,26,049,"Michigan","Genesee County",3,81,1739,718,1021
050,26,049,"Michigan","Genesee County",3,82,1636,670,966
050,26,049,"Michigan","Genesee County",3,83,1509,585,924
050,26,049,"Michigan","Genesee County",3,84,1305,517,788
050,26,049,"Michigan","Genesee County",3,85,7879,2756,5123
050,26,049,"Michigan","Genesee County",4,0,4365,2261,2104
050,26,049,"Michigan","Genesee County",4,1,4205,2143,2062
050,26,049,"Michigan","Genesee County",4,2,4430,2214,2216
050,26,049,"Michigan","Genesee County",4,3,4547,2300,2247
050,26,049,"Michigan","Genesee County",4,4,4678,2371,2307
050,26,049,"Michigan","Genesee County",4,5,4820,2500,2320
050,26,049,"Michigan","Genesee County",4,6,4917,2502,2415
050,26,049,"Michigan","Genesee County",4,7,4906,2490,2416
050,26,049,"Michigan","Genesee County",4,8,4984,2537,2447
050,26,049,"Michigan","Genesee County",4,9,4929,2513,2416
050,26,049,"Michigan","Genesee County",4,10,4969,2563,2406
050,26,049,"Michigan","Genesee County",4,11,5106,2618,2488
050,26,049,"Michigan","Genesee County",4,12,5171,2671,2500
050,26,049,"Michigan","Genesee County",4,13,5271,2709,2562
050,26,049,"Michigan","Genesee County",4,14,5477,2830,2647
050,26,049,"Michigan","Genesee County",4,15,5551,2858,2693
050,26,049,"Michigan","Genesee County",4,16,5438,2778,2660
050,26,049,"Michigan","Genesee County",4,17,5414,2779,2635
050,26,049,"Michigan","Genesee County",4,18,4838,2524,2314
050,26,049,"Michigan","Genesee County",4,19,4041,2136,1905
050,26,049,"Michigan","Genesee County",4,20,4273,2199,2074
050,26,049,"Michigan","Genesee County",4,21,4651,2425,2226
050,26,049,"Michigan","Genesee County",4,22,4938,2495,2443
050,26,049,"Michigan","Genesee County",4,23,5025,2477,2548
050,26,049,"Michigan","Genesee County",4,24,5052,2507,2545
050,26,049,"Michigan","Genesee County",4,25,5092,2532,2560
050,26,049,"Michigan","Genesee County",4,26,5114,2580,2534
050,26,049,"Michigan","Genesee County",4,27,5219,2591,2628
050,26,049,"Michigan","Genesee County",4,28,5161,2516,2645
050,26,049,"Michigan","Genesee County",4,29,5427,2693,2734
050,26,049,"Michigan","Genesee County",4,30,5571,2716,2855
050,26,049,"Michigan","Genesee County",4,31,5515,2660,2855
050,26,049,"Michigan","Genesee County",4,32,5307,2544,2763
050,26,049,"Michigan","Genesee County",4,33,4982,2441,2541
050,26,049,"Michigan","Genesee County",4,34,4713,2296,2417
050,26,049,"Michigan","Genesee County",4,35,4539,2226,2313
050,26,049,"Michigan","Genesee County",4,36,4558,2223,2335
050,26,049,"Michigan","Genesee County",4,37,4586,2263,2323
050,26,049,"Michigan","Genesee County",4,38,4550,2191,2359
050,26,049,"Michigan","Genesee County",4,39,4619,2186,2433
050,26,049,"Michigan","Genesee County",4,40,4710,2268,2442
050,26,049,"Michigan","Genesee County",4,41,4927,2354,2573
050,26,049,"Michigan","Genesee County",4,42,4997,2395,2602
050,26,049,"Michigan","Genesee County",4,43,4860,2295,2565
050,26,049,"Michigan","Genesee County",4,44,4642,2239,2403
050,26,049,"Michigan","Genesee County",4,45,4601,2258,2343
050,26,049,"Michigan","Genesee County",4,46,4589,2281,2308
050,26,049,"Michigan","Genesee County",4,47,4594,2184,2410
050,26,049,"Michigan","Genesee County",4,48,4624,2190,2434
050,26,049,"Michigan","Genesee County",4,49,4833,2316,2517
050,26,049,"Michigan","Genesee County",4,50,5185,2505,2680
050,26,049,"Michigan","Genesee County",4,51,5527,2671,2856
050,26,049,"Michigan","Genesee County",4,52,5473,2684,2789
050,26,049,"Michigan","Genesee County",4,53,5165,2530,2635
050,26,049,"Michigan","Genesee County",4,54,5093,2483,2610
050,26,049,"Michigan","Genesee County",4,55,5166,2502,2664
050,26,049,"Michigan","Genesee County",4,56,5240,2579,2661
050,26,049,"Michigan","Genesee County",4,57,5475,2647,2828
050,26,049,"Michigan","Genesee County",4,58,5693,2733,2960
050,26,049,"Michigan","Genesee County",4,59,5690,2698,2992
050,26,049,"Michigan","Genesee County",4,60,5647,2694,2953
050,26,049,"Michigan","Genesee County",4,61,5673,2680,2993
050,26,049,"Michigan","Genesee County",4,62,5555,2619,2936
050,26,049,"Michigan","Genesee County",4,63,5618,2635,2983
050,26,049,"Michigan","Genesee County",4,64,5779,2748,3031
050,26,049,"Michigan","Genesee County",4,65,5686,2732,2954
050,26,049,"Michigan","Genesee County",4,66,5323,2501,2822
050,26,049,"Michigan","Genesee County",4,67,5024,2343,2681
050,26,049,"Michigan","Genesee County",4,68,4840,2259,2581
050,26,049,"Michigan","Genesee County",4,69,4626,2125,2501
050,26,049,"Michigan","Genesee County",4,70,4416,2005,2411
050,26,049,"Michigan","Genesee County",4,71,4093,1846,2247
050,26,049,"Michigan","Genesee County",4,72,3873,1773,2100
050,26,049,"Michigan","Genesee County",4,73,3694,1701,1993
050,26,049,"Michigan","Genesee County",4,74,3689,1649,2040
050,26,049,"Michigan","Genesee County",4,75,4000,1775,2225
050,26,049,"Michigan","Genesee County",4,76,2726,1210,1516
050,26,049,"Michigan","Genesee County",4,77,2545,1150,1395
050,26,049,"Michigan","Genesee County",4,78,2468,1119,1349
050,26,049,"Michigan","Genesee County",4,79,2518,1111,1407
050,26,049,"Michigan","Genesee County",4,80,2122,917,1205
050,26,049,"Michigan","Genesee County",4,81,1828,756,1072
050,26,049,"Michigan","Genesee County",4,82,1625,665,960
050,26,049,"Michigan","Genesee County",4,83,1500,612,888
050,26,049,"Michigan","Genesee County",4,84,1339,516,823
050,26,049,"Michigan","Genesee County",4,85,7683,2679,5004
050,26,049,"Michigan","Genesee County",5,0,4296,2226,2070
050,26,049,"Michigan","Genesee County",5,1,4404,2290,2114
050,26,049,"Michigan","Genesee County",5,2,4275,2180,2095
050,26,049,"Michigan","Genesee County",5,3,4427,2224,2203
050,26,049,"Michigan","Genesee County",5,4,4610,2333,2277
050,26,049,"Michigan","Genesee County",5,5,4688,2359,2329
050,26,049,"Michigan","Genesee County",5,6,4856,2509,2347
050,26,049,"Michigan","Genesee County",5,7,4923,2510,2413
050,26,049,"Michigan","Genesee County",5,8,4947,2520,2427
050,26,049,"Michigan","Genesee County",5,9,4969,2518,2451
050,26,049,"Michigan","Genesee County",5,10,4904,2522,2382
050,26,049,"Michigan","Genesee County",5,11,4953,2569,2384
050,26,049,"Michigan","Genesee County",5,12,5079,2608,2471
050,26,049,"Michigan","Genesee County",5,13,5167,2654,2513
050,26,049,"Michigan","Genesee County",5,14,5236,2688,2548
050,26,049,"Michigan","Genesee County",5,15,5482,2807,2675
050,26,049,"Michigan","Genesee County",5,16,5553,2841,2712
050,26,049,"Michigan","Genesee County",5,17,5450,2775,2675
050,26,049,"Michigan","Genesee County",5,18,4787,2531,2256
050,26,049,"Michigan","Genesee County",5,19,4104,2151,1953
050,26,049,"Michigan","Genesee County",5,20,4321,2218,2103
050,26,049,"Michigan","Genesee County",5,21,4483,2295,2188
050,26,049,"Michigan","Genesee County",5,22,4868,2501,2367
050,26,049,"Michigan","Genesee County",5,23,5163,2562,2601
050,26,049,"Michigan","Genesee County",5,24,5076,2520,2556
050,26,049,"Michigan","Genesee County",5,25,4949,2446,2503
050,26,049,"Michigan","Genesee County",5,26,5047,2505,2542
050,26,049,"Michigan","Genesee County",5,27,5156,2565,2591
050,26,049,"Michigan","Genesee County",5,28,5163,2519,2644
050,26,049,"Michigan","Genesee County",5,29,5226,2560,2666
050,26,049,"Michigan","Genesee County",5,30,5484,2713,2771
050,26,049,"Michigan","Genesee County",5,31,5577,2749,2828
050,26,049,"Michigan","Genesee County",5,32,5527,2662,2865
050,26,049,"Michigan","Genesee County",5,33,5337,2554,2783
050,26,049,"Michigan","Genesee County",5,34,5008,2486,2522
050,26,049,"Michigan","Genesee County",5,35,4747,2307,2440
050,26,049,"Michigan","Genesee County",5,36,4532,2222,2310
050,26,049,"Michigan","Genesee County",5,37,4536,2213,2323
050,26,049,"Michigan","Genesee County",5,38,4621,2275,2346
050,26,049,"Michigan","Genesee County",5,39,4592,2209,2383
050,26,049,"Michigan","Genesee County",5,40,4656,2216,2440
050,26,049,"Michigan","Genesee County",5,41,4687,2245,2442
050,26,049,"Michigan","Genesee County",5,42,4892,2326,2566
050,26,049,"Michigan","Genesee County",5,43,5001,2398,2603
050,26,049,"Michigan","Genesee County",5,44,4832,2279,2553
050,26,049,"Michigan","Genesee County",5,45,4629,2232,2397
050,26,049,"Michigan","Genesee County",5,46,4574,2260,2314
050,26,049,"Michigan","Genesee County",5,47,4558,2240,2318
050,26,049,"Michigan","Genesee County",5,48,4562,2189,2373
050,26,049,"Michigan","Genesee County",5,49,4617,2168,2449
050,26,049,"Michigan","Genesee County",5,50,4819,2326,2493
050,26,049,"Michigan","Genesee County",5,51,5133,2483,2650
050,26,049,"Michigan","Genesee County",5,52,5513,2674,2839
050,26,049,"Michigan","Genesee County",5,53,5392,2635,2757
050,26,049,"Michigan","Genesee County",5,54,5159,2533,2626
050,26,049,"Michigan","Genesee County",5,55,5029,2433,2596
050,26,049,"Michigan","Genesee County",5,56,5180,2504,2676
050,26,049,"Michigan","Genesee County",5,57,5189,2552,2637
050,26,049,"Michigan","Genesee County",5,58,5414,2636,2778
050,26,049,"Michigan","Genesee County",5,59,5605,2675,2930
050,26,049,"Michigan","Genesee County",5,60,5609,2660,2949
050,26,049,"Michigan","Genesee County",5,61,5554,2636,2918
050,26,049,"Michigan","Genesee County",5,62,5579,2631,2948
050,26,049,"Michigan","Genesee County",5,63,5469,2550,2919
050,26,049,"Michigan","Genesee County",5,64,5518,2577,2941
050,26,049,"Michigan","Genesee County",5,65,5678,2688,2990
050,26,049,"Michigan","Genesee County",5,66,5572,2661,2911
050,26,049,"Michigan","Genesee County",5,67,5202,2442,2760
050,26,049,"Michigan","Genesee County",5,68,4940,2299,2641
050,26,049,"Michigan","Genesee County",5,69,4761,2203,2558
050,26,049,"Michigan","Genesee County",5,70,4546,2080,2466
050,26,049,"Michigan","Genesee County",5,71,4312,1942,2370
050,26,049,"Michigan","Genesee County",5,72,3996,1793,2203
050,26,049,"Michigan","Genesee County",5,73,3742,1694,2048
050,26,049,"Michigan","Genesee County",5,74,3581,1643,1938
050,26,049,"Michigan","Genesee County",5,75,3620,1592,2028
050,26,049,"Michigan","Genesee County",5,76,3848,1700,2148
050,26,049,"Michigan","Genesee County",5,77,2640,1162,1478
050,26,049,"Michigan","Genesee County",5,78,2421,1081,1340
050,26,049,"Michigan","Genesee County",5,79,2351,1073,1278
050,26,049,"Michigan","Genesee County",5,80,2399,1042,1357
050,26,049,"Michigan","Genesee County",5,81,2009,855,1154
050,26,049,"Michigan","Genesee County",5,82,1710,704,1006
050,26,049,"Michigan","Genesee County",5,83,1488,608,880
050,26,049,"Michigan","Genesee County",5,84,1355,560,795
050,26,049,"Michigan","Genesee County",5,85,7658,2667,4991
050,26,051,"Michigan","Gladwin County",1,0,254,131,123
050,26,051,"Michigan","Gladwin County",1,1,251,134,117
050,26,051,"Michigan","Gladwin County",1,2,273,137,136
050,26,051,"Michigan","Gladwin County",1,3,272,139,133
050,26,051,"Michigan","Gladwin County",1,4,283,134,149
050,26,051,"Michigan","Gladwin County",1,5,291,142,149
050,26,051,"Michigan","Gladwin County",1,6,253,135,118
050,26,051,"Michigan","Gladwin County",1,7,259,141,118
050,26,051,"Michigan","Gladwin County",1,8,239,132,107
050,26,051,"Michigan","Gladwin County",1,9,257,145,112
050,26,051,"Michigan","Gladwin County",1,10,278,171,107
050,26,051,"Michigan","Gladwin County",1,11,264,151,113
050,26,051,"Michigan","Gladwin County",1,12,279,145,134
050,26,051,"Michigan","Gladwin County",1,13,287,146,141
050,26,051,"Michigan","Gladwin County",1,14,290,151,139
050,26,051,"Michigan","Gladwin County",1,15,265,144,121
050,26,051,"Michigan","Gladwin County",1,16,264,145,119
050,26,051,"Michigan","Gladwin County",1,17,277,140,137
050,26,051,"Michigan","Gladwin County",1,18,254,128,126
050,26,051,"Michigan","Gladwin County",1,19,203,106,97
050,26,051,"Michigan","Gladwin County",1,20,217,117,100
050,26,051,"Michigan","Gladwin County",1,21,215,117,98
050,26,051,"Michigan","Gladwin County",1,22,222,105,117
050,26,051,"Michigan","Gladwin County",1,23,213,114,99
050,26,051,"Michigan","Gladwin County",1,24,190,98,92
050,26,051,"Michigan","Gladwin County",1,25,214,110,104
050,26,051,"Michigan","Gladwin County",1,26,239,124,115
050,26,051,"Michigan","Gladwin County",1,27,248,138,110
050,26,051,"Michigan","Gladwin County",1,28,249,119,130
050,26,051,"Michigan","Gladwin County",1,29,244,129,115
050,26,051,"Michigan","Gladwin County",1,30,271,143,128
050,26,051,"Michigan","Gladwin County",1,31,229,112,117
050,26,051,"Michigan","Gladwin County",1,32,233,124,109
050,26,051,"Michigan","Gladwin County",1,33,216,105,111
050,26,051,"Michigan","Gladwin County",1,34,243,118,125
050,26,051,"Michigan","Gladwin County",1,35,231,117,114
050,26,051,"Michigan","Gladwin County",1,36,259,135,124
050,26,051,"Michigan","Gladwin County",1,37,246,126,120
050,26,051,"Michigan","Gladwin County",1,38,240,130,110
050,26,051,"Michigan","Gladwin County",1,39,250,128,122
050,26,051,"Michigan","Gladwin County",1,40,250,126,124
050,26,051,"Michigan","Gladwin County",1,41,241,128,113
050,26,051,"Michigan","Gladwin County",1,42,256,120,136
050,26,051,"Michigan","Gladwin County",1,43,249,134,115
050,26,051,"Michigan","Gladwin County",1,44,226,122,104
050,26,051,"Michigan","Gladwin County",1,45,234,118,116
050,26,051,"Michigan","Gladwin County",1,46,240,123,117
050,26,051,"Michigan","Gladwin County",1,47,277,137,140
050,26,051,"Michigan","Gladwin County",1,48,285,149,136
050,26,051,"Michigan","Gladwin County",1,49,311,156,155
050,26,051,"Michigan","Gladwin County",1,50,314,155,159
050,26,051,"Michigan","Gladwin County",1,51,345,172,173
050,26,051,"Michigan","Gladwin County",1,52,323,156,167
050,26,051,"Michigan","Gladwin County",1,53,357,184,173
050,26,051,"Michigan","Gladwin County",1,54,352,181,171
050,26,051,"Michigan","Gladwin County",1,55,358,192,166
050,26,051,"Michigan","Gladwin County",1,56,387,205,182
050,26,051,"Michigan","Gladwin County",1,57,387,201,186
050,26,051,"Michigan","Gladwin County",1,58,404,215,189
050,26,051,"Michigan","Gladwin County",1,59,463,233,230
050,26,051,"Michigan","Gladwin County",1,60,459,234,225
050,26,051,"Michigan","Gladwin County",1,61,486,241,245
050,26,051,"Michigan","Gladwin County",1,62,492,244,248
050,26,051,"Michigan","Gladwin County",1,63,493,253,240
050,26,051,"Michigan","Gladwin County",1,64,446,215,231
050,26,051,"Michigan","Gladwin County",1,65,452,226,226
050,26,051,"Michigan","Gladwin County",1,66,476,227,249
050,26,051,"Michigan","Gladwin County",1,67,457,219,238
050,26,051,"Michigan","Gladwin County",1,68,432,217,215
050,26,051,"Michigan","Gladwin County",1,69,416,210,206
050,26,051,"Michigan","Gladwin County",1,70,403,191,212
050,26,051,"Michigan","Gladwin County",1,71,425,209,216
050,26,051,"Michigan","Gladwin County",1,72,407,211,196
050,26,051,"Michigan","Gladwin County",1,73,388,213,175
050,26,051,"Michigan","Gladwin County",1,74,244,118,126
050,26,051,"Michigan","Gladwin County",1,75,271,125,146
050,26,051,"Michigan","Gladwin County",1,76,295,160,135
050,26,051,"Michigan","Gladwin County",1,77,297,152,145
050,26,051,"Michigan","Gladwin County",1,78,233,116,117
050,26,051,"Michigan","Gladwin County",1,79,199,91,108
050,26,051,"Michigan","Gladwin County",1,80,189,85,104
050,26,051,"Michigan","Gladwin County",1,81,187,91,96
050,26,051,"Michigan","Gladwin County",1,82,177,89,88
050,26,051,"Michigan","Gladwin County",1,83,136,66,70
050,26,051,"Michigan","Gladwin County",1,84,108,49,59
050,26,051,"Michigan","Gladwin County",1,85,598,230,368
050,26,051,"Michigan","Gladwin County",2,0,236,119,117
050,26,051,"Michigan","Gladwin County",2,1,252,132,120
050,26,051,"Michigan","Gladwin County",2,2,264,135,129
050,26,051,"Michigan","Gladwin County",2,3,271,138,133
050,26,051,"Michigan","Gladwin County",2,4,284,137,147
050,26,051,"Michigan","Gladwin County",2,5,290,140,150
050,26,051,"Michigan","Gladwin County",2,6,265,139,126
050,26,051,"Michigan","Gladwin County",2,7,259,140,119
050,26,051,"Michigan","Gladwin County",2,8,243,135,108
050,26,051,"Michigan","Gladwin County",2,9,253,143,110
050,26,051,"Michigan","Gladwin County",2,10,273,165,108
050,26,051,"Michigan","Gladwin County",2,11,265,153,112
050,26,051,"Michigan","Gladwin County",2,12,277,148,129
050,26,051,"Michigan","Gladwin County",2,13,287,146,141
050,26,051,"Michigan","Gladwin County",2,14,292,153,139
050,26,051,"Michigan","Gladwin County",2,15,270,146,124
050,26,051,"Michigan","Gladwin County",2,16,265,146,119
050,26,051,"Michigan","Gladwin County",2,17,276,141,135
050,26,051,"Michigan","Gladwin County",2,18,246,126,120
050,26,051,"Michigan","Gladwin County",2,19,204,106,98
050,26,051,"Michigan","Gladwin County",2,20,218,117,101
050,26,051,"Michigan","Gladwin County",2,21,215,115,100
050,26,051,"Michigan","Gladwin County",2,22,225,110,115
050,26,051,"Michigan","Gladwin County",2,23,215,112,103
050,26,051,"Michigan","Gladwin County",2,24,193,101,92
050,26,051,"Michigan","Gladwin County",2,25,210,108,102
050,26,051,"Michigan","Gladwin County",2,26,234,122,112
050,26,051,"Michigan","Gladwin County",2,27,246,134,112
050,26,051,"Michigan","Gladwin County",2,28,250,126,124
050,26,051,"Michigan","Gladwin County",2,29,249,128,121
050,26,051,"Michigan","Gladwin County",2,30,264,139,125
050,26,051,"Michigan","Gladwin County",2,31,237,118,119
050,26,051,"Michigan","Gladwin County",2,32,232,121,111
050,26,051,"Michigan","Gladwin County",2,33,220,108,112
050,26,051,"Michigan","Gladwin County",2,34,237,114,123
050,26,051,"Michigan","Gladwin County",2,35,239,119,120
050,26,051,"Michigan","Gladwin County",2,36,251,130,121
050,26,051,"Michigan","Gladwin County",2,37,250,130,120
050,26,051,"Michigan","Gladwin County",2,38,244,132,112
050,26,051,"Michigan","Gladwin County",2,39,244,126,118
050,26,051,"Michigan","Gladwin County",2,40,251,127,124
050,26,051,"Michigan","Gladwin County",2,41,242,126,116
050,26,051,"Michigan","Gladwin County",2,42,246,119,127
050,26,051,"Michigan","Gladwin County",2,43,255,133,122
050,26,051,"Michigan","Gladwin County",2,44,229,123,106
050,26,051,"Michigan","Gladwin County",2,45,233,120,113
050,26,051,"Michigan","Gladwin County",2,46,241,125,116
050,26,051,"Michigan","Gladwin County",2,47,266,132,134
050,26,051,"Michigan","Gladwin County",2,48,286,148,138
050,26,051,"Michigan","Gladwin County",2,49,307,157,150
050,26,051,"Michigan","Gladwin County",2,50,316,156,160
050,26,051,"Michigan","Gladwin County",2,51,337,167,170
050,26,051,"Michigan","Gladwin County",2,52,327,159,168
050,26,051,"Michigan","Gladwin County",2,53,346,175,171
050,26,051,"Michigan","Gladwin County",2,54,354,182,172
050,26,051,"Michigan","Gladwin County",2,55,353,187,166
050,26,051,"Michigan","Gladwin County",2,56,378,200,178
050,26,051,"Michigan","Gladwin County",2,57,390,204,186
050,26,051,"Michigan","Gladwin County",2,58,406,214,192
050,26,051,"Michigan","Gladwin County",2,59,455,230,225
050,26,051,"Michigan","Gladwin County",2,60,464,235,229
050,26,051,"Michigan","Gladwin County",2,61,485,242,243
050,26,051,"Michigan","Gladwin County",2,62,496,247,249
050,26,051,"Michigan","Gladwin County",2,63,501,256,245
050,26,051,"Michigan","Gladwin County",2,64,449,219,230
050,26,051,"Michigan","Gladwin County",2,65,452,222,230
050,26,051,"Michigan","Gladwin County",2,66,474,227,247
050,26,051,"Michigan","Gladwin County",2,67,464,223,241
050,26,051,"Michigan","Gladwin County",2,68,436,217,219
050,26,051,"Michigan","Gladwin County",2,69,421,210,211
050,26,051,"Michigan","Gladwin County",2,70,405,196,209
050,26,051,"Michigan","Gladwin County",2,71,417,203,214
050,26,051,"Michigan","Gladwin County",2,72,398,204,194
050,26,051,"Michigan","Gladwin County",2,73,408,222,186
050,26,051,"Michigan","Gladwin County",2,74,259,130,129
050,26,051,"Michigan","Gladwin County",2,75,262,123,139
050,26,051,"Michigan","Gladwin County",2,76,281,148,133
050,26,051,"Michigan","Gladwin County",2,77,303,157,146
050,26,051,"Michigan","Gladwin County",2,78,238,120,118
050,26,051,"Michigan","Gladwin County",2,79,202,95,107
050,26,051,"Michigan","Gladwin County",2,80,184,83,101
050,26,051,"Michigan","Gladwin County",2,81,186,89,97
050,26,051,"Michigan","Gladwin County",2,82,175,87,88
050,26,051,"Michigan","Gladwin County",2,83,143,71,72
050,26,051,"Michigan","Gladwin County",2,84,110,51,59
050,26,051,"Michigan","Gladwin County",2,85,602,231,371
050,26,051,"Michigan","Gladwin County",3,0,241,124,117
050,26,051,"Michigan","Gladwin County",3,1,238,121,117
050,26,051,"Michigan","Gladwin County",3,2,244,127,117
050,26,051,"Michigan","Gladwin County",3,3,255,128,127
050,26,051,"Michigan","Gladwin County",3,4,272,141,131
050,26,051,"Michigan","Gladwin County",3,5,293,144,149
050,26,051,"Michigan","Gladwin County",3,6,286,146,140
050,26,051,"Michigan","Gladwin County",3,7,257,137,120
050,26,051,"Michigan","Gladwin County",3,8,272,148,124
050,26,051,"Michigan","Gladwin County",3,9,249,133,116
050,26,051,"Michigan","Gladwin County",3,10,245,142,103
050,26,051,"Michigan","Gladwin County",3,11,282,170,112
050,26,051,"Michigan","Gladwin County",3,12,268,150,118
050,26,051,"Michigan","Gladwin County",3,13,289,150,139
050,26,051,"Michigan","Gladwin County",3,14,289,148,141
050,26,051,"Michigan","Gladwin County",3,15,279,150,129
050,26,051,"Michigan","Gladwin County",3,16,276,147,129
050,26,051,"Michigan","Gladwin County",3,17,272,148,124
050,26,051,"Michigan","Gladwin County",3,18,233,128,105
050,26,051,"Michigan","Gladwin County",3,19,194,101,93
050,26,051,"Michigan","Gladwin County",3,20,228,111,117
050,26,051,"Michigan","Gladwin County",3,21,219,117,102
050,26,051,"Michigan","Gladwin County",3,22,228,118,110
050,26,051,"Michigan","Gladwin County",3,23,214,107,107
050,26,051,"Michigan","Gladwin County",3,24,222,115,107
050,26,051,"Michigan","Gladwin County",3,25,193,99,94
050,26,051,"Michigan","Gladwin County",3,26,213,123,90
050,26,051,"Michigan","Gladwin County",3,27,239,114,125
050,26,051,"Michigan","Gladwin County",3,28,241,116,125
050,26,051,"Michigan","Gladwin County",3,29,246,128,118
050,26,051,"Michigan","Gladwin County",3,30,258,129,129
050,26,051,"Michigan","Gladwin County",3,31,269,143,126
050,26,051,"Michigan","Gladwin County",3,32,242,122,120
050,26,051,"Michigan","Gladwin County",3,33,233,114,119
050,26,051,"Michigan","Gladwin County",3,34,238,116,122
050,26,051,"Michigan","Gladwin County",3,35,231,116,115
050,26,051,"Michigan","Gladwin County",3,36,238,117,121
050,26,051,"Michigan","Gladwin County",3,37,258,137,121
050,26,051,"Michigan","Gladwin County",3,38,264,132,132
050,26,051,"Michigan","Gladwin County",3,39,243,128,115
050,26,051,"Michigan","Gladwin County",3,40,252,127,125
050,26,051,"Michigan","Gladwin County",3,41,256,123,133
050,26,051,"Michigan","Gladwin County",3,42,252,131,121
050,26,051,"Michigan","Gladwin County",3,43,246,125,121
050,26,051,"Michigan","Gladwin County",3,44,260,137,123
050,26,051,"Michigan","Gladwin County",3,45,247,126,121
050,26,051,"Michigan","Gladwin County",3,46,233,122,111
050,26,051,"Michigan","Gladwin County",3,47,257,136,121
050,26,051,"Michigan","Gladwin County",3,48,269,137,132
050,26,051,"Michigan","Gladwin County",3,49,291,147,144
050,26,051,"Michigan","Gladwin County",3,50,322,162,160
050,26,051,"Michigan","Gladwin County",3,51,319,157,162
050,26,051,"Michigan","Gladwin County",3,52,354,180,174
050,26,051,"Michigan","Gladwin County",3,53,328,154,174
050,26,051,"Michigan","Gladwin County",3,54,348,183,165
050,26,051,"Michigan","Gladwin County",3,55,355,179,176
050,26,051,"Michigan","Gladwin County",3,56,365,188,177
050,26,051,"Michigan","Gladwin County",3,57,392,199,193
050,26,051,"Michigan","Gladwin County",3,58,416,208,208
050,26,051,"Michigan","Gladwin County",3,59,423,219,204
050,26,051,"Michigan","Gladwin County",3,60,469,235,234
050,26,051,"Michigan","Gladwin County",3,61,472,239,233
050,26,051,"Michigan","Gladwin County",3,62,511,251,260
050,26,051,"Michigan","Gladwin County",3,63,500,251,249
050,26,051,"Michigan","Gladwin County",3,64,514,265,249
050,26,051,"Michigan","Gladwin County",3,65,451,220,231
050,26,051,"Michigan","Gladwin County",3,66,444,222,222
050,26,051,"Michigan","Gladwin County",3,67,467,226,241
050,26,051,"Michigan","Gladwin County",3,68,466,226,240
050,26,051,"Michigan","Gladwin County",3,69,428,218,210
050,26,051,"Michigan","Gladwin County",3,70,409,205,204
050,26,051,"Michigan","Gladwin County",3,71,390,188,202
050,26,051,"Michigan","Gladwin County",3,72,396,194,202
050,26,051,"Michigan","Gladwin County",3,73,387,198,189
050,26,051,"Michigan","Gladwin County",3,74,395,212,183
050,26,051,"Michigan","Gladwin County",3,75,255,128,127
050,26,051,"Michigan","Gladwin County",3,76,243,119,124
050,26,051,"Michigan","Gladwin County",3,77,264,135,129
050,26,051,"Michigan","Gladwin County",3,78,288,151,137
050,26,051,"Michigan","Gladwin County",3,79,227,115,112
050,26,051,"Michigan","Gladwin County",3,80,184,88,96
050,26,051,"Michigan","Gladwin County",3,81,168,73,95
050,26,051,"Michigan","Gladwin County",3,82,168,80,88
050,26,051,"Michigan","Gladwin County",3,83,153,83,70
050,26,051,"Michigan","Gladwin County",3,84,127,59,68
050,26,051,"Michigan","Gladwin County",3,85,563,221,342
050,26,051,"Michigan","Gladwin County",4,0,229,105,124
050,26,051,"Michigan","Gladwin County",4,1,256,128,128
050,26,051,"Michigan","Gladwin County",4,2,239,124,115
050,26,051,"Michigan","Gladwin County",4,3,253,132,121
050,26,051,"Michigan","Gladwin County",4,4,247,122,125
050,26,051,"Michigan","Gladwin County",4,5,287,147,140
050,26,051,"Michigan","Gladwin County",4,6,301,152,149
050,26,051,"Michigan","Gladwin County",4,7,291,150,141
050,26,051,"Michigan","Gladwin County",4,8,278,150,128
050,26,051,"Michigan","Gladwin County",4,9,276,149,127
050,26,051,"Michigan","Gladwin County",4,10,262,138,124
050,26,051,"Michigan","Gladwin County",4,11,256,144,112
050,26,051,"Michigan","Gladwin County",4,12,294,172,122
050,26,051,"Michigan","Gladwin County",4,13,271,151,120
050,26,051,"Michigan","Gladwin County",4,14,282,149,133
050,26,051,"Michigan","Gladwin County",4,15,299,157,142
050,26,051,"Michigan","Gladwin County",4,16,286,154,132
050,26,051,"Michigan","Gladwin County",4,17,281,148,133
050,26,051,"Michigan","Gladwin County",4,18,221,122,99
050,26,051,"Michigan","Gladwin County",4,19,172,91,81
050,26,051,"Michigan","Gladwin County",4,20,195,104,91
050,26,051,"Michigan","Gladwin County",4,21,235,108,127
050,26,051,"Michigan","Gladwin County",4,22,241,122,119
050,26,051,"Michigan","Gladwin County",4,23,220,114,106
050,26,051,"Michigan","Gladwin County",4,24,212,109,103
050,26,051,"Michigan","Gladwin County",4,25,220,111,109
050,26,051,"Michigan","Gladwin County",4,26,194,100,94
050,26,051,"Michigan","Gladwin County",4,27,224,126,98
050,26,051,"Michigan","Gladwin County",4,28,251,118,133
050,26,051,"Michigan","Gladwin County",4,29,240,114,126
050,26,051,"Michigan","Gladwin County",4,30,250,127,123
050,26,051,"Michigan","Gladwin County",4,31,271,136,135
050,26,051,"Michigan","Gladwin County",4,32,276,138,138
050,26,051,"Michigan","Gladwin County",4,33,244,121,123
050,26,051,"Michigan","Gladwin County",4,34,242,118,124
050,26,051,"Michigan","Gladwin County",4,35,248,128,120
050,26,051,"Michigan","Gladwin County",4,36,249,126,123
050,26,051,"Michigan","Gladwin County",4,37,246,123,123
050,26,051,"Michigan","Gladwin County",4,38,272,143,129
050,26,051,"Michigan","Gladwin County",4,39,262,130,132
050,26,051,"Michigan","Gladwin County",4,40,249,132,117
050,26,051,"Michigan","Gladwin County",4,41,251,118,133
050,26,051,"Michigan","Gladwin County",4,42,254,122,132
050,26,051,"Michigan","Gladwin County",4,43,247,126,121
050,26,051,"Michigan","Gladwin County",4,44,250,128,122
050,26,051,"Michigan","Gladwin County",4,45,267,145,122
050,26,051,"Michigan","Gladwin County",4,46,245,122,123
050,26,051,"Michigan","Gladwin County",4,47,240,124,116
050,26,051,"Michigan","Gladwin County",4,48,259,140,119
050,26,051,"Michigan","Gladwin County",4,49,265,133,132
050,26,051,"Michigan","Gladwin County",4,50,297,149,148
050,26,051,"Michigan","Gladwin County",4,51,326,169,157
050,26,051,"Michigan","Gladwin County",4,52,317,155,162
050,26,051,"Michigan","Gladwin County",4,53,359,187,172
050,26,051,"Michigan","Gladwin County",4,54,357,168,189
050,26,051,"Michigan","Gladwin County",4,55,354,186,168
050,26,051,"Michigan","Gladwin County",4,56,378,186,192
050,26,051,"Michigan","Gladwin County",4,57,368,183,185
050,26,051,"Michigan","Gladwin County",4,58,410,209,201
050,26,051,"Michigan","Gladwin County",4,59,438,223,215
050,26,051,"Michigan","Gladwin County",4,60,429,221,208
050,26,051,"Michigan","Gladwin County",4,61,484,236,248
050,26,051,"Michigan","Gladwin County",4,62,473,232,241
050,26,051,"Michigan","Gladwin County",4,63,519,253,266
050,26,051,"Michigan","Gladwin County",4,64,520,260,260
050,26,051,"Michigan","Gladwin County",4,65,525,273,252
050,26,051,"Michigan","Gladwin County",4,66,453,223,230
050,26,051,"Michigan","Gladwin County",4,67,451,233,218
050,26,051,"Michigan","Gladwin County",4,68,459,222,237
050,26,051,"Michigan","Gladwin County",4,69,451,216,235
050,26,051,"Michigan","Gladwin County",4,70,410,216,194
050,26,051,"Michigan","Gladwin County",4,71,397,196,201
050,26,051,"Michigan","Gladwin County",4,72,367,180,187
050,26,051,"Michigan","Gladwin County",4,73,388,187,201
050,26,051,"Michigan","Gladwin County",4,74,374,188,186
050,26,051,"Michigan","Gladwin County",4,75,369,197,172
050,26,051,"Michigan","Gladwin County",4,76,241,129,112
050,26,051,"Michigan","Gladwin County",4,77,227,104,123
050,26,051,"Michigan","Gladwin County",4,78,246,127,119
050,26,051,"Michigan","Gladwin County",4,79,271,140,131
050,26,051,"Michigan","Gladwin County",4,80,197,101,96
050,26,051,"Michigan","Gladwin County",4,81,172,80,92
050,26,051,"Michigan","Gladwin County",4,82,152,69,83
050,26,051,"Michigan","Gladwin County",4,83,157,78,79
050,26,051,"Michigan","Gladwin County",4,84,142,75,67
050,26,051,"Michigan","Gladwin County",4,85,543,222,321
050,26,051,"Michigan","Gladwin County",5,0,227,103,124
050,26,051,"Michigan","Gladwin County",5,1,249,124,125
050,26,051,"Michigan","Gladwin County",5,2,268,137,131
050,26,051,"Michigan","Gladwin County",5,3,245,130,115
050,26,051,"Michigan","Gladwin County",5,4,271,146,125
050,26,051,"Michigan","Gladwin County",5,5,257,131,126
050,26,051,"Michigan","Gladwin County",5,6,291,152,139
050,26,051,"Michigan","Gladwin County",5,7,300,152,148
050,26,051,"Michigan","Gladwin County",5,8,292,149,143
050,26,051,"Michigan","Gladwin County",5,9,278,153,125
050,26,051,"Michigan","Gladwin County",5,10,287,159,128
050,26,051,"Michigan","Gladwin County",5,11,259,138,121
050,26,051,"Michigan","Gladwin County",5,12,256,141,115
050,26,051,"Michigan","Gladwin County",5,13,299,177,122
050,26,051,"Michigan","Gladwin County",5,14,283,156,127
050,26,051,"Michigan","Gladwin County",5,15,283,154,129
050,26,051,"Michigan","Gladwin County",5,16,304,155,149
050,26,051,"Michigan","Gladwin County",5,17,284,154,130
050,26,051,"Michigan","Gladwin County",5,18,230,122,108
050,26,051,"Michigan","Gladwin County",5,19,175,95,80
050,26,051,"Michigan","Gladwin County",5,20,185,104,81
050,26,051,"Michigan","Gladwin County",5,21,209,113,96
050,26,051,"Michigan","Gladwin County",5,22,247,114,133
050,26,051,"Michigan","Gladwin County",5,23,247,123,124
050,26,051,"Michigan","Gladwin County",5,24,230,119,111
050,26,051,"Michigan","Gladwin County",5,25,218,110,108
050,26,051,"Michigan","Gladwin County",5,26,223,108,115
050,26,051,"Michigan","Gladwin County",5,27,194,102,92
050,26,051,"Michigan","Gladwin County",5,28,224,124,100
050,26,051,"Michigan","Gladwin County",5,29,249,119,130
050,26,051,"Michigan","Gladwin County",5,30,252,116,136
050,26,051,"Michigan","Gladwin County",5,31,263,135,128
050,26,051,"Michigan","Gladwin County",5,32,278,147,131
050,26,051,"Michigan","Gladwin County",5,33,273,136,137
050,26,051,"Michigan","Gladwin County",5,34,246,121,125
050,26,051,"Michigan","Gladwin County",5,35,245,124,121
050,26,051,"Michigan","Gladwin County",5,36,245,124,121
050,26,051,"Michigan","Gladwin County",5,37,270,141,129
050,26,051,"Michigan","Gladwin County",5,38,254,123,131
050,26,051,"Michigan","Gladwin County",5,39,273,144,129
050,26,051,"Michigan","Gladwin County",5,40,277,135,142
050,26,051,"Michigan","Gladwin County",5,41,263,135,128
050,26,051,"Michigan","Gladwin County",5,42,253,122,131
050,26,051,"Michigan","Gladwin County",5,43,269,131,138
050,26,051,"Michigan","Gladwin County",5,44,240,123,117
050,26,051,"Michigan","Gladwin County",5,45,250,128,122
050,26,051,"Michigan","Gladwin County",5,46,278,145,133
050,26,051,"Michigan","Gladwin County",5,47,253,126,127
050,26,051,"Michigan","Gladwin County",5,48,239,127,112
050,26,051,"Michigan","Gladwin County",5,49,263,143,120
050,26,051,"Michigan","Gladwin County",5,50,273,133,140
050,26,051,"Michigan","Gladwin County",5,51,303,155,148
050,26,051,"Michigan","Gladwin County",5,52,340,176,164
050,26,051,"Michigan","Gladwin County",5,53,320,160,160
050,26,051,"Michigan","Gladwin County",5,54,375,194,181
050,26,051,"Michigan","Gladwin County",5,55,370,171,199
050,26,051,"Michigan","Gladwin County",5,56,367,190,177
050,26,051,"Michigan","Gladwin County",5,57,385,184,201
050,26,051,"Michigan","Gladwin County",5,58,391,198,193
050,26,051,"Michigan","Gladwin County",5,59,422,214,208
050,26,051,"Michigan","Gladwin County",5,60,450,228,222
050,26,051,"Michigan","Gladwin County",5,61,452,238,214
050,26,051,"Michigan","Gladwin County",5,62,492,240,252
050,26,051,"Michigan","Gladwin County",5,63,479,236,243
050,26,051,"Michigan","Gladwin County",5,64,540,259,281
050,26,051,"Michigan","Gladwin County",5,65,528,267,261
050,26,051,"Michigan","Gladwin County",5,66,536,273,263
050,26,051,"Michigan","Gladwin County",5,67,452,225,227
050,26,051,"Michigan","Gladwin County",5,68,452,227,225
050,26,051,"Michigan","Gladwin County",5,69,447,219,228
050,26,051,"Michigan","Gladwin County",5,70,448,219,229
050,26,051,"Michigan","Gladwin County",5,71,397,215,182
050,26,051,"Michigan","Gladwin County",5,72,383,194,189
050,26,051,"Michigan","Gladwin County",5,73,357,173,184
050,26,051,"Michigan","Gladwin County",5,74,365,175,190
050,26,051,"Michigan","Gladwin County",5,75,357,183,174
050,26,051,"Michigan","Gladwin County",5,76,346,190,156
050,26,051,"Michigan","Gladwin County",5,77,221,114,107
050,26,051,"Michigan","Gladwin County",5,78,202,92,110
050,26,051,"Michigan","Gladwin County",5,79,235,120,115
050,26,051,"Michigan","Gladwin County",5,80,240,122,118
050,26,051,"Michigan","Gladwin County",5,81,186,95,91
050,26,051,"Michigan","Gladwin County",5,82,153,70,83
050,26,051,"Michigan","Gladwin County",5,83,142,66,76
050,26,051,"Michigan","Gladwin County",5,84,145,70,75
050,26,051,"Michigan","Gladwin County",5,85,554,240,314
050,26,053,"Michigan","Gogebic County",1,0,131,67,64
050,26,053,"Michigan","Gogebic County",1,1,123,59,64
050,26,053,"Michigan","Gogebic County",1,2,112,54,58
050,26,053,"Michigan","Gogebic County",1,3,119,61,58
050,26,053,"Michigan","Gogebic County",1,4,123,67,56
050,26,053,"Michigan","Gogebic County",1,5,140,71,69
050,26,053,"Michigan","Gogebic County",1,6,120,62,58
050,26,053,"Michigan","Gogebic County",1,7,117,59,58
050,26,053,"Michigan","Gogebic County",1,8,135,73,62
050,26,053,"Michigan","Gogebic County",1,9,140,69,71
050,26,053,"Michigan","Gogebic County",1,10,139,72,67
050,26,053,"Michigan","Gogebic County",1,11,153,69,84
050,26,053,"Michigan","Gogebic County",1,12,157,75,82
050,26,053,"Michigan","Gogebic County",1,13,153,84,69
050,26,053,"Michigan","Gogebic County",1,14,140,70,70
050,26,053,"Michigan","Gogebic County",1,15,144,79,65
050,26,053,"Michigan","Gogebic County",1,16,151,79,72
050,26,053,"Michigan","Gogebic County",1,17,142,66,76
050,26,053,"Michigan","Gogebic County",1,18,130,72,58
050,26,053,"Michigan","Gogebic County",1,19,116,68,48
050,26,053,"Michigan","Gogebic County",1,20,121,67,54
050,26,053,"Michigan","Gogebic County",1,21,111,55,56
050,26,053,"Michigan","Gogebic County",1,22,119,55,64
050,26,053,"Michigan","Gogebic County",1,23,131,74,57
050,26,053,"Michigan","Gogebic County",1,24,134,76,58
050,26,053,"Michigan","Gogebic County",1,25,138,70,68
050,26,053,"Michigan","Gogebic County",1,26,144,78,66
050,26,053,"Michigan","Gogebic County",1,27,127,70,57
050,26,053,"Michigan","Gogebic County",1,28,121,68,53
050,26,053,"Michigan","Gogebic County",1,29,147,73,74
050,26,053,"Michigan","Gogebic County",1,30,145,71,74
050,26,053,"Michigan","Gogebic County",1,31,154,64,90
050,26,053,"Michigan","Gogebic County",1,32,133,76,57
050,26,053,"Michigan","Gogebic County",1,33,120,59,61
050,26,053,"Michigan","Gogebic County",1,34,141,72,69
050,26,053,"Michigan","Gogebic County",1,35,142,73,69
050,26,053,"Michigan","Gogebic County",1,36,152,83,69
050,26,053,"Michigan","Gogebic County",1,37,137,78,59
050,26,053,"Michigan","Gogebic County",1,38,146,82,64
050,26,053,"Michigan","Gogebic County",1,39,158,83,75
050,26,053,"Michigan","Gogebic County",1,40,162,83,79
050,26,053,"Michigan","Gogebic County",1,41,147,72,75
050,26,053,"Michigan","Gogebic County",1,42,148,70,78
050,26,053,"Michigan","Gogebic County",1,43,103,55,48
050,26,053,"Michigan","Gogebic County",1,44,134,76,58
050,26,053,"Michigan","Gogebic County",1,45,147,87,60
050,26,053,"Michigan","Gogebic County",1,46,147,76,71
050,26,053,"Michigan","Gogebic County",1,47,148,75,73
050,26,053,"Michigan","Gogebic County",1,48,170,86,84
050,26,053,"Michigan","Gogebic County",1,49,159,81,78
050,26,053,"Michigan","Gogebic County",1,50,179,92,87
050,26,053,"Michigan","Gogebic County",1,51,198,101,97
050,26,053,"Michigan","Gogebic County",1,52,185,89,96
050,26,053,"Michigan","Gogebic County",1,53,184,96,88
050,26,053,"Michigan","Gogebic County",1,54,203,106,97
050,26,053,"Michigan","Gogebic County",1,55,209,109,100
050,26,053,"Michigan","Gogebic County",1,56,220,116,104
050,26,053,"Michigan","Gogebic County",1,57,236,119,117
050,26,053,"Michigan","Gogebic County",1,58,242,111,131
050,26,053,"Michigan","Gogebic County",1,59,263,115,148
050,26,053,"Michigan","Gogebic County",1,60,262,133,129
050,26,053,"Michigan","Gogebic County",1,61,275,142,133
050,26,053,"Michigan","Gogebic County",1,62,264,146,118
050,26,053,"Michigan","Gogebic County",1,63,268,142,126
050,26,053,"Michigan","Gogebic County",1,64,254,138,116
050,26,053,"Michigan","Gogebic County",1,65,261,133,128
050,26,053,"Michigan","Gogebic County",1,66,269,138,131
050,26,053,"Michigan","Gogebic County",1,67,274,139,135
050,26,053,"Michigan","Gogebic County",1,68,253,136,117
050,26,053,"Michigan","Gogebic County",1,69,248,134,114
050,26,053,"Michigan","Gogebic County",1,70,242,139,103
050,26,053,"Michigan","Gogebic County",1,71,232,134,98
050,26,053,"Michigan","Gogebic County",1,72,244,131,113
050,26,053,"Michigan","Gogebic County",1,73,229,120,109
050,26,053,"Michigan","Gogebic County",1,74,155,81,74
050,26,053,"Michigan","Gogebic County",1,75,155,80,75
050,26,053,"Michigan","Gogebic County",1,76,157,77,80
050,26,053,"Michigan","Gogebic County",1,77,158,85,73
050,26,053,"Michigan","Gogebic County",1,78,127,60,67
050,26,053,"Michigan","Gogebic County",1,79,110,60,50
050,26,053,"Michigan","Gogebic County",1,80,99,46,53
050,26,053,"Michigan","Gogebic County",1,81,97,39,58
050,26,053,"Michigan","Gogebic County",1,82,89,36,53
050,26,053,"Michigan","Gogebic County",1,83,81,37,44
050,26,053,"Michigan","Gogebic County",1,84,89,39,50
050,26,053,"Michigan","Gogebic County",1,85,494,178,316
050,26,053,"Michigan","Gogebic County",2,0,126,62,64
050,26,053,"Michigan","Gogebic County",2,1,123,59,64
050,26,053,"Michigan","Gogebic County",2,2,112,54,58
050,26,053,"Michigan","Gogebic County",2,3,116,59,57
050,26,053,"Michigan","Gogebic County",2,4,124,66,58
050,26,053,"Michigan","Gogebic County",2,5,135,69,66
050,26,053,"Michigan","Gogebic County",2,6,126,64,62
050,26,053,"Michigan","Gogebic County",2,7,117,58,59
050,26,053,"Michigan","Gogebic County",2,8,130,68,62
050,26,053,"Michigan","Gogebic County",2,9,139,69,70
050,26,053,"Michigan","Gogebic County",2,10,140,72,68
050,26,053,"Michigan","Gogebic County",2,11,147,68,79
050,26,053,"Michigan","Gogebic County",2,12,156,73,83
050,26,053,"Michigan","Gogebic County",2,13,152,80,72
050,26,053,"Michigan","Gogebic County",2,14,143,73,70
050,26,053,"Michigan","Gogebic County",2,15,145,79,66
050,26,053,"Michigan","Gogebic County",2,16,149,78,71
050,26,053,"Michigan","Gogebic County",2,17,145,69,76
050,26,053,"Michigan","Gogebic County",2,18,127,68,59
050,26,053,"Michigan","Gogebic County",2,19,118,69,49
050,26,053,"Michigan","Gogebic County",2,20,119,67,52
050,26,053,"Michigan","Gogebic County",2,21,109,54,55
050,26,053,"Michigan","Gogebic County",2,22,115,53,62
050,26,053,"Michigan","Gogebic County",2,23,127,69,58
050,26,053,"Michigan","Gogebic County",2,24,136,76,60
050,26,053,"Michigan","Gogebic County",2,25,136,70,66
050,26,053,"Michigan","Gogebic County",2,26,142,76,66
050,26,053,"Michigan","Gogebic County",2,27,132,73,59
050,26,053,"Michigan","Gogebic County",2,28,123,69,54
050,26,053,"Michigan","Gogebic County",2,29,141,72,69
050,26,053,"Michigan","Gogebic County",2,30,148,73,75
050,26,053,"Michigan","Gogebic County",2,31,151,66,85
050,26,053,"Michigan","Gogebic County",2,32,137,73,64
050,26,053,"Michigan","Gogebic County",2,33,123,63,60
050,26,053,"Michigan","Gogebic County",2,34,137,70,67
050,26,053,"Michigan","Gogebic County",2,35,143,73,70
050,26,053,"Michigan","Gogebic County",2,36,148,81,67
050,26,053,"Michigan","Gogebic County",2,37,143,81,62
050,26,053,"Michigan","Gogebic County",2,38,144,81,63
050,26,053,"Michigan","Gogebic County",2,39,154,82,72
050,26,053,"Michigan","Gogebic County",2,40,161,82,79
050,26,053,"Michigan","Gogebic County",2,41,151,74,77
050,26,053,"Michigan","Gogebic County",2,42,146,70,76
050,26,053,"Michigan","Gogebic County",2,43,116,61,55
050,26,053,"Michigan","Gogebic County",2,44,123,70,53
050,26,053,"Michigan","Gogebic County",2,45,145,84,61
050,26,053,"Michigan","Gogebic County",2,46,147,79,68
050,26,053,"Michigan","Gogebic County",2,47,146,74,72
050,26,053,"Michigan","Gogebic County",2,48,166,85,81
050,26,053,"Michigan","Gogebic County",2,49,163,82,81
050,26,053,"Michigan","Gogebic County",2,50,176,90,86
050,26,053,"Michigan","Gogebic County",2,51,195,99,96
050,26,053,"Michigan","Gogebic County",2,52,188,91,97
050,26,053,"Michigan","Gogebic County",2,53,184,95,89
050,26,053,"Michigan","Gogebic County",2,54,199,104,95
050,26,053,"Michigan","Gogebic County",2,55,208,108,100
050,26,053,"Michigan","Gogebic County",2,56,216,113,103
050,26,053,"Michigan","Gogebic County",2,57,233,118,115
050,26,053,"Michigan","Gogebic County",2,58,240,112,128
050,26,053,"Michigan","Gogebic County",2,59,260,115,145
050,26,053,"Michigan","Gogebic County",2,60,264,129,135
050,26,053,"Michigan","Gogebic County",2,61,271,140,131
050,26,053,"Michigan","Gogebic County",2,62,265,143,122
050,26,053,"Michigan","Gogebic County",2,63,270,144,126
050,26,053,"Michigan","Gogebic County",2,64,256,138,118
050,26,053,"Michigan","Gogebic County",2,65,258,133,125
050,26,053,"Michigan","Gogebic County",2,66,266,136,130
050,26,053,"Michigan","Gogebic County",2,67,273,139,134
050,26,053,"Michigan","Gogebic County",2,68,256,136,120
050,26,053,"Michigan","Gogebic County",2,69,249,133,116
050,26,053,"Michigan","Gogebic County",2,70,244,139,105
050,26,053,"Michigan","Gogebic County",2,71,234,137,97
050,26,053,"Michigan","Gogebic County",2,72,235,127,108
050,26,053,"Michigan","Gogebic County",2,73,242,128,114
050,26,053,"Michigan","Gogebic County",2,74,162,84,78
050,26,053,"Michigan","Gogebic County",2,75,153,79,74
050,26,053,"Michigan","Gogebic County",2,76,153,76,77
050,26,053,"Michigan","Gogebic County",2,77,162,85,77
050,26,053,"Michigan","Gogebic County",2,78,130,64,66
050,26,053,"Michigan","Gogebic County",2,79,112,60,52
050,26,053,"Michigan","Gogebic County",2,80,100,48,52
050,26,053,"Michigan","Gogebic County",2,81,95,39,56
050,26,053,"Michigan","Gogebic County",2,82,92,36,56
050,26,053,"Michigan","Gogebic County",2,83,82,38,44
050,26,053,"Michigan","Gogebic County",2,84,87,37,50
050,26,053,"Michigan","Gogebic County",2,85,494,181,313
050,26,053,"Michigan","Gogebic County",3,0,89,45,44
050,26,053,"Michigan","Gogebic County",3,1,120,62,58
050,26,053,"Michigan","Gogebic County",3,2,123,60,63
050,26,053,"Michigan","Gogebic County",3,3,122,62,60
050,26,053,"Michigan","Gogebic County",3,4,128,65,63
050,26,053,"Michigan","Gogebic County",3,5,127,70,57
050,26,053,"Michigan","Gogebic County",3,6,133,69,64
050,26,053,"Michigan","Gogebic County",3,7,132,71,61
050,26,053,"Michigan","Gogebic County",3,8,117,58,59
050,26,053,"Michigan","Gogebic County",3,9,132,68,64
050,26,053,"Michigan","Gogebic County",3,10,146,76,70
050,26,053,"Michigan","Gogebic County",3,11,135,70,65
050,26,053,"Michigan","Gogebic County",3,12,151,70,81
050,26,053,"Michigan","Gogebic County",3,13,157,72,85
050,26,053,"Michigan","Gogebic County",3,14,152,82,70
050,26,053,"Michigan","Gogebic County",3,15,144,74,70
050,26,053,"Michigan","Gogebic County",3,16,149,81,68
050,26,053,"Michigan","Gogebic County",3,17,148,79,69
050,26,053,"Michigan","Gogebic County",3,18,136,66,70
050,26,053,"Michigan","Gogebic County",3,19,125,71,54
050,26,053,"Michigan","Gogebic County",3,20,117,67,50
050,26,053,"Michigan","Gogebic County",3,21,112,58,54
050,26,053,"Michigan","Gogebic County",3,22,112,55,57
050,26,053,"Michigan","Gogebic County",3,23,123,55,68
050,26,053,"Michigan","Gogebic County",3,24,135,80,55
050,26,053,"Michigan","Gogebic County",3,25,133,75,58
050,26,053,"Michigan","Gogebic County",3,26,148,76,72
050,26,053,"Michigan","Gogebic County",3,27,144,79,65
050,26,053,"Michigan","Gogebic County",3,28,125,72,53
050,26,053,"Michigan","Gogebic County",3,29,140,78,62
050,26,053,"Michigan","Gogebic County",3,30,145,71,74
050,26,053,"Michigan","Gogebic County",3,31,146,71,75
050,26,053,"Michigan","Gogebic County",3,32,155,66,89
050,26,053,"Michigan","Gogebic County",3,33,155,87,68
050,26,053,"Michigan","Gogebic County",3,34,120,59,61
050,26,053,"Michigan","Gogebic County",3,35,149,77,72
050,26,053,"Michigan","Gogebic County",3,36,147,73,74
050,26,053,"Michigan","Gogebic County",3,37,153,80,73
050,26,053,"Michigan","Gogebic County",3,38,142,80,62
050,26,053,"Michigan","Gogebic County",3,39,144,82,62
050,26,053,"Michigan","Gogebic County",3,40,158,85,73
050,26,053,"Michigan","Gogebic County",3,41,162,85,77
050,26,053,"Michigan","Gogebic County",3,42,153,72,81
050,26,053,"Michigan","Gogebic County",3,43,148,73,75
050,26,053,"Michigan","Gogebic County",3,44,124,62,62
050,26,053,"Michigan","Gogebic County",3,45,124,70,54
050,26,053,"Michigan","Gogebic County",3,46,148,83,65
050,26,053,"Michigan","Gogebic County",3,47,149,80,69
050,26,053,"Michigan","Gogebic County",3,48,146,72,74
050,26,053,"Michigan","Gogebic County",3,49,163,84,79
050,26,053,"Michigan","Gogebic County",3,50,163,84,79
050,26,053,"Michigan","Gogebic County",3,51,182,94,88
050,26,053,"Michigan","Gogebic County",3,52,195,98,97
050,26,053,"Michigan","Gogebic County",3,53,192,95,97
050,26,053,"Michigan","Gogebic County",3,54,190,101,89
050,26,053,"Michigan","Gogebic County",3,55,199,106,93
050,26,053,"Michigan","Gogebic County",3,56,213,110,103
050,26,053,"Michigan","Gogebic County",3,57,222,114,108
050,26,053,"Michigan","Gogebic County",3,58,238,121,117
050,26,053,"Michigan","Gogebic County",3,59,242,111,131
050,26,053,"Michigan","Gogebic County",3,60,255,118,137
050,26,053,"Michigan","Gogebic County",3,61,257,121,136
050,26,053,"Michigan","Gogebic County",3,62,267,140,127
050,26,053,"Michigan","Gogebic County",3,63,278,154,124
050,26,053,"Michigan","Gogebic County",3,64,268,143,125
050,26,053,"Michigan","Gogebic County",3,65,258,145,113
050,26,053,"Michigan","Gogebic County",3,66,253,129,124
050,26,053,"Michigan","Gogebic County",3,67,271,137,134
050,26,053,"Michigan","Gogebic County",3,68,267,137,130
050,26,053,"Michigan","Gogebic County",3,69,251,132,119
050,26,053,"Michigan","Gogebic County",3,70,242,128,114
050,26,053,"Michigan","Gogebic County",3,71,234,132,102
050,26,053,"Michigan","Gogebic County",3,72,230,132,98
050,26,053,"Michigan","Gogebic County",3,73,231,124,107
050,26,053,"Michigan","Gogebic County",3,74,231,117,114
050,26,053,"Michigan","Gogebic County",3,75,154,80,74
050,26,053,"Michigan","Gogebic County",3,76,145,74,71
050,26,053,"Michigan","Gogebic County",3,77,148,74,74
050,26,053,"Michigan","Gogebic County",3,78,152,78,74
050,26,053,"Michigan","Gogebic County",3,79,112,57,55
050,26,053,"Michigan","Gogebic County",3,80,105,57,48
050,26,053,"Michigan","Gogebic County",3,81,91,42,49
050,26,053,"Michigan","Gogebic County",3,82,89,34,55
050,26,053,"Michigan","Gogebic County",3,83,84,37,47
050,26,053,"Michigan","Gogebic County",3,84,83,36,47
050,26,053,"Michigan","Gogebic County",3,85,489,182,307
050,26,053,"Michigan","Gogebic County",4,0,98,45,53
050,26,053,"Michigan","Gogebic County",4,1,96,54,42
050,26,053,"Michigan","Gogebic County",4,2,116,58,58
050,26,053,"Michigan","Gogebic County",4,3,130,59,71
050,26,053,"Michigan","Gogebic County",4,4,112,58,54
050,26,053,"Michigan","Gogebic County",4,5,124,63,61
050,26,053,"Michigan","Gogebic County",4,6,125,71,54
050,26,053,"Michigan","Gogebic County",4,7,132,69,63
050,26,053,"Michigan","Gogebic County",4,8,135,72,63
050,26,053,"Michigan","Gogebic County",4,9,119,59,60
050,26,053,"Michigan","Gogebic County",4,10,135,71,64
050,26,053,"Michigan","Gogebic County",4,11,145,77,68
050,26,053,"Michigan","Gogebic County",4,12,145,70,75
050,26,053,"Michigan","Gogebic County",4,13,149,71,78
050,26,053,"Michigan","Gogebic County",4,14,162,77,85
050,26,053,"Michigan","Gogebic County",4,15,160,82,78
050,26,053,"Michigan","Gogebic County",4,16,144,74,70
050,26,053,"Michigan","Gogebic County",4,17,152,84,68
050,26,053,"Michigan","Gogebic County",4,18,136,74,62
050,26,053,"Michigan","Gogebic County",4,19,124,65,59
050,26,053,"Michigan","Gogebic County",4,20,123,69,54
050,26,053,"Michigan","Gogebic County",4,21,106,57,49
050,26,053,"Michigan","Gogebic County",4,22,121,67,54
050,26,053,"Michigan","Gogebic County",4,23,111,56,55
050,26,053,"Michigan","Gogebic County",4,24,127,63,64
050,26,053,"Michigan","Gogebic County",4,25,128,75,53
050,26,053,"Michigan","Gogebic County",4,26,135,76,59
050,26,053,"Michigan","Gogebic County",4,27,142,74,68
050,26,053,"Michigan","Gogebic County",4,28,147,75,72
050,26,053,"Michigan","Gogebic County",4,29,124,70,54
050,26,053,"Michigan","Gogebic County",4,30,151,83,68
050,26,053,"Michigan","Gogebic County",4,31,153,77,76
050,26,053,"Michigan","Gogebic County",4,32,154,77,77
050,26,053,"Michigan","Gogebic County",4,33,161,69,92
050,26,053,"Michigan","Gogebic County",4,34,160,88,72
050,26,053,"Michigan","Gogebic County",4,35,121,60,61
050,26,053,"Michigan","Gogebic County",4,36,151,80,71
050,26,053,"Michigan","Gogebic County",4,37,157,79,78
050,26,053,"Michigan","Gogebic County",4,38,154,78,76
050,26,053,"Michigan","Gogebic County",4,39,144,82,62
050,26,053,"Michigan","Gogebic County",4,40,148,85,63
050,26,053,"Michigan","Gogebic County",4,41,158,84,74
050,26,053,"Michigan","Gogebic County",4,42,165,85,80
050,26,053,"Michigan","Gogebic County",4,43,159,75,84
050,26,053,"Michigan","Gogebic County",4,44,148,73,75
050,26,053,"Michigan","Gogebic County",4,45,124,60,64
050,26,053,"Michigan","Gogebic County",4,46,123,72,51
050,26,053,"Michigan","Gogebic County",4,47,158,88,70
050,26,053,"Michigan","Gogebic County",4,48,160,87,73
050,26,053,"Michigan","Gogebic County",4,49,142,72,70
050,26,053,"Michigan","Gogebic County",4,50,169,90,79
050,26,053,"Michigan","Gogebic County",4,51,170,87,83
050,26,053,"Michigan","Gogebic County",4,52,185,93,92
050,26,053,"Michigan","Gogebic County",4,53,196,102,94
050,26,053,"Michigan","Gogebic County",4,54,186,90,96
050,26,053,"Michigan","Gogebic County",4,55,196,103,93
050,26,053,"Michigan","Gogebic County",4,56,207,108,99
050,26,053,"Michigan","Gogebic County",4,57,217,114,103
050,26,053,"Michigan","Gogebic County",4,58,230,113,117
050,26,053,"Michigan","Gogebic County",4,59,243,126,117
050,26,053,"Michigan","Gogebic County",4,60,238,111,127
050,26,053,"Michigan","Gogebic County",4,61,262,124,138
050,26,053,"Michigan","Gogebic County",4,62,265,119,146
050,26,053,"Michigan","Gogebic County",4,63,266,136,130
050,26,053,"Michigan","Gogebic County",4,64,277,155,122
050,26,053,"Michigan","Gogebic County",4,65,269,145,124
050,26,053,"Michigan","Gogebic County",4,66,252,138,114
050,26,053,"Michigan","Gogebic County",4,67,249,128,121
050,26,053,"Michigan","Gogebic County",4,68,266,133,133
050,26,053,"Michigan","Gogebic County",4,69,255,135,120
050,26,053,"Michigan","Gogebic County",4,70,243,125,118
050,26,053,"Michigan","Gogebic County",4,71,231,122,109
050,26,053,"Michigan","Gogebic County",4,72,234,132,102
050,26,053,"Michigan","Gogebic County",4,73,224,130,94
050,26,053,"Michigan","Gogebic County",4,74,219,118,101
050,26,053,"Michigan","Gogebic County",4,75,225,115,110
050,26,053,"Michigan","Gogebic County",4,76,146,74,72
050,26,053,"Michigan","Gogebic County",4,77,141,73,68
050,26,053,"Michigan","Gogebic County",4,78,130,61,69
050,26,053,"Michigan","Gogebic County",4,79,145,75,70
050,26,053,"Michigan","Gogebic County",4,80,112,59,53
050,26,053,"Michigan","Gogebic County",4,81,93,48,45
050,26,053,"Michigan","Gogebic County",4,82,87,39,48
050,26,053,"Michigan","Gogebic County",4,83,81,36,45
050,26,053,"Michigan","Gogebic County",4,84,83,32,51
050,26,053,"Michigan","Gogebic County",4,85,491,186,305
050,26,053,"Michigan","Gogebic County",5,0,77,36,41
050,26,053,"Michigan","Gogebic County",5,1,100,48,52
050,26,053,"Michigan","Gogebic County",5,2,97,54,43
050,26,053,"Michigan","Gogebic County",5,3,117,57,60
050,26,053,"Michigan","Gogebic County",5,4,129,58,71
050,26,053,"Michigan","Gogebic County",5,5,113,64,49
050,26,053,"Michigan","Gogebic County",5,6,120,62,58
050,26,053,"Michigan","Gogebic County",5,7,121,66,55
050,26,053,"Michigan","Gogebic County",5,8,141,74,67
050,26,053,"Michigan","Gogebic County",5,9,130,71,59
050,26,053,"Michigan","Gogebic County",5,10,127,58,69
050,26,053,"Michigan","Gogebic County",5,11,128,70,58
050,26,053,"Michigan","Gogebic County",5,12,136,70,66
050,26,053,"Michigan","Gogebic County",5,13,141,69,72
050,26,053,"Michigan","Gogebic County",5,14,150,73,77
050,26,053,"Michigan","Gogebic County",5,15,166,82,84
050,26,053,"Michigan","Gogebic County",5,16,158,83,75
050,26,053,"Michigan","Gogebic County",5,17,148,76,72
050,26,053,"Michigan","Gogebic County",5,18,138,82,56
050,26,053,"Michigan","Gogebic County",5,19,118,68,50
050,26,053,"Michigan","Gogebic County",5,20,122,65,57
050,26,053,"Michigan","Gogebic County",5,21,120,62,58
050,26,053,"Michigan","Gogebic County",5,22,107,56,51
050,26,053,"Michigan","Gogebic County",5,23,117,67,50
050,26,053,"Michigan","Gogebic County",5,24,107,55,52
050,26,053,"Michigan","Gogebic County",5,25,119,60,59
050,26,053,"Michigan","Gogebic County",5,26,128,78,50
050,26,053,"Michigan","Gogebic County",5,27,135,73,62
050,26,053,"Michigan","Gogebic County",5,28,133,63,70
050,26,053,"Michigan","Gogebic County",5,29,146,77,69
050,26,053,"Michigan","Gogebic County",5,30,125,70,55
050,26,053,"Michigan","Gogebic County",5,31,148,80,68
050,26,053,"Michigan","Gogebic County",5,32,159,85,74
050,26,053,"Michigan","Gogebic County",5,33,146,70,76
050,26,053,"Michigan","Gogebic County",5,34,166,68,98
050,26,053,"Michigan","Gogebic County",5,35,166,92,74
050,26,053,"Michigan","Gogebic County",5,36,126,66,60
050,26,053,"Michigan","Gogebic County",5,37,150,81,69
050,26,053,"Michigan","Gogebic County",5,38,158,80,78
050,26,053,"Michigan","Gogebic County",5,39,148,74,74
050,26,053,"Michigan","Gogebic County",5,40,152,82,70
050,26,053,"Michigan","Gogebic County",5,41,150,84,66
050,26,053,"Michigan","Gogebic County",5,42,158,79,79
050,26,053,"Michigan","Gogebic County",5,43,164,81,83
050,26,053,"Michigan","Gogebic County",5,44,161,80,81
050,26,053,"Michigan","Gogebic County",5,45,146,76,70
050,26,053,"Michigan","Gogebic County",5,46,119,58,61
050,26,053,"Michigan","Gogebic County",5,47,132,75,57
050,26,053,"Michigan","Gogebic County",5,48,155,87,68
050,26,053,"Michigan","Gogebic County",5,49,155,83,72
050,26,053,"Michigan","Gogebic County",5,50,135,69,66
050,26,053,"Michigan","Gogebic County",5,51,169,92,77
050,26,053,"Michigan","Gogebic County",5,52,168,83,85
050,26,053,"Michigan","Gogebic County",5,53,185,96,89
050,26,053,"Michigan","Gogebic County",5,54,195,99,96
050,26,053,"Michigan","Gogebic County",5,55,190,92,98
050,26,053,"Michigan","Gogebic County",5,56,197,103,94
050,26,053,"Michigan","Gogebic County",5,57,213,112,101
050,26,053,"Michigan","Gogebic County",5,58,225,121,104
050,26,053,"Michigan","Gogebic County",5,59,229,108,121
050,26,053,"Michigan","Gogebic County",5,60,242,123,119
050,26,053,"Michigan","Gogebic County",5,61,238,112,126
050,26,053,"Michigan","Gogebic County",5,62,262,120,142
050,26,053,"Michigan","Gogebic County",5,63,267,123,144
050,26,053,"Michigan","Gogebic County",5,64,259,130,129
050,26,053,"Michigan","Gogebic County",5,65,282,156,126
050,26,053,"Michigan","Gogebic County",5,66,260,141,119
050,26,053,"Michigan","Gogebic County",5,67,251,138,113
050,26,053,"Michigan","Gogebic County",5,68,249,130,119
050,26,053,"Michigan","Gogebic County",5,69,260,129,131
050,26,053,"Michigan","Gogebic County",5,70,245,126,119
050,26,053,"Michigan","Gogebic County",5,71,239,121,118
050,26,053,"Michigan","Gogebic County",5,72,232,122,110
050,26,053,"Michigan","Gogebic County",5,73,224,126,98
050,26,053,"Michigan","Gogebic County",5,74,213,123,90
050,26,053,"Michigan","Gogebic County",5,75,218,118,100
050,26,053,"Michigan","Gogebic County",5,76,222,113,109
050,26,053,"Michigan","Gogebic County",5,77,140,70,70
050,26,053,"Michigan","Gogebic County",5,78,129,63,66
050,26,053,"Michigan","Gogebic County",5,79,125,59,66
050,26,053,"Michigan","Gogebic County",5,80,141,77,64
050,26,053,"Michigan","Gogebic County",5,81,95,48,47
050,26,053,"Michigan","Gogebic County",5,82,89,43,46
050,26,053,"Michigan","Gogebic County",5,83,83,41,42
050,26,053,"Michigan","Gogebic County",5,84,80,31,49
050,26,053,"Michigan","Gogebic County",5,85,500,189,311
050,26,055,"Michigan","Grand Traverse County",1,0,864,445,419
050,26,055,"Michigan","Grand Traverse County",1,1,871,461,410
050,26,055,"Michigan","Grand Traverse County",1,2,931,493,438
050,26,055,"Michigan","Grand Traverse County",1,3,978,511,467
050,26,055,"Michigan","Grand Traverse County",1,4,1020,546,474
050,26,055,"Michigan","Grand Traverse County",1,5,1061,535,526
050,26,055,"Michigan","Grand Traverse County",1,6,1057,548,509
050,26,055,"Michigan","Grand Traverse County",1,7,1047,535,512
050,26,055,"Michigan","Grand Traverse County",1,8,1023,515,508
050,26,055,"Michigan","Grand Traverse County",1,9,1041,548,493
050,26,055,"Michigan","Grand Traverse County",1,10,1085,577,508
050,26,055,"Michigan","Grand Traverse County",1,11,1107,586,521
050,26,055,"Michigan","Grand Traverse County",1,12,1192,626,566
050,26,055,"Michigan","Grand Traverse County",1,13,1171,576,595
050,26,055,"Michigan","Grand Traverse County",1,14,1103,533,570
050,26,055,"Michigan","Grand Traverse County",1,15,1144,595,549
050,26,055,"Michigan","Grand Traverse County",1,16,1222,630,592
050,26,055,"Michigan","Grand Traverse County",1,17,1163,582,581
050,26,055,"Michigan","Grand Traverse County",1,18,1112,592,520
050,26,055,"Michigan","Grand Traverse County",1,19,1109,591,518
050,26,055,"Michigan","Grand Traverse County",1,20,947,497,450
050,26,055,"Michigan","Grand Traverse County",1,21,1020,525,495
050,26,055,"Michigan","Grand Traverse County",1,22,988,495,493
050,26,055,"Michigan","Grand Traverse County",1,23,1038,516,522
050,26,055,"Michigan","Grand Traverse County",1,24,1074,527,547
050,26,055,"Michigan","Grand Traverse County",1,25,1080,543,537
050,26,055,"Michigan","Grand Traverse County",1,26,1114,587,527
050,26,055,"Michigan","Grand Traverse County",1,27,1109,564,545
050,26,055,"Michigan","Grand Traverse County",1,28,1192,609,583
050,26,055,"Michigan","Grand Traverse County",1,29,1235,633,602
050,26,055,"Michigan","Grand Traverse County",1,30,1221,631,590
050,26,055,"Michigan","Grand Traverse County",1,31,1144,583,561
050,26,055,"Michigan","Grand Traverse County",1,32,1148,552,596
050,26,055,"Michigan","Grand Traverse County",1,33,1212,594,618
050,26,055,"Michigan","Grand Traverse County",1,34,1238,617,621
050,26,055,"Michigan","Grand Traverse County",1,35,1238,644,594
050,26,055,"Michigan","Grand Traverse County",1,36,1258,655,603
050,26,055,"Michigan","Grand Traverse County",1,37,1303,657,646
050,26,055,"Michigan","Grand Traverse County",1,38,1235,618,617
050,26,055,"Michigan","Grand Traverse County",1,39,1199,598,601
050,26,055,"Michigan","Grand Traverse County",1,40,1194,631,563
050,26,055,"Michigan","Grand Traverse County",1,41,1128,569,559
050,26,055,"Michigan","Grand Traverse County",1,42,1095,517,578
050,26,055,"Michigan","Grand Traverse County",1,43,1063,525,538
050,26,055,"Michigan","Grand Traverse County",1,44,1032,525,507
050,26,055,"Michigan","Grand Traverse County",1,45,1051,515,536
050,26,055,"Michigan","Grand Traverse County",1,46,1025,497,528
050,26,055,"Michigan","Grand Traverse County",1,47,1058,546,512
050,26,055,"Michigan","Grand Traverse County",1,48,1129,579,550
050,26,055,"Michigan","Grand Traverse County",1,49,1255,617,638
050,26,055,"Michigan","Grand Traverse County",1,50,1262,618,644
050,26,055,"Michigan","Grand Traverse County",1,51,1156,605,551
050,26,055,"Michigan","Grand Traverse County",1,52,1140,582,558
050,26,055,"Michigan","Grand Traverse County",1,53,1169,587,582
050,26,055,"Michigan","Grand Traverse County",1,54,1170,568,602
050,26,055,"Michigan","Grand Traverse County",1,55,1286,611,675
050,26,055,"Michigan","Grand Traverse County",1,56,1356,661,695
050,26,055,"Michigan","Grand Traverse County",1,57,1384,666,718
050,26,055,"Michigan","Grand Traverse County",1,58,1429,696,733
050,26,055,"Michigan","Grand Traverse County",1,59,1475,707,768
050,26,055,"Michigan","Grand Traverse County",1,60,1482,710,772
050,26,055,"Michigan","Grand Traverse County",1,61,1478,688,790
050,26,055,"Michigan","Grand Traverse County",1,62,1558,739,819
050,26,055,"Michigan","Grand Traverse County",1,63,1515,754,761
050,26,055,"Michigan","Grand Traverse County",1,64,1456,707,749
050,26,055,"Michigan","Grand Traverse County",1,65,1455,701,754
050,26,055,"Michigan","Grand Traverse County",1,66,1418,678,740
050,26,055,"Michigan","Grand Traverse County",1,67,1388,660,728
050,26,055,"Michigan","Grand Traverse County",1,68,1336,670,666
050,26,055,"Michigan","Grand Traverse County",1,69,1225,606,619
050,26,055,"Michigan","Grand Traverse County",1,70,1173,578,595
050,26,055,"Michigan","Grand Traverse County",1,71,1118,552,566
050,26,055,"Michigan","Grand Traverse County",1,72,1104,528,576
050,26,055,"Michigan","Grand Traverse County",1,73,1127,536,591
050,26,055,"Michigan","Grand Traverse County",1,74,788,353,435
050,26,055,"Michigan","Grand Traverse County",1,75,748,355,393
050,26,055,"Michigan","Grand Traverse County",1,76,690,327,363
050,26,055,"Michigan","Grand Traverse County",1,77,718,332,386
050,26,055,"Michigan","Grand Traverse County",1,78,604,264,340
050,26,055,"Michigan","Grand Traverse County",1,79,538,243,295
050,26,055,"Michigan","Grand Traverse County",1,80,475,203,272
050,26,055,"Michigan","Grand Traverse County",1,81,438,192,246
050,26,055,"Michigan","Grand Traverse County",1,82,432,194,238
050,26,055,"Michigan","Grand Traverse County",1,83,346,144,202
050,26,055,"Michigan","Grand Traverse County",1,84,342,139,203
050,26,055,"Michigan","Grand Traverse County",1,85,2148,701,1447
050,26,055,"Michigan","Grand Traverse County",2,0,883,458,425
050,26,055,"Michigan","Grand Traverse County",2,1,871,461,410
050,26,055,"Michigan","Grand Traverse County",2,2,923,490,433
050,26,055,"Michigan","Grand Traverse County",2,3,967,508,459
050,26,055,"Michigan","Grand Traverse County",2,4,1017,541,476
050,26,055,"Michigan","Grand Traverse County",2,5,1056,540,516
050,26,055,"Michigan","Grand Traverse County",2,6,1064,547,517
050,26,055,"Michigan","Grand Traverse County",2,7,1054,542,512
050,26,055,"Michigan","Grand Traverse County",2,8,1031,523,508
050,26,055,"Michigan","Grand Traverse County",2,9,1037,540,497
050,26,055,"Michigan","Grand Traverse County",2,10,1073,571,502
050,26,055,"Michigan","Grand Traverse County",2,11,1099,583,516
050,26,055,"Michigan","Grand Traverse County",2,12,1177,619,558
050,26,055,"Michigan","Grand Traverse County",2,13,1175,588,587
050,26,055,"Michigan","Grand Traverse County",2,14,1120,544,576
050,26,055,"Michigan","Grand Traverse County",2,15,1138,582,556
050,26,055,"Michigan","Grand Traverse County",2,16,1210,626,584
050,26,055,"Michigan","Grand Traverse County",2,17,1182,598,584
050,26,055,"Michigan","Grand Traverse County",2,18,1123,596,527
050,26,055,"Michigan","Grand Traverse County",2,19,1100,588,512
050,26,055,"Michigan","Grand Traverse County",2,20,964,504,460
050,26,055,"Michigan","Grand Traverse County",2,21,1020,525,495
050,26,055,"Michigan","Grand Traverse County",2,22,993,498,495
050,26,055,"Michigan","Grand Traverse County",2,23,1042,521,521
050,26,055,"Michigan","Grand Traverse County",2,24,1062,525,537
050,26,055,"Michigan","Grand Traverse County",2,25,1088,549,539
050,26,055,"Michigan","Grand Traverse County",2,26,1110,575,535
050,26,055,"Michigan","Grand Traverse County",2,27,1113,572,541
050,26,055,"Michigan","Grand Traverse County",2,28,1174,601,573
050,26,055,"Michigan","Grand Traverse County",2,29,1232,629,603
050,26,055,"Michigan","Grand Traverse County",2,30,1229,632,597
050,26,055,"Michigan","Grand Traverse County",2,31,1167,594,573
050,26,055,"Michigan","Grand Traverse County",2,32,1149,557,592
050,26,055,"Michigan","Grand Traverse County",2,33,1198,586,612
050,26,055,"Michigan","Grand Traverse County",2,34,1240,615,625
050,26,055,"Michigan","Grand Traverse County",2,35,1250,647,603
050,26,055,"Michigan","Grand Traverse County",2,36,1246,649,597
050,26,055,"Michigan","Grand Traverse County",2,37,1294,656,638
050,26,055,"Michigan","Grand Traverse County",2,38,1259,631,628
050,26,055,"Michigan","Grand Traverse County",2,39,1214,610,604
050,26,055,"Michigan","Grand Traverse County",2,40,1203,626,577
050,26,055,"Michigan","Grand Traverse County",2,41,1150,584,566
050,26,055,"Michigan","Grand Traverse County",2,42,1101,528,573
050,26,055,"Michigan","Grand Traverse County",2,43,1076,527,549
050,26,055,"Michigan","Grand Traverse County",2,44,1031,521,510
050,26,055,"Michigan","Grand Traverse County",2,45,1052,520,532
050,26,055,"Michigan","Grand Traverse County",2,46,1019,495,524
050,26,055,"Michigan","Grand Traverse County",2,47,1040,529,511
050,26,055,"Michigan","Grand Traverse County",2,48,1110,570,540
050,26,055,"Michigan","Grand Traverse County",2,49,1235,616,619
050,26,055,"Michigan","Grand Traverse County",2,50,1273,623,650
050,26,055,"Michigan","Grand Traverse County",2,51,1176,606,570
050,26,055,"Michigan","Grand Traverse County",2,52,1137,583,554
050,26,055,"Michigan","Grand Traverse County",2,53,1168,589,579
050,26,055,"Michigan","Grand Traverse County",2,54,1164,568,596
050,26,055,"Michigan","Grand Traverse County",2,55,1258,602,656
050,26,055,"Michigan","Grand Traverse County",2,56,1343,655,688
050,26,055,"Michigan","Grand Traverse County",2,57,1378,664,714
050,26,055,"Michigan","Grand Traverse County",2,58,1417,689,728
050,26,055,"Michigan","Grand Traverse County",2,59,1473,708,765
050,26,055,"Michigan","Grand Traverse County",2,60,1477,706,771
050,26,055,"Michigan","Grand Traverse County",2,61,1477,693,784
050,26,055,"Michigan","Grand Traverse County",2,62,1540,729,811
050,26,055,"Michigan","Grand Traverse County",2,63,1538,760,778
050,26,055,"Michigan","Grand Traverse County",2,64,1467,714,753
050,26,055,"Michigan","Grand Traverse County",2,65,1445,695,750
050,26,055,"Michigan","Grand Traverse County",2,66,1427,683,744
050,26,055,"Michigan","Grand Traverse County",2,67,1387,661,726
050,26,055,"Michigan","Grand Traverse County",2,68,1341,663,678
050,26,055,"Michigan","Grand Traverse County",2,69,1259,624,635
050,26,055,"Michigan","Grand Traverse County",2,70,1176,579,597
050,26,055,"Michigan","Grand Traverse County",2,71,1130,560,570
050,26,055,"Michigan","Grand Traverse County",2,72,1086,523,563
050,26,055,"Michigan","Grand Traverse County",2,73,1176,561,615
050,26,055,"Michigan","Grand Traverse County",2,74,813,370,443
050,26,055,"Michigan","Grand Traverse County",2,75,763,357,406
050,26,055,"Michigan","Grand Traverse County",2,76,688,327,361
050,26,055,"Michigan","Grand Traverse County",2,77,728,338,390
050,26,055,"Michigan","Grand Traverse County",2,78,618,273,345
050,26,055,"Michigan","Grand Traverse County",2,79,540,240,300
050,26,055,"Michigan","Grand Traverse County",2,80,489,210,279
050,26,055,"Michigan","Grand Traverse County",2,81,443,193,250
050,26,055,"Michigan","Grand Traverse County",2,82,431,193,238
050,26,055,"Michigan","Grand Traverse County",2,83,358,152,206
050,26,055,"Michigan","Grand Traverse County",2,84,340,139,201
050,26,055,"Michigan","Grand Traverse County",2,85,2140,698,1442
050,26,055,"Michigan","Grand Traverse County",3,0,892,459,433
050,26,055,"Michigan","Grand Traverse County",3,1,901,467,434
050,26,055,"Michigan","Grand Traverse County",3,2,893,473,420
050,26,055,"Michigan","Grand Traverse County",3,3,958,507,451
050,26,055,"Michigan","Grand Traverse County",3,4,975,513,462
050,26,055,"Michigan","Grand Traverse County",3,5,1033,561,472
050,26,055,"Michigan","Grand Traverse County",3,6,1051,530,521
050,26,055,"Michigan","Grand Traverse County",3,7,1083,556,527
050,26,055,"Michigan","Grand Traverse County",3,8,1056,542,514
050,26,055,"Michigan","Grand Traverse County",3,9,1044,528,516
050,26,055,"Michigan","Grand Traverse County",3,10,1035,545,490
050,26,055,"Michigan","Grand Traverse County",3,11,1087,572,515
050,26,055,"Michigan","Grand Traverse County",3,12,1088,574,514
050,26,055,"Michigan","Grand Traverse County",3,13,1205,631,574
050,26,055,"Michigan","Grand Traverse County",3,14,1180,594,586
050,26,055,"Michigan","Grand Traverse County",3,15,1133,543,590
050,26,055,"Michigan","Grand Traverse County",3,16,1134,582,552
050,26,055,"Michigan","Grand Traverse County",3,17,1210,621,589
050,26,055,"Michigan","Grand Traverse County",3,18,1176,625,551
050,26,055,"Michigan","Grand Traverse County",3,19,1011,532,479
050,26,055,"Michigan","Grand Traverse County",3,20,976,517,459
050,26,055,"Michigan","Grand Traverse County",3,21,1021,523,498
050,26,055,"Michigan","Grand Traverse County",3,22,985,505,480
050,26,055,"Michigan","Grand Traverse County",3,23,1039,515,524
050,26,055,"Michigan","Grand Traverse County",3,24,1076,545,531
050,26,055,"Michigan","Grand Traverse County",3,25,1117,574,543
050,26,055,"Michigan","Grand Traverse County",3,26,1071,547,524
050,26,055,"Michigan","Grand Traverse County",3,27,1158,599,559
050,26,055,"Michigan","Grand Traverse County",3,28,1153,606,547
050,26,055,"Michigan","Grand Traverse County",3,29,1192,608,584
050,26,055,"Michigan","Grand Traverse County",3,30,1217,620,597
050,26,055,"Michigan","Grand Traverse County",3,31,1228,623,605
050,26,055,"Michigan","Grand Traverse County",3,32,1181,600,581
050,26,055,"Michigan","Grand Traverse County",3,33,1189,587,602
050,26,055,"Michigan","Grand Traverse County",3,34,1224,586,638
050,26,055,"Michigan","Grand Traverse County",3,35,1261,642,619
050,26,055,"Michigan","Grand Traverse County",3,36,1252,642,610
050,26,055,"Michigan","Grand Traverse County",3,37,1241,645,596
050,26,055,"Michigan","Grand Traverse County",3,38,1302,651,651
050,26,055,"Michigan","Grand Traverse County",3,39,1268,638,630
050,26,055,"Michigan","Grand Traverse County",3,40,1265,633,632
050,26,055,"Michigan","Grand Traverse County",3,41,1213,631,582
050,26,055,"Michigan","Grand Traverse County",3,42,1153,588,565
050,26,055,"Michigan","Grand Traverse County",3,43,1091,530,561
050,26,055,"Michigan","Grand Traverse County",3,44,1082,535,547
050,26,055,"Michigan","Grand Traverse County",3,45,1065,531,534
050,26,055,"Michigan","Grand Traverse County",3,46,1061,529,532
050,26,055,"Michigan","Grand Traverse County",3,47,1041,510,531
050,26,055,"Michigan","Grand Traverse County",3,48,1046,531,515
050,26,055,"Michigan","Grand Traverse County",3,49,1096,566,530
050,26,055,"Michigan","Grand Traverse County",3,50,1226,603,623
050,26,055,"Michigan","Grand Traverse County",3,51,1256,619,637
050,26,055,"Michigan","Grand Traverse County",3,52,1180,610,570
050,26,055,"Michigan","Grand Traverse County",3,53,1127,582,545
050,26,055,"Michigan","Grand Traverse County",3,54,1154,580,574
050,26,055,"Michigan","Grand Traverse County",3,55,1188,585,603
050,26,055,"Michigan","Grand Traverse County",3,56,1251,599,652
050,26,055,"Michigan","Grand Traverse County",3,57,1341,641,700
050,26,055,"Michigan","Grand Traverse County",3,58,1421,695,726
050,26,055,"Michigan","Grand Traverse County",3,59,1423,695,728
050,26,055,"Michigan","Grand Traverse County",3,60,1477,710,767
050,26,055,"Michigan","Grand Traverse County",3,61,1476,698,778
050,26,055,"Michigan","Grand Traverse County",3,62,1512,702,810
050,26,055,"Michigan","Grand Traverse County",3,63,1531,729,802
050,26,055,"Michigan","Grand Traverse County",3,64,1543,762,781
050,26,055,"Michigan","Grand Traverse County",3,65,1471,723,748
050,26,055,"Michigan","Grand Traverse County",3,66,1447,684,763
050,26,055,"Michigan","Grand Traverse County",3,67,1400,661,739
050,26,055,"Michigan","Grand Traverse County",3,68,1371,655,716
050,26,055,"Michigan","Grand Traverse County",3,69,1319,658,661
050,26,055,"Michigan","Grand Traverse County",3,70,1246,608,638
050,26,055,"Michigan","Grand Traverse County",3,71,1159,576,583
050,26,055,"Michigan","Grand Traverse County",3,72,1116,549,567
050,26,055,"Michigan","Grand Traverse County",3,73,1068,517,551
050,26,055,"Michigan","Grand Traverse County",3,74,1162,546,616
050,26,055,"Michigan","Grand Traverse County",3,75,799,357,442
050,26,055,"Michigan","Grand Traverse County",3,76,723,338,385
050,26,055,"Michigan","Grand Traverse County",3,77,681,322,359
050,26,055,"Michigan","Grand Traverse County",3,78,700,323,377
050,26,055,"Michigan","Grand Traverse County",3,79,584,258,326
050,26,055,"Michigan","Grand Traverse County",3,80,519,225,294
050,26,055,"Michigan","Grand Traverse County",3,81,457,200,257
050,26,055,"Michigan","Grand Traverse County",3,82,416,177,239
050,26,055,"Michigan","Grand Traverse County",3,83,391,172,219
050,26,055,"Michigan","Grand Traverse County",3,84,346,145,201
050,26,055,"Michigan","Grand Traverse County",3,85,2079,678,1401
050,26,055,"Michigan","Grand Traverse County",4,0,896,441,455
050,26,055,"Michigan","Grand Traverse County",4,1,898,464,434
050,26,055,"Michigan","Grand Traverse County",4,2,921,475,446
050,26,055,"Michigan","Grand Traverse County",4,3,897,468,429
050,26,055,"Michigan","Grand Traverse County",4,4,952,511,441
050,26,055,"Michigan","Grand Traverse County",4,5,977,514,463
050,26,055,"Michigan","Grand Traverse County",4,6,1008,539,469
050,26,055,"Michigan","Grand Traverse County",4,7,1049,528,521
050,26,055,"Michigan","Grand Traverse County",4,8,1086,549,537
050,26,055,"Michigan","Grand Traverse County",4,9,1058,549,509
050,26,055,"Michigan","Grand Traverse County",4,10,1061,527,534
050,26,055,"Michigan","Grand Traverse County",4,11,1052,550,502
050,26,055,"Michigan","Grand Traverse County",4,12,1093,582,511
050,26,055,"Michigan","Grand Traverse County",4,13,1091,568,523
050,26,055,"Michigan","Grand Traverse County",4,14,1221,634,587
050,26,055,"Michigan","Grand Traverse County",4,15,1172,587,585
050,26,055,"Michigan","Grand Traverse County",4,16,1135,555,580
050,26,055,"Michigan","Grand Traverse County",4,17,1142,584,558
050,26,055,"Michigan","Grand Traverse County",4,18,1178,627,551
050,26,055,"Michigan","Grand Traverse County",4,19,1092,588,504
050,26,055,"Michigan","Grand Traverse County",4,20,922,477,445
050,26,055,"Michigan","Grand Traverse County",4,21,1035,545,490
050,26,055,"Michigan","Grand Traverse County",4,22,1003,489,514
050,26,055,"Michigan","Grand Traverse County",4,23,1041,537,504
050,26,055,"Michigan","Grand Traverse County",4,24,1014,506,508
050,26,055,"Michigan","Grand Traverse County",4,25,1116,584,532
050,26,055,"Michigan","Grand Traverse County",4,26,1104,566,538
050,26,055,"Michigan","Grand Traverse County",4,27,1063,542,521
050,26,055,"Michigan","Grand Traverse County",4,28,1190,613,577
050,26,055,"Michigan","Grand Traverse County",4,29,1152,616,536
050,26,055,"Michigan","Grand Traverse County",4,30,1186,611,575
050,26,055,"Michigan","Grand Traverse County",4,31,1249,621,628
050,26,055,"Michigan","Grand Traverse County",4,32,1227,620,607
050,26,055,"Michigan","Grand Traverse County",4,33,1199,613,586
050,26,055,"Michigan","Grand Traverse County",4,34,1188,580,608
050,26,055,"Michigan","Grand Traverse County",4,35,1260,621,639
050,26,055,"Michigan","Grand Traverse County",4,36,1264,640,624
050,26,055,"Michigan","Grand Traverse County",4,37,1271,643,628
050,26,055,"Michigan","Grand Traverse County",4,38,1259,648,611
050,26,055,"Michigan","Grand Traverse County",4,39,1307,639,668
050,26,055,"Michigan","Grand Traverse County",4,40,1264,633,631
050,26,055,"Michigan","Grand Traverse County",4,41,1261,640,621
050,26,055,"Michigan","Grand Traverse County",4,42,1229,637,592
050,26,055,"Michigan","Grand Traverse County",4,43,1159,596,563
050,26,055,"Michigan","Grand Traverse County",4,44,1108,533,575
050,26,055,"Michigan","Grand Traverse County",4,45,1129,546,583
050,26,055,"Michigan","Grand Traverse County",4,46,1031,511,520
050,26,055,"Michigan","Grand Traverse County",4,47,1065,530,535
050,26,055,"Michigan","Grand Traverse County",4,48,1037,507,530
050,26,055,"Michigan","Grand Traverse County",4,49,1043,529,514
050,26,055,"Michigan","Grand Traverse County",4,50,1130,584,546
050,26,055,"Michigan","Grand Traverse County",4,51,1210,596,614
050,26,055,"Michigan","Grand Traverse County",4,52,1256,610,646
050,26,055,"Michigan","Grand Traverse County",4,53,1200,631,569
050,26,055,"Michigan","Grand Traverse County",4,54,1121,569,552
050,26,055,"Michigan","Grand Traverse County",4,55,1187,600,587
050,26,055,"Michigan","Grand Traverse County",4,56,1183,583,600
050,26,055,"Michigan","Grand Traverse County",4,57,1235,576,659
050,26,055,"Michigan","Grand Traverse County",4,58,1366,647,719
050,26,055,"Michigan","Grand Traverse County",4,59,1422,694,728
050,26,055,"Michigan","Grand Traverse County",4,60,1411,687,724
050,26,055,"Michigan","Grand Traverse County",4,61,1485,715,770
050,26,055,"Michigan","Grand Traverse County",4,62,1484,702,782
050,26,055,"Michigan","Grand Traverse County",4,63,1522,703,819
050,26,055,"Michigan","Grand Traverse County",4,64,1539,722,817
050,26,055,"Michigan","Grand Traverse County",4,65,1510,743,767
050,26,055,"Michigan","Grand Traverse County",4,66,1464,717,747
050,26,055,"Michigan","Grand Traverse County",4,67,1427,670,757
050,26,055,"Michigan","Grand Traverse County",4,68,1391,650,741
050,26,055,"Michigan","Grand Traverse County",4,69,1345,638,707
050,26,055,"Michigan","Grand Traverse County",4,70,1308,644,664
050,26,055,"Michigan","Grand Traverse County",4,71,1226,601,625
050,26,055,"Michigan","Grand Traverse County",4,72,1149,561,588
050,26,055,"Michigan","Grand Traverse County",4,73,1071,522,549
050,26,055,"Michigan","Grand Traverse County",4,74,1049,502,547
050,26,055,"Michigan","Grand Traverse County",4,75,1168,539,629
050,26,055,"Michigan","Grand Traverse County",4,76,754,337,417
050,26,055,"Michigan","Grand Traverse County",4,77,715,329,386
050,26,055,"Michigan","Grand Traverse County",4,78,661,307,354
050,26,055,"Michigan","Grand Traverse County",4,79,658,308,350
050,26,055,"Michigan","Grand Traverse County",4,80,574,253,321
050,26,055,"Michigan","Grand Traverse County",4,81,487,208,279
050,26,055,"Michigan","Grand Traverse County",4,82,446,187,259
050,26,055,"Michigan","Grand Traverse County",4,83,371,157,214
050,26,055,"Michigan","Grand Traverse County",4,84,358,153,205
050,26,055,"Michigan","Grand Traverse County",4,85,2060,686,1374
050,26,055,"Michigan","Grand Traverse County",5,0,894,443,451
050,26,055,"Michigan","Grand Traverse County",5,1,865,431,434
050,26,055,"Michigan","Grand Traverse County",5,2,910,472,438
050,26,055,"Michigan","Grand Traverse County",5,3,905,456,449
050,26,055,"Michigan","Grand Traverse County",5,4,915,488,427
050,26,055,"Michigan","Grand Traverse County",5,5,966,513,453
050,26,055,"Michigan","Grand Traverse County",5,6,988,510,478
050,26,055,"Michigan","Grand Traverse County",5,7,1007,538,469
050,26,055,"Michigan","Grand Traverse County",5,8,1056,520,536
050,26,055,"Michigan","Grand Traverse County",5,9,1076,552,524
050,26,055,"Michigan","Grand Traverse County",5,10,1057,565,492
050,26,055,"Michigan","Grand Traverse County",5,11,1064,533,531
050,26,055,"Michigan","Grand Traverse County",5,12,1037,541,496
050,26,055,"Michigan","Grand Traverse County",5,13,1093,591,502
050,26,055,"Michigan","Grand Traverse County",5,14,1085,580,505
050,26,055,"Michigan","Grand Traverse County",5,15,1209,631,578
050,26,055,"Michigan","Grand Traverse County",5,16,1168,583,585
050,26,055,"Michigan","Grand Traverse County",5,17,1131,546,585
050,26,055,"Michigan","Grand Traverse County",5,18,1113,589,524
050,26,055,"Michigan","Grand Traverse County",5,19,1100,593,507
050,26,055,"Michigan","Grand Traverse County",5,20,988,532,456
050,26,055,"Michigan","Grand Traverse County",5,21,984,508,476
050,26,055,"Michigan","Grand Traverse County",5,22,995,526,469
050,26,055,"Michigan","Grand Traverse County",5,23,1060,523,537
050,26,055,"Michigan","Grand Traverse County",5,24,1041,538,503
050,26,055,"Michigan","Grand Traverse County",5,25,1061,536,525
050,26,055,"Michigan","Grand Traverse County",5,26,1061,552,509
050,26,055,"Michigan","Grand Traverse County",5,27,1119,569,550
050,26,055,"Michigan","Grand Traverse County",5,28,1062,560,502
050,26,055,"Michigan","Grand Traverse County",5,29,1161,609,552
050,26,055,"Michigan","Grand Traverse County",5,30,1159,628,531
050,26,055,"Michigan","Grand Traverse County",5,31,1211,622,589
050,26,055,"Michigan","Grand Traverse County",5,32,1218,594,624
050,26,055,"Michigan","Grand Traverse County",5,33,1243,639,604
050,26,055,"Michigan","Grand Traverse County",5,34,1225,621,604
050,26,055,"Michigan","Grand Traverse County",5,35,1227,606,621
050,26,055,"Michigan","Grand Traverse County",5,36,1298,646,652
050,26,055,"Michigan","Grand Traverse County",5,37,1284,655,629
050,26,055,"Michigan","Grand Traverse County",5,38,1267,644,623
050,26,055,"Michigan","Grand Traverse County",5,39,1274,653,621
050,26,055,"Michigan","Grand Traverse County",5,40,1311,646,665
050,26,055,"Michigan","Grand Traverse County",5,41,1264,636,628
050,26,055,"Michigan","Grand Traverse County",5,42,1294,668,626
050,26,055,"Michigan","Grand Traverse County",5,43,1223,634,589
050,26,055,"Michigan","Grand Traverse County",5,44,1162,596,566
050,26,055,"Michigan","Grand Traverse County",5,45,1119,535,584
050,26,055,"Michigan","Grand Traverse County",5,46,1132,544,588
050,26,055,"Michigan","Grand Traverse County",5,47,1029,525,504
050,26,055,"Michigan","Grand Traverse County",5,48,1068,528,540
050,26,055,"Michigan","Grand Traverse County",5,49,1038,516,522
050,26,055,"Michigan","Grand Traverse County",5,50,1064,532,532
050,26,055,"Michigan","Grand Traverse County",5,51,1100,571,529
050,26,055,"Michigan","Grand Traverse County",5,52,1224,595,629
050,26,055,"Michigan","Grand Traverse County",5,53,1272,629,643
050,26,055,"Michigan","Grand Traverse County",5,54,1177,615,562
050,26,055,"Michigan","Grand Traverse County",5,55,1134,574,560
050,26,055,"Michigan","Grand Traverse County",5,56,1173,589,584
050,26,055,"Michigan","Grand Traverse County",5,57,1164,572,592
050,26,055,"Michigan","Grand Traverse County",5,58,1250,587,663
050,26,055,"Michigan","Grand Traverse County",5,59,1357,647,710
050,26,055,"Michigan","Grand Traverse County",5,60,1414,686,728
050,26,055,"Michigan","Grand Traverse County",5,61,1411,685,726
050,26,055,"Michigan","Grand Traverse County",5,62,1467,705,762
050,26,055,"Michigan","Grand Traverse County",5,63,1477,691,786
050,26,055,"Michigan","Grand Traverse County",5,64,1530,693,837
050,26,055,"Michigan","Grand Traverse County",5,65,1544,727,817
050,26,055,"Michigan","Grand Traverse County",5,66,1512,738,774
050,26,055,"Michigan","Grand Traverse County",5,67,1446,702,744
050,26,055,"Michigan","Grand Traverse County",5,68,1408,658,750
050,26,055,"Michigan","Grand Traverse County",5,69,1378,645,733
050,26,055,"Michigan","Grand Traverse County",5,70,1330,626,704
050,26,055,"Michigan","Grand Traverse County",5,71,1295,646,649
050,26,055,"Michigan","Grand Traverse County",5,72,1204,587,617
050,26,055,"Michigan","Grand Traverse County",5,73,1121,548,573
050,26,055,"Michigan","Grand Traverse County",5,74,1056,507,549
050,26,055,"Michigan","Grand Traverse County",5,75,1043,494,549
050,26,055,"Michigan","Grand Traverse County",5,76,1110,511,599
050,26,055,"Michigan","Grand Traverse County",5,77,749,335,414
050,26,055,"Michigan","Grand Traverse County",5,78,690,315,375
050,26,055,"Michigan","Grand Traverse County",5,79,618,287,331
050,26,055,"Michigan","Grand Traverse County",5,80,644,299,345
050,26,055,"Michigan","Grand Traverse County",5,81,537,232,305
050,26,055,"Michigan","Grand Traverse County",5,82,472,197,275
050,26,055,"Michigan","Grand Traverse County",5,83,415,169,246
050,26,055,"Michigan","Grand Traverse County",5,84,345,141,204
050,26,055,"Michigan","Grand Traverse County",5,85,2073,699,1374
050,26,057,"Michigan","Gratiot County",1,0,396,202,194
050,26,057,"Michigan","Gratiot County",1,1,431,217,214
050,26,057,"Michigan","Gratiot County",1,2,414,203,211
050,26,057,"Michigan","Gratiot County",1,3,397,204,193
050,26,057,"Michigan","Gratiot County",1,4,417,216,201
050,26,057,"Michigan","Gratiot County",1,5,447,254,193
050,26,057,"Michigan","Gratiot County",1,6,408,200,208
050,26,057,"Michigan","Gratiot County",1,7,451,209,242
050,26,057,"Michigan","Gratiot County",1,8,470,241,229
050,26,057,"Michigan","Gratiot County",1,9,461,251,210
050,26,057,"Michigan","Gratiot County",1,10,491,247,244
050,26,057,"Michigan","Gratiot County",1,11,483,247,236
050,26,057,"Michigan","Gratiot County",1,12,483,259,224
050,26,057,"Michigan","Gratiot County",1,13,505,245,260
050,26,057,"Michigan","Gratiot County",1,14,519,256,263
050,26,057,"Michigan","Gratiot County",1,15,519,275,244
050,26,057,"Michigan","Gratiot County",1,16,481,256,225
050,26,057,"Michigan","Gratiot County",1,17,492,263,229
050,26,057,"Michigan","Gratiot County",1,18,678,315,363
050,26,057,"Michigan","Gratiot County",1,19,888,460,428
050,26,057,"Michigan","Gratiot County",1,20,865,465,400
050,26,057,"Michigan","Gratiot County",1,21,803,448,355
050,26,057,"Michigan","Gratiot County",1,22,625,388,237
050,26,057,"Michigan","Gratiot County",1,23,528,318,210
050,26,057,"Michigan","Gratiot County",1,24,532,312,220
050,26,057,"Michigan","Gratiot County",1,25,539,340,199
050,26,057,"Michigan","Gratiot County",1,26,539,337,202
050,26,057,"Michigan","Gratiot County",1,27,569,352,217
050,26,057,"Michigan","Gratiot County",1,28,557,340,217
050,26,057,"Michigan","Gratiot County",1,29,583,350,233
050,26,057,"Michigan","Gratiot County",1,30,541,332,209
050,26,057,"Michigan","Gratiot County",1,31,533,329,204
050,26,057,"Michigan","Gratiot County",1,32,519,325,194
050,26,057,"Michigan","Gratiot County",1,33,501,302,199
050,26,057,"Michigan","Gratiot County",1,34,526,318,208
050,26,057,"Michigan","Gratiot County",1,35,535,318,217
050,26,057,"Michigan","Gratiot County",1,36,531,314,217
050,26,057,"Michigan","Gratiot County",1,37,539,316,223
050,26,057,"Michigan","Gratiot County",1,38,556,322,234
050,26,057,"Michigan","Gratiot County",1,39,586,356,230
050,26,057,"Michigan","Gratiot County",1,40,563,343,220
050,26,057,"Michigan","Gratiot County",1,41,546,319,227
050,26,057,"Michigan","Gratiot County",1,42,514,297,217
050,26,057,"Michigan","Gratiot County",1,43,512,308,204
050,26,057,"Michigan","Gratiot County",1,44,493,298,195
050,26,057,"Michigan","Gratiot County",1,45,488,300,188
050,26,057,"Michigan","Gratiot County",1,46,495,307,188
050,26,057,"Michigan","Gratiot County",1,47,480,281,199
050,26,057,"Michigan","Gratiot County",1,48,522,296,226
050,26,057,"Michigan","Gratiot County",1,49,579,337,242
050,26,057,"Michigan","Gratiot County",1,50,510,283,227
050,26,057,"Michigan","Gratiot County",1,51,527,309,218
050,26,057,"Michigan","Gratiot County",1,52,493,256,237
050,26,057,"Michigan","Gratiot County",1,53,523,283,240
050,26,057,"Michigan","Gratiot County",1,54,557,296,261
050,26,057,"Michigan","Gratiot County",1,55,575,307,268
050,26,057,"Michigan","Gratiot County",1,56,565,301,264
050,26,057,"Michigan","Gratiot County",1,57,586,315,271
050,26,057,"Michigan","Gratiot County",1,58,555,292,263
050,26,057,"Michigan","Gratiot County",1,59,556,283,273
050,26,057,"Michigan","Gratiot County",1,60,567,298,269
050,26,057,"Michigan","Gratiot County",1,61,529,280,249
050,26,057,"Michigan","Gratiot County",1,62,524,280,244
050,26,057,"Michigan","Gratiot County",1,63,508,274,234
050,26,057,"Michigan","Gratiot County",1,64,485,249,236
050,26,057,"Michigan","Gratiot County",1,65,480,234,246
050,26,057,"Michigan","Gratiot County",1,66,453,207,246
050,26,057,"Michigan","Gratiot County",1,67,469,235,234
050,26,057,"Michigan","Gratiot County",1,68,451,219,232
050,26,057,"Michigan","Gratiot County",1,69,401,183,218
050,26,057,"Michigan","Gratiot County",1,70,380,181,199
050,26,057,"Michigan","Gratiot County",1,71,384,191,193
050,26,057,"Michigan","Gratiot County",1,72,379,186,193
050,26,057,"Michigan","Gratiot County",1,73,372,190,182
050,26,057,"Michigan","Gratiot County",1,74,281,127,154
050,26,057,"Michigan","Gratiot County",1,75,302,136,166
050,26,057,"Michigan","Gratiot County",1,76,276,130,146
050,26,057,"Michigan","Gratiot County",1,77,258,121,137
050,26,057,"Michigan","Gratiot County",1,78,260,111,149
050,26,057,"Michigan","Gratiot County",1,79,221,94,127
050,26,057,"Michigan","Gratiot County",1,80,190,83,107
050,26,057,"Michigan","Gratiot County",1,81,182,79,103
050,26,057,"Michigan","Gratiot County",1,82,172,81,91
050,26,057,"Michigan","Gratiot County",1,83,151,69,82
050,26,057,"Michigan","Gratiot County",1,84,142,55,87
050,26,057,"Michigan","Gratiot County",1,85,968,344,624
050,26,057,"Michigan","Gratiot County",2,0,391,207,184
050,26,057,"Michigan","Gratiot County",2,1,420,213,207
050,26,057,"Michigan","Gratiot County",2,2,417,206,211
050,26,057,"Michigan","Gratiot County",2,3,400,201,199
050,26,057,"Michigan","Gratiot County",2,4,412,213,199
050,26,057,"Michigan","Gratiot County",2,5,437,243,194
050,26,057,"Michigan","Gratiot County",2,6,417,212,205
050,26,057,"Michigan","Gratiot County",2,7,441,207,234
050,26,057,"Michigan","Gratiot County",2,8,464,232,232
050,26,057,"Michigan","Gratiot County",2,9,464,249,215
050,26,057,"Michigan","Gratiot County",2,10,484,247,237
050,26,057,"Michigan","Gratiot County",2,11,486,249,237
050,26,057,"Michigan","Gratiot County",2,12,489,259,230
050,26,057,"Michigan","Gratiot County",2,13,505,251,254
050,26,057,"Michigan","Gratiot County",2,14,518,255,263
050,26,057,"Michigan","Gratiot County",2,15,517,269,248
050,26,057,"Michigan","Gratiot County",2,16,487,259,228
050,26,057,"Michigan","Gratiot County",2,17,487,261,226
050,26,057,"Michigan","Gratiot County",2,18,667,315,352
050,26,057,"Michigan","Gratiot County",2,19,882,455,427
050,26,057,"Michigan","Gratiot County",2,20,873,465,408
050,26,057,"Michigan","Gratiot County",2,21,807,449,358
050,26,057,"Michigan","Gratiot County",2,22,626,386,240
050,26,057,"Michigan","Gratiot County",2,23,533,322,211
050,26,057,"Michigan","Gratiot County",2,24,527,311,216
050,26,057,"Michigan","Gratiot County",2,25,538,335,203
050,26,057,"Michigan","Gratiot County",2,26,539,336,203
050,26,057,"Michigan","Gratiot County",2,27,559,347,212
050,26,057,"Michigan","Gratiot County",2,28,561,343,218
050,26,057,"Michigan","Gratiot County",2,29,569,342,227
050,26,057,"Michigan","Gratiot County",2,30,548,333,215
050,26,057,"Michigan","Gratiot County",2,31,530,326,204
050,26,057,"Michigan","Gratiot County",2,32,529,332,197
050,26,057,"Michigan","Gratiot County",2,33,505,303,202
050,26,057,"Michigan","Gratiot County",2,34,522,314,208
050,26,057,"Michigan","Gratiot County",2,35,537,320,217
050,26,057,"Michigan","Gratiot County",2,36,525,312,213
050,26,057,"Michigan","Gratiot County",2,37,536,315,221
050,26,057,"Michigan","Gratiot County",2,38,557,325,232
050,26,057,"Michigan","Gratiot County",2,39,577,350,227
050,26,057,"Michigan","Gratiot County",2,40,571,347,224
050,26,057,"Michigan","Gratiot County",2,41,543,319,224
050,26,057,"Michigan","Gratiot County",2,42,506,290,216
050,26,057,"Michigan","Gratiot County",2,43,520,312,208
050,26,057,"Michigan","Gratiot County",2,44,492,298,194
050,26,057,"Michigan","Gratiot County",2,45,486,297,189
050,26,057,"Michigan","Gratiot County",2,46,495,308,187
050,26,057,"Michigan","Gratiot County",2,47,476,281,195
050,26,057,"Michigan","Gratiot County",2,48,507,290,217
050,26,057,"Michigan","Gratiot County",2,49,569,328,241
050,26,057,"Michigan","Gratiot County",2,50,525,295,230
050,26,057,"Michigan","Gratiot County",2,51,525,304,221
050,26,057,"Michigan","Gratiot County",2,52,493,262,231
050,26,057,"Michigan","Gratiot County",2,53,519,279,240
050,26,057,"Michigan","Gratiot County",2,54,546,291,255
050,26,057,"Michigan","Gratiot County",2,55,566,298,268
050,26,057,"Michigan","Gratiot County",2,56,571,305,266
050,26,057,"Michigan","Gratiot County",2,57,580,311,269
050,26,057,"Michigan","Gratiot County",2,58,559,295,264
050,26,057,"Michigan","Gratiot County",2,59,554,284,270
050,26,057,"Michigan","Gratiot County",2,60,560,293,267
050,26,057,"Michigan","Gratiot County",2,61,531,279,252
050,26,057,"Michigan","Gratiot County",2,62,522,278,244
050,26,057,"Michigan","Gratiot County",2,63,520,280,240
050,26,057,"Michigan","Gratiot County",2,64,481,247,234
050,26,057,"Michigan","Gratiot County",2,65,478,237,241
050,26,057,"Michigan","Gratiot County",2,66,455,209,246
050,26,057,"Michigan","Gratiot County",2,67,461,226,235
050,26,057,"Michigan","Gratiot County",2,68,450,221,229
050,26,057,"Michigan","Gratiot County",2,69,412,190,222
050,26,057,"Michigan","Gratiot County",2,70,381,180,201
050,26,057,"Michigan","Gratiot County",2,71,379,186,193
050,26,057,"Michigan","Gratiot County",2,72,373,182,191
050,26,057,"Michigan","Gratiot County",2,73,390,199,191
050,26,057,"Michigan","Gratiot County",2,74,282,131,151
050,26,057,"Michigan","Gratiot County",2,75,298,133,165
050,26,057,"Michigan","Gratiot County",2,76,275,126,149
050,26,057,"Michigan","Gratiot County",2,77,266,124,142
050,26,057,"Michigan","Gratiot County",2,78,258,112,146
050,26,057,"Michigan","Gratiot County",2,79,225,96,129
050,26,057,"Michigan","Gratiot County",2,80,194,85,109
050,26,057,"Michigan","Gratiot County",2,81,185,80,105
050,26,057,"Michigan","Gratiot County",2,82,171,78,93
050,26,057,"Michigan","Gratiot County",2,83,150,70,80
050,26,057,"Michigan","Gratiot County",2,84,140,56,84
050,26,057,"Michigan","Gratiot County",2,85,960,340,620
050,26,057,"Michigan","Gratiot County",3,0,355,186,169
050,26,057,"Michigan","Gratiot County",3,1,415,215,200
050,26,057,"Michigan","Gratiot County",3,2,419,214,205
050,26,057,"Michigan","Gratiot County",3,3,423,206,217
050,26,057,"Michigan","Gratiot County",3,4,403,207,196
050,26,057,"Michigan","Gratiot County",3,5,430,223,207
050,26,057,"Michigan","Gratiot County",3,6,429,235,194
050,26,057,"Michigan","Gratiot County",3,7,402,205,197
050,26,057,"Michigan","Gratiot County",3,8,437,210,227
050,26,057,"Michigan","Gratiot County",3,9,455,226,229
050,26,057,"Michigan","Gratiot County",3,10,470,250,220
050,26,057,"Michigan","Gratiot County",3,11,488,248,240
050,26,057,"Michigan","Gratiot County",3,12,482,247,235
050,26,057,"Michigan","Gratiot County",3,13,494,259,235
050,26,057,"Michigan","Gratiot County",3,14,506,248,258
050,26,057,"Michigan","Gratiot County",3,15,515,250,265
050,26,057,"Michigan","Gratiot County",3,16,516,271,245
050,26,057,"Michigan","Gratiot County",3,17,487,263,224
050,26,057,"Michigan","Gratiot County",3,18,661,319,342
050,26,057,"Michigan","Gratiot County",3,19,854,440,414
050,26,057,"Michigan","Gratiot County",3,20,840,441,399
050,26,057,"Michigan","Gratiot County",3,21,816,448,368
050,26,057,"Michigan","Gratiot County",3,22,623,374,249
050,26,057,"Michigan","Gratiot County",3,23,528,326,202
050,26,057,"Michigan","Gratiot County",3,24,519,320,199
050,26,057,"Michigan","Gratiot County",3,25,554,334,220
050,26,057,"Michigan","Gratiot County",3,26,538,328,210
050,26,057,"Michigan","Gratiot County",3,27,541,333,208
050,26,057,"Michigan","Gratiot County",3,28,552,341,211
050,26,057,"Michigan","Gratiot County",3,29,558,333,225
050,26,057,"Michigan","Gratiot County",3,30,551,324,227
050,26,057,"Michigan","Gratiot County",3,31,547,322,225
050,26,057,"Michigan","Gratiot County",3,32,551,346,205
050,26,057,"Michigan","Gratiot County",3,33,504,311,193
050,26,057,"Michigan","Gratiot County",3,34,515,310,205
050,26,057,"Michigan","Gratiot County",3,35,504,305,199
050,26,057,"Michigan","Gratiot County",3,36,530,309,221
050,26,057,"Michigan","Gratiot County",3,37,520,307,213
050,26,057,"Michigan","Gratiot County",3,38,556,327,229
050,26,057,"Michigan","Gratiot County",3,39,555,322,233
050,26,057,"Michigan","Gratiot County",3,40,572,348,224
050,26,057,"Michigan","Gratiot County",3,41,559,335,224
050,26,057,"Michigan","Gratiot County",3,42,508,286,222
050,26,057,"Michigan","Gratiot County",3,43,524,305,219
050,26,057,"Michigan","Gratiot County",3,44,526,312,214
050,26,057,"Michigan","Gratiot County",3,45,475,282,193
050,26,057,"Michigan","Gratiot County",3,46,494,305,189
050,26,057,"Michigan","Gratiot County",3,47,453,276,177
050,26,057,"Michigan","Gratiot County",3,48,451,257,194
050,26,057,"Michigan","Gratiot County",3,49,510,293,217
050,26,057,"Michigan","Gratiot County",3,50,549,319,230
050,26,057,"Michigan","Gratiot County",3,51,534,297,237
050,26,057,"Michigan","Gratiot County",3,52,475,260,215
050,26,057,"Michigan","Gratiot County",3,53,504,277,227
050,26,057,"Michigan","Gratiot County",3,54,513,274,239
050,26,057,"Michigan","Gratiot County",3,55,527,272,255
050,26,057,"Michigan","Gratiot County",3,56,554,294,260
050,26,057,"Michigan","Gratiot County",3,57,567,303,264
050,26,057,"Michigan","Gratiot County",3,58,566,305,261
050,26,057,"Michigan","Gratiot County",3,59,550,288,262
050,26,057,"Michigan","Gratiot County",3,60,554,284,270
050,26,057,"Michigan","Gratiot County",3,61,538,282,256
050,26,057,"Michigan","Gratiot County",3,62,510,260,250
050,26,057,"Michigan","Gratiot County",3,63,525,284,241
050,26,057,"Michigan","Gratiot County",3,64,504,264,240
050,26,057,"Michigan","Gratiot County",3,65,472,243,229
050,26,057,"Michigan","Gratiot County",3,66,458,221,237
050,26,057,"Michigan","Gratiot County",3,67,435,203,232
050,26,057,"Michigan","Gratiot County",3,68,455,219,236
050,26,057,"Michigan","Gratiot County",3,69,434,212,222
050,26,057,"Michigan","Gratiot County",3,70,405,187,218
050,26,057,"Michigan","Gratiot County",3,71,361,167,194
050,26,057,"Michigan","Gratiot County",3,72,374,180,194
050,26,057,"Michigan","Gratiot County",3,73,348,175,173
050,26,057,"Michigan","Gratiot County",3,74,374,185,189
050,26,057,"Michigan","Gratiot County",3,75,277,125,152
050,26,057,"Michigan","Gratiot County",3,76,275,122,153
050,26,057,"Michigan","Gratiot County",3,77,260,119,141
050,26,057,"Michigan","Gratiot County",3,78,263,119,144
050,26,057,"Michigan","Gratiot County",3,79,234,100,134
050,26,057,"Michigan","Gratiot County",3,80,206,88,118
050,26,057,"Michigan","Gratiot County",3,81,185,82,103
050,26,057,"Michigan","Gratiot County",3,82,165,72,93
050,26,057,"Michigan","Gratiot County",3,83,153,71,82
050,26,057,"Michigan","Gratiot County",3,84,134,64,70
050,26,057,"Michigan","Gratiot County",3,85,933,335,598
050,26,057,"Michigan","Gratiot County",4,0,349,184,165
050,26,057,"Michigan","Gratiot County",4,1,360,180,180
050,26,057,"Michigan","Gratiot County",4,2,427,222,205
050,26,057,"Michigan","Gratiot County",4,3,408,205,203
050,26,057,"Michigan","Gratiot County",4,4,430,211,219
050,26,057,"Michigan","Gratiot County",4,5,414,209,205
050,26,057,"Michigan","Gratiot County",4,6,432,235,197
050,26,057,"Michigan","Gratiot County",4,7,444,248,196
050,26,057,"Michigan","Gratiot County",4,8,414,207,207
050,26,057,"Michigan","Gratiot County",4,9,435,207,228
050,26,057,"Michigan","Gratiot County",4,10,458,225,233
050,26,057,"Michigan","Gratiot County",4,11,469,249,220
050,26,057,"Michigan","Gratiot County",4,12,497,257,240
050,26,057,"Michigan","Gratiot County",4,13,477,244,233
050,26,057,"Michigan","Gratiot County",4,14,491,256,235
050,26,057,"Michigan","Gratiot County",4,15,501,242,259
050,26,057,"Michigan","Gratiot County",4,16,511,241,270
050,26,057,"Michigan","Gratiot County",4,17,512,260,252
050,26,057,"Michigan","Gratiot County",4,18,649,321,328
050,26,057,"Michigan","Gratiot County",4,19,836,446,390
050,26,057,"Michigan","Gratiot County",4,20,843,442,401
050,26,057,"Michigan","Gratiot County",4,21,773,422,351
050,26,057,"Michigan","Gratiot County",4,22,625,381,244
050,26,057,"Michigan","Gratiot County",4,23,551,339,212
050,26,057,"Michigan","Gratiot County",4,24,525,325,200
050,26,057,"Michigan","Gratiot County",4,25,521,333,188
050,26,057,"Michigan","Gratiot County",4,26,534,314,220
050,26,057,"Michigan","Gratiot County",4,27,540,332,208
050,26,057,"Michigan","Gratiot County",4,28,552,342,210
050,26,057,"Michigan","Gratiot County",4,29,540,336,204
050,26,057,"Michigan","Gratiot County",4,30,544,321,223
050,26,057,"Michigan","Gratiot County",4,31,577,337,240
050,26,057,"Michigan","Gratiot County",4,32,572,338,234
050,26,057,"Michigan","Gratiot County",4,33,541,339,202
050,26,057,"Michigan","Gratiot County",4,34,517,327,190
050,26,057,"Michigan","Gratiot County",4,35,507,308,199
050,26,057,"Michigan","Gratiot County",4,36,504,304,200
050,26,057,"Michigan","Gratiot County",4,37,529,310,219
050,26,057,"Michigan","Gratiot County",4,38,535,316,219
050,26,057,"Michigan","Gratiot County",4,39,568,340,228
050,26,057,"Michigan","Gratiot County",4,40,569,332,237
050,26,057,"Michigan","Gratiot County",4,41,565,343,222
050,26,057,"Michigan","Gratiot County",4,42,534,304,230
050,26,057,"Michigan","Gratiot County",4,43,529,309,220
050,26,057,"Michigan","Gratiot County",4,44,529,308,221
050,26,057,"Michigan","Gratiot County",4,45,508,292,216
050,26,057,"Michigan","Gratiot County",4,46,481,290,191
050,26,057,"Michigan","Gratiot County",4,47,475,289,186
050,26,057,"Michigan","Gratiot County",4,48,441,272,169
050,26,057,"Michigan","Gratiot County",4,49,456,258,198
050,26,057,"Michigan","Gratiot County",4,50,498,281,217
050,26,057,"Michigan","Gratiot County",4,51,560,321,239
050,26,057,"Michigan","Gratiot County",4,52,487,264,223
050,26,057,"Michigan","Gratiot County",4,53,493,279,214
050,26,057,"Michigan","Gratiot County",4,54,506,280,226
050,26,057,"Michigan","Gratiot County",4,55,494,256,238
050,26,057,"Michigan","Gratiot County",4,56,513,260,253
050,26,057,"Michigan","Gratiot County",4,57,540,288,252
050,26,057,"Michigan","Gratiot County",4,58,541,294,247
050,26,057,"Michigan","Gratiot County",4,59,556,296,260
050,26,057,"Michigan","Gratiot County",4,60,549,286,263
050,26,057,"Michigan","Gratiot County",4,61,545,276,269
050,26,057,"Michigan","Gratiot County",4,62,523,270,253
050,26,057,"Michigan","Gratiot County",4,63,502,259,243
050,26,057,"Michigan","Gratiot County",4,64,503,270,233
050,26,057,"Michigan","Gratiot County",4,65,490,254,236
050,26,057,"Michigan","Gratiot County",4,66,451,221,230
050,26,057,"Michigan","Gratiot County",4,67,455,227,228
050,26,057,"Michigan","Gratiot County",4,68,426,198,228
050,26,057,"Michigan","Gratiot County",4,69,443,211,232
050,26,057,"Michigan","Gratiot County",4,70,417,205,212
050,26,057,"Michigan","Gratiot County",4,71,386,173,213
050,26,057,"Michigan","Gratiot County",4,72,358,159,199
050,26,057,"Michigan","Gratiot County",4,73,354,172,182
050,26,057,"Michigan","Gratiot County",4,74,341,174,167
050,26,057,"Michigan","Gratiot County",4,75,359,173,186
050,26,057,"Michigan","Gratiot County",4,76,255,119,136
050,26,057,"Michigan","Gratiot County",4,77,267,117,150
050,26,057,"Michigan","Gratiot County",4,78,265,118,147
050,26,057,"Michigan","Gratiot County",4,79,247,110,137
050,26,057,"Michigan","Gratiot County",4,80,216,94,122
050,26,057,"Michigan","Gratiot County",4,81,194,83,111
050,26,057,"Michigan","Gratiot County",4,82,169,77,92
050,26,057,"Michigan","Gratiot County",4,83,140,64,76
050,26,057,"Michigan","Gratiot County",4,84,138,64,74
050,26,057,"Michigan","Gratiot County",4,85,924,354,570
050,26,057,"Michigan","Gratiot County",5,0,352,185,167
050,26,057,"Michigan","Gratiot County",5,1,368,196,172
050,26,057,"Michigan","Gratiot County",5,2,364,192,172
050,26,057,"Michigan","Gratiot County",5,3,438,224,214
050,26,057,"Michigan","Gratiot County",5,4,427,222,205
050,26,057,"Michigan","Gratiot County",5,5,423,205,218
050,26,057,"Michigan","Gratiot County",5,6,427,223,204
050,26,057,"Michigan","Gratiot County",5,7,431,232,199
050,26,057,"Michigan","Gratiot County",5,8,443,245,198
050,26,057,"Michigan","Gratiot County",5,9,422,215,207
050,26,057,"Michigan","Gratiot County",5,10,449,215,234
050,26,057,"Michigan","Gratiot County",5,11,463,225,238
050,26,057,"Michigan","Gratiot County",5,12,475,249,226
050,26,057,"Michigan","Gratiot County",5,13,504,256,248
050,26,057,"Michigan","Gratiot County",5,14,460,230,230
050,26,057,"Michigan","Gratiot County",5,15,494,251,243
050,26,057,"Michigan","Gratiot County",5,16,508,254,254
050,26,057,"Michigan","Gratiot County",5,17,525,256,269
050,26,057,"Michigan","Gratiot County",5,18,661,315,346
050,26,057,"Michigan","Gratiot County",5,19,842,449,393
050,26,057,"Michigan","Gratiot County",5,20,836,451,385
050,26,057,"Michigan","Gratiot County",5,21,791,425,366
050,26,057,"Michigan","Gratiot County",5,22,597,359,238
050,26,057,"Michigan","Gratiot County",5,23,553,338,215
050,26,057,"Michigan","Gratiot County",5,24,552,335,217
050,26,057,"Michigan","Gratiot County",5,25,548,337,211
050,26,057,"Michigan","Gratiot County",5,26,533,341,192
050,26,057,"Michigan","Gratiot County",5,27,572,335,237
050,26,057,"Michigan","Gratiot County",5,28,542,341,201
050,26,057,"Michigan","Gratiot County",5,29,565,355,210
050,26,057,"Michigan","Gratiot County",5,30,544,337,207
050,26,057,"Michigan","Gratiot County",5,31,553,329,224
050,26,057,"Michigan","Gratiot County",5,32,620,372,248
050,26,057,"Michigan","Gratiot County",5,33,572,340,232
050,26,057,"Michigan","Gratiot County",5,34,563,352,211
050,26,057,"Michigan","Gratiot County",5,35,519,325,194
050,26,057,"Michigan","Gratiot County",5,36,519,307,212
050,26,057,"Michigan","Gratiot County",5,37,514,313,201
050,26,057,"Michigan","Gratiot County",5,38,542,318,224
050,26,057,"Michigan","Gratiot County",5,39,560,340,220
050,26,057,"Michigan","Gratiot County",5,40,576,346,230
050,26,057,"Michigan","Gratiot County",5,41,567,330,237
050,26,057,"Michigan","Gratiot County",5,42,538,312,226
050,26,057,"Michigan","Gratiot County",5,43,569,334,235
050,26,057,"Michigan","Gratiot County",5,44,541,314,227
050,26,057,"Michigan","Gratiot County",5,45,517,299,218
050,26,057,"Michigan","Gratiot County",5,46,531,314,217
050,26,057,"Michigan","Gratiot County",5,47,479,287,192
050,26,057,"Michigan","Gratiot County",5,48,461,278,183
050,26,057,"Michigan","Gratiot County",5,49,450,276,174
050,26,057,"Michigan","Gratiot County",5,50,452,250,202
050,26,057,"Michigan","Gratiot County",5,51,514,297,217
050,26,057,"Michigan","Gratiot County",5,52,521,290,231
050,26,057,"Michigan","Gratiot County",5,53,501,281,220
050,26,057,"Michigan","Gratiot County",5,54,481,273,208
050,26,057,"Michigan","Gratiot County",5,55,483,259,224
050,26,057,"Michigan","Gratiot County",5,56,480,250,230
050,26,057,"Michigan","Gratiot County",5,57,499,248,251
050,26,057,"Michigan","Gratiot County",5,58,532,287,245
050,26,057,"Michigan","Gratiot County",5,59,539,290,249
050,26,057,"Michigan","Gratiot County",5,60,561,296,265
050,26,057,"Michigan","Gratiot County",5,61,526,268,258
050,26,057,"Michigan","Gratiot County",5,62,539,266,273
050,26,057,"Michigan","Gratiot County",5,63,515,268,247
050,26,057,"Michigan","Gratiot County",5,64,488,246,242
050,26,057,"Michigan","Gratiot County",5,65,493,260,233
050,26,057,"Michigan","Gratiot County",5,66,469,235,234
050,26,057,"Michigan","Gratiot County",5,67,446,228,218
050,26,057,"Michigan","Gratiot County",5,68,452,226,226
050,26,057,"Michigan","Gratiot County",5,69,416,185,231
050,26,057,"Michigan","Gratiot County",5,70,433,212,221
050,26,057,"Michigan","Gratiot County",5,71,399,192,207
050,26,057,"Michigan","Gratiot County",5,72,377,162,215
050,26,057,"Michigan","Gratiot County",5,73,342,159,183
050,26,057,"Michigan","Gratiot County",5,74,351,169,182
050,26,057,"Michigan","Gratiot County",5,75,338,169,169
050,26,057,"Michigan","Gratiot County",5,76,333,167,166
050,26,057,"Michigan","Gratiot County",5,77,253,116,137
050,26,057,"Michigan","Gratiot County",5,78,265,113,152
050,26,057,"Michigan","Gratiot County",5,79,247,112,135
050,26,057,"Michigan","Gratiot County",5,80,232,107,125
050,26,057,"Michigan","Gratiot County",5,81,206,89,117
050,26,057,"Michigan","Gratiot County",5,82,181,77,104
050,26,057,"Michigan","Gratiot County",5,83,149,69,80
050,26,057,"Michigan","Gratiot County",5,84,133,58,75
050,26,057,"Michigan","Gratiot County",5,85,922,368,554
050,26,059,"Michigan","Hillsdale County",1,0,494,253,241
050,26,059,"Michigan","Hillsdale County",1,1,495,251,244
050,26,059,"Michigan","Hillsdale County",1,2,495,253,242
050,26,059,"Michigan","Hillsdale County",1,3,527,277,250
050,26,059,"Michigan","Hillsdale County",1,4,536,282,254
050,26,059,"Michigan","Hillsdale County",1,5,528,270,258
050,26,059,"Michigan","Hillsdale County",1,6,569,286,283
050,26,059,"Michigan","Hillsdale County",1,7,528,243,285
050,26,059,"Michigan","Hillsdale County",1,8,518,274,244
050,26,059,"Michigan","Hillsdale County",1,9,523,266,257
050,26,059,"Michigan","Hillsdale County",1,10,537,269,268
050,26,059,"Michigan","Hillsdale County",1,11,565,304,261
050,26,059,"Michigan","Hillsdale County",1,12,593,318,275
050,26,059,"Michigan","Hillsdale County",1,13,590,298,292
050,26,059,"Michigan","Hillsdale County",1,14,592,310,282
050,26,059,"Michigan","Hillsdale County",1,15,612,310,302
050,26,059,"Michigan","Hillsdale County",1,16,605,297,308
050,26,059,"Michigan","Hillsdale County",1,17,620,314,306
050,26,059,"Michigan","Hillsdale County",1,18,637,320,317
050,26,059,"Michigan","Hillsdale County",1,19,720,363,357
050,26,059,"Michigan","Hillsdale County",1,20,700,340,360
050,26,059,"Michigan","Hillsdale County",1,21,612,303,309
050,26,059,"Michigan","Hillsdale County",1,22,580,289,291
050,26,059,"Michigan","Hillsdale County",1,23,516,263,253
050,26,059,"Michigan","Hillsdale County",1,24,490,255,235
050,26,059,"Michigan","Hillsdale County",1,25,469,249,220
050,26,059,"Michigan","Hillsdale County",1,26,481,245,236
050,26,059,"Michigan","Hillsdale County",1,27,473,240,233
050,26,059,"Michigan","Hillsdale County",1,28,506,254,252
050,26,059,"Michigan","Hillsdale County",1,29,507,259,248
050,26,059,"Michigan","Hillsdale County",1,30,515,263,252
050,26,059,"Michigan","Hillsdale County",1,31,474,254,220
050,26,059,"Michigan","Hillsdale County",1,32,452,242,210
050,26,059,"Michigan","Hillsdale County",1,33,469,237,232
050,26,059,"Michigan","Hillsdale County",1,34,463,236,227
050,26,059,"Michigan","Hillsdale County",1,35,476,229,247
050,26,059,"Michigan","Hillsdale County",1,36,484,237,247
050,26,059,"Michigan","Hillsdale County",1,37,515,256,259
050,26,059,"Michigan","Hillsdale County",1,38,507,245,262
050,26,059,"Michigan","Hillsdale County",1,39,505,252,253
050,26,059,"Michigan","Hillsdale County",1,40,493,253,240
050,26,059,"Michigan","Hillsdale County",1,41,507,250,257
050,26,059,"Michigan","Hillsdale County",1,42,527,267,260
050,26,059,"Michigan","Hillsdale County",1,43,498,248,250
050,26,059,"Michigan","Hillsdale County",1,44,494,247,247
050,26,059,"Michigan","Hillsdale County",1,45,477,231,246
050,26,059,"Michigan","Hillsdale County",1,46,527,268,259
050,26,059,"Michigan","Hillsdale County",1,47,505,272,233
050,26,059,"Michigan","Hillsdale County",1,48,563,298,265
050,26,059,"Michigan","Hillsdale County",1,49,598,315,283
050,26,059,"Michigan","Hillsdale County",1,50,568,297,271
050,26,059,"Michigan","Hillsdale County",1,51,574,280,294
050,26,059,"Michigan","Hillsdale County",1,52,546,280,266
050,26,059,"Michigan","Hillsdale County",1,53,570,291,279
050,26,059,"Michigan","Hillsdale County",1,54,569,295,274
050,26,059,"Michigan","Hillsdale County",1,55,622,325,297
050,26,059,"Michigan","Hillsdale County",1,56,686,355,331
050,26,059,"Michigan","Hillsdale County",1,57,643,327,316
050,26,059,"Michigan","Hillsdale County",1,58,679,345,334
050,26,059,"Michigan","Hillsdale County",1,59,725,350,375
050,26,059,"Michigan","Hillsdale County",1,60,702,360,342
050,26,059,"Michigan","Hillsdale County",1,61,737,377,360
050,26,059,"Michigan","Hillsdale County",1,62,745,360,385
050,26,059,"Michigan","Hillsdale County",1,63,760,366,394
050,26,059,"Michigan","Hillsdale County",1,64,713,356,357
050,26,059,"Michigan","Hillsdale County",1,65,699,338,361
050,26,059,"Michigan","Hillsdale County",1,66,667,355,312
050,26,059,"Michigan","Hillsdale County",1,67,634,324,310
050,26,059,"Michigan","Hillsdale County",1,68,620,312,308
050,26,059,"Michigan","Hillsdale County",1,69,591,314,277
050,26,059,"Michigan","Hillsdale County",1,70,517,273,244
050,26,059,"Michigan","Hillsdale County",1,71,508,239,269
050,26,059,"Michigan","Hillsdale County",1,72,512,231,281
050,26,059,"Michigan","Hillsdale County",1,73,486,214,272
050,26,059,"Michigan","Hillsdale County",1,74,369,172,197
050,26,059,"Michigan","Hillsdale County",1,75,344,169,175
050,26,059,"Michigan","Hillsdale County",1,76,365,178,187
050,26,059,"Michigan","Hillsdale County",1,77,356,176,180
050,26,059,"Michigan","Hillsdale County",1,78,304,154,150
050,26,059,"Michigan","Hillsdale County",1,79,271,139,132
050,26,059,"Michigan","Hillsdale County",1,80,253,122,131
050,26,059,"Michigan","Hillsdale County",1,81,242,115,127
050,26,059,"Michigan","Hillsdale County",1,82,214,100,114
050,26,059,"Michigan","Hillsdale County",1,83,197,94,103
050,26,059,"Michigan","Hillsdale County",1,84,158,65,93
050,26,059,"Michigan","Hillsdale County",1,85,941,307,634
050,26,059,"Michigan","Hillsdale County",2,0,504,256,248
050,26,059,"Michigan","Hillsdale County",2,1,490,248,242
050,26,059,"Michigan","Hillsdale County",2,2,493,251,242
050,26,059,"Michigan","Hillsdale County",2,3,518,271,247
050,26,059,"Michigan","Hillsdale County",2,4,537,284,253
050,26,059,"Michigan","Hillsdale County",2,5,530,273,257
050,26,059,"Michigan","Hillsdale County",2,6,563,283,280
050,26,059,"Michigan","Hillsdale County",2,7,539,254,285
050,26,059,"Michigan","Hillsdale County",2,8,518,266,252
050,26,059,"Michigan","Hillsdale County",2,9,524,268,256
050,26,059,"Michigan","Hillsdale County",2,10,536,269,267
050,26,059,"Michigan","Hillsdale County",2,11,557,297,260
050,26,059,"Michigan","Hillsdale County",2,12,587,314,273
050,26,059,"Michigan","Hillsdale County",2,13,592,302,290
050,26,059,"Michigan","Hillsdale County",2,14,596,310,286
050,26,059,"Michigan","Hillsdale County",2,15,607,310,297
050,26,059,"Michigan","Hillsdale County",2,16,612,302,310
050,26,059,"Michigan","Hillsdale County",2,17,618,312,306
050,26,059,"Michigan","Hillsdale County",2,18,637,315,322
050,26,059,"Michigan","Hillsdale County",2,19,716,363,353
050,26,059,"Michigan","Hillsdale County",2,20,704,341,363
050,26,059,"Michigan","Hillsdale County",2,21,618,302,316
050,26,059,"Michigan","Hillsdale County",2,22,572,284,288
050,26,059,"Michigan","Hillsdale County",2,23,519,265,254
050,26,059,"Michigan","Hillsdale County",2,24,489,252,237
050,26,059,"Michigan","Hillsdale County",2,25,470,248,222
050,26,059,"Michigan","Hillsdale County",2,26,478,248,230
050,26,059,"Michigan","Hillsdale County",2,27,473,240,233
050,26,059,"Michigan","Hillsdale County",2,28,500,251,249
050,26,059,"Michigan","Hillsdale County",2,29,511,258,253
050,26,059,"Michigan","Hillsdale County",2,30,516,264,252
050,26,059,"Michigan","Hillsdale County",2,31,484,256,228
050,26,059,"Michigan","Hillsdale County",2,32,457,244,213
050,26,059,"Michigan","Hillsdale County",2,33,467,238,229
050,26,059,"Michigan","Hillsdale County",2,34,471,240,231
050,26,059,"Michigan","Hillsdale County",2,35,476,232,244
050,26,059,"Michigan","Hillsdale County",2,36,479,234,245
050,26,059,"Michigan","Hillsdale County",2,37,509,251,258
050,26,059,"Michigan","Hillsdale County",2,38,509,248,261
050,26,059,"Michigan","Hillsdale County",2,39,502,249,253
050,26,059,"Michigan","Hillsdale County",2,40,502,256,246
050,26,059,"Michigan","Hillsdale County",2,41,506,253,253
050,26,059,"Michigan","Hillsdale County",2,42,523,264,259
050,26,059,"Michigan","Hillsdale County",2,43,514,257,257
050,26,059,"Michigan","Hillsdale County",2,44,487,241,246
050,26,059,"Michigan","Hillsdale County",2,45,484,237,247
050,26,059,"Michigan","Hillsdale County",2,46,511,257,254
050,26,059,"Michigan","Hillsdale County",2,47,505,270,235
050,26,059,"Michigan","Hillsdale County",2,48,548,291,257
050,26,059,"Michigan","Hillsdale County",2,49,592,312,280
050,26,059,"Michigan","Hillsdale County",2,50,576,300,276
050,26,059,"Michigan","Hillsdale County",2,51,571,283,288
050,26,059,"Michigan","Hillsdale County",2,52,547,280,267
050,26,059,"Michigan","Hillsdale County",2,53,561,287,274
050,26,059,"Michigan","Hillsdale County",2,54,567,293,274
050,26,059,"Michigan","Hillsdale County",2,55,608,318,290
050,26,059,"Michigan","Hillsdale County",2,56,675,349,326
050,26,059,"Michigan","Hillsdale County",2,57,658,335,323
050,26,059,"Michigan","Hillsdale County",2,58,670,341,329
050,26,059,"Michigan","Hillsdale County",2,59,715,348,367
050,26,059,"Michigan","Hillsdale County",2,60,704,356,348
050,26,059,"Michigan","Hillsdale County",2,61,725,371,354
050,26,059,"Michigan","Hillsdale County",2,62,740,362,378
050,26,059,"Michigan","Hillsdale County",2,63,764,369,395
050,26,059,"Michigan","Hillsdale County",2,64,718,355,363
050,26,059,"Michigan","Hillsdale County",2,65,707,345,362
050,26,059,"Michigan","Hillsdale County",2,66,676,352,324
050,26,059,"Michigan","Hillsdale County",2,67,639,329,310
050,26,059,"Michigan","Hillsdale County",2,68,617,312,305
050,26,059,"Michigan","Hillsdale County",2,69,597,312,285
050,26,059,"Michigan","Hillsdale County",2,70,533,282,251
050,26,059,"Michigan","Hillsdale County",2,71,509,246,263
050,26,059,"Michigan","Hillsdale County",2,72,503,227,276
050,26,059,"Michigan","Hillsdale County",2,73,517,231,286
050,26,059,"Michigan","Hillsdale County",2,74,368,169,199
050,26,059,"Michigan","Hillsdale County",2,75,349,168,181
050,26,059,"Michigan","Hillsdale County",2,76,349,168,181
050,26,059,"Michigan","Hillsdale County",2,77,355,170,185
050,26,059,"Michigan","Hillsdale County",2,78,303,155,148
050,26,059,"Michigan","Hillsdale County",2,79,272,140,132
050,26,059,"Michigan","Hillsdale County",2,80,256,125,131
050,26,059,"Michigan","Hillsdale County",2,81,239,115,124
050,26,059,"Michigan","Hillsdale County",2,82,214,97,117
050,26,059,"Michigan","Hillsdale County",2,83,190,86,104
050,26,059,"Michigan","Hillsdale County",2,84,162,68,94
050,26,059,"Michigan","Hillsdale County",2,85,927,300,627
050,26,059,"Michigan","Hillsdale County",3,0,468,255,213
050,26,059,"Michigan","Hillsdale County",3,1,515,251,264
050,26,059,"Michigan","Hillsdale County",3,2,490,252,238
050,26,059,"Michigan","Hillsdale County",3,3,486,247,239
050,26,059,"Michigan","Hillsdale County",3,4,550,297,253
050,26,059,"Michigan","Hillsdale County",3,5,538,288,250
050,26,059,"Michigan","Hillsdale County",3,6,517,260,257
050,26,059,"Michigan","Hillsdale County",3,7,557,285,272
050,26,059,"Michigan","Hillsdale County",3,8,548,257,291
050,26,059,"Michigan","Hillsdale County",3,9,521,263,258
050,26,059,"Michigan","Hillsdale County",3,10,536,272,264
050,26,059,"Michigan","Hillsdale County",3,11,543,278,265
050,26,059,"Michigan","Hillsdale County",3,12,554,292,262
050,26,059,"Michigan","Hillsdale County",3,13,576,310,266
050,26,059,"Michigan","Hillsdale County",3,14,608,311,297
050,26,059,"Michigan","Hillsdale County",3,15,573,293,280
050,26,059,"Michigan","Hillsdale County",3,16,602,309,293
050,26,059,"Michigan","Hillsdale County",3,17,614,304,310
050,26,059,"Michigan","Hillsdale County",3,18,636,306,330
050,26,059,"Michigan","Hillsdale County",3,19,707,370,337
050,26,059,"Michigan","Hillsdale County",3,20,679,334,345
050,26,059,"Michigan","Hillsdale County",3,21,601,297,304
050,26,059,"Michigan","Hillsdale County",3,22,572,277,295
050,26,059,"Michigan","Hillsdale County",3,23,512,262,250
050,26,059,"Michigan","Hillsdale County",3,24,513,261,252
050,26,059,"Michigan","Hillsdale County",3,25,474,254,220
050,26,059,"Michigan","Hillsdale County",3,26,467,242,225
050,26,059,"Michigan","Hillsdale County",3,27,494,261,233
050,26,059,"Michigan","Hillsdale County",3,28,461,242,219
050,26,059,"Michigan","Hillsdale County",3,29,509,255,254
050,26,059,"Michigan","Hillsdale County",3,30,513,260,253
050,26,059,"Michigan","Hillsdale County",3,31,512,255,257
050,26,059,"Michigan","Hillsdale County",3,32,486,253,233
050,26,059,"Michigan","Hillsdale County",3,33,487,259,228
050,26,059,"Michigan","Hillsdale County",3,34,468,239,229
050,26,059,"Michigan","Hillsdale County",3,35,483,247,236
050,26,059,"Michigan","Hillsdale County",3,36,480,231,249
050,26,059,"Michigan","Hillsdale County",3,37,484,239,245
050,26,059,"Michigan","Hillsdale County",3,38,511,257,254
050,26,059,"Michigan","Hillsdale County",3,39,519,258,261
050,26,059,"Michigan","Hillsdale County",3,40,498,249,249
050,26,059,"Michigan","Hillsdale County",3,41,499,260,239
050,26,059,"Michigan","Hillsdale County",3,42,492,239,253
050,26,059,"Michigan","Hillsdale County",3,43,529,269,260
050,26,059,"Michigan","Hillsdale County",3,44,510,253,257
050,26,059,"Michigan","Hillsdale County",3,45,482,243,239
050,26,059,"Michigan","Hillsdale County",3,46,496,239,257
050,26,059,"Michigan","Hillsdale County",3,47,508,257,251
050,26,059,"Michigan","Hillsdale County",3,48,497,261,236
050,26,059,"Michigan","Hillsdale County",3,49,561,300,261
050,26,059,"Michigan","Hillsdale County",3,50,581,311,270
050,26,059,"Michigan","Hillsdale County",3,51,586,307,279
050,26,059,"Michigan","Hillsdale County",3,52,575,286,289
050,26,059,"Michigan","Hillsdale County",3,53,559,281,278
050,26,059,"Michigan","Hillsdale County",3,54,547,286,261
050,26,059,"Michigan","Hillsdale County",3,55,576,302,274
050,26,059,"Michigan","Hillsdale County",3,56,608,314,294
050,26,059,"Michigan","Hillsdale County",3,57,679,353,326
050,26,059,"Michigan","Hillsdale County",3,58,662,335,327
050,26,059,"Michigan","Hillsdale County",3,59,659,330,329
050,26,059,"Michigan","Hillsdale County",3,60,719,341,378
050,26,059,"Michigan","Hillsdale County",3,61,696,351,345
050,26,059,"Michigan","Hillsdale County",3,62,722,369,353
050,26,059,"Michigan","Hillsdale County",3,63,737,361,376
050,26,059,"Michigan","Hillsdale County",3,64,777,369,408
050,26,059,"Michigan","Hillsdale County",3,65,730,363,367
050,26,059,"Michigan","Hillsdale County",3,66,706,341,365
050,26,059,"Michigan","Hillsdale County",3,67,660,347,313
050,26,059,"Michigan","Hillsdale County",3,68,622,323,299
050,26,059,"Michigan","Hillsdale County",3,69,600,301,299
050,26,059,"Michigan","Hillsdale County",3,70,579,305,274
050,26,059,"Michigan","Hillsdale County",3,71,524,277,247
050,26,059,"Michigan","Hillsdale County",3,72,479,236,243
050,26,059,"Michigan","Hillsdale County",3,73,492,223,269
050,26,059,"Michigan","Hillsdale County",3,74,496,220,276
050,26,059,"Michigan","Hillsdale County",3,75,351,164,187
050,26,059,"Michigan","Hillsdale County",3,76,334,163,171
050,26,059,"Michigan","Hillsdale County",3,77,323,152,171
050,26,059,"Michigan","Hillsdale County",3,78,337,167,170
050,26,059,"Michigan","Hillsdale County",3,79,275,137,138
050,26,059,"Michigan","Hillsdale County",3,80,249,127,122
050,26,059,"Michigan","Hillsdale County",3,81,251,123,128
050,26,059,"Michigan","Hillsdale County",3,82,221,100,121
050,26,059,"Michigan","Hillsdale County",3,83,187,78,109
050,26,059,"Michigan","Hillsdale County",3,84,171,75,96
050,26,059,"Michigan","Hillsdale County",3,85,919,308,611
050,26,059,"Michigan","Hillsdale County",4,0,484,246,238
050,26,059,"Michigan","Hillsdale County",4,1,486,261,225
050,26,059,"Michigan","Hillsdale County",4,2,524,257,267
050,26,059,"Michigan","Hillsdale County",4,3,494,257,237
050,26,059,"Michigan","Hillsdale County",4,4,492,254,238
050,26,059,"Michigan","Hillsdale County",4,5,565,302,263
050,26,059,"Michigan","Hillsdale County",4,6,558,302,256
050,26,059,"Michigan","Hillsdale County",4,7,537,274,263
050,26,059,"Michigan","Hillsdale County",4,8,582,299,283
050,26,059,"Michigan","Hillsdale County",4,9,555,257,298
050,26,059,"Michigan","Hillsdale County",4,10,531,271,260
050,26,059,"Michigan","Hillsdale County",4,11,570,283,287
050,26,059,"Michigan","Hillsdale County",4,12,547,275,272
050,26,059,"Michigan","Hillsdale County",4,13,565,284,281
050,26,059,"Michigan","Hillsdale County",4,14,579,309,270
050,26,059,"Michigan","Hillsdale County",4,15,613,311,302
050,26,059,"Michigan","Hillsdale County",4,16,596,302,294
050,26,059,"Michigan","Hillsdale County",4,17,606,304,302
050,26,059,"Michigan","Hillsdale County",4,18,642,307,335
050,26,059,"Michigan","Hillsdale County",4,19,708,355,353
050,26,059,"Michigan","Hillsdale County",4,20,680,342,338
050,26,059,"Michigan","Hillsdale County",4,21,597,292,305
050,26,059,"Michigan","Hillsdale County",4,22,566,287,279
050,26,059,"Michigan","Hillsdale County",4,23,531,265,266
050,26,059,"Michigan","Hillsdale County",4,24,464,233,231
050,26,059,"Michigan","Hillsdale County",4,25,478,243,235
050,26,059,"Michigan","Hillsdale County",4,26,476,257,219
050,26,059,"Michigan","Hillsdale County",4,27,486,242,244
050,26,059,"Michigan","Hillsdale County",4,28,523,271,252
050,26,059,"Michigan","Hillsdale County",4,29,463,242,221
050,26,059,"Michigan","Hillsdale County",4,30,494,248,246
050,26,059,"Michigan","Hillsdale County",4,31,523,264,259
050,26,059,"Michigan","Hillsdale County",4,32,518,260,258
050,26,059,"Michigan","Hillsdale County",4,33,494,258,236
050,26,059,"Michigan","Hillsdale County",4,34,491,253,238
050,26,059,"Michigan","Hillsdale County",4,35,470,242,228
050,26,059,"Michigan","Hillsdale County",4,36,478,243,235
050,26,059,"Michigan","Hillsdale County",4,37,488,231,257
050,26,059,"Michigan","Hillsdale County",4,38,484,237,247
050,26,059,"Michigan","Hillsdale County",4,39,512,255,257
050,26,059,"Michigan","Hillsdale County",4,40,523,261,262
050,26,059,"Michigan","Hillsdale County",4,41,504,254,250
050,26,059,"Michigan","Hillsdale County",4,42,499,260,239
050,26,059,"Michigan","Hillsdale County",4,43,512,244,268
050,26,059,"Michigan","Hillsdale County",4,44,528,264,264
050,26,059,"Michigan","Hillsdale County",4,45,509,254,255
050,26,059,"Michigan","Hillsdale County",4,46,485,237,248
050,26,059,"Michigan","Hillsdale County",4,47,492,244,248
050,26,059,"Michigan","Hillsdale County",4,48,511,255,256
050,26,059,"Michigan","Hillsdale County",4,49,506,262,244
050,26,059,"Michigan","Hillsdale County",4,50,570,299,271
050,26,059,"Michigan","Hillsdale County",4,51,585,309,276
050,26,059,"Michigan","Hillsdale County",4,52,585,309,276
050,26,059,"Michigan","Hillsdale County",4,53,583,297,286
050,26,059,"Michigan","Hillsdale County",4,54,537,278,259
050,26,059,"Michigan","Hillsdale County",4,55,550,291,259
050,26,059,"Michigan","Hillsdale County",4,56,578,301,277
050,26,059,"Michigan","Hillsdale County",4,57,604,315,289
050,26,059,"Michigan","Hillsdale County",4,58,675,344,331
050,26,059,"Michigan","Hillsdale County",4,59,665,344,321
050,26,059,"Michigan","Hillsdale County",4,60,675,338,337
050,26,059,"Michigan","Hillsdale County",4,61,718,343,375
050,26,059,"Michigan","Hillsdale County",4,62,683,347,336
050,26,059,"Michigan","Hillsdale County",4,63,722,367,355
050,26,059,"Michigan","Hillsdale County",4,64,745,365,380
050,26,059,"Michigan","Hillsdale County",4,65,751,360,391
050,26,059,"Michigan","Hillsdale County",4,66,726,350,376
050,26,059,"Michigan","Hillsdale County",4,67,695,336,359
050,26,059,"Michigan","Hillsdale County",4,68,648,337,311
050,26,059,"Michigan","Hillsdale County",4,69,598,309,289
050,26,059,"Michigan","Hillsdale County",4,70,570,276,294
050,26,059,"Michigan","Hillsdale County",4,71,561,297,264
050,26,059,"Michigan","Hillsdale County",4,72,492,262,230
050,26,059,"Michigan","Hillsdale County",4,73,465,229,236
050,26,059,"Michigan","Hillsdale County",4,74,487,223,264
050,26,059,"Michigan","Hillsdale County",4,75,471,216,255
050,26,059,"Michigan","Hillsdale County",4,76,342,162,180
050,26,059,"Michigan","Hillsdale County",4,77,309,145,164
050,26,059,"Michigan","Hillsdale County",4,78,315,149,166
050,26,059,"Michigan","Hillsdale County",4,79,310,151,159
050,26,059,"Michigan","Hillsdale County",4,80,259,127,132
050,26,059,"Michigan","Hillsdale County",4,81,237,123,114
050,26,059,"Michigan","Hillsdale County",4,82,234,112,122
050,26,059,"Michigan","Hillsdale County",4,83,199,88,111
050,26,059,"Michigan","Hillsdale County",4,84,155,61,94
050,26,059,"Michigan","Hillsdale County",4,85,917,323,594
050,26,059,"Michigan","Hillsdale County",5,0,442,222,220
050,26,059,"Michigan","Hillsdale County",5,1,483,238,245
050,26,059,"Michigan","Hillsdale County",5,2,468,245,223
050,26,059,"Michigan","Hillsdale County",5,3,515,254,261
050,26,059,"Michigan","Hillsdale County",5,4,512,258,254
050,26,059,"Michigan","Hillsdale County",5,5,512,267,245
050,26,059,"Michigan","Hillsdale County",5,6,581,312,269
050,26,059,"Michigan","Hillsdale County",5,7,545,293,252
050,26,059,"Michigan","Hillsdale County",5,8,558,286,272
050,26,059,"Michigan","Hillsdale County",5,9,582,299,283
050,26,059,"Michigan","Hillsdale County",5,10,558,250,308
050,26,059,"Michigan","Hillsdale County",5,11,537,274,263
050,26,059,"Michigan","Hillsdale County",5,12,574,289,285
050,26,059,"Michigan","Hillsdale County",5,13,541,274,267
050,26,059,"Michigan","Hillsdale County",5,14,574,292,282
050,26,059,"Michigan","Hillsdale County",5,15,581,316,265
050,26,059,"Michigan","Hillsdale County",5,16,624,314,310
050,26,059,"Michigan","Hillsdale County",5,17,617,322,295
050,26,059,"Michigan","Hillsdale County",5,18,637,315,322
050,26,059,"Michigan","Hillsdale County",5,19,713,363,350
050,26,059,"Michigan","Hillsdale County",5,20,684,329,355
050,26,059,"Michigan","Hillsdale County",5,21,606,296,310
050,26,059,"Michigan","Hillsdale County",5,22,538,272,266
050,26,059,"Michigan","Hillsdale County",5,23,508,271,237
050,26,059,"Michigan","Hillsdale County",5,24,515,257,258
050,26,059,"Michigan","Hillsdale County",5,25,466,238,228
050,26,059,"Michigan","Hillsdale County",5,26,457,235,222
050,26,059,"Michigan","Hillsdale County",5,27,451,242,209
050,26,059,"Michigan","Hillsdale County",5,28,470,239,231
050,26,059,"Michigan","Hillsdale County",5,29,512,258,254
050,26,059,"Michigan","Hillsdale County",5,30,471,248,223
050,26,059,"Michigan","Hillsdale County",5,31,499,247,252
050,26,059,"Michigan","Hillsdale County",5,32,518,259,259
050,26,059,"Michigan","Hillsdale County",5,33,513,259,254
050,26,059,"Michigan","Hillsdale County",5,34,500,252,248
050,26,059,"Michigan","Hillsdale County",5,35,495,262,233
050,26,059,"Michigan","Hillsdale County",5,36,482,247,235
050,26,059,"Michigan","Hillsdale County",5,37,477,240,237
050,26,059,"Michigan","Hillsdale County",5,38,493,239,254
050,26,059,"Michigan","Hillsdale County",5,39,481,232,249
050,26,059,"Michigan","Hillsdale County",5,40,532,265,267
050,26,059,"Michigan","Hillsdale County",5,41,527,263,264
050,26,059,"Michigan","Hillsdale County",5,42,511,261,250
050,26,059,"Michigan","Hillsdale County",5,43,505,261,244
050,26,059,"Michigan","Hillsdale County",5,44,511,244,267
050,26,059,"Michigan","Hillsdale County",5,45,524,262,262
050,26,059,"Michigan","Hillsdale County",5,46,511,254,257
050,26,059,"Michigan","Hillsdale County",5,47,487,241,246
050,26,059,"Michigan","Hillsdale County",5,48,485,235,250
050,26,059,"Michigan","Hillsdale County",5,49,512,256,256
050,26,059,"Michigan","Hillsdale County",5,50,512,264,248
050,26,059,"Michigan","Hillsdale County",5,51,563,298,265
050,26,059,"Michigan","Hillsdale County",5,52,564,296,268
050,26,059,"Michigan","Hillsdale County",5,53,599,314,285
050,26,059,"Michigan","Hillsdale County",5,54,567,292,275
050,26,059,"Michigan","Hillsdale County",5,55,535,280,255
050,26,059,"Michigan","Hillsdale County",5,56,544,287,257
050,26,059,"Michigan","Hillsdale County",5,57,560,290,270
050,26,059,"Michigan","Hillsdale County",5,58,599,315,284
050,26,059,"Michigan","Hillsdale County",5,59,677,344,333
050,26,059,"Michigan","Hillsdale County",5,60,668,343,325
050,26,059,"Michigan","Hillsdale County",5,61,692,351,341
050,26,059,"Michigan","Hillsdale County",5,62,710,339,371
050,26,059,"Michigan","Hillsdale County",5,63,672,343,329
050,26,059,"Michigan","Hillsdale County",5,64,722,364,358
050,26,059,"Michigan","Hillsdale County",5,65,738,356,382
050,26,059,"Michigan","Hillsdale County",5,66,750,357,393
050,26,059,"Michigan","Hillsdale County",5,67,700,337,363
050,26,059,"Michigan","Hillsdale County",5,68,676,330,346
050,26,059,"Michigan","Hillsdale County",5,69,622,325,297
050,26,059,"Michigan","Hillsdale County",5,70,585,295,290
050,26,059,"Michigan","Hillsdale County",5,71,559,271,288
050,26,059,"Michigan","Hillsdale County",5,72,543,291,252
050,26,059,"Michigan","Hillsdale County",5,73,480,256,224
050,26,059,"Michigan","Hillsdale County",5,74,454,224,230
050,26,059,"Michigan","Hillsdale County",5,75,460,212,248
050,26,059,"Michigan","Hillsdale County",5,76,456,208,248
050,26,059,"Michigan","Hillsdale County",5,77,323,151,172
050,26,059,"Michigan","Hillsdale County",5,78,300,144,156
050,26,059,"Michigan","Hillsdale County",5,79,288,135,153
050,26,059,"Michigan","Hillsdale County",5,80,286,134,152
050,26,059,"Michigan","Hillsdale County",5,81,241,117,124
050,26,059,"Michigan","Hillsdale County",5,82,224,110,114
050,26,059,"Michigan","Hillsdale County",5,83,214,100,114
050,26,059,"Michigan","Hillsdale County",5,84,175,74,101
050,26,059,"Michigan","Hillsdale County",5,85,934,335,599
050,26,061,"Michigan","Houghton County",1,0,371,189,182
050,26,061,"Michigan","Houghton County",1,1,367,189,178
050,26,061,"Michigan","Houghton County",1,2,362,195,167
050,26,061,"Michigan","Houghton County",1,3,377,214,163
050,26,061,"Michigan","Houghton County",1,4,391,197,194
050,26,061,"Michigan","Houghton County",1,5,392,195,197
050,26,061,"Michigan","Houghton County",1,6,376,194,182
050,26,061,"Michigan","Houghton County",1,7,402,219,183
050,26,061,"Michigan","Houghton County",1,8,396,204,192
050,26,061,"Michigan","Houghton County",1,9,404,220,184
050,26,061,"Michigan","Houghton County",1,10,436,235,201
050,26,061,"Michigan","Houghton County",1,11,453,225,228
050,26,061,"Michigan","Houghton County",1,12,459,240,219
050,26,061,"Michigan","Houghton County",1,13,463,242,221
050,26,061,"Michigan","Houghton County",1,14,443,223,220
050,26,061,"Michigan","Houghton County",1,15,467,250,217
050,26,061,"Michigan","Houghton County",1,16,467,245,222
050,26,061,"Michigan","Houghton County",1,17,439,229,210
050,26,061,"Michigan","Houghton County",1,18,1067,672,395
050,26,061,"Michigan","Houghton County",1,19,1756,1214,542
050,26,061,"Michigan","Houghton County",1,20,1493,1012,481
050,26,061,"Michigan","Houghton County",1,21,1478,973,505
050,26,061,"Michigan","Houghton County",1,22,1276,896,380
050,26,061,"Michigan","Houghton County",1,23,881,598,283
050,26,061,"Michigan","Houghton County",1,24,596,350,246
050,26,061,"Michigan","Houghton County",1,25,442,254,188
050,26,061,"Michigan","Houghton County",1,26,390,221,169
050,26,061,"Michigan","Houghton County",1,27,347,184,163
050,26,061,"Michigan","Houghton County",1,28,351,181,170
050,26,061,"Michigan","Houghton County",1,29,385,206,179
050,26,061,"Michigan","Houghton County",1,30,389,221,168
050,26,061,"Michigan","Houghton County",1,31,332,183,149
050,26,061,"Michigan","Houghton County",1,32,309,161,148
050,26,061,"Michigan","Houghton County",1,33,361,207,154
050,26,061,"Michigan","Houghton County",1,34,343,187,156
050,26,061,"Michigan","Houghton County",1,35,327,167,160
050,26,061,"Michigan","Houghton County",1,36,359,189,170
050,26,061,"Michigan","Houghton County",1,37,386,203,183
050,26,061,"Michigan","Houghton County",1,38,372,189,183
050,26,061,"Michigan","Houghton County",1,39,338,172,166
050,26,061,"Michigan","Houghton County",1,40,344,175,169
050,26,061,"Michigan","Houghton County",1,41,329,168,161
050,26,061,"Michigan","Houghton County",1,42,341,162,179
050,26,061,"Michigan","Houghton County",1,43,343,174,169
050,26,061,"Michigan","Houghton County",1,44,337,167,170
050,26,061,"Michigan","Houghton County",1,45,336,181,155
050,26,061,"Michigan","Houghton County",1,46,319,170,149
050,26,061,"Michigan","Houghton County",1,47,316,155,161
050,26,061,"Michigan","Houghton County",1,48,326,164,162
050,26,061,"Michigan","Houghton County",1,49,366,197,169
050,26,061,"Michigan","Houghton County",1,50,363,191,172
050,26,061,"Michigan","Houghton County",1,51,344,188,156
050,26,061,"Michigan","Houghton County",1,52,331,185,146
050,26,061,"Michigan","Houghton County",1,53,362,190,172
050,26,061,"Michigan","Houghton County",1,54,360,177,183
050,26,061,"Michigan","Houghton County",1,55,400,190,210
050,26,061,"Michigan","Houghton County",1,56,421,211,210
050,26,061,"Michigan","Houghton County",1,57,441,233,208
050,26,061,"Michigan","Houghton County",1,58,439,229,210
050,26,061,"Michigan","Houghton County",1,59,424,206,218
050,26,061,"Michigan","Houghton County",1,60,402,201,201
050,26,061,"Michigan","Houghton County",1,61,422,216,206
050,26,061,"Michigan","Houghton County",1,62,446,233,213
050,26,061,"Michigan","Houghton County",1,63,444,227,217
050,26,061,"Michigan","Houghton County",1,64,411,213,198
050,26,061,"Michigan","Houghton County",1,65,433,226,207
050,26,061,"Michigan","Houghton County",1,66,421,213,208
050,26,061,"Michigan","Houghton County",1,67,455,234,221
050,26,061,"Michigan","Houghton County",1,68,447,228,219
050,26,061,"Michigan","Houghton County",1,69,381,185,196
050,26,061,"Michigan","Houghton County",1,70,365,196,169
050,26,061,"Michigan","Houghton County",1,71,360,181,179
050,26,061,"Michigan","Houghton County",1,72,360,188,172
050,26,061,"Michigan","Houghton County",1,73,347,177,170
050,26,061,"Michigan","Houghton County",1,74,259,127,132
050,26,061,"Michigan","Houghton County",1,75,266,132,134
050,26,061,"Michigan","Houghton County",1,76,243,122,121
050,26,061,"Michigan","Houghton County",1,77,249,117,132
050,26,061,"Michigan","Houghton County",1,78,203,88,115
050,26,061,"Michigan","Houghton County",1,79,181,83,98
050,26,061,"Michigan","Houghton County",1,80,178,87,91
050,26,061,"Michigan","Houghton County",1,81,184,84,100
050,26,061,"Michigan","Houghton County",1,82,154,71,83
050,26,061,"Michigan","Houghton County",1,83,136,60,76
050,26,061,"Michigan","Houghton County",1,84,125,51,74
050,26,061,"Michigan","Houghton County",1,85,797,282,515
050,26,061,"Michigan","Houghton County",2,0,361,186,175
050,26,061,"Michigan","Houghton County",2,1,365,187,178
050,26,061,"Michigan","Houghton County",2,2,358,192,166
050,26,061,"Michigan","Houghton County",2,3,370,207,163
050,26,061,"Michigan","Houghton County",2,4,390,203,187
050,26,061,"Michigan","Houghton County",2,5,390,195,195
050,26,061,"Michigan","Houghton County",2,6,381,195,186
050,26,061,"Michigan","Houghton County",2,7,396,213,183
050,26,061,"Michigan","Houghton County",2,8,397,207,190
050,26,061,"Michigan","Houghton County",2,9,397,214,183
050,26,061,"Michigan","Houghton County",2,10,429,231,198
050,26,061,"Michigan","Houghton County",2,11,448,226,222
050,26,061,"Michigan","Houghton County",2,12,461,239,222
050,26,061,"Michigan","Houghton County",2,13,457,240,217
050,26,061,"Michigan","Houghton County",2,14,448,227,221
050,26,061,"Michigan","Houghton County",2,15,462,244,218
050,26,061,"Michigan","Houghton County",2,16,466,246,220
050,26,061,"Michigan","Houghton County",2,17,451,235,216
050,26,061,"Michigan","Houghton County",2,18,1058,669,389
050,26,061,"Michigan","Houghton County",2,19,1746,1203,543
050,26,061,"Michigan","Houghton County",2,20,1504,1017,487
050,26,061,"Michigan","Houghton County",2,21,1450,954,496
050,26,061,"Michigan","Houghton County",2,22,1265,888,377
050,26,061,"Michigan","Houghton County",2,23,885,605,280
050,26,061,"Michigan","Houghton County",2,24,592,347,245
050,26,061,"Michigan","Houghton County",2,25,449,259,190
050,26,061,"Michigan","Houghton County",2,26,387,219,168
050,26,061,"Michigan","Houghton County",2,27,341,184,157
050,26,061,"Michigan","Houghton County",2,28,345,180,165
050,26,061,"Michigan","Houghton County",2,29,374,199,175
050,26,061,"Michigan","Houghton County",2,30,392,222,170
050,26,061,"Michigan","Houghton County",2,31,337,185,152
050,26,061,"Michigan","Houghton County",2,32,313,164,149
050,26,061,"Michigan","Houghton County",2,33,349,196,153
050,26,061,"Michigan","Houghton County",2,34,349,192,157
050,26,061,"Michigan","Houghton County",2,35,331,171,160
050,26,061,"Michigan","Houghton County",2,36,350,182,168
050,26,061,"Michigan","Houghton County",2,37,380,200,180
050,26,061,"Michigan","Houghton County",2,38,374,191,183
050,26,061,"Michigan","Houghton County",2,39,344,177,167
050,26,061,"Michigan","Houghton County",2,40,344,176,168
050,26,061,"Michigan","Houghton County",2,41,333,170,163
050,26,061,"Michigan","Houghton County",2,42,336,163,173
050,26,061,"Michigan","Houghton County",2,43,345,172,173
050,26,061,"Michigan","Houghton County",2,44,337,167,170
050,26,061,"Michigan","Houghton County",2,45,337,177,160
050,26,061,"Michigan","Houghton County",2,46,322,172,150
050,26,061,"Michigan","Houghton County",2,47,316,158,158
050,26,061,"Michigan","Houghton County",2,48,322,161,161
050,26,061,"Michigan","Houghton County",2,49,359,191,168
050,26,061,"Michigan","Houghton County",2,50,364,190,174
050,26,061,"Michigan","Houghton County",2,51,347,189,158
050,26,061,"Michigan","Houghton County",2,52,329,183,146
050,26,061,"Michigan","Houghton County",2,53,352,186,166
050,26,061,"Michigan","Houghton County",2,54,356,177,179
050,26,061,"Michigan","Houghton County",2,55,387,185,202
050,26,061,"Michigan","Houghton County",2,56,413,204,209
050,26,061,"Michigan","Houghton County",2,57,431,223,208
050,26,061,"Michigan","Houghton County",2,58,439,232,207
050,26,061,"Michigan","Houghton County",2,59,429,213,216
050,26,061,"Michigan","Houghton County",2,60,407,203,204
050,26,061,"Michigan","Houghton County",2,61,412,208,204
050,26,061,"Michigan","Houghton County",2,62,439,229,210
050,26,061,"Michigan","Houghton County",2,63,447,228,219
050,26,061,"Michigan","Houghton County",2,64,416,215,201
050,26,061,"Michigan","Houghton County",2,65,430,224,206
050,26,061,"Michigan","Houghton County",2,66,426,217,209
050,26,061,"Michigan","Houghton County",2,67,442,226,216
050,26,061,"Michigan","Houghton County",2,68,440,226,214
050,26,061,"Michigan","Houghton County",2,69,398,196,202
050,26,061,"Michigan","Houghton County",2,70,368,193,175
050,26,061,"Michigan","Houghton County",2,71,360,183,177
050,26,061,"Michigan","Houghton County",2,72,356,186,170
050,26,061,"Michigan","Houghton County",2,73,364,185,179
050,26,061,"Michigan","Houghton County",2,74,261,130,131
050,26,061,"Michigan","Houghton County",2,75,263,130,133
050,26,061,"Michigan","Houghton County",2,76,242,120,122
050,26,061,"Michigan","Houghton County",2,77,250,118,132
050,26,061,"Michigan","Houghton County",2,78,207,91,116
050,26,061,"Michigan","Houghton County",2,79,184,83,101
050,26,061,"Michigan","Houghton County",2,80,175,84,91
050,26,061,"Michigan","Houghton County",2,81,182,84,98
050,26,061,"Michigan","Houghton County",2,82,161,75,86
050,26,061,"Michigan","Houghton County",2,83,137,61,76
050,26,061,"Michigan","Houghton County",2,84,125,52,73
050,26,061,"Michigan","Houghton County",2,85,805,288,517
050,26,061,"Michigan","Houghton County",3,0,379,188,191
050,26,061,"Michigan","Houghton County",3,1,371,192,179
050,26,061,"Michigan","Houghton County",3,2,370,189,181
050,26,061,"Michigan","Houghton County",3,3,377,203,174
050,26,061,"Michigan","Houghton County",3,4,381,208,173
050,26,061,"Michigan","Houghton County",3,5,402,202,200
050,26,061,"Michigan","Houghton County",3,6,397,195,202
050,26,061,"Michigan","Houghton County",3,7,385,202,183
050,26,061,"Michigan","Houghton County",3,8,406,221,185
050,26,061,"Michigan","Houghton County",3,9,402,207,195
050,26,061,"Michigan","Houghton County",3,10,405,215,190
050,26,061,"Michigan","Houghton County",3,11,441,237,204
050,26,061,"Michigan","Houghton County",3,12,466,232,234
050,26,061,"Michigan","Houghton County",3,13,461,243,218
050,26,061,"Michigan","Houghton County",3,14,461,242,219
050,26,061,"Michigan","Houghton County",3,15,447,226,221
050,26,061,"Michigan","Houghton County",3,16,460,239,221
050,26,061,"Michigan","Houghton County",3,17,486,260,226
050,26,061,"Michigan","Houghton County",3,18,1072,684,388
050,26,061,"Michigan","Houghton County",3,19,1740,1197,543
050,26,061,"Michigan","Houghton County",3,20,1488,999,489
050,26,061,"Michigan","Houghton County",3,21,1401,913,488
050,26,061,"Michigan","Houghton County",3,22,1292,900,392
050,26,061,"Michigan","Houghton County",3,23,928,651,277
050,26,061,"Michigan","Houghton County",3,24,587,331,256
050,26,061,"Michigan","Houghton County",3,25,474,277,197
050,26,061,"Michigan","Houghton County",3,26,403,236,167
050,26,061,"Michigan","Houghton County",3,27,379,215,164
050,26,061,"Michigan","Houghton County",3,28,366,195,171
050,26,061,"Michigan","Houghton County",3,29,346,181,165
050,26,061,"Michigan","Houghton County",3,30,396,217,179
050,26,061,"Michigan","Houghton County",3,31,382,210,172
050,26,061,"Michigan","Houghton County",3,32,344,183,161
050,26,061,"Michigan","Houghton County",3,33,319,165,154
050,26,061,"Michigan","Houghton County",3,34,342,190,152
050,26,061,"Michigan","Houghton County",3,35,352,192,160
050,26,061,"Michigan","Houghton County",3,36,338,168,170
050,26,061,"Michigan","Houghton County",3,37,358,179,179
050,26,061,"Michigan","Houghton County",3,38,376,194,182
050,26,061,"Michigan","Houghton County",3,39,390,205,185
050,26,061,"Michigan","Houghton County",3,40,353,183,170
050,26,061,"Michigan","Houghton County",3,41,362,184,178
050,26,061,"Michigan","Houghton County",3,42,339,175,164
050,26,061,"Michigan","Houghton County",3,43,334,159,175
050,26,061,"Michigan","Houghton County",3,44,347,175,172
050,26,061,"Michigan","Houghton County",3,45,335,170,165
050,26,061,"Michigan","Houghton County",3,46,343,184,159
050,26,061,"Michigan","Houghton County",3,47,324,172,152
050,26,061,"Michigan","Houghton County",3,48,311,154,157
050,26,061,"Michigan","Houghton County",3,49,340,171,169
050,26,061,"Michigan","Houghton County",3,50,357,182,175
050,26,061,"Michigan","Houghton County",3,51,360,189,171
050,26,061,"Michigan","Houghton County",3,52,354,194,160
050,26,061,"Michigan","Houghton County",3,53,336,182,154
050,26,061,"Michigan","Houghton County",3,54,352,194,158
050,26,061,"Michigan","Houghton County",3,55,354,176,178
050,26,061,"Michigan","Houghton County",3,56,380,185,195
050,26,061,"Michigan","Houghton County",3,57,420,204,216
050,26,061,"Michigan","Houghton County",3,58,435,228,207
050,26,061,"Michigan","Houghton County",3,59,432,229,203
050,26,061,"Michigan","Houghton County",3,60,432,213,219
050,26,061,"Michigan","Houghton County",3,61,405,203,202
050,26,061,"Michigan","Houghton County",3,62,409,208,201
050,26,061,"Michigan","Houghton County",3,63,425,219,206
050,26,061,"Michigan","Houghton County",3,64,440,221,219
050,26,061,"Michigan","Houghton County",3,65,406,205,201
050,26,061,"Michigan","Houghton County",3,66,435,225,210
050,26,061,"Michigan","Houghton County",3,67,420,213,207
050,26,061,"Michigan","Houghton County",3,68,434,225,209
050,26,061,"Michigan","Houghton County",3,69,418,217,201
050,26,061,"Michigan","Houghton County",3,70,390,192,198
050,26,061,"Michigan","Houghton County",3,71,357,186,171
050,26,061,"Michigan","Houghton County",3,72,358,186,172
050,26,061,"Michigan","Houghton County",3,73,342,171,171
050,26,061,"Michigan","Houghton County",3,74,359,186,173
050,26,061,"Michigan","Houghton County",3,75,249,124,125
050,26,061,"Michigan","Houghton County",3,76,252,130,122
050,26,061,"Michigan","Houghton County",3,77,229,110,119
050,26,061,"Michigan","Houghton County",3,78,235,110,125
050,26,061,"Michigan","Houghton County",3,79,204,89,115
050,26,061,"Michigan","Houghton County",3,80,165,75,90
050,26,061,"Michigan","Houghton County",3,81,168,82,86
050,26,061,"Michigan","Houghton County",3,82,176,77,99
050,26,061,"Michigan","Houghton County",3,83,139,66,73
050,26,061,"Michigan","Houghton County",3,84,124,50,74
050,26,061,"Michigan","Houghton County",3,85,798,280,518
050,26,061,"Michigan","Houghton County",4,0,370,183,187
050,26,061,"Michigan","Houghton County",4,1,376,190,186
050,26,061,"Michigan","Houghton County",4,2,367,182,185
050,26,061,"Michigan","Houghton County",4,3,375,190,185
050,26,061,"Michigan","Houghton County",4,4,389,211,178
050,26,061,"Michigan","Houghton County",4,5,394,217,177
050,26,061,"Michigan","Houghton County",4,6,403,205,198
050,26,061,"Michigan","Houghton County",4,7,392,190,202
050,26,061,"Michigan","Houghton County",4,8,399,207,192
050,26,061,"Michigan","Houghton County",4,9,403,215,188
050,26,061,"Michigan","Houghton County",4,10,412,211,201
050,26,061,"Michigan","Houghton County",4,11,413,221,192
050,26,061,"Michigan","Houghton County",4,12,447,244,203
050,26,061,"Michigan","Houghton County",4,13,461,230,231
050,26,061,"Michigan","Houghton County",4,14,471,250,221
050,26,061,"Michigan","Houghton County",4,15,461,243,218
050,26,061,"Michigan","Houghton County",4,16,451,227,224
050,26,061,"Michigan","Houghton County",4,17,477,251,226
050,26,061,"Michigan","Houghton County",4,18,997,632,365
050,26,061,"Michigan","Houghton County",4,19,1571,1078,493
050,26,061,"Michigan","Houghton County",4,20,1372,918,454
050,26,061,"Michigan","Houghton County",4,21,1354,860,494
050,26,061,"Michigan","Houghton County",4,22,1232,859,373
050,26,061,"Michigan","Houghton County",4,23,897,608,289
050,26,061,"Michigan","Houghton County",4,24,627,371,256
050,26,061,"Michigan","Houghton County",4,25,462,251,211
050,26,061,"Michigan","Houghton County",4,26,429,246,183
050,26,061,"Michigan","Houghton County",4,27,366,206,160
050,26,061,"Michigan","Houghton County",4,28,383,221,162
050,26,061,"Michigan","Houghton County",4,29,360,184,176
050,26,061,"Michigan","Houghton County",4,30,385,218,167
050,26,061,"Michigan","Houghton County",4,31,402,210,192
050,26,061,"Michigan","Houghton County",4,32,356,199,157
050,26,061,"Michigan","Houghton County",4,33,349,184,165
050,26,061,"Michigan","Houghton County",4,34,339,179,160
050,26,061,"Michigan","Houghton County",4,35,336,188,148
050,26,061,"Michigan","Houghton County",4,36,363,199,164
050,26,061,"Michigan","Houghton County",4,37,343,172,171
050,26,061,"Michigan","Houghton County",4,38,341,166,175
050,26,061,"Michigan","Houghton County",4,39,387,207,180
050,26,061,"Michigan","Houghton County",4,40,390,210,180
050,26,061,"Michigan","Houghton County",4,41,367,188,179
050,26,061,"Michigan","Houghton County",4,42,351,178,173
050,26,061,"Michigan","Houghton County",4,43,337,173,164
050,26,061,"Michigan","Houghton County",4,44,345,163,182
050,26,061,"Michigan","Houghton County",4,45,350,179,171
050,26,061,"Michigan","Houghton County",4,46,347,174,173
050,26,061,"Michigan","Houghton County",4,47,345,186,159
050,26,061,"Michigan","Houghton County",4,48,330,173,157
050,26,061,"Michigan","Houghton County",4,49,320,165,155
050,26,061,"Michigan","Houghton County",4,50,350,174,176
050,26,061,"Michigan","Houghton County",4,51,365,187,178
050,26,061,"Michigan","Houghton County",4,52,350,185,165
050,26,061,"Michigan","Houghton County",4,53,362,196,166
050,26,061,"Michigan","Houghton County",4,54,338,181,157
050,26,061,"Michigan","Houghton County",4,55,345,185,160
050,26,061,"Michigan","Houghton County",4,56,355,178,177
050,26,061,"Michigan","Houghton County",4,57,386,188,198
050,26,061,"Michigan","Houghton County",4,58,425,210,215
050,26,061,"Michigan","Houghton County",4,59,424,220,204
050,26,061,"Michigan","Houghton County",4,60,437,228,209
050,26,061,"Michigan","Houghton County",4,61,438,213,225
050,26,061,"Michigan","Houghton County",4,62,395,206,189
050,26,061,"Michigan","Houghton County",4,63,405,204,201
050,26,061,"Michigan","Houghton County",4,64,423,212,211
050,26,061,"Michigan","Houghton County",4,65,442,219,223
050,26,061,"Michigan","Houghton County",4,66,398,202,196
050,26,061,"Michigan","Houghton County",4,67,425,219,206
050,26,061,"Michigan","Houghton County",4,68,415,210,205
050,26,061,"Michigan","Houghton County",4,69,421,219,202
050,26,061,"Michigan","Houghton County",4,70,409,214,195
050,26,061,"Michigan","Houghton County",4,71,381,184,197
050,26,061,"Michigan","Houghton County",4,72,355,189,166
050,26,061,"Michigan","Houghton County",4,73,338,166,172
050,26,061,"Michigan","Houghton County",4,74,331,167,164
050,26,061,"Michigan","Houghton County",4,75,336,171,165
050,26,061,"Michigan","Houghton County",4,76,239,122,117
050,26,061,"Michigan","Houghton County",4,77,236,121,115
050,26,061,"Michigan","Houghton County",4,78,214,102,112
050,26,061,"Michigan","Houghton County",4,79,233,105,128
050,26,061,"Michigan","Houghton County",4,80,192,82,110
050,26,061,"Michigan","Houghton County",4,81,157,66,91
050,26,061,"Michigan","Houghton County",4,82,168,80,88
050,26,061,"Michigan","Houghton County",4,83,155,67,88
050,26,061,"Michigan","Houghton County",4,84,124,55,69
050,26,061,"Michigan","Houghton County",4,85,799,270,529
050,26,061,"Michigan","Houghton County",5,0,348,172,176
050,26,061,"Michigan","Houghton County",5,1,360,175,185
050,26,061,"Michigan","Houghton County",5,2,369,187,182
050,26,061,"Michigan","Houghton County",5,3,367,179,188
050,26,061,"Michigan","Houghton County",5,4,392,199,193
050,26,061,"Michigan","Houghton County",5,5,383,207,176
050,26,061,"Michigan","Houghton County",5,6,392,213,179
050,26,061,"Michigan","Houghton County",5,7,409,213,196
050,26,061,"Michigan","Houghton County",5,8,388,185,203
050,26,061,"Michigan","Houghton County",5,9,402,207,195
050,26,061,"Michigan","Houghton County",5,10,407,217,190
050,26,061,"Michigan","Houghton County",5,11,415,215,200
050,26,061,"Michigan","Houghton County",5,12,413,216,197
050,26,061,"Michigan","Houghton County",5,13,440,239,201
050,26,061,"Michigan","Houghton County",5,14,466,232,234
050,26,061,"Michigan","Houghton County",5,15,474,250,224
050,26,061,"Michigan","Houghton County",5,16,460,239,221
050,26,061,"Michigan","Houghton County",5,17,473,241,232
050,26,061,"Michigan","Houghton County",5,18,1095,701,394
050,26,061,"Michigan","Houghton County",5,19,1779,1227,552
050,26,061,"Michigan","Houghton County",5,20,1486,1014,472
050,26,061,"Michigan","Houghton County",5,21,1389,914,475
050,26,061,"Michigan","Houghton County",5,22,1252,854,398
050,26,061,"Michigan","Houghton County",5,23,901,634,267
050,26,061,"Michigan","Houghton County",5,24,624,351,273
050,26,061,"Michigan","Houghton County",5,25,508,300,208
050,26,061,"Michigan","Houghton County",5,26,416,222,194
050,26,061,"Michigan","Houghton County",5,27,388,216,172
050,26,061,"Michigan","Houghton County",5,28,378,220,158
050,26,061,"Michigan","Houghton County",5,29,366,202,164
050,26,061,"Michigan","Houghton County",5,30,387,204,183
050,26,061,"Michigan","Houghton County",5,31,389,214,175
050,26,061,"Michigan","Houghton County",5,32,379,190,189
050,26,061,"Michigan","Houghton County",5,33,348,197,151
050,26,061,"Michigan","Houghton County",5,34,358,193,165
050,26,061,"Michigan","Houghton County",5,35,336,175,161
050,26,061,"Michigan","Houghton County",5,36,336,186,150
050,26,061,"Michigan","Houghton County",5,37,365,198,167
050,26,061,"Michigan","Houghton County",5,38,341,169,172
050,26,061,"Michigan","Houghton County",5,39,341,171,170
050,26,061,"Michigan","Houghton County",5,40,392,210,182
050,26,061,"Michigan","Houghton County",5,41,411,225,186
050,26,061,"Michigan","Houghton County",5,42,370,187,183
050,26,061,"Michigan","Houghton County",5,43,345,178,167
050,26,061,"Michigan","Houghton County",5,44,339,173,166
050,26,061,"Michigan","Houghton County",5,45,330,157,173
050,26,061,"Michigan","Houghton County",5,46,347,173,174
050,26,061,"Michigan","Houghton County",5,47,340,168,172
050,26,061,"Michigan","Houghton County",5,48,341,185,156
050,26,061,"Michigan","Houghton County",5,49,326,172,154
050,26,061,"Michigan","Houghton County",5,50,320,158,162
050,26,061,"Michigan","Houghton County",5,51,342,174,168
050,26,061,"Michigan","Houghton County",5,52,362,188,174
050,26,061,"Michigan","Houghton County",5,53,359,189,170
050,26,061,"Michigan","Houghton County",5,54,355,197,158
050,26,061,"Michigan","Houghton County",5,55,338,173,165
050,26,061,"Michigan","Houghton County",5,56,337,184,153
050,26,061,"Michigan","Houghton County",5,57,351,173,178
050,26,061,"Michigan","Houghton County",5,58,392,197,195
050,26,061,"Michigan","Houghton County",5,59,407,197,210
050,26,061,"Michigan","Houghton County",5,60,424,215,209
050,26,061,"Michigan","Houghton County",5,61,438,228,210
050,26,061,"Michigan","Houghton County",5,62,428,211,217
050,26,061,"Michigan","Houghton County",5,63,377,190,187
050,26,061,"Michigan","Houghton County",5,64,397,197,200
050,26,061,"Michigan","Houghton County",5,65,418,209,209
050,26,061,"Michigan","Houghton County",5,66,441,221,220
050,26,061,"Michigan","Houghton County",5,67,394,198,196
050,26,061,"Michigan","Houghton County",5,68,424,216,208
050,26,061,"Michigan","Houghton County",5,69,393,203,190
050,26,061,"Michigan","Houghton County",5,70,411,216,195
050,26,061,"Michigan","Houghton County",5,71,400,208,192
050,26,061,"Michigan","Houghton County",5,72,380,188,192
050,26,061,"Michigan","Houghton County",5,73,341,174,167
050,26,061,"Michigan","Houghton County",5,74,335,168,167
050,26,061,"Michigan","Houghton County",5,75,322,163,159
050,26,061,"Michigan","Houghton County",5,76,321,167,154
050,26,061,"Michigan","Houghton County",5,77,228,114,114
050,26,061,"Michigan","Houghton County",5,78,226,118,108
050,26,061,"Michigan","Houghton County",5,79,215,100,115
050,26,061,"Michigan","Houghton County",5,80,215,97,118
050,26,061,"Michigan","Houghton County",5,81,178,71,107
050,26,061,"Michigan","Houghton County",5,82,160,66,94
050,26,061,"Michigan","Houghton County",5,83,149,71,78
050,26,061,"Michigan","Houghton County",5,84,145,58,87
050,26,061,"Michigan","Houghton County",5,85,815,281,534
050,26,063,"Michigan","Huron County",1,0,256,130,126
050,26,063,"Michigan","Huron County",1,1,280,147,133
050,26,063,"Michigan","Huron County",1,2,306,155,151
050,26,063,"Michigan","Huron County",1,3,343,176,167
050,26,063,"Michigan","Huron County",1,4,323,160,163
050,26,063,"Michigan","Huron County",1,5,314,157,157
050,26,063,"Michigan","Huron County",1,6,327,159,168
050,26,063,"Michigan","Huron County",1,7,316,168,148
050,26,063,"Michigan","Huron County",1,8,316,159,157
050,26,063,"Michigan","Huron County",1,9,348,176,172
050,26,063,"Michigan","Huron County",1,10,382,188,194
050,26,063,"Michigan","Huron County",1,11,358,185,173
050,26,063,"Michigan","Huron County",1,12,365,190,175
050,26,063,"Michigan","Huron County",1,13,347,184,163
050,26,063,"Michigan","Huron County",1,14,369,186,183
050,26,063,"Michigan","Huron County",1,15,365,183,182
050,26,063,"Michigan","Huron County",1,16,374,192,182
050,26,063,"Michigan","Huron County",1,17,389,201,188
050,26,063,"Michigan","Huron County",1,18,315,167,148
050,26,063,"Michigan","Huron County",1,19,268,144,124
050,26,063,"Michigan","Huron County",1,20,289,154,135
050,26,063,"Michigan","Huron County",1,21,305,156,149
050,26,063,"Michigan","Huron County",1,22,313,163,150
050,26,063,"Michigan","Huron County",1,23,311,159,152
050,26,063,"Michigan","Huron County",1,24,303,158,145
050,26,063,"Michigan","Huron County",1,25,313,178,135
050,26,063,"Michigan","Huron County",1,26,307,170,137
050,26,063,"Michigan","Huron County",1,27,293,163,130
050,26,063,"Michigan","Huron County",1,28,294,146,148
050,26,063,"Michigan","Huron County",1,29,298,133,165
050,26,063,"Michigan","Huron County",1,30,293,150,143
050,26,063,"Michigan","Huron County",1,31,309,164,145
050,26,063,"Michigan","Huron County",1,32,294,148,146
050,26,063,"Michigan","Huron County",1,33,277,145,132
050,26,063,"Michigan","Huron County",1,34,301,169,132
050,26,063,"Michigan","Huron County",1,35,305,161,144
050,26,063,"Michigan","Huron County",1,36,327,173,154
050,26,063,"Michigan","Huron County",1,37,328,179,149
050,26,063,"Michigan","Huron County",1,38,333,167,166
050,26,063,"Michigan","Huron County",1,39,347,181,166
050,26,063,"Michigan","Huron County",1,40,319,166,153
050,26,063,"Michigan","Huron County",1,41,326,165,161
050,26,063,"Michigan","Huron County",1,42,298,158,140
050,26,063,"Michigan","Huron County",1,43,297,154,143
050,26,063,"Michigan","Huron County",1,44,278,136,142
050,26,063,"Michigan","Huron County",1,45,278,144,134
050,26,063,"Michigan","Huron County",1,46,301,159,142
050,26,063,"Michigan","Huron County",1,47,324,166,158
050,26,063,"Michigan","Huron County",1,48,361,178,183
050,26,063,"Michigan","Huron County",1,49,395,187,208
050,26,063,"Michigan","Huron County",1,50,406,210,196
050,26,063,"Michigan","Huron County",1,51,406,209,197
050,26,063,"Michigan","Huron County",1,52,404,191,213
050,26,063,"Michigan","Huron County",1,53,412,204,208
050,26,063,"Michigan","Huron County",1,54,431,230,201
050,26,063,"Michigan","Huron County",1,55,451,232,219
050,26,063,"Michigan","Huron County",1,56,497,247,250
050,26,063,"Michigan","Huron County",1,57,484,231,253
050,26,063,"Michigan","Huron County",1,58,506,250,256
050,26,063,"Michigan","Huron County",1,59,536,264,272
050,26,063,"Michigan","Huron County",1,60,543,284,259
050,26,063,"Michigan","Huron County",1,61,569,284,285
050,26,063,"Michigan","Huron County",1,62,576,281,295
050,26,063,"Michigan","Huron County",1,63,546,280,266
050,26,063,"Michigan","Huron County",1,64,547,269,278
050,26,063,"Michigan","Huron County",1,65,565,269,296
050,26,063,"Michigan","Huron County",1,66,593,296,297
050,26,063,"Michigan","Huron County",1,67,548,292,256
050,26,063,"Michigan","Huron County",1,68,534,269,265
050,26,063,"Michigan","Huron County",1,69,473,238,235
050,26,063,"Michigan","Huron County",1,70,432,206,226
050,26,063,"Michigan","Huron County",1,71,458,222,236
050,26,063,"Michigan","Huron County",1,72,453,236,217
050,26,063,"Michigan","Huron County",1,73,425,216,209
050,26,063,"Michigan","Huron County",1,74,294,149,145
050,26,063,"Michigan","Huron County",1,75,311,145,166
050,26,063,"Michigan","Huron County",1,76,310,135,175
050,26,063,"Michigan","Huron County",1,77,299,142,157
050,26,063,"Michigan","Huron County",1,78,275,129,146
050,26,063,"Michigan","Huron County",1,79,268,143,125
050,26,063,"Michigan","Huron County",1,80,226,110,116
050,26,063,"Michigan","Huron County",1,81,212,88,124
050,26,063,"Michigan","Huron County",1,82,176,72,104
050,26,063,"Michigan","Huron County",1,83,157,69,88
050,26,063,"Michigan","Huron County",1,84,169,68,101
050,26,063,"Michigan","Huron County",1,85,928,339,589
050,26,063,"Michigan","Huron County",2,0,263,136,127
050,26,063,"Michigan","Huron County",2,1,272,142,130
050,26,063,"Michigan","Huron County",2,2,299,153,146
050,26,063,"Michigan","Huron County",2,3,332,170,162
050,26,063,"Michigan","Huron County",2,4,331,165,166
050,26,063,"Michigan","Huron County",2,5,316,157,159
050,26,063,"Michigan","Huron County",2,6,328,162,166
050,26,063,"Michigan","Huron County",2,7,317,163,154
050,26,063,"Michigan","Huron County",2,8,314,159,155
050,26,063,"Michigan","Huron County",2,9,341,173,168
050,26,063,"Michigan","Huron County",2,10,375,186,189
050,26,063,"Michigan","Huron County",2,11,365,186,179
050,26,063,"Michigan","Huron County",2,12,365,189,176
050,26,063,"Michigan","Huron County",2,13,350,185,165
050,26,063,"Michigan","Huron County",2,14,364,185,179
050,26,063,"Michigan","Huron County",2,15,367,185,182
050,26,063,"Michigan","Huron County",2,16,373,191,182
050,26,063,"Michigan","Huron County",2,17,386,201,185
050,26,063,"Michigan","Huron County",2,18,317,169,148
050,26,063,"Michigan","Huron County",2,19,265,142,123
050,26,063,"Michigan","Huron County",2,20,290,153,137
050,26,063,"Michigan","Huron County",2,21,304,156,148
050,26,063,"Michigan","Huron County",2,22,316,163,153
050,26,063,"Michigan","Huron County",2,23,312,160,152
050,26,063,"Michigan","Huron County",2,24,303,158,145
050,26,063,"Michigan","Huron County",2,25,308,172,136
050,26,063,"Michigan","Huron County",2,26,306,172,134
050,26,063,"Michigan","Huron County",2,27,293,164,129
050,26,063,"Michigan","Huron County",2,28,295,149,146
050,26,063,"Michigan","Huron County",2,29,297,137,160
050,26,063,"Michigan","Huron County",2,30,295,147,148
050,26,063,"Michigan","Huron County",2,31,303,161,142
050,26,063,"Michigan","Huron County",2,32,296,150,146
050,26,063,"Michigan","Huron County",2,33,279,144,135
050,26,063,"Michigan","Huron County",2,34,294,163,131
050,26,063,"Michigan","Huron County",2,35,305,164,141
050,26,063,"Michigan","Huron County",2,36,317,169,148
050,26,063,"Michigan","Huron County",2,37,329,178,151
050,26,063,"Michigan","Huron County",2,38,334,170,164
050,26,063,"Michigan","Huron County",2,39,342,176,166
050,26,063,"Michigan","Huron County",2,40,328,171,157
050,26,063,"Michigan","Huron County",2,41,322,164,158
050,26,063,"Michigan","Huron County",2,42,304,159,145
050,26,063,"Michigan","Huron County",2,43,303,158,145
050,26,063,"Michigan","Huron County",2,44,281,139,142
050,26,063,"Michigan","Huron County",2,45,281,143,138
050,26,063,"Michigan","Huron County",2,46,293,154,139
050,26,063,"Michigan","Huron County",2,47,317,165,152
050,26,063,"Michigan","Huron County",2,48,351,174,177
050,26,063,"Michigan","Huron County",2,49,391,189,202
050,26,063,"Michigan","Huron County",2,50,405,205,200
050,26,063,"Michigan","Huron County",2,51,405,208,197
050,26,063,"Michigan","Huron County",2,52,404,195,209
050,26,063,"Michigan","Huron County",2,53,411,201,210
050,26,063,"Michigan","Huron County",2,54,425,222,203
050,26,063,"Michigan","Huron County",2,55,446,232,214
050,26,063,"Michigan","Huron County",2,56,487,244,243
050,26,063,"Michigan","Huron County",2,57,488,236,252
050,26,063,"Michigan","Huron County",2,58,495,240,255
050,26,063,"Michigan","Huron County",2,59,535,263,272
050,26,063,"Michigan","Huron County",2,60,541,279,262
050,26,063,"Michigan","Huron County",2,61,561,282,279
050,26,063,"Michigan","Huron County",2,62,576,282,294
050,26,063,"Michigan","Huron County",2,63,557,281,276
050,26,063,"Michigan","Huron County",2,64,544,270,274
050,26,063,"Michigan","Huron County",2,65,564,270,294
050,26,063,"Michigan","Huron County",2,66,589,291,298
050,26,063,"Michigan","Huron County",2,67,559,293,266
050,26,063,"Michigan","Huron County",2,68,535,275,260
050,26,063,"Michigan","Huron County",2,69,490,246,244
050,26,063,"Michigan","Huron County",2,70,441,213,228
050,26,063,"Michigan","Huron County",2,71,452,218,234
050,26,063,"Michigan","Huron County",2,72,444,228,216
050,26,063,"Michigan","Huron County",2,73,456,234,222
050,26,063,"Michigan","Huron County",2,74,301,153,148
050,26,063,"Michigan","Huron County",2,75,306,146,160
050,26,063,"Michigan","Huron County",2,76,305,133,172
050,26,063,"Michigan","Huron County",2,77,306,145,161
050,26,063,"Michigan","Huron County",2,78,273,130,143
050,26,063,"Michigan","Huron County",2,79,262,134,128
050,26,063,"Michigan","Huron County",2,80,233,116,117
050,26,063,"Michigan","Huron County",2,81,210,91,119
050,26,063,"Michigan","Huron County",2,82,180,71,109
050,26,063,"Michigan","Huron County",2,83,160,70,90
050,26,063,"Michigan","Huron County",2,84,164,66,98
050,26,063,"Michigan","Huron County",2,85,925,337,588
050,26,063,"Michigan","Huron County",3,0,292,150,142
050,26,063,"Michigan","Huron County",3,1,273,139,134
050,26,063,"Michigan","Huron County",3,2,284,143,141
050,26,063,"Michigan","Huron County",3,3,312,156,156
050,26,063,"Michigan","Huron County",3,4,344,178,166
050,26,063,"Michigan","Huron County",3,5,337,174,163
050,26,063,"Michigan","Huron County",3,6,319,159,160
050,26,063,"Michigan","Huron County",3,7,330,168,162
050,26,063,"Michigan","Huron County",3,8,313,163,150
050,26,063,"Michigan","Huron County",3,9,311,162,149
050,26,063,"Michigan","Huron County",3,10,339,170,169
050,26,063,"Michigan","Huron County",3,11,369,179,190
050,26,063,"Michigan","Huron County",3,12,360,184,176
050,26,063,"Michigan","Huron County",3,13,363,182,181
050,26,063,"Michigan","Huron County",3,14,351,179,172
050,26,063,"Michigan","Huron County",3,15,365,186,179
050,26,063,"Michigan","Huron County",3,16,366,181,185
050,26,063,"Michigan","Huron County",3,17,380,198,182
050,26,063,"Michigan","Huron County",3,18,330,183,147
050,26,063,"Michigan","Huron County",3,19,249,132,117
050,26,063,"Michigan","Huron County",3,20,279,145,134
050,26,063,"Michigan","Huron County",3,21,310,157,153
050,26,063,"Michigan","Huron County",3,22,327,167,160
050,26,063,"Michigan","Huron County",3,23,309,166,143
050,26,063,"Michigan","Huron County",3,24,299,162,137
050,26,063,"Michigan","Huron County",3,25,313,164,149
050,26,063,"Michigan","Huron County",3,26,302,174,128
050,26,063,"Michigan","Huron County",3,27,318,175,143
050,26,063,"Michigan","Huron County",3,28,296,155,141
050,26,063,"Michigan","Huron County",3,29,294,148,146
050,26,063,"Michigan","Huron County",3,30,323,148,175
050,26,063,"Michigan","Huron County",3,31,302,148,154
050,26,063,"Michigan","Huron County",3,32,305,164,141
050,26,063,"Michigan","Huron County",3,33,290,151,139
050,26,063,"Michigan","Huron County",3,34,275,141,134
050,26,063,"Michigan","Huron County",3,35,296,160,136
050,26,063,"Michigan","Huron County",3,36,299,159,140
050,26,063,"Michigan","Huron County",3,37,314,163,151
050,26,063,"Michigan","Huron County",3,38,327,178,149
050,26,063,"Michigan","Huron County",3,39,343,178,165
050,26,063,"Michigan","Huron County",3,40,348,178,170
050,26,063,"Michigan","Huron County",3,41,331,174,157
050,26,063,"Michigan","Huron County",3,42,320,159,161
050,26,063,"Michigan","Huron County",3,43,313,168,145
050,26,063,"Michigan","Huron County",3,44,303,156,147
050,26,063,"Michigan","Huron County",3,45,290,143,147
050,26,063,"Michigan","Huron County",3,46,286,151,135
050,26,063,"Michigan","Huron County",3,47,292,152,140
050,26,063,"Michigan","Huron County",3,48,320,168,152
050,26,063,"Michigan","Huron County",3,49,351,170,181
050,26,063,"Michigan","Huron County",3,50,396,193,203
050,26,063,"Michigan","Huron County",3,51,403,201,202
050,26,063,"Michigan","Huron County",3,52,413,215,198
050,26,063,"Michigan","Huron County",3,53,413,202,211
050,26,063,"Michigan","Huron County",3,54,409,200,209
050,26,063,"Michigan","Huron County",3,55,441,228,213
050,26,063,"Michigan","Huron County",3,56,443,230,213
050,26,063,"Michigan","Huron County",3,57,502,253,249
050,26,063,"Michigan","Huron County",3,58,492,237,255
050,26,063,"Michigan","Huron County",3,59,506,240,266
050,26,063,"Michigan","Huron County",3,60,526,262,264
050,26,063,"Michigan","Huron County",3,61,550,282,268
050,26,063,"Michigan","Huron County",3,62,566,286,280
050,26,063,"Michigan","Huron County",3,63,592,292,300
050,26,063,"Michigan","Huron County",3,64,556,276,280
050,26,063,"Michigan","Huron County",3,65,553,275,278
050,26,063,"Michigan","Huron County",3,66,560,269,291
050,26,063,"Michigan","Huron County",3,67,573,279,294
050,26,063,"Michigan","Huron County",3,68,549,284,265
050,26,063,"Michigan","Huron County",3,69,521,267,254
050,26,063,"Michigan","Huron County",3,70,476,244,232
050,26,063,"Michigan","Huron County",3,71,431,207,224
050,26,063,"Michigan","Huron County",3,72,444,215,229
050,26,063,"Michigan","Huron County",3,73,429,217,212
050,26,063,"Michigan","Huron County",3,74,435,219,216
050,26,063,"Michigan","Huron County",3,75,286,148,138
050,26,063,"Michigan","Huron County",3,76,296,141,155
050,26,063,"Michigan","Huron County",3,77,278,124,154
050,26,063,"Michigan","Huron County",3,78,290,139,151
050,26,063,"Michigan","Huron County",3,79,250,117,133
050,26,063,"Michigan","Huron County",3,80,245,125,120
050,26,063,"Michigan","Huron County",3,81,207,103,104
050,26,063,"Michigan","Huron County",3,82,190,82,108
050,26,063,"Michigan","Huron County",3,83,166,65,101
050,26,063,"Michigan","Huron County",3,84,157,65,92
050,26,063,"Michigan","Huron County",3,85,901,330,571
050,26,063,"Michigan","Huron County",4,0,278,116,162
050,26,063,"Michigan","Huron County",4,1,282,138,144
050,26,063,"Michigan","Huron County",4,2,268,136,132
050,26,063,"Michigan","Huron County",4,3,280,139,141
050,26,063,"Michigan","Huron County",4,4,307,151,156
050,26,063,"Michigan","Huron County",4,5,343,178,165
050,26,063,"Michigan","Huron County",4,6,328,168,160
050,26,063,"Michigan","Huron County",4,7,318,161,157
050,26,063,"Michigan","Huron County",4,8,342,176,166
050,26,063,"Michigan","Huron County",4,9,321,165,156
050,26,063,"Michigan","Huron County",4,10,318,163,155
050,26,063,"Michigan","Huron County",4,11,346,175,171
050,26,063,"Michigan","Huron County",4,12,369,178,191
050,26,063,"Michigan","Huron County",4,13,366,185,181
050,26,063,"Michigan","Huron County",4,14,372,196,176
050,26,063,"Michigan","Huron County",4,15,365,189,176
050,26,063,"Michigan","Huron County",4,16,367,188,179
050,26,063,"Michigan","Huron County",4,17,370,181,189
050,26,063,"Michigan","Huron County",4,18,318,172,146
050,26,063,"Michigan","Huron County",4,19,257,140,117
050,26,063,"Michigan","Huron County",4,20,258,131,127
050,26,063,"Michigan","Huron County",4,21,286,153,133
050,26,063,"Michigan","Huron County",4,22,328,170,158
050,26,063,"Michigan","Huron County",4,23,338,172,166
050,26,063,"Michigan","Huron County",4,24,299,165,134
050,26,063,"Michigan","Huron County",4,25,293,171,122
050,26,063,"Michigan","Huron County",4,26,301,163,138
050,26,063,"Michigan","Huron County",4,27,306,175,131
050,26,063,"Michigan","Huron County",4,28,319,173,146
050,26,063,"Michigan","Huron County",4,29,287,150,137
050,26,063,"Michigan","Huron County",4,30,305,154,151
050,26,063,"Michigan","Huron County",4,31,313,146,167
050,26,063,"Michigan","Huron County",4,32,302,151,151
050,26,063,"Michigan","Huron County",4,33,296,159,137
050,26,063,"Michigan","Huron County",4,34,300,155,145
050,26,063,"Michigan","Huron County",4,35,274,142,132
050,26,063,"Michigan","Huron County",4,36,304,161,143
050,26,063,"Michigan","Huron County",4,37,300,159,141
050,26,063,"Michigan","Huron County",4,38,324,169,155
050,26,063,"Michigan","Huron County",4,39,332,179,153
050,26,063,"Michigan","Huron County",4,40,333,172,161
050,26,063,"Michigan","Huron County",4,41,352,181,171
050,26,063,"Michigan","Huron County",4,42,334,179,155
050,26,063,"Michigan","Huron County",4,43,323,160,163
050,26,063,"Michigan","Huron County",4,44,315,165,150
050,26,063,"Michigan","Huron County",4,45,310,162,148
050,26,063,"Michigan","Huron County",4,46,292,146,146
050,26,063,"Michigan","Huron County",4,47,285,152,133
050,26,063,"Michigan","Huron County",4,48,287,145,142
050,26,063,"Michigan","Huron County",4,49,319,170,149
050,26,063,"Michigan","Huron County",4,50,353,178,175
050,26,063,"Michigan","Huron County",4,51,385,189,196
050,26,063,"Michigan","Huron County",4,52,409,208,201
050,26,063,"Michigan","Huron County",4,53,404,205,199
050,26,063,"Michigan","Huron County",4,54,412,200,212
050,26,063,"Michigan","Huron County",4,55,415,197,218
050,26,063,"Michigan","Huron County",4,56,438,231,207
050,26,063,"Michigan","Huron County",4,57,447,235,212
050,26,063,"Michigan","Huron County",4,58,501,246,255
050,26,063,"Michigan","Huron County",4,59,505,238,267
050,26,063,"Michigan","Huron County",4,60,513,242,271
050,26,063,"Michigan","Huron County",4,61,538,264,274
050,26,063,"Michigan","Huron County",4,62,550,279,271
050,26,063,"Michigan","Huron County",4,63,570,289,281
050,26,063,"Michigan","Huron County",4,64,592,291,301
050,26,063,"Michigan","Huron County",4,65,551,269,282
050,26,063,"Michigan","Huron County",4,66,547,267,280
050,26,063,"Michigan","Huron County",4,67,546,264,282
050,26,063,"Michigan","Huron County",4,68,565,271,294
050,26,063,"Michigan","Huron County",4,69,537,280,257
050,26,063,"Michigan","Huron County",4,70,510,264,246
050,26,063,"Michigan","Huron County",4,71,473,237,236
050,26,063,"Michigan","Huron County",4,72,420,199,221
050,26,063,"Michigan","Huron County",4,73,442,210,232
050,26,063,"Michigan","Huron County",4,74,415,210,205
050,26,063,"Michigan","Huron County",4,75,422,221,201
050,26,063,"Michigan","Huron County",4,76,285,146,139
050,26,063,"Michigan","Huron County",4,77,283,138,145
050,26,063,"Michigan","Huron County",4,78,261,119,142
050,26,063,"Michigan","Huron County",4,79,265,122,143
050,26,063,"Michigan","Huron County",4,80,235,109,126
050,26,063,"Michigan","Huron County",4,81,231,116,115
050,26,063,"Michigan","Huron County",4,82,189,92,97
050,26,063,"Michigan","Huron County",4,83,171,74,97
050,26,063,"Michigan","Huron County",4,84,157,61,96
050,26,063,"Michigan","Huron County",4,85,878,313,565
050,26,063,"Michigan","Huron County",5,0,277,115,162
050,26,063,"Michigan","Huron County",5,1,283,116,167
050,26,063,"Michigan","Huron County",5,2,285,139,146
050,26,063,"Michigan","Huron County",5,3,263,134,129
050,26,063,"Michigan","Huron County",5,4,287,147,140
050,26,063,"Michigan","Huron County",5,5,305,152,153
050,26,063,"Michigan","Huron County",5,6,348,188,160
050,26,063,"Michigan","Huron County",5,7,333,169,164
050,26,063,"Michigan","Huron County",5,8,318,163,155
050,26,063,"Michigan","Huron County",5,9,340,177,163
050,26,063,"Michigan","Huron County",5,10,321,161,160
050,26,063,"Michigan","Huron County",5,11,320,164,156
050,26,063,"Michigan","Huron County",5,12,335,167,168
050,26,063,"Michigan","Huron County",5,13,372,175,197
050,26,063,"Michigan","Huron County",5,14,360,186,174
050,26,063,"Michigan","Huron County",5,15,365,189,176
050,26,063,"Michigan","Huron County",5,16,360,186,174
050,26,063,"Michigan","Huron County",5,17,363,187,176
050,26,063,"Michigan","Huron County",5,18,320,164,156
050,26,063,"Michigan","Huron County",5,19,281,149,132
050,26,063,"Michigan","Huron County",5,20,300,155,145
050,26,063,"Michigan","Huron County",5,21,272,138,134
050,26,063,"Michigan","Huron County",5,22,288,153,135
050,26,063,"Michigan","Huron County",5,23,326,168,158
050,26,063,"Michigan","Huron County",5,24,341,175,166
050,26,063,"Michigan","Huron County",5,25,289,156,133
050,26,063,"Michigan","Huron County",5,26,295,169,126
050,26,063,"Michigan","Huron County",5,27,277,146,131
050,26,063,"Michigan","Huron County",5,28,303,169,134
050,26,063,"Michigan","Huron County",5,29,313,170,143
050,26,063,"Michigan","Huron County",5,30,286,154,132
050,26,063,"Michigan","Huron County",5,31,295,152,143
050,26,063,"Michigan","Huron County",5,32,297,136,161
050,26,063,"Michigan","Huron County",5,33,299,147,152
050,26,063,"Michigan","Huron County",5,34,296,159,137
050,26,063,"Michigan","Huron County",5,35,304,153,151
050,26,063,"Michigan","Huron County",5,36,275,141,134
050,26,063,"Michigan","Huron County",5,37,304,160,144
050,26,063,"Michigan","Huron County",5,38,298,161,137
050,26,063,"Michigan","Huron County",5,39,317,162,155
050,26,063,"Michigan","Huron County",5,40,327,177,150
050,26,063,"Michigan","Huron County",5,41,328,171,157
050,26,063,"Michigan","Huron County",5,42,346,181,165
050,26,063,"Michigan","Huron County",5,43,345,188,157
050,26,063,"Michigan","Huron County",5,44,322,155,167
050,26,063,"Michigan","Huron County",5,45,318,166,152
050,26,063,"Michigan","Huron County",5,46,310,165,145
050,26,063,"Michigan","Huron County",5,47,280,139,141
050,26,063,"Michigan","Huron County",5,48,285,147,138
050,26,063,"Michigan","Huron County",5,49,286,143,143
050,26,063,"Michigan","Huron County",5,50,333,180,153
050,26,063,"Michigan","Huron County",5,51,350,174,176
050,26,063,"Michigan","Huron County",5,52,386,194,192
050,26,063,"Michigan","Huron County",5,53,410,208,202
050,26,063,"Michigan","Huron County",5,54,403,204,199
050,26,063,"Michigan","Huron County",5,55,412,196,216
050,26,063,"Michigan","Huron County",5,56,414,200,214
050,26,063,"Michigan","Huron County",5,57,439,233,206
050,26,063,"Michigan","Huron County",5,58,448,235,213
050,26,063,"Michigan","Huron County",5,59,515,256,259
050,26,063,"Michigan","Huron County",5,60,504,243,261
050,26,063,"Michigan","Huron County",5,61,510,239,271
050,26,063,"Michigan","Huron County",5,62,533,261,272
050,26,063,"Michigan","Huron County",5,63,554,278,276
050,26,063,"Michigan","Huron County",5,64,568,286,282
050,26,063,"Michigan","Huron County",5,65,590,285,305
050,26,063,"Michigan","Huron County",5,66,538,258,280
050,26,063,"Michigan","Huron County",5,67,543,267,276
050,26,063,"Michigan","Huron County",5,68,542,260,282
050,26,063,"Michigan","Huron County",5,69,548,264,284
050,26,063,"Michigan","Huron County",5,70,522,272,250
050,26,063,"Michigan","Huron County",5,71,506,261,245
050,26,063,"Michigan","Huron County",5,72,466,230,236
050,26,063,"Michigan","Huron County",5,73,419,197,222
050,26,063,"Michigan","Huron County",5,74,424,199,225
050,26,063,"Michigan","Huron County",5,75,404,209,195
050,26,063,"Michigan","Huron County",5,76,417,219,198
050,26,063,"Michigan","Huron County",5,77,271,141,130
050,26,063,"Michigan","Huron County",5,78,272,134,138
050,26,063,"Michigan","Huron County",5,79,243,104,139
050,26,063,"Michigan","Huron County",5,80,252,113,139
050,26,063,"Michigan","Huron County",5,81,212,97,115
050,26,063,"Michigan","Huron County",5,82,212,105,107
050,26,063,"Michigan","Huron County",5,83,173,86,87
050,26,063,"Michigan","Huron County",5,84,161,67,94
050,26,063,"Michigan","Huron County",5,85,875,305,570
050,26,065,"Michigan","Ingham County",1,0,2930,1489,1441
050,26,065,"Michigan","Ingham County",1,1,2952,1514,1438
050,26,065,"Michigan","Ingham County",1,2,3059,1563,1496
050,26,065,"Michigan","Ingham County",1,3,3180,1626,1554
050,26,065,"Michigan","Ingham County",1,4,3184,1651,1533
050,26,065,"Michigan","Ingham County",1,5,3245,1651,1594
050,26,065,"Michigan","Ingham County",1,6,3150,1631,1519
050,26,065,"Michigan","Ingham County",1,7,3123,1576,1547
050,26,065,"Michigan","Ingham County",1,8,3001,1538,1463
050,26,065,"Michigan","Ingham County",1,9,3085,1581,1504
050,26,065,"Michigan","Ingham County",1,10,3133,1560,1573
050,26,065,"Michigan","Ingham County",1,11,3135,1624,1511
050,26,065,"Michigan","Ingham County",1,12,3220,1671,1549
050,26,065,"Michigan","Ingham County",1,13,3283,1672,1611
050,26,065,"Michigan","Ingham County",1,14,3148,1588,1560
050,26,065,"Michigan","Ingham County",1,15,3107,1584,1523
050,26,065,"Michigan","Ingham County",1,16,3190,1663,1527
050,26,065,"Michigan","Ingham County",1,17,3192,1641,1551
050,26,065,"Michigan","Ingham County",1,18,6566,3052,3514
050,26,065,"Michigan","Ingham County",1,19,9297,4449,4848
050,26,065,"Michigan","Ingham County",1,20,9098,4451,4647
050,26,065,"Michigan","Ingham County",1,21,8956,4380,4576
050,26,065,"Michigan","Ingham County",1,22,7991,3972,4019
050,26,065,"Michigan","Ingham County",1,23,6549,3363,3186
050,26,065,"Michigan","Ingham County",1,24,5422,2819,2603
050,26,065,"Michigan","Ingham County",1,25,4781,2455,2326
050,26,065,"Michigan","Ingham County",1,26,4478,2288,2190
050,26,065,"Michigan","Ingham County",1,27,4338,2202,2136
050,26,065,"Michigan","Ingham County",1,28,4245,2148,2097
050,26,065,"Michigan","Ingham County",1,29,4136,2124,2012
050,26,065,"Michigan","Ingham County",1,30,4048,2043,2005
050,26,065,"Michigan","Ingham County",1,31,3848,1933,1915
050,26,065,"Michigan","Ingham County",1,32,3637,1840,1797
050,26,065,"Michigan","Ingham County",1,33,3404,1701,1703
050,26,065,"Michigan","Ingham County",1,34,3465,1755,1710
050,26,065,"Michigan","Ingham County",1,35,3443,1754,1689
050,26,065,"Michigan","Ingham County",1,36,3415,1708,1707
050,26,065,"Michigan","Ingham County",1,37,3569,1773,1796
050,26,065,"Michigan","Ingham County",1,38,3344,1651,1693
050,26,065,"Michigan","Ingham County",1,39,3312,1656,1656
050,26,065,"Michigan","Ingham County",1,40,3375,1693,1682
050,26,065,"Michigan","Ingham County",1,41,3312,1633,1679
050,26,065,"Michigan","Ingham County",1,42,3127,1575,1552
050,26,065,"Michigan","Ingham County",1,43,3020,1482,1538
050,26,065,"Michigan","Ingham County",1,44,2874,1378,1496
050,26,065,"Michigan","Ingham County",1,45,2806,1363,1443
050,26,065,"Michigan","Ingham County",1,46,2830,1346,1484
050,26,065,"Michigan","Ingham County",1,47,2884,1372,1512
050,26,065,"Michigan","Ingham County",1,48,3120,1537,1583
050,26,065,"Michigan","Ingham County",1,49,3244,1612,1632
050,26,065,"Michigan","Ingham County",1,50,3084,1515,1569
050,26,065,"Michigan","Ingham County",1,51,3043,1494,1549
050,26,065,"Michigan","Ingham County",1,52,2885,1442,1443
050,26,065,"Michigan","Ingham County",1,53,2896,1440,1456
050,26,065,"Michigan","Ingham County",1,54,3000,1482,1518
050,26,065,"Michigan","Ingham County",1,55,3103,1482,1621
050,26,065,"Michigan","Ingham County",1,56,3149,1512,1637
050,26,065,"Michigan","Ingham County",1,57,3204,1562,1642
050,26,065,"Michigan","Ingham County",1,58,3242,1602,1640
050,26,065,"Michigan","Ingham County",1,59,3204,1531,1673
050,26,065,"Michigan","Ingham County",1,60,3183,1480,1703
050,26,065,"Michigan","Ingham County",1,61,3205,1507,1698
050,26,065,"Michigan","Ingham County",1,62,3334,1571,1763
050,26,065,"Michigan","Ingham County",1,63,3225,1516,1709
050,26,065,"Michigan","Ingham County",1,64,3111,1467,1644
050,26,065,"Michigan","Ingham County",1,65,3057,1415,1642
050,26,065,"Michigan","Ingham County",1,66,2907,1335,1572
050,26,065,"Michigan","Ingham County",1,67,2770,1269,1501
050,26,065,"Michigan","Ingham County",1,68,2736,1248,1488
050,26,065,"Michigan","Ingham County",1,69,2577,1179,1398
050,26,065,"Michigan","Ingham County",1,70,2443,1142,1301
050,26,065,"Michigan","Ingham County",1,71,2371,1100,1271
050,26,065,"Michigan","Ingham County",1,72,2261,1047,1214
050,26,065,"Michigan","Ingham County",1,73,2244,1036,1208
050,26,065,"Michigan","Ingham County",1,74,1523,685,838
050,26,065,"Michigan","Ingham County",1,75,1466,666,800
050,26,065,"Michigan","Ingham County",1,76,1476,668,808
050,26,065,"Michigan","Ingham County",1,77,1507,667,840
050,26,065,"Michigan","Ingham County",1,78,1259,558,701
050,26,065,"Michigan","Ingham County",1,79,1067,459,608
050,26,065,"Michigan","Ingham County",1,80,966,413,553
050,26,065,"Michigan","Ingham County",1,81,873,381,492
050,26,065,"Michigan","Ingham County",1,82,788,321,467
050,26,065,"Michigan","Ingham County",1,83,676,288,388
050,26,065,"Michigan","Ingham County",1,84,658,265,393
050,26,065,"Michigan","Ingham County",1,85,4163,1412,2751
050,26,065,"Michigan","Ingham County",2,0,2930,1487,1443
050,26,065,"Michigan","Ingham County",2,1,2932,1502,1430
050,26,065,"Michigan","Ingham County",2,2,3033,1552,1481
050,26,065,"Michigan","Ingham County",2,3,3147,1610,1537
050,26,065,"Michigan","Ingham County",2,4,3188,1646,1542
050,26,065,"Michigan","Ingham County",2,5,3232,1650,1582
050,26,065,"Michigan","Ingham County",2,6,3166,1633,1533
050,26,065,"Michigan","Ingham County",2,7,3116,1581,1535
050,26,065,"Michigan","Ingham County",2,8,3021,1546,1475
050,26,065,"Michigan","Ingham County",2,9,3053,1565,1488
050,26,065,"Michigan","Ingham County",2,10,3116,1562,1554
050,26,065,"Michigan","Ingham County",2,11,3117,1597,1520
050,26,065,"Michigan","Ingham County",2,12,3215,1664,1551
050,26,065,"Michigan","Ingham County",2,13,3260,1668,1592
050,26,065,"Michigan","Ingham County",2,14,3174,1603,1571
050,26,065,"Michigan","Ingham County",2,15,3120,1585,1535
050,26,065,"Michigan","Ingham County",2,16,3170,1639,1531
050,26,065,"Michigan","Ingham County",2,17,3198,1650,1548
050,26,065,"Michigan","Ingham County",2,18,6526,3033,3493
050,26,065,"Michigan","Ingham County",2,19,9271,4438,4833
050,26,065,"Michigan","Ingham County",2,20,9170,4483,4687
050,26,065,"Michigan","Ingham County",2,21,8930,4366,4564
050,26,065,"Michigan","Ingham County",2,22,7946,3956,3990
050,26,065,"Michigan","Ingham County",2,23,6518,3338,3180
050,26,065,"Michigan","Ingham County",2,24,5414,2812,2602
050,26,065,"Michigan","Ingham County",2,25,4760,2430,2330
050,26,065,"Michigan","Ingham County",2,26,4462,2290,2172
050,26,065,"Michigan","Ingham County",2,27,4281,2179,2102
050,26,065,"Michigan","Ingham County",2,28,4231,2143,2088
050,26,065,"Michigan","Ingham County",2,29,4123,2104,2019
050,26,065,"Michigan","Ingham County",2,30,4058,2053,2005
050,26,065,"Michigan","Ingham County",2,31,3863,1939,1924
050,26,065,"Michigan","Ingham County",2,32,3667,1852,1815
050,26,065,"Michigan","Ingham County",2,33,3437,1724,1713
050,26,065,"Michigan","Ingham County",2,34,3439,1734,1705
050,26,065,"Michigan","Ingham County",2,35,3458,1754,1704
050,26,065,"Michigan","Ingham County",2,36,3398,1703,1695
050,26,065,"Michigan","Ingham County",2,37,3527,1751,1776
050,26,065,"Michigan","Ingham County",2,38,3407,1690,1717
050,26,065,"Michigan","Ingham County",2,39,3297,1644,1653
050,26,065,"Michigan","Ingham County",2,40,3378,1691,1687
050,26,065,"Michigan","Ingham County",2,41,3320,1642,1678
050,26,065,"Michigan","Ingham County",2,42,3153,1577,1576
050,26,065,"Michigan","Ingham County",2,43,3067,1511,1556
050,26,065,"Michigan","Ingham County",2,44,2883,1388,1495
050,26,065,"Michigan","Ingham County",2,45,2841,1375,1466
050,26,065,"Michigan","Ingham County",2,46,2804,1336,1468
050,26,065,"Michigan","Ingham County",2,47,2869,1367,1502
050,26,065,"Michigan","Ingham County",2,48,3051,1489,1562
050,26,065,"Michigan","Ingham County",2,49,3224,1601,1623
050,26,065,"Michigan","Ingham County",2,50,3131,1545,1586
050,26,065,"Michigan","Ingham County",2,51,3025,1482,1543
050,26,065,"Michigan","Ingham County",2,52,2915,1454,1461
050,26,065,"Michigan","Ingham County",2,53,2892,1438,1454
050,26,065,"Michigan","Ingham County",2,54,2964,1469,1495
050,26,065,"Michigan","Ingham County",2,55,3064,1475,1589
050,26,065,"Michigan","Ingham County",2,56,3137,1506,1631
050,26,065,"Michigan","Ingham County",2,57,3190,1550,1640
050,26,065,"Michigan","Ingham County",2,58,3213,1581,1632
050,26,065,"Michigan","Ingham County",2,59,3210,1548,1662
050,26,065,"Michigan","Ingham County",2,60,3161,1475,1686
050,26,065,"Michigan","Ingham County",2,61,3181,1494,1687
050,26,065,"Michigan","Ingham County",2,62,3271,1535,1736
050,26,065,"Michigan","Ingham County",2,63,3260,1532,1728
050,26,065,"Michigan","Ingham County",2,64,3106,1464,1642
050,26,065,"Michigan","Ingham County",2,65,3039,1416,1623
050,26,065,"Michigan","Ingham County",2,66,2928,1345,1583
050,26,065,"Michigan","Ingham County",2,67,2767,1265,1502
050,26,065,"Michigan","Ingham County",2,68,2712,1235,1477
050,26,065,"Michigan","Ingham County",2,69,2625,1197,1428
050,26,065,"Michigan","Ingham County",2,70,2454,1142,1312
050,26,065,"Michigan","Ingham County",2,71,2369,1100,1269
050,26,065,"Michigan","Ingham County",2,72,2240,1038,1202
050,26,065,"Michigan","Ingham County",2,73,2335,1079,1256
050,26,065,"Michigan","Ingham County",2,74,1585,717,868
050,26,065,"Michigan","Ingham County",2,75,1469,666,803
050,26,065,"Michigan","Ingham County",2,76,1451,657,794
050,26,065,"Michigan","Ingham County",2,77,1517,672,845
050,26,065,"Michigan","Ingham County",2,78,1282,564,718
050,26,065,"Michigan","Ingham County",2,79,1088,468,620
050,26,065,"Michigan","Ingham County",2,80,977,416,561
050,26,065,"Michigan","Ingham County",2,81,878,382,496
050,26,065,"Michigan","Ingham County",2,82,798,328,470
050,26,065,"Michigan","Ingham County",2,83,679,285,394
050,26,065,"Michigan","Ingham County",2,84,655,263,392
050,26,065,"Michigan","Ingham County",2,85,4146,1416,2730
050,26,065,"Michigan","Ingham County",3,0,2721,1394,1327
050,26,065,"Michigan","Ingham County",3,1,2944,1494,1450
050,26,065,"Michigan","Ingham County",3,2,2920,1509,1411
050,26,065,"Michigan","Ingham County",3,3,2996,1519,1477
050,26,065,"Michigan","Ingham County",3,4,3109,1557,1552
050,26,065,"Michigan","Ingham County",3,5,3182,1650,1532
050,26,065,"Michigan","Ingham County",3,6,3180,1631,1549
050,26,065,"Michigan","Ingham County",3,7,3163,1612,1551
050,26,065,"Michigan","Ingham County",3,8,3141,1592,1549
050,26,065,"Michigan","Ingham County",3,9,3009,1539,1470
050,26,065,"Michigan","Ingham County",3,10,3027,1550,1477
050,26,065,"Michigan","Ingham County",3,11,3110,1553,1557
050,26,065,"Michigan","Ingham County",3,12,3109,1594,1515
050,26,065,"Michigan","Ingham County",3,13,3193,1668,1525
050,26,065,"Michigan","Ingham County",3,14,3246,1676,1570
050,26,065,"Michigan","Ingham County",3,15,3186,1605,1581
050,26,065,"Michigan","Ingham County",3,16,3128,1586,1542
050,26,065,"Michigan","Ingham County",3,17,3179,1650,1529
050,26,065,"Michigan","Ingham County",3,18,3494,1772,1722
050,26,065,"Michigan","Ingham County",3,19,4349,2086,2263
050,26,065,"Michigan","Ingham County",3,20,6404,3171,3233
050,26,065,"Michigan","Ingham County",3,21,7830,3765,4065
050,26,065,"Michigan","Ingham County",3,22,7234,3624,3610
050,26,065,"Michigan","Ingham County",3,23,6171,3121,3050
050,26,065,"Michigan","Ingham County",3,24,5351,2742,2609
050,26,065,"Michigan","Ingham County",3,25,4654,2305,2349
050,26,065,"Michigan","Ingham County",3,26,4284,2190,2094
050,26,065,"Michigan","Ingham County",3,27,4182,2190,1992
050,26,065,"Michigan","Ingham County",3,28,4148,2086,2062
050,26,065,"Michigan","Ingham County",3,29,4127,2066,2061
050,26,065,"Michigan","Ingham County",3,30,4032,2060,1972
050,26,065,"Michigan","Ingham County",3,31,3999,2025,1974
050,26,065,"Michigan","Ingham County",3,32,3779,1882,1897
050,26,065,"Michigan","Ingham County",3,33,3642,1829,1813
050,26,065,"Michigan","Ingham County",3,34,3380,1709,1671
050,26,065,"Michigan","Ingham County",3,35,3366,1686,1680
050,26,065,"Michigan","Ingham County",3,36,3424,1733,1691
050,26,065,"Michigan","Ingham County",3,37,3396,1722,1674
050,26,065,"Michigan","Ingham County",3,38,3510,1766,1744
050,26,065,"Michigan","Ingham County",3,39,3376,1669,1707
050,26,065,"Michigan","Ingham County",3,40,3269,1631,1638
050,26,065,"Michigan","Ingham County",3,41,3381,1677,1704
050,26,065,"Michigan","Ingham County",3,42,3316,1644,1672
050,26,065,"Michigan","Ingham County",3,43,3112,1564,1548
050,26,065,"Michigan","Ingham County",3,44,3014,1463,1551
050,26,065,"Michigan","Ingham County",3,45,2849,1379,1470
050,26,065,"Michigan","Ingham County",3,46,2814,1363,1451
050,26,065,"Michigan","Ingham County",3,47,2773,1338,1435
050,26,065,"Michigan","Ingham County",3,48,2855,1344,1511
050,26,065,"Michigan","Ingham County",3,49,3018,1479,1539
050,26,065,"Michigan","Ingham County",3,50,3250,1596,1654
050,26,065,"Michigan","Ingham County",3,51,3081,1516,1565
050,26,065,"Michigan","Ingham County",3,52,2973,1456,1517
050,26,065,"Michigan","Ingham County",3,53,2919,1446,1473
050,26,065,"Michigan","Ingham County",3,54,2871,1424,1447
050,26,065,"Michigan","Ingham County",3,55,2937,1446,1491
050,26,065,"Michigan","Ingham County",3,56,3012,1455,1557
050,26,065,"Michigan","Ingham County",3,57,3102,1493,1609
050,26,065,"Michigan","Ingham County",3,58,3099,1484,1615
050,26,065,"Michigan","Ingham County",3,59,3165,1569,1596
050,26,065,"Michigan","Ingham County",3,60,3167,1515,1652
050,26,065,"Michigan","Ingham County",3,61,3083,1431,1652
050,26,065,"Michigan","Ingham County",3,62,3100,1444,1656
050,26,065,"Michigan","Ingham County",3,63,3193,1487,1706
050,26,065,"Michigan","Ingham County",3,64,3191,1502,1689
050,26,065,"Michigan","Ingham County",3,65,3013,1407,1606
050,26,065,"Michigan","Ingham County",3,66,2980,1387,1593
050,26,065,"Michigan","Ingham County",3,67,2872,1316,1556
050,26,065,"Michigan","Ingham County",3,68,2672,1226,1446
050,26,065,"Michigan","Ingham County",3,69,2650,1204,1446
050,26,065,"Michigan","Ingham County",3,70,2537,1147,1390
050,26,065,"Michigan","Ingham County",3,71,2371,1094,1277
050,26,065,"Michigan","Ingham County",3,72,2319,1066,1253
050,26,065,"Michigan","Ingham County",3,73,2142,991,1151
050,26,065,"Michigan","Ingham County",3,74,2235,1025,1210
050,26,065,"Michigan","Ingham County",3,75,1536,699,837
050,26,065,"Michigan","Ingham County",3,76,1422,634,788
050,26,065,"Michigan","Ingham County",3,77,1377,610,767
050,26,065,"Michigan","Ingham County",3,78,1458,647,811
050,26,065,"Michigan","Ingham County",3,79,1200,524,676
050,26,065,"Michigan","Ingham County",3,80,1033,432,601
050,26,065,"Michigan","Ingham County",3,81,934,400,534
050,26,065,"Michigan","Ingham County",3,82,803,354,449
050,26,065,"Michigan","Ingham County",3,83,730,301,429
050,26,065,"Michigan","Ingham County",3,84,633,247,386
050,26,065,"Michigan","Ingham County",3,85,4088,1418,2670
050,26,065,"Michigan","Ingham County",4,0,2839,1451,1388
050,26,065,"Michigan","Ingham County",4,1,2752,1403,1349
050,26,065,"Michigan","Ingham County",4,2,2961,1501,1460
050,26,065,"Michigan","Ingham County",4,3,2923,1475,1448
050,26,065,"Michigan","Ingham County",4,4,2939,1470,1469
050,26,065,"Michigan","Ingham County",4,5,3142,1578,1564
050,26,065,"Michigan","Ingham County",4,6,3178,1633,1545
050,26,065,"Michigan","Ingham County",4,7,3211,1649,1562
050,26,065,"Michigan","Ingham County",4,8,3148,1601,1547
050,26,065,"Michigan","Ingham County",4,9,3090,1577,1513
050,26,065,"Michigan","Ingham County",4,10,2995,1548,1447
050,26,065,"Michigan","Ingham County",4,11,3003,1537,1466
050,26,065,"Michigan","Ingham County",4,12,3088,1563,1525
050,26,065,"Michigan","Ingham County",4,13,3082,1572,1510
050,26,065,"Michigan","Ingham County",4,14,3193,1665,1528
050,26,065,"Michigan","Ingham County",4,15,3256,1676,1580
050,26,065,"Michigan","Ingham County",4,16,3164,1585,1579
050,26,065,"Michigan","Ingham County",4,17,3158,1610,1548
050,26,065,"Michigan","Ingham County",4,18,6501,3053,3448
050,26,065,"Michigan","Ingham County",4,19,9117,4375,4742
050,26,065,"Michigan","Ingham County",4,20,8958,4353,4605
050,26,065,"Michigan","Ingham County",4,21,9065,4398,4667
050,26,065,"Michigan","Ingham County",4,22,8008,3954,4054
050,26,065,"Michigan","Ingham County",4,23,6293,3277,3016
050,26,065,"Michigan","Ingham County",4,24,5328,2743,2585
050,26,065,"Michigan","Ingham County",4,25,4776,2374,2402
050,26,065,"Michigan","Ingham County",4,26,4314,2162,2152
050,26,065,"Michigan","Ingham County",4,27,4045,2087,1958
050,26,065,"Michigan","Ingham County",4,28,4065,2144,1921
050,26,065,"Michigan","Ingham County",4,29,4052,2019,2033
050,26,065,"Michigan","Ingham County",4,30,4042,2048,1994
050,26,065,"Michigan","Ingham County",4,31,3988,2015,1973
050,26,065,"Michigan","Ingham County",4,32,3970,2012,1958
050,26,065,"Michigan","Ingham County",4,33,3721,1817,1904
050,26,065,"Michigan","Ingham County",4,34,3534,1769,1765
050,26,065,"Michigan","Ingham County",4,35,3310,1678,1632
050,26,065,"Michigan","Ingham County",4,36,3333,1671,1662
050,26,065,"Michigan","Ingham County",4,37,3356,1707,1649
050,26,065,"Michigan","Ingham County",4,38,3353,1698,1655
050,26,065,"Michigan","Ingham County",4,39,3468,1734,1734
050,26,065,"Michigan","Ingham County",4,40,3369,1680,1689
050,26,065,"Michigan","Ingham County",4,41,3272,1630,1642
050,26,065,"Michigan","Ingham County",4,42,3350,1659,1691
050,26,065,"Michigan","Ingham County",4,43,3295,1641,1654
050,26,065,"Michigan","Ingham County",4,44,3066,1527,1539
050,26,065,"Michigan","Ingham County",4,45,3012,1470,1542
050,26,065,"Michigan","Ingham County",4,46,2824,1366,1458
050,26,065,"Michigan","Ingham County",4,47,2785,1343,1442
050,26,065,"Michigan","Ingham County",4,48,2714,1306,1408
050,26,065,"Michigan","Ingham County",4,49,2816,1337,1479
050,26,065,"Michigan","Ingham County",4,50,2976,1455,1521
050,26,065,"Michigan","Ingham County",4,51,3196,1559,1637
050,26,065,"Michigan","Ingham County",4,52,3052,1503,1549
050,26,065,"Michigan","Ingham County",4,53,2949,1443,1506
050,26,065,"Michigan","Ingham County",4,54,2896,1441,1455
050,26,065,"Michigan","Ingham County",4,55,2805,1380,1425
050,26,065,"Michigan","Ingham County",4,56,2869,1417,1452
050,26,065,"Michigan","Ingham County",4,57,2976,1464,1512
050,26,065,"Michigan","Ingham County",4,58,3026,1462,1564
050,26,065,"Michigan","Ingham County",4,59,3055,1466,1589
050,26,065,"Michigan","Ingham County",4,60,3127,1526,1601
050,26,065,"Michigan","Ingham County",4,61,3084,1469,1615
050,26,065,"Michigan","Ingham County",4,62,3006,1381,1625
050,26,065,"Michigan","Ingham County",4,63,3047,1416,1631
050,26,065,"Michigan","Ingham County",4,64,3130,1446,1684
050,26,065,"Michigan","Ingham County",4,65,3073,1438,1635
050,26,065,"Michigan","Ingham County",4,66,2935,1359,1576
050,26,065,"Michigan","Ingham County",4,67,2875,1332,1543
050,26,065,"Michigan","Ingham County",4,68,2762,1256,1506
050,26,065,"Michigan","Ingham County",4,69,2639,1202,1437
050,26,065,"Michigan","Ingham County",4,70,2592,1179,1413
050,26,065,"Michigan","Ingham County",4,71,2467,1103,1364
050,26,065,"Michigan","Ingham County",4,72,2294,1060,1234
050,26,065,"Michigan","Ingham County",4,73,2233,1003,1230
050,26,065,"Michigan","Ingham County",4,74,2091,963,1128
050,26,065,"Michigan","Ingham County",4,75,2160,991,1169
050,26,065,"Michigan","Ingham County",4,76,1484,664,820
050,26,065,"Michigan","Ingham County",4,77,1350,596,754
050,26,065,"Michigan","Ingham County",4,78,1329,581,748
050,26,065,"Michigan","Ingham County",4,79,1387,608,779
050,26,065,"Michigan","Ingham County",4,80,1156,480,676
050,26,065,"Michigan","Ingham County",4,81,966,414,552
050,26,065,"Michigan","Ingham County",4,82,865,373,492
050,26,065,"Michigan","Ingham County",4,83,727,323,404
050,26,065,"Michigan","Ingham County",4,84,687,270,417
050,26,065,"Michigan","Ingham County",4,85,3989,1403,2586
050,26,065,"Michigan","Ingham County",5,0,2899,1479,1420
050,26,065,"Michigan","Ingham County",5,1,2834,1461,1373
050,26,065,"Michigan","Ingham County",5,2,2738,1391,1347
050,26,065,"Michigan","Ingham County",5,3,2929,1489,1440
050,26,065,"Michigan","Ingham County",5,4,2921,1477,1444
050,26,065,"Michigan","Ingham County",5,5,2958,1491,1467
050,26,065,"Michigan","Ingham County",5,6,3127,1572,1555
050,26,065,"Michigan","Ingham County",5,7,3139,1622,1517
050,26,065,"Michigan","Ingham County",5,8,3200,1645,1555
050,26,065,"Michigan","Ingham County",5,9,3152,1591,1561
050,26,065,"Michigan","Ingham County",5,10,3055,1539,1516
050,26,065,"Michigan","Ingham County",5,11,2997,1549,1448
050,26,065,"Michigan","Ingham County",5,12,2974,1511,1463
050,26,065,"Michigan","Ingham County",5,13,3121,1605,1516
050,26,065,"Michigan","Ingham County",5,14,3078,1574,1504
050,26,065,"Michigan","Ingham County",5,15,3200,1662,1538
050,26,065,"Michigan","Ingham County",5,16,3279,1683,1596
050,26,065,"Michigan","Ingham County",5,17,3257,1641,1616
050,26,065,"Michigan","Ingham County",5,18,6814,3177,3637
050,26,065,"Michigan","Ingham County",5,19,9710,4672,5038
050,26,065,"Michigan","Ingham County",5,20,9278,4545,4733
050,26,065,"Michigan","Ingham County",5,21,8989,4357,4632
050,26,065,"Michigan","Ingham County",5,22,8090,3977,4113
050,26,065,"Michigan","Ingham County",5,23,6509,3323,3186
050,26,065,"Michigan","Ingham County",5,24,5184,2714,2470
050,26,065,"Michigan","Ingham County",5,25,4673,2309,2364
050,26,065,"Michigan","Ingham County",5,26,4367,2167,2200
050,26,065,"Michigan","Ingham County",5,27,4000,1985,2015
050,26,065,"Michigan","Ingham County",5,28,3919,2024,1895
050,26,065,"Michigan","Ingham County",5,29,3857,2024,1833
050,26,065,"Michigan","Ingham County",5,30,4014,1976,2038
050,26,065,"Michigan","Ingham County",5,31,3964,2001,1963
050,26,065,"Michigan","Ingham County",5,32,3862,1958,1904
050,26,065,"Michigan","Ingham County",5,33,3860,1974,1886
050,26,065,"Michigan","Ingham County",5,34,3692,1800,1892
050,26,065,"Michigan","Ingham County",5,35,3512,1770,1742
050,26,065,"Michigan","Ingham County",5,36,3246,1643,1603
050,26,065,"Michigan","Ingham County",5,37,3301,1657,1644
050,26,065,"Michigan","Ingham County",5,38,3309,1676,1633
050,26,065,"Michigan","Ingham County",5,39,3287,1649,1638
050,26,065,"Michigan","Ingham County",5,40,3404,1703,1701
050,26,065,"Michigan","Ingham County",5,41,3329,1662,1667
050,26,065,"Michigan","Ingham County",5,42,3276,1619,1657
050,26,065,"Michigan","Ingham County",5,43,3354,1669,1685
050,26,065,"Michigan","Ingham County",5,44,3286,1610,1676
050,26,065,"Michigan","Ingham County",5,45,3067,1531,1536
050,26,065,"Michigan","Ingham County",5,46,2988,1476,1512
050,26,065,"Michigan","Ingham County",5,47,2791,1346,1445
050,26,065,"Michigan","Ingham County",5,48,2755,1309,1446
050,26,065,"Michigan","Ingham County",5,49,2697,1295,1402
050,26,065,"Michigan","Ingham County",5,50,2797,1320,1477
050,26,065,"Michigan","Ingham County",5,51,2957,1433,1524
050,26,065,"Michigan","Ingham County",5,52,3176,1540,1636
050,26,065,"Michigan","Ingham County",5,53,2992,1456,1536
050,26,065,"Michigan","Ingham County",5,54,2892,1409,1483
050,26,065,"Michigan","Ingham County",5,55,2863,1397,1466
050,26,065,"Michigan","Ingham County",5,56,2758,1352,1406
050,26,065,"Michigan","Ingham County",5,57,2805,1399,1406
050,26,065,"Michigan","Ingham County",5,58,2925,1424,1501
050,26,065,"Michigan","Ingham County",5,59,2994,1448,1546
050,26,065,"Michigan","Ingham County",5,60,2978,1419,1559
050,26,065,"Michigan","Ingham County",5,61,3061,1499,1562
050,26,065,"Michigan","Ingham County",5,62,3007,1428,1579
050,26,065,"Michigan","Ingham County",5,63,2960,1364,1596
050,26,065,"Michigan","Ingham County",5,64,2961,1381,1580
050,26,065,"Michigan","Ingham County",5,65,3052,1408,1644
050,26,065,"Michigan","Ingham County",5,66,2994,1395,1599
050,26,065,"Michigan","Ingham County",5,67,2884,1336,1548
050,26,065,"Michigan","Ingham County",5,68,2789,1280,1509
050,26,065,"Michigan","Ingham County",5,69,2711,1230,1481
050,26,065,"Michigan","Ingham County",5,70,2592,1180,1412
050,26,065,"Michigan","Ingham County",5,71,2517,1137,1380
050,26,065,"Michigan","Ingham County",5,72,2413,1081,1332
050,26,065,"Michigan","Ingham County",5,73,2202,1000,1202
050,26,065,"Michigan","Ingham County",5,74,2176,978,1198
050,26,065,"Michigan","Ingham County",5,75,2039,951,1088
050,26,065,"Michigan","Ingham County",5,76,2095,954,1141
050,26,065,"Michigan","Ingham County",5,77,1421,623,798
050,26,065,"Michigan","Ingham County",5,78,1305,566,739
050,26,065,"Michigan","Ingham County",5,79,1266,549,717
050,26,065,"Michigan","Ingham County",5,80,1327,568,759
050,26,065,"Michigan","Ingham County",5,81,1089,455,634
050,26,065,"Michigan","Ingham County",5,82,900,372,528
050,26,065,"Michigan","Ingham County",5,83,797,353,444
050,26,065,"Michigan","Ingham County",5,84,683,284,399
050,26,065,"Michigan","Ingham County",5,85,4017,1429,2588
050,26,067,"Michigan","Ionia County",1,0,665,341,324
050,26,067,"Michigan","Ionia County",1,1,689,359,330
050,26,067,"Michigan","Ionia County",1,2,725,375,350
050,26,067,"Michigan","Ionia County",1,3,775,380,395
050,26,067,"Michigan","Ionia County",1,4,768,387,381
050,26,067,"Michigan","Ionia County",1,5,759,390,369
050,26,067,"Michigan","Ionia County",1,6,761,406,355
050,26,067,"Michigan","Ionia County",1,7,794,393,401
050,26,067,"Michigan","Ionia County",1,8,757,389,368
050,26,067,"Michigan","Ionia County",1,9,781,410,371
050,26,067,"Michigan","Ionia County",1,10,809,427,382
050,26,067,"Michigan","Ionia County",1,11,855,449,406
050,26,067,"Michigan","Ionia County",1,12,905,455,450
050,26,067,"Michigan","Ionia County",1,13,890,452,438
050,26,067,"Michigan","Ionia County",1,14,854,426,428
050,26,067,"Michigan","Ionia County",1,15,880,459,421
050,26,067,"Michigan","Ionia County",1,16,880,468,412
050,26,067,"Michigan","Ionia County",1,17,872,460,412
050,26,067,"Michigan","Ionia County",1,18,810,462,348
050,26,067,"Michigan","Ionia County",1,19,762,513,249
050,26,067,"Michigan","Ionia County",1,20,875,602,273
050,26,067,"Michigan","Ionia County",1,21,928,623,305
050,26,067,"Michigan","Ionia County",1,22,951,599,352
050,26,067,"Michigan","Ionia County",1,23,953,593,360
050,26,067,"Michigan","Ionia County",1,24,994,624,370
050,26,067,"Michigan","Ionia County",1,25,995,621,374
050,26,067,"Michigan","Ionia County",1,26,991,609,382
050,26,067,"Michigan","Ionia County",1,27,1004,612,392
050,26,067,"Michigan","Ionia County",1,28,975,608,367
050,26,067,"Michigan","Ionia County",1,29,1054,666,388
050,26,067,"Michigan","Ionia County",1,30,976,603,373
050,26,067,"Michigan","Ionia County",1,31,949,587,362
050,26,067,"Michigan","Ionia County",1,32,907,572,335
050,26,067,"Michigan","Ionia County",1,33,876,517,359
050,26,067,"Michigan","Ionia County",1,34,850,476,374
050,26,067,"Michigan","Ionia County",1,35,883,525,358
050,26,067,"Michigan","Ionia County",1,36,880,520,360
050,26,067,"Michigan","Ionia County",1,37,945,542,403
050,26,067,"Michigan","Ionia County",1,38,930,565,365
050,26,067,"Michigan","Ionia County",1,39,938,567,371
050,26,067,"Michigan","Ionia County",1,40,900,517,383
050,26,067,"Michigan","Ionia County",1,41,865,502,363
050,26,067,"Michigan","Ionia County",1,42,911,553,358
050,26,067,"Michigan","Ionia County",1,43,863,501,362
050,26,067,"Michigan","Ionia County",1,44,882,520,362
050,26,067,"Michigan","Ionia County",1,45,870,490,380
050,26,067,"Michigan","Ionia County",1,46,853,495,358
050,26,067,"Michigan","Ionia County",1,47,839,505,334
050,26,067,"Michigan","Ionia County",1,48,919,524,395
050,26,067,"Michigan","Ionia County",1,49,926,522,404
050,26,067,"Michigan","Ionia County",1,50,926,530,396
050,26,067,"Michigan","Ionia County",1,51,940,535,405
050,26,067,"Michigan","Ionia County",1,52,890,500,390
050,26,067,"Michigan","Ionia County",1,53,885,486,399
050,26,067,"Michigan","Ionia County",1,54,860,473,387
050,26,067,"Michigan","Ionia County",1,55,877,475,402
050,26,067,"Michigan","Ionia County",1,56,917,494,423
050,26,067,"Michigan","Ionia County",1,57,932,497,435
050,26,067,"Michigan","Ionia County",1,58,949,493,456
050,26,067,"Michigan","Ionia County",1,59,936,498,438
050,26,067,"Michigan","Ionia County",1,60,884,482,402
050,26,067,"Michigan","Ionia County",1,61,888,474,414
050,26,067,"Michigan","Ionia County",1,62,865,456,409
050,26,067,"Michigan","Ionia County",1,63,825,415,410
050,26,067,"Michigan","Ionia County",1,64,807,411,396
050,26,067,"Michigan","Ionia County",1,65,760,382,378
050,26,067,"Michigan","Ionia County",1,66,727,357,370
050,26,067,"Michigan","Ionia County",1,67,679,339,340
050,26,067,"Michigan","Ionia County",1,68,664,332,332
050,26,067,"Michigan","Ionia County",1,69,639,325,314
050,26,067,"Michigan","Ionia County",1,70,578,290,288
050,26,067,"Michigan","Ionia County",1,71,561,285,276
050,26,067,"Michigan","Ionia County",1,72,563,275,288
050,26,067,"Michigan","Ionia County",1,73,563,274,289
050,26,067,"Michigan","Ionia County",1,74,399,192,207
050,26,067,"Michigan","Ionia County",1,75,409,193,216
050,26,067,"Michigan","Ionia County",1,76,400,192,208
050,26,067,"Michigan","Ionia County",1,77,364,166,198
050,26,067,"Michigan","Ionia County",1,78,306,148,158
050,26,067,"Michigan","Ionia County",1,79,253,124,129
050,26,067,"Michigan","Ionia County",1,80,262,126,136
050,26,067,"Michigan","Ionia County",1,81,234,101,133
050,26,067,"Michigan","Ionia County",1,82,196,81,115
050,26,067,"Michigan","Ionia County",1,83,176,66,110
050,26,067,"Michigan","Ionia County",1,84,157,65,92
050,26,067,"Michigan","Ionia County",1,85,847,321,526
050,26,067,"Michigan","Ionia County",2,0,681,352,329
050,26,067,"Michigan","Ionia County",2,1,681,351,330
050,26,067,"Michigan","Ionia County",2,2,716,367,349
050,26,067,"Michigan","Ionia County",2,3,761,377,384
050,26,067,"Michigan","Ionia County",2,4,774,389,385
050,26,067,"Michigan","Ionia County",2,5,761,390,371
050,26,067,"Michigan","Ionia County",2,6,766,403,363
050,26,067,"Michigan","Ionia County",2,7,786,397,389
050,26,067,"Michigan","Ionia County",2,8,760,387,373
050,26,067,"Michigan","Ionia County",2,9,771,400,371
050,26,067,"Michigan","Ionia County",2,10,804,422,382
050,26,067,"Michigan","Ionia County",2,11,841,443,398
050,26,067,"Michigan","Ionia County",2,12,900,458,442
050,26,067,"Michigan","Ionia County",2,13,895,454,441
050,26,067,"Michigan","Ionia County",2,14,870,436,434
050,26,067,"Michigan","Ionia County",2,15,876,452,424
050,26,067,"Michigan","Ionia County",2,16,882,467,415
050,26,067,"Michigan","Ionia County",2,17,880,466,414
050,26,067,"Michigan","Ionia County",2,18,808,467,341
050,26,067,"Michigan","Ionia County",2,19,768,509,259
050,26,067,"Michigan","Ionia County",2,20,879,604,275
050,26,067,"Michigan","Ionia County",2,21,927,622,305
050,26,067,"Michigan","Ionia County",2,22,947,600,347
050,26,067,"Michigan","Ionia County",2,23,955,592,363
050,26,067,"Michigan","Ionia County",2,24,994,622,372
050,26,067,"Michigan","Ionia County",2,25,993,616,377
050,26,067,"Michigan","Ionia County",2,26,992,608,384
050,26,067,"Michigan","Ionia County",2,27,1009,616,393
050,26,067,"Michigan","Ionia County",2,28,981,604,377
050,26,067,"Michigan","Ionia County",2,29,1041,657,384
050,26,067,"Michigan","Ionia County",2,30,995,616,379
050,26,067,"Michigan","Ionia County",2,31,954,592,362
050,26,067,"Michigan","Ionia County",2,32,917,575,342
050,26,067,"Michigan","Ionia County",2,33,874,517,357
050,26,067,"Michigan","Ionia County",2,34,846,473,373
050,26,067,"Michigan","Ionia County",2,35,888,525,363
050,26,067,"Michigan","Ionia County",2,36,878,520,358
050,26,067,"Michigan","Ionia County",2,37,935,542,393
050,26,067,"Michigan","Ionia County",2,38,940,563,377
050,26,067,"Michigan","Ionia County",2,39,938,568,370
050,26,067,"Michigan","Ionia County",2,40,907,521,386
050,26,067,"Michigan","Ionia County",2,41,872,504,368
050,26,067,"Michigan","Ionia County",2,42,908,552,356
050,26,067,"Michigan","Ionia County",2,43,862,499,363
050,26,067,"Michigan","Ionia County",2,44,883,523,360
050,26,067,"Michigan","Ionia County",2,45,873,493,380
050,26,067,"Michigan","Ionia County",2,46,853,492,361
050,26,067,"Michigan","Ionia County",2,47,836,498,338
050,26,067,"Michigan","Ionia County",2,48,893,509,384
050,26,067,"Michigan","Ionia County",2,49,932,530,402
050,26,067,"Michigan","Ionia County",2,50,925,522,403
050,26,067,"Michigan","Ionia County",2,51,938,537,401
050,26,067,"Michigan","Ionia County",2,52,894,502,392
050,26,067,"Michigan","Ionia County",2,53,883,489,394
050,26,067,"Michigan","Ionia County",2,54,859,472,387
050,26,067,"Michigan","Ionia County",2,55,867,469,398
050,26,067,"Michigan","Ionia County",2,56,911,492,419
050,26,067,"Michigan","Ionia County",2,57,931,499,432
050,26,067,"Michigan","Ionia County",2,58,938,487,451
050,26,067,"Michigan","Ionia County",2,59,941,497,444
050,26,067,"Michigan","Ionia County",2,60,898,486,412
050,26,067,"Michigan","Ionia County",2,61,884,474,410
050,26,067,"Michigan","Ionia County",2,62,868,460,408
050,26,067,"Michigan","Ionia County",2,63,836,425,411
050,26,067,"Michigan","Ionia County",2,64,801,407,394
050,26,067,"Michigan","Ionia County",2,65,770,388,382
050,26,067,"Michigan","Ionia County",2,66,731,360,371
050,26,067,"Michigan","Ionia County",2,67,690,343,347
050,26,067,"Michigan","Ionia County",2,68,657,327,330
050,26,067,"Michigan","Ionia County",2,69,648,330,318
050,26,067,"Michigan","Ionia County",2,70,586,294,292
050,26,067,"Michigan","Ionia County",2,71,565,284,281
050,26,067,"Michigan","Ionia County",2,72,549,269,280
050,26,067,"Michigan","Ionia County",2,73,592,289,303
050,26,067,"Michigan","Ionia County",2,74,404,194,210
050,26,067,"Michigan","Ionia County",2,75,406,193,213
050,26,067,"Michigan","Ionia County",2,76,396,189,207
050,26,067,"Michigan","Ionia County",2,77,374,172,202
050,26,067,"Michigan","Ionia County",2,78,314,150,164
050,26,067,"Michigan","Ionia County",2,79,261,127,134
050,26,067,"Michigan","Ionia County",2,80,253,120,133
050,26,067,"Michigan","Ionia County",2,81,237,106,131
050,26,067,"Michigan","Ionia County",2,82,203,84,119
050,26,067,"Michigan","Ionia County",2,83,176,67,109
050,26,067,"Michigan","Ionia County",2,84,155,63,92
050,26,067,"Michigan","Ionia County",2,85,846,319,527
050,26,067,"Michigan","Ionia County",3,0,624,312,312
050,26,067,"Michigan","Ionia County",3,1,701,369,332
050,26,067,"Michigan","Ionia County",3,2,691,357,334
050,26,067,"Michigan","Ionia County",3,3,723,377,346
050,26,067,"Michigan","Ionia County",3,4,752,388,364
050,26,067,"Michigan","Ionia County",3,5,752,384,368
050,26,067,"Michigan","Ionia County",3,6,791,406,385
050,26,067,"Michigan","Ionia County",3,7,751,388,363
050,26,067,"Michigan","Ionia County",3,8,785,393,392
050,26,067,"Michigan","Ionia County",3,9,758,382,376
050,26,067,"Michigan","Ionia County",3,10,785,394,391
050,26,067,"Michigan","Ionia County",3,11,813,424,389
050,26,067,"Michigan","Ionia County",3,12,828,443,385
050,26,067,"Michigan","Ionia County",3,13,887,465,422
050,26,067,"Michigan","Ionia County",3,14,877,444,433
050,26,067,"Michigan","Ionia County",3,15,854,429,425
050,26,067,"Michigan","Ionia County",3,16,861,440,421
050,26,067,"Michigan","Ionia County",3,17,893,477,416
050,26,067,"Michigan","Ionia County",3,18,815,490,325
050,26,067,"Michigan","Ionia County",3,19,757,487,270
050,26,067,"Michigan","Ionia County",3,20,864,582,282
050,26,067,"Michigan","Ionia County",3,21,929,620,309
050,26,067,"Michigan","Ionia County",3,22,928,608,320
050,26,067,"Michigan","Ionia County",3,23,943,583,360
050,26,067,"Michigan","Ionia County",3,24,1004,621,383
050,26,067,"Michigan","Ionia County",3,25,976,591,385
050,26,067,"Michigan","Ionia County",3,26,1009,609,400
050,26,067,"Michigan","Ionia County",3,27,1020,627,393
050,26,067,"Michigan","Ionia County",3,28,1000,593,407
050,26,067,"Michigan","Ionia County",3,29,1023,641,382
050,26,067,"Michigan","Ionia County",3,30,1015,625,390
050,26,067,"Michigan","Ionia County",3,31,1013,624,389
050,26,067,"Michigan","Ionia County",3,32,938,573,365
050,26,067,"Michigan","Ionia County",3,33,877,521,356
050,26,067,"Michigan","Ionia County",3,34,845,476,369
050,26,067,"Michigan","Ionia County",3,35,887,516,371
050,26,067,"Michigan","Ionia County",3,36,864,507,357
050,26,067,"Michigan","Ionia County",3,37,889,525,364
050,26,067,"Michigan","Ionia County",3,38,935,548,387
050,26,067,"Michigan","Ionia County",3,39,944,557,387
050,26,067,"Michigan","Ionia County",3,40,869,518,351
050,26,067,"Michigan","Ionia County",3,41,913,528,385
050,26,067,"Michigan","Ionia County",3,42,908,556,352
050,26,067,"Michigan","Ionia County",3,43,847,483,364
050,26,067,"Michigan","Ionia County",3,44,882,532,350
050,26,067,"Michigan","Ionia County",3,45,864,503,361
050,26,067,"Michigan","Ionia County",3,46,871,493,378
050,26,067,"Michigan","Ionia County",3,47,833,478,355
050,26,067,"Michigan","Ionia County",3,48,807,458,349
050,26,067,"Michigan","Ionia County",3,49,877,510,367
050,26,067,"Michigan","Ionia County",3,50,926,507,419
050,26,067,"Michigan","Ionia County",3,51,933,535,398
050,26,067,"Michigan","Ionia County",3,52,916,511,405
050,26,067,"Michigan","Ionia County",3,53,897,501,396
050,26,067,"Michigan","Ionia County",3,54,865,471,394
050,26,067,"Michigan","Ionia County",3,55,848,452,396
050,26,067,"Michigan","Ionia County",3,56,885,476,409
050,26,067,"Michigan","Ionia County",3,57,914,490,424
050,26,067,"Michigan","Ionia County",3,58,897,473,424
050,26,067,"Michigan","Ionia County",3,59,930,481,449
050,26,067,"Michigan","Ionia County",3,60,931,494,437
050,26,067,"Michigan","Ionia County",3,61,895,487,408
050,26,067,"Michigan","Ionia County",3,62,856,456,400
050,26,067,"Michigan","Ionia County",3,63,848,438,410
050,26,067,"Michigan","Ionia County",3,64,830,413,417
050,26,067,"Michigan","Ionia County",3,65,799,413,386
050,26,067,"Michigan","Ionia County",3,66,744,370,374
050,26,067,"Michigan","Ionia County",3,67,719,354,365
050,26,067,"Michigan","Ionia County",3,68,676,329,347
050,26,067,"Michigan","Ionia County",3,69,649,331,318
050,26,067,"Michigan","Ionia County",3,70,623,313,310
050,26,067,"Michigan","Ionia County",3,71,560,276,284
050,26,067,"Michigan","Ionia County",3,72,552,274,278
050,26,067,"Michigan","Ionia County",3,73,546,268,278
050,26,067,"Michigan","Ionia County",3,74,580,284,296
050,26,067,"Michigan","Ionia County",3,75,381,177,204
050,26,067,"Michigan","Ionia County",3,76,395,185,210
050,26,067,"Michigan","Ionia County",3,77,375,177,198
050,26,067,"Michigan","Ionia County",3,78,364,162,202
050,26,067,"Michigan","Ionia County",3,79,299,140,159
050,26,067,"Michigan","Ionia County",3,80,251,115,136
050,26,067,"Michigan","Ionia County",3,81,234,115,119
050,26,067,"Michigan","Ionia County",3,82,216,97,119
050,26,067,"Michigan","Ionia County",3,83,187,74,113
050,26,067,"Michigan","Ionia County",3,84,153,61,92
050,26,067,"Michigan","Ionia County",3,85,877,325,552
050,26,067,"Michigan","Ionia County",4,0,666,334,332
050,26,067,"Michigan","Ionia County",4,1,610,311,299
050,26,067,"Michigan","Ionia County",4,2,704,362,342
050,26,067,"Michigan","Ionia County",4,3,682,345,337
050,26,067,"Michigan","Ionia County",4,4,732,381,351
050,26,067,"Michigan","Ionia County",4,5,765,396,369
050,26,067,"Michigan","Ionia County",4,6,779,402,377
050,26,067,"Michigan","Ionia County",4,7,803,421,382
050,26,067,"Michigan","Ionia County",4,8,753,393,360
050,26,067,"Michigan","Ionia County",4,9,782,393,389
050,26,067,"Michigan","Ionia County",4,10,791,399,392
050,26,067,"Michigan","Ionia County",4,11,777,396,381
050,26,067,"Michigan","Ionia County",4,12,819,426,393
050,26,067,"Michigan","Ionia County",4,13,826,439,387
050,26,067,"Michigan","Ionia County",4,14,892,451,441
050,26,067,"Michigan","Ionia County",4,15,883,446,437
050,26,067,"Michigan","Ionia County",4,16,838,417,421
050,26,067,"Michigan","Ionia County",4,17,873,469,404
050,26,067,"Michigan","Ionia County",4,18,830,496,334
050,26,067,"Michigan","Ionia County",4,19,744,485,259
050,26,067,"Michigan","Ionia County",4,20,854,557,297
050,26,067,"Michigan","Ionia County",4,21,893,605,288
050,26,067,"Michigan","Ionia County",4,22,919,615,304
050,26,067,"Michigan","Ionia County",4,23,939,603,336
050,26,067,"Michigan","Ionia County",4,24,962,614,348
050,26,067,"Michigan","Ionia County",4,25,965,603,362
050,26,067,"Michigan","Ionia County",4,26,954,572,382
050,26,067,"Michigan","Ionia County",4,27,1005,610,395
050,26,067,"Michigan","Ionia County",4,28,999,603,396
050,26,067,"Michigan","Ionia County",4,29,1020,622,398
050,26,067,"Michigan","Ionia County",4,30,1007,625,382
050,26,067,"Michigan","Ionia County",4,31,1008,621,387
050,26,067,"Michigan","Ionia County",4,32,1019,614,405
050,26,067,"Michigan","Ionia County",4,33,907,535,372
050,26,067,"Michigan","Ionia County",4,34,842,485,357
050,26,067,"Michigan","Ionia County",4,35,888,522,366
050,26,067,"Michigan","Ionia County",4,36,912,526,386
050,26,067,"Michigan","Ionia County",4,37,878,513,365
050,26,067,"Michigan","Ionia County",4,38,888,518,370
050,26,067,"Michigan","Ionia County",4,39,962,572,390
050,26,067,"Michigan","Ionia County",4,40,908,520,388
050,26,067,"Michigan","Ionia County",4,41,866,521,345
050,26,067,"Michigan","Ionia County",4,42,985,593,392
050,26,067,"Michigan","Ionia County",4,43,847,494,353
050,26,067,"Michigan","Ionia County",4,44,894,525,369
050,26,067,"Michigan","Ionia County",4,45,865,515,350
050,26,067,"Michigan","Ionia County",4,46,875,511,364
050,26,067,"Michigan","Ionia County",4,47,873,488,385
050,26,067,"Michigan","Ionia County",4,48,811,457,354
050,26,067,"Michigan","Ionia County",4,49,814,470,344
050,26,067,"Michigan","Ionia County",4,50,856,491,365
050,26,067,"Michigan","Ionia County",4,51,935,528,407
050,26,067,"Michigan","Ionia County",4,52,902,504,398
050,26,067,"Michigan","Ionia County",4,53,918,511,407
050,26,067,"Michigan","Ionia County",4,54,890,488,402
050,26,067,"Michigan","Ionia County",4,55,825,444,381
050,26,067,"Michigan","Ionia County",4,56,839,447,392
050,26,067,"Michigan","Ionia County",4,57,878,471,407
050,26,067,"Michigan","Ionia County",4,58,884,461,423
050,26,067,"Michigan","Ionia County",4,59,886,467,419
050,26,067,"Michigan","Ionia County",4,60,925,473,452
050,26,067,"Michigan","Ionia County",4,61,915,476,439
050,26,067,"Michigan","Ionia County",4,62,880,483,397
050,26,067,"Michigan","Ionia County",4,63,824,431,393
050,26,067,"Michigan","Ionia County",4,64,830,426,404
050,26,067,"Michigan","Ionia County",4,65,833,422,411
050,26,067,"Michigan","Ionia County",4,66,781,399,382
050,26,067,"Michigan","Ionia County",4,67,728,363,365
050,26,067,"Michigan","Ionia County",4,68,691,334,357
050,26,067,"Michigan","Ionia County",4,69,675,339,336
050,26,067,"Michigan","Ionia County",4,70,635,316,319
050,26,067,"Michigan","Ionia County",4,71,601,296,305
050,26,067,"Michigan","Ionia County",4,72,553,271,282
050,26,067,"Michigan","Ionia County",4,73,544,268,276
050,26,067,"Michigan","Ionia County",4,74,526,258,268
050,26,067,"Michigan","Ionia County",4,75,558,263,295
050,26,067,"Michigan","Ionia County",4,76,378,173,205
050,26,067,"Michigan","Ionia County",4,77,365,169,196
050,26,067,"Michigan","Ionia County",4,78,358,162,196
050,26,067,"Michigan","Ionia County",4,79,342,148,194
050,26,067,"Michigan","Ionia County",4,80,279,120,159
050,26,067,"Michigan","Ionia County",4,81,229,110,119
050,26,067,"Michigan","Ionia County",4,82,212,104,108
050,26,067,"Michigan","Ionia County",4,83,206,91,115
050,26,067,"Michigan","Ionia County",4,84,160,65,95
050,26,067,"Michigan","Ionia County",4,85,887,316,571
050,26,067,"Michigan","Ionia County",5,0,663,333,330
050,26,067,"Michigan","Ionia County",5,1,677,329,348
050,26,067,"Michigan","Ionia County",5,2,603,309,294
050,26,067,"Michigan","Ionia County",5,3,712,369,343
050,26,067,"Michigan","Ionia County",5,4,711,367,344
050,26,067,"Michigan","Ionia County",5,5,712,375,337
050,26,067,"Michigan","Ionia County",5,6,743,379,364
050,26,067,"Michigan","Ionia County",5,7,765,401,364
050,26,067,"Michigan","Ionia County",5,8,794,411,383
050,26,067,"Michigan","Ionia County",5,9,764,389,375
050,26,067,"Michigan","Ionia County",5,10,763,374,389
050,26,067,"Michigan","Ionia County",5,11,787,394,393
050,26,067,"Michigan","Ionia County",5,12,783,390,393
050,26,067,"Michigan","Ionia County",5,13,836,444,392
050,26,067,"Michigan","Ionia County",5,14,827,441,386
050,26,067,"Michigan","Ionia County",5,15,869,443,426
050,26,067,"Michigan","Ionia County",5,16,894,458,436
050,26,067,"Michigan","Ionia County",5,17,850,425,425
050,26,067,"Michigan","Ionia County",5,18,803,474,329
050,26,067,"Michigan","Ionia County",5,19,754,490,264
050,26,067,"Michigan","Ionia County",5,20,828,549,279
050,26,067,"Michigan","Ionia County",5,21,869,549,320
050,26,067,"Michigan","Ionia County",5,22,886,560,326
050,26,067,"Michigan","Ionia County",5,23,931,597,334
050,26,067,"Michigan","Ionia County",5,24,944,587,357
050,26,067,"Michigan","Ionia County",5,25,922,560,362
050,26,067,"Michigan","Ionia County",5,26,932,568,364
050,26,067,"Michigan","Ionia County",5,27,926,571,355
050,26,067,"Michigan","Ionia County",5,28,957,564,393
050,26,067,"Michigan","Ionia County",5,29,1033,625,408
050,26,067,"Michigan","Ionia County",5,30,983,584,399
050,26,067,"Michigan","Ionia County",5,31,993,608,385
050,26,067,"Michigan","Ionia County",5,32,988,589,399
050,26,067,"Michigan","Ionia County",5,33,989,573,416
050,26,067,"Michigan","Ionia County",5,34,856,486,370
050,26,067,"Michigan","Ionia County",5,35,860,504,356
050,26,067,"Michigan","Ionia County",5,36,889,508,381
050,26,067,"Michigan","Ionia County",5,37,897,515,382
050,26,067,"Michigan","Ionia County",5,38,889,513,376
050,26,067,"Michigan","Ionia County",5,39,878,515,363
050,26,067,"Michigan","Ionia County",5,40,906,520,386
050,26,067,"Michigan","Ionia County",5,41,890,498,392
050,26,067,"Michigan","Ionia County",5,42,910,558,352
050,26,067,"Michigan","Ionia County",5,43,893,507,386
050,26,067,"Michigan","Ionia County",5,44,875,527,348
050,26,067,"Michigan","Ionia County",5,45,867,496,371
050,26,067,"Michigan","Ionia County",5,46,842,496,346
050,26,067,"Michigan","Ionia County",5,47,837,481,356
050,26,067,"Michigan","Ionia County",5,48,841,452,389
050,26,067,"Michigan","Ionia County",5,49,804,460,344
050,26,067,"Michigan","Ionia County",5,50,791,437,354
050,26,067,"Michigan","Ionia County",5,51,865,498,367
050,26,067,"Michigan","Ionia County",5,52,909,495,414
050,26,067,"Michigan","Ionia County",5,53,884,492,392
050,26,067,"Michigan","Ionia County",5,54,892,483,409
050,26,067,"Michigan","Ionia County",5,55,865,466,399
050,26,067,"Michigan","Ionia County",5,56,815,444,371
050,26,067,"Michigan","Ionia County",5,57,848,459,389
050,26,067,"Michigan","Ionia County",5,58,834,435,399
050,26,067,"Michigan","Ionia County",5,59,862,447,415
050,26,067,"Michigan","Ionia County",5,60,898,476,422
050,26,067,"Michigan","Ionia County",5,61,904,456,448
050,26,067,"Michigan","Ionia County",5,62,907,471,436
050,26,067,"Michigan","Ionia County",5,63,858,466,392
050,26,067,"Michigan","Ionia County",5,64,819,424,395
050,26,067,"Michigan","Ionia County",5,65,821,422,399
050,26,067,"Michigan","Ionia County",5,66,820,409,411
050,26,067,"Michigan","Ionia County",5,67,762,390,372
050,26,067,"Michigan","Ionia County",5,68,714,349,365
050,26,067,"Michigan","Ionia County",5,69,679,338,341
050,26,067,"Michigan","Ionia County",5,70,665,329,336
050,26,067,"Michigan","Ionia County",5,71,618,300,318
050,26,067,"Michigan","Ionia County",5,72,587,284,303
050,26,067,"Michigan","Ionia County",5,73,534,268,266
050,26,067,"Michigan","Ionia County",5,74,515,253,262
050,26,067,"Michigan","Ionia County",5,75,503,242,261
050,26,067,"Michigan","Ionia County",5,76,544,253,291
050,26,067,"Michigan","Ionia County",5,77,350,156,194
050,26,067,"Michigan","Ionia County",5,78,346,158,188
050,26,067,"Michigan","Ionia County",5,79,342,152,190
050,26,067,"Michigan","Ionia County",5,80,327,127,200
050,26,067,"Michigan","Ionia County",5,81,258,115,143
050,26,067,"Michigan","Ionia County",5,82,209,99,110
050,26,067,"Michigan","Ionia County",5,83,205,98,107
050,26,067,"Michigan","Ionia County",5,84,177,81,96
050,26,067,"Michigan","Ionia County",5,85,910,324,586
050,26,069,"Michigan","Iosco County",1,0,252,129,123
050,26,069,"Michigan","Iosco County",1,1,235,126,109
050,26,069,"Michigan","Iosco County",1,2,232,128,104
050,26,069,"Michigan","Iosco County",1,3,243,125,118
050,26,069,"Michigan","Iosco County",1,4,227,115,112
050,26,069,"Michigan","Iosco County",1,5,259,123,136
050,26,069,"Michigan","Iosco County",1,6,242,121,121
050,26,069,"Michigan","Iosco County",1,7,252,124,128
050,26,069,"Michigan","Iosco County",1,8,230,114,116
050,26,069,"Michigan","Iosco County",1,9,224,119,105
050,26,069,"Michigan","Iosco County",1,10,222,117,105
050,26,069,"Michigan","Iosco County",1,11,217,106,111
050,26,069,"Michigan","Iosco County",1,12,237,117,120
050,26,069,"Michigan","Iosco County",1,13,240,121,119
050,26,069,"Michigan","Iosco County",1,14,253,126,127
050,26,069,"Michigan","Iosco County",1,15,243,125,118
050,26,069,"Michigan","Iosco County",1,16,247,123,124
050,26,069,"Michigan","Iosco County",1,17,238,123,115
050,26,069,"Michigan","Iosco County",1,18,210,112,98
050,26,069,"Michigan","Iosco County",1,19,183,96,87
050,26,069,"Michigan","Iosco County",1,20,187,93,94
050,26,069,"Michigan","Iosco County",1,21,205,103,102
050,26,069,"Michigan","Iosco County",1,22,213,121,92
050,26,069,"Michigan","Iosco County",1,23,238,118,120
050,26,069,"Michigan","Iosco County",1,24,204,106,98
050,26,069,"Michigan","Iosco County",1,25,221,111,110
050,26,069,"Michigan","Iosco County",1,26,247,135,112
050,26,069,"Michigan","Iosco County",1,27,238,117,121
050,26,069,"Michigan","Iosco County",1,28,249,133,116
050,26,069,"Michigan","Iosco County",1,29,252,131,121
050,26,069,"Michigan","Iosco County",1,30,243,125,118
050,26,069,"Michigan","Iosco County",1,31,228,116,112
050,26,069,"Michigan","Iosco County",1,32,218,108,110
050,26,069,"Michigan","Iosco County",1,33,215,110,105
050,26,069,"Michigan","Iosco County",1,34,223,113,110
050,26,069,"Michigan","Iosco County",1,35,238,119,119
050,26,069,"Michigan","Iosco County",1,36,249,136,113
050,26,069,"Michigan","Iosco County",1,37,244,133,111
050,26,069,"Michigan","Iosco County",1,38,225,114,111
050,26,069,"Michigan","Iosco County",1,39,222,105,117
050,26,069,"Michigan","Iosco County",1,40,231,115,116
050,26,069,"Michigan","Iosco County",1,41,244,126,118
050,26,069,"Michigan","Iosco County",1,42,237,112,125
050,26,069,"Michigan","Iosco County",1,43,228,119,109
050,26,069,"Michigan","Iosco County",1,44,217,109,108
050,26,069,"Michigan","Iosco County",1,45,212,110,102
050,26,069,"Michigan","Iosco County",1,46,218,114,104
050,26,069,"Michigan","Iosco County",1,47,220,105,115
050,26,069,"Michigan","Iosco County",1,48,238,118,120
050,26,069,"Michigan","Iosco County",1,49,300,153,147
050,26,069,"Michigan","Iosco County",1,50,300,153,147
050,26,069,"Michigan","Iosco County",1,51,308,162,146
050,26,069,"Michigan","Iosco County",1,52,301,163,138
050,26,069,"Michigan","Iosco County",1,53,298,156,142
050,26,069,"Michigan","Iosco County",1,54,333,167,166
050,26,069,"Michigan","Iosco County",1,55,372,179,193
050,26,069,"Michigan","Iosco County",1,56,378,184,194
050,26,069,"Michigan","Iosco County",1,57,413,196,217
050,26,069,"Michigan","Iosco County",1,58,430,205,225
050,26,069,"Michigan","Iosco County",1,59,464,227,237
050,26,069,"Michigan","Iosco County",1,60,464,217,247
050,26,069,"Michigan","Iosco County",1,61,500,244,256
050,26,069,"Michigan","Iosco County",1,62,550,296,254
050,26,069,"Michigan","Iosco County",1,63,490,252,238
050,26,069,"Michigan","Iosco County",1,64,491,255,236
050,26,069,"Michigan","Iosco County",1,65,496,256,240
050,26,069,"Michigan","Iosco County",1,66,509,243,266
050,26,069,"Michigan","Iosco County",1,67,507,260,247
050,26,069,"Michigan","Iosco County",1,68,483,260,223
050,26,069,"Michigan","Iosco County",1,69,433,224,209
050,26,069,"Michigan","Iosco County",1,70,448,215,233
050,26,069,"Michigan","Iosco County",1,71,422,210,212
050,26,069,"Michigan","Iosco County",1,72,409,208,201
050,26,069,"Michigan","Iosco County",1,73,433,212,221
050,26,069,"Michigan","Iosco County",1,74,298,144,154
050,26,069,"Michigan","Iosco County",1,75,309,158,151
050,26,069,"Michigan","Iosco County",1,76,316,157,159
050,26,069,"Michigan","Iosco County",1,77,318,156,162
050,26,069,"Michigan","Iosco County",1,78,280,134,146
050,26,069,"Michigan","Iosco County",1,79,236,115,121
050,26,069,"Michigan","Iosco County",1,80,209,102,107
050,26,069,"Michigan","Iosco County",1,81,194,90,104
050,26,069,"Michigan","Iosco County",1,82,182,86,96
050,26,069,"Michigan","Iosco County",1,83,165,85,80
050,26,069,"Michigan","Iosco County",1,84,151,62,89
050,26,069,"Michigan","Iosco County",1,85,747,289,458
050,26,069,"Michigan","Iosco County",2,0,237,128,109
050,26,069,"Michigan","Iosco County",2,1,238,126,112
050,26,069,"Michigan","Iosco County",2,2,233,127,106
050,26,069,"Michigan","Iosco County",2,3,239,124,115
050,26,069,"Michigan","Iosco County",2,4,232,118,114
050,26,069,"Michigan","Iosco County",2,5,250,120,130
050,26,069,"Michigan","Iosco County",2,6,245,122,123
050,26,069,"Michigan","Iosco County",2,7,248,124,124
050,26,069,"Michigan","Iosco County",2,8,235,114,121
050,26,069,"Michigan","Iosco County",2,9,223,118,105
050,26,069,"Michigan","Iosco County",2,10,222,118,104
050,26,069,"Michigan","Iosco County",2,11,217,109,108
050,26,069,"Michigan","Iosco County",2,12,235,116,119
050,26,069,"Michigan","Iosco County",2,13,241,120,121
050,26,069,"Michigan","Iosco County",2,14,249,125,124
050,26,069,"Michigan","Iosco County",2,15,246,126,120
050,26,069,"Michigan","Iosco County",2,16,244,123,121
050,26,069,"Michigan","Iosco County",2,17,240,123,117
050,26,069,"Michigan","Iosco County",2,18,205,110,95
050,26,069,"Michigan","Iosco County",2,19,179,94,85
050,26,069,"Michigan","Iosco County",2,20,192,97,95
050,26,069,"Michigan","Iosco County",2,21,206,104,102
050,26,069,"Michigan","Iosco County",2,22,214,118,96
050,26,069,"Michigan","Iosco County",2,23,234,120,114
050,26,069,"Michigan","Iosco County",2,24,209,108,101
050,26,069,"Michigan","Iosco County",2,25,218,111,107
050,26,069,"Michigan","Iosco County",2,26,241,130,111
050,26,069,"Michigan","Iosco County",2,27,240,123,117
050,26,069,"Michigan","Iosco County",2,28,248,131,117
050,26,069,"Michigan","Iosco County",2,29,250,131,119
050,26,069,"Michigan","Iosco County",2,30,251,129,122
050,26,069,"Michigan","Iosco County",2,31,232,119,113
050,26,069,"Michigan","Iosco County",2,32,219,108,111
050,26,069,"Michigan","Iosco County",2,33,215,110,105
050,26,069,"Michigan","Iosco County",2,34,219,111,108
050,26,069,"Michigan","Iosco County",2,35,234,117,117
050,26,069,"Michigan","Iosco County",2,36,245,131,114
050,26,069,"Michigan","Iosco County",2,37,246,134,112
050,26,069,"Michigan","Iosco County",2,38,228,117,111
050,26,069,"Michigan","Iosco County",2,39,221,107,114
050,26,069,"Michigan","Iosco County",2,40,230,113,117
050,26,069,"Michigan","Iosco County",2,41,240,124,116
050,26,069,"Michigan","Iosco County",2,42,234,115,119
050,26,069,"Michigan","Iosco County",2,43,231,119,112
050,26,069,"Michigan","Iosco County",2,44,220,113,107
050,26,069,"Michigan","Iosco County",2,45,213,110,103
050,26,069,"Michigan","Iosco County",2,46,216,114,102
050,26,069,"Michigan","Iosco County",2,47,219,105,114
050,26,069,"Michigan","Iosco County",2,48,234,115,119
050,26,069,"Michigan","Iosco County",2,49,286,146,140
050,26,069,"Michigan","Iosco County",2,50,301,154,147
050,26,069,"Michigan","Iosco County",2,51,306,160,146
050,26,069,"Michigan","Iosco County",2,52,301,161,140
050,26,069,"Michigan","Iosco County",2,53,298,157,141
050,26,069,"Michigan","Iosco County",2,54,323,163,160
050,26,069,"Michigan","Iosco County",2,55,365,179,186
050,26,069,"Michigan","Iosco County",2,56,379,184,195
050,26,069,"Michigan","Iosco County",2,57,405,193,212
050,26,069,"Michigan","Iosco County",2,58,430,204,226
050,26,069,"Michigan","Iosco County",2,59,458,221,237
050,26,069,"Michigan","Iosco County",2,60,464,220,244
050,26,069,"Michigan","Iosco County",2,61,493,238,255
050,26,069,"Michigan","Iosco County",2,62,538,284,254
050,26,069,"Michigan","Iosco County",2,63,514,268,246
050,26,069,"Michigan","Iosco County",2,64,490,254,236
050,26,069,"Michigan","Iosco County",2,65,497,257,240
050,26,069,"Michigan","Iosco County",2,66,511,249,262
050,26,069,"Michigan","Iosco County",2,67,508,256,252
050,26,069,"Michigan","Iosco County",2,68,488,259,229
050,26,069,"Michigan","Iosco County",2,69,450,237,213
050,26,069,"Michigan","Iosco County",2,70,438,213,225
050,26,069,"Michigan","Iosco County",2,71,427,211,216
050,26,069,"Michigan","Iosco County",2,72,404,204,200
050,26,069,"Michigan","Iosco County",2,73,445,218,227
050,26,069,"Michigan","Iosco County",2,74,306,148,158
050,26,069,"Michigan","Iosco County",2,75,304,153,151
050,26,069,"Michigan","Iosco County",2,76,309,155,154
050,26,069,"Michigan","Iosco County",2,77,322,160,162
050,26,069,"Michigan","Iosco County",2,78,281,135,146
050,26,069,"Michigan","Iosco County",2,79,244,119,125
050,26,069,"Michigan","Iosco County",2,80,212,102,110
050,26,069,"Michigan","Iosco County",2,81,187,91,96
050,26,069,"Michigan","Iosco County",2,82,180,86,94
050,26,069,"Michigan","Iosco County",2,83,165,85,80
050,26,069,"Michigan","Iosco County",2,84,155,68,87
050,26,069,"Michigan","Iosco County",2,85,743,284,459
050,26,069,"Michigan","Iosco County",3,0,198,101,97
050,26,069,"Michigan","Iosco County",3,1,229,124,105
050,26,069,"Michigan","Iosco County",3,2,243,124,119
050,26,069,"Michigan","Iosco County",3,3,252,144,108
050,26,069,"Michigan","Iosco County",3,4,244,126,118
050,26,069,"Michigan","Iosco County",3,5,242,122,120
050,26,069,"Michigan","Iosco County",3,6,255,126,129
050,26,069,"Michigan","Iosco County",3,7,250,123,127
050,26,069,"Michigan","Iosco County",3,8,246,120,126
050,26,069,"Michigan","Iosco County",3,9,232,112,120
050,26,069,"Michigan","Iosco County",3,10,219,113,106
050,26,069,"Michigan","Iosco County",3,11,219,118,101
050,26,069,"Michigan","Iosco County",3,12,227,111,116
050,26,069,"Michigan","Iosco County",3,13,236,117,119
050,26,069,"Michigan","Iosco County",3,14,254,127,127
050,26,069,"Michigan","Iosco County",3,15,257,127,130
050,26,069,"Michigan","Iosco County",3,16,250,129,121
050,26,069,"Michigan","Iosco County",3,17,256,124,132
050,26,069,"Michigan","Iosco County",3,18,205,111,94
050,26,069,"Michigan","Iosco County",3,19,161,87,74
050,26,069,"Michigan","Iosco County",3,20,188,100,88
050,26,069,"Michigan","Iosco County",3,21,186,96,90
050,26,069,"Michigan","Iosco County",3,22,217,110,107
050,26,069,"Michigan","Iosco County",3,23,231,125,106
050,26,069,"Michigan","Iosco County",3,24,246,132,114
050,26,069,"Michigan","Iosco County",3,25,218,117,101
050,26,069,"Michigan","Iosco County",3,26,237,114,123
050,26,069,"Michigan","Iosco County",3,27,240,129,111
050,26,069,"Michigan","Iosco County",3,28,235,125,110
050,26,069,"Michigan","Iosco County",3,29,257,138,119
050,26,069,"Michigan","Iosco County",3,30,252,127,125
050,26,069,"Michigan","Iosco County",3,31,262,140,122
050,26,069,"Michigan","Iosco County",3,32,228,113,115
050,26,069,"Michigan","Iosco County",3,33,211,106,105
050,26,069,"Michigan","Iosco County",3,34,231,122,109
050,26,069,"Michigan","Iosco County",3,35,223,112,111
050,26,069,"Michigan","Iosco County",3,36,230,115,115
050,26,069,"Michigan","Iosco County",3,37,251,132,119
050,26,069,"Michigan","Iosco County",3,38,248,132,116
050,26,069,"Michigan","Iosco County",3,39,236,121,115
050,26,069,"Michigan","Iosco County",3,40,233,116,117
050,26,069,"Michigan","Iosco County",3,41,243,123,120
050,26,069,"Michigan","Iosco County",3,42,250,126,124
050,26,069,"Michigan","Iosco County",3,43,238,110,128
050,26,069,"Michigan","Iosco County",3,44,242,126,116
050,26,069,"Michigan","Iosco County",3,45,213,110,103
050,26,069,"Michigan","Iosco County",3,46,219,114,105
050,26,069,"Michigan","Iosco County",3,47,215,115,100
050,26,069,"Michigan","Iosco County",3,48,216,104,112
050,26,069,"Michigan","Iosco County",3,49,230,112,118
050,26,069,"Michigan","Iosco County",3,50,298,151,147
050,26,069,"Michigan","Iosco County",3,51,316,165,151
050,26,069,"Michigan","Iosco County",3,52,319,166,153
050,26,069,"Michigan","Iosco County",3,53,313,163,150
050,26,069,"Michigan","Iosco County",3,54,302,157,145
050,26,069,"Michigan","Iosco County",3,55,343,165,178
050,26,069,"Michigan","Iosco County",3,56,369,184,185
050,26,069,"Michigan","Iosco County",3,57,387,191,196
050,26,069,"Michigan","Iosco County",3,58,429,206,223
050,26,069,"Michigan","Iosco County",3,59,433,206,227
050,26,069,"Michigan","Iosco County",3,60,478,226,252
050,26,069,"Michigan","Iosco County",3,61,500,233,267
050,26,069,"Michigan","Iosco County",3,62,531,271,260
050,26,069,"Michigan","Iosco County",3,63,567,303,264
050,26,069,"Michigan","Iosco County",3,64,506,264,242
050,26,069,"Michigan","Iosco County",3,65,503,258,245
050,26,069,"Michigan","Iosco County",3,66,509,269,240
050,26,069,"Michigan","Iosco County",3,67,507,251,256
050,26,069,"Michigan","Iosco County",3,68,503,256,247
050,26,069,"Michigan","Iosco County",3,69,480,253,227
050,26,069,"Michigan","Iosco County",3,70,434,225,209
050,26,069,"Michigan","Iosco County",3,71,430,208,222
050,26,069,"Michigan","Iosco County",3,72,410,199,211
050,26,069,"Michigan","Iosco County",3,73,386,196,190
050,26,069,"Michigan","Iosco County",3,74,421,212,209
050,26,069,"Michigan","Iosco County",3,75,296,147,149
050,26,069,"Michigan","Iosco County",3,76,283,138,145
050,26,069,"Michigan","Iosco County",3,77,294,146,148
050,26,069,"Michigan","Iosco County",3,78,301,141,160
050,26,069,"Michigan","Iosco County",3,79,254,127,127
050,26,069,"Michigan","Iosco County",3,80,237,106,131
050,26,069,"Michigan","Iosco County",3,81,182,89,93
050,26,069,"Michigan","Iosco County",3,82,178,88,90
050,26,069,"Michigan","Iosco County",3,83,159,80,79
050,26,069,"Michigan","Iosco County",3,84,158,79,79
050,26,069,"Michigan","Iosco County",3,85,733,276,457
050,26,069,"Michigan","Iosco County",4,0,214,100,114
050,26,069,"Michigan","Iosco County",4,1,192,98,94
050,26,069,"Michigan","Iosco County",4,2,227,120,107
050,26,069,"Michigan","Iosco County",4,3,234,122,112
050,26,069,"Michigan","Iosco County",4,4,263,146,117
050,26,069,"Michigan","Iosco County",4,5,244,121,123
050,26,069,"Michigan","Iosco County",4,6,255,126,129
050,26,069,"Michigan","Iosco County",4,7,257,128,129
050,26,069,"Michigan","Iosco County",4,8,245,120,125
050,26,069,"Michigan","Iosco County",4,9,251,119,132
050,26,069,"Michigan","Iosco County",4,10,235,117,118
050,26,069,"Michigan","Iosco County",4,11,215,111,104
050,26,069,"Michigan","Iosco County",4,12,234,131,103
050,26,069,"Michigan","Iosco County",4,13,230,112,118
050,26,069,"Michigan","Iosco County",4,14,252,120,132
050,26,069,"Michigan","Iosco County",4,15,258,128,130
050,26,069,"Michigan","Iosco County",4,16,274,137,137
050,26,069,"Michigan","Iosco County",4,17,254,133,121
050,26,069,"Michigan","Iosco County",4,18,208,103,105
050,26,069,"Michigan","Iosco County",4,19,157,86,71
050,26,069,"Michigan","Iosco County",4,20,165,94,71
050,26,069,"Michigan","Iosco County",4,21,187,94,93
050,26,069,"Michigan","Iosco County",4,22,207,112,95
050,26,069,"Michigan","Iosco County",4,23,247,130,117
050,26,069,"Michigan","Iosco County",4,24,226,126,100
050,26,069,"Michigan","Iosco County",4,25,237,120,117
050,26,069,"Michigan","Iosco County",4,26,221,117,104
050,26,069,"Michigan","Iosco County",4,27,228,108,120
050,26,069,"Michigan","Iosco County",4,28,239,128,111
050,26,069,"Michigan","Iosco County",4,29,237,128,109
050,26,069,"Michigan","Iosco County",4,30,261,135,126
050,26,069,"Michigan","Iosco County",4,31,249,124,125
050,26,069,"Michigan","Iosco County",4,32,267,132,135
050,26,069,"Michigan","Iosco County",4,33,230,111,119
050,26,069,"Michigan","Iosco County",4,34,217,114,103
050,26,069,"Michigan","Iosco County",4,35,251,132,119
050,26,069,"Michigan","Iosco County",4,36,212,108,104
050,26,069,"Michigan","Iosco County",4,37,242,120,122
050,26,069,"Michigan","Iosco County",4,38,255,131,124
050,26,069,"Michigan","Iosco County",4,39,239,126,113
050,26,069,"Michigan","Iosco County",4,40,240,122,118
050,26,069,"Michigan","Iosco County",4,41,236,124,112
050,26,069,"Michigan","Iosco County",4,42,251,126,125
050,26,069,"Michigan","Iosco County",4,43,259,134,125
050,26,069,"Michigan","Iosco County",4,44,233,109,124
050,26,069,"Michigan","Iosco County",4,45,253,130,123
050,26,069,"Michigan","Iosco County",4,46,223,114,109
050,26,069,"Michigan","Iosco County",4,47,227,116,111
050,26,069,"Michigan","Iosco County",4,48,217,116,101
050,26,069,"Michigan","Iosco County",4,49,227,114,113
050,26,069,"Michigan","Iosco County",4,50,241,119,122
050,26,069,"Michigan","Iosco County",4,51,308,158,150
050,26,069,"Michigan","Iosco County",4,52,327,169,158
050,26,069,"Michigan","Iosco County",4,53,330,165,165
050,26,069,"Michigan","Iosco County",4,54,322,174,148
050,26,069,"Michigan","Iosco County",4,55,304,160,144
050,26,069,"Michigan","Iosco County",4,56,352,162,190
050,26,069,"Michigan","Iosco County",4,57,382,189,193
050,26,069,"Michigan","Iosco County",4,58,405,197,208
050,26,069,"Michigan","Iosco County",4,59,433,206,227
050,26,069,"Michigan","Iosco County",4,60,440,209,231
050,26,069,"Michigan","Iosco County",4,61,507,239,268
050,26,069,"Michigan","Iosco County",4,62,528,251,277
050,26,069,"Michigan","Iosco County",4,63,538,277,261
050,26,069,"Michigan","Iosco County",4,64,584,315,269
050,26,069,"Michigan","Iosco County",4,65,524,265,259
050,26,069,"Michigan","Iosco County",4,66,504,262,242
050,26,069,"Michigan","Iosco County",4,67,504,271,233
050,26,069,"Michigan","Iosco County",4,68,497,245,252
050,26,069,"Michigan","Iosco County",4,69,505,252,253
050,26,069,"Michigan","Iosco County",4,70,468,243,225
050,26,069,"Michigan","Iosco County",4,71,425,222,203
050,26,069,"Michigan","Iosco County",4,72,418,197,221
050,26,069,"Michigan","Iosco County",4,73,405,195,210
050,26,069,"Michigan","Iosco County",4,74,368,185,183
050,26,069,"Michigan","Iosco County",4,75,414,206,208
050,26,069,"Michigan","Iosco County",4,76,267,130,137
050,26,069,"Michigan","Iosco County",4,77,270,132,138
050,26,069,"Michigan","Iosco County",4,78,280,134,146
050,26,069,"Michigan","Iosco County",4,79,278,131,147
050,26,069,"Michigan","Iosco County",4,80,242,115,127
050,26,069,"Michigan","Iosco County",4,81,202,91,111
050,26,069,"Michigan","Iosco County",4,82,173,85,88
050,26,069,"Michigan","Iosco County",4,83,158,84,74
050,26,069,"Michigan","Iosco County",4,84,163,74,89
050,26,069,"Michigan","Iosco County",4,85,725,281,444
050,26,069,"Michigan","Iosco County",5,0,199,96,103
050,26,069,"Michigan","Iosco County",5,1,211,88,123
050,26,069,"Michigan","Iosco County",5,2,194,95,99
050,26,069,"Michigan","Iosco County",5,3,232,129,103
050,26,069,"Michigan","Iosco County",5,4,229,116,113
050,26,069,"Michigan","Iosco County",5,5,271,155,116
050,26,069,"Michigan","Iosco County",5,6,245,119,126
050,26,069,"Michigan","Iosco County",5,7,247,119,128
050,26,069,"Michigan","Iosco County",5,8,261,130,131
050,26,069,"Michigan","Iosco County",5,9,249,119,130
050,26,069,"Michigan","Iosco County",5,10,248,121,127
050,26,069,"Michigan","Iosco County",5,11,245,122,123
050,26,069,"Michigan","Iosco County",5,12,228,120,108
050,26,069,"Michigan","Iosco County",5,13,230,129,101
050,26,069,"Michigan","Iosco County",5,14,238,114,124
050,26,069,"Michigan","Iosco County",5,15,252,125,127
050,26,069,"Michigan","Iosco County",5,16,261,129,132
050,26,069,"Michigan","Iosco County",5,17,282,142,140
050,26,069,"Michigan","Iosco County",5,18,220,121,99
050,26,069,"Michigan","Iosco County",5,19,160,81,79
050,26,069,"Michigan","Iosco County",5,20,173,95,78
050,26,069,"Michigan","Iosco County",5,21,176,100,76
050,26,069,"Michigan","Iosco County",5,22,192,100,92
050,26,069,"Michigan","Iosco County",5,23,220,119,101
050,26,069,"Michigan","Iosco County",5,24,235,125,110
050,26,069,"Michigan","Iosco County",5,25,222,127,95
050,26,069,"Michigan","Iosco County",5,26,241,126,115
050,26,069,"Michigan","Iosco County",5,27,206,100,106
050,26,069,"Michigan","Iosco County",5,28,237,111,126
050,26,069,"Michigan","Iosco County",5,29,238,123,115
050,26,069,"Michigan","Iosco County",5,30,221,121,100
050,26,069,"Michigan","Iosco County",5,31,251,136,115
050,26,069,"Michigan","Iosco County",5,32,260,131,129
050,26,069,"Michigan","Iosco County",5,33,257,125,132
050,26,069,"Michigan","Iosco County",5,34,235,118,117
050,26,069,"Michigan","Iosco County",5,35,228,117,111
050,26,069,"Michigan","Iosco County",5,36,250,124,126
050,26,069,"Michigan","Iosco County",5,37,220,112,108
050,26,069,"Michigan","Iosco County",5,38,245,121,124
050,26,069,"Michigan","Iosco County",5,39,260,135,125
050,26,069,"Michigan","Iosco County",5,40,240,130,110
050,26,069,"Michigan","Iosco County",5,41,253,133,120
050,26,069,"Michigan","Iosco County",5,42,237,127,110
050,26,069,"Michigan","Iosco County",5,43,247,119,128
050,26,069,"Michigan","Iosco County",5,44,270,143,127
050,26,069,"Michigan","Iosco County",5,45,235,114,121
050,26,069,"Michigan","Iosco County",5,46,261,138,123
050,26,069,"Michigan","Iosco County",5,47,217,111,106
050,26,069,"Michigan","Iosco County",5,48,220,114,106
050,26,069,"Michigan","Iosco County",5,49,215,113,102
050,26,069,"Michigan","Iosco County",5,50,236,120,116
050,26,069,"Michigan","Iosco County",5,51,242,119,123
050,26,069,"Michigan","Iosco County",5,52,298,156,142
050,26,069,"Michigan","Iosco County",5,53,324,165,159
050,26,069,"Michigan","Iosco County",5,54,350,174,176
050,26,069,"Michigan","Iosco County",5,55,319,170,149
050,26,069,"Michigan","Iosco County",5,56,307,158,149
050,26,069,"Michigan","Iosco County",5,57,344,169,175
050,26,069,"Michigan","Iosco County",5,58,394,193,201
050,26,069,"Michigan","Iosco County",5,59,406,194,212
050,26,069,"Michigan","Iosco County",5,60,447,211,236
050,26,069,"Michigan","Iosco County",5,61,448,211,237
050,26,069,"Michigan","Iosco County",5,62,526,253,273
050,26,069,"Michigan","Iosco County",5,63,546,258,288
050,26,069,"Michigan","Iosco County",5,64,540,278,262
050,26,069,"Michigan","Iosco County",5,65,592,316,276
050,26,069,"Michigan","Iosco County",5,66,522,269,253
050,26,069,"Michigan","Iosco County",5,67,500,263,237
050,26,069,"Michigan","Iosco County",5,68,502,270,232
050,26,069,"Michigan","Iosco County",5,69,499,248,251
050,26,069,"Michigan","Iosco County",5,70,496,243,253
050,26,069,"Michigan","Iosco County",5,71,464,244,220
050,26,069,"Michigan","Iosco County",5,72,414,210,204
050,26,069,"Michigan","Iosco County",5,73,394,188,206
050,26,069,"Michigan","Iosco County",5,74,390,189,201
050,26,069,"Michigan","Iosco County",5,75,358,180,178
050,26,069,"Michigan","Iosco County",5,76,391,189,202
050,26,069,"Michigan","Iosco County",5,77,252,122,130
050,26,069,"Michigan","Iosco County",5,78,254,121,133
050,26,069,"Michigan","Iosco County",5,79,258,126,132
050,26,069,"Michigan","Iosco County",5,80,263,119,144
050,26,069,"Michigan","Iosco County",5,81,209,101,108
050,26,069,"Michigan","Iosco County",5,82,190,84,106
050,26,069,"Michigan","Iosco County",5,83,154,75,79
050,26,069,"Michigan","Iosco County",5,84,147,73,74
050,26,069,"Michigan","Iosco County",5,85,733,292,441
050,26,071,"Michigan","Iron County",1,0,83,41,42
050,26,071,"Michigan","Iron County",1,1,93,41,52
050,26,071,"Michigan","Iron County",1,2,112,40,72
050,26,071,"Michigan","Iron County",1,3,99,44,55
050,26,071,"Michigan","Iron County",1,4,105,54,51
050,26,071,"Michigan","Iron County",1,5,107,51,56
050,26,071,"Michigan","Iron County",1,6,118,57,61
050,26,071,"Michigan","Iron County",1,7,118,67,51
050,26,071,"Michigan","Iron County",1,8,110,53,57
050,26,071,"Michigan","Iron County",1,9,107,46,61
050,26,071,"Michigan","Iron County",1,10,125,57,68
050,26,071,"Michigan","Iron County",1,11,126,61,65
050,26,071,"Michigan","Iron County",1,12,119,56,63
050,26,071,"Michigan","Iron County",1,13,115,61,54
050,26,071,"Michigan","Iron County",1,14,114,57,57
050,26,071,"Michigan","Iron County",1,15,130,67,63
050,26,071,"Michigan","Iron County",1,16,109,59,50
050,26,071,"Michigan","Iron County",1,17,112,62,50
050,26,071,"Michigan","Iron County",1,18,109,57,52
050,26,071,"Michigan","Iron County",1,19,85,45,40
050,26,071,"Michigan","Iron County",1,20,85,42,43
050,26,071,"Michigan","Iron County",1,21,84,39,45
050,26,071,"Michigan","Iron County",1,22,84,41,43
050,26,071,"Michigan","Iron County",1,23,96,50,46
050,26,071,"Michigan","Iron County",1,24,81,36,45
050,26,071,"Michigan","Iron County",1,25,78,32,46
050,26,071,"Michigan","Iron County",1,26,102,60,42
050,26,071,"Michigan","Iron County",1,27,97,61,36
050,26,071,"Michigan","Iron County",1,28,82,42,40
050,26,071,"Michigan","Iron County",1,29,112,55,57
050,26,071,"Michigan","Iron County",1,30,95,47,48
050,26,071,"Michigan","Iron County",1,31,100,52,48
050,26,071,"Michigan","Iron County",1,32,99,48,51
050,26,071,"Michigan","Iron County",1,33,86,47,39
050,26,071,"Michigan","Iron County",1,34,87,40,47
050,26,071,"Michigan","Iron County",1,35,106,46,60
050,26,071,"Michigan","Iron County",1,36,115,52,63
050,26,071,"Michigan","Iron County",1,37,119,57,62
050,26,071,"Michigan","Iron County",1,38,131,67,64
050,26,071,"Michigan","Iron County",1,39,111,58,53
050,26,071,"Michigan","Iron County",1,40,109,60,49
050,26,071,"Michigan","Iron County",1,41,113,55,58
050,26,071,"Michigan","Iron County",1,42,112,56,56
050,26,071,"Michigan","Iron County",1,43,127,68,59
050,26,071,"Michigan","Iron County",1,44,110,62,48
050,26,071,"Michigan","Iron County",1,45,111,63,48
050,26,071,"Michigan","Iron County",1,46,102,53,49
050,26,071,"Michigan","Iron County",1,47,111,60,51
050,26,071,"Michigan","Iron County",1,48,100,49,51
050,26,071,"Michigan","Iron County",1,49,133,67,66
050,26,071,"Michigan","Iron County",1,50,118,64,54
050,26,071,"Michigan","Iron County",1,51,119,68,51
050,26,071,"Michigan","Iron County",1,52,125,70,55
050,26,071,"Michigan","Iron County",1,53,148,76,72
050,26,071,"Michigan","Iron County",1,54,139,69,70
050,26,071,"Michigan","Iron County",1,55,169,78,91
050,26,071,"Michigan","Iron County",1,56,183,89,94
050,26,071,"Michigan","Iron County",1,57,209,107,102
050,26,071,"Michigan","Iron County",1,58,218,112,106
050,26,071,"Michigan","Iron County",1,59,207,105,102
050,26,071,"Michigan","Iron County",1,60,209,96,113
050,26,071,"Michigan","Iron County",1,61,229,109,120
050,26,071,"Michigan","Iron County",1,62,232,116,116
050,26,071,"Michigan","Iron County",1,63,257,128,129
050,26,071,"Michigan","Iron County",1,64,251,129,122
050,26,071,"Michigan","Iron County",1,65,231,123,108
050,26,071,"Michigan","Iron County",1,66,247,126,121
050,26,071,"Michigan","Iron County",1,67,248,129,119
050,26,071,"Michigan","Iron County",1,68,247,137,110
050,26,071,"Michigan","Iron County",1,69,208,121,87
050,26,071,"Michigan","Iron County",1,70,198,108,90
050,26,071,"Michigan","Iron County",1,71,178,97,81
050,26,071,"Michigan","Iron County",1,72,195,107,88
050,26,071,"Michigan","Iron County",1,73,194,108,86
050,26,071,"Michigan","Iron County",1,74,137,69,68
050,26,071,"Michigan","Iron County",1,75,135,68,67
050,26,071,"Michigan","Iron County",1,76,133,72,61
050,26,071,"Michigan","Iron County",1,77,115,60,55
050,26,071,"Michigan","Iron County",1,78,113,55,58
050,26,071,"Michigan","Iron County",1,79,100,48,52
050,26,071,"Michigan","Iron County",1,80,85,36,49
050,26,071,"Michigan","Iron County",1,81,83,35,48
050,26,071,"Michigan","Iron County",1,82,70,28,42
050,26,071,"Michigan","Iron County",1,83,77,38,39
050,26,071,"Michigan","Iron County",1,84,61,22,39
050,26,071,"Michigan","Iron County",1,85,491,175,316
050,26,071,"Michigan","Iron County",2,0,84,42,42
050,26,071,"Michigan","Iron County",2,1,93,42,51
050,26,071,"Michigan","Iron County",2,2,108,41,67
050,26,071,"Michigan","Iron County",2,3,102,43,59
050,26,071,"Michigan","Iron County",2,4,104,52,52
050,26,071,"Michigan","Iron County",2,5,108,51,57
050,26,071,"Michigan","Iron County",2,6,117,57,60
050,26,071,"Michigan","Iron County",2,7,119,66,53
050,26,071,"Michigan","Iron County",2,8,114,57,57
050,26,071,"Michigan","Iron County",2,9,108,48,60
050,26,071,"Michigan","Iron County",2,10,121,55,66
050,26,071,"Michigan","Iron County",2,11,126,60,66
050,26,071,"Michigan","Iron County",2,12,123,59,64
050,26,071,"Michigan","Iron County",2,13,116,60,56
050,26,071,"Michigan","Iron County",2,14,115,59,56
050,26,071,"Michigan","Iron County",2,15,127,65,62
050,26,071,"Michigan","Iron County",2,16,114,60,54
050,26,071,"Michigan","Iron County",2,17,110,60,50
050,26,071,"Michigan","Iron County",2,18,104,56,48
050,26,071,"Michigan","Iron County",2,19,85,44,41
050,26,071,"Michigan","Iron County",2,20,88,44,44
050,26,071,"Michigan","Iron County",2,21,86,40,46
050,26,071,"Michigan","Iron County",2,22,85,41,44
050,26,071,"Michigan","Iron County",2,23,93,48,45
050,26,071,"Michigan","Iron County",2,24,86,40,46
050,26,071,"Michigan","Iron County",2,25,80,34,46
050,26,071,"Michigan","Iron County",2,26,97,54,43
050,26,071,"Michigan","Iron County",2,27,99,62,37
050,26,071,"Michigan","Iron County",2,28,87,46,41
050,26,071,"Michigan","Iron County",2,29,107,53,54
050,26,071,"Michigan","Iron County",2,30,102,51,51
050,26,071,"Michigan","Iron County",2,31,98,49,49
050,26,071,"Michigan","Iron County",2,32,97,48,49
050,26,071,"Michigan","Iron County",2,33,90,48,42
050,26,071,"Michigan","Iron County",2,34,89,43,46
050,26,071,"Michigan","Iron County",2,35,105,46,59
050,26,071,"Michigan","Iron County",2,36,111,49,62
050,26,071,"Michigan","Iron County",2,37,118,57,61
050,26,071,"Michigan","Iron County",2,38,128,64,64
050,26,071,"Michigan","Iron County",2,39,116,60,56
050,26,071,"Michigan","Iron County",2,40,112,62,50
050,26,071,"Michigan","Iron County",2,41,110,54,56
050,26,071,"Michigan","Iron County",2,42,113,57,56
050,26,071,"Michigan","Iron County",2,43,126,67,59
050,26,071,"Michigan","Iron County",2,44,112,62,50
050,26,071,"Michigan","Iron County",2,45,112,62,50
050,26,071,"Michigan","Iron County",2,46,103,55,48
050,26,071,"Michigan","Iron County",2,47,110,59,51
050,26,071,"Michigan","Iron County",2,48,102,52,50
050,26,071,"Michigan","Iron County",2,49,125,62,63
050,26,071,"Michigan","Iron County",2,50,120,64,56
050,26,071,"Michigan","Iron County",2,51,118,67,51
050,26,071,"Michigan","Iron County",2,52,122,69,53
050,26,071,"Michigan","Iron County",2,53,143,75,68
050,26,071,"Michigan","Iron County",2,54,143,71,72
050,26,071,"Michigan","Iron County",2,55,163,77,86
050,26,071,"Michigan","Iron County",2,56,182,87,95
050,26,071,"Michigan","Iron County",2,57,205,104,101
050,26,071,"Michigan","Iron County",2,58,218,113,105
050,26,071,"Michigan","Iron County",2,59,211,107,104
050,26,071,"Michigan","Iron County",2,60,211,99,112
050,26,071,"Michigan","Iron County",2,61,226,107,119
050,26,071,"Michigan","Iron County",2,62,230,113,117
050,26,071,"Michigan","Iron County",2,63,252,125,127
050,26,071,"Michigan","Iron County",2,64,251,129,122
050,26,071,"Michigan","Iron County",2,65,235,125,110
050,26,071,"Michigan","Iron County",2,66,243,126,117
050,26,071,"Michigan","Iron County",2,67,246,129,117
050,26,071,"Michigan","Iron County",2,68,245,134,111
050,26,071,"Michigan","Iron County",2,69,217,126,91
050,26,071,"Michigan","Iron County",2,70,200,110,90
050,26,071,"Michigan","Iron County",2,71,182,100,82
050,26,071,"Michigan","Iron County",2,72,188,103,85
050,26,071,"Michigan","Iron County",2,73,203,112,91
050,26,071,"Michigan","Iron County",2,74,138,72,66
050,26,071,"Michigan","Iron County",2,75,137,69,68
050,26,071,"Michigan","Iron County",2,76,129,68,61
050,26,071,"Michigan","Iron County",2,77,119,63,56
050,26,071,"Michigan","Iron County",2,78,110,54,56
050,26,071,"Michigan","Iron County",2,79,99,49,50
050,26,071,"Michigan","Iron County",2,80,86,39,47
050,26,071,"Michigan","Iron County",2,81,81,33,48
050,26,071,"Michigan","Iron County",2,82,73,30,43
050,26,071,"Michigan","Iron County",2,83,76,36,40
050,26,071,"Michigan","Iron County",2,84,62,23,39
050,26,071,"Michigan","Iron County",2,85,485,174,311
050,26,071,"Michigan","Iron County",3,0,68,28,40
050,26,071,"Michigan","Iron County",3,1,79,40,39
050,26,071,"Michigan","Iron County",3,2,92,41,51
050,26,071,"Michigan","Iron County",3,3,106,42,64
050,26,071,"Michigan","Iron County",3,4,107,49,58
050,26,071,"Michigan","Iron County",3,5,102,55,47
050,26,071,"Michigan","Iron County",3,6,109,51,58
050,26,071,"Michigan","Iron County",3,7,115,59,56
050,26,071,"Michigan","Iron County",3,8,129,68,61
050,26,071,"Michigan","Iron County",3,9,115,55,60
050,26,071,"Michigan","Iron County",3,10,109,48,61
050,26,071,"Michigan","Iron County",3,11,130,57,73
050,26,071,"Michigan","Iron County",3,12,123,55,68
050,26,071,"Michigan","Iron County",3,13,128,59,69
050,26,071,"Michigan","Iron County",3,14,116,61,55
050,26,071,"Michigan","Iron County",3,15,123,66,57
050,26,071,"Michigan","Iron County",3,16,133,67,66
050,26,071,"Michigan","Iron County",3,17,109,55,54
050,26,071,"Michigan","Iron County",3,18,91,46,45
050,26,071,"Michigan","Iron County",3,19,81,45,36
050,26,071,"Michigan","Iron County",3,20,91,51,40
050,26,071,"Michigan","Iron County",3,21,86,45,41
050,26,071,"Michigan","Iron County",3,22,93,46,47
050,26,071,"Michigan","Iron County",3,23,88,42,46
050,26,071,"Michigan","Iron County",3,24,92,48,44
050,26,071,"Michigan","Iron County",3,25,77,41,36
050,26,071,"Michigan","Iron County",3,26,75,34,41
050,26,071,"Michigan","Iron County",3,27,108,60,48
050,26,071,"Michigan","Iron County",3,28,102,58,44
050,26,071,"Michigan","Iron County",3,29,87,53,34
050,26,071,"Michigan","Iron County",3,30,112,57,55
050,26,071,"Michigan","Iron County",3,31,109,51,58
050,26,071,"Michigan","Iron County",3,32,91,46,45
050,26,071,"Michigan","Iron County",3,33,97,51,46
050,26,071,"Michigan","Iron County",3,34,100,59,41
050,26,071,"Michigan","Iron County",3,35,99,44,55
050,26,071,"Michigan","Iron County",3,36,108,50,58
050,26,071,"Michigan","Iron County",3,37,118,52,66
050,26,071,"Michigan","Iron County",3,38,123,61,62
050,26,071,"Michigan","Iron County",3,39,125,60,65
050,26,071,"Michigan","Iron County",3,40,117,64,53
050,26,071,"Michigan","Iron County",3,41,112,62,50
050,26,071,"Michigan","Iron County",3,42,114,60,54
050,26,071,"Michigan","Iron County",3,43,116,62,54
050,26,071,"Michigan","Iron County",3,44,137,71,66
050,26,071,"Michigan","Iron County",3,45,110,60,50
050,26,071,"Michigan","Iron County",3,46,114,62,52
050,26,071,"Michigan","Iron County",3,47,100,54,46
050,26,071,"Michigan","Iron County",3,48,113,65,48
050,26,071,"Michigan","Iron County",3,49,101,49,52
050,26,071,"Michigan","Iron County",3,50,126,66,60
050,26,071,"Michigan","Iron County",3,51,128,70,58
050,26,071,"Michigan","Iron County",3,52,116,66,50
050,26,071,"Michigan","Iron County",3,53,126,69,57
050,26,071,"Michigan","Iron County",3,54,147,74,73
050,26,071,"Michigan","Iron County",3,55,146,76,70
050,26,071,"Michigan","Iron County",3,56,163,75,88
050,26,071,"Michigan","Iron County",3,57,185,89,96
050,26,071,"Michigan","Iron County",3,58,209,110,99
050,26,071,"Michigan","Iron County",3,59,217,109,108
050,26,071,"Michigan","Iron County",3,60,215,110,105
050,26,071,"Michigan","Iron County",3,61,223,104,119
050,26,071,"Michigan","Iron County",3,62,228,109,119
050,26,071,"Michigan","Iron County",3,63,237,116,121
050,26,071,"Michigan","Iron County",3,64,258,128,130
050,26,071,"Michigan","Iron County",3,65,249,125,124
050,26,071,"Michigan","Iron County",3,66,240,129,111
050,26,071,"Michigan","Iron County",3,67,237,122,115
050,26,071,"Michigan","Iron County",3,68,236,127,109
050,26,071,"Michigan","Iron County",3,69,239,126,113
050,26,071,"Michigan","Iron County",3,70,210,121,89
050,26,071,"Michigan","Iron County",3,71,192,105,87
050,26,071,"Michigan","Iron County",3,72,181,97,84
050,26,071,"Michigan","Iron County",3,73,187,98,89
050,26,071,"Michigan","Iron County",3,74,190,107,83
050,26,071,"Michigan","Iron County",3,75,135,70,65
050,26,071,"Michigan","Iron County",3,76,126,64,62
050,26,071,"Michigan","Iron County",3,77,117,59,58
050,26,071,"Michigan","Iron County",3,78,114,60,54
050,26,071,"Michigan","Iron County",3,79,99,52,47
050,26,071,"Michigan","Iron County",3,80,95,45,50
050,26,071,"Michigan","Iron County",3,81,81,34,47
050,26,071,"Michigan","Iron County",3,82,72,31,41
050,26,071,"Michigan","Iron County",3,83,80,36,44
050,26,071,"Michigan","Iron County",3,84,63,27,36
050,26,071,"Michigan","Iron County",3,85,463,164,299
050,26,071,"Michigan","Iron County",4,0,70,34,36
050,26,071,"Michigan","Iron County",4,1,78,32,46
050,26,071,"Michigan","Iron County",4,2,82,43,39
050,26,071,"Michigan","Iron County",4,3,90,42,48
050,26,071,"Michigan","Iron County",4,4,108,41,67
050,26,071,"Michigan","Iron County",4,5,112,52,60
050,26,071,"Michigan","Iron County",4,6,111,59,52
050,26,071,"Michigan","Iron County",4,7,113,57,56
050,26,071,"Michigan","Iron County",4,8,119,60,59
050,26,071,"Michigan","Iron County",4,9,130,65,65
050,26,071,"Michigan","Iron County",4,10,122,56,66
050,26,071,"Michigan","Iron County",4,11,117,56,61
050,26,071,"Michigan","Iron County",4,12,136,67,69
050,26,071,"Michigan","Iron County",4,13,126,58,68
050,26,071,"Michigan","Iron County",4,14,131,62,69
050,26,071,"Michigan","Iron County",4,15,118,66,52
050,26,071,"Michigan","Iron County",4,16,127,65,62
050,26,071,"Michigan","Iron County",4,17,135,70,65
050,26,071,"Michigan","Iron County",4,18,91,52,39
050,26,071,"Michigan","Iron County",4,19,74,40,34
050,26,071,"Michigan","Iron County",4,20,80,43,37
050,26,071,"Michigan","Iron County",4,21,88,49,39
050,26,071,"Michigan","Iron County",4,22,92,43,49
050,26,071,"Michigan","Iron County",4,23,101,46,55
050,26,071,"Michigan","Iron County",4,24,81,37,44
050,26,071,"Michigan","Iron County",4,25,96,47,49
050,26,071,"Michigan","Iron County",4,26,76,44,32
050,26,071,"Michigan","Iron County",4,27,75,34,41
050,26,071,"Michigan","Iron County",4,28,104,49,55
050,26,071,"Michigan","Iron County",4,29,101,56,45
050,26,071,"Michigan","Iron County",4,30,94,52,42
050,26,071,"Michigan","Iron County",4,31,119,62,57
050,26,071,"Michigan","Iron County",4,32,110,50,60
050,26,071,"Michigan","Iron County",4,33,97,50,47
050,26,071,"Michigan","Iron County",4,34,102,56,46
050,26,071,"Michigan","Iron County",4,35,102,56,46
050,26,071,"Michigan","Iron County",4,36,98,43,55
050,26,071,"Michigan","Iron County",4,37,112,49,63
050,26,071,"Michigan","Iron County",4,38,129,58,71
050,26,071,"Michigan","Iron County",4,39,125,59,66
050,26,071,"Michigan","Iron County",4,40,130,66,64
050,26,071,"Michigan","Iron County",4,41,115,62,53
050,26,071,"Michigan","Iron County",4,42,113,63,50
050,26,071,"Michigan","Iron County",4,43,125,66,59
050,26,071,"Michigan","Iron County",4,44,126,69,57
050,26,071,"Michigan","Iron County",4,45,139,72,67
050,26,071,"Michigan","Iron County",4,46,117,63,54
050,26,071,"Michigan","Iron County",4,47,116,65,51
050,26,071,"Michigan","Iron County",4,48,100,56,44
050,26,071,"Michigan","Iron County",4,49,113,63,50
050,26,071,"Michigan","Iron County",4,50,110,59,51
050,26,071,"Michigan","Iron County",4,51,126,65,61
050,26,071,"Michigan","Iron County",4,52,135,71,64
050,26,071,"Michigan","Iron County",4,53,121,71,50
050,26,071,"Michigan","Iron County",4,54,127,68,59
050,26,071,"Michigan","Iron County",4,55,140,69,71
050,26,071,"Michigan","Iron County",4,56,157,81,76
050,26,071,"Michigan","Iron County",4,57,171,77,94
050,26,071,"Michigan","Iron County",4,58,189,92,97
050,26,071,"Michigan","Iron County",4,59,212,113,99
050,26,071,"Michigan","Iron County",4,60,218,109,109
050,26,071,"Michigan","Iron County",4,61,221,113,108
050,26,071,"Michigan","Iron County",4,62,228,107,121
050,26,071,"Michigan","Iron County",4,63,234,114,120
050,26,071,"Michigan","Iron County",4,64,250,123,127
050,26,071,"Michigan","Iron County",4,65,264,133,131
050,26,071,"Michigan","Iron County",4,66,251,126,125
050,26,071,"Michigan","Iron County",4,67,234,121,113
050,26,071,"Michigan","Iron County",4,68,242,121,121
050,26,071,"Michigan","Iron County",4,69,236,127,109
050,26,071,"Michigan","Iron County",4,70,238,123,115
050,26,071,"Michigan","Iron County",4,71,203,115,88
050,26,071,"Michigan","Iron County",4,72,185,99,86
050,26,071,"Michigan","Iron County",4,73,174,92,82
050,26,071,"Michigan","Iron County",4,74,176,92,84
050,26,071,"Michigan","Iron County",4,75,190,100,90
050,26,071,"Michigan","Iron County",4,76,120,64,56
050,26,071,"Michigan","Iron County",4,77,115,57,58
050,26,071,"Michigan","Iron County",4,78,112,58,54
050,26,071,"Michigan","Iron County",4,79,101,54,47
050,26,071,"Michigan","Iron County",4,80,99,49,50
050,26,071,"Michigan","Iron County",4,81,83,34,49
050,26,071,"Michigan","Iron County",4,82,73,32,41
050,26,071,"Michigan","Iron County",4,83,77,37,40
050,26,071,"Michigan","Iron County",4,84,68,27,41
050,26,071,"Michigan","Iron County",4,85,459,164,295
050,26,071,"Michigan","Iron County",5,0,63,30,33
050,26,071,"Michigan","Iron County",5,1,72,42,30
050,26,071,"Michigan","Iron County",5,2,83,31,52
050,26,071,"Michigan","Iron County",5,3,80,41,39
050,26,071,"Michigan","Iron County",5,4,97,47,50
050,26,071,"Michigan","Iron County",5,5,115,46,69
050,26,071,"Michigan","Iron County",5,6,112,50,62
050,26,071,"Michigan","Iron County",5,7,110,61,49
050,26,071,"Michigan","Iron County",5,8,111,54,57
050,26,071,"Michigan","Iron County",5,9,125,61,64
050,26,071,"Michigan","Iron County",5,10,131,66,65
050,26,071,"Michigan","Iron County",5,11,124,57,67
050,26,071,"Michigan","Iron County",5,12,107,50,57
050,26,071,"Michigan","Iron County",5,13,144,72,72
050,26,071,"Michigan","Iron County",5,14,119,54,65
050,26,071,"Michigan","Iron County",5,15,142,69,73
050,26,071,"Michigan","Iron County",5,16,125,73,52
050,26,071,"Michigan","Iron County",5,17,132,73,59
050,26,071,"Michigan","Iron County",5,18,114,63,51
050,26,071,"Michigan","Iron County",5,19,79,43,36
050,26,071,"Michigan","Iron County",5,20,75,40,35
050,26,071,"Michigan","Iron County",5,21,89,45,44
050,26,071,"Michigan","Iron County",5,22,96,56,40
050,26,071,"Michigan","Iron County",5,23,94,42,52
050,26,071,"Michigan","Iron County",5,24,109,52,57
050,26,071,"Michigan","Iron County",5,25,74,37,37
050,26,071,"Michigan","Iron County",5,26,96,50,46
050,26,071,"Michigan","Iron County",5,27,78,47,31
050,26,071,"Michigan","Iron County",5,28,70,34,36
050,26,071,"Michigan","Iron County",5,29,100,51,49
050,26,071,"Michigan","Iron County",5,30,107,57,50
050,26,071,"Michigan","Iron County",5,31,99,53,46
050,26,071,"Michigan","Iron County",5,32,116,63,53
050,26,071,"Michigan","Iron County",5,33,113,48,65
050,26,071,"Michigan","Iron County",5,34,106,55,51
050,26,071,"Michigan","Iron County",5,35,106,58,48
050,26,071,"Michigan","Iron County",5,36,101,57,44
050,26,071,"Michigan","Iron County",5,37,107,51,56
050,26,071,"Michigan","Iron County",5,38,117,51,66
050,26,071,"Michigan","Iron County",5,39,132,61,71
050,26,071,"Michigan","Iron County",5,40,128,63,65
050,26,071,"Michigan","Iron County",5,41,127,64,63
050,26,071,"Michigan","Iron County",5,42,121,66,55
050,26,071,"Michigan","Iron County",5,43,118,65,53
050,26,071,"Michigan","Iron County",5,44,134,69,65
050,26,071,"Michigan","Iron County",5,45,131,70,61
050,26,071,"Michigan","Iron County",5,46,140,73,67
050,26,071,"Michigan","Iron County",5,47,113,62,51
050,26,071,"Michigan","Iron County",5,48,120,68,52
050,26,071,"Michigan","Iron County",5,49,104,54,50
050,26,071,"Michigan","Iron County",5,50,119,69,50
050,26,071,"Michigan","Iron County",5,51,112,58,54
050,26,071,"Michigan","Iron County",5,52,126,65,61
050,26,071,"Michigan","Iron County",5,53,130,67,63
050,26,071,"Michigan","Iron County",5,54,119,67,52
050,26,071,"Michigan","Iron County",5,55,129,71,58
050,26,071,"Michigan","Iron County",5,56,142,70,72
050,26,071,"Michigan","Iron County",5,57,167,87,80
050,26,071,"Michigan","Iron County",5,58,171,76,95
050,26,071,"Michigan","Iron County",5,59,191,92,99
050,26,071,"Michigan","Iron County",5,60,212,106,106
050,26,071,"Michigan","Iron County",5,61,218,110,108
050,26,071,"Michigan","Iron County",5,62,222,112,110
050,26,071,"Michigan","Iron County",5,63,244,118,126
050,26,071,"Michigan","Iron County",5,64,235,114,121
050,26,071,"Michigan","Iron County",5,65,252,126,126
050,26,071,"Michigan","Iron County",5,66,272,137,135
050,26,071,"Michigan","Iron County",5,67,249,123,126
050,26,071,"Michigan","Iron County",5,68,230,117,113
050,26,071,"Michigan","Iron County",5,69,236,116,120
050,26,071,"Michigan","Iron County",5,70,235,124,111
050,26,071,"Michigan","Iron County",5,71,232,120,112
050,26,071,"Michigan","Iron County",5,72,204,120,84
050,26,071,"Michigan","Iron County",5,73,181,94,87
050,26,071,"Michigan","Iron County",5,74,168,89,79
050,26,071,"Michigan","Iron County",5,75,170,85,85
050,26,071,"Michigan","Iron County",5,76,169,92,77
050,26,071,"Michigan","Iron County",5,77,112,59,53
050,26,071,"Michigan","Iron County",5,78,115,59,56
050,26,071,"Michigan","Iron County",5,79,101,54,47
050,26,071,"Michigan","Iron County",5,80,96,48,48
050,26,071,"Michigan","Iron County",5,81,91,40,51
050,26,071,"Michigan","Iron County",5,82,74,31,43
050,26,071,"Michigan","Iron County",5,83,79,39,40
050,26,071,"Michigan","Iron County",5,84,62,25,37
050,26,071,"Michigan","Iron County",5,85,469,171,298
050,26,073,"Michigan","Isabella County",1,0,542,275,267
050,26,073,"Michigan","Isabella County",1,1,550,267,283
050,26,073,"Michigan","Isabella County",1,2,605,292,313
050,26,073,"Michigan","Isabella County",1,3,579,287,292
050,26,073,"Michigan","Isabella County",1,4,609,313,296
050,26,073,"Michigan","Isabella County",1,5,640,340,300
050,26,073,"Michigan","Isabella County",1,6,593,295,298
050,26,073,"Michigan","Isabella County",1,7,578,288,290
050,26,073,"Michigan","Isabella County",1,8,575,276,299
050,26,073,"Michigan","Isabella County",1,9,597,317,280
050,26,073,"Michigan","Isabella County",1,10,712,360,352
050,26,073,"Michigan","Isabella County",1,11,687,367,320
050,26,073,"Michigan","Isabella County",1,12,687,365,322
050,26,073,"Michigan","Isabella County",1,13,694,360,334
050,26,073,"Michigan","Isabella County",1,14,692,350,342
050,26,073,"Michigan","Isabella County",1,15,647,323,324
050,26,073,"Michigan","Isabella County",1,16,660,330,330
050,26,073,"Michigan","Isabella County",1,17,659,341,318
050,26,073,"Michigan","Isabella County",1,18,1987,801,1186
050,26,073,"Michigan","Isabella County",1,19,3024,1341,1683
050,26,073,"Michigan","Isabella County",1,20,3091,1315,1776
050,26,073,"Michigan","Isabella County",1,21,2917,1267,1650
050,26,073,"Michigan","Isabella County",1,22,2595,1261,1334
050,26,073,"Michigan","Isabella County",1,23,2047,1037,1010
050,26,073,"Michigan","Isabella County",1,24,1226,667,559
050,26,073,"Michigan","Isabella County",1,25,978,523,455
050,26,073,"Michigan","Isabella County",1,26,867,474,393
050,26,073,"Michigan","Isabella County",1,27,805,435,370
050,26,073,"Michigan","Isabella County",1,28,803,401,402
050,26,073,"Michigan","Isabella County",1,29,789,394,395
050,26,073,"Michigan","Isabella County",1,30,797,430,367
050,26,073,"Michigan","Isabella County",1,31,719,376,343
050,26,073,"Michigan","Isabella County",1,32,699,371,328
050,26,073,"Michigan","Isabella County",1,33,631,335,296
050,26,073,"Michigan","Isabella County",1,34,653,323,330
050,26,073,"Michigan","Isabella County",1,35,662,331,331
050,26,073,"Michigan","Isabella County",1,36,678,355,323
050,26,073,"Michigan","Isabella County",1,37,683,366,317
050,26,073,"Michigan","Isabella County",1,38,746,388,358
050,26,073,"Michigan","Isabella County",1,39,672,356,316
050,26,073,"Michigan","Isabella County",1,40,666,346,320
050,26,073,"Michigan","Isabella County",1,41,681,353,328
050,26,073,"Michigan","Isabella County",1,42,665,341,324
050,26,073,"Michigan","Isabella County",1,43,594,283,311
050,26,073,"Michigan","Isabella County",1,44,597,297,300
050,26,073,"Michigan","Isabella County",1,45,555,287,268
050,26,073,"Michigan","Isabella County",1,46,555,293,262
050,26,073,"Michigan","Isabella County",1,47,580,299,281
050,26,073,"Michigan","Isabella County",1,48,619,326,293
050,26,073,"Michigan","Isabella County",1,49,639,316,323
050,26,073,"Michigan","Isabella County",1,50,666,336,330
050,26,073,"Michigan","Isabella County",1,51,635,322,313
050,26,073,"Michigan","Isabella County",1,52,633,313,320
050,26,073,"Michigan","Isabella County",1,53,644,326,318
050,26,073,"Michigan","Isabella County",1,54,664,333,331
050,26,073,"Michigan","Isabella County",1,55,713,351,362
050,26,073,"Michigan","Isabella County",1,56,698,366,332
050,26,073,"Michigan","Isabella County",1,57,727,377,350
050,26,073,"Michigan","Isabella County",1,58,710,343,367
050,26,073,"Michigan","Isabella County",1,59,715,346,369
050,26,073,"Michigan","Isabella County",1,60,718,350,368
050,26,073,"Michigan","Isabella County",1,61,714,354,360
050,26,073,"Michigan","Isabella County",1,62,723,349,374
050,26,073,"Michigan","Isabella County",1,63,728,353,375
050,26,073,"Michigan","Isabella County",1,64,651,300,351
050,26,073,"Michigan","Isabella County",1,65,668,315,353
050,26,073,"Michigan","Isabella County",1,66,663,330,333
050,26,073,"Michigan","Isabella County",1,67,649,326,323
050,26,073,"Michigan","Isabella County",1,68,618,301,317
050,26,073,"Michigan","Isabella County",1,69,543,264,279
050,26,073,"Michigan","Isabella County",1,70,513,256,257
050,26,073,"Michigan","Isabella County",1,71,463,226,237
050,26,073,"Michigan","Isabella County",1,72,465,224,241
050,26,073,"Michigan","Isabella County",1,73,442,217,225
050,26,073,"Michigan","Isabella County",1,74,286,134,152
050,26,073,"Michigan","Isabella County",1,75,293,130,163
050,26,073,"Michigan","Isabella County",1,76,305,144,161
050,26,073,"Michigan","Isabella County",1,77,303,138,165
050,26,073,"Michigan","Isabella County",1,78,254,124,130
050,26,073,"Michigan","Isabella County",1,79,241,102,139
050,26,073,"Michigan","Isabella County",1,80,233,98,135
050,26,073,"Michigan","Isabella County",1,81,221,98,123
050,26,073,"Michigan","Isabella County",1,82,192,89,103
050,26,073,"Michigan","Isabella County",1,83,169,76,93
050,26,073,"Michigan","Isabella County",1,84,160,68,92
050,26,073,"Michigan","Isabella County",1,85,850,269,581
050,26,073,"Michigan","Isabella County",2,0,567,295,272
050,26,073,"Michigan","Isabella County",2,1,546,267,279
050,26,073,"Michigan","Isabella County",2,2,590,286,304
050,26,073,"Michigan","Isabella County",2,3,590,289,301
050,26,073,"Michigan","Isabella County",2,4,607,308,299
050,26,073,"Michigan","Isabella County",2,5,631,334,297
050,26,073,"Michigan","Isabella County",2,6,607,307,300
050,26,073,"Michigan","Isabella County",2,7,583,289,294
050,26,073,"Michigan","Isabella County",2,8,577,279,298
050,26,073,"Michigan","Isabella County",2,9,596,310,286
050,26,073,"Michigan","Isabella County",2,10,684,351,333
050,26,073,"Michigan","Isabella County",2,11,695,366,329
050,26,073,"Michigan","Isabella County",2,12,692,368,324
050,26,073,"Michigan","Isabella County",2,13,694,362,332
050,26,073,"Michigan","Isabella County",2,14,695,353,342
050,26,073,"Michigan","Isabella County",2,15,663,333,330
050,26,073,"Michigan","Isabella County",2,16,661,331,330
050,26,073,"Michigan","Isabella County",2,17,664,340,324
050,26,073,"Michigan","Isabella County",2,18,1979,800,1179
050,26,073,"Michigan","Isabella County",2,19,3031,1348,1683
050,26,073,"Michigan","Isabella County",2,20,3145,1334,1811
050,26,073,"Michigan","Isabella County",2,21,2921,1271,1650
050,26,073,"Michigan","Isabella County",2,22,2602,1265,1337
050,26,073,"Michigan","Isabella County",2,23,2024,1022,1002
050,26,073,"Michigan","Isabella County",2,24,1217,664,553
050,26,073,"Michigan","Isabella County",2,25,974,521,453
050,26,073,"Michigan","Isabella County",2,26,844,455,389
050,26,073,"Michigan","Isabella County",2,27,800,436,364
050,26,073,"Michigan","Isabella County",2,28,799,408,391
050,26,073,"Michigan","Isabella County",2,29,794,397,397
050,26,073,"Michigan","Isabella County",2,30,797,421,376
050,26,073,"Michigan","Isabella County",2,31,735,389,346
050,26,073,"Michigan","Isabella County",2,32,703,372,331
050,26,073,"Michigan","Isabella County",2,33,647,343,304
050,26,073,"Michigan","Isabella County",2,34,653,327,326
050,26,073,"Michigan","Isabella County",2,35,665,330,335
050,26,073,"Michigan","Isabella County",2,36,662,343,319
050,26,073,"Michigan","Isabella County",2,37,684,366,318
050,26,073,"Michigan","Isabella County",2,38,732,383,349
050,26,073,"Michigan","Isabella County",2,39,690,364,326
050,26,073,"Michigan","Isabella County",2,40,673,351,322
050,26,073,"Michigan","Isabella County",2,41,676,351,325
050,26,073,"Michigan","Isabella County",2,42,662,340,322
050,26,073,"Michigan","Isabella County",2,43,613,297,316
050,26,073,"Michigan","Isabella County",2,44,593,295,298
050,26,073,"Michigan","Isabella County",2,45,568,290,278
050,26,073,"Michigan","Isabella County",2,46,555,293,262
050,26,073,"Michigan","Isabella County",2,47,571,297,274
050,26,073,"Michigan","Isabella County",2,48,607,318,289
050,26,073,"Michigan","Isabella County",2,49,638,320,318
050,26,073,"Michigan","Isabella County",2,50,658,330,328
050,26,073,"Michigan","Isabella County",2,51,641,321,320
050,26,073,"Michigan","Isabella County",2,52,631,315,316
050,26,073,"Michigan","Isabella County",2,53,639,325,314
050,26,073,"Michigan","Isabella County",2,54,661,333,328
050,26,073,"Michigan","Isabella County",2,55,704,348,356
050,26,073,"Michigan","Isabella County",2,56,706,364,342
050,26,073,"Michigan","Isabella County",2,57,721,376,345
050,26,073,"Michigan","Isabella County",2,58,713,352,361
050,26,073,"Michigan","Isabella County",2,59,716,346,370
050,26,073,"Michigan","Isabella County",2,60,711,346,365
050,26,073,"Michigan","Isabella County",2,61,710,348,362
050,26,073,"Michigan","Isabella County",2,62,719,348,371
050,26,073,"Michigan","Isabella County",2,63,733,356,377
050,26,073,"Michigan","Isabella County",2,64,662,309,353
050,26,073,"Michigan","Isabella County",2,65,665,312,353
050,26,073,"Michigan","Isabella County",2,66,666,327,339
050,26,073,"Michigan","Isabella County",2,67,649,326,323
050,26,073,"Michigan","Isabella County",2,68,620,306,314
050,26,073,"Michigan","Isabella County",2,69,564,273,291
050,26,073,"Michigan","Isabella County",2,70,518,255,263
050,26,073,"Michigan","Isabella County",2,71,469,230,239
050,26,073,"Michigan","Isabella County",2,72,448,216,232
050,26,073,"Michigan","Isabella County",2,73,471,229,242
050,26,073,"Michigan","Isabella County",2,74,303,144,159
050,26,073,"Michigan","Isabella County",2,75,290,129,161
050,26,073,"Michigan","Isabella County",2,76,302,139,163
050,26,073,"Michigan","Isabella County",2,77,311,143,168
050,26,073,"Michigan","Isabella County",2,78,256,120,136
050,26,073,"Michigan","Isabella County",2,79,241,105,136
050,26,073,"Michigan","Isabella County",2,80,223,93,130
050,26,073,"Michigan","Isabella County",2,81,217,97,120
050,26,073,"Michigan","Isabella County",2,82,196,88,108
050,26,073,"Michigan","Isabella County",2,83,171,77,94
050,26,073,"Michigan","Isabella County",2,84,156,69,87
050,26,073,"Michigan","Isabella County",2,85,861,277,584
050,26,073,"Michigan","Isabella County",3,0,574,304,270
050,26,073,"Michigan","Isabella County",3,1,571,294,277
050,26,073,"Michigan","Isabella County",3,2,559,273,286
050,26,073,"Michigan","Isabella County",3,3,612,301,311
050,26,073,"Michigan","Isabella County",3,4,594,290,304
050,26,073,"Michigan","Isabella County",3,5,612,306,306
050,26,073,"Michigan","Isabella County",3,6,650,337,313
050,26,073,"Michigan","Isabella County",3,7,619,324,295
050,26,073,"Michigan","Isabella County",3,8,597,291,306
050,26,073,"Michigan","Isabella County",3,9,578,284,294
050,26,073,"Michigan","Isabella County",3,10,610,315,295
050,26,073,"Michigan","Isabella County",3,11,694,356,338
050,26,073,"Michigan","Isabella County",3,12,702,374,328
050,26,073,"Michigan","Isabella County",3,13,693,365,328
050,26,073,"Michigan","Isabella County",3,14,678,360,318
050,26,073,"Michigan","Isabella County",3,15,711,365,346
050,26,073,"Michigan","Isabella County",3,16,665,337,328
050,26,073,"Michigan","Isabella County",3,17,668,335,333
050,26,073,"Michigan","Isabella County",3,18,1826,753,1073
050,26,073,"Michigan","Isabella County",3,19,2818,1264,1554
050,26,073,"Michigan","Isabella County",3,20,3120,1307,1813
050,26,073,"Michigan","Isabella County",3,21,3014,1306,1708
050,26,073,"Michigan","Isabella County",3,22,2630,1267,1363
050,26,073,"Michigan","Isabella County",3,23,2016,1036,980
050,26,073,"Michigan","Isabella County",3,24,1243,681,562
050,26,073,"Michigan","Isabella County",3,25,991,550,441
050,26,073,"Michigan","Isabella County",3,26,797,409,388
050,26,073,"Michigan","Isabella County",3,27,740,417,323
050,26,073,"Michigan","Isabella County",3,28,756,403,353
050,26,073,"Michigan","Isabella County",3,29,765,383,382
050,26,073,"Michigan","Isabella County",3,30,771,382,389
050,26,073,"Michigan","Isabella County",3,31,788,407,381
050,26,073,"Michigan","Isabella County",3,32,723,375,348
050,26,073,"Michigan","Isabella County",3,33,692,359,333
050,26,073,"Michigan","Isabella County",3,34,653,346,307
050,26,073,"Michigan","Isabella County",3,35,656,329,327
050,26,073,"Michigan","Isabella County",3,36,665,328,337
050,26,073,"Michigan","Isabella County",3,37,650,345,305
050,26,073,"Michigan","Isabella County",3,38,695,358,337
050,26,073,"Michigan","Isabella County",3,39,724,373,351
050,26,073,"Michigan","Isabella County",3,40,668,347,321
050,26,073,"Michigan","Isabella County",3,41,667,355,312
050,26,073,"Michigan","Isabella County",3,42,679,348,331
050,26,073,"Michigan","Isabella County",3,43,663,342,321
050,26,073,"Michigan","Isabella County",3,44,624,301,323
050,26,073,"Michigan","Isabella County",3,45,577,288,289
050,26,073,"Michigan","Isabella County",3,46,603,316,287
050,26,073,"Michigan","Isabella County",3,47,560,288,272
050,26,073,"Michigan","Isabella County",3,48,567,299,268
050,26,073,"Michigan","Isabella County",3,49,591,305,286
050,26,073,"Michigan","Isabella County",3,50,631,320,311
050,26,073,"Michigan","Isabella County",3,51,659,322,337
050,26,073,"Michigan","Isabella County",3,52,631,321,310
050,26,073,"Michigan","Isabella County",3,53,638,318,320
050,26,073,"Michigan","Isabella County",3,54,639,328,311
050,26,073,"Michigan","Isabella County",3,55,663,337,326
050,26,073,"Michigan","Isabella County",3,56,697,339,358
050,26,073,"Michigan","Isabella County",3,57,694,356,338
050,26,073,"Michigan","Isabella County",3,58,705,369,336
050,26,073,"Michigan","Isabella County",3,59,696,339,357
050,26,073,"Michigan","Isabella County",3,60,702,329,373
050,26,073,"Michigan","Isabella County",3,61,701,337,364
050,26,073,"Michigan","Isabella County",3,62,697,346,351
050,26,073,"Michigan","Isabella County",3,63,695,334,361
050,26,073,"Michigan","Isabella County",3,64,712,351,361
050,26,073,"Michigan","Isabella County",3,65,647,302,345
050,26,073,"Michigan","Isabella County",3,66,656,305,351
050,26,073,"Michigan","Isabella County",3,67,651,320,331
050,26,073,"Michigan","Isabella County",3,68,634,319,315
050,26,073,"Michigan","Isabella County",3,69,604,293,311
050,26,073,"Michigan","Isabella County",3,70,555,262,293
050,26,073,"Michigan","Isabella County",3,71,496,255,241
050,26,073,"Michigan","Isabella County",3,72,451,216,235
050,26,073,"Michigan","Isabella County",3,73,450,215,235
050,26,073,"Michigan","Isabella County",3,74,433,211,222
050,26,073,"Michigan","Isabella County",3,75,291,140,151
050,26,073,"Michigan","Isabella County",3,76,282,126,156
050,26,073,"Michigan","Isabella County",3,77,290,135,155
050,26,073,"Michigan","Isabella County",3,78,295,138,157
050,26,073,"Michigan","Isabella County",3,79,240,110,130
050,26,073,"Michigan","Isabella County",3,80,229,99,130
050,26,073,"Michigan","Isabella County",3,81,195,79,116
050,26,073,"Michigan","Isabella County",3,82,203,89,114
050,26,073,"Michigan","Isabella County",3,83,185,87,98
050,26,073,"Michigan","Isabella County",3,84,150,69,81
050,26,073,"Michigan","Isabella County",3,85,832,280,552
050,26,073,"Michigan","Isabella County",4,0,592,305,287
050,26,073,"Michigan","Isabella County",4,1,605,330,275
050,26,073,"Michigan","Isabella County",4,2,600,312,288
050,26,073,"Michigan","Isabella County",4,3,581,282,299
050,26,073,"Michigan","Isabella County",4,4,629,308,321
050,26,073,"Michigan","Isabella County",4,5,599,299,300
050,26,073,"Michigan","Isabella County",4,6,628,314,314
050,26,073,"Michigan","Isabella County",4,7,657,343,314
050,26,073,"Michigan","Isabella County",4,8,623,322,301
050,26,073,"Michigan","Isabella County",4,9,610,301,309
050,26,073,"Michigan","Isabella County",4,10,599,285,314
050,26,073,"Michigan","Isabella County",4,11,627,320,307
050,26,073,"Michigan","Isabella County",4,12,702,361,341
050,26,073,"Michigan","Isabella County",4,13,720,380,340
050,26,073,"Michigan","Isabella County",4,14,705,369,336
050,26,073,"Michigan","Isabella County",4,15,701,369,332
050,26,073,"Michigan","Isabella County",4,16,720,365,355
050,26,073,"Michigan","Isabella County",4,17,664,327,337
050,26,073,"Michigan","Isabella County",4,18,1734,712,1022
050,26,073,"Michigan","Isabella County",4,19,2665,1202,1463
050,26,073,"Michigan","Isabella County",4,20,3027,1273,1754
050,26,073,"Michigan","Isabella County",4,21,3043,1309,1734
050,26,073,"Michigan","Isabella County",4,22,2751,1334,1417
050,26,073,"Michigan","Isabella County",4,23,2067,1045,1022
050,26,073,"Michigan","Isabella County",4,24,1194,665,529
050,26,073,"Michigan","Isabella County",4,25,997,539,458
050,26,073,"Michigan","Isabella County",4,26,807,431,376
050,26,073,"Michigan","Isabella County",4,27,685,354,331
050,26,073,"Michigan","Isabella County",4,28,725,405,320
050,26,073,"Michigan","Isabella County",4,29,745,409,336
050,26,073,"Michigan","Isabella County",4,30,747,377,370
050,26,073,"Michigan","Isabella County",4,31,754,366,388
050,26,073,"Michigan","Isabella County",4,32,791,406,385
050,26,073,"Michigan","Isabella County",4,33,736,379,357
050,26,073,"Michigan","Isabella County",4,34,731,370,361
050,26,073,"Michigan","Isabella County",4,35,660,354,306
050,26,073,"Michigan","Isabella County",4,36,676,340,336
050,26,073,"Michigan","Isabella County",4,37,674,329,345
050,26,073,"Michigan","Isabella County",4,38,637,331,306
050,26,073,"Michigan","Isabella County",4,39,691,348,343
050,26,073,"Michigan","Isabella County",4,40,736,373,363
050,26,073,"Michigan","Isabella County",4,41,676,353,323
050,26,073,"Michigan","Isabella County",4,42,671,360,311
050,26,073,"Michigan","Isabella County",4,43,665,335,330
050,26,073,"Michigan","Isabella County",4,44,689,358,331
050,26,073,"Michigan","Isabella County",4,45,602,288,314
050,26,073,"Michigan","Isabella County",4,46,576,300,276
050,26,073,"Michigan","Isabella County",4,47,608,311,297
050,26,073,"Michigan","Isabella County",4,48,558,287,271
050,26,073,"Michigan","Isabella County",4,49,558,294,264
050,26,073,"Michigan","Isabella County",4,50,605,316,289
050,26,073,"Michigan","Isabella County",4,51,613,303,310
050,26,073,"Michigan","Isabella County",4,52,647,313,334
050,26,073,"Michigan","Isabella County",4,53,624,317,307
050,26,073,"Michigan","Isabella County",4,54,619,309,310
050,26,073,"Michigan","Isabella County",4,55,641,333,308
050,26,073,"Michigan","Isabella County",4,56,651,327,324
050,26,073,"Michigan","Isabella County",4,57,684,332,352
050,26,073,"Michigan","Isabella County",4,58,675,347,328
050,26,073,"Michigan","Isabella County",4,59,700,367,333
050,26,073,"Michigan","Isabella County",4,60,686,327,359
050,26,073,"Michigan","Isabella County",4,61,690,325,365
050,26,073,"Michigan","Isabella County",4,62,697,334,363
050,26,073,"Michigan","Isabella County",4,63,699,343,356
050,26,073,"Michigan","Isabella County",4,64,674,316,358
050,26,073,"Michigan","Isabella County",4,65,699,349,350
050,26,073,"Michigan","Isabella County",4,66,636,291,345
050,26,073,"Michigan","Isabella County",4,67,642,298,344
050,26,073,"Michigan","Isabella County",4,68,632,311,321
050,26,073,"Michigan","Isabella County",4,69,640,320,320
050,26,073,"Michigan","Isabella County",4,70,592,276,316
050,26,073,"Michigan","Isabella County",4,71,535,259,276
050,26,073,"Michigan","Isabella County",4,72,479,250,229
050,26,073,"Michigan","Isabella County",4,73,452,214,238
050,26,073,"Michigan","Isabella County",4,74,429,206,223
050,26,073,"Michigan","Isabella County",4,75,409,201,208
050,26,073,"Michigan","Isabella County",4,76,286,141,145
050,26,073,"Michigan","Isabella County",4,77,260,113,147
050,26,073,"Michigan","Isabella County",4,78,268,128,140
050,26,073,"Michigan","Isabella County",4,79,276,125,151
050,26,073,"Michigan","Isabella County",4,80,227,104,123
050,26,073,"Michigan","Isabella County",4,81,208,90,118
050,26,073,"Michigan","Isabella County",4,82,178,69,109
050,26,073,"Michigan","Isabella County",4,83,183,84,99
050,26,073,"Michigan","Isabella County",4,84,160,77,83
050,26,073,"Michigan","Isabella County",4,85,832,288,544
050,26,073,"Michigan","Isabella County",5,0,585,300,285
050,26,073,"Michigan","Isabella County",5,1,615,307,308
050,26,073,"Michigan","Isabella County",5,2,576,310,266
050,26,073,"Michigan","Isabella County",5,3,598,312,286
050,26,073,"Michigan","Isabella County",5,4,579,274,305
050,26,073,"Michigan","Isabella County",5,5,607,301,306
050,26,073,"Michigan","Isabella County",5,6,594,289,305
050,26,073,"Michigan","Isabella County",5,7,618,309,309
050,26,073,"Michigan","Isabella County",5,8,657,343,314
050,26,073,"Michigan","Isabella County",5,9,631,333,298
050,26,073,"Michigan","Isabella County",5,10,605,299,306
050,26,073,"Michigan","Isabella County",5,11,595,285,310
050,26,073,"Michigan","Isabella County",5,12,613,310,303
050,26,073,"Michigan","Isabella County",5,13,698,361,337
050,26,073,"Michigan","Isabella County",5,14,722,382,340
050,26,073,"Michigan","Isabella County",5,15,699,365,334
050,26,073,"Michigan","Isabella County",5,16,709,375,334
050,26,073,"Michigan","Isabella County",5,17,726,362,364
050,26,073,"Michigan","Isabella County",5,18,1653,666,987
050,26,073,"Michigan","Isabella County",5,19,2605,1159,1446
050,26,073,"Michigan","Isabella County",5,20,2952,1241,1711
050,26,073,"Michigan","Isabella County",5,21,2996,1286,1710
050,26,073,"Michigan","Isabella County",5,22,2799,1318,1481
050,26,073,"Michigan","Isabella County",5,23,2146,1115,1031
050,26,073,"Michigan","Isabella County",5,24,1274,709,565
050,26,073,"Michigan","Isabella County",5,25,976,533,443
050,26,073,"Michigan","Isabella County",5,26,840,433,407
050,26,073,"Michigan","Isabella County",5,27,761,408,353
050,26,073,"Michigan","Isabella County",5,28,682,360,322
050,26,073,"Michigan","Isabella County",5,29,701,387,314
050,26,073,"Michigan","Isabella County",5,30,732,401,331
050,26,073,"Michigan","Isabella County",5,31,717,356,361
050,26,073,"Michigan","Isabella County",5,32,733,366,367
050,26,073,"Michigan","Isabella County",5,33,768,398,370
050,26,073,"Michigan","Isabella County",5,34,712,368,344
050,26,073,"Michigan","Isabella County",5,35,709,372,337
050,26,073,"Michigan","Isabella County",5,36,652,351,301
050,26,073,"Michigan","Isabella County",5,37,662,328,334
050,26,073,"Michigan","Isabella County",5,38,674,319,355
050,26,073,"Michigan","Isabella County",5,39,616,315,301
050,26,073,"Michigan","Isabella County",5,40,683,333,350
050,26,073,"Michigan","Isabella County",5,41,704,356,348
050,26,073,"Michigan","Isabella County",5,42,673,351,322
050,26,073,"Michigan","Isabella County",5,43,662,347,315
050,26,073,"Michigan","Isabella County",5,44,667,339,328
050,26,073,"Michigan","Isabella County",5,45,674,354,320
050,26,073,"Michigan","Isabella County",5,46,609,293,316
050,26,073,"Michigan","Isabella County",5,47,556,282,274
050,26,073,"Michigan","Isabella County",5,48,595,300,295
050,26,073,"Michigan","Isabella County",5,49,548,276,272
050,26,073,"Michigan","Isabella County",5,50,550,289,261
050,26,073,"Michigan","Isabella County",5,51,602,305,297
050,26,073,"Michigan","Isabella County",5,52,601,295,306
050,26,073,"Michigan","Isabella County",5,53,627,304,323
050,26,073,"Michigan","Isabella County",5,54,640,327,313
050,26,073,"Michigan","Isabella County",5,55,620,306,314
050,26,073,"Michigan","Isabella County",5,56,631,319,312
050,26,073,"Michigan","Isabella County",5,57,654,324,330
050,26,073,"Michigan","Isabella County",5,58,678,339,339
050,26,073,"Michigan","Isabella County",5,59,660,350,310
050,26,073,"Michigan","Isabella County",5,60,681,355,326
050,26,073,"Michigan","Isabella County",5,61,681,325,356
050,26,073,"Michigan","Isabella County",5,62,674,316,358
050,26,073,"Michigan","Isabella County",5,63,691,333,358
050,26,073,"Michigan","Isabella County",5,64,674,327,347
050,26,073,"Michigan","Isabella County",5,65,672,328,344
050,26,073,"Michigan","Isabella County",5,66,687,331,356
050,26,073,"Michigan","Isabella County",5,67,628,290,338
050,26,073,"Michigan","Isabella County",5,68,622,289,333
050,26,073,"Michigan","Isabella County",5,69,632,310,322
050,26,073,"Michigan","Isabella County",5,70,626,309,317
050,26,073,"Michigan","Isabella County",5,71,577,273,304
050,26,073,"Michigan","Isabella County",5,72,520,252,268
050,26,073,"Michigan","Isabella County",5,73,475,247,228
050,26,073,"Michigan","Isabella County",5,74,439,209,230
050,26,073,"Michigan","Isabella County",5,75,417,202,215
050,26,073,"Michigan","Isabella County",5,76,398,196,202
050,26,073,"Michigan","Isabella County",5,77,272,135,137
050,26,073,"Michigan","Isabella County",5,78,257,110,147
050,26,073,"Michigan","Isabella County",5,79,260,117,143
050,26,073,"Michigan","Isabella County",5,80,264,123,141
050,26,073,"Michigan","Isabella County",5,81,204,97,107
050,26,073,"Michigan","Isabella County",5,82,188,80,108
050,26,073,"Michigan","Isabella County",5,83,163,66,97
050,26,073,"Michigan","Isabella County",5,84,161,76,85
050,26,073,"Michigan","Isabella County",5,85,834,299,535
050,26,075,"Michigan","Jackson County",1,0,1692,864,828
050,26,075,"Michigan","Jackson County",1,1,1708,857,851
050,26,075,"Michigan","Jackson County",1,2,1785,904,881
050,26,075,"Michigan","Jackson County",1,3,1789,908,881
050,26,075,"Michigan","Jackson County",1,4,1863,936,927
050,26,075,"Michigan","Jackson County",1,5,1919,1005,914
050,26,075,"Michigan","Jackson County",1,6,1827,949,878
050,26,075,"Michigan","Jackson County",1,7,1862,965,897
050,26,075,"Michigan","Jackson County",1,8,1891,993,898
050,26,075,"Michigan","Jackson County",1,9,1872,970,902
050,26,075,"Michigan","Jackson County",1,10,1929,987,942
050,26,075,"Michigan","Jackson County",1,11,1948,1001,947
050,26,075,"Michigan","Jackson County",1,12,2054,1065,989
050,26,075,"Michigan","Jackson County",1,13,2018,1054,964
050,26,075,"Michigan","Jackson County",1,14,1997,1039,958
050,26,075,"Michigan","Jackson County",1,15,2041,1051,990
050,26,075,"Michigan","Jackson County",1,16,2098,1063,1035
050,26,075,"Michigan","Jackson County",1,17,2077,1068,1009
050,26,075,"Michigan","Jackson County",1,18,2043,1043,1000
050,26,075,"Michigan","Jackson County",1,19,2040,1053,987
050,26,075,"Michigan","Jackson County",1,20,2075,1077,998
050,26,075,"Michigan","Jackson County",1,21,2084,1132,952
050,26,075,"Michigan","Jackson County",1,22,2011,1094,917
050,26,075,"Michigan","Jackson County",1,23,1904,1036,868
050,26,075,"Michigan","Jackson County",1,24,1951,1045,906
050,26,075,"Michigan","Jackson County",1,25,1979,1094,885
050,26,075,"Michigan","Jackson County",1,26,2012,1088,924
050,26,075,"Michigan","Jackson County",1,27,2052,1095,957
050,26,075,"Michigan","Jackson County",1,28,2269,1221,1048
050,26,075,"Michigan","Jackson County",1,29,2308,1239,1069
050,26,075,"Michigan","Jackson County",1,30,2169,1148,1021
050,26,075,"Michigan","Jackson County",1,31,2071,1106,965
050,26,075,"Michigan","Jackson County",1,32,1940,1012,928
050,26,075,"Michigan","Jackson County",1,33,1808,950,858
050,26,075,"Michigan","Jackson County",1,34,1919,1030,889
050,26,075,"Michigan","Jackson County",1,35,1867,1007,860
050,26,075,"Michigan","Jackson County",1,36,1813,968,845
050,26,075,"Michigan","Jackson County",1,37,1912,1039,873
050,26,075,"Michigan","Jackson County",1,38,1918,1040,878
050,26,075,"Michigan","Jackson County",1,39,1920,1030,890
050,26,075,"Michigan","Jackson County",1,40,1927,1047,880
050,26,075,"Michigan","Jackson County",1,41,1929,1062,867
050,26,075,"Michigan","Jackson County",1,42,1902,1051,851
050,26,075,"Michigan","Jackson County",1,43,1835,1007,828
050,26,075,"Michigan","Jackson County",1,44,1786,984,802
050,26,075,"Michigan","Jackson County",1,45,1806,1007,799
050,26,075,"Michigan","Jackson County",1,46,1812,988,824
050,26,075,"Michigan","Jackson County",1,47,1903,1032,871
050,26,075,"Michigan","Jackson County",1,48,2054,1087,967
050,26,075,"Michigan","Jackson County",1,49,2257,1178,1079
050,26,075,"Michigan","Jackson County",1,50,2156,1101,1055
050,26,075,"Michigan","Jackson County",1,51,2116,1102,1014
050,26,075,"Michigan","Jackson County",1,52,2092,1114,978
050,26,075,"Michigan","Jackson County",1,53,2128,1114,1014
050,26,075,"Michigan","Jackson County",1,54,2116,1107,1009
050,26,075,"Michigan","Jackson County",1,55,2230,1134,1096
050,26,075,"Michigan","Jackson County",1,56,2321,1164,1157
050,26,075,"Michigan","Jackson County",1,57,2343,1161,1182
050,26,075,"Michigan","Jackson County",1,58,2393,1221,1172
050,26,075,"Michigan","Jackson County",1,59,2458,1289,1169
050,26,075,"Michigan","Jackson County",1,60,2360,1205,1155
050,26,075,"Michigan","Jackson County",1,61,2321,1159,1162
050,26,075,"Michigan","Jackson County",1,62,2342,1188,1154
050,26,075,"Michigan","Jackson County",1,63,2266,1127,1139
050,26,075,"Michigan","Jackson County",1,64,2191,1041,1150
050,26,075,"Michigan","Jackson County",1,65,2103,995,1108
050,26,075,"Michigan","Jackson County",1,66,1993,974,1019
050,26,075,"Michigan","Jackson County",1,67,1970,984,986
050,26,075,"Michigan","Jackson County",1,68,1954,958,996
050,26,075,"Michigan","Jackson County",1,69,1814,889,925
050,26,075,"Michigan","Jackson County",1,70,1669,837,832
050,26,075,"Michigan","Jackson County",1,71,1615,793,822
050,26,075,"Michigan","Jackson County",1,72,1604,754,850
050,26,075,"Michigan","Jackson County",1,73,1611,751,860
050,26,075,"Michigan","Jackson County",1,74,1100,537,563
050,26,075,"Michigan","Jackson County",1,75,1116,540,576
050,26,075,"Michigan","Jackson County",1,76,1127,530,597
050,26,075,"Michigan","Jackson County",1,77,1129,540,589
050,26,075,"Michigan","Jackson County",1,78,945,427,518
050,26,075,"Michigan","Jackson County",1,79,800,344,456
050,26,075,"Michigan","Jackson County",1,80,700,296,404
050,26,075,"Michigan","Jackson County",1,81,669,292,377
050,26,075,"Michigan","Jackson County",1,82,654,270,384
050,26,075,"Michigan","Jackson County",1,83,571,241,330
050,26,075,"Michigan","Jackson County",1,84,542,243,299
050,26,075,"Michigan","Jackson County",1,85,3205,1170,2035
050,26,075,"Michigan","Jackson County",2,0,1671,857,814
050,26,075,"Michigan","Jackson County",2,1,1703,859,844
050,26,075,"Michigan","Jackson County",2,2,1764,891,873
050,26,075,"Michigan","Jackson County",2,3,1780,904,876
050,26,075,"Michigan","Jackson County",2,4,1844,931,913
050,26,075,"Michigan","Jackson County",2,5,1903,986,917
050,26,075,"Michigan","Jackson County",2,6,1858,968,890
050,26,075,"Michigan","Jackson County",2,7,1857,959,898
050,26,075,"Michigan","Jackson County",2,8,1881,983,898
050,26,075,"Michigan","Jackson County",2,9,1872,973,899
050,26,075,"Michigan","Jackson County",2,10,1910,978,932
050,26,075,"Michigan","Jackson County",2,11,1938,995,943
050,26,075,"Michigan","Jackson County",2,12,2038,1054,984
050,26,075,"Michigan","Jackson County",2,13,2020,1052,968
050,26,075,"Michigan","Jackson County",2,14,1996,1040,956
050,26,075,"Michigan","Jackson County",2,15,2034,1052,982
050,26,075,"Michigan","Jackson County",2,16,2084,1062,1022
050,26,075,"Michigan","Jackson County",2,17,2082,1069,1013
050,26,075,"Michigan","Jackson County",2,18,2038,1043,995
050,26,075,"Michigan","Jackson County",2,19,2035,1042,993
050,26,075,"Michigan","Jackson County",2,20,2096,1087,1009
050,26,075,"Michigan","Jackson County",2,21,2080,1125,955
050,26,075,"Michigan","Jackson County",2,22,2016,1099,917
050,26,075,"Michigan","Jackson County",2,23,1912,1040,872
050,26,075,"Michigan","Jackson County",2,24,1940,1047,893
050,26,075,"Michigan","Jackson County",2,25,1972,1077,895
050,26,075,"Michigan","Jackson County",2,26,2005,1089,916
050,26,075,"Michigan","Jackson County",2,27,2045,1099,946
050,26,075,"Michigan","Jackson County",2,28,2229,1203,1026
050,26,075,"Michigan","Jackson County",2,29,2288,1229,1059
050,26,075,"Michigan","Jackson County",2,30,2216,1174,1042
050,26,075,"Michigan","Jackson County",2,31,2098,1119,979
050,26,075,"Michigan","Jackson County",2,32,1959,1027,932
050,26,075,"Michigan","Jackson County",2,33,1836,961,875
050,26,075,"Michigan","Jackson County",2,34,1894,1013,881
050,26,075,"Michigan","Jackson County",2,35,1884,1014,870
050,26,075,"Michigan","Jackson County",2,36,1818,971,847
050,26,075,"Michigan","Jackson County",2,37,1891,1025,866
050,26,075,"Michigan","Jackson County",2,38,1924,1045,879
050,26,075,"Michigan","Jackson County",2,39,1919,1034,885
050,26,075,"Michigan","Jackson County",2,40,1937,1052,885
050,26,075,"Michigan","Jackson County",2,41,1918,1050,868
050,26,075,"Michigan","Jackson County",2,42,1895,1047,848
050,26,075,"Michigan","Jackson County",2,43,1856,1017,839
050,26,075,"Michigan","Jackson County",2,44,1778,979,799
050,26,075,"Michigan","Jackson County",2,45,1805,1003,802
050,26,075,"Michigan","Jackson County",2,46,1809,995,814
050,26,075,"Michigan","Jackson County",2,47,1872,1015,857
050,26,075,"Michigan","Jackson County",2,48,2011,1067,944
050,26,075,"Michigan","Jackson County",2,49,2224,1166,1058
050,26,075,"Michigan","Jackson County",2,50,2173,1112,1061
050,26,075,"Michigan","Jackson County",2,51,2121,1101,1020
050,26,075,"Michigan","Jackson County",2,52,2090,1102,988
050,26,075,"Michigan","Jackson County",2,53,2120,1110,1010
050,26,075,"Michigan","Jackson County",2,54,2110,1103,1007
050,26,075,"Michigan","Jackson County",2,55,2189,1118,1071
050,26,075,"Michigan","Jackson County",2,56,2296,1152,1144
050,26,075,"Michigan","Jackson County",2,57,2335,1156,1179
050,26,075,"Michigan","Jackson County",2,58,2372,1201,1171
050,26,075,"Michigan","Jackson County",2,59,2452,1274,1178
050,26,075,"Michigan","Jackson County",2,60,2368,1217,1151
050,26,075,"Michigan","Jackson County",2,61,2313,1157,1156
050,26,075,"Michigan","Jackson County",2,62,2320,1171,1149
050,26,075,"Michigan","Jackson County",2,63,2301,1150,1151
050,26,075,"Michigan","Jackson County",2,64,2188,1053,1135
050,26,075,"Michigan","Jackson County",2,65,2110,998,1112
050,26,075,"Michigan","Jackson County",2,66,2007,970,1037
050,26,075,"Michigan","Jackson County",2,67,1965,975,990
050,26,075,"Michigan","Jackson County",2,68,1940,953,987
050,26,075,"Michigan","Jackson County",2,69,1843,897,946
050,26,075,"Michigan","Jackson County",2,70,1692,843,849
050,26,075,"Michigan","Jackson County",2,71,1615,791,824
050,26,075,"Michigan","Jackson County",2,72,1569,745,824
050,26,075,"Michigan","Jackson County",2,73,1682,784,898
050,26,075,"Michigan","Jackson County",2,74,1137,542,595
050,26,075,"Michigan","Jackson County",2,75,1107,536,571
050,26,075,"Michigan","Jackson County",2,76,1112,529,583
050,26,075,"Michigan","Jackson County",2,77,1141,545,596
050,26,075,"Michigan","Jackson County",2,78,966,444,522
050,26,075,"Michigan","Jackson County",2,79,818,353,465
050,26,075,"Michigan","Jackson County",2,80,716,302,414
050,26,075,"Michigan","Jackson County",2,81,664,288,376
050,26,075,"Michigan","Jackson County",2,82,641,270,371
050,26,075,"Michigan","Jackson County",2,83,577,242,335
050,26,075,"Michigan","Jackson County",2,84,537,236,301
050,26,075,"Michigan","Jackson County",2,85,3209,1174,2035
050,26,075,"Michigan","Jackson County",3,0,1643,846,797
050,26,075,"Michigan","Jackson County",3,1,1671,882,789
050,26,075,"Michigan","Jackson County",3,2,1738,872,866
050,26,075,"Michigan","Jackson County",3,3,1766,895,871
050,26,075,"Michigan","Jackson County",3,4,1791,903,888
050,26,075,"Michigan","Jackson County",3,5,1832,914,918
050,26,075,"Michigan","Jackson County",3,6,1909,991,918
050,26,075,"Michigan","Jackson County",3,7,1861,983,878
050,26,075,"Michigan","Jackson County",3,8,1847,954,893
050,26,075,"Michigan","Jackson County",3,9,1876,984,892
050,26,075,"Michigan","Jackson County",3,10,1873,978,895
050,26,075,"Michigan","Jackson County",3,11,1911,975,936
050,26,075,"Michigan","Jackson County",3,12,1971,1005,966
050,26,075,"Michigan","Jackson County",3,13,2059,1069,990
050,26,075,"Michigan","Jackson County",3,14,2011,1053,958
050,26,075,"Michigan","Jackson County",3,15,2004,1053,951
050,26,075,"Michigan","Jackson County",3,16,2035,1051,984
050,26,075,"Michigan","Jackson County",3,17,2094,1075,1019
050,26,075,"Michigan","Jackson County",3,18,2051,1080,971
050,26,075,"Michigan","Jackson County",3,19,1960,1003,957
050,26,075,"Michigan","Jackson County",3,20,2039,1070,969
050,26,075,"Michigan","Jackson County",3,21,2091,1134,957
050,26,075,"Michigan","Jackson County",3,22,2006,1112,894
050,26,075,"Michigan","Jackson County",3,23,1980,1101,879
050,26,075,"Michigan","Jackson County",3,24,1904,1027,877
050,26,075,"Michigan","Jackson County",3,25,1960,1049,911
050,26,075,"Michigan","Jackson County",3,26,1971,1087,884
050,26,075,"Michigan","Jackson County",3,27,2013,1098,915
050,26,075,"Michigan","Jackson County",3,28,2135,1163,972
050,26,075,"Michigan","Jackson County",3,29,2188,1193,995
050,26,075,"Michigan","Jackson County",3,30,2308,1252,1056
050,26,075,"Michigan","Jackson County",3,31,2240,1196,1044
050,26,075,"Michigan","Jackson County",3,32,2151,1149,1002
050,26,075,"Michigan","Jackson County",3,33,1919,1012,907
050,26,075,"Michigan","Jackson County",3,34,1859,983,876
050,26,075,"Michigan","Jackson County",3,35,1905,1018,887
050,26,075,"Michigan","Jackson County",3,36,1934,1050,884
050,26,075,"Michigan","Jackson County",3,37,1805,972,833
050,26,075,"Michigan","Jackson County",3,38,1940,1056,884
050,26,075,"Michigan","Jackson County",3,39,1955,1064,891
050,26,075,"Michigan","Jackson County",3,40,1951,1052,899
050,26,075,"Michigan","Jackson County",3,41,1921,1042,879
050,26,075,"Michigan","Jackson County",3,42,1937,1066,871
050,26,075,"Michigan","Jackson County",3,43,1885,1051,834
050,26,075,"Michigan","Jackson County",3,44,1824,1003,821
050,26,075,"Michigan","Jackson County",3,45,1786,988,798
050,26,075,"Michigan","Jackson County",3,46,1837,1030,807
050,26,075,"Michigan","Jackson County",3,47,1782,977,805
050,26,075,"Michigan","Jackson County",3,48,1862,1003,859
050,26,075,"Michigan","Jackson County",3,49,2025,1086,939
050,26,075,"Michigan","Jackson County",3,50,2183,1124,1059
050,26,075,"Michigan","Jackson County",3,51,2172,1123,1049
050,26,075,"Michigan","Jackson County",3,52,2133,1103,1030
050,26,075,"Michigan","Jackson County",3,53,2064,1085,979
050,26,075,"Michigan","Jackson County",3,54,2114,1108,1006
050,26,075,"Michigan","Jackson County",3,55,2077,1094,983
050,26,075,"Michigan","Jackson County",3,56,2176,1093,1083
050,26,075,"Michigan","Jackson County",3,57,2274,1133,1141
050,26,075,"Michigan","Jackson County",3,58,2304,1124,1180
050,26,075,"Michigan","Jackson County",3,59,2366,1208,1158
050,26,075,"Michigan","Jackson County",3,60,2410,1249,1161
050,26,075,"Michigan","Jackson County",3,61,2341,1208,1133
050,26,075,"Michigan","Jackson County",3,62,2291,1140,1151
050,26,075,"Michigan","Jackson County",3,63,2310,1159,1151
050,26,075,"Michigan","Jackson County",3,64,2243,1117,1126
050,26,075,"Michigan","Jackson County",3,65,2153,1044,1109
050,26,075,"Michigan","Jackson County",3,66,2061,964,1097
050,26,075,"Michigan","Jackson County",3,67,1981,955,1026
050,26,075,"Michigan","Jackson County",3,68,1908,935,973
050,26,075,"Michigan","Jackson County",3,69,1901,922,979
050,26,075,"Michigan","Jackson County",3,70,1796,869,927
050,26,075,"Michigan","Jackson County",3,71,1650,820,830
050,26,075,"Michigan","Jackson County",3,72,1580,767,813
050,26,075,"Michigan","Jackson County",3,73,1515,712,803
050,26,075,"Michigan","Jackson County",3,74,1634,750,884
050,26,075,"Michigan","Jackson County",3,75,1099,506,593
050,26,075,"Michigan","Jackson County",3,76,1054,501,553
050,26,075,"Michigan","Jackson County",3,77,1064,509,555
050,26,075,"Michigan","Jackson County",3,78,1084,513,571
050,26,075,"Michigan","Jackson County",3,79,911,417,494
050,26,075,"Michigan","Jackson County",3,80,778,329,449
050,26,075,"Michigan","Jackson County",3,81,685,292,393
050,26,075,"Michigan","Jackson County",3,82,620,270,350
050,26,075,"Michigan","Jackson County",3,83,592,245,347
050,26,075,"Michigan","Jackson County",3,84,513,220,293
050,26,075,"Michigan","Jackson County",3,85,3109,1166,1943
050,26,075,"Michigan","Jackson County",4,0,1640,870,770
050,26,075,"Michigan","Jackson County",4,1,1653,850,803
050,26,075,"Michigan","Jackson County",4,2,1713,889,824
050,26,075,"Michigan","Jackson County",4,3,1746,871,875
050,26,075,"Michigan","Jackson County",4,4,1788,927,861
050,26,075,"Michigan","Jackson County",4,5,1780,896,884
050,26,075,"Michigan","Jackson County",4,6,1842,927,915
050,26,075,"Michigan","Jackson County",4,7,1897,972,925
050,26,075,"Michigan","Jackson County",4,8,1844,972,872
050,26,075,"Michigan","Jackson County",4,9,1825,942,883
050,26,075,"Michigan","Jackson County",4,10,1897,992,905
050,26,075,"Michigan","Jackson County",4,11,1854,975,879
050,26,075,"Michigan","Jackson County",4,12,1930,982,948
050,26,075,"Michigan","Jackson County",4,13,1947,1000,947
050,26,075,"Michigan","Jackson County",4,14,2067,1079,988
050,26,075,"Michigan","Jackson County",4,15,1999,1045,954
050,26,075,"Michigan","Jackson County",4,16,2014,1062,952
050,26,075,"Michigan","Jackson County",4,17,2031,1056,975
050,26,075,"Michigan","Jackson County",4,18,2018,1047,971
050,26,075,"Michigan","Jackson County",4,19,1925,1007,918
050,26,075,"Michigan","Jackson County",4,20,1986,1030,956
050,26,075,"Michigan","Jackson County",4,21,2044,1114,930
050,26,075,"Michigan","Jackson County",4,22,2052,1117,935
050,26,075,"Michigan","Jackson County",4,23,1910,1067,843
050,26,075,"Michigan","Jackson County",4,24,1992,1110,882
050,26,075,"Michigan","Jackson County",4,25,1891,1008,883
050,26,075,"Michigan","Jackson County",4,26,1961,1047,914
050,26,075,"Michigan","Jackson County",4,27,1999,1113,886
050,26,075,"Michigan","Jackson County",4,28,2033,1103,930
050,26,075,"Michigan","Jackson County",4,29,2117,1140,977
050,26,075,"Michigan","Jackson County",4,30,2187,1196,991
050,26,075,"Michigan","Jackson County",4,31,2317,1252,1065
050,26,075,"Michigan","Jackson County",4,32,2233,1174,1059
050,26,075,"Michigan","Jackson County",4,33,2130,1155,975
050,26,075,"Michigan","Jackson County",4,34,1959,1028,931
050,26,075,"Michigan","Jackson County",4,35,1849,961,888
050,26,075,"Michigan","Jackson County",4,36,1910,1021,889
050,26,075,"Michigan","Jackson County",4,37,1926,1034,892
050,26,075,"Michigan","Jackson County",4,38,1862,1018,844
050,26,075,"Michigan","Jackson County",4,39,1960,1061,899
050,26,075,"Michigan","Jackson County",4,40,2001,1092,909
050,26,075,"Michigan","Jackson County",4,41,1943,1040,903
050,26,075,"Michigan","Jackson County",4,42,1907,1019,888
050,26,075,"Michigan","Jackson County",4,43,1922,1057,865
050,26,075,"Michigan","Jackson County",4,44,1864,1031,833
050,26,075,"Michigan","Jackson County",4,45,1842,1016,826
050,26,075,"Michigan","Jackson County",4,46,1803,1009,794
050,26,075,"Michigan","Jackson County",4,47,1804,1004,800
050,26,075,"Michigan","Jackson County",4,48,1757,960,797
050,26,075,"Michigan","Jackson County",4,49,1873,1018,855
050,26,075,"Michigan","Jackson County",4,50,1970,1035,935
050,26,075,"Michigan","Jackson County",4,51,2197,1123,1074
050,26,075,"Michigan","Jackson County",4,52,2189,1130,1059
050,26,075,"Michigan","Jackson County",4,53,2117,1086,1031
050,26,075,"Michigan","Jackson County",4,54,2074,1090,984
050,26,075,"Michigan","Jackson County",4,55,2083,1085,998
050,26,075,"Michigan","Jackson County",4,56,2057,1081,976
050,26,075,"Michigan","Jackson County",4,57,2123,1062,1061
050,26,075,"Michigan","Jackson County",4,58,2232,1105,1127
050,26,075,"Michigan","Jackson County",4,59,2276,1112,1164
050,26,075,"Michigan","Jackson County",4,60,2305,1182,1123
050,26,075,"Michigan","Jackson County",4,61,2376,1223,1153
050,26,075,"Michigan","Jackson County",4,62,2325,1182,1143
050,26,075,"Michigan","Jackson County",4,63,2273,1136,1137
050,26,075,"Michigan","Jackson County",4,64,2277,1141,1136
050,26,075,"Michigan","Jackson County",4,65,2212,1100,1112
050,26,075,"Michigan","Jackson County",4,66,2121,1028,1093
050,26,075,"Michigan","Jackson County",4,67,2020,957,1063
050,26,075,"Michigan","Jackson County",4,68,1941,939,1002
050,26,075,"Michigan","Jackson County",4,69,1862,904,958
050,26,075,"Michigan","Jackson County",4,70,1861,895,966
050,26,075,"Michigan","Jackson County",4,71,1745,853,892
050,26,075,"Michigan","Jackson County",4,72,1592,787,805
050,26,075,"Michigan","Jackson County",4,73,1530,741,789
050,26,075,"Michigan","Jackson County",4,74,1464,673,791
050,26,075,"Michigan","Jackson County",4,75,1601,722,879
050,26,075,"Michigan","Jackson County",4,76,1059,476,583
050,26,075,"Michigan","Jackson County",4,77,1009,481,528
050,26,075,"Michigan","Jackson County",4,78,1022,481,541
050,26,075,"Michigan","Jackson County",4,79,1017,473,544
050,26,075,"Michigan","Jackson County",4,80,855,385,470
050,26,075,"Michigan","Jackson County",4,81,736,313,423
050,26,075,"Michigan","Jackson County",4,82,634,268,366
050,26,075,"Michigan","Jackson County",4,83,576,248,328
050,26,075,"Michigan","Jackson County",4,84,526,217,309
050,26,075,"Michigan","Jackson County",4,85,3057,1154,1903
050,26,075,"Michigan","Jackson County",5,0,1593,848,745
050,26,075,"Michigan","Jackson County",5,1,1659,881,778
050,26,075,"Michigan","Jackson County",5,2,1635,836,799
050,26,075,"Michigan","Jackson County",5,3,1707,888,819
050,26,075,"Michigan","Jackson County",5,4,1735,871,864
050,26,075,"Michigan","Jackson County",5,5,1752,909,843
050,26,075,"Michigan","Jackson County",5,6,1799,901,898
050,26,075,"Michigan","Jackson County",5,7,1830,925,905
050,26,075,"Michigan","Jackson County",5,8,1881,962,919
050,26,075,"Michigan","Jackson County",5,9,1869,969,900
050,26,075,"Michigan","Jackson County",5,10,1857,950,907
050,26,075,"Michigan","Jackson County",5,11,1879,971,908
050,26,075,"Michigan","Jackson County",5,12,1853,980,873
050,26,075,"Michigan","Jackson County",5,13,1925,973,952
050,26,075,"Michigan","Jackson County",5,14,1946,1001,945
050,26,075,"Michigan","Jackson County",5,15,2054,1067,987
050,26,075,"Michigan","Jackson County",5,16,2008,1045,963
050,26,075,"Michigan","Jackson County",5,17,2020,1070,950
050,26,075,"Michigan","Jackson County",5,18,1999,1040,959
050,26,075,"Michigan","Jackson County",5,19,1947,995,952
050,26,075,"Michigan","Jackson County",5,20,2013,1066,947
050,26,075,"Michigan","Jackson County",5,21,2020,1092,928
050,26,075,"Michigan","Jackson County",5,22,2019,1090,929
050,26,075,"Michigan","Jackson County",5,23,1957,1073,884
050,26,075,"Michigan","Jackson County",5,24,1922,1064,858
050,26,075,"Michigan","Jackson County",5,25,1935,1080,855
050,26,075,"Michigan","Jackson County",5,26,1877,993,884
050,26,075,"Michigan","Jackson County",5,27,1951,1043,908
050,26,075,"Michigan","Jackson County",5,28,2009,1110,899
050,26,075,"Michigan","Jackson County",5,29,2020,1081,939
050,26,075,"Michigan","Jackson County",5,30,2125,1148,977
050,26,075,"Michigan","Jackson County",5,31,2211,1197,1014
050,26,075,"Michigan","Jackson County",5,32,2294,1232,1062
050,26,075,"Michigan","Jackson County",5,33,2220,1163,1057
050,26,075,"Michigan","Jackson County",5,34,2137,1152,985
050,26,075,"Michigan","Jackson County",5,35,1953,1024,929
050,26,075,"Michigan","Jackson County",5,36,1838,956,882
050,26,075,"Michigan","Jackson County",5,37,1909,1011,898
050,26,075,"Michigan","Jackson County",5,38,1960,1064,896
050,26,075,"Michigan","Jackson County",5,39,1876,1032,844
050,26,075,"Michigan","Jackson County",5,40,1973,1082,891
050,26,075,"Michigan","Jackson County",5,41,1961,1053,908
050,26,075,"Michigan","Jackson County",5,42,1936,1033,903
050,26,075,"Michigan","Jackson County",5,43,1871,994,877
050,26,075,"Michigan","Jackson County",5,44,1893,1028,865
050,26,075,"Michigan","Jackson County",5,45,1867,1025,842
050,26,075,"Michigan","Jackson County",5,46,1846,1026,820
050,26,075,"Michigan","Jackson County",5,47,1775,990,785
050,26,075,"Michigan","Jackson County",5,48,1784,973,811
050,26,075,"Michigan","Jackson County",5,49,1760,968,792
050,26,075,"Michigan","Jackson County",5,50,1832,972,860
050,26,075,"Michigan","Jackson County",5,51,1988,1044,944
050,26,075,"Michigan","Jackson County",5,52,2199,1122,1077
050,26,075,"Michigan","Jackson County",5,53,2189,1118,1071
050,26,075,"Michigan","Jackson County",5,54,2108,1069,1039
050,26,075,"Michigan","Jackson County",5,55,2045,1063,982
050,26,075,"Michigan","Jackson County",5,56,2066,1072,994
050,26,075,"Michigan","Jackson County",5,57,2037,1064,973
050,26,075,"Michigan","Jackson County",5,58,2112,1051,1061
050,26,075,"Michigan","Jackson County",5,59,2228,1097,1131
050,26,075,"Michigan","Jackson County",5,60,2225,1089,1136
050,26,075,"Michigan","Jackson County",5,61,2312,1174,1138
050,26,075,"Michigan","Jackson County",5,62,2365,1204,1161
050,26,075,"Michigan","Jackson County",5,63,2310,1167,1143
050,26,075,"Michigan","Jackson County",5,64,2224,1109,1115
050,26,075,"Michigan","Jackson County",5,65,2229,1133,1096
050,26,075,"Michigan","Jackson County",5,66,2179,1073,1106
050,26,075,"Michigan","Jackson County",5,67,2077,1015,1062
050,26,075,"Michigan","Jackson County",5,68,1987,936,1051
050,26,075,"Michigan","Jackson County",5,69,1916,918,998
050,26,075,"Michigan","Jackson County",5,70,1819,878,941
050,26,075,"Michigan","Jackson County",5,71,1826,876,950
050,26,075,"Michigan","Jackson County",5,72,1696,818,878
050,26,075,"Michigan","Jackson County",5,73,1530,755,775
050,26,075,"Michigan","Jackson County",5,74,1481,705,776
050,26,075,"Michigan","Jackson County",5,75,1431,645,786
050,26,075,"Michigan","Jackson County",5,76,1542,688,854
050,26,075,"Michigan","Jackson County",5,77,1022,461,561
050,26,075,"Michigan","Jackson County",5,78,968,455,513
050,26,075,"Michigan","Jackson County",5,79,960,447,513
050,26,075,"Michigan","Jackson County",5,80,965,434,531
050,26,075,"Michigan","Jackson County",5,81,820,376,444
050,26,075,"Michigan","Jackson County",5,82,696,299,397
050,26,075,"Michigan","Jackson County",5,83,596,248,348
050,26,075,"Michigan","Jackson County",5,84,522,226,296
050,26,075,"Michigan","Jackson County",5,85,3062,1157,1905
050,26,077,"Michigan","Kalamazoo County",1,0,2956,1501,1455
050,26,077,"Michigan","Kalamazoo County",1,1,2971,1503,1468
050,26,077,"Michigan","Kalamazoo County",1,2,3060,1575,1485
050,26,077,"Michigan","Kalamazoo County",1,3,3086,1603,1483
050,26,077,"Michigan","Kalamazoo County",1,4,3186,1640,1546
050,26,077,"Michigan","Kalamazoo County",1,5,3180,1628,1552
050,26,077,"Michigan","Kalamazoo County",1,6,3170,1629,1541
050,26,077,"Michigan","Kalamazoo County",1,7,3142,1579,1563
050,26,077,"Michigan","Kalamazoo County",1,8,3144,1635,1509
050,26,077,"Michigan","Kalamazoo County",1,9,3138,1598,1540
050,26,077,"Michigan","Kalamazoo County",1,10,3210,1619,1591
050,26,077,"Michigan","Kalamazoo County",1,11,3231,1687,1544
050,26,077,"Michigan","Kalamazoo County",1,12,3365,1711,1654
050,26,077,"Michigan","Kalamazoo County",1,13,3315,1713,1602
050,26,077,"Michigan","Kalamazoo County",1,14,3271,1693,1578
050,26,077,"Michigan","Kalamazoo County",1,15,3236,1676,1560
050,26,077,"Michigan","Kalamazoo County",1,16,3182,1612,1570
050,26,077,"Michigan","Kalamazoo County",1,17,3167,1632,1535
050,26,077,"Michigan","Kalamazoo County",1,18,3949,1973,1976
050,26,077,"Michigan","Kalamazoo County",1,19,4907,2459,2448
050,26,077,"Michigan","Kalamazoo County",1,20,6305,2947,3358
050,26,077,"Michigan","Kalamazoo County",1,21,7250,3412,3838
050,26,077,"Michigan","Kalamazoo County",1,22,6243,3034,3209
050,26,077,"Michigan","Kalamazoo County",1,23,5978,2991,2987
050,26,077,"Michigan","Kalamazoo County",1,24,4725,2417,2308
050,26,077,"Michigan","Kalamazoo County",1,25,4190,2106,2084
050,26,077,"Michigan","Kalamazoo County",1,26,3860,1919,1941
050,26,077,"Michigan","Kalamazoo County",1,27,3667,1875,1792
050,26,077,"Michigan","Kalamazoo County",1,28,3655,1807,1848
050,26,077,"Michigan","Kalamazoo County",1,29,3746,1879,1867
050,26,077,"Michigan","Kalamazoo County",1,30,3459,1755,1704
050,26,077,"Michigan","Kalamazoo County",1,31,3289,1687,1602
050,26,077,"Michigan","Kalamazoo County",1,32,3329,1660,1669
050,26,077,"Michigan","Kalamazoo County",1,33,3092,1582,1510
050,26,077,"Michigan","Kalamazoo County",1,34,3183,1622,1561
050,26,077,"Michigan","Kalamazoo County",1,35,3300,1639,1661
050,26,077,"Michigan","Kalamazoo County",1,36,3265,1640,1625
050,26,077,"Michigan","Kalamazoo County",1,37,3256,1645,1611
050,26,077,"Michigan","Kalamazoo County",1,38,3260,1655,1605
050,26,077,"Michigan","Kalamazoo County",1,39,3275,1659,1616
050,26,077,"Michigan","Kalamazoo County",1,40,3214,1598,1616
050,26,077,"Michigan","Kalamazoo County",1,41,3117,1566,1551
050,26,077,"Michigan","Kalamazoo County",1,42,3095,1553,1542
050,26,077,"Michigan","Kalamazoo County",1,43,2849,1385,1464
050,26,077,"Michigan","Kalamazoo County",1,44,2753,1381,1372
050,26,077,"Michigan","Kalamazoo County",1,45,2736,1384,1352
050,26,077,"Michigan","Kalamazoo County",1,46,2598,1274,1324
050,26,077,"Michigan","Kalamazoo County",1,47,2732,1361,1371
050,26,077,"Michigan","Kalamazoo County",1,48,2916,1460,1456
050,26,077,"Michigan","Kalamazoo County",1,49,3099,1537,1562
050,26,077,"Michigan","Kalamazoo County",1,50,3008,1492,1516
050,26,077,"Michigan","Kalamazoo County",1,51,2891,1435,1456
050,26,077,"Michigan","Kalamazoo County",1,52,2753,1403,1350
050,26,077,"Michigan","Kalamazoo County",1,53,2757,1370,1387
050,26,077,"Michigan","Kalamazoo County",1,54,2726,1348,1378
050,26,077,"Michigan","Kalamazoo County",1,55,2958,1443,1515
050,26,077,"Michigan","Kalamazoo County",1,56,2979,1443,1536
050,26,077,"Michigan","Kalamazoo County",1,57,3004,1433,1571
050,26,077,"Michigan","Kalamazoo County",1,58,3051,1459,1592
050,26,077,"Michigan","Kalamazoo County",1,59,3096,1512,1584
050,26,077,"Michigan","Kalamazoo County",1,60,3058,1517,1541
050,26,077,"Michigan","Kalamazoo County",1,61,3013,1505,1508
050,26,077,"Michigan","Kalamazoo County",1,62,3095,1473,1622
050,26,077,"Michigan","Kalamazoo County",1,63,3040,1441,1599
050,26,077,"Michigan","Kalamazoo County",1,64,2928,1395,1533
050,26,077,"Michigan","Kalamazoo County",1,65,2802,1339,1463
050,26,077,"Michigan","Kalamazoo County",1,66,2758,1312,1446
050,26,077,"Michigan","Kalamazoo County",1,67,2744,1288,1456
050,26,077,"Michigan","Kalamazoo County",1,68,2733,1272,1461
050,26,077,"Michigan","Kalamazoo County",1,69,2504,1187,1317
050,26,077,"Michigan","Kalamazoo County",1,70,2324,1063,1261
050,26,077,"Michigan","Kalamazoo County",1,71,2249,995,1254
050,26,077,"Michigan","Kalamazoo County",1,72,2223,1041,1182
050,26,077,"Michigan","Kalamazoo County",1,73,2172,1048,1124
050,26,077,"Michigan","Kalamazoo County",1,74,1488,673,815
050,26,077,"Michigan","Kalamazoo County",1,75,1490,657,833
050,26,077,"Michigan","Kalamazoo County",1,76,1536,691,845
050,26,077,"Michigan","Kalamazoo County",1,77,1502,661,841
050,26,077,"Michigan","Kalamazoo County",1,78,1303,573,730
050,26,077,"Michigan","Kalamazoo County",1,79,1151,495,656
050,26,077,"Michigan","Kalamazoo County",1,80,1049,443,606
050,26,077,"Michigan","Kalamazoo County",1,81,992,435,557
050,26,077,"Michigan","Kalamazoo County",1,82,838,356,482
050,26,077,"Michigan","Kalamazoo County",1,83,777,301,476
050,26,077,"Michigan","Kalamazoo County",1,84,727,301,426
050,26,077,"Michigan","Kalamazoo County",1,85,4656,1576,3080
050,26,077,"Michigan","Kalamazoo County",2,0,2954,1502,1452
050,26,077,"Michigan","Kalamazoo County",2,1,2961,1497,1464
050,26,077,"Michigan","Kalamazoo County",2,2,3036,1558,1478
050,26,077,"Michigan","Kalamazoo County",2,3,3075,1597,1478
050,26,077,"Michigan","Kalamazoo County",2,4,3163,1633,1530
050,26,077,"Michigan","Kalamazoo County",2,5,3191,1636,1555
050,26,077,"Michigan","Kalamazoo County",2,6,3174,1629,1545
050,26,077,"Michigan","Kalamazoo County",2,7,3148,1591,1557
050,26,077,"Michigan","Kalamazoo County",2,8,3142,1622,1520
050,26,077,"Michigan","Kalamazoo County",2,9,3136,1609,1527
050,26,077,"Michigan","Kalamazoo County",2,10,3188,1612,1576
050,26,077,"Michigan","Kalamazoo County",2,11,3214,1662,1552
050,26,077,"Michigan","Kalamazoo County",2,12,3339,1706,1633
050,26,077,"Michigan","Kalamazoo County",2,13,3317,1707,1610
050,26,077,"Michigan","Kalamazoo County",2,14,3277,1695,1582
050,26,077,"Michigan","Kalamazoo County",2,15,3241,1680,1561
050,26,077,"Michigan","Kalamazoo County",2,16,3200,1632,1568
050,26,077,"Michigan","Kalamazoo County",2,17,3178,1629,1549
050,26,077,"Michigan","Kalamazoo County",2,18,3925,1956,1969
050,26,077,"Michigan","Kalamazoo County",2,19,4911,2465,2446
050,26,077,"Michigan","Kalamazoo County",2,20,6380,2991,3389
050,26,077,"Michigan","Kalamazoo County",2,21,7216,3404,3812
050,26,077,"Michigan","Kalamazoo County",2,22,6230,3027,3203
050,26,077,"Michigan","Kalamazoo County",2,23,5940,2972,2968
050,26,077,"Michigan","Kalamazoo County",2,24,4711,2404,2307
050,26,077,"Michigan","Kalamazoo County",2,25,4173,2096,2077
050,26,077,"Michigan","Kalamazoo County",2,26,3863,1923,1940
050,26,077,"Michigan","Kalamazoo County",2,27,3648,1851,1797
050,26,077,"Michigan","Kalamazoo County",2,28,3658,1825,1833
050,26,077,"Michigan","Kalamazoo County",2,29,3721,1860,1861
050,26,077,"Michigan","Kalamazoo County",2,30,3544,1788,1756
050,26,077,"Michigan","Kalamazoo County",2,31,3329,1698,1631
050,26,077,"Michigan","Kalamazoo County",2,32,3303,1651,1652
050,26,077,"Michigan","Kalamazoo County",2,33,3147,1598,1549
050,26,077,"Michigan","Kalamazoo County",2,34,3161,1614,1547
050,26,077,"Michigan","Kalamazoo County",2,35,3299,1651,1648
050,26,077,"Michigan","Kalamazoo County",2,36,3252,1628,1624
050,26,077,"Michigan","Kalamazoo County",2,37,3255,1639,1616
050,26,077,"Michigan","Kalamazoo County",2,38,3272,1658,1614
050,26,077,"Michigan","Kalamazoo County",2,39,3269,1659,1610
050,26,077,"Michigan","Kalamazoo County",2,40,3247,1620,1627
050,26,077,"Michigan","Kalamazoo County",2,41,3130,1564,1566
050,26,077,"Michigan","Kalamazoo County",2,42,3081,1545,1536
050,26,077,"Michigan","Kalamazoo County",2,43,2927,1436,1491
050,26,077,"Michigan","Kalamazoo County",2,44,2752,1369,1383
050,26,077,"Michigan","Kalamazoo County",2,45,2748,1384,1364
050,26,077,"Michigan","Kalamazoo County",2,46,2613,1294,1319
050,26,077,"Michigan","Kalamazoo County",2,47,2694,1342,1352
050,26,077,"Michigan","Kalamazoo County",2,48,2867,1437,1430
050,26,077,"Michigan","Kalamazoo County",2,49,3064,1522,1542
050,26,077,"Michigan","Kalamazoo County",2,50,3026,1500,1526
050,26,077,"Michigan","Kalamazoo County",2,51,2902,1442,1460
050,26,077,"Michigan","Kalamazoo County",2,52,2773,1401,1372
050,26,077,"Michigan","Kalamazoo County",2,53,2748,1376,1372
050,26,077,"Michigan","Kalamazoo County",2,54,2729,1353,1376
050,26,077,"Michigan","Kalamazoo County",2,55,2896,1420,1476
050,26,077,"Michigan","Kalamazoo County",2,56,2974,1439,1535
050,26,077,"Michigan","Kalamazoo County",2,57,2988,1425,1563
050,26,077,"Michigan","Kalamazoo County",2,58,3032,1450,1582
050,26,077,"Michigan","Kalamazoo County",2,59,3094,1505,1589
050,26,077,"Michigan","Kalamazoo County",2,60,3045,1502,1543
050,26,077,"Michigan","Kalamazoo County",2,61,3005,1493,1512
050,26,077,"Michigan","Kalamazoo County",2,62,3061,1474,1587
050,26,077,"Michigan","Kalamazoo County",2,63,3070,1456,1614
050,26,077,"Michigan","Kalamazoo County",2,64,2929,1394,1535
050,26,077,"Michigan","Kalamazoo County",2,65,2820,1343,1477
050,26,077,"Michigan","Kalamazoo County",2,66,2764,1316,1448
050,26,077,"Michigan","Kalamazoo County",2,67,2737,1289,1448
050,26,077,"Michigan","Kalamazoo County",2,68,2715,1264,1451
050,26,077,"Michigan","Kalamazoo County",2,69,2565,1208,1357
050,26,077,"Michigan","Kalamazoo County",2,70,2356,1085,1271
050,26,077,"Michigan","Kalamazoo County",2,71,2261,1006,1255
050,26,077,"Michigan","Kalamazoo County",2,72,2177,1006,1171
050,26,077,"Michigan","Kalamazoo County",2,73,2277,1090,1187
050,26,077,"Michigan","Kalamazoo County",2,74,1546,712,834
050,26,077,"Michigan","Kalamazoo County",2,75,1486,658,828
050,26,077,"Michigan","Kalamazoo County",2,76,1492,666,826
050,26,077,"Michigan","Kalamazoo County",2,77,1536,680,856
050,26,077,"Michigan","Kalamazoo County",2,78,1321,578,743
050,26,077,"Michigan","Kalamazoo County",2,79,1167,509,658
050,26,077,"Michigan","Kalamazoo County",2,80,1062,451,611
050,26,077,"Michigan","Kalamazoo County",2,81,977,420,557
050,26,077,"Michigan","Kalamazoo County",2,82,860,364,496
050,26,077,"Michigan","Kalamazoo County",2,83,785,311,474
050,26,077,"Michigan","Kalamazoo County",2,84,712,291,421
050,26,077,"Michigan","Kalamazoo County",2,85,4644,1578,3066
050,26,077,"Michigan","Kalamazoo County",3,0,2620,1342,1278
050,26,077,"Michigan","Kalamazoo County",3,1,2895,1451,1444
050,26,077,"Michigan","Kalamazoo County",3,2,2945,1486,1459
050,26,077,"Michigan","Kalamazoo County",3,3,3055,1573,1482
050,26,077,"Michigan","Kalamazoo County",3,4,3084,1616,1468
050,26,077,"Michigan","Kalamazoo County",3,5,3115,1623,1492
050,26,077,"Michigan","Kalamazoo County",3,6,3172,1639,1533
050,26,077,"Michigan","Kalamazoo County",3,7,3158,1653,1505
050,26,077,"Michigan","Kalamazoo County",3,8,3110,1568,1542
050,26,077,"Michigan","Kalamazoo County",3,9,3125,1609,1516
050,26,077,"Michigan","Kalamazoo County",3,10,3165,1620,1545
050,26,077,"Michigan","Kalamazoo County",3,11,3168,1591,1577
050,26,077,"Michigan","Kalamazoo County",3,12,3206,1650,1556
050,26,077,"Michigan","Kalamazoo County",3,13,3281,1692,1589
050,26,077,"Michigan","Kalamazoo County",3,14,3303,1691,1612
050,26,077,"Michigan","Kalamazoo County",3,15,3272,1691,1581
050,26,077,"Michigan","Kalamazoo County",3,16,3225,1664,1561
050,26,077,"Michigan","Kalamazoo County",3,17,3206,1631,1575
050,26,077,"Michigan","Kalamazoo County",3,18,3755,1870,1885
050,26,077,"Michigan","Kalamazoo County",3,19,4671,2351,2320
050,26,077,"Michigan","Kalamazoo County",3,20,6269,2961,3308
050,26,077,"Michigan","Kalamazoo County",3,21,7094,3351,3743
050,26,077,"Michigan","Kalamazoo County",3,22,6117,2958,3159
050,26,077,"Michigan","Kalamazoo County",3,23,5799,2908,2891
050,26,077,"Michigan","Kalamazoo County",3,24,4723,2404,2319
050,26,077,"Michigan","Kalamazoo County",3,25,4148,2082,2066
050,26,077,"Michigan","Kalamazoo County",3,26,3868,1942,1926
050,26,077,"Michigan","Kalamazoo County",3,27,3605,1803,1802
050,26,077,"Michigan","Kalamazoo County",3,28,3559,1794,1765
050,26,077,"Michigan","Kalamazoo County",3,29,3611,1780,1831
050,26,077,"Michigan","Kalamazoo County",3,30,3670,1823,1847
050,26,077,"Michigan","Kalamazoo County",3,31,3551,1808,1743
050,26,077,"Michigan","Kalamazoo County",3,32,3306,1682,1624
050,26,077,"Michigan","Kalamazoo County",3,33,3259,1622,1637
050,26,077,"Michigan","Kalamazoo County",3,34,3140,1600,1540
050,26,077,"Michigan","Kalamazoo County",3,35,3162,1621,1541
050,26,077,"Michigan","Kalamazoo County",3,36,3292,1676,1616
050,26,077,"Michigan","Kalamazoo County",3,37,3210,1603,1607
050,26,077,"Michigan","Kalamazoo County",3,38,3219,1631,1588
050,26,077,"Michigan","Kalamazoo County",3,39,3231,1631,1600
050,26,077,"Michigan","Kalamazoo County",3,40,3263,1646,1617
050,26,077,"Michigan","Kalamazoo County",3,41,3245,1621,1624
050,26,077,"Michigan","Kalamazoo County",3,42,3112,1547,1565
050,26,077,"Michigan","Kalamazoo County",3,43,3069,1541,1528
050,26,077,"Michigan","Kalamazoo County",3,44,2898,1416,1482
050,26,077,"Michigan","Kalamazoo County",3,45,2711,1336,1375
050,26,077,"Michigan","Kalamazoo County",3,46,2736,1380,1356
050,26,077,"Michigan","Kalamazoo County",3,47,2610,1293,1317
050,26,077,"Michigan","Kalamazoo County",3,48,2687,1335,1352
050,26,077,"Michigan","Kalamazoo County",3,49,2837,1422,1415
050,26,077,"Michigan","Kalamazoo County",3,50,3009,1487,1522
050,26,077,"Michigan","Kalamazoo County",3,51,3015,1497,1518
050,26,077,"Michigan","Kalamazoo County",3,52,2860,1419,1441
050,26,077,"Michigan","Kalamazoo County",3,53,2731,1380,1351
050,26,077,"Michigan","Kalamazoo County",3,54,2701,1346,1355
050,26,077,"Michigan","Kalamazoo County",3,55,2727,1354,1373
050,26,077,"Michigan","Kalamazoo County",3,56,2870,1396,1474
050,26,077,"Michigan","Kalamazoo County",3,57,2924,1398,1526
050,26,077,"Michigan","Kalamazoo County",3,58,2951,1396,1555
050,26,077,"Michigan","Kalamazoo County",3,59,2949,1403,1546
050,26,077,"Michigan","Kalamazoo County",3,60,3049,1488,1561
050,26,077,"Michigan","Kalamazoo County",3,61,2992,1467,1525
050,26,077,"Michigan","Kalamazoo County",3,62,2970,1477,1493
050,26,077,"Michigan","Kalamazoo County",3,63,2968,1431,1537
050,26,077,"Michigan","Kalamazoo County",3,64,3022,1424,1598
050,26,077,"Michigan","Kalamazoo County",3,65,2820,1317,1503
050,26,077,"Michigan","Kalamazoo County",3,66,2766,1306,1460
050,26,077,"Michigan","Kalamazoo County",3,67,2716,1290,1426
050,26,077,"Michigan","Kalamazoo County",3,68,2713,1276,1437
050,26,077,"Michigan","Kalamazoo County",3,69,2653,1240,1413
050,26,077,"Michigan","Kalamazoo County",3,70,2529,1186,1343
050,26,077,"Michigan","Kalamazoo County",3,71,2311,1061,1250
050,26,077,"Michigan","Kalamazoo County",3,72,2207,979,1228
050,26,077,"Michigan","Kalamazoo County",3,73,2115,965,1150
050,26,077,"Michigan","Kalamazoo County",3,74,2215,1045,1170
050,26,077,"Michigan","Kalamazoo County",3,75,1510,692,818
050,26,077,"Michigan","Kalamazoo County",3,76,1425,633,792
050,26,077,"Michigan","Kalamazoo County",3,77,1443,636,807
050,26,077,"Michigan","Kalamazoo County",3,78,1487,659,828
050,26,077,"Michigan","Kalamazoo County",3,79,1258,550,708
050,26,077,"Michigan","Kalamazoo County",3,80,1117,481,636
050,26,077,"Michigan","Kalamazoo County",3,81,1010,421,589
050,26,077,"Michigan","Kalamazoo County",3,82,897,377,520
050,26,077,"Michigan","Kalamazoo County",3,83,819,342,477
050,26,077,"Michigan","Kalamazoo County",3,84,715,292,423
050,26,077,"Michigan","Kalamazoo County",3,85,4527,1542,2985
050,26,077,"Michigan","Kalamazoo County",4,0,2731,1426,1305
050,26,077,"Michigan","Kalamazoo County",4,1,2609,1325,1284
050,26,077,"Michigan","Kalamazoo County",4,2,2911,1457,1454
050,26,077,"Michigan","Kalamazoo County",4,3,2935,1504,1431
050,26,077,"Michigan","Kalamazoo County",4,4,3067,1583,1484
050,26,077,"Michigan","Kalamazoo County",4,5,3067,1614,1453
050,26,077,"Michigan","Kalamazoo County",4,6,3112,1608,1504
050,26,077,"Michigan","Kalamazoo County",4,7,3171,1627,1544
050,26,077,"Michigan","Kalamazoo County",4,8,3160,1654,1506
050,26,077,"Michigan","Kalamazoo County",4,9,3145,1581,1564
050,26,077,"Michigan","Kalamazoo County",4,10,3123,1609,1514
050,26,077,"Michigan","Kalamazoo County",4,11,3172,1616,1556
050,26,077,"Michigan","Kalamazoo County",4,12,3204,1606,1598
050,26,077,"Michigan","Kalamazoo County",4,13,3219,1671,1548
050,26,077,"Michigan","Kalamazoo County",4,14,3305,1691,1614
050,26,077,"Michigan","Kalamazoo County",4,15,3308,1688,1620
050,26,077,"Michigan","Kalamazoo County",4,16,3286,1690,1596
050,26,077,"Michigan","Kalamazoo County",4,17,3214,1635,1579
050,26,077,"Michigan","Kalamazoo County",4,18,3924,1932,1992
050,26,077,"Michigan","Kalamazoo County",4,19,4809,2434,2375
050,26,077,"Michigan","Kalamazoo County",4,20,6368,2999,3369
050,26,077,"Michigan","Kalamazoo County",4,21,7239,3432,3807
050,26,077,"Michigan","Kalamazoo County",4,22,6108,2987,3121
050,26,077,"Michigan","Kalamazoo County",4,23,5807,2910,2897
050,26,077,"Michigan","Kalamazoo County",4,24,4586,2338,2248
050,26,077,"Michigan","Kalamazoo County",4,25,4103,2041,2062
050,26,077,"Michigan","Kalamazoo County",4,26,3753,1870,1883
050,26,077,"Michigan","Kalamazoo County",4,27,3597,1800,1797
050,26,077,"Michigan","Kalamazoo County",4,28,3566,1803,1763
050,26,077,"Michigan","Kalamazoo County",4,29,3475,1736,1739
050,26,077,"Michigan","Kalamazoo County",4,30,3547,1742,1805
050,26,077,"Michigan","Kalamazoo County",4,31,3629,1804,1825
050,26,077,"Michigan","Kalamazoo County",4,32,3471,1757,1714
050,26,077,"Michigan","Kalamazoo County",4,33,3279,1650,1629
050,26,077,"Michigan","Kalamazoo County",4,34,3233,1606,1627
050,26,077,"Michigan","Kalamazoo County",4,35,3162,1594,1568
050,26,077,"Michigan","Kalamazoo County",4,36,3198,1634,1564
050,26,077,"Michigan","Kalamazoo County",4,37,3299,1674,1625
050,26,077,"Michigan","Kalamazoo County",4,38,3204,1613,1591
050,26,077,"Michigan","Kalamazoo County",4,39,3205,1629,1576
050,26,077,"Michigan","Kalamazoo County",4,40,3257,1630,1627
050,26,077,"Michigan","Kalamazoo County",4,41,3226,1622,1604
050,26,077,"Michigan","Kalamazoo County",4,42,3246,1622,1624
050,26,077,"Michigan","Kalamazoo County",4,43,3080,1522,1558
050,26,077,"Michigan","Kalamazoo County",4,44,3051,1516,1535
050,26,077,"Michigan","Kalamazoo County",4,45,2878,1409,1469
050,26,077,"Michigan","Kalamazoo County",4,46,2714,1355,1359
050,26,077,"Michigan","Kalamazoo County",4,47,2781,1410,1371
050,26,077,"Michigan","Kalamazoo County",4,48,2572,1270,1302
050,26,077,"Michigan","Kalamazoo County",4,49,2674,1325,1349
050,26,077,"Michigan","Kalamazoo County",4,50,2820,1424,1396
050,26,077,"Michigan","Kalamazoo County",4,51,2975,1470,1505
050,26,077,"Michigan","Kalamazoo County",4,52,2968,1478,1490
050,26,077,"Michigan","Kalamazoo County",4,53,2817,1387,1430
050,26,077,"Michigan","Kalamazoo County",4,54,2707,1364,1343
050,26,077,"Michigan","Kalamazoo County",4,55,2692,1345,1347
050,26,077,"Michigan","Kalamazoo County",4,56,2694,1332,1362
050,26,077,"Michigan","Kalamazoo County",4,57,2790,1338,1452
050,26,077,"Michigan","Kalamazoo County",4,58,2900,1390,1510
050,26,077,"Michigan","Kalamazoo County",4,59,2888,1348,1540
050,26,077,"Michigan","Kalamazoo County",4,60,2890,1377,1513
050,26,077,"Michigan","Kalamazoo County",4,61,3004,1459,1545
050,26,077,"Michigan","Kalamazoo County",4,62,2930,1428,1502
050,26,077,"Michigan","Kalamazoo County",4,63,2873,1417,1456
050,26,077,"Michigan","Kalamazoo County",4,64,2878,1383,1495
050,26,077,"Michigan","Kalamazoo County",4,65,2942,1375,1567
050,26,077,"Michigan","Kalamazoo County",4,66,2744,1279,1465
050,26,077,"Michigan","Kalamazoo County",4,67,2705,1265,1440
050,26,077,"Michigan","Kalamazoo County",4,68,2676,1272,1404
050,26,077,"Michigan","Kalamazoo County",4,69,2650,1236,1414
050,26,077,"Michigan","Kalamazoo County",4,70,2599,1205,1394
050,26,077,"Michigan","Kalamazoo County",4,71,2488,1169,1319
050,26,077,"Michigan","Kalamazoo County",4,72,2261,1035,1226
050,26,077,"Michigan","Kalamazoo County",4,73,2159,941,1218
050,26,077,"Michigan","Kalamazoo County",4,74,2064,935,1129
050,26,077,"Michigan","Kalamazoo County",4,75,2165,1009,1156
050,26,077,"Michigan","Kalamazoo County",4,76,1451,665,786
050,26,077,"Michigan","Kalamazoo County",4,77,1396,603,793
050,26,077,"Michigan","Kalamazoo County",4,78,1384,603,781
050,26,077,"Michigan","Kalamazoo County",4,79,1409,615,794
050,26,077,"Michigan","Kalamazoo County",4,80,1201,514,687
050,26,077,"Michigan","Kalamazoo County",4,81,1056,452,604
050,26,077,"Michigan","Kalamazoo County",4,82,923,374,549
050,26,077,"Michigan","Kalamazoo County",4,83,863,355,508
050,26,077,"Michigan","Kalamazoo County",4,84,744,327,417
050,26,077,"Michigan","Kalamazoo County",4,85,4406,1520,2886
050,26,077,"Michigan","Kalamazoo County",5,0,2713,1420,1293
050,26,077,"Michigan","Kalamazoo County",5,1,2717,1397,1320
050,26,077,"Michigan","Kalamazoo County",5,2,2599,1315,1284
050,26,077,"Michigan","Kalamazoo County",5,3,2939,1482,1457
050,26,077,"Michigan","Kalamazoo County",5,4,2926,1488,1438
050,26,077,"Michigan","Kalamazoo County",5,5,3070,1570,1500
050,26,077,"Michigan","Kalamazoo County",5,6,3076,1628,1448
050,26,077,"Michigan","Kalamazoo County",5,7,3129,1619,1510
050,26,077,"Michigan","Kalamazoo County",5,8,3176,1620,1556
050,26,077,"Michigan","Kalamazoo County",5,9,3174,1651,1523
050,26,077,"Michigan","Kalamazoo County",5,10,3174,1597,1577
050,26,077,"Michigan","Kalamazoo County",5,11,3117,1606,1511
050,26,077,"Michigan","Kalamazoo County",5,12,3185,1629,1556
050,26,077,"Michigan","Kalamazoo County",5,13,3219,1616,1603
050,26,077,"Michigan","Kalamazoo County",5,14,3204,1650,1554
050,26,077,"Michigan","Kalamazoo County",5,15,3318,1705,1613
050,26,077,"Michigan","Kalamazoo County",5,16,3333,1697,1636
050,26,077,"Michigan","Kalamazoo County",5,17,3319,1690,1629
050,26,077,"Michigan","Kalamazoo County",5,18,4056,1977,2079
050,26,077,"Michigan","Kalamazoo County",5,19,5041,2526,2515
050,26,077,"Michigan","Kalamazoo County",5,20,6377,2996,3381
050,26,077,"Michigan","Kalamazoo County",5,21,7254,3442,3812
050,26,077,"Michigan","Kalamazoo County",5,22,6245,3084,3161
050,26,077,"Michigan","Kalamazoo County",5,23,5814,2952,2862
050,26,077,"Michigan","Kalamazoo County",5,24,4625,2367,2258
050,26,077,"Michigan","Kalamazoo County",5,25,4026,2018,2008
050,26,077,"Michigan","Kalamazoo County",5,26,3741,1860,1881
050,26,077,"Michigan","Kalamazoo County",5,27,3541,1787,1754
050,26,077,"Michigan","Kalamazoo County",5,28,3531,1793,1738
050,26,077,"Michigan","Kalamazoo County",5,29,3479,1763,1716
050,26,077,"Michigan","Kalamazoo County",5,30,3410,1707,1703
050,26,077,"Michigan","Kalamazoo County",5,31,3490,1694,1796
050,26,077,"Michigan","Kalamazoo County",5,32,3603,1790,1813
050,26,077,"Michigan","Kalamazoo County",5,33,3479,1766,1713
050,26,077,"Michigan","Kalamazoo County",5,34,3313,1691,1622
050,26,077,"Michigan","Kalamazoo County",5,35,3289,1623,1666
050,26,077,"Michigan","Kalamazoo County",5,36,3151,1583,1568
050,26,077,"Michigan","Kalamazoo County",5,37,3191,1637,1554
050,26,077,"Michigan","Kalamazoo County",5,38,3286,1666,1620
050,26,077,"Michigan","Kalamazoo County",5,39,3197,1599,1598
050,26,077,"Michigan","Kalamazoo County",5,40,3249,1635,1614
050,26,077,"Michigan","Kalamazoo County",5,41,3258,1626,1632
050,26,077,"Michigan","Kalamazoo County",5,42,3243,1636,1607
050,26,077,"Michigan","Kalamazoo County",5,43,3255,1630,1625
050,26,077,"Michigan","Kalamazoo County",5,44,3079,1521,1558
050,26,077,"Michigan","Kalamazoo County",5,45,3024,1505,1519
050,26,077,"Michigan","Kalamazoo County",5,46,2898,1410,1488
050,26,077,"Michigan","Kalamazoo County",5,47,2733,1368,1365
050,26,077,"Michigan","Kalamazoo County",5,48,2768,1415,1353
050,26,077,"Michigan","Kalamazoo County",5,49,2557,1266,1291
050,26,077,"Michigan","Kalamazoo County",5,50,2652,1318,1334
050,26,077,"Michigan","Kalamazoo County",5,51,2814,1411,1403
050,26,077,"Michigan","Kalamazoo County",5,52,2962,1465,1497
050,26,077,"Michigan","Kalamazoo County",5,53,2955,1476,1479
050,26,077,"Michigan","Kalamazoo County",5,54,2771,1345,1426
050,26,077,"Michigan","Kalamazoo County",5,55,2716,1362,1354
050,26,077,"Michigan","Kalamazoo County",5,56,2649,1324,1325
050,26,077,"Michigan","Kalamazoo County",5,57,2663,1303,1360
050,26,077,"Michigan","Kalamazoo County",5,58,2764,1324,1440
050,26,077,"Michigan","Kalamazoo County",5,59,2869,1374,1495
050,26,077,"Michigan","Kalamazoo County",5,60,2841,1344,1497
050,26,077,"Michigan","Kalamazoo County",5,61,2860,1347,1513
050,26,077,"Michigan","Kalamazoo County",5,62,2982,1453,1529
050,26,077,"Michigan","Kalamazoo County",5,63,2869,1392,1477
050,26,077,"Michigan","Kalamazoo County",5,64,2825,1397,1428
050,26,077,"Michigan","Kalamazoo County",5,65,2837,1343,1494
050,26,077,"Michigan","Kalamazoo County",5,66,2885,1331,1554
050,26,077,"Michigan","Kalamazoo County",5,67,2708,1250,1458
050,26,077,"Michigan","Kalamazoo County",5,68,2675,1244,1431
050,26,077,"Michigan","Kalamazoo County",5,69,2603,1229,1374
050,26,077,"Michigan","Kalamazoo County",5,70,2586,1199,1387
050,26,077,"Michigan","Kalamazoo County",5,71,2566,1192,1374
050,26,077,"Michigan","Kalamazoo County",5,72,2453,1151,1302
050,26,077,"Michigan","Kalamazoo County",5,73,2221,998,1223
050,26,077,"Michigan","Kalamazoo County",5,74,2100,909,1191
050,26,077,"Michigan","Kalamazoo County",5,75,2035,918,1117
050,26,077,"Michigan","Kalamazoo County",5,76,2100,978,1122
050,26,077,"Michigan","Kalamazoo County",5,77,1406,638,768
050,26,077,"Michigan","Kalamazoo County",5,78,1352,578,774
050,26,077,"Michigan","Kalamazoo County",5,79,1314,570,744
050,26,077,"Michigan","Kalamazoo County",5,80,1374,593,781
050,26,077,"Michigan","Kalamazoo County",5,81,1142,488,654
050,26,077,"Michigan","Kalamazoo County",5,82,980,410,570
050,26,077,"Michigan","Kalamazoo County",5,83,880,351,529
050,26,077,"Michigan","Kalamazoo County",5,84,792,338,454
050,26,077,"Michigan","Kalamazoo County",5,85,4423,1568,2855
050,26,079,"Michigan","Kalkaska County",1,0,191,98,93
050,26,079,"Michigan","Kalkaska County",1,1,189,98,91
050,26,079,"Michigan","Kalkaska County",1,2,169,80,89
050,26,079,"Michigan","Kalkaska County",1,3,177,93,84
050,26,079,"Michigan","Kalkaska County",1,4,203,112,91
050,26,079,"Michigan","Kalkaska County",1,5,194,99,95
050,26,079,"Michigan","Kalkaska County",1,6,197,89,108
050,26,079,"Michigan","Kalkaska County",1,7,197,104,93
050,26,079,"Michigan","Kalkaska County",1,8,217,108,109
050,26,079,"Michigan","Kalkaska County",1,9,209,118,91
050,26,079,"Michigan","Kalkaska County",1,10,230,126,104
050,26,079,"Michigan","Kalkaska County",1,11,223,116,107
050,26,079,"Michigan","Kalkaska County",1,12,230,114,116
050,26,079,"Michigan","Kalkaska County",1,13,231,114,117
050,26,079,"Michigan","Kalkaska County",1,14,212,109,103
050,26,079,"Michigan","Kalkaska County",1,15,222,109,113
050,26,079,"Michigan","Kalkaska County",1,16,244,126,118
050,26,079,"Michigan","Kalkaska County",1,17,216,112,104
050,26,079,"Michigan","Kalkaska County",1,18,174,96,78
050,26,079,"Michigan","Kalkaska County",1,19,144,78,66
050,26,079,"Michigan","Kalkaska County",1,20,163,90,73
050,26,079,"Michigan","Kalkaska County",1,21,156,87,69
050,26,079,"Michigan","Kalkaska County",1,22,163,81,82
050,26,079,"Michigan","Kalkaska County",1,23,175,84,91
050,26,079,"Michigan","Kalkaska County",1,24,191,104,87
050,26,079,"Michigan","Kalkaska County",1,25,192,100,92
050,26,079,"Michigan","Kalkaska County",1,26,199,107,92
050,26,079,"Michigan","Kalkaska County",1,27,213,110,103
050,26,079,"Michigan","Kalkaska County",1,28,197,91,106
050,26,079,"Michigan","Kalkaska County",1,29,222,108,114
050,26,079,"Michigan","Kalkaska County",1,30,214,109,105
050,26,079,"Michigan","Kalkaska County",1,31,201,96,105
050,26,079,"Michigan","Kalkaska County",1,32,210,105,105
050,26,079,"Michigan","Kalkaska County",1,33,220,115,105
050,26,079,"Michigan","Kalkaska County",1,34,224,117,107
050,26,079,"Michigan","Kalkaska County",1,35,200,101,99
050,26,079,"Michigan","Kalkaska County",1,36,214,108,106
050,26,079,"Michigan","Kalkaska County",1,37,217,117,100
050,26,079,"Michigan","Kalkaska County",1,38,204,101,103
050,26,079,"Michigan","Kalkaska County",1,39,205,91,114
050,26,079,"Michigan","Kalkaska County",1,40,208,110,98
050,26,079,"Michigan","Kalkaska County",1,41,199,106,93
050,26,079,"Michigan","Kalkaska County",1,42,190,93,97
050,26,079,"Michigan","Kalkaska County",1,43,205,104,101
050,26,079,"Michigan","Kalkaska County",1,44,198,101,97
050,26,079,"Michigan","Kalkaska County",1,45,200,102,98
050,26,079,"Michigan","Kalkaska County",1,46,198,106,92
050,26,079,"Michigan","Kalkaska County",1,47,189,99,90
050,26,079,"Michigan","Kalkaska County",1,48,233,119,114
050,26,079,"Michigan","Kalkaska County",1,49,236,127,109
050,26,079,"Michigan","Kalkaska County",1,50,217,116,101
050,26,079,"Michigan","Kalkaska County",1,51,221,116,105
050,26,079,"Michigan","Kalkaska County",1,52,230,122,108
050,26,079,"Michigan","Kalkaska County",1,53,217,119,98
050,26,079,"Michigan","Kalkaska County",1,54,261,139,122
050,26,079,"Michigan","Kalkaska County",1,55,296,155,141
050,26,079,"Michigan","Kalkaska County",1,56,267,136,131
050,26,079,"Michigan","Kalkaska County",1,57,280,144,136
050,26,079,"Michigan","Kalkaska County",1,58,284,146,138
050,26,079,"Michigan","Kalkaska County",1,59,304,141,163
050,26,079,"Michigan","Kalkaska County",1,60,318,159,159
050,26,079,"Michigan","Kalkaska County",1,61,304,155,149
050,26,079,"Michigan","Kalkaska County",1,62,302,151,151
050,26,079,"Michigan","Kalkaska County",1,63,305,148,157
050,26,079,"Michigan","Kalkaska County",1,64,287,143,144
050,26,079,"Michigan","Kalkaska County",1,65,256,139,117
050,26,079,"Michigan","Kalkaska County",1,66,250,131,119
050,26,079,"Michigan","Kalkaska County",1,67,276,133,143
050,26,079,"Michigan","Kalkaska County",1,68,256,143,113
050,26,079,"Michigan","Kalkaska County",1,69,237,127,110
050,26,079,"Michigan","Kalkaska County",1,70,207,110,97
050,26,079,"Michigan","Kalkaska County",1,71,206,107,99
050,26,079,"Michigan","Kalkaska County",1,72,228,118,110
050,26,079,"Michigan","Kalkaska County",1,73,243,132,111
050,26,079,"Michigan","Kalkaska County",1,74,155,76,79
050,26,079,"Michigan","Kalkaska County",1,75,144,71,73
050,26,079,"Michigan","Kalkaska County",1,76,162,81,81
050,26,079,"Michigan","Kalkaska County",1,77,176,82,94
050,26,079,"Michigan","Kalkaska County",1,78,136,71,65
050,26,079,"Michigan","Kalkaska County",1,79,112,54,58
050,26,079,"Michigan","Kalkaska County",1,80,98,50,48
050,26,079,"Michigan","Kalkaska County",1,81,92,45,47
050,26,079,"Michigan","Kalkaska County",1,82,83,42,41
050,26,079,"Michigan","Kalkaska County",1,83,74,38,36
050,26,079,"Michigan","Kalkaska County",1,84,55,28,27
050,26,079,"Michigan","Kalkaska County",1,85,297,114,183
050,26,079,"Michigan","Kalkaska County",2,0,190,100,90
050,26,079,"Michigan","Kalkaska County",2,1,189,98,91
050,26,079,"Michigan","Kalkaska County",2,2,174,84,90
050,26,079,"Michigan","Kalkaska County",2,3,173,89,84
050,26,079,"Michigan","Kalkaska County",2,4,196,107,89
050,26,079,"Michigan","Kalkaska County",2,5,196,102,94
050,26,079,"Michigan","Kalkaska County",2,6,199,92,107
050,26,079,"Michigan","Kalkaska County",2,7,195,100,95
050,26,079,"Michigan","Kalkaska County",2,8,211,107,104
050,26,079,"Michigan","Kalkaska County",2,9,213,116,97
050,26,079,"Michigan","Kalkaska County",2,10,222,123,99
050,26,079,"Michigan","Kalkaska County",2,11,222,118,104
050,26,079,"Michigan","Kalkaska County",2,12,229,115,114
050,26,079,"Michigan","Kalkaska County",2,13,230,114,116
050,26,079,"Michigan","Kalkaska County",2,14,217,111,106
050,26,079,"Michigan","Kalkaska County",2,15,218,109,109
050,26,079,"Michigan","Kalkaska County",2,16,239,123,116
050,26,079,"Michigan","Kalkaska County",2,17,224,114,110
050,26,079,"Michigan","Kalkaska County",2,18,174,94,80
050,26,079,"Michigan","Kalkaska County",2,19,142,77,65
050,26,079,"Michigan","Kalkaska County",2,20,165,90,75
050,26,079,"Michigan","Kalkaska County",2,21,161,89,72
050,26,079,"Michigan","Kalkaska County",2,22,163,82,81
050,26,079,"Michigan","Kalkaska County",2,23,174,84,90
050,26,079,"Michigan","Kalkaska County",2,24,188,99,89
050,26,079,"Michigan","Kalkaska County",2,25,194,102,92
050,26,079,"Michigan","Kalkaska County",2,26,200,107,93
050,26,079,"Michigan","Kalkaska County",2,27,209,109,100
050,26,079,"Michigan","Kalkaska County",2,28,203,97,106
050,26,079,"Michigan","Kalkaska County",2,29,221,107,114
050,26,079,"Michigan","Kalkaska County",2,30,216,109,107
050,26,079,"Michigan","Kalkaska County",2,31,202,98,104
050,26,079,"Michigan","Kalkaska County",2,32,207,104,103
050,26,079,"Michigan","Kalkaska County",2,33,215,112,103
050,26,079,"Michigan","Kalkaska County",2,34,222,114,108
050,26,079,"Michigan","Kalkaska County",2,35,208,106,102
050,26,079,"Michigan","Kalkaska County",2,36,207,104,103
050,26,079,"Michigan","Kalkaska County",2,37,216,115,101
050,26,079,"Michigan","Kalkaska County",2,38,207,104,103
050,26,079,"Michigan","Kalkaska County",2,39,205,93,112
050,26,079,"Michigan","Kalkaska County",2,40,206,105,101
050,26,079,"Michigan","Kalkaska County",2,41,199,105,94
050,26,079,"Michigan","Kalkaska County",2,42,191,95,96
050,26,079,"Michigan","Kalkaska County",2,43,205,104,101
050,26,079,"Michigan","Kalkaska County",2,44,199,101,98
050,26,079,"Michigan","Kalkaska County",2,45,201,102,99
050,26,079,"Michigan","Kalkaska County",2,46,198,104,94
050,26,079,"Michigan","Kalkaska County",2,47,188,99,89
050,26,079,"Michigan","Kalkaska County",2,48,224,115,109
050,26,079,"Michigan","Kalkaska County",2,49,237,127,110
050,26,079,"Michigan","Kalkaska County",2,50,221,118,103
050,26,079,"Michigan","Kalkaska County",2,51,221,117,104
050,26,079,"Michigan","Kalkaska County",2,52,226,120,106
050,26,079,"Michigan","Kalkaska County",2,53,219,119,100
050,26,079,"Michigan","Kalkaska County",2,54,251,135,116
050,26,079,"Michigan","Kalkaska County",2,55,284,149,135
050,26,079,"Michigan","Kalkaska County",2,56,276,142,134
050,26,079,"Michigan","Kalkaska County",2,57,280,143,137
050,26,079,"Michigan","Kalkaska County",2,58,285,146,139
050,26,079,"Michigan","Kalkaska County",2,59,302,145,157
050,26,079,"Michigan","Kalkaska County",2,60,317,155,162
050,26,079,"Michigan","Kalkaska County",2,61,305,154,151
050,26,079,"Michigan","Kalkaska County",2,62,300,150,150
050,26,079,"Michigan","Kalkaska County",2,63,308,150,158
050,26,079,"Michigan","Kalkaska County",2,64,286,141,145
050,26,079,"Michigan","Kalkaska County",2,65,261,138,123
050,26,079,"Michigan","Kalkaska County",2,66,253,133,120
050,26,079,"Michigan","Kalkaska County",2,67,268,132,136
050,26,079,"Michigan","Kalkaska County",2,68,258,139,119
050,26,079,"Michigan","Kalkaska County",2,69,242,130,112
050,26,079,"Michigan","Kalkaska County",2,70,214,114,100
050,26,079,"Michigan","Kalkaska County",2,71,206,109,97
050,26,079,"Michigan","Kalkaska County",2,72,219,114,105
050,26,079,"Michigan","Kalkaska County",2,73,249,135,114
050,26,079,"Michigan","Kalkaska County",2,74,163,83,80
050,26,079,"Michigan","Kalkaska County",2,75,146,72,74
050,26,079,"Michigan","Kalkaska County",2,76,152,76,76
050,26,079,"Michigan","Kalkaska County",2,77,172,81,91
050,26,079,"Michigan","Kalkaska County",2,78,144,73,71
050,26,079,"Michigan","Kalkaska County",2,79,115,58,57
050,26,079,"Michigan","Kalkaska County",2,80,98,50,48
050,26,079,"Michigan","Kalkaska County",2,81,93,46,47
050,26,079,"Michigan","Kalkaska County",2,82,84,42,42
050,26,079,"Michigan","Kalkaska County",2,83,74,38,36
050,26,079,"Michigan","Kalkaska County",2,84,59,30,29
050,26,079,"Michigan","Kalkaska County",2,85,296,113,183
050,26,079,"Michigan","Kalkaska County",3,0,162,81,81
050,26,079,"Michigan","Kalkaska County",3,1,185,102,83
050,26,079,"Michigan","Kalkaska County",3,2,187,99,88
050,26,079,"Michigan","Kalkaska County",3,3,167,81,86
050,26,079,"Michigan","Kalkaska County",3,4,170,88,82
050,26,079,"Michigan","Kalkaska County",3,5,193,100,93
050,26,079,"Michigan","Kalkaska County",3,6,201,105,96
050,26,079,"Michigan","Kalkaska County",3,7,200,91,109
050,26,079,"Michigan","Kalkaska County",3,8,203,100,103
050,26,079,"Michigan","Kalkaska County",3,9,220,112,108
050,26,079,"Michigan","Kalkaska County",3,10,206,109,97
050,26,079,"Michigan","Kalkaska County",3,11,217,117,100
050,26,079,"Michigan","Kalkaska County",3,12,224,122,102
050,26,079,"Michigan","Kalkaska County",3,13,234,117,117
050,26,079,"Michigan","Kalkaska County",3,14,223,110,113
050,26,079,"Michigan","Kalkaska County",3,15,214,113,101
050,26,079,"Michigan","Kalkaska County",3,16,217,108,109
050,26,079,"Michigan","Kalkaska County",3,17,240,122,118
050,26,079,"Michigan","Kalkaska County",3,18,195,102,93
050,26,079,"Michigan","Kalkaska County",3,19,134,77,57
050,26,079,"Michigan","Kalkaska County",3,20,146,81,65
050,26,079,"Michigan","Kalkaska County",3,21,170,90,80
050,26,079,"Michigan","Kalkaska County",3,22,163,88,75
050,26,079,"Michigan","Kalkaska County",3,23,181,91,90
050,26,079,"Michigan","Kalkaska County",3,24,176,80,96
050,26,079,"Michigan","Kalkaska County",3,25,179,98,81
050,26,079,"Michigan","Kalkaska County",3,26,204,106,98
050,26,079,"Michigan","Kalkaska County",3,27,195,101,94
050,26,079,"Michigan","Kalkaska County",3,28,221,114,107
050,26,079,"Michigan","Kalkaska County",3,29,210,101,109
050,26,079,"Michigan","Kalkaska County",3,30,224,109,115
050,26,079,"Michigan","Kalkaska County",3,31,218,108,110
050,26,079,"Michigan","Kalkaska County",3,32,206,107,99
050,26,079,"Michigan","Kalkaska County",3,33,220,115,105
050,26,079,"Michigan","Kalkaska County",3,34,213,109,104
050,26,079,"Michigan","Kalkaska County",3,35,214,110,104
050,26,079,"Michigan","Kalkaska County",3,36,215,109,106
050,26,079,"Michigan","Kalkaska County",3,37,216,104,112
050,26,079,"Michigan","Kalkaska County",3,38,216,121,95
050,26,079,"Michigan","Kalkaska County",3,39,209,110,99
050,26,079,"Michigan","Kalkaska County",3,40,208,94,114
050,26,079,"Michigan","Kalkaska County",3,41,215,110,105
050,26,079,"Michigan","Kalkaska County",3,42,200,105,95
050,26,079,"Michigan","Kalkaska County",3,43,188,95,93
050,26,079,"Michigan","Kalkaska County",3,44,209,108,101
050,26,079,"Michigan","Kalkaska County",3,45,207,104,103
050,26,079,"Michigan","Kalkaska County",3,46,211,108,103
050,26,079,"Michigan","Kalkaska County",3,47,199,103,96
050,26,079,"Michigan","Kalkaska County",3,48,193,101,92
050,26,079,"Michigan","Kalkaska County",3,49,219,112,107
050,26,079,"Michigan","Kalkaska County",3,50,242,126,116
050,26,079,"Michigan","Kalkaska County",3,51,222,111,111
050,26,079,"Michigan","Kalkaska County",3,52,224,118,106
050,26,079,"Michigan","Kalkaska County",3,53,249,138,111
050,26,079,"Michigan","Kalkaska County",3,54,220,116,104
050,26,079,"Michigan","Kalkaska County",3,55,249,135,114
050,26,079,"Michigan","Kalkaska County",3,56,289,150,139
050,26,079,"Michigan","Kalkaska County",3,57,283,147,136
050,26,079,"Michigan","Kalkaska County",3,58,274,137,137
050,26,079,"Michigan","Kalkaska County",3,59,297,153,144
050,26,079,"Michigan","Kalkaska County",3,60,301,142,159
050,26,079,"Michigan","Kalkaska County",3,61,328,164,164
050,26,079,"Michigan","Kalkaska County",3,62,303,152,151
050,26,079,"Michigan","Kalkaska County",3,63,311,155,156
050,26,079,"Michigan","Kalkaska County",3,64,317,153,164
050,26,079,"Michigan","Kalkaska County",3,65,281,141,140
050,26,079,"Michigan","Kalkaska County",3,66,264,140,124
050,26,079,"Michigan","Kalkaska County",3,67,247,129,118
050,26,079,"Michigan","Kalkaska County",3,68,259,130,129
050,26,079,"Michigan","Kalkaska County",3,69,252,133,119
050,26,079,"Michigan","Kalkaska County",3,70,235,126,109
050,26,079,"Michigan","Kalkaska County",3,71,207,111,96
050,26,079,"Michigan","Kalkaska County",3,72,208,109,99
050,26,079,"Michigan","Kalkaska County",3,73,210,109,101
050,26,079,"Michigan","Kalkaska County",3,74,242,133,109
050,26,079,"Michigan","Kalkaska County",3,75,156,84,72
050,26,079,"Michigan","Kalkaska County",3,76,137,68,69
050,26,079,"Michigan","Kalkaska County",3,77,143,70,73
050,26,079,"Michigan","Kalkaska County",3,78,162,78,84
050,26,079,"Michigan","Kalkaska County",3,79,135,67,68
050,26,079,"Michigan","Kalkaska County",3,80,102,47,55
050,26,079,"Michigan","Kalkaska County",3,81,88,43,45
050,26,079,"Michigan","Kalkaska County",3,82,92,44,48
050,26,079,"Michigan","Kalkaska County",3,83,78,40,38
050,26,079,"Michigan","Kalkaska County",3,84,63,33,30
050,26,079,"Michigan","Kalkaska County",3,85,287,112,175
050,26,079,"Michigan","Kalkaska County",4,0,185,92,93
050,26,079,"Michigan","Kalkaska County",4,1,158,69,89
050,26,079,"Michigan","Kalkaska County",4,2,185,101,84
050,26,079,"Michigan","Kalkaska County",4,3,180,93,87
050,26,079,"Michigan","Kalkaska County",4,4,175,84,91
050,26,079,"Michigan","Kalkaska County",4,5,178,96,82
050,26,079,"Michigan","Kalkaska County",4,6,202,104,98
050,26,079,"Michigan","Kalkaska County",4,7,200,105,95
050,26,079,"Michigan","Kalkaska County",4,8,213,91,122
050,26,079,"Michigan","Kalkaska County",4,9,196,95,101
050,26,079,"Michigan","Kalkaska County",4,10,227,112,115
050,26,079,"Michigan","Kalkaska County",4,11,205,108,97
050,26,079,"Michigan","Kalkaska County",4,12,222,122,100
050,26,079,"Michigan","Kalkaska County",4,13,236,128,108
050,26,079,"Michigan","Kalkaska County",4,14,239,120,119
050,26,079,"Michigan","Kalkaska County",4,15,232,115,117
050,26,079,"Michigan","Kalkaska County",4,16,213,107,106
050,26,079,"Michigan","Kalkaska County",4,17,220,112,108
050,26,079,"Michigan","Kalkaska County",4,18,212,110,102
050,26,079,"Michigan","Kalkaska County",4,19,146,76,70
050,26,079,"Michigan","Kalkaska County",4,20,138,78,60
050,26,079,"Michigan","Kalkaska County",4,21,159,80,79
050,26,079,"Michigan","Kalkaska County",4,22,177,95,82
050,26,079,"Michigan","Kalkaska County",4,23,179,98,81
050,26,079,"Michigan","Kalkaska County",4,24,181,92,89
050,26,079,"Michigan","Kalkaska County",4,25,183,85,98
050,26,079,"Michigan","Kalkaska County",4,26,192,104,88
050,26,079,"Michigan","Kalkaska County",4,27,206,112,94
050,26,079,"Michigan","Kalkaska County",4,28,199,105,94
050,26,079,"Michigan","Kalkaska County",4,29,234,122,112
050,26,079,"Michigan","Kalkaska County",4,30,223,104,119
050,26,079,"Michigan","Kalkaska County",4,31,224,106,118
050,26,079,"Michigan","Kalkaska County",4,32,231,121,110
050,26,079,"Michigan","Kalkaska County",4,33,207,108,99
050,26,079,"Michigan","Kalkaska County",4,34,241,127,114
050,26,079,"Michigan","Kalkaska County",4,35,219,117,102
050,26,079,"Michigan","Kalkaska County",4,36,232,117,115
050,26,079,"Michigan","Kalkaska County",4,37,207,106,101
050,26,079,"Michigan","Kalkaska County",4,38,222,112,110
050,26,079,"Michigan","Kalkaska County",4,39,230,131,99
050,26,079,"Michigan","Kalkaska County",4,40,219,115,104
050,26,079,"Michigan","Kalkaska County",4,41,216,97,119
050,26,079,"Michigan","Kalkaska County",4,42,220,110,110
050,26,079,"Michigan","Kalkaska County",4,43,197,104,93
050,26,079,"Michigan","Kalkaska County",4,44,192,99,93
050,26,079,"Michigan","Kalkaska County",4,45,210,104,106
050,26,079,"Michigan","Kalkaska County",4,46,208,109,99
050,26,079,"Michigan","Kalkaska County",4,47,215,109,106
050,26,079,"Michigan","Kalkaska County",4,48,203,104,99
050,26,079,"Michigan","Kalkaska County",4,49,205,109,96
050,26,079,"Michigan","Kalkaska County",4,50,215,112,103
050,26,079,"Michigan","Kalkaska County",4,51,259,137,122
050,26,079,"Michigan","Kalkaska County",4,52,225,113,112
050,26,079,"Michigan","Kalkaska County",4,53,221,117,104
050,26,079,"Michigan","Kalkaska County",4,54,256,141,115
050,26,079,"Michigan","Kalkaska County",4,55,214,111,103
050,26,079,"Michigan","Kalkaska County",4,56,259,141,118
050,26,079,"Michigan","Kalkaska County",4,57,301,157,144
050,26,079,"Michigan","Kalkaska County",4,58,277,148,129
050,26,079,"Michigan","Kalkaska County",4,59,286,139,147
050,26,079,"Michigan","Kalkaska County",4,60,298,152,146
050,26,079,"Michigan","Kalkaska County",4,61,318,148,170
050,26,079,"Michigan","Kalkaska County",4,62,332,165,167
050,26,079,"Michigan","Kalkaska County",4,63,294,149,145
050,26,079,"Michigan","Kalkaska County",4,64,306,148,158
050,26,079,"Michigan","Kalkaska County",4,65,311,156,155
050,26,079,"Michigan","Kalkaska County",4,66,290,144,146
050,26,079,"Michigan","Kalkaska County",4,67,266,137,129
050,26,079,"Michigan","Kalkaska County",4,68,251,129,122
050,26,079,"Michigan","Kalkaska County",4,69,253,124,129
050,26,079,"Michigan","Kalkaska County",4,70,252,135,117
050,26,079,"Michigan","Kalkaska County",4,71,227,122,105
050,26,079,"Michigan","Kalkaska County",4,72,214,113,101
050,26,079,"Michigan","Kalkaska County",4,73,197,104,93
050,26,079,"Michigan","Kalkaska County",4,74,205,105,100
050,26,079,"Michigan","Kalkaska County",4,75,236,128,108
050,26,079,"Michigan","Kalkaska County",4,76,153,84,69
050,26,079,"Michigan","Kalkaska County",4,77,130,64,66
050,26,079,"Michigan","Kalkaska County",4,78,133,67,66
050,26,079,"Michigan","Kalkaska County",4,79,157,73,84
050,26,079,"Michigan","Kalkaska County",4,80,117,57,60
050,26,079,"Michigan","Kalkaska County",4,81,93,41,52
050,26,079,"Michigan","Kalkaska County",4,82,80,37,43
050,26,079,"Michigan","Kalkaska County",4,83,77,38,39
050,26,079,"Michigan","Kalkaska County",4,84,69,36,33
050,26,079,"Michigan","Kalkaska County",4,85,279,110,169
050,26,079,"Michigan","Kalkaska County",5,0,184,92,92
050,26,079,"Michigan","Kalkaska County",5,1,179,88,91
050,26,079,"Michigan","Kalkaska County",5,2,168,72,96
050,26,079,"Michigan","Kalkaska County",5,3,199,100,99
050,26,079,"Michigan","Kalkaska County",5,4,187,97,90
050,26,079,"Michigan","Kalkaska County",5,5,169,78,91
050,26,079,"Michigan","Kalkaska County",5,6,175,95,80
050,26,079,"Michigan","Kalkaska County",5,7,205,107,98
050,26,079,"Michigan","Kalkaska County",5,8,190,103,87
050,26,079,"Michigan","Kalkaska County",5,9,209,91,118
050,26,079,"Michigan","Kalkaska County",5,10,206,101,105
050,26,079,"Michigan","Kalkaska County",5,11,229,113,116
050,26,079,"Michigan","Kalkaska County",5,12,199,107,92
050,26,079,"Michigan","Kalkaska County",5,13,225,118,107
050,26,079,"Michigan","Kalkaska County",5,14,240,127,113
050,26,079,"Michigan","Kalkaska County",5,15,236,121,115
050,26,079,"Michigan","Kalkaska County",5,16,237,118,119
050,26,079,"Michigan","Kalkaska County",5,17,220,112,108
050,26,079,"Michigan","Kalkaska County",5,18,184,96,88
050,26,079,"Michigan","Kalkaska County",5,19,158,82,76
050,26,079,"Michigan","Kalkaska County",5,20,157,79,78
050,26,079,"Michigan","Kalkaska County",5,21,148,78,70
050,26,079,"Michigan","Kalkaska County",5,22,170,84,86
050,26,079,"Michigan","Kalkaska County",5,23,188,107,81
050,26,079,"Michigan","Kalkaska County",5,24,187,100,87
050,26,079,"Michigan","Kalkaska County",5,25,180,88,92
050,26,079,"Michigan","Kalkaska County",5,26,203,100,103
050,26,079,"Michigan","Kalkaska County",5,27,201,108,93
050,26,079,"Michigan","Kalkaska County",5,28,225,119,106
050,26,079,"Michigan","Kalkaska County",5,29,221,116,105
050,26,079,"Michigan","Kalkaska County",5,30,241,123,118
050,26,079,"Michigan","Kalkaska County",5,31,232,112,120
050,26,079,"Michigan","Kalkaska County",5,32,242,122,120
050,26,079,"Michigan","Kalkaska County",5,33,233,123,110
050,26,079,"Michigan","Kalkaska County",5,34,208,106,102
050,26,079,"Michigan","Kalkaska County",5,35,243,125,118
050,26,079,"Michigan","Kalkaska County",5,36,223,126,97
050,26,079,"Michigan","Kalkaska County",5,37,237,119,118
050,26,079,"Michigan","Kalkaska County",5,38,219,112,107
050,26,079,"Michigan","Kalkaska County",5,39,231,111,120
050,26,079,"Michigan","Kalkaska County",5,40,234,135,99
050,26,079,"Michigan","Kalkaska County",5,41,221,117,104
050,26,079,"Michigan","Kalkaska County",5,42,218,99,119
050,26,079,"Michigan","Kalkaska County",5,43,219,111,108
050,26,079,"Michigan","Kalkaska County",5,44,195,104,91
050,26,079,"Michigan","Kalkaska County",5,45,203,106,97
050,26,079,"Michigan","Kalkaska County",5,46,209,104,105
050,26,079,"Michigan","Kalkaska County",5,47,201,106,95
050,26,079,"Michigan","Kalkaska County",5,48,220,107,113
050,26,079,"Michigan","Kalkaska County",5,49,208,105,103
050,26,079,"Michigan","Kalkaska County",5,50,205,109,96
050,26,079,"Michigan","Kalkaska County",5,51,213,114,99
050,26,079,"Michigan","Kalkaska County",5,52,256,133,123
050,26,079,"Michigan","Kalkaska County",5,53,234,116,118
050,26,079,"Michigan","Kalkaska County",5,54,227,121,106
050,26,079,"Michigan","Kalkaska County",5,55,273,154,119
050,26,079,"Michigan","Kalkaska County",5,56,225,119,106
050,26,079,"Michigan","Kalkaska County",5,57,274,150,124
050,26,079,"Michigan","Kalkaska County",5,58,308,161,147
050,26,079,"Michigan","Kalkaska County",5,59,288,155,133
050,26,079,"Michigan","Kalkaska County",5,60,291,143,148
050,26,079,"Michigan","Kalkaska County",5,61,294,148,146
050,26,079,"Michigan","Kalkaska County",5,62,306,148,158
050,26,079,"Michigan","Kalkaska County",5,63,339,168,171
050,26,079,"Michigan","Kalkaska County",5,64,296,146,150
050,26,079,"Michigan","Kalkaska County",5,65,308,151,157
050,26,079,"Michigan","Kalkaska County",5,66,321,160,161
050,26,079,"Michigan","Kalkaska County",5,67,289,141,148
050,26,079,"Michigan","Kalkaska County",5,68,259,132,127
050,26,079,"Michigan","Kalkaska County",5,69,248,123,125
050,26,079,"Michigan","Kalkaska County",5,70,254,127,127
050,26,079,"Michigan","Kalkaska County",5,71,247,134,113
050,26,079,"Michigan","Kalkaska County",5,72,222,117,105
050,26,079,"Michigan","Kalkaska County",5,73,212,113,99
050,26,079,"Michigan","Kalkaska County",5,74,189,97,92
050,26,079,"Michigan","Kalkaska County",5,75,200,105,95
050,26,079,"Michigan","Kalkaska County",5,76,230,126,104
050,26,079,"Michigan","Kalkaska County",5,77,147,79,68
050,26,079,"Michigan","Kalkaska County",5,78,121,61,60
050,26,079,"Michigan","Kalkaska County",5,79,125,60,65
050,26,079,"Michigan","Kalkaska County",5,80,143,65,78
050,26,079,"Michigan","Kalkaska County",5,81,114,54,60
050,26,079,"Michigan","Kalkaska County",5,82,84,37,47
050,26,079,"Michigan","Kalkaska County",5,83,68,33,35
050,26,079,"Michigan","Kalkaska County",5,84,65,34,31
050,26,079,"Michigan","Kalkaska County",5,85,299,125,174
050,26,081,"Michigan","Kent County",1,0,8437,4307,4130
050,26,081,"Michigan","Kent County",1,1,8295,4225,4070
050,26,081,"Michigan","Kent County",1,2,8382,4261,4121
050,26,081,"Michigan","Kent County",1,3,8600,4448,4152
050,26,081,"Michigan","Kent County",1,4,8811,4545,4266
050,26,081,"Michigan","Kent County",1,5,8781,4490,4291
050,26,081,"Michigan","Kent County",1,6,8744,4504,4240
050,26,081,"Michigan","Kent County",1,7,8788,4482,4306
050,26,081,"Michigan","Kent County",1,8,8720,4525,4195
050,26,081,"Michigan","Kent County",1,9,8652,4480,4172
050,26,081,"Michigan","Kent County",1,10,8872,4562,4310
050,26,081,"Michigan","Kent County",1,11,8986,4645,4341
050,26,081,"Michigan","Kent County",1,12,9228,4745,4483
050,26,081,"Michigan","Kent County",1,13,9331,4816,4515
050,26,081,"Michigan","Kent County",1,14,9038,4640,4398
050,26,081,"Michigan","Kent County",1,15,8917,4611,4306
050,26,081,"Michigan","Kent County",1,16,9090,4605,4485
050,26,081,"Michigan","Kent County",1,17,8885,4492,4393
050,26,081,"Michigan","Kent County",1,18,8776,4465,4311
050,26,081,"Michigan","Kent County",1,19,8704,4382,4322
050,26,081,"Michigan","Kent County",1,20,8350,4171,4179
050,26,081,"Michigan","Kent County",1,21,8068,4026,4042
050,26,081,"Michigan","Kent County",1,22,8498,4191,4307
050,26,081,"Michigan","Kent County",1,23,9209,4490,4719
050,26,081,"Michigan","Kent County",1,24,9850,4889,4961
050,26,081,"Michigan","Kent County",1,25,10225,5160,5065
050,26,081,"Michigan","Kent County",1,26,10493,5299,5194
050,26,081,"Michigan","Kent County",1,27,10674,5440,5234
050,26,081,"Michigan","Kent County",1,28,10822,5451,5371
050,26,081,"Michigan","Kent County",1,29,11004,5556,5448
050,26,081,"Michigan","Kent County",1,30,10754,5353,5401
050,26,081,"Michigan","Kent County",1,31,10372,5276,5096
050,26,081,"Michigan","Kent County",1,32,10060,5022,5038
050,26,081,"Michigan","Kent County",1,33,9641,4836,4805
050,26,081,"Michigan","Kent County",1,34,9567,4825,4742
050,26,081,"Michigan","Kent County",1,35,9473,4766,4707
050,26,081,"Michigan","Kent County",1,36,9189,4570,4619
050,26,081,"Michigan","Kent County",1,37,9271,4655,4616
050,26,081,"Michigan","Kent County",1,38,9064,4627,4437
050,26,081,"Michigan","Kent County",1,39,8847,4549,4298
050,26,081,"Michigan","Kent County",1,40,8697,4401,4296
050,26,081,"Michigan","Kent County",1,41,8279,4116,4163
050,26,081,"Michigan","Kent County",1,42,7895,3921,3974
050,26,081,"Michigan","Kent County",1,43,7608,3812,3796
050,26,081,"Michigan","Kent County",1,44,7389,3687,3702
050,26,081,"Michigan","Kent County",1,45,7270,3620,3650
050,26,081,"Michigan","Kent County",1,46,7077,3516,3561
050,26,081,"Michigan","Kent County",1,47,7204,3637,3567
050,26,081,"Michigan","Kent County",1,48,7683,3910,3773
050,26,081,"Michigan","Kent County",1,49,8178,4123,4055
050,26,081,"Michigan","Kent County",1,50,8056,3998,4058
050,26,081,"Michigan","Kent County",1,51,7780,3894,3886
050,26,081,"Michigan","Kent County",1,52,7590,3873,3717
050,26,081,"Michigan","Kent County",1,53,7569,3760,3809
050,26,081,"Michigan","Kent County",1,54,7723,3815,3908
050,26,081,"Michigan","Kent County",1,55,8015,3946,4069
050,26,081,"Michigan","Kent County",1,56,8297,4184,4113
050,26,081,"Michigan","Kent County",1,57,8367,4194,4173
050,26,081,"Michigan","Kent County",1,58,8493,4202,4291
050,26,081,"Michigan","Kent County",1,59,8291,4077,4214
050,26,081,"Michigan","Kent County",1,60,8199,4024,4175
050,26,081,"Michigan","Kent County",1,61,8081,4036,4045
050,26,081,"Michigan","Kent County",1,62,8005,3919,4086
050,26,081,"Michigan","Kent County",1,63,7767,3790,3977
050,26,081,"Michigan","Kent County",1,64,7399,3572,3827
050,26,081,"Michigan","Kent County",1,65,7102,3421,3681
050,26,081,"Michigan","Kent County",1,66,6882,3314,3568
050,26,081,"Michigan","Kent County",1,67,6560,3193,3367
050,26,081,"Michigan","Kent County",1,68,6294,3047,3247
050,26,081,"Michigan","Kent County",1,69,5670,2676,2994
050,26,081,"Michigan","Kent County",1,70,5351,2534,2817
050,26,081,"Michigan","Kent County",1,71,5048,2331,2717
050,26,081,"Michigan","Kent County",1,72,4949,2274,2675
050,26,081,"Michigan","Kent County",1,73,4881,2264,2617
050,26,081,"Michigan","Kent County",1,74,3340,1526,1814
050,26,081,"Michigan","Kent County",1,75,3290,1493,1797
050,26,081,"Michigan","Kent County",1,76,3272,1454,1818
050,26,081,"Michigan","Kent County",1,77,3286,1470,1816
050,26,081,"Michigan","Kent County",1,78,2870,1247,1623
050,26,081,"Michigan","Kent County",1,79,2483,1054,1429
050,26,081,"Michigan","Kent County",1,80,2254,984,1270
050,26,081,"Michigan","Kent County",1,81,2194,974,1220
050,26,081,"Michigan","Kent County",1,82,2056,861,1195
050,26,081,"Michigan","Kent County",1,83,1765,708,1057
050,26,081,"Michigan","Kent County",1,84,1654,668,986
050,26,081,"Michigan","Kent County",1,85,10396,3743,6653
050,26,081,"Michigan","Kent County",2,0,8412,4305,4107
050,26,081,"Michigan","Kent County",2,1,8300,4230,4070
050,26,081,"Michigan","Kent County",2,2,8342,4247,4095
050,26,081,"Michigan","Kent County",2,3,8500,4379,4121
050,26,081,"Michigan","Kent County",2,4,8763,4519,4244
050,26,081,"Michigan","Kent County",2,5,8765,4490,4275
050,26,081,"Michigan","Kent County",2,6,8762,4500,4262
050,26,081,"Michigan","Kent County",2,7,8758,4477,4281
050,26,081,"Michigan","Kent County",2,8,8701,4492,4209
050,26,081,"Michigan","Kent County",2,9,8670,4499,4171
050,26,081,"Michigan","Kent County",2,10,8811,4538,4273
050,26,081,"Michigan","Kent County",2,11,8912,4601,4311
050,26,081,"Michigan","Kent County",2,12,9207,4740,4467
050,26,081,"Michigan","Kent County",2,13,9287,4792,4495
050,26,081,"Michigan","Kent County",2,14,9091,4673,4418
050,26,081,"Michigan","Kent County",2,15,8944,4608,4336
050,26,081,"Michigan","Kent County",2,16,9059,4612,4447
050,26,081,"Michigan","Kent County",2,17,8946,4527,4419
050,26,081,"Michigan","Kent County",2,18,8742,4435,4307
050,26,081,"Michigan","Kent County",2,19,8713,4384,4329
050,26,081,"Michigan","Kent County",2,20,8447,4213,4234
050,26,081,"Michigan","Kent County",2,21,8115,4039,4076
050,26,081,"Michigan","Kent County",2,22,8576,4228,4348
050,26,081,"Michigan","Kent County",2,23,9188,4487,4701
050,26,081,"Michigan","Kent County",2,24,9768,4842,4926
050,26,081,"Michigan","Kent County",2,25,10187,5135,5052
050,26,081,"Michigan","Kent County",2,26,10461,5296,5165
050,26,081,"Michigan","Kent County",2,27,10616,5409,5207
050,26,081,"Michigan","Kent County",2,28,10785,5460,5325
050,26,081,"Michigan","Kent County",2,29,10947,5522,5425
050,26,081,"Michigan","Kent County",2,30,10838,5409,5429
050,26,081,"Michigan","Kent County",2,31,10411,5273,5138
050,26,081,"Michigan","Kent County",2,32,10092,5059,5033
050,26,081,"Michigan","Kent County",2,33,9717,4876,4841
050,26,081,"Michigan","Kent County",2,34,9569,4816,4753
050,26,081,"Michigan","Kent County",2,35,9536,4797,4739
050,26,081,"Michigan","Kent County",2,36,9197,4580,4617
050,26,081,"Michigan","Kent County",2,37,9265,4646,4619
050,26,081,"Michigan","Kent County",2,38,9139,4644,4495
050,26,081,"Michigan","Kent County",2,39,8862,4543,4319
050,26,081,"Michigan","Kent County",2,40,8772,4462,4310
050,26,081,"Michigan","Kent County",2,41,8362,4181,4181
050,26,081,"Michigan","Kent County",2,42,7937,3949,3988
050,26,081,"Michigan","Kent County",2,43,7717,3857,3860
050,26,081,"Michigan","Kent County",2,44,7370,3685,3685
050,26,081,"Michigan","Kent County",2,45,7323,3648,3675
050,26,081,"Michigan","Kent County",2,46,7087,3526,3561
050,26,081,"Michigan","Kent County",2,47,7146,3596,3550
050,26,081,"Michigan","Kent County",2,48,7551,3833,3718
050,26,081,"Michigan","Kent County",2,49,8083,4090,3993
050,26,081,"Michigan","Kent County",2,50,8081,4026,4055
050,26,081,"Michigan","Kent County",2,51,7819,3908,3911
050,26,081,"Michigan","Kent County",2,52,7604,3863,3741
050,26,081,"Michigan","Kent County",2,53,7555,3774,3781
050,26,081,"Michigan","Kent County",2,54,7651,3785,3866
050,26,081,"Michigan","Kent County",2,55,7911,3892,4019
050,26,081,"Michigan","Kent County",2,56,8225,4122,4103
050,26,081,"Michigan","Kent County",2,57,8329,4180,4149
050,26,081,"Michigan","Kent County",2,58,8435,4188,4247
050,26,081,"Michigan","Kent County",2,59,8363,4117,4246
050,26,081,"Michigan","Kent County",2,60,8174,4002,4172
050,26,081,"Michigan","Kent County",2,61,8060,4004,4056
050,26,081,"Michigan","Kent County",2,62,7969,3921,4048
050,26,081,"Michigan","Kent County",2,63,7844,3828,4016
050,26,081,"Michigan","Kent County",2,64,7412,3590,3822
050,26,081,"Michigan","Kent County",2,65,7131,3432,3699
050,26,081,"Michigan","Kent County",2,66,6912,3325,3587
050,26,081,"Michigan","Kent County",2,67,6602,3204,3398
050,26,081,"Michigan","Kent County",2,68,6293,3052,3241
050,26,081,"Michigan","Kent County",2,69,5827,2770,3057
050,26,081,"Michigan","Kent County",2,70,5380,2541,2839
050,26,081,"Michigan","Kent County",2,71,5097,2366,2731
050,26,081,"Michigan","Kent County",2,72,4867,2240,2627
050,26,081,"Michigan","Kent County",2,73,5095,2362,2733
050,26,081,"Michigan","Kent County",2,74,3483,1594,1889
050,26,081,"Michigan","Kent County",2,75,3301,1498,1803
050,26,081,"Michigan","Kent County",2,76,3224,1432,1792
050,26,081,"Michigan","Kent County",2,77,3328,1485,1843
050,26,081,"Michigan","Kent County",2,78,2895,1266,1629
050,26,081,"Michigan","Kent County",2,79,2548,1092,1456
050,26,081,"Michigan","Kent County",2,80,2274,983,1291
050,26,081,"Michigan","Kent County",2,81,2160,948,1212
050,26,081,"Michigan","Kent County",2,82,2068,881,1187
050,26,081,"Michigan","Kent County",2,83,1792,731,1061
050,26,081,"Michigan","Kent County",2,84,1647,656,991
050,26,081,"Michigan","Kent County",2,85,10387,3764,6623
050,26,081,"Michigan","Kent County",3,0,7984,4173,3811
050,26,081,"Michigan","Kent County",3,1,8228,4212,4016
050,26,081,"Michigan","Kent County",3,2,8233,4184,4049
050,26,081,"Michigan","Kent County",3,3,8326,4220,4106
050,26,081,"Michigan","Kent County",3,4,8434,4340,4094
050,26,081,"Michigan","Kent County",3,5,8725,4513,4212
050,26,081,"Michigan","Kent County",3,6,8729,4453,4276
050,26,081,"Michigan","Kent County",3,7,8686,4457,4229
050,26,081,"Michigan","Kent County",3,8,8689,4464,4225
050,26,081,"Michigan","Kent County",3,9,8645,4478,4167
050,26,081,"Michigan","Kent County",3,10,8618,4479,4139
050,26,081,"Michigan","Kent County",3,11,8695,4455,4240
050,26,081,"Michigan","Kent County",3,12,8873,4571,4302
050,26,081,"Michigan","Kent County",3,13,9141,4688,4453
050,26,081,"Michigan","Kent County",3,14,9289,4785,4504
050,26,081,"Michigan","Kent County",3,15,9020,4640,4380
050,26,081,"Michigan","Kent County",3,16,8955,4625,4330
050,26,081,"Michigan","Kent County",3,17,9050,4633,4417
050,26,081,"Michigan","Kent County",3,18,8674,4383,4291
050,26,081,"Michigan","Kent County",3,19,8416,4240,4176
050,26,081,"Michigan","Kent County",3,20,8343,4175,4168
050,26,081,"Michigan","Kent County",3,21,8245,4100,4145
050,26,081,"Michigan","Kent County",3,22,8641,4270,4371
050,26,081,"Michigan","Kent County",3,23,9268,4536,4732
050,26,081,"Michigan","Kent County",3,24,9775,4840,4935
050,26,081,"Michigan","Kent County",3,25,10080,4996,5084
050,26,081,"Michigan","Kent County",3,26,10287,5236,5051
050,26,081,"Michigan","Kent County",3,27,10571,5354,5217
050,26,081,"Michigan","Kent County",3,28,10509,5334,5175
050,26,081,"Michigan","Kent County",3,29,10788,5482,5306
050,26,081,"Michigan","Kent County",3,30,10738,5400,5338
050,26,081,"Michigan","Kent County",3,31,10837,5445,5392
050,26,081,"Michigan","Kent County",3,32,10370,5228,5142
050,26,081,"Michigan","Kent County",3,33,10060,5047,5013
050,26,081,"Michigan","Kent County",3,34,9618,4864,4754
050,26,081,"Michigan","Kent County",3,35,9436,4730,4706
050,26,081,"Michigan","Kent County",3,36,9504,4746,4758
050,26,081,"Michigan","Kent County",3,37,9156,4579,4577
050,26,081,"Michigan","Kent County",3,38,9193,4626,4567
050,26,081,"Michigan","Kent County",3,39,9082,4613,4469
050,26,081,"Michigan","Kent County",3,40,8848,4553,4295
050,26,081,"Michigan","Kent County",3,41,8741,4433,4308
050,26,081,"Michigan","Kent County",3,42,8257,4119,4138
050,26,081,"Michigan","Kent County",3,43,7840,3905,3935
050,26,081,"Michigan","Kent County",3,44,7664,3819,3845
050,26,081,"Michigan","Kent County",3,45,7274,3627,3647
050,26,081,"Michigan","Kent County",3,46,7273,3646,3627
050,26,081,"Michigan","Kent County",3,47,7002,3489,3513
050,26,081,"Michigan","Kent County",3,48,7065,3550,3515
050,26,081,"Michigan","Kent County",3,49,7472,3784,3688
050,26,081,"Michigan","Kent County",3,50,7958,4004,3954
050,26,081,"Michigan","Kent County",3,51,8029,4015,4014
050,26,081,"Michigan","Kent County",3,52,7727,3869,3858
050,26,081,"Michigan","Kent County",3,53,7515,3804,3711
050,26,081,"Michigan","Kent County",3,54,7462,3730,3732
050,26,081,"Michigan","Kent County",3,55,7564,3740,3824
050,26,081,"Michigan","Kent County",3,56,7854,3867,3987
050,26,081,"Michigan","Kent County",3,57,8086,4051,4035
050,26,081,"Michigan","Kent County",3,58,8168,4072,4096
050,26,081,"Michigan","Kent County",3,59,8289,4102,4187
050,26,081,"Michigan","Kent County",3,60,8215,4021,4194
050,26,081,"Michigan","Kent County",3,61,8043,3929,4114
050,26,081,"Michigan","Kent County",3,62,7904,3906,3998
050,26,081,"Michigan","Kent County",3,63,7774,3812,3962
050,26,081,"Michigan","Kent County",3,64,7695,3735,3960
050,26,081,"Michigan","Kent County",3,65,7260,3502,3758
050,26,081,"Michigan","Kent County",3,66,6994,3371,3623
050,26,081,"Michigan","Kent County",3,67,6777,3253,3524
050,26,081,"Michigan","Kent County",3,68,6501,3129,3372
050,26,081,"Michigan","Kent County",3,69,6150,2957,3193
050,26,081,"Michigan","Kent County",3,70,5722,2705,3017
050,26,081,"Michigan","Kent County",3,71,5229,2462,2767
050,26,081,"Michigan","Kent County",3,72,4966,2300,2666
050,26,081,"Michigan","Kent County",3,73,4733,2151,2582
050,26,081,"Michigan","Kent County",3,74,4960,2289,2671
050,26,081,"Michigan","Kent County",3,75,3397,1542,1855
050,26,081,"Michigan","Kent County",3,76,3200,1436,1764
050,26,081,"Michigan","Kent County",3,77,3113,1357,1756
050,26,081,"Michigan","Kent County",3,78,3210,1425,1785
050,26,081,"Michigan","Kent County",3,79,2750,1192,1558
050,26,081,"Michigan","Kent County",3,80,2448,1042,1406
050,26,081,"Michigan","Kent County",3,81,2145,906,1239
050,26,081,"Michigan","Kent County",3,82,2036,877,1159
050,26,081,"Michigan","Kent County",3,83,1925,825,1100
050,26,081,"Michigan","Kent County",3,84,1647,647,1000
050,26,081,"Michigan","Kent County",3,85,10059,3626,6433
050,26,081,"Michigan","Kent County",4,0,8143,4203,3940
050,26,081,"Michigan","Kent County",4,1,7854,4107,3747
050,26,081,"Michigan","Kent County",4,2,8186,4210,3976
050,26,081,"Michigan","Kent County",4,3,8156,4124,4032
050,26,081,"Michigan","Kent County",4,4,8271,4207,4064
050,26,081,"Michigan","Kent County",4,5,8417,4316,4101
050,26,081,"Michigan","Kent County",4,6,8663,4464,4199
050,26,081,"Michigan","Kent County",4,7,8715,4444,4271
050,26,081,"Michigan","Kent County",4,8,8619,4416,4203
050,26,081,"Michigan","Kent County",4,9,8616,4442,4174
050,26,081,"Michigan","Kent County",4,10,8579,4429,4150
050,26,081,"Michigan","Kent County",4,11,8576,4454,4122
050,26,081,"Michigan","Kent County",4,12,8629,4398,4231
050,26,081,"Michigan","Kent County",4,13,8835,4562,4273
050,26,081,"Michigan","Kent County",4,14,9100,4671,4429
050,26,081,"Michigan","Kent County",4,15,9252,4774,4478
050,26,081,"Michigan","Kent County",4,16,9091,4684,4407
050,26,081,"Michigan","Kent County",4,17,8970,4635,4335
050,26,081,"Michigan","Kent County",4,18,8782,4460,4322
050,26,081,"Michigan","Kent County",4,19,8287,4117,4170
050,26,081,"Michigan","Kent County",4,20,8084,4028,4056
050,26,081,"Michigan","Kent County",4,21,8151,4081,4070
050,26,081,"Michigan","Kent County",4,22,8695,4298,4397
050,26,081,"Michigan","Kent County",4,23,9242,4529,4713
050,26,081,"Michigan","Kent County",4,24,9663,4719,4944
050,26,081,"Michigan","Kent County",4,25,10124,5015,5109
050,26,081,"Michigan","Kent County",4,26,10035,4966,5069
050,26,081,"Michigan","Kent County",4,27,10327,5228,5099
050,26,081,"Michigan","Kent County",4,28,10429,5337,5092
050,26,081,"Michigan","Kent County",4,29,10569,5343,5226
050,26,081,"Michigan","Kent County",4,30,10743,5458,5285
050,26,081,"Michigan","Kent County",4,31,10655,5365,5290
050,26,081,"Michigan","Kent County",4,32,10619,5320,5299
050,26,081,"Michigan","Kent County",4,33,10295,5198,5097
050,26,081,"Michigan","Kent County",4,34,10019,5018,5001
050,26,081,"Michigan","Kent County",4,35,9535,4807,4728
050,26,081,"Michigan","Kent County",4,36,9413,4747,4666
050,26,081,"Michigan","Kent County",4,37,9417,4722,4695
050,26,081,"Michigan","Kent County",4,38,9135,4568,4567
050,26,081,"Michigan","Kent County",4,39,9063,4545,4518
050,26,081,"Michigan","Kent County",4,40,9036,4585,4451
050,26,081,"Michigan","Kent County",4,41,8797,4508,4289
050,26,081,"Michigan","Kent County",4,42,8653,4371,4282
050,26,081,"Michigan","Kent County",4,43,8217,4093,4124
050,26,081,"Michigan","Kent County",4,44,7773,3866,3907
050,26,081,"Michigan","Kent County",4,45,7638,3805,3833
050,26,081,"Michigan","Kent County",4,46,7241,3625,3616
050,26,081,"Michigan","Kent County",4,47,7201,3614,3587
050,26,081,"Michigan","Kent County",4,48,6950,3473,3477
050,26,081,"Michigan","Kent County",4,49,6982,3508,3474
050,26,081,"Michigan","Kent County",4,50,7359,3722,3637
050,26,081,"Michigan","Kent County",4,51,7885,3976,3909
050,26,081,"Michigan","Kent County",4,52,7924,3958,3966
050,26,081,"Michigan","Kent County",4,53,7611,3776,3835
050,26,081,"Michigan","Kent County",4,54,7415,3760,3655
050,26,081,"Michigan","Kent County",4,55,7333,3667,3666
050,26,081,"Michigan","Kent County",4,56,7430,3683,3747
050,26,081,"Michigan","Kent County",4,57,7712,3790,3922
050,26,081,"Michigan","Kent County",4,58,7966,3970,3996
050,26,081,"Michigan","Kent County",4,59,8054,4022,4032
050,26,081,"Michigan","Kent County",4,60,8080,3996,4084
050,26,081,"Michigan","Kent County",4,61,8078,3972,4106
050,26,081,"Michigan","Kent County",4,62,7885,3836,4049
050,26,081,"Michigan","Kent County",4,63,7668,3779,3889
050,26,081,"Michigan","Kent County",4,64,7613,3721,3892
050,26,081,"Michigan","Kent County",4,65,7498,3623,3875
050,26,081,"Michigan","Kent County",4,66,7141,3419,3722
050,26,081,"Michigan","Kent County",4,67,6843,3270,3573
050,26,081,"Michigan","Kent County",4,68,6605,3140,3465
050,26,081,"Michigan","Kent County",4,69,6343,3034,3309
050,26,081,"Michigan","Kent County",4,70,6025,2879,3146
050,26,081,"Michigan","Kent County",4,71,5599,2634,2965
050,26,081,"Michigan","Kent County",4,72,5125,2416,2709
050,26,081,"Michigan","Kent County",4,73,4824,2207,2617
050,26,081,"Michigan","Kent County",4,74,4593,2089,2504
050,26,081,"Michigan","Kent County",4,75,4834,2221,2613
050,26,081,"Michigan","Kent County",4,76,3285,1475,1810
050,26,081,"Michigan","Kent County",4,77,3117,1387,1730
050,26,081,"Michigan","Kent County",4,78,3014,1323,1691
050,26,081,"Michigan","Kent County",4,79,3085,1368,1717
050,26,081,"Michigan","Kent County",4,80,2620,1120,1500
050,26,081,"Michigan","Kent County",4,81,2316,984,1332
050,26,081,"Michigan","Kent County",4,82,2021,840,1181
050,26,081,"Michigan","Kent County",4,83,1893,817,1076
050,26,081,"Michigan","Kent County",4,84,1786,750,1036
050,26,081,"Michigan","Kent County",4,85,9898,3567,6331
050,26,081,"Michigan","Kent County",5,0,8154,4213,3941
050,26,081,"Michigan","Kent County",5,1,8037,4159,3878
050,26,081,"Michigan","Kent County",5,2,7829,4075,3754
050,26,081,"Michigan","Kent County",5,3,8147,4182,3965
050,26,081,"Michigan","Kent County",5,4,8106,4105,4001
050,26,081,"Michigan","Kent County",5,5,8290,4189,4101
050,26,081,"Michigan","Kent County",5,6,8376,4283,4093
050,26,081,"Michigan","Kent County",5,7,8632,4453,4179
050,26,081,"Michigan","Kent County",5,8,8685,4411,4274
050,26,081,"Michigan","Kent County",5,9,8614,4426,4188
050,26,081,"Michigan","Kent County",5,10,8646,4441,4205
050,26,081,"Michigan","Kent County",5,11,8558,4440,4118
050,26,081,"Michigan","Kent County",5,12,8534,4455,4079
050,26,081,"Michigan","Kent County",5,13,8590,4360,4230
050,26,081,"Michigan","Kent County",5,14,8819,4556,4263
050,26,081,"Michigan","Kent County",5,15,9071,4652,4419
050,26,081,"Michigan","Kent County",5,16,9264,4765,4499
050,26,081,"Michigan","Kent County",5,17,9158,4743,4415
050,26,081,"Michigan","Kent County",5,18,8707,4490,4217
050,26,081,"Michigan","Kent County",5,19,8468,4236,4232
050,26,081,"Michigan","Kent County",5,20,8147,4007,4140
050,26,081,"Michigan","Kent County",5,21,7927,3916,4011
050,26,081,"Michigan","Kent County",5,22,8589,4282,4307
050,26,081,"Michigan","Kent County",5,23,9348,4529,4819
050,26,081,"Michigan","Kent County",5,24,9866,4866,5000
050,26,081,"Michigan","Kent County",5,25,9954,4945,5009
050,26,081,"Michigan","Kent County",5,26,10155,5025,5130
050,26,081,"Michigan","Kent County",5,27,10093,5030,5063
050,26,081,"Michigan","Kent County",5,28,10313,5210,5103
050,26,081,"Michigan","Kent County",5,29,10463,5383,5080
050,26,081,"Michigan","Kent County",5,30,10496,5280,5216
050,26,081,"Michigan","Kent County",5,31,10711,5451,5260
050,26,081,"Michigan","Kent County",5,32,10677,5360,5317
050,26,081,"Michigan","Kent County",5,33,10585,5326,5259
050,26,081,"Michigan","Kent County",5,34,10166,5160,5006
050,26,081,"Michigan","Kent County",5,35,10014,4987,5027
050,26,081,"Michigan","Kent County",5,36,9508,4824,4684
050,26,081,"Michigan","Kent County",5,37,9360,4698,4662
050,26,081,"Michigan","Kent County",5,38,9328,4673,4655
050,26,081,"Michigan","Kent County",5,39,8996,4478,4518
050,26,081,"Michigan","Kent County",5,40,9026,4482,4544
050,26,081,"Michigan","Kent County",5,41,8957,4564,4393
050,26,081,"Michigan","Kent County",5,42,8761,4482,4279
050,26,081,"Michigan","Kent County",5,43,8598,4333,4265
050,26,081,"Michigan","Kent County",5,44,8160,4059,4101
050,26,081,"Michigan","Kent County",5,45,7738,3840,3898
050,26,081,"Michigan","Kent County",5,46,7542,3768,3774
050,26,081,"Michigan","Kent County",5,47,7183,3579,3604
050,26,081,"Michigan","Kent County",5,48,7133,3566,3567
050,26,081,"Michigan","Kent County",5,49,6895,3449,3446
050,26,081,"Michigan","Kent County",5,50,6910,3467,3443
050,26,081,"Michigan","Kent County",5,51,7322,3713,3609
050,26,081,"Michigan","Kent County",5,52,7805,3931,3874
050,26,081,"Michigan","Kent County",5,53,7820,3912,3908
050,26,081,"Michigan","Kent County",5,54,7543,3751,3792
050,26,081,"Michigan","Kent County",5,55,7297,3684,3613
050,26,081,"Michigan","Kent County",5,56,7300,3639,3661
050,26,081,"Michigan","Kent County",5,57,7347,3650,3697
050,26,081,"Michigan","Kent County",5,58,7592,3716,3876
050,26,081,"Michigan","Kent County",5,59,7868,3899,3969
050,26,081,"Michigan","Kent County",5,60,7887,3892,3995
050,26,081,"Michigan","Kent County",5,61,8001,3951,4050
050,26,081,"Michigan","Kent County",5,62,7955,3880,4075
050,26,081,"Michigan","Kent County",5,63,7691,3736,3955
050,26,081,"Michigan","Kent County",5,64,7512,3697,3815
050,26,081,"Michigan","Kent County",5,65,7459,3653,3806
050,26,081,"Michigan","Kent County",5,66,7400,3569,3831
050,26,081,"Michigan","Kent County",5,67,6980,3327,3653
050,26,081,"Michigan","Kent County",5,68,6754,3208,3546
050,26,081,"Michigan","Kent County",5,69,6493,3068,3425
050,26,081,"Michigan","Kent County",5,70,6259,2997,3262
050,26,081,"Michigan","Kent County",5,71,5899,2806,3093
050,26,081,"Michigan","Kent County",5,72,5482,2583,2899
050,26,081,"Michigan","Kent County",5,73,5003,2346,2657
050,26,081,"Michigan","Kent County",5,74,4682,2137,2545
050,26,081,"Michigan","Kent County",5,75,4510,2034,2476
050,26,081,"Michigan","Kent County",5,76,4721,2150,2571
050,26,081,"Michigan","Kent County",5,77,3210,1432,1778
050,26,081,"Michigan","Kent County",5,78,3013,1334,1679
050,26,081,"Michigan","Kent County",5,79,2915,1283,1632
050,26,081,"Michigan","Kent County",5,80,2957,1290,1667
050,26,081,"Michigan","Kent County",5,81,2497,1057,1440
050,26,081,"Michigan","Kent County",5,82,2218,917,1301
050,26,081,"Michigan","Kent County",5,83,1889,794,1095
050,26,081,"Michigan","Kent County",5,84,1783,749,1034
050,26,081,"Michigan","Kent County",5,85,10006,3668,6338
050,26,083,"Michigan","Keweenaw County",1,0,12,6,6
050,26,083,"Michigan","Keweenaw County",1,1,14,8,6
050,26,083,"Michigan","Keweenaw County",1,2,24,8,16
050,26,083,"Michigan","Keweenaw County",1,3,18,10,8
050,26,083,"Michigan","Keweenaw County",1,4,18,8,10
050,26,083,"Michigan","Keweenaw County",1,5,18,10,8
050,26,083,"Michigan","Keweenaw County",1,6,23,15,8
050,26,083,"Michigan","Keweenaw County",1,7,18,9,9
050,26,083,"Michigan","Keweenaw County",1,8,11,7,4
050,26,083,"Michigan","Keweenaw County",1,9,17,10,7
050,26,083,"Michigan","Keweenaw County",1,10,15,8,7
050,26,083,"Michigan","Keweenaw County",1,11,16,6,10
050,26,083,"Michigan","Keweenaw County",1,12,17,7,10
050,26,083,"Michigan","Keweenaw County",1,13,22,10,12
050,26,083,"Michigan","Keweenaw County",1,14,22,8,14
050,26,083,"Michigan","Keweenaw County",1,15,16,8,8
050,26,083,"Michigan","Keweenaw County",1,16,21,11,10
050,26,083,"Michigan","Keweenaw County",1,17,17,7,10
050,26,083,"Michigan","Keweenaw County",1,18,18,8,10
050,26,083,"Michigan","Keweenaw County",1,19,14,6,8
050,26,083,"Michigan","Keweenaw County",1,20,14,6,8
050,26,083,"Michigan","Keweenaw County",1,21,14,8,6
050,26,083,"Michigan","Keweenaw County",1,22,13,5,8
050,26,083,"Michigan","Keweenaw County",1,23,14,8,6
050,26,083,"Michigan","Keweenaw County",1,24,17,10,7
050,26,083,"Michigan","Keweenaw County",1,25,13,7,6
050,26,083,"Michigan","Keweenaw County",1,26,14,9,5
050,26,083,"Michigan","Keweenaw County",1,27,15,7,8
050,26,083,"Michigan","Keweenaw County",1,28,22,11,11
050,26,083,"Michigan","Keweenaw County",1,29,20,8,12
050,26,083,"Michigan","Keweenaw County",1,30,16,9,7
050,26,083,"Michigan","Keweenaw County",1,31,18,12,6
050,26,083,"Michigan","Keweenaw County",1,32,9,4,5
050,26,083,"Michigan","Keweenaw County",1,33,13,6,7
050,26,083,"Michigan","Keweenaw County",1,34,11,5,6
050,26,083,"Michigan","Keweenaw County",1,35,15,8,7
050,26,083,"Michigan","Keweenaw County",1,36,20,8,12
050,26,083,"Michigan","Keweenaw County",1,37,16,8,8
050,26,083,"Michigan","Keweenaw County",1,38,13,5,8
050,26,083,"Michigan","Keweenaw County",1,39,15,8,7
050,26,083,"Michigan","Keweenaw County",1,40,21,13,8
050,26,083,"Michigan","Keweenaw County",1,41,16,9,7
050,26,083,"Michigan","Keweenaw County",1,42,14,8,6
050,26,083,"Michigan","Keweenaw County",1,43,15,9,6
050,26,083,"Michigan","Keweenaw County",1,44,22,10,12
050,26,083,"Michigan","Keweenaw County",1,45,24,12,12
050,26,083,"Michigan","Keweenaw County",1,46,17,8,9
050,26,083,"Michigan","Keweenaw County",1,47,18,9,9
050,26,083,"Michigan","Keweenaw County",1,48,22,10,12
050,26,083,"Michigan","Keweenaw County",1,49,21,12,9
050,26,083,"Michigan","Keweenaw County",1,50,23,12,11
050,26,083,"Michigan","Keweenaw County",1,51,19,10,9
050,26,083,"Michigan","Keweenaw County",1,52,16,7,9
050,26,083,"Michigan","Keweenaw County",1,53,21,9,12
050,26,083,"Michigan","Keweenaw County",1,54,20,8,12
050,26,083,"Michigan","Keweenaw County",1,55,27,16,11
050,26,083,"Michigan","Keweenaw County",1,56,30,16,14
050,26,083,"Michigan","Keweenaw County",1,57,38,18,20
050,26,083,"Michigan","Keweenaw County",1,58,34,16,18
050,26,083,"Michigan","Keweenaw County",1,59,38,20,18
050,26,083,"Michigan","Keweenaw County",1,60,32,15,17
050,26,083,"Michigan","Keweenaw County",1,61,38,17,21
050,26,083,"Michigan","Keweenaw County",1,62,41,23,18
050,26,083,"Michigan","Keweenaw County",1,63,39,20,19
050,26,083,"Michigan","Keweenaw County",1,64,43,22,21
050,26,083,"Michigan","Keweenaw County",1,65,42,19,23
050,26,083,"Michigan","Keweenaw County",1,66,51,28,23
050,26,083,"Michigan","Keweenaw County",1,67,48,20,28
050,26,083,"Michigan","Keweenaw County",1,68,36,16,20
050,26,083,"Michigan","Keweenaw County",1,69,47,18,29
050,26,083,"Michigan","Keweenaw County",1,70,54,27,27
050,26,083,"Michigan","Keweenaw County",1,71,44,25,19
050,26,083,"Michigan","Keweenaw County",1,72,51,33,18
050,26,083,"Michigan","Keweenaw County",1,73,47,30,17
050,26,083,"Michigan","Keweenaw County",1,74,34,23,11
050,26,083,"Michigan","Keweenaw County",1,75,31,18,13
050,26,083,"Michigan","Keweenaw County",1,76,31,17,14
050,26,083,"Michigan","Keweenaw County",1,77,34,24,10
050,26,083,"Michigan","Keweenaw County",1,78,34,16,18
050,26,083,"Michigan","Keweenaw County",1,79,27,15,12
050,26,083,"Michigan","Keweenaw County",1,80,23,15,8
050,26,083,"Michigan","Keweenaw County",1,81,13,7,6
050,26,083,"Michigan","Keweenaw County",1,82,9,5,4
050,26,083,"Michigan","Keweenaw County",1,83,18,8,10
050,26,083,"Michigan","Keweenaw County",1,84,18,7,11
050,26,083,"Michigan","Keweenaw County",1,85,53,19,34
050,26,083,"Michigan","Keweenaw County",2,0,15,10,5
050,26,083,"Michigan","Keweenaw County",2,1,14,8,6
050,26,083,"Michigan","Keweenaw County",2,2,23,9,14
050,26,083,"Michigan","Keweenaw County",2,3,21,10,11
050,26,083,"Michigan","Keweenaw County",2,4,20,9,11
050,26,083,"Michigan","Keweenaw County",2,5,20,10,10
050,26,083,"Michigan","Keweenaw County",2,6,23,15,8
050,26,083,"Michigan","Keweenaw County",2,7,19,10,9
050,26,083,"Michigan","Keweenaw County",2,8,12,7,5
050,26,083,"Michigan","Keweenaw County",2,9,16,9,7
050,26,083,"Michigan","Keweenaw County",2,10,15,8,7
050,26,083,"Michigan","Keweenaw County",2,11,15,6,9
050,26,083,"Michigan","Keweenaw County",2,12,17,7,10
050,26,083,"Michigan","Keweenaw County",2,13,20,9,11
050,26,083,"Michigan","Keweenaw County",2,14,22,8,14
050,26,083,"Michigan","Keweenaw County",2,15,17,8,9
050,26,083,"Michigan","Keweenaw County",2,16,20,10,10
050,26,083,"Michigan","Keweenaw County",2,17,18,8,10
050,26,083,"Michigan","Keweenaw County",2,18,17,7,10
050,26,083,"Michigan","Keweenaw County",2,19,14,6,8
050,26,083,"Michigan","Keweenaw County",2,20,14,6,8
050,26,083,"Michigan","Keweenaw County",2,21,14,7,7
050,26,083,"Michigan","Keweenaw County",2,22,15,7,8
050,26,083,"Michigan","Keweenaw County",2,23,15,8,7
050,26,083,"Michigan","Keweenaw County",2,24,17,10,7
050,26,083,"Michigan","Keweenaw County",2,25,13,8,5
050,26,083,"Michigan","Keweenaw County",2,26,14,9,5
050,26,083,"Michigan","Keweenaw County",2,27,16,7,9
050,26,083,"Michigan","Keweenaw County",2,28,21,10,11
050,26,083,"Michigan","Keweenaw County",2,29,21,9,12
050,26,083,"Michigan","Keweenaw County",2,30,18,10,8
050,26,083,"Michigan","Keweenaw County",2,31,18,12,6
050,26,083,"Michigan","Keweenaw County",2,32,11,6,5
050,26,083,"Michigan","Keweenaw County",2,33,12,6,6
050,26,083,"Michigan","Keweenaw County",2,34,11,5,6
050,26,083,"Michigan","Keweenaw County",2,35,14,7,7
050,26,083,"Michigan","Keweenaw County",2,36,19,8,11
050,26,083,"Michigan","Keweenaw County",2,37,16,8,8
050,26,083,"Michigan","Keweenaw County",2,38,14,6,8
050,26,083,"Michigan","Keweenaw County",2,39,14,7,7
050,26,083,"Michigan","Keweenaw County",2,40,20,12,8
050,26,083,"Michigan","Keweenaw County",2,41,17,10,7
050,26,083,"Michigan","Keweenaw County",2,42,14,8,6
050,26,083,"Michigan","Keweenaw County",2,43,16,10,6
050,26,083,"Michigan","Keweenaw County",2,44,20,10,10
050,26,083,"Michigan","Keweenaw County",2,45,24,12,12
050,26,083,"Michigan","Keweenaw County",2,46,19,9,10
050,26,083,"Michigan","Keweenaw County",2,47,18,9,9
050,26,083,"Michigan","Keweenaw County",2,48,21,10,11
050,26,083,"Michigan","Keweenaw County",2,49,21,11,10
050,26,083,"Michigan","Keweenaw County",2,50,23,12,11
050,26,083,"Michigan","Keweenaw County",2,51,19,10,9
050,26,083,"Michigan","Keweenaw County",2,52,17,8,9
050,26,083,"Michigan","Keweenaw County",2,53,21,9,12
050,26,083,"Michigan","Keweenaw County",2,54,20,8,12
050,26,083,"Michigan","Keweenaw County",2,55,25,14,11
050,26,083,"Michigan","Keweenaw County",2,56,30,16,14
050,26,083,"Michigan","Keweenaw County",2,57,37,18,19
050,26,083,"Michigan","Keweenaw County",2,58,35,16,19
050,26,083,"Michigan","Keweenaw County",2,59,37,19,18
050,26,083,"Michigan","Keweenaw County",2,60,33,16,17
050,26,083,"Michigan","Keweenaw County",2,61,37,16,21
050,26,083,"Michigan","Keweenaw County",2,62,39,21,18
050,26,083,"Michigan","Keweenaw County",2,63,40,21,19
050,26,083,"Michigan","Keweenaw County",2,64,41,20,21
050,26,083,"Michigan","Keweenaw County",2,65,42,20,22
050,26,083,"Michigan","Keweenaw County",2,66,49,26,23
050,26,083,"Michigan","Keweenaw County",2,67,49,22,27
050,26,083,"Michigan","Keweenaw County",2,68,39,17,22
050,26,083,"Michigan","Keweenaw County",2,69,45,18,27
050,26,083,"Michigan","Keweenaw County",2,70,52,25,27
050,26,083,"Michigan","Keweenaw County",2,71,46,25,21
050,26,083,"Michigan","Keweenaw County",2,72,49,31,18
050,26,083,"Michigan","Keweenaw County",2,73,51,33,18
050,26,083,"Michigan","Keweenaw County",2,74,33,22,11
050,26,083,"Michigan","Keweenaw County",2,75,32,19,13
050,26,083,"Michigan","Keweenaw County",2,76,31,17,14
050,26,083,"Michigan","Keweenaw County",2,77,35,23,12
050,26,083,"Michigan","Keweenaw County",2,78,33,18,15
050,26,083,"Michigan","Keweenaw County",2,79,28,15,13
050,26,083,"Michigan","Keweenaw County",2,80,24,15,9
050,26,083,"Michigan","Keweenaw County",2,81,16,9,7
050,26,083,"Michigan","Keweenaw County",2,82,10,6,4
050,26,083,"Michigan","Keweenaw County",2,83,16,7,9
050,26,083,"Michigan","Keweenaw County",2,84,17,7,10
050,26,083,"Michigan","Keweenaw County",2,85,54,19,35
050,26,083,"Michigan","Keweenaw County",3,0,13,5,8
050,26,083,"Michigan","Keweenaw County",3,1,13,8,5
050,26,083,"Michigan","Keweenaw County",3,2,14,8,6
050,26,083,"Michigan","Keweenaw County",3,3,26,10,16
050,26,083,"Michigan","Keweenaw County",3,4,20,9,11
050,26,083,"Michigan","Keweenaw County",3,5,21,9,12
050,26,083,"Michigan","Keweenaw County",3,6,19,9,10
050,26,083,"Michigan","Keweenaw County",3,7,24,15,9
050,26,083,"Michigan","Keweenaw County",3,8,19,10,9
050,26,083,"Michigan","Keweenaw County",3,9,13,4,9
050,26,083,"Michigan","Keweenaw County",3,10,17,9,8
050,26,083,"Michigan","Keweenaw County",3,11,16,8,8
050,26,083,"Michigan","Keweenaw County",3,12,14,5,9
050,26,083,"Michigan","Keweenaw County",3,13,20,10,10
050,26,083,"Michigan","Keweenaw County",3,14,22,9,13
050,26,083,"Michigan","Keweenaw County",3,15,23,9,14
050,26,083,"Michigan","Keweenaw County",3,16,21,9,12
050,26,083,"Michigan","Keweenaw County",3,17,26,12,14
050,26,083,"Michigan","Keweenaw County",3,18,15,6,9
050,26,083,"Michigan","Keweenaw County",3,19,14,6,8
050,26,083,"Michigan","Keweenaw County",3,20,20,8,12
050,26,083,"Michigan","Keweenaw County",3,21,15,6,9
050,26,083,"Michigan","Keweenaw County",3,22,16,7,9
050,26,083,"Michigan","Keweenaw County",3,23,19,10,9
050,26,083,"Michigan","Keweenaw County",3,24,12,5,7
050,26,083,"Michigan","Keweenaw County",3,25,19,13,6
050,26,083,"Michigan","Keweenaw County",3,26,12,7,5
050,26,083,"Michigan","Keweenaw County",3,27,16,11,5
050,26,083,"Michigan","Keweenaw County",3,28,16,8,8
050,26,083,"Michigan","Keweenaw County",3,29,21,10,11
050,26,083,"Michigan","Keweenaw County",3,30,22,9,13
050,26,083,"Michigan","Keweenaw County",3,31,19,11,8
050,26,083,"Michigan","Keweenaw County",3,32,19,12,7
050,26,083,"Michigan","Keweenaw County",3,33,11,6,5
050,26,083,"Michigan","Keweenaw County",3,34,12,6,6
050,26,083,"Michigan","Keweenaw County",3,35,10,5,5
050,26,083,"Michigan","Keweenaw County",3,36,20,11,9
050,26,083,"Michigan","Keweenaw County",3,37,20,9,11
050,26,083,"Michigan","Keweenaw County",3,38,21,12,9
050,26,083,"Michigan","Keweenaw County",3,39,16,6,10
050,26,083,"Michigan","Keweenaw County",3,40,15,8,7
050,26,083,"Michigan","Keweenaw County",3,41,19,12,7
050,26,083,"Michigan","Keweenaw County",3,42,21,11,10
050,26,083,"Michigan","Keweenaw County",3,43,14,9,5
050,26,083,"Michigan","Keweenaw County",3,44,17,11,6
050,26,083,"Michigan","Keweenaw County",3,45,22,10,12
050,26,083,"Michigan","Keweenaw County",3,46,24,12,12
050,26,083,"Michigan","Keweenaw County",3,47,23,10,13
050,26,083,"Michigan","Keweenaw County",3,48,20,9,11
050,26,083,"Michigan","Keweenaw County",3,49,24,10,14
050,26,083,"Michigan","Keweenaw County",3,50,24,14,10
050,26,083,"Michigan","Keweenaw County",3,51,23,11,12
050,26,083,"Michigan","Keweenaw County",3,52,21,11,10
050,26,083,"Michigan","Keweenaw County",3,53,18,9,9
050,26,083,"Michigan","Keweenaw County",3,54,20,8,12
050,26,083,"Michigan","Keweenaw County",3,55,19,8,11
050,26,083,"Michigan","Keweenaw County",3,56,26,15,11
050,26,083,"Michigan","Keweenaw County",3,57,30,15,15
050,26,083,"Michigan","Keweenaw County",3,58,35,16,19
050,26,083,"Michigan","Keweenaw County",3,59,37,17,20
050,26,083,"Michigan","Keweenaw County",3,60,36,18,18
050,26,083,"Michigan","Keweenaw County",3,61,34,17,17
050,26,083,"Michigan","Keweenaw County",3,62,38,17,21
050,26,083,"Michigan","Keweenaw County",3,63,43,21,22
050,26,083,"Michigan","Keweenaw County",3,64,35,16,19
050,26,083,"Michigan","Keweenaw County",3,65,41,20,21
050,26,083,"Michigan","Keweenaw County",3,66,41,19,22
050,26,083,"Michigan","Keweenaw County",3,67,48,26,22
050,26,083,"Michigan","Keweenaw County",3,68,47,21,26
050,26,083,"Michigan","Keweenaw County",3,69,36,15,21
050,26,083,"Michigan","Keweenaw County",3,70,48,20,28
050,26,083,"Michigan","Keweenaw County",3,71,53,26,27
050,26,083,"Michigan","Keweenaw County",3,72,45,24,21
050,26,083,"Michigan","Keweenaw County",3,73,48,30,18
050,26,083,"Michigan","Keweenaw County",3,74,50,32,18
050,26,083,"Michigan","Keweenaw County",3,75,34,22,12
050,26,083,"Michigan","Keweenaw County",3,76,31,18,13
050,26,083,"Michigan","Keweenaw County",3,77,26,14,12
050,26,083,"Michigan","Keweenaw County",3,78,33,21,12
050,26,083,"Michigan","Keweenaw County",3,79,32,19,13
050,26,083,"Michigan","Keweenaw County",3,80,29,16,13
050,26,083,"Michigan","Keweenaw County",3,81,22,13,9
050,26,083,"Michigan","Keweenaw County",3,82,15,9,6
050,26,083,"Michigan","Keweenaw County",3,83,9,6,3
050,26,083,"Michigan","Keweenaw County",3,84,16,7,9
050,26,083,"Michigan","Keweenaw County",3,85,60,20,40
050,26,083,"Michigan","Keweenaw County",4,0,10,3,7
050,26,083,"Michigan","Keweenaw County",4,1,14,6,8
050,26,083,"Michigan","Keweenaw County",4,2,10,7,3
050,26,083,"Michigan","Keweenaw County",4,3,14,8,6
050,26,083,"Michigan","Keweenaw County",4,4,23,8,15
050,26,083,"Michigan","Keweenaw County",4,5,20,8,12
050,26,083,"Michigan","Keweenaw County",4,6,20,8,12
050,26,083,"Michigan","Keweenaw County",4,7,25,13,12
050,26,083,"Michigan","Keweenaw County",4,8,26,17,9
050,26,083,"Michigan","Keweenaw County",4,9,19,10,9
050,26,083,"Michigan","Keweenaw County",4,10,16,8,8
050,26,083,"Michigan","Keweenaw County",4,11,19,10,9
050,26,083,"Michigan","Keweenaw County",4,12,20,8,12
050,26,083,"Michigan","Keweenaw County",4,13,18,5,13
050,26,083,"Michigan","Keweenaw County",4,14,18,9,9
050,26,083,"Michigan","Keweenaw County",4,15,22,9,13
050,26,083,"Michigan","Keweenaw County",4,16,24,9,15
050,26,083,"Michigan","Keweenaw County",4,17,20,9,11
050,26,083,"Michigan","Keweenaw County",4,18,23,11,12
050,26,083,"Michigan","Keweenaw County",4,19,10,5,5
050,26,083,"Michigan","Keweenaw County",4,20,15,5,10
050,26,083,"Michigan","Keweenaw County",4,21,24,10,14
050,26,083,"Michigan","Keweenaw County",4,22,16,6,10
050,26,083,"Michigan","Keweenaw County",4,23,13,7,6
050,26,083,"Michigan","Keweenaw County",4,24,18,8,10
050,26,083,"Michigan","Keweenaw County",4,25,17,9,8
050,26,083,"Michigan","Keweenaw County",4,26,20,13,7
050,26,083,"Michigan","Keweenaw County",4,27,18,10,8
050,26,083,"Michigan","Keweenaw County",4,28,16,11,5
050,26,083,"Michigan","Keweenaw County",4,29,17,11,6
050,26,083,"Michigan","Keweenaw County",4,30,21,9,12
050,26,083,"Michigan","Keweenaw County",4,31,23,13,10
050,26,083,"Michigan","Keweenaw County",4,32,19,9,10
050,26,083,"Michigan","Keweenaw County",4,33,22,13,9
050,26,083,"Michigan","Keweenaw County",4,34,12,6,6
050,26,083,"Michigan","Keweenaw County",4,35,15,8,7
050,26,083,"Michigan","Keweenaw County",4,36,11,5,6
050,26,083,"Michigan","Keweenaw County",4,37,22,12,10
050,26,083,"Michigan","Keweenaw County",4,38,20,9,11
050,26,083,"Michigan","Keweenaw County",4,39,22,13,9
050,26,083,"Michigan","Keweenaw County",4,40,17,6,11
050,26,083,"Michigan","Keweenaw County",4,41,14,8,6
050,26,083,"Michigan","Keweenaw County",4,42,20,13,7
050,26,083,"Michigan","Keweenaw County",4,43,21,11,10
050,26,083,"Michigan","Keweenaw County",4,44,15,9,6
050,26,083,"Michigan","Keweenaw County",4,45,17,11,6
050,26,083,"Michigan","Keweenaw County",4,46,22,10,12
050,26,083,"Michigan","Keweenaw County",4,47,25,13,12
050,26,083,"Michigan","Keweenaw County",4,48,26,13,13
050,26,083,"Michigan","Keweenaw County",4,49,18,7,11
050,26,083,"Michigan","Keweenaw County",4,50,26,11,15
050,26,083,"Michigan","Keweenaw County",4,51,25,14,11
050,26,083,"Michigan","Keweenaw County",4,52,27,12,15
050,26,083,"Michigan","Keweenaw County",4,53,26,13,13
050,26,083,"Michigan","Keweenaw County",4,54,19,10,9
050,26,083,"Michigan","Keweenaw County",4,55,22,9,13
050,26,083,"Michigan","Keweenaw County",4,56,19,8,11
050,26,083,"Michigan","Keweenaw County",4,57,28,16,12
050,26,083,"Michigan","Keweenaw County",4,58,31,15,16
050,26,083,"Michigan","Keweenaw County",4,59,36,16,20
050,26,083,"Michigan","Keweenaw County",4,60,37,17,20
050,26,083,"Michigan","Keweenaw County",4,61,37,16,21
050,26,083,"Michigan","Keweenaw County",4,62,41,20,21
050,26,083,"Michigan","Keweenaw County",4,63,39,18,21
050,26,083,"Michigan","Keweenaw County",4,64,43,24,19
050,26,083,"Michigan","Keweenaw County",4,65,34,13,21
050,26,083,"Michigan","Keweenaw County",4,66,40,20,20
050,26,083,"Michigan","Keweenaw County",4,67,41,19,22
050,26,083,"Michigan","Keweenaw County",4,68,47,26,21
050,26,083,"Michigan","Keweenaw County",4,69,47,22,25
050,26,083,"Michigan","Keweenaw County",4,70,39,17,22
050,26,083,"Michigan","Keweenaw County",4,71,50,22,28
050,26,083,"Michigan","Keweenaw County",4,72,52,25,27
050,26,083,"Michigan","Keweenaw County",4,73,44,24,20
050,26,083,"Michigan","Keweenaw County",4,74,46,27,19
050,26,083,"Michigan","Keweenaw County",4,75,50,31,19
050,26,083,"Michigan","Keweenaw County",4,76,31,21,10
050,26,083,"Michigan","Keweenaw County",4,77,32,19,13
050,26,083,"Michigan","Keweenaw County",4,78,28,15,13
050,26,083,"Michigan","Keweenaw County",4,79,28,18,10
050,26,083,"Michigan","Keweenaw County",4,80,32,20,12
050,26,083,"Michigan","Keweenaw County",4,81,25,15,10
050,26,083,"Michigan","Keweenaw County",4,82,21,13,8
050,26,083,"Michigan","Keweenaw County",4,83,14,8,6
050,26,083,"Michigan","Keweenaw County",4,84,8,5,3
050,26,083,"Michigan","Keweenaw County",4,85,63,22,41
050,26,083,"Michigan","Keweenaw County",5,0,10,3,7
050,26,083,"Michigan","Keweenaw County",5,1,12,3,9
050,26,083,"Michigan","Keweenaw County",5,2,15,7,8
050,26,083,"Michigan","Keweenaw County",5,3,11,8,3
050,26,083,"Michigan","Keweenaw County",5,4,14,8,6
050,26,083,"Michigan","Keweenaw County",5,5,23,10,13
050,26,083,"Michigan","Keweenaw County",5,6,21,8,13
050,26,083,"Michigan","Keweenaw County",5,7,18,8,10
050,26,083,"Michigan","Keweenaw County",5,8,23,12,11
050,26,083,"Michigan","Keweenaw County",5,9,26,17,9
050,26,083,"Michigan","Keweenaw County",5,10,19,10,9
050,26,083,"Michigan","Keweenaw County",5,11,20,8,12
050,26,083,"Michigan","Keweenaw County",5,12,20,11,9
050,26,083,"Michigan","Keweenaw County",5,13,21,9,12
050,26,083,"Michigan","Keweenaw County",5,14,18,5,13
050,26,083,"Michigan","Keweenaw County",5,15,17,9,8
050,26,083,"Michigan","Keweenaw County",5,16,22,9,13
050,26,083,"Michigan","Keweenaw County",5,17,23,9,14
050,26,083,"Michigan","Keweenaw County",5,18,18,9,9
050,26,083,"Michigan","Keweenaw County",5,19,20,9,11
050,26,083,"Michigan","Keweenaw County",5,20,11,5,6
050,26,083,"Michigan","Keweenaw County",5,21,12,3,9
050,26,083,"Michigan","Keweenaw County",5,22,26,11,15
050,26,083,"Michigan","Keweenaw County",5,23,18,10,8
050,26,083,"Michigan","Keweenaw County",5,24,10,4,6
050,26,083,"Michigan","Keweenaw County",5,25,16,7,9
050,26,083,"Michigan","Keweenaw County",5,26,18,9,9
050,26,083,"Michigan","Keweenaw County",5,27,23,14,9
050,26,083,"Michigan","Keweenaw County",5,28,17,9,8
050,26,083,"Michigan","Keweenaw County",5,29,22,12,10
050,26,083,"Michigan","Keweenaw County",5,30,19,13,6
050,26,083,"Michigan","Keweenaw County",5,31,21,9,12
050,26,083,"Michigan","Keweenaw County",5,32,25,14,11
050,26,083,"Michigan","Keweenaw County",5,33,24,10,14
050,26,083,"Michigan","Keweenaw County",5,34,22,12,10
050,26,083,"Michigan","Keweenaw County",5,35,11,6,5
050,26,083,"Michigan","Keweenaw County",5,36,16,9,7
050,26,083,"Michigan","Keweenaw County",5,37,11,5,6
050,26,083,"Michigan","Keweenaw County",5,38,25,15,10
050,26,083,"Michigan","Keweenaw County",5,39,20,10,10
050,26,083,"Michigan","Keweenaw County",5,40,24,13,11
050,26,083,"Michigan","Keweenaw County",5,41,17,6,11
050,26,083,"Michigan","Keweenaw County",5,42,14,8,6
050,26,083,"Michigan","Keweenaw County",5,43,19,11,8
050,26,083,"Michigan","Keweenaw County",5,44,17,9,8
050,26,083,"Michigan","Keweenaw County",5,45,15,9,6
050,26,083,"Michigan","Keweenaw County",5,46,17,11,6
050,26,083,"Michigan","Keweenaw County",5,47,22,10,12
050,26,083,"Michigan","Keweenaw County",5,48,25,13,12
050,26,083,"Michigan","Keweenaw County",5,49,23,12,11
050,26,083,"Michigan","Keweenaw County",5,50,19,8,11
050,26,083,"Michigan","Keweenaw County",5,51,26,10,16
050,26,083,"Michigan","Keweenaw County",5,52,25,15,10
050,26,083,"Michigan","Keweenaw County",5,53,24,11,13
050,26,083,"Michigan","Keweenaw County",5,54,26,12,14
050,26,083,"Michigan","Keweenaw County",5,55,23,13,10
050,26,083,"Michigan","Keweenaw County",5,56,22,9,13
050,26,083,"Michigan","Keweenaw County",5,57,23,12,11
050,26,083,"Michigan","Keweenaw County",5,58,28,16,12
050,26,083,"Michigan","Keweenaw County",5,59,31,15,16
050,26,083,"Michigan","Keweenaw County",5,60,39,16,23
050,26,083,"Michigan","Keweenaw County",5,61,38,18,20
050,26,083,"Michigan","Keweenaw County",5,62,38,17,21
050,26,083,"Michigan","Keweenaw County",5,63,44,20,24
050,26,083,"Michigan","Keweenaw County",5,64,43,21,22
050,26,083,"Michigan","Keweenaw County",5,65,43,24,19
050,26,083,"Michigan","Keweenaw County",5,66,34,13,21
050,26,083,"Michigan","Keweenaw County",5,67,43,23,20
050,26,083,"Michigan","Keweenaw County",5,68,39,18,21
050,26,083,"Michigan","Keweenaw County",5,69,46,26,20
050,26,083,"Michigan","Keweenaw County",5,70,47,20,27
050,26,083,"Michigan","Keweenaw County",5,71,40,17,23
050,26,083,"Michigan","Keweenaw County",5,72,51,23,28
050,26,083,"Michigan","Keweenaw County",5,73,52,25,27
050,26,083,"Michigan","Keweenaw County",5,74,42,22,20
050,26,083,"Michigan","Keweenaw County",5,75,46,27,19
050,26,083,"Michigan","Keweenaw County",5,76,48,30,18
050,26,083,"Michigan","Keweenaw County",5,77,31,22,9
050,26,083,"Michigan","Keweenaw County",5,78,30,17,13
050,26,083,"Michigan","Keweenaw County",5,79,27,14,13
050,26,083,"Michigan","Keweenaw County",5,80,29,18,11
050,26,083,"Michigan","Keweenaw County",5,81,31,18,13
050,26,083,"Michigan","Keweenaw County",5,82,21,12,9
050,26,083,"Michigan","Keweenaw County",5,83,22,13,9
050,26,083,"Michigan","Keweenaw County",5,84,13,8,5
050,26,083,"Michigan","Keweenaw County",5,85,57,21,36
050,26,085,"Michigan","Lake County",1,0,76,39,37
050,26,085,"Michigan","Lake County",1,1,96,50,46
050,26,085,"Michigan","Lake County",1,2,97,49,48
050,26,085,"Michigan","Lake County",1,3,104,58,46
050,26,085,"Michigan","Lake County",1,4,116,62,54
050,26,085,"Michigan","Lake County",1,5,114,51,63
050,26,085,"Michigan","Lake County",1,6,100,45,55
050,26,085,"Michigan","Lake County",1,7,102,56,46
050,26,085,"Michigan","Lake County",1,8,109,59,50
050,26,085,"Michigan","Lake County",1,9,108,53,55
050,26,085,"Michigan","Lake County",1,10,85,46,39
050,26,085,"Michigan","Lake County",1,11,114,59,55
050,26,085,"Michigan","Lake County",1,12,115,62,53
050,26,085,"Michigan","Lake County",1,13,111,53,58
050,26,085,"Michigan","Lake County",1,14,112,58,54
050,26,085,"Michigan","Lake County",1,15,114,59,55
050,26,085,"Michigan","Lake County",1,16,112,58,54
050,26,085,"Michigan","Lake County",1,17,124,68,56
050,26,085,"Michigan","Lake County",1,18,107,64,43
050,26,085,"Michigan","Lake County",1,19,110,67,43
050,26,085,"Michigan","Lake County",1,20,124,71,53
050,26,085,"Michigan","Lake County",1,21,115,71,44
050,26,085,"Michigan","Lake County",1,22,130,85,45
050,26,085,"Michigan","Lake County",1,23,123,78,45
050,26,085,"Michigan","Lake County",1,24,120,72,48
050,26,085,"Michigan","Lake County",1,25,119,74,45
050,26,085,"Michigan","Lake County",1,26,134,81,53
050,26,085,"Michigan","Lake County",1,27,128,90,38
050,26,085,"Michigan","Lake County",1,28,133,84,49
050,26,085,"Michigan","Lake County",1,29,122,84,38
050,26,085,"Michigan","Lake County",1,30,116,70,46
050,26,085,"Michigan","Lake County",1,31,128,82,46
050,26,085,"Michigan","Lake County",1,32,115,76,39
050,26,085,"Michigan","Lake County",1,33,125,81,44
050,26,085,"Michigan","Lake County",1,34,112,66,46
050,26,085,"Michigan","Lake County",1,35,134,79,55
050,26,085,"Michigan","Lake County",1,36,117,69,48
050,26,085,"Michigan","Lake County",1,37,122,72,50
050,26,085,"Michigan","Lake County",1,38,139,67,72
050,26,085,"Michigan","Lake County",1,39,127,74,53
050,26,085,"Michigan","Lake County",1,40,126,77,49
050,26,085,"Michigan","Lake County",1,41,132,81,51
050,26,085,"Michigan","Lake County",1,42,148,96,52
050,26,085,"Michigan","Lake County",1,43,119,70,49
050,26,085,"Michigan","Lake County",1,44,128,73,55
050,26,085,"Michigan","Lake County",1,45,121,70,51
050,26,085,"Michigan","Lake County",1,46,141,84,57
050,26,085,"Michigan","Lake County",1,47,160,95,65
050,26,085,"Michigan","Lake County",1,48,167,100,67
050,26,085,"Michigan","Lake County",1,49,189,104,85
050,26,085,"Michigan","Lake County",1,50,141,85,56
050,26,085,"Michigan","Lake County",1,51,137,86,51
050,26,085,"Michigan","Lake County",1,52,151,86,65
050,26,085,"Michigan","Lake County",1,53,157,80,77
050,26,085,"Michigan","Lake County",1,54,191,102,89
050,26,085,"Michigan","Lake County",1,55,167,92,75
050,26,085,"Michigan","Lake County",1,56,181,102,79
050,26,085,"Michigan","Lake County",1,57,204,97,107
050,26,085,"Michigan","Lake County",1,58,207,101,106
050,26,085,"Michigan","Lake County",1,59,220,109,111
050,26,085,"Michigan","Lake County",1,60,230,120,110
050,26,085,"Michigan","Lake County",1,61,237,114,123
050,26,085,"Michigan","Lake County",1,62,216,108,108
050,26,085,"Michigan","Lake County",1,63,238,122,116
050,26,085,"Michigan","Lake County",1,64,225,120,105
050,26,085,"Michigan","Lake County",1,65,243,124,119
050,26,085,"Michigan","Lake County",1,66,254,132,122
050,26,085,"Michigan","Lake County",1,67,245,134,111
050,26,085,"Michigan","Lake County",1,68,239,132,107
050,26,085,"Michigan","Lake County",1,69,201,100,101
050,26,085,"Michigan","Lake County",1,70,172,89,83
050,26,085,"Michigan","Lake County",1,71,177,95,82
050,26,085,"Michigan","Lake County",1,72,169,95,74
050,26,085,"Michigan","Lake County",1,73,190,103,87
050,26,085,"Michigan","Lake County",1,74,138,69,69
050,26,085,"Michigan","Lake County",1,75,127,69,58
050,26,085,"Michigan","Lake County",1,76,127,70,57
050,26,085,"Michigan","Lake County",1,77,116,58,58
050,26,085,"Michigan","Lake County",1,78,99,48,51
050,26,085,"Michigan","Lake County",1,79,87,48,39
050,26,085,"Michigan","Lake County",1,80,68,33,35
050,26,085,"Michigan","Lake County",1,81,82,48,34
050,26,085,"Michigan","Lake County",1,82,62,34,28
050,26,085,"Michigan","Lake County",1,83,57,29,28
050,26,085,"Michigan","Lake County",1,84,60,30,30
050,26,085,"Michigan","Lake County",1,85,243,112,131
050,26,085,"Michigan","Lake County",2,0,76,40,36
050,26,085,"Michigan","Lake County",2,1,90,46,44
050,26,085,"Michigan","Lake County",2,2,97,48,49
050,26,085,"Michigan","Lake County",2,3,102,56,46
050,26,085,"Michigan","Lake County",2,4,111,60,51
050,26,085,"Michigan","Lake County",2,5,113,52,61
050,26,085,"Michigan","Lake County",2,6,105,48,57
050,26,085,"Michigan","Lake County",2,7,102,53,49
050,26,085,"Michigan","Lake County",2,8,107,57,50
050,26,085,"Michigan","Lake County",2,9,107,55,52
050,26,085,"Michigan","Lake County",2,10,91,48,43
050,26,085,"Michigan","Lake County",2,11,106,56,50
050,26,085,"Michigan","Lake County",2,12,115,61,54
050,26,085,"Michigan","Lake County",2,13,112,56,56
050,26,085,"Michigan","Lake County",2,14,111,57,54
050,26,085,"Michigan","Lake County",2,15,113,58,55
050,26,085,"Michigan","Lake County",2,16,112,57,55
050,26,085,"Michigan","Lake County",2,17,121,66,55
050,26,085,"Michigan","Lake County",2,18,107,65,42
050,26,085,"Michigan","Lake County",2,19,106,65,41
050,26,085,"Michigan","Lake County",2,20,125,72,53
050,26,085,"Michigan","Lake County",2,21,117,73,44
050,26,085,"Michigan","Lake County",2,22,126,82,44
050,26,085,"Michigan","Lake County",2,23,126,80,46
050,26,085,"Michigan","Lake County",2,24,121,73,48
050,26,085,"Michigan","Lake County",2,25,120,73,47
050,26,085,"Michigan","Lake County",2,26,130,79,51
050,26,085,"Michigan","Lake County",2,27,131,89,42
050,26,085,"Michigan","Lake County",2,28,133,87,46
050,26,085,"Michigan","Lake County",2,29,125,84,41
050,26,085,"Michigan","Lake County",2,30,117,74,43
050,26,085,"Michigan","Lake County",2,31,124,79,45
050,26,085,"Michigan","Lake County",2,32,120,79,41
050,26,085,"Michigan","Lake County",2,33,122,79,43
050,26,085,"Michigan","Lake County",2,34,118,70,48
050,26,085,"Michigan","Lake County",2,35,129,77,52
050,26,085,"Michigan","Lake County",2,36,120,71,49
050,26,085,"Michigan","Lake County",2,37,120,71,49
050,26,085,"Michigan","Lake County",2,38,134,68,66
050,26,085,"Michigan","Lake County",2,39,129,72,57
050,26,085,"Michigan","Lake County",2,40,127,77,50
050,26,085,"Michigan","Lake County",2,41,132,81,51
050,26,085,"Michigan","Lake County",2,42,143,92,51
050,26,085,"Michigan","Lake County",2,43,130,78,52
050,26,085,"Michigan","Lake County",2,44,126,73,53
050,26,085,"Michigan","Lake County",2,45,123,71,52
050,26,085,"Michigan","Lake County",2,46,138,82,56
050,26,085,"Michigan","Lake County",2,47,153,92,61
050,26,085,"Michigan","Lake County",2,48,165,98,67
050,26,085,"Michigan","Lake County",2,49,182,102,80
050,26,085,"Michigan","Lake County",2,50,154,89,65
050,26,085,"Michigan","Lake County",2,51,139,88,51
050,26,085,"Michigan","Lake County",2,52,148,88,60
050,26,085,"Michigan","Lake County",2,53,159,83,76
050,26,085,"Michigan","Lake County",2,54,184,97,87
050,26,085,"Michigan","Lake County",2,55,175,97,78
050,26,085,"Michigan","Lake County",2,56,176,98,78
050,26,085,"Michigan","Lake County",2,57,202,99,103
050,26,085,"Michigan","Lake County",2,58,207,100,107
050,26,085,"Michigan","Lake County",2,59,218,107,111
050,26,085,"Michigan","Lake County",2,60,226,113,113
050,26,085,"Michigan","Lake County",2,61,234,113,121
050,26,085,"Michigan","Lake County",2,62,224,112,112
050,26,085,"Michigan","Lake County",2,63,233,119,114
050,26,085,"Michigan","Lake County",2,64,226,117,109
050,26,085,"Michigan","Lake County",2,65,241,125,116
050,26,085,"Michigan","Lake County",2,66,254,133,121
050,26,085,"Michigan","Lake County",2,67,247,134,113
050,26,085,"Michigan","Lake County",2,68,239,131,108
050,26,085,"Michigan","Lake County",2,69,212,109,103
050,26,085,"Michigan","Lake County",2,70,178,91,87
050,26,085,"Michigan","Lake County",2,71,174,91,83
050,26,085,"Michigan","Lake County",2,72,168,94,74
050,26,085,"Michigan","Lake County",2,73,192,104,88
050,26,085,"Michigan","Lake County",2,74,140,72,68
050,26,085,"Michigan","Lake County",2,75,128,69,59
050,26,085,"Michigan","Lake County",2,76,123,67,56
050,26,085,"Michigan","Lake County",2,77,120,62,58
050,26,085,"Michigan","Lake County",2,78,100,49,51
050,26,085,"Michigan","Lake County",2,79,86,45,41
050,26,085,"Michigan","Lake County",2,80,73,36,37
050,26,085,"Michigan","Lake County",2,81,78,45,33
050,26,085,"Michigan","Lake County",2,82,64,37,27
050,26,085,"Michigan","Lake County",2,83,58,30,28
050,26,085,"Michigan","Lake County",2,84,58,29,29
050,26,085,"Michigan","Lake County",2,85,246,113,133
050,26,085,"Michigan","Lake County",3,0,78,44,34
050,26,085,"Michigan","Lake County",3,1,80,39,41
050,26,085,"Michigan","Lake County",3,2,94,45,49
050,26,085,"Michigan","Lake County",3,3,94,45,49
050,26,085,"Michigan","Lake County",3,4,97,53,44
050,26,085,"Michigan","Lake County",3,5,123,70,53
050,26,085,"Michigan","Lake County",3,6,103,49,54
050,26,085,"Michigan","Lake County",3,7,109,52,57
050,26,085,"Michigan","Lake County",3,8,98,54,44
050,26,085,"Michigan","Lake County",3,9,114,56,58
050,26,085,"Michigan","Lake County",3,10,101,49,52
050,26,085,"Michigan","Lake County",3,11,104,54,50
050,26,085,"Michigan","Lake County",3,12,106,52,54
050,26,085,"Michigan","Lake County",3,13,121,66,55
050,26,085,"Michigan","Lake County",3,14,127,70,57
050,26,085,"Michigan","Lake County",3,15,112,56,56
050,26,085,"Michigan","Lake County",3,16,105,49,56
050,26,085,"Michigan","Lake County",3,17,120,59,61
050,26,085,"Michigan","Lake County",3,18,119,73,46
050,26,085,"Michigan","Lake County",3,19,95,63,32
050,26,085,"Michigan","Lake County",3,20,114,70,44
050,26,085,"Michigan","Lake County",3,21,116,71,45
050,26,085,"Michigan","Lake County",3,22,127,84,43
050,26,085,"Michigan","Lake County",3,23,111,68,43
050,26,085,"Michigan","Lake County",3,24,130,75,55
050,26,085,"Michigan","Lake County",3,25,113,72,41
050,26,085,"Michigan","Lake County",3,26,120,69,51
050,26,085,"Michigan","Lake County",3,27,138,85,53
050,26,085,"Michigan","Lake County",3,28,124,87,37
050,26,085,"Michigan","Lake County",3,29,123,86,37
050,26,085,"Michigan","Lake County",3,30,136,91,45
050,26,085,"Michigan","Lake County",3,31,121,77,44
050,26,085,"Michigan","Lake County",3,32,120,73,47
050,26,085,"Michigan","Lake County",3,33,125,81,44
050,26,085,"Michigan","Lake County",3,34,117,76,41
050,26,085,"Michigan","Lake County",3,35,130,78,52
050,26,085,"Michigan","Lake County",3,36,146,84,62
050,26,085,"Michigan","Lake County",3,37,135,79,56
050,26,085,"Michigan","Lake County",3,38,136,79,57
050,26,085,"Michigan","Lake County",3,39,135,70,65
050,26,085,"Michigan","Lake County",3,40,133,79,54
050,26,085,"Michigan","Lake County",3,41,128,78,50
050,26,085,"Michigan","Lake County",3,42,132,78,54
050,26,085,"Michigan","Lake County",3,43,146,86,60
050,26,085,"Michigan","Lake County",3,44,135,85,50
050,26,085,"Michigan","Lake County",3,45,117,66,51
050,26,085,"Michigan","Lake County",3,46,129,78,51
050,26,085,"Michigan","Lake County",3,47,135,82,53
050,26,085,"Michigan","Lake County",3,48,158,96,62
050,26,085,"Michigan","Lake County",3,49,170,100,70
050,26,085,"Michigan","Lake County",3,50,196,106,90
050,26,085,"Michigan","Lake County",3,51,164,97,67
050,26,085,"Michigan","Lake County",3,52,143,88,55
050,26,085,"Michigan","Lake County",3,53,164,94,70
050,26,085,"Michigan","Lake County",3,54,181,98,83
050,26,085,"Michigan","Lake County",3,55,194,101,93
050,26,085,"Michigan","Lake County",3,56,174,95,79
050,26,085,"Michigan","Lake County",3,57,193,107,86
050,26,085,"Michigan","Lake County",3,58,212,108,104
050,26,085,"Michigan","Lake County",3,59,221,108,113
050,26,085,"Michigan","Lake County",3,60,209,105,104
050,26,085,"Michigan","Lake County",3,61,233,120,113
050,26,085,"Michigan","Lake County",3,62,247,120,127
050,26,085,"Michigan","Lake County",3,63,232,112,120
050,26,085,"Michigan","Lake County",3,64,242,123,119
050,26,085,"Michigan","Lake County",3,65,237,124,113
050,26,085,"Michigan","Lake County",3,66,252,130,122
050,26,085,"Michigan","Lake County",3,67,253,133,120
050,26,085,"Michigan","Lake County",3,68,239,133,106
050,26,085,"Michigan","Lake County",3,69,238,131,107
050,26,085,"Michigan","Lake County",3,70,202,103,99
050,26,085,"Michigan","Lake County",3,71,175,87,88
050,26,085,"Michigan","Lake County",3,72,176,89,87
050,26,085,"Michigan","Lake County",3,73,165,93,72
050,26,085,"Michigan","Lake County",3,74,181,100,81
050,26,085,"Michigan","Lake County",3,75,133,66,67
050,26,085,"Michigan","Lake County",3,76,113,63,50
050,26,085,"Michigan","Lake County",3,77,118,63,55
050,26,085,"Michigan","Lake County",3,78,117,60,57
050,26,085,"Michigan","Lake County",3,79,86,44,42
050,26,085,"Michigan","Lake County",3,80,72,41,31
050,26,085,"Michigan","Lake County",3,81,73,34,39
050,26,085,"Michigan","Lake County",3,82,66,41,25
050,26,085,"Michigan","Lake County",3,83,64,36,28
050,26,085,"Michigan","Lake County",3,84,52,29,23
050,26,085,"Michigan","Lake County",3,85,257,120,137
050,26,085,"Michigan","Lake County",4,0,89,45,44
050,26,085,"Michigan","Lake County",4,1,73,40,33
050,26,085,"Michigan","Lake County",4,2,89,49,40
050,26,085,"Michigan","Lake County",4,3,93,47,46
050,26,085,"Michigan","Lake County",4,4,89,46,43
050,26,085,"Michigan","Lake County",4,5,99,55,44
050,26,085,"Michigan","Lake County",4,6,128,74,54
050,26,085,"Michigan","Lake County",4,7,114,58,56
050,26,085,"Michigan","Lake County",4,8,116,61,55
050,26,085,"Michigan","Lake County",4,9,104,61,43
050,26,085,"Michigan","Lake County",4,10,115,54,61
050,26,085,"Michigan","Lake County",4,11,111,59,52
050,26,085,"Michigan","Lake County",4,12,107,55,52
050,26,085,"Michigan","Lake County",4,13,118,57,61
050,26,085,"Michigan","Lake County",4,14,114,62,52
050,26,085,"Michigan","Lake County",4,15,117,64,53
050,26,085,"Michigan","Lake County",4,16,110,55,55
050,26,085,"Michigan","Lake County",4,17,111,56,55
050,26,085,"Michigan","Lake County",4,18,115,64,51
050,26,085,"Michigan","Lake County",4,19,115,73,42
050,26,085,"Michigan","Lake County",4,20,104,69,35
050,26,085,"Michigan","Lake County",4,21,119,75,44
050,26,085,"Michigan","Lake County",4,22,132,79,53
050,26,085,"Michigan","Lake County",4,23,131,91,40
050,26,085,"Michigan","Lake County",4,24,113,70,43
050,26,085,"Michigan","Lake County",4,25,150,86,64
050,26,085,"Michigan","Lake County",4,26,123,74,49
050,26,085,"Michigan","Lake County",4,27,127,78,49
050,26,085,"Michigan","Lake County",4,28,142,92,50
050,26,085,"Michigan","Lake County",4,29,125,86,39
050,26,085,"Michigan","Lake County",4,30,127,81,46
050,26,085,"Michigan","Lake County",4,31,138,90,48
050,26,085,"Michigan","Lake County",4,32,134,79,55
050,26,085,"Michigan","Lake County",4,33,113,70,43
050,26,085,"Michigan","Lake County",4,34,117,78,39
050,26,085,"Michigan","Lake County",4,35,127,79,48
050,26,085,"Michigan","Lake County",4,36,138,81,57
050,26,085,"Michigan","Lake County",4,37,155,91,64
050,26,085,"Michigan","Lake County",4,38,136,80,56
050,26,085,"Michigan","Lake County",4,39,147,86,61
050,26,085,"Michigan","Lake County",4,40,140,68,72
050,26,085,"Michigan","Lake County",4,41,142,78,64
050,26,085,"Michigan","Lake County",4,42,139,86,53
050,26,085,"Michigan","Lake County",4,43,125,73,52
050,26,085,"Michigan","Lake County",4,44,157,91,66
050,26,085,"Michigan","Lake County",4,45,131,77,54
050,26,085,"Michigan","Lake County",4,46,124,66,58
050,26,085,"Michigan","Lake County",4,47,134,72,62
050,26,085,"Michigan","Lake County",4,48,139,88,51
050,26,085,"Michigan","Lake County",4,49,168,102,66
050,26,085,"Michigan","Lake County",4,50,172,98,74
050,26,085,"Michigan","Lake County",4,51,207,109,98
050,26,085,"Michigan","Lake County",4,52,175,104,71
050,26,085,"Michigan","Lake County",4,53,150,92,58
050,26,085,"Michigan","Lake County",4,54,181,101,80
050,26,085,"Michigan","Lake County",4,55,184,97,87
050,26,085,"Michigan","Lake County",4,56,207,108,99
050,26,085,"Michigan","Lake County",4,57,174,93,81
050,26,085,"Michigan","Lake County",4,58,204,112,92
050,26,085,"Michigan","Lake County",4,59,218,111,107
050,26,085,"Michigan","Lake County",4,60,245,120,125
050,26,085,"Michigan","Lake County",4,61,237,117,120
050,26,085,"Michigan","Lake County",4,62,257,138,119
050,26,085,"Michigan","Lake County",4,63,263,125,138
050,26,085,"Michigan","Lake County",4,64,240,111,129
050,26,085,"Michigan","Lake County",4,65,254,132,122
050,26,085,"Michigan","Lake County",4,66,245,129,116
050,26,085,"Michigan","Lake County",4,67,262,132,130
050,26,085,"Michigan","Lake County",4,68,257,135,122
050,26,085,"Michigan","Lake County",4,69,238,133,105
050,26,085,"Michigan","Lake County",4,70,230,126,104
050,26,085,"Michigan","Lake County",4,71,211,107,104
050,26,085,"Michigan","Lake County",4,72,169,84,85
050,26,085,"Michigan","Lake County",4,73,165,83,82
050,26,085,"Michigan","Lake County",4,74,157,89,68
050,26,085,"Michigan","Lake County",4,75,176,95,81
050,26,085,"Michigan","Lake County",4,76,119,56,63
050,26,085,"Michigan","Lake County",4,77,115,61,54
050,26,085,"Michigan","Lake County",4,78,114,60,54
050,26,085,"Michigan","Lake County",4,79,107,55,52
050,26,085,"Michigan","Lake County",4,80,74,42,32
050,26,085,"Michigan","Lake County",4,81,73,41,32
050,26,085,"Michigan","Lake County",4,82,58,27,31
050,26,085,"Michigan","Lake County",4,83,67,43,24
050,26,085,"Michigan","Lake County",4,84,63,36,27
050,26,085,"Michigan","Lake County",4,85,259,119,140
050,26,085,"Michigan","Lake County",5,0,88,44,44
050,26,085,"Michigan","Lake County",5,1,99,54,45
050,26,085,"Michigan","Lake County",5,2,67,42,25
050,26,085,"Michigan","Lake County",5,3,87,41,46
050,26,085,"Michigan","Lake County",5,4,89,48,41
050,26,085,"Michigan","Lake County",5,5,77,40,37
050,26,085,"Michigan","Lake County",5,6,99,55,44
050,26,085,"Michigan","Lake County",5,7,123,71,52
050,26,085,"Michigan","Lake County",5,8,117,60,57
050,26,085,"Michigan","Lake County",5,9,106,53,53
050,26,085,"Michigan","Lake County",5,10,101,53,48
050,26,085,"Michigan","Lake County",5,11,104,53,51
050,26,085,"Michigan","Lake County",5,12,109,62,47
050,26,085,"Michigan","Lake County",5,13,106,58,48
050,26,085,"Michigan","Lake County",5,14,120,55,65
050,26,085,"Michigan","Lake County",5,15,114,58,56
050,26,085,"Michigan","Lake County",5,16,124,68,56
050,26,085,"Michigan","Lake County",5,17,117,59,58
050,26,085,"Michigan","Lake County",5,18,111,64,47
050,26,085,"Michigan","Lake County",5,19,113,71,42
050,26,085,"Michigan","Lake County",5,20,126,78,48
050,26,085,"Michigan","Lake County",5,21,105,71,34
050,26,085,"Michigan","Lake County",5,22,143,87,56
050,26,085,"Michigan","Lake County",5,23,147,84,63
050,26,085,"Michigan","Lake County",5,24,131,89,42
050,26,085,"Michigan","Lake County",5,25,116,73,43
050,26,085,"Michigan","Lake County",5,26,145,82,63
050,26,085,"Michigan","Lake County",5,27,126,81,45
050,26,085,"Michigan","Lake County",5,28,128,79,49
050,26,085,"Michigan","Lake County",5,29,138,93,45
050,26,085,"Michigan","Lake County",5,30,117,76,41
050,26,085,"Michigan","Lake County",5,31,136,89,47
050,26,085,"Michigan","Lake County",5,32,130,85,45
050,26,085,"Michigan","Lake County",5,33,124,70,54
050,26,085,"Michigan","Lake County",5,34,111,67,44
050,26,085,"Michigan","Lake County",5,35,121,79,42
050,26,085,"Michigan","Lake County",5,36,122,70,52
050,26,085,"Michigan","Lake County",5,37,134,80,54
050,26,085,"Michigan","Lake County",5,38,143,81,62
050,26,085,"Michigan","Lake County",5,39,149,90,59
050,26,085,"Michigan","Lake County",5,40,150,87,63
050,26,085,"Michigan","Lake County",5,41,144,72,72
050,26,085,"Michigan","Lake County",5,42,144,80,64
050,26,085,"Michigan","Lake County",5,43,143,86,57
050,26,085,"Michigan","Lake County",5,44,135,78,57
050,26,085,"Michigan","Lake County",5,45,155,90,65
050,26,085,"Michigan","Lake County",5,46,137,78,59
050,26,085,"Michigan","Lake County",5,47,129,71,58
050,26,085,"Michigan","Lake County",5,48,129,76,53
050,26,085,"Michigan","Lake County",5,49,140,89,51
050,26,085,"Michigan","Lake County",5,50,172,96,76
050,26,085,"Michigan","Lake County",5,51,171,97,74
050,26,085,"Michigan","Lake County",5,52,214,113,101
050,26,085,"Michigan","Lake County",5,53,180,103,77
050,26,085,"Michigan","Lake County",5,54,150,88,62
050,26,085,"Michigan","Lake County",5,55,175,95,80
050,26,085,"Michigan","Lake County",5,56,185,100,85
050,26,085,"Michigan","Lake County",5,57,209,107,102
050,26,085,"Michigan","Lake County",5,58,185,98,87
050,26,085,"Michigan","Lake County",5,59,225,122,103
050,26,085,"Michigan","Lake County",5,60,233,113,120
050,26,085,"Michigan","Lake County",5,61,256,128,128
050,26,085,"Michigan","Lake County",5,62,250,128,122
050,26,085,"Michigan","Lake County",5,63,269,146,123
050,26,085,"Michigan","Lake County",5,64,278,138,140
050,26,085,"Michigan","Lake County",5,65,257,123,134
050,26,085,"Michigan","Lake County",5,66,256,130,126
050,26,085,"Michigan","Lake County",5,67,253,133,120
050,26,085,"Michigan","Lake County",5,68,264,132,132
050,26,085,"Michigan","Lake County",5,69,251,129,122
050,26,085,"Michigan","Lake County",5,70,235,128,107
050,26,085,"Michigan","Lake County",5,71,231,124,107
050,26,085,"Michigan","Lake County",5,72,205,101,104
050,26,085,"Michigan","Lake County",5,73,153,77,76
050,26,085,"Michigan","Lake County",5,74,154,79,75
050,26,085,"Michigan","Lake County",5,75,152,84,68
050,26,085,"Michigan","Lake County",5,76,155,83,72
050,26,085,"Michigan","Lake County",5,77,114,53,61
050,26,085,"Michigan","Lake County",5,78,113,57,56
050,26,085,"Michigan","Lake County",5,79,100,54,46
050,26,085,"Michigan","Lake County",5,80,90,44,46
050,26,085,"Michigan","Lake County",5,81,72,37,35
050,26,085,"Michigan","Lake County",5,82,62,35,27
050,26,085,"Michigan","Lake County",5,83,54,26,28
050,26,085,"Michigan","Lake County",5,84,66,42,24
050,26,085,"Michigan","Lake County",5,85,276,133,143
050,26,087,"Michigan","Lapeer County",1,0,809,416,393
050,26,087,"Michigan","Lapeer County",1,1,879,452,427
050,26,087,"Michigan","Lapeer County",1,2,802,427,375
050,26,087,"Michigan","Lapeer County",1,3,831,443,388
050,26,087,"Michigan","Lapeer County",1,4,904,464,440
050,26,087,"Michigan","Lapeer County",1,5,956,474,482
050,26,087,"Michigan","Lapeer County",1,6,943,487,456
050,26,087,"Michigan","Lapeer County",1,7,984,509,475
050,26,087,"Michigan","Lapeer County",1,8,953,506,447
050,26,087,"Michigan","Lapeer County",1,9,961,523,438
050,26,087,"Michigan","Lapeer County",1,10,1025,542,483
050,26,087,"Michigan","Lapeer County",1,11,1050,515,535
050,26,087,"Michigan","Lapeer County",1,12,1115,559,556
050,26,087,"Michigan","Lapeer County",1,13,1112,572,540
050,26,087,"Michigan","Lapeer County",1,14,1106,574,532
050,26,087,"Michigan","Lapeer County",1,15,1176,627,549
050,26,087,"Michigan","Lapeer County",1,16,1258,656,602
050,26,087,"Michigan","Lapeer County",1,17,1265,664,601
050,26,087,"Michigan","Lapeer County",1,18,1143,634,509
050,26,087,"Michigan","Lapeer County",1,19,841,476,365
050,26,087,"Michigan","Lapeer County",1,20,873,477,396
050,26,087,"Michigan","Lapeer County",1,21,965,522,443
050,26,087,"Michigan","Lapeer County",1,22,1020,557,463
050,26,087,"Michigan","Lapeer County",1,23,1008,534,474
050,26,087,"Michigan","Lapeer County",1,24,970,525,445
050,26,087,"Michigan","Lapeer County",1,25,974,512,462
050,26,087,"Michigan","Lapeer County",1,26,1025,528,497
050,26,087,"Michigan","Lapeer County",1,27,1023,545,478
050,26,087,"Michigan","Lapeer County",1,28,982,513,469
050,26,087,"Michigan","Lapeer County",1,29,1047,566,481
050,26,087,"Michigan","Lapeer County",1,30,998,564,434
050,26,087,"Michigan","Lapeer County",1,31,936,508,428
050,26,087,"Michigan","Lapeer County",1,32,919,462,457
050,26,087,"Michigan","Lapeer County",1,33,939,480,459
050,26,087,"Michigan","Lapeer County",1,34,951,511,440
050,26,087,"Michigan","Lapeer County",1,35,936,500,436
050,26,087,"Michigan","Lapeer County",1,36,960,497,463
050,26,087,"Michigan","Lapeer County",1,37,1018,540,478
050,26,087,"Michigan","Lapeer County",1,38,997,505,492
050,26,087,"Michigan","Lapeer County",1,39,1041,537,504
050,26,087,"Michigan","Lapeer County",1,40,1023,522,501
050,26,087,"Michigan","Lapeer County",1,41,1029,537,492
050,26,087,"Michigan","Lapeer County",1,42,1026,537,489
050,26,087,"Michigan","Lapeer County",1,43,1014,524,490
050,26,087,"Michigan","Lapeer County",1,44,957,483,474
050,26,087,"Michigan","Lapeer County",1,45,980,500,480
050,26,087,"Michigan","Lapeer County",1,46,1038,540,498
050,26,087,"Michigan","Lapeer County",1,47,1067,550,517
050,26,087,"Michigan","Lapeer County",1,48,1181,598,583
050,26,087,"Michigan","Lapeer County",1,49,1294,642,652
050,26,087,"Michigan","Lapeer County",1,50,1266,647,619
050,26,087,"Michigan","Lapeer County",1,51,1292,660,632
050,26,087,"Michigan","Lapeer County",1,52,1376,713,663
050,26,087,"Michigan","Lapeer County",1,53,1441,739,702
050,26,087,"Michigan","Lapeer County",1,54,1428,737,691
050,26,087,"Michigan","Lapeer County",1,55,1480,751,729
050,26,087,"Michigan","Lapeer County",1,56,1497,751,746
050,26,087,"Michigan","Lapeer County",1,57,1485,763,722
050,26,087,"Michigan","Lapeer County",1,58,1540,794,746
050,26,087,"Michigan","Lapeer County",1,59,1538,775,763
050,26,087,"Michigan","Lapeer County",1,60,1483,765,718
050,26,087,"Michigan","Lapeer County",1,61,1485,763,722
050,26,087,"Michigan","Lapeer County",1,62,1489,760,729
050,26,087,"Michigan","Lapeer County",1,63,1478,758,720
050,26,087,"Michigan","Lapeer County",1,64,1388,718,670
050,26,087,"Michigan","Lapeer County",1,65,1305,677,628
050,26,087,"Michigan","Lapeer County",1,66,1246,625,621
050,26,087,"Michigan","Lapeer County",1,67,1149,562,587
050,26,087,"Michigan","Lapeer County",1,68,1127,563,564
050,26,087,"Michigan","Lapeer County",1,69,1078,538,540
050,26,087,"Michigan","Lapeer County",1,70,1016,505,511
050,26,087,"Michigan","Lapeer County",1,71,967,491,476
050,26,087,"Michigan","Lapeer County",1,72,940,446,494
050,26,087,"Michigan","Lapeer County",1,73,948,473,475
050,26,087,"Michigan","Lapeer County",1,74,660,318,342
050,26,087,"Michigan","Lapeer County",1,75,675,331,344
050,26,087,"Michigan","Lapeer County",1,76,689,338,351
050,26,087,"Michigan","Lapeer County",1,77,676,338,338
050,26,087,"Michigan","Lapeer County",1,78,560,264,296
050,26,087,"Michigan","Lapeer County",1,79,488,216,272
050,26,087,"Michigan","Lapeer County",1,80,411,196,215
050,26,087,"Michigan","Lapeer County",1,81,387,189,198
050,26,087,"Michigan","Lapeer County",1,82,373,165,208
050,26,087,"Michigan","Lapeer County",1,83,301,121,180
050,26,087,"Michigan","Lapeer County",1,84,275,115,160
050,26,087,"Michigan","Lapeer County",1,85,1379,497,882
050,26,087,"Michigan","Lapeer County",2,0,823,422,401
050,26,087,"Michigan","Lapeer County",2,1,867,446,421
050,26,087,"Michigan","Lapeer County",2,2,825,437,388
050,26,087,"Michigan","Lapeer County",2,3,825,442,383
050,26,087,"Michigan","Lapeer County",2,4,899,465,434
050,26,087,"Michigan","Lapeer County",2,5,950,475,475
050,26,087,"Michigan","Lapeer County",2,6,955,490,465
050,26,087,"Michigan","Lapeer County",2,7,970,505,465
050,26,087,"Michigan","Lapeer County",2,8,961,508,453
050,26,087,"Michigan","Lapeer County",2,9,960,522,438
050,26,087,"Michigan","Lapeer County",2,10,1005,534,471
050,26,087,"Michigan","Lapeer County",2,11,1040,518,522
050,26,087,"Michigan","Lapeer County",2,12,1106,551,555
050,26,087,"Michigan","Lapeer County",2,13,1107,564,543
050,26,087,"Michigan","Lapeer County",2,14,1108,575,533
050,26,087,"Michigan","Lapeer County",2,15,1157,612,545
050,26,087,"Michigan","Lapeer County",2,16,1242,653,589
050,26,087,"Michigan","Lapeer County",2,17,1269,667,602
050,26,087,"Michigan","Lapeer County",2,18,1127,627,500
050,26,087,"Michigan","Lapeer County",2,19,855,480,375
050,26,087,"Michigan","Lapeer County",2,20,881,480,401
050,26,087,"Michigan","Lapeer County",2,21,953,514,439
050,26,087,"Michigan","Lapeer County",2,22,1015,551,464
050,26,087,"Michigan","Lapeer County",2,23,1010,540,470
050,26,087,"Michigan","Lapeer County",2,24,976,526,450
050,26,087,"Michigan","Lapeer County",2,25,974,516,458
050,26,087,"Michigan","Lapeer County",2,26,1012,526,486
050,26,087,"Michigan","Lapeer County",2,27,1023,539,484
050,26,087,"Michigan","Lapeer County",2,28,1002,527,475
050,26,087,"Michigan","Lapeer County",2,29,1039,557,482
050,26,087,"Michigan","Lapeer County",2,30,1019,568,451
050,26,087,"Michigan","Lapeer County",2,31,951,519,432
050,26,087,"Michigan","Lapeer County",2,32,932,478,454
050,26,087,"Michigan","Lapeer County",2,33,936,479,457
050,26,087,"Michigan","Lapeer County",2,34,947,501,446
050,26,087,"Michigan","Lapeer County",2,35,947,505,442
050,26,087,"Michigan","Lapeer County",2,36,946,492,454
050,26,087,"Michigan","Lapeer County",2,37,1010,532,478
050,26,087,"Michigan","Lapeer County",2,38,1006,517,489
050,26,087,"Michigan","Lapeer County",2,39,1028,527,501
050,26,087,"Michigan","Lapeer County",2,40,1034,529,505
050,26,087,"Michigan","Lapeer County",2,41,1024,531,493
050,26,087,"Michigan","Lapeer County",2,42,1027,540,487
050,26,087,"Michigan","Lapeer County",2,43,1023,532,491
050,26,087,"Michigan","Lapeer County",2,44,960,488,472
050,26,087,"Michigan","Lapeer County",2,45,981,499,482
050,26,087,"Michigan","Lapeer County",2,46,1020,531,489
050,26,087,"Michigan","Lapeer County",2,47,1055,543,512
050,26,087,"Michigan","Lapeer County",2,48,1153,588,565
050,26,087,"Michigan","Lapeer County",2,49,1276,637,639
050,26,087,"Michigan","Lapeer County",2,50,1278,647,631
050,26,087,"Michigan","Lapeer County",2,51,1283,657,626
050,26,087,"Michigan","Lapeer County",2,52,1347,697,650
050,26,087,"Michigan","Lapeer County",2,53,1422,733,689
050,26,087,"Michigan","Lapeer County",2,54,1427,733,694
050,26,087,"Michigan","Lapeer County",2,55,1465,746,719
050,26,087,"Michigan","Lapeer County",2,56,1492,750,742
050,26,087,"Michigan","Lapeer County",2,57,1492,764,728
050,26,087,"Michigan","Lapeer County",2,58,1519,783,736
050,26,087,"Michigan","Lapeer County",2,59,1548,785,763
050,26,087,"Michigan","Lapeer County",2,60,1485,764,721
050,26,087,"Michigan","Lapeer County",2,61,1479,758,721
050,26,087,"Michigan","Lapeer County",2,62,1482,759,723
050,26,087,"Michigan","Lapeer County",2,63,1482,761,721
050,26,087,"Michigan","Lapeer County",2,64,1396,720,676
050,26,087,"Michigan","Lapeer County",2,65,1320,682,638
050,26,087,"Michigan","Lapeer County",2,66,1261,637,624
050,26,087,"Michigan","Lapeer County",2,67,1165,569,596
050,26,087,"Michigan","Lapeer County",2,68,1123,559,564
050,26,087,"Michigan","Lapeer County",2,69,1091,543,548
050,26,087,"Michigan","Lapeer County",2,70,1025,511,514
050,26,087,"Michigan","Lapeer County",2,71,970,489,481
050,26,087,"Michigan","Lapeer County",2,72,924,446,478
050,26,087,"Michigan","Lapeer County",2,73,986,482,504
050,26,087,"Michigan","Lapeer County",2,74,681,331,350
050,26,087,"Michigan","Lapeer County",2,75,669,326,343
050,26,087,"Michigan","Lapeer County",2,76,670,329,341
050,26,087,"Michigan","Lapeer County",2,77,684,341,343
050,26,087,"Michigan","Lapeer County",2,78,571,273,298
050,26,087,"Michigan","Lapeer County",2,79,492,223,269
050,26,087,"Michigan","Lapeer County",2,80,423,196,227
050,26,087,"Michigan","Lapeer County",2,81,385,189,196
050,26,087,"Michigan","Lapeer County",2,82,372,169,203
050,26,087,"Michigan","Lapeer County",2,83,309,126,183
050,26,087,"Michigan","Lapeer County",2,84,279,115,164
050,26,087,"Michigan","Lapeer County",2,85,1375,495,880
050,26,087,"Michigan","Lapeer County",3,0,763,404,359
050,26,087,"Michigan","Lapeer County",3,1,839,425,414
050,26,087,"Michigan","Lapeer County",3,2,865,453,412
050,26,087,"Michigan","Lapeer County",3,3,845,438,407
050,26,087,"Michigan","Lapeer County",3,4,848,447,401
050,26,087,"Michigan","Lapeer County",3,5,913,466,447
050,26,087,"Michigan","Lapeer County",3,6,957,474,483
050,26,087,"Michigan","Lapeer County",3,7,960,500,460
050,26,087,"Michigan","Lapeer County",3,8,990,510,480
050,26,087,"Michigan","Lapeer County",3,9,981,523,458
050,26,087,"Michigan","Lapeer County",3,10,968,527,441
050,26,087,"Michigan","Lapeer County",3,11,1026,539,487
050,26,087,"Michigan","Lapeer County",3,12,1058,522,536
050,26,087,"Michigan","Lapeer County",3,13,1120,562,558
050,26,087,"Michigan","Lapeer County",3,14,1094,560,534
050,26,087,"Michigan","Lapeer County",3,15,1152,610,542
050,26,087,"Michigan","Lapeer County",3,16,1162,622,540
050,26,087,"Michigan","Lapeer County",3,17,1250,678,572
050,26,087,"Michigan","Lapeer County",3,18,1131,632,499
050,26,087,"Michigan","Lapeer County",3,19,882,494,388
050,26,087,"Michigan","Lapeer County",3,20,898,483,415
050,26,087,"Michigan","Lapeer County",3,21,938,499,439
050,26,087,"Michigan","Lapeer County",3,22,1010,524,486
050,26,087,"Michigan","Lapeer County",3,23,1054,565,489
050,26,087,"Michigan","Lapeer County",3,24,974,539,435
050,26,087,"Michigan","Lapeer County",3,25,942,498,444
050,26,087,"Michigan","Lapeer County",3,26,987,519,468
050,26,087,"Michigan","Lapeer County",3,27,987,521,466
050,26,087,"Michigan","Lapeer County",3,28,993,522,471
050,26,087,"Michigan","Lapeer County",3,29,1048,551,497
050,26,087,"Michigan","Lapeer County",3,30,1062,587,475
050,26,087,"Michigan","Lapeer County",3,31,1049,579,470
050,26,087,"Michigan","Lapeer County",3,32,973,523,450
050,26,087,"Michigan","Lapeer County",3,33,951,497,454
050,26,087,"Michigan","Lapeer County",3,34,967,489,478
050,26,087,"Michigan","Lapeer County",3,35,972,514,458
050,26,087,"Michigan","Lapeer County",3,36,975,527,448
050,26,087,"Michigan","Lapeer County",3,37,973,518,455
050,26,087,"Michigan","Lapeer County",3,38,1041,558,483
050,26,087,"Michigan","Lapeer County",3,39,1023,524,499
050,26,087,"Michigan","Lapeer County",3,40,1056,561,495
050,26,087,"Michigan","Lapeer County",3,41,1031,524,507
050,26,087,"Michigan","Lapeer County",3,42,1025,534,491
050,26,087,"Michigan","Lapeer County",3,43,1038,543,495
050,26,087,"Michigan","Lapeer County",3,44,1014,526,488
050,26,087,"Michigan","Lapeer County",3,45,961,488,473
050,26,087,"Michigan","Lapeer County",3,46,991,502,489
050,26,087,"Michigan","Lapeer County",3,47,1031,538,493
050,26,087,"Michigan","Lapeer County",3,48,1056,539,517
050,26,087,"Michigan","Lapeer County",3,49,1162,598,564
050,26,087,"Michigan","Lapeer County",3,50,1266,640,626
050,26,087,"Michigan","Lapeer County",3,51,1286,667,619
050,26,087,"Michigan","Lapeer County",3,52,1282,656,626
050,26,087,"Michigan","Lapeer County",3,53,1336,698,638
050,26,087,"Michigan","Lapeer County",3,54,1416,724,692
050,26,087,"Michigan","Lapeer County",3,55,1408,721,687
050,26,087,"Michigan","Lapeer County",3,56,1451,732,719
050,26,087,"Michigan","Lapeer County",3,57,1521,770,751
050,26,087,"Michigan","Lapeer County",3,58,1495,757,738
050,26,087,"Michigan","Lapeer County",3,59,1541,791,750
050,26,087,"Michigan","Lapeer County",3,60,1532,783,749
050,26,087,"Michigan","Lapeer County",3,61,1465,755,710
050,26,087,"Michigan","Lapeer County",3,62,1464,759,705
050,26,087,"Michigan","Lapeer County",3,63,1444,738,706
050,26,087,"Michigan","Lapeer County",3,64,1478,752,726
050,26,087,"Michigan","Lapeer County",3,65,1404,715,689
050,26,087,"Michigan","Lapeer County",3,66,1293,670,623
050,26,087,"Michigan","Lapeer County",3,67,1243,623,620
050,26,087,"Michigan","Lapeer County",3,68,1138,561,577
050,26,087,"Michigan","Lapeer County",3,69,1090,538,552
050,26,087,"Michigan","Lapeer County",3,70,1079,531,548
050,26,087,"Michigan","Lapeer County",3,71,998,502,496
050,26,087,"Michigan","Lapeer County",3,72,928,459,469
050,26,087,"Michigan","Lapeer County",3,73,891,437,454
050,26,087,"Michigan","Lapeer County",3,74,944,457,487
050,26,087,"Michigan","Lapeer County",3,75,649,315,334
050,26,087,"Michigan","Lapeer County",3,76,624,306,318
050,26,087,"Michigan","Lapeer County",3,77,638,310,328
050,26,087,"Michigan","Lapeer County",3,78,645,312,333
050,26,087,"Michigan","Lapeer County",3,79,515,249,266
050,26,087,"Michigan","Lapeer County",3,80,458,202,256
050,26,087,"Michigan","Lapeer County",3,81,401,181,220
050,26,087,"Michigan","Lapeer County",3,82,362,174,188
050,26,087,"Michigan","Lapeer County",3,83,332,147,185
050,26,087,"Michigan","Lapeer County",3,84,283,120,163
050,26,087,"Michigan","Lapeer County",3,85,1376,502,874
050,26,087,"Michigan","Lapeer County",4,0,772,405,367
050,26,087,"Michigan","Lapeer County",4,1,829,455,374
050,26,087,"Michigan","Lapeer County",4,2,876,450,426
050,26,087,"Michigan","Lapeer County",4,3,886,455,431
050,26,087,"Michigan","Lapeer County",4,4,874,462,412
050,26,087,"Michigan","Lapeer County",4,5,882,459,423
050,26,087,"Michigan","Lapeer County",4,6,933,474,459
050,26,087,"Michigan","Lapeer County",4,7,978,494,484
050,26,087,"Michigan","Lapeer County",4,8,970,501,469
050,26,087,"Michigan","Lapeer County",4,9,1014,523,491
050,26,087,"Michigan","Lapeer County",4,10,978,510,468
050,26,087,"Michigan","Lapeer County",4,11,977,529,448
050,26,087,"Michigan","Lapeer County",4,12,1060,566,494
050,26,087,"Michigan","Lapeer County",4,13,1063,534,529
050,26,087,"Michigan","Lapeer County",4,14,1118,557,561
050,26,087,"Michigan","Lapeer County",4,15,1130,574,556
050,26,087,"Michigan","Lapeer County",4,16,1157,626,531
050,26,087,"Michigan","Lapeer County",4,17,1184,640,544
050,26,087,"Michigan","Lapeer County",4,18,1080,607,473
050,26,087,"Michigan","Lapeer County",4,19,842,471,371
050,26,087,"Michigan","Lapeer County",4,20,894,487,407
050,26,087,"Michigan","Lapeer County",4,21,902,495,407
050,26,087,"Michigan","Lapeer County",4,22,962,524,438
050,26,087,"Michigan","Lapeer County",4,23,1009,524,485
050,26,087,"Michigan","Lapeer County",4,24,996,559,437
050,26,087,"Michigan","Lapeer County",4,25,966,531,435
050,26,087,"Michigan","Lapeer County",4,26,927,487,440
050,26,087,"Michigan","Lapeer County",4,27,1000,521,479
050,26,087,"Michigan","Lapeer County",4,28,987,514,473
050,26,087,"Michigan","Lapeer County",4,29,1037,552,485
050,26,087,"Michigan","Lapeer County",4,30,1095,579,516
050,26,087,"Michigan","Lapeer County",4,31,1086,595,491
050,26,087,"Michigan","Lapeer County",4,32,1065,570,495
050,26,087,"Michigan","Lapeer County",4,33,1011,547,464
050,26,087,"Michigan","Lapeer County",4,34,961,496,465
050,26,087,"Michigan","Lapeer County",4,35,1040,537,503
050,26,087,"Michigan","Lapeer County",4,36,1000,536,464
050,26,087,"Michigan","Lapeer County",4,37,982,532,450
050,26,087,"Michigan","Lapeer County",4,38,1001,545,456
050,26,087,"Michigan","Lapeer County",4,39,1041,560,481
050,26,087,"Michigan","Lapeer County",4,40,1051,542,509
050,26,087,"Michigan","Lapeer County",4,41,1075,553,522
050,26,087,"Michigan","Lapeer County",4,42,1049,532,517
050,26,087,"Michigan","Lapeer County",4,43,1002,521,481
050,26,087,"Michigan","Lapeer County",4,44,1020,525,495
050,26,087,"Michigan","Lapeer County",4,45,1015,528,487
050,26,087,"Michigan","Lapeer County",4,46,983,506,477
050,26,087,"Michigan","Lapeer County",4,47,1001,515,486
050,26,087,"Michigan","Lapeer County",4,48,1033,535,498
050,26,087,"Michigan","Lapeer County",4,49,1066,542,524
050,26,087,"Michigan","Lapeer County",4,50,1160,599,561
050,26,087,"Michigan","Lapeer County",4,51,1268,645,623
050,26,087,"Michigan","Lapeer County",4,52,1287,667,620
050,26,087,"Michigan","Lapeer County",4,53,1270,649,621
050,26,087,"Michigan","Lapeer County",4,54,1328,697,631
050,26,087,"Michigan","Lapeer County",4,55,1406,710,696
050,26,087,"Michigan","Lapeer County",4,56,1380,706,674
050,26,087,"Michigan","Lapeer County",4,57,1462,740,722
050,26,087,"Michigan","Lapeer County",4,58,1495,748,747
050,26,087,"Michigan","Lapeer County",4,59,1489,747,742
050,26,087,"Michigan","Lapeer County",4,60,1549,788,761
050,26,087,"Michigan","Lapeer County",4,61,1519,770,749
050,26,087,"Michigan","Lapeer County",4,62,1435,736,699
050,26,087,"Michigan","Lapeer County",4,63,1439,747,692
050,26,087,"Michigan","Lapeer County",4,64,1418,722,696
050,26,087,"Michigan","Lapeer County",4,65,1453,746,707
050,26,087,"Michigan","Lapeer County",4,66,1359,681,678
050,26,087,"Michigan","Lapeer County",4,67,1263,656,607
050,26,087,"Michigan","Lapeer County",4,68,1228,607,621
050,26,087,"Michigan","Lapeer County",4,69,1114,549,565
050,26,087,"Michigan","Lapeer County",4,70,1072,522,550
050,26,087,"Michigan","Lapeer County",4,71,1043,512,531
050,26,087,"Michigan","Lapeer County",4,72,980,489,491
050,26,087,"Michigan","Lapeer County",4,73,911,451,460
050,26,087,"Michigan","Lapeer County",4,74,861,421,440
050,26,087,"Michigan","Lapeer County",4,75,898,434,464
050,26,087,"Michigan","Lapeer County",4,76,617,297,320
050,26,087,"Michigan","Lapeer County",4,77,601,289,312
050,26,087,"Michigan","Lapeer County",4,78,607,285,322
050,26,087,"Michigan","Lapeer County",4,79,579,294,285
050,26,087,"Michigan","Lapeer County",4,80,479,231,248
050,26,087,"Michigan","Lapeer County",4,81,441,189,252
050,26,087,"Michigan","Lapeer County",4,82,374,161,213
050,26,087,"Michigan","Lapeer County",4,83,311,151,160
050,26,087,"Michigan","Lapeer County",4,84,301,127,174
050,26,087,"Michigan","Lapeer County",4,85,1375,497,878
050,26,087,"Michigan","Lapeer County",5,0,752,395,357
050,26,087,"Michigan","Lapeer County",5,1,807,416,391
050,26,087,"Michigan","Lapeer County",5,2,870,473,397
050,26,087,"Michigan","Lapeer County",5,3,893,461,432
050,26,087,"Michigan","Lapeer County",5,4,891,471,420
050,26,087,"Michigan","Lapeer County",5,5,880,461,419
050,26,087,"Michigan","Lapeer County",5,6,892,475,417
050,26,087,"Michigan","Lapeer County",5,7,941,477,464
050,26,087,"Michigan","Lapeer County",5,8,983,496,487
050,26,087,"Michigan","Lapeer County",5,9,991,510,481
050,26,087,"Michigan","Lapeer County",5,10,1038,532,506
050,26,087,"Michigan","Lapeer County",5,11,984,510,474
050,26,087,"Michigan","Lapeer County",5,12,986,530,456
050,26,087,"Michigan","Lapeer County",5,13,1048,558,490
050,26,087,"Michigan","Lapeer County",5,14,1077,542,535
050,26,087,"Michigan","Lapeer County",5,15,1127,574,553
050,26,087,"Michigan","Lapeer County",5,16,1141,594,547
050,26,087,"Michigan","Lapeer County",5,17,1179,638,541
050,26,087,"Michigan","Lapeer County",5,18,1044,597,447
050,26,087,"Michigan","Lapeer County",5,19,834,469,365
050,26,087,"Michigan","Lapeer County",5,20,895,492,403
050,26,087,"Michigan","Lapeer County",5,21,952,518,434
050,26,087,"Michigan","Lapeer County",5,22,954,504,450
050,26,087,"Michigan","Lapeer County",5,23,980,535,445
050,26,087,"Michigan","Lapeer County",5,24,1007,530,477
050,26,087,"Michigan","Lapeer County",5,25,989,564,425
050,26,087,"Michigan","Lapeer County",5,26,971,543,428
050,26,087,"Michigan","Lapeer County",5,27,936,491,445
050,26,087,"Michigan","Lapeer County",5,28,989,521,468
050,26,087,"Michigan","Lapeer County",5,29,1028,534,494
050,26,087,"Michigan","Lapeer County",5,30,1099,573,526
050,26,087,"Michigan","Lapeer County",5,31,1107,582,525
050,26,087,"Michigan","Lapeer County",5,32,1104,597,507
050,26,087,"Michigan","Lapeer County",5,33,1086,581,505
050,26,087,"Michigan","Lapeer County",5,34,1049,576,473
050,26,087,"Michigan","Lapeer County",5,35,982,517,465
050,26,087,"Michigan","Lapeer County",5,36,1029,524,505
050,26,087,"Michigan","Lapeer County",5,37,1019,540,479
050,26,087,"Michigan","Lapeer County",5,38,1001,544,457
050,26,087,"Michigan","Lapeer County",5,39,1022,553,469
050,26,087,"Michigan","Lapeer County",5,40,1051,578,473
050,26,087,"Michigan","Lapeer County",5,41,1075,545,530
050,26,087,"Michigan","Lapeer County",5,42,1095,572,523
050,26,087,"Michigan","Lapeer County",5,43,1068,543,525
050,26,087,"Michigan","Lapeer County",5,44,998,508,490
050,26,087,"Michigan","Lapeer County",5,45,1016,520,496
050,26,087,"Michigan","Lapeer County",5,46,1044,549,495
050,26,087,"Michigan","Lapeer County",5,47,996,506,490
050,26,087,"Michigan","Lapeer County",5,48,1014,527,487
050,26,087,"Michigan","Lapeer County",5,49,1044,543,501
050,26,087,"Michigan","Lapeer County",5,50,1090,561,529
050,26,087,"Michigan","Lapeer County",5,51,1146,589,557
050,26,087,"Michigan","Lapeer County",5,52,1273,646,627
050,26,087,"Michigan","Lapeer County",5,53,1262,650,612
050,26,087,"Michigan","Lapeer County",5,54,1281,647,634
050,26,087,"Michigan","Lapeer County",5,55,1316,695,621
050,26,087,"Michigan","Lapeer County",5,56,1410,705,705
050,26,087,"Michigan","Lapeer County",5,57,1372,702,670
050,26,087,"Michigan","Lapeer County",5,58,1448,733,715
050,26,087,"Michigan","Lapeer County",5,59,1497,744,753
050,26,087,"Michigan","Lapeer County",5,60,1486,743,743
050,26,087,"Michigan","Lapeer County",5,61,1561,792,769
050,26,087,"Michigan","Lapeer County",5,62,1522,774,748
050,26,087,"Michigan","Lapeer County",5,63,1440,740,700
050,26,087,"Michigan","Lapeer County",5,64,1434,735,699
050,26,087,"Michigan","Lapeer County",5,65,1424,721,703
050,26,087,"Michigan","Lapeer County",5,66,1434,732,702
050,26,087,"Michigan","Lapeer County",5,67,1341,676,665
050,26,087,"Michigan","Lapeer County",5,68,1252,644,608
050,26,087,"Michigan","Lapeer County",5,69,1205,597,608
050,26,087,"Michigan","Lapeer County",5,70,1075,524,551
050,26,087,"Michigan","Lapeer County",5,71,1041,510,531
050,26,087,"Michigan","Lapeer County",5,72,1004,488,516
050,26,087,"Michigan","Lapeer County",5,73,949,481,468
050,26,087,"Michigan","Lapeer County",5,74,891,439,452
050,26,087,"Michigan","Lapeer County",5,75,831,404,427
050,26,087,"Michigan","Lapeer County",5,76,846,403,443
050,26,087,"Michigan","Lapeer County",5,77,604,284,320
050,26,087,"Michigan","Lapeer County",5,78,585,272,313
050,26,087,"Michigan","Lapeer County",5,79,565,276,289
050,26,087,"Michigan","Lapeer County",5,80,540,271,269
050,26,087,"Michigan","Lapeer County",5,81,463,224,239
050,26,087,"Michigan","Lapeer County",5,82,413,176,237
050,26,087,"Michigan","Lapeer County",5,83,324,137,187
050,26,087,"Michigan","Lapeer County",5,84,283,135,148
050,26,087,"Michigan","Lapeer County",5,85,1411,516,895
050,26,089,"Michigan","Leelanau County",1,0,151,76,75
050,26,089,"Michigan","Leelanau County",1,1,165,74,91
050,26,089,"Michigan","Leelanau County",1,2,166,82,84
050,26,089,"Michigan","Leelanau County",1,3,188,95,93
050,26,089,"Michigan","Leelanau County",1,4,189,92,97
050,26,089,"Michigan","Leelanau County",1,5,192,102,90
050,26,089,"Michigan","Leelanau County",1,6,181,87,94
050,26,089,"Michigan","Leelanau County",1,7,201,103,98
050,26,089,"Michigan","Leelanau County",1,8,197,106,91
050,26,089,"Michigan","Leelanau County",1,9,194,103,91
050,26,089,"Michigan","Leelanau County",1,10,209,107,102
050,26,089,"Michigan","Leelanau County",1,11,210,107,103
050,26,089,"Michigan","Leelanau County",1,12,200,104,96
050,26,089,"Michigan","Leelanau County",1,13,205,110,95
050,26,089,"Michigan","Leelanau County",1,14,219,104,115
050,26,089,"Michigan","Leelanau County",1,15,225,113,112
050,26,089,"Michigan","Leelanau County",1,16,215,115,100
050,26,089,"Michigan","Leelanau County",1,17,240,124,116
050,26,089,"Michigan","Leelanau County",1,18,192,107,85
050,26,089,"Michigan","Leelanau County",1,19,159,88,71
050,26,089,"Michigan","Leelanau County",1,20,178,93,85
050,26,089,"Michigan","Leelanau County",1,21,192,99,93
050,26,089,"Michigan","Leelanau County",1,22,192,102,90
050,26,089,"Michigan","Leelanau County",1,23,193,98,95
050,26,089,"Michigan","Leelanau County",1,24,162,73,89
050,26,089,"Michigan","Leelanau County",1,25,168,85,83
050,26,089,"Michigan","Leelanau County",1,26,176,86,90
050,26,089,"Michigan","Leelanau County",1,27,186,103,83
050,26,089,"Michigan","Leelanau County",1,28,182,94,88
050,26,089,"Michigan","Leelanau County",1,29,178,89,89
050,26,089,"Michigan","Leelanau County",1,30,183,87,96
050,26,089,"Michigan","Leelanau County",1,31,193,93,100
050,26,089,"Michigan","Leelanau County",1,32,182,94,88
050,26,089,"Michigan","Leelanau County",1,33,214,96,118
050,26,089,"Michigan","Leelanau County",1,34,221,108,113
050,26,089,"Michigan","Leelanau County",1,35,199,85,114
050,26,089,"Michigan","Leelanau County",1,36,212,108,104
050,26,089,"Michigan","Leelanau County",1,37,209,96,113
050,26,089,"Michigan","Leelanau County",1,38,231,108,123
050,26,089,"Michigan","Leelanau County",1,39,231,129,102
050,26,089,"Michigan","Leelanau County",1,40,227,127,100
050,26,089,"Michigan","Leelanau County",1,41,215,105,110
050,26,089,"Michigan","Leelanau County",1,42,204,105,99
050,26,089,"Michigan","Leelanau County",1,43,215,116,99
050,26,089,"Michigan","Leelanau County",1,44,189,98,91
050,26,089,"Michigan","Leelanau County",1,45,198,97,101
050,26,089,"Michigan","Leelanau County",1,46,194,97,97
050,26,089,"Michigan","Leelanau County",1,47,180,98,82
050,26,089,"Michigan","Leelanau County",1,48,224,121,103
050,26,089,"Michigan","Leelanau County",1,49,244,124,120
050,26,089,"Michigan","Leelanau County",1,50,256,132,124
050,26,089,"Michigan","Leelanau County",1,51,232,121,111
050,26,089,"Michigan","Leelanau County",1,52,231,115,116
050,26,089,"Michigan","Leelanau County",1,53,247,113,134
050,26,089,"Michigan","Leelanau County",1,54,263,117,146
050,26,089,"Michigan","Leelanau County",1,55,307,145,162
050,26,089,"Michigan","Leelanau County",1,56,328,159,169
050,26,089,"Michigan","Leelanau County",1,57,367,174,193
050,26,089,"Michigan","Leelanau County",1,58,417,187,230
050,26,089,"Michigan","Leelanau County",1,59,409,187,222
050,26,089,"Michigan","Leelanau County",1,60,403,189,214
050,26,089,"Michigan","Leelanau County",1,61,408,205,203
050,26,089,"Michigan","Leelanau County",1,62,438,227,211
050,26,089,"Michigan","Leelanau County",1,63,461,221,240
050,26,089,"Michigan","Leelanau County",1,64,471,211,260
050,26,089,"Michigan","Leelanau County",1,65,524,255,269
050,26,089,"Michigan","Leelanau County",1,66,512,232,280
050,26,089,"Michigan","Leelanau County",1,67,493,241,252
050,26,089,"Michigan","Leelanau County",1,68,501,254,247
050,26,089,"Michigan","Leelanau County",1,69,462,228,234
050,26,089,"Michigan","Leelanau County",1,70,416,203,213
050,26,089,"Michigan","Leelanau County",1,71,388,194,194
050,26,089,"Michigan","Leelanau County",1,72,404,201,203
050,26,089,"Michigan","Leelanau County",1,73,416,209,207
050,26,089,"Michigan","Leelanau County",1,74,275,142,133
050,26,089,"Michigan","Leelanau County",1,75,264,143,121
050,26,089,"Michigan","Leelanau County",1,76,281,149,132
050,26,089,"Michigan","Leelanau County",1,77,267,131,136
050,26,089,"Michigan","Leelanau County",1,78,232,115,117
050,26,089,"Michigan","Leelanau County",1,79,213,107,106
050,26,089,"Michigan","Leelanau County",1,80,180,90,90
050,26,089,"Michigan","Leelanau County",1,81,174,86,88
050,26,089,"Michigan","Leelanau County",1,82,155,73,82
050,26,089,"Michigan","Leelanau County",1,83,138,73,65
050,26,089,"Michigan","Leelanau County",1,84,129,68,61
050,26,089,"Michigan","Leelanau County",1,85,768,323,445
050,26,089,"Michigan","Leelanau County",2,0,151,80,71
050,26,089,"Michigan","Leelanau County",2,1,158,72,86
050,26,089,"Michigan","Leelanau County",2,2,168,81,87
050,26,089,"Michigan","Leelanau County",2,3,183,93,90
050,26,089,"Michigan","Leelanau County",2,4,190,93,97
050,26,089,"Michigan","Leelanau County",2,5,192,99,93
050,26,089,"Michigan","Leelanau County",2,6,186,92,94
050,26,089,"Michigan","Leelanau County",2,7,198,101,97
050,26,089,"Michigan","Leelanau County",2,8,196,104,92
050,26,089,"Michigan","Leelanau County",2,9,198,106,92
050,26,089,"Michigan","Leelanau County",2,10,205,104,101
050,26,089,"Michigan","Leelanau County",2,11,210,106,104
050,26,089,"Michigan","Leelanau County",2,12,205,106,99
050,26,089,"Michigan","Leelanau County",2,13,202,107,95
050,26,089,"Michigan","Leelanau County",2,14,215,105,110
050,26,089,"Michigan","Leelanau County",2,15,224,111,113
050,26,089,"Michigan","Leelanau County",2,16,218,114,104
050,26,089,"Michigan","Leelanau County",2,17,234,123,111
050,26,089,"Michigan","Leelanau County",2,18,196,108,88
050,26,089,"Michigan","Leelanau County",2,19,157,86,71
050,26,089,"Michigan","Leelanau County",2,20,176,94,82
050,26,089,"Michigan","Leelanau County",2,21,190,99,91
050,26,089,"Michigan","Leelanau County",2,22,193,103,90
050,26,089,"Michigan","Leelanau County",2,23,191,97,94
050,26,089,"Michigan","Leelanau County",2,24,166,77,89
050,26,089,"Michigan","Leelanau County",2,25,164,82,82
050,26,089,"Michigan","Leelanau County",2,26,172,86,86
050,26,089,"Michigan","Leelanau County",2,27,184,98,86
050,26,089,"Michigan","Leelanau County",2,28,184,96,88
050,26,089,"Michigan","Leelanau County",2,29,178,89,89
050,26,089,"Michigan","Leelanau County",2,30,186,90,96
050,26,089,"Michigan","Leelanau County",2,31,188,89,99
050,26,089,"Michigan","Leelanau County",2,32,185,94,91
050,26,089,"Michigan","Leelanau County",2,33,207,96,111
050,26,089,"Michigan","Leelanau County",2,34,218,104,114
050,26,089,"Michigan","Leelanau County",2,35,206,91,115
050,26,089,"Michigan","Leelanau County",2,36,206,101,105
050,26,089,"Michigan","Leelanau County",2,37,213,100,113
050,26,089,"Michigan","Leelanau County",2,38,227,106,121
050,26,089,"Michigan","Leelanau County",2,39,234,124,110
050,26,089,"Michigan","Leelanau County",2,40,230,128,102
050,26,089,"Michigan","Leelanau County",2,41,218,111,107
050,26,089,"Michigan","Leelanau County",2,42,207,105,102
050,26,089,"Michigan","Leelanau County",2,43,213,114,99
050,26,089,"Michigan","Leelanau County",2,44,193,102,91
050,26,089,"Michigan","Leelanau County",2,45,198,99,99
050,26,089,"Michigan","Leelanau County",2,46,194,96,98
050,26,089,"Michigan","Leelanau County",2,47,184,98,86
050,26,089,"Michigan","Leelanau County",2,48,212,115,97
050,26,089,"Michigan","Leelanau County",2,49,240,123,117
050,26,089,"Michigan","Leelanau County",2,50,253,129,124
050,26,089,"Michigan","Leelanau County",2,51,237,123,114
050,26,089,"Michigan","Leelanau County",2,52,233,117,116
050,26,089,"Michigan","Leelanau County",2,53,247,114,133
050,26,089,"Michigan","Leelanau County",2,54,262,118,144
050,26,089,"Michigan","Leelanau County",2,55,302,141,161
050,26,089,"Michigan","Leelanau County",2,56,328,158,170
050,26,089,"Michigan","Leelanau County",2,57,361,172,189
050,26,089,"Michigan","Leelanau County",2,58,403,182,221
050,26,089,"Michigan","Leelanau County",2,59,415,189,226
050,26,089,"Michigan","Leelanau County",2,60,404,189,215
050,26,089,"Michigan","Leelanau County",2,61,408,202,206
050,26,089,"Michigan","Leelanau County",2,62,430,220,210
050,26,089,"Michigan","Leelanau County",2,63,462,225,237
050,26,089,"Michigan","Leelanau County",2,64,470,214,256
050,26,089,"Michigan","Leelanau County",2,65,517,246,271
050,26,089,"Michigan","Leelanau County",2,66,518,238,280
050,26,089,"Michigan","Leelanau County",2,67,499,239,260
050,26,089,"Michigan","Leelanau County",2,68,496,252,244
050,26,089,"Michigan","Leelanau County",2,69,474,236,238
050,26,089,"Michigan","Leelanau County",2,70,425,208,217
050,26,089,"Michigan","Leelanau County",2,71,396,197,199
050,26,089,"Michigan","Leelanau County",2,72,390,194,196
050,26,089,"Michigan","Leelanau County",2,73,433,219,214
050,26,089,"Michigan","Leelanau County",2,74,287,147,140
050,26,089,"Michigan","Leelanau County",2,75,265,142,123
050,26,089,"Michigan","Leelanau County",2,76,272,145,127
050,26,089,"Michigan","Leelanau County",2,77,276,138,138
050,26,089,"Michigan","Leelanau County",2,78,233,115,118
050,26,089,"Michigan","Leelanau County",2,79,216,109,107
050,26,089,"Michigan","Leelanau County",2,80,186,94,92
050,26,089,"Michigan","Leelanau County",2,81,170,82,88
050,26,089,"Michigan","Leelanau County",2,82,154,75,79
050,26,089,"Michigan","Leelanau County",2,83,140,72,68
050,26,089,"Michigan","Leelanau County",2,84,129,67,62
050,26,089,"Michigan","Leelanau County",2,85,774,327,447
050,26,089,"Michigan","Leelanau County",3,0,153,83,70
050,26,089,"Michigan","Leelanau County",3,1,166,86,80
050,26,089,"Michigan","Leelanau County",3,2,170,77,93
050,26,089,"Michigan","Leelanau County",3,3,179,89,90
050,26,089,"Michigan","Leelanau County",3,4,198,97,101
050,26,089,"Michigan","Leelanau County",3,5,198,93,105
050,26,089,"Michigan","Leelanau County",3,6,205,114,91
050,26,089,"Michigan","Leelanau County",3,7,179,86,93
050,26,089,"Michigan","Leelanau County",3,8,199,101,98
050,26,089,"Michigan","Leelanau County",3,9,199,105,94
050,26,089,"Michigan","Leelanau County",3,10,199,106,93
050,26,089,"Michigan","Leelanau County",3,11,202,106,96
050,26,089,"Michigan","Leelanau County",3,12,215,104,111
050,26,089,"Michigan","Leelanau County",3,13,206,109,97
050,26,089,"Michigan","Leelanau County",3,14,204,104,100
050,26,089,"Michigan","Leelanau County",3,15,213,106,107
050,26,089,"Michigan","Leelanau County",3,16,226,117,109
050,26,089,"Michigan","Leelanau County",3,17,224,122,102
050,26,089,"Michigan","Leelanau County",3,18,190,99,91
050,26,089,"Michigan","Leelanau County",3,19,160,87,73
050,26,089,"Michigan","Leelanau County",3,20,166,86,80
050,26,089,"Michigan","Leelanau County",3,21,182,99,83
050,26,089,"Michigan","Leelanau County",3,22,206,108,98
050,26,089,"Michigan","Leelanau County",3,23,194,106,88
050,26,089,"Michigan","Leelanau County",3,24,203,101,102
050,26,089,"Michigan","Leelanau County",3,25,154,65,89
050,26,089,"Michigan","Leelanau County",3,26,162,79,83
050,26,089,"Michigan","Leelanau County",3,27,197,95,102
050,26,089,"Michigan","Leelanau County",3,28,183,91,92
050,26,089,"Michigan","Leelanau County",3,29,188,97,91
050,26,089,"Michigan","Leelanau County",3,30,193,101,92
050,26,089,"Michigan","Leelanau County",3,31,192,92,100
050,26,089,"Michigan","Leelanau County",3,32,204,96,108
050,26,089,"Michigan","Leelanau County",3,33,186,100,86
050,26,089,"Michigan","Leelanau County",3,34,211,99,112
050,26,089,"Michigan","Leelanau County",3,35,227,107,120
050,26,089,"Michigan","Leelanau County",3,36,219,101,118
050,26,089,"Michigan","Leelanau County",3,37,214,112,102
050,26,089,"Michigan","Leelanau County",3,38,226,104,122
050,26,089,"Michigan","Leelanau County",3,39,242,114,128
050,26,089,"Michigan","Leelanau County",3,40,227,120,107
050,26,089,"Michigan","Leelanau County",3,41,236,130,106
050,26,089,"Michigan","Leelanau County",3,42,233,116,117
050,26,089,"Michigan","Leelanau County",3,43,226,123,103
050,26,089,"Michigan","Leelanau County",3,44,220,117,103
050,26,089,"Michigan","Leelanau County",3,45,193,104,89
050,26,089,"Michigan","Leelanau County",3,46,196,98,98
050,26,089,"Michigan","Leelanau County",3,47,192,95,97
050,26,089,"Michigan","Leelanau County",3,48,181,94,87
050,26,089,"Michigan","Leelanau County",3,49,226,128,98
050,26,089,"Michigan","Leelanau County",3,50,246,129,117
050,26,089,"Michigan","Leelanau County",3,51,255,133,122
050,26,089,"Michigan","Leelanau County",3,52,242,125,117
050,26,089,"Michigan","Leelanau County",3,53,252,121,131
050,26,089,"Michigan","Leelanau County",3,54,259,117,142
050,26,089,"Michigan","Leelanau County",3,55,273,119,154
050,26,089,"Michigan","Leelanau County",3,56,320,147,173
050,26,089,"Michigan","Leelanau County",3,57,346,171,175
050,26,089,"Michigan","Leelanau County",3,58,356,170,186
050,26,089,"Michigan","Leelanau County",3,59,433,200,233
050,26,089,"Michigan","Leelanau County",3,60,431,194,237
050,26,089,"Michigan","Leelanau County",3,61,429,206,223
050,26,089,"Michigan","Leelanau County",3,62,418,209,209
050,26,089,"Michigan","Leelanau County",3,63,461,241,220
050,26,089,"Michigan","Leelanau County",3,64,472,221,251
050,26,089,"Michigan","Leelanau County",3,65,490,227,263
050,26,089,"Michigan","Leelanau County",3,66,528,251,277
050,26,089,"Michigan","Leelanau County",3,67,521,238,283
050,26,089,"Michigan","Leelanau County",3,68,503,238,265
050,26,089,"Michigan","Leelanau County",3,69,495,255,240
050,26,089,"Michigan","Leelanau County",3,70,477,238,239
050,26,089,"Michigan","Leelanau County",3,71,420,209,211
050,26,089,"Michigan","Leelanau County",3,72,386,194,192
050,26,089,"Michigan","Leelanau County",3,73,371,182,189
050,26,089,"Michigan","Leelanau County",3,74,423,212,211
050,26,089,"Michigan","Leelanau County",3,75,277,142,135
050,26,089,"Michigan","Leelanau County",3,76,263,141,122
050,26,089,"Michigan","Leelanau County",3,77,261,138,123
050,26,089,"Michigan","Leelanau County",3,78,268,132,136
050,26,089,"Michigan","Leelanau County",3,79,222,110,112
050,26,089,"Michigan","Leelanau County",3,80,202,107,95
050,26,089,"Michigan","Leelanau County",3,81,188,90,98
050,26,089,"Michigan","Leelanau County",3,82,148,72,76
050,26,089,"Michigan","Leelanau County",3,83,139,66,73
050,26,089,"Michigan","Leelanau County",3,84,124,61,63
050,26,089,"Michigan","Leelanau County",3,85,764,327,437
050,26,089,"Michigan","Leelanau County",4,0,183,104,79
050,26,089,"Michigan","Leelanau County",4,1,165,89,76
050,26,089,"Michigan","Leelanau County",4,2,165,79,86
050,26,089,"Michigan","Leelanau County",4,3,178,79,99
050,26,089,"Michigan","Leelanau County",4,4,183,87,96
050,26,089,"Michigan","Leelanau County",4,5,197,95,102
050,26,089,"Michigan","Leelanau County",4,6,211,99,112
050,26,089,"Michigan","Leelanau County",4,7,201,111,90
050,26,089,"Michigan","Leelanau County",4,8,180,86,94
050,26,089,"Michigan","Leelanau County",4,9,200,100,100
050,26,089,"Michigan","Leelanau County",4,10,199,106,93
050,26,089,"Michigan","Leelanau County",4,11,202,106,96
050,26,089,"Michigan","Leelanau County",4,12,207,108,99
050,26,089,"Michigan","Leelanau County",4,13,228,117,111
050,26,089,"Michigan","Leelanau County",4,14,202,110,92
050,26,089,"Michigan","Leelanau County",4,15,221,109,112
050,26,089,"Michigan","Leelanau County",4,16,212,103,109
050,26,089,"Michigan","Leelanau County",4,17,231,123,108
050,26,089,"Michigan","Leelanau County",4,18,192,112,80
050,26,089,"Michigan","Leelanau County",4,19,155,78,77
050,26,089,"Michigan","Leelanau County",4,20,163,89,74
050,26,089,"Michigan","Leelanau County",4,21,173,84,89
050,26,089,"Michigan","Leelanau County",4,22,194,112,82
050,26,089,"Michigan","Leelanau County",4,23,187,97,90
050,26,089,"Michigan","Leelanau County",4,24,187,103,84
050,26,089,"Michigan","Leelanau County",4,25,186,88,98
050,26,089,"Michigan","Leelanau County",4,26,140,58,82
050,26,089,"Michigan","Leelanau County",4,27,160,75,85
050,26,089,"Michigan","Leelanau County",4,28,199,106,93
050,26,089,"Michigan","Leelanau County",4,29,173,94,79
050,26,089,"Michigan","Leelanau County",4,30,195,103,92
050,26,089,"Michigan","Leelanau County",4,31,188,94,94
050,26,089,"Michigan","Leelanau County",4,32,205,106,99
050,26,089,"Michigan","Leelanau County",4,33,209,96,113
050,26,089,"Michigan","Leelanau County",4,34,188,100,88
050,26,089,"Michigan","Leelanau County",4,35,229,115,114
050,26,089,"Michigan","Leelanau County",4,36,235,115,120
050,26,089,"Michigan","Leelanau County",4,37,230,106,124
050,26,089,"Michigan","Leelanau County",4,38,233,125,108
050,26,089,"Michigan","Leelanau County",4,39,237,114,123
050,26,089,"Michigan","Leelanau County",4,40,238,108,130
050,26,089,"Michigan","Leelanau County",4,41,240,127,113
050,26,089,"Michigan","Leelanau County",4,42,247,135,112
050,26,089,"Michigan","Leelanau County",4,43,239,116,123
050,26,089,"Michigan","Leelanau County",4,44,231,128,103
050,26,089,"Michigan","Leelanau County",4,45,225,118,107
050,26,089,"Michigan","Leelanau County",4,46,199,105,94
050,26,089,"Michigan","Leelanau County",4,47,202,103,99
050,26,089,"Michigan","Leelanau County",4,48,200,103,97
050,26,089,"Michigan","Leelanau County",4,49,185,97,88
050,26,089,"Michigan","Leelanau County",4,50,229,130,99
050,26,089,"Michigan","Leelanau County",4,51,252,133,119
050,26,089,"Michigan","Leelanau County",4,52,270,145,125
050,26,089,"Michigan","Leelanau County",4,53,258,133,125
050,26,089,"Michigan","Leelanau County",4,54,257,125,132
050,26,089,"Michigan","Leelanau County",4,55,262,118,144
050,26,089,"Michigan","Leelanau County",4,56,287,132,155
050,26,089,"Michigan","Leelanau County",4,57,323,143,180
050,26,089,"Michigan","Leelanau County",4,58,359,180,179
050,26,089,"Michigan","Leelanau County",4,59,365,176,189
050,26,089,"Michigan","Leelanau County",4,60,448,204,244
050,26,089,"Michigan","Leelanau County",4,61,439,197,242
050,26,089,"Michigan","Leelanau County",4,62,448,220,228
050,26,089,"Michigan","Leelanau County",4,63,434,218,216
050,26,089,"Michigan","Leelanau County",4,64,488,257,231
050,26,089,"Michigan","Leelanau County",4,65,488,231,257
050,26,089,"Michigan","Leelanau County",4,66,511,240,271
050,26,089,"Michigan","Leelanau County",4,67,535,253,282
050,26,089,"Michigan","Leelanau County",4,68,524,239,285
050,26,089,"Michigan","Leelanau County",4,69,508,241,267
050,26,089,"Michigan","Leelanau County",4,70,508,262,246
050,26,089,"Michigan","Leelanau County",4,71,478,244,234
050,26,089,"Michigan","Leelanau County",4,72,418,209,209
050,26,089,"Michigan","Leelanau County",4,73,383,192,191
050,26,089,"Michigan","Leelanau County",4,74,364,182,182
050,26,089,"Michigan","Leelanau County",4,75,413,206,207
050,26,089,"Michigan","Leelanau County",4,76,269,142,127
050,26,089,"Michigan","Leelanau County",4,77,253,134,119
050,26,089,"Michigan","Leelanau County",4,78,251,131,120
050,26,089,"Michigan","Leelanau County",4,79,255,131,124
050,26,089,"Michigan","Leelanau County",4,80,207,107,100
050,26,089,"Michigan","Leelanau County",4,81,198,102,96
050,26,089,"Michigan","Leelanau County",4,82,164,81,83
050,26,089,"Michigan","Leelanau County",4,83,137,65,72
050,26,089,"Michigan","Leelanau County",4,84,136,64,72
050,26,089,"Michigan","Leelanau County",4,85,735,317,418
050,26,089,"Michigan","Leelanau County",5,0,187,106,81
050,26,089,"Michigan","Leelanau County",5,1,196,109,87
050,26,089,"Michigan","Leelanau County",5,2,159,84,75
050,26,089,"Michigan","Leelanau County",5,3,163,84,79
050,26,089,"Michigan","Leelanau County",5,4,185,80,105
050,26,089,"Michigan","Leelanau County",5,5,173,85,88
050,26,089,"Michigan","Leelanau County",5,6,196,95,101
050,26,089,"Michigan","Leelanau County",5,7,210,100,110
050,26,089,"Michigan","Leelanau County",5,8,199,106,93
050,26,089,"Michigan","Leelanau County",5,9,184,90,94
050,26,089,"Michigan","Leelanau County",5,10,209,106,103
050,26,089,"Michigan","Leelanau County",5,11,202,109,93
050,26,089,"Michigan","Leelanau County",5,12,207,114,93
050,26,089,"Michigan","Leelanau County",5,13,212,109,103
050,26,089,"Michigan","Leelanau County",5,14,232,123,109
050,26,089,"Michigan","Leelanau County",5,15,203,111,92
050,26,089,"Michigan","Leelanau County",5,16,235,119,116
050,26,089,"Michigan","Leelanau County",5,17,214,104,110
050,26,089,"Michigan","Leelanau County",5,18,199,112,87
050,26,089,"Michigan","Leelanau County",5,19,145,77,68
050,26,089,"Michigan","Leelanau County",5,20,168,85,83
050,26,089,"Michigan","Leelanau County",5,21,177,95,82
050,26,089,"Michigan","Leelanau County",5,22,177,89,88
050,26,089,"Michigan","Leelanau County",5,23,183,107,76
050,26,089,"Michigan","Leelanau County",5,24,179,97,82
050,26,089,"Michigan","Leelanau County",5,25,168,93,75
050,26,089,"Michigan","Leelanau County",5,26,179,83,96
050,26,089,"Michigan","Leelanau County",5,27,150,65,85
050,26,089,"Michigan","Leelanau County",5,28,171,81,90
050,26,089,"Michigan","Leelanau County",5,29,201,109,92
050,26,089,"Michigan","Leelanau County",5,30,187,96,91
050,26,089,"Michigan","Leelanau County",5,31,202,104,98
050,26,089,"Michigan","Leelanau County",5,32,197,99,98
050,26,089,"Michigan","Leelanau County",5,33,212,102,110
050,26,089,"Michigan","Leelanau County",5,34,220,100,120
050,26,089,"Michigan","Leelanau County",5,35,191,101,90
050,26,089,"Michigan","Leelanau County",5,36,239,118,121
050,26,089,"Michigan","Leelanau County",5,37,236,120,116
050,26,089,"Michigan","Leelanau County",5,38,236,106,130
050,26,089,"Michigan","Leelanau County",5,39,229,127,102
050,26,089,"Michigan","Leelanau County",5,40,248,120,128
050,26,089,"Michigan","Leelanau County",5,41,246,111,135
050,26,089,"Michigan","Leelanau County",5,42,246,127,119
050,26,089,"Michigan","Leelanau County",5,43,260,148,112
050,26,089,"Michigan","Leelanau County",5,44,239,119,120
050,26,089,"Michigan","Leelanau County",5,45,225,127,98
050,26,089,"Michigan","Leelanau County",5,46,231,116,115
050,26,089,"Michigan","Leelanau County",5,47,209,110,99
050,26,089,"Michigan","Leelanau County",5,48,202,103,99
050,26,089,"Michigan","Leelanau County",5,49,198,102,96
050,26,089,"Michigan","Leelanau County",5,50,191,102,89
050,26,089,"Michigan","Leelanau County",5,51,239,132,107
050,26,089,"Michigan","Leelanau County",5,52,256,140,116
050,26,089,"Michigan","Leelanau County",5,53,279,148,131
050,26,089,"Michigan","Leelanau County",5,54,266,138,128
050,26,089,"Michigan","Leelanau County",5,55,260,126,134
050,26,089,"Michigan","Leelanau County",5,56,262,120,142
050,26,089,"Michigan","Leelanau County",5,57,286,137,149
050,26,089,"Michigan","Leelanau County",5,58,331,144,187
050,26,089,"Michigan","Leelanau County",5,59,369,181,188
050,26,089,"Michigan","Leelanau County",5,60,374,176,198
050,26,089,"Michigan","Leelanau County",5,61,464,214,250
050,26,089,"Michigan","Leelanau County",5,62,453,207,246
050,26,089,"Michigan","Leelanau County",5,63,470,235,235
050,26,089,"Michigan","Leelanau County",5,64,441,218,223
050,26,089,"Michigan","Leelanau County",5,65,494,262,232
050,26,089,"Michigan","Leelanau County",5,66,483,231,252
050,26,089,"Michigan","Leelanau County",5,67,505,244,261
050,26,089,"Michigan","Leelanau County",5,68,545,262,283
050,26,089,"Michigan","Leelanau County",5,69,521,234,287
050,26,089,"Michigan","Leelanau County",5,70,509,238,271
050,26,089,"Michigan","Leelanau County",5,71,507,263,244
050,26,089,"Michigan","Leelanau County",5,72,474,236,238
050,26,089,"Michigan","Leelanau County",5,73,415,207,208
050,26,089,"Michigan","Leelanau County",5,74,375,190,185
050,26,089,"Michigan","Leelanau County",5,75,356,173,183
050,26,089,"Michigan","Leelanau County",5,76,404,203,201
050,26,089,"Michigan","Leelanau County",5,77,256,133,123
050,26,089,"Michigan","Leelanau County",5,78,243,132,111
050,26,089,"Michigan","Leelanau County",5,79,239,127,112
050,26,089,"Michigan","Leelanau County",5,80,234,123,111
050,26,089,"Michigan","Leelanau County",5,81,197,97,100
050,26,089,"Michigan","Leelanau County",5,82,177,94,83
050,26,089,"Michigan","Leelanau County",5,83,150,73,77
050,26,089,"Michigan","Leelanau County",5,84,134,62,72
050,26,089,"Michigan","Leelanau County",5,85,744,321,423
050,26,091,"Michigan","Lenawee County",1,0,1006,514,492
050,26,091,"Michigan","Lenawee County",1,1,996,521,475
050,26,091,"Michigan","Lenawee County",1,2,1055,549,506
050,26,091,"Michigan","Lenawee County",1,3,1095,565,530
050,26,091,"Michigan","Lenawee County",1,4,1134,570,564
050,26,091,"Michigan","Lenawee County",1,5,1133,553,580
050,26,091,"Michigan","Lenawee County",1,6,1137,581,556
050,26,091,"Michigan","Lenawee County",1,7,1121,582,539
050,26,091,"Michigan","Lenawee County",1,8,1118,581,537
050,26,091,"Michigan","Lenawee County",1,9,1095,572,523
050,26,091,"Michigan","Lenawee County",1,10,1155,604,551
050,26,091,"Michigan","Lenawee County",1,11,1217,649,568
050,26,091,"Michigan","Lenawee County",1,12,1252,664,588
050,26,091,"Michigan","Lenawee County",1,13,1310,689,621
050,26,091,"Michigan","Lenawee County",1,14,1257,655,602
050,26,091,"Michigan","Lenawee County",1,15,1261,641,620
050,26,091,"Michigan","Lenawee County",1,16,1278,663,615
050,26,091,"Michigan","Lenawee County",1,17,1287,675,612
050,26,091,"Michigan","Lenawee County",1,18,1362,716,646
050,26,091,"Michigan","Lenawee County",1,19,1383,729,654
050,26,091,"Michigan","Lenawee County",1,20,1360,733,627
050,26,091,"Michigan","Lenawee County",1,21,1324,713,611
050,26,091,"Michigan","Lenawee County",1,22,1221,652,569
050,26,091,"Michigan","Lenawee County",1,23,1085,581,504
050,26,091,"Michigan","Lenawee County",1,24,1111,592,519
050,26,091,"Michigan","Lenawee County",1,25,1156,634,522
050,26,091,"Michigan","Lenawee County",1,26,1161,637,524
050,26,091,"Michigan","Lenawee County",1,27,1146,616,530
050,26,091,"Michigan","Lenawee County",1,28,1238,659,579
050,26,091,"Michigan","Lenawee County",1,29,1236,645,591
050,26,091,"Michigan","Lenawee County",1,30,1181,629,552
050,26,091,"Michigan","Lenawee County",1,31,1133,595,538
050,26,091,"Michigan","Lenawee County",1,32,1136,601,535
050,26,091,"Michigan","Lenawee County",1,33,1090,580,510
050,26,091,"Michigan","Lenawee County",1,34,1146,599,547
050,26,091,"Michigan","Lenawee County",1,35,1178,638,540
050,26,091,"Michigan","Lenawee County",1,36,1184,640,544
050,26,091,"Michigan","Lenawee County",1,37,1230,641,589
050,26,091,"Michigan","Lenawee County",1,38,1190,638,552
050,26,091,"Michigan","Lenawee County",1,39,1223,659,564
050,26,091,"Michigan","Lenawee County",1,40,1170,635,535
050,26,091,"Michigan","Lenawee County",1,41,1220,659,561
050,26,091,"Michigan","Lenawee County",1,42,1196,606,590
050,26,091,"Michigan","Lenawee County",1,43,1139,588,551
050,26,091,"Michigan","Lenawee County",1,44,1099,594,505
050,26,091,"Michigan","Lenawee County",1,45,1172,636,536
050,26,091,"Michigan","Lenawee County",1,46,1136,598,538
050,26,091,"Michigan","Lenawee County",1,47,1216,632,584
050,26,091,"Michigan","Lenawee County",1,48,1327,690,637
050,26,091,"Michigan","Lenawee County",1,49,1421,733,688
050,26,091,"Michigan","Lenawee County",1,50,1333,700,633
050,26,091,"Michigan","Lenawee County",1,51,1312,700,612
050,26,091,"Michigan","Lenawee County",1,52,1282,657,625
050,26,091,"Michigan","Lenawee County",1,53,1285,652,633
050,26,091,"Michigan","Lenawee County",1,54,1293,645,648
050,26,091,"Michigan","Lenawee County",1,55,1389,704,685
050,26,091,"Michigan","Lenawee County",1,56,1428,717,711
050,26,091,"Michigan","Lenawee County",1,57,1417,711,706
050,26,091,"Michigan","Lenawee County",1,58,1441,702,739
050,26,091,"Michigan","Lenawee County",1,59,1405,700,705
050,26,091,"Michigan","Lenawee County",1,60,1413,707,706
050,26,091,"Michigan","Lenawee County",1,61,1464,733,731
050,26,091,"Michigan","Lenawee County",1,62,1526,742,784
050,26,091,"Michigan","Lenawee County",1,63,1435,732,703
050,26,091,"Michigan","Lenawee County",1,64,1382,716,666
050,26,091,"Michigan","Lenawee County",1,65,1364,677,687
050,26,091,"Michigan","Lenawee County",1,66,1273,612,661
050,26,091,"Michigan","Lenawee County",1,67,1286,628,658
050,26,091,"Michigan","Lenawee County",1,68,1320,635,685
050,26,091,"Michigan","Lenawee County",1,69,1165,565,600
050,26,091,"Michigan","Lenawee County",1,70,1136,547,589
050,26,091,"Michigan","Lenawee County",1,71,1134,535,599
050,26,091,"Michigan","Lenawee County",1,72,1107,523,584
050,26,091,"Michigan","Lenawee County",1,73,1139,536,603
050,26,091,"Michigan","Lenawee County",1,74,767,368,399
050,26,091,"Michigan","Lenawee County",1,75,741,350,391
050,26,091,"Michigan","Lenawee County",1,76,740,332,408
050,26,091,"Michigan","Lenawee County",1,77,771,340,431
050,26,091,"Michigan","Lenawee County",1,78,642,297,345
050,26,091,"Michigan","Lenawee County",1,79,539,241,298
050,26,091,"Michigan","Lenawee County",1,80,497,208,289
050,26,091,"Michigan","Lenawee County",1,81,444,200,244
050,26,091,"Michigan","Lenawee County",1,82,429,178,251
050,26,091,"Michigan","Lenawee County",1,83,392,160,232
050,26,091,"Michigan","Lenawee County",1,84,364,142,222
050,26,091,"Michigan","Lenawee County",1,85,1890,660,1230
050,26,091,"Michigan","Lenawee County",2,0,1002,516,486
050,26,091,"Michigan","Lenawee County",2,1,1000,519,481
050,26,091,"Michigan","Lenawee County",2,2,1050,545,505
050,26,091,"Michigan","Lenawee County",2,3,1082,557,525
050,26,091,"Michigan","Lenawee County",2,4,1129,567,562
050,26,091,"Michigan","Lenawee County",2,5,1137,556,581
050,26,091,"Michigan","Lenawee County",2,6,1134,573,561
050,26,091,"Michigan","Lenawee County",2,7,1123,580,543
050,26,091,"Michigan","Lenawee County",2,8,1115,578,537
050,26,091,"Michigan","Lenawee County",2,9,1097,574,523
050,26,091,"Michigan","Lenawee County",2,10,1143,601,542
050,26,091,"Michigan","Lenawee County",2,11,1199,639,560
050,26,091,"Michigan","Lenawee County",2,12,1249,662,587
050,26,091,"Michigan","Lenawee County",2,13,1291,680,611
050,26,091,"Michigan","Lenawee County",2,14,1267,662,605
050,26,091,"Michigan","Lenawee County",2,15,1263,647,616
050,26,091,"Michigan","Lenawee County",2,16,1274,659,615
050,26,091,"Michigan","Lenawee County",2,17,1287,674,613
050,26,091,"Michigan","Lenawee County",2,18,1360,716,644
050,26,091,"Michigan","Lenawee County",2,19,1383,730,653
050,26,091,"Michigan","Lenawee County",2,20,1367,731,636
050,26,091,"Michigan","Lenawee County",2,21,1318,713,605
050,26,091,"Michigan","Lenawee County",2,22,1211,650,561
050,26,091,"Michigan","Lenawee County",2,23,1099,587,512
050,26,091,"Michigan","Lenawee County",2,24,1103,592,511
050,26,091,"Michigan","Lenawee County",2,25,1148,627,521
050,26,091,"Michigan","Lenawee County",2,26,1163,641,522
050,26,091,"Michigan","Lenawee County",2,27,1142,618,524
050,26,091,"Michigan","Lenawee County",2,28,1221,653,568
050,26,091,"Michigan","Lenawee County",2,29,1240,650,590
050,26,091,"Michigan","Lenawee County",2,30,1199,636,563
050,26,091,"Michigan","Lenawee County",2,31,1139,600,539
050,26,091,"Michigan","Lenawee County",2,32,1136,598,538
050,26,091,"Michigan","Lenawee County",2,33,1101,585,516
050,26,091,"Michigan","Lenawee County",2,34,1137,595,542
050,26,091,"Michigan","Lenawee County",2,35,1175,631,544
050,26,091,"Michigan","Lenawee County",2,36,1177,636,541
050,26,091,"Michigan","Lenawee County",2,37,1219,640,579
050,26,091,"Michigan","Lenawee County",2,38,1202,639,563
050,26,091,"Michigan","Lenawee County",2,39,1207,651,556
050,26,091,"Michigan","Lenawee County",2,40,1186,642,544
050,26,091,"Michigan","Lenawee County",2,41,1212,659,553
050,26,091,"Michigan","Lenawee County",2,42,1193,612,581
050,26,091,"Michigan","Lenawee County",2,43,1159,596,563
050,26,091,"Michigan","Lenawee County",2,44,1096,583,513
050,26,091,"Michigan","Lenawee County",2,45,1159,629,530
050,26,091,"Michigan","Lenawee County",2,46,1140,604,536
050,26,091,"Michigan","Lenawee County",2,47,1189,619,570
050,26,091,"Michigan","Lenawee County",2,48,1299,676,623
050,26,091,"Michigan","Lenawee County",2,49,1402,726,676
050,26,091,"Michigan","Lenawee County",2,50,1359,710,649
050,26,091,"Michigan","Lenawee County",2,51,1311,693,618
050,26,091,"Michigan","Lenawee County",2,52,1279,661,618
050,26,091,"Michigan","Lenawee County",2,53,1285,654,631
050,26,091,"Michigan","Lenawee County",2,54,1283,645,638
050,26,091,"Michigan","Lenawee County",2,55,1366,689,677
050,26,091,"Michigan","Lenawee County",2,56,1419,715,704
050,26,091,"Michigan","Lenawee County",2,57,1416,707,709
050,26,091,"Michigan","Lenawee County",2,58,1434,704,730
050,26,091,"Michigan","Lenawee County",2,59,1417,700,717
050,26,091,"Michigan","Lenawee County",2,60,1401,701,700
050,26,091,"Michigan","Lenawee County",2,61,1441,724,717
050,26,091,"Michigan","Lenawee County",2,62,1505,736,769
050,26,091,"Michigan","Lenawee County",2,63,1466,740,726
050,26,091,"Michigan","Lenawee County",2,64,1381,708,673
050,26,091,"Michigan","Lenawee County",2,65,1363,684,679
050,26,091,"Michigan","Lenawee County",2,66,1292,628,664
050,26,091,"Michigan","Lenawee County",2,67,1280,623,657
050,26,091,"Michigan","Lenawee County",2,68,1298,625,673
050,26,091,"Michigan","Lenawee County",2,69,1205,584,621
050,26,091,"Michigan","Lenawee County",2,70,1127,540,587
050,26,091,"Michigan","Lenawee County",2,71,1131,536,595
050,26,091,"Michigan","Lenawee County",2,72,1082,506,576
050,26,091,"Michigan","Lenawee County",2,73,1177,552,625
050,26,091,"Michigan","Lenawee County",2,74,800,386,414
050,26,091,"Michigan","Lenawee County",2,75,742,350,392
050,26,091,"Michigan","Lenawee County",2,76,725,330,395
050,26,091,"Michigan","Lenawee County",2,77,780,343,437
050,26,091,"Michigan","Lenawee County",2,78,652,298,354
050,26,091,"Michigan","Lenawee County",2,79,550,245,305
050,26,091,"Michigan","Lenawee County",2,80,504,211,293
050,26,091,"Michigan","Lenawee County",2,81,446,196,250
050,26,091,"Michigan","Lenawee County",2,82,438,184,254
050,26,091,"Michigan","Lenawee County",2,83,394,160,234
050,26,091,"Michigan","Lenawee County",2,84,361,142,219
050,26,091,"Michigan","Lenawee County",2,85,1891,660,1231
050,26,091,"Michigan","Lenawee County",3,0,888,461,427
050,26,091,"Michigan","Lenawee County",3,1,1029,522,507
050,26,091,"Michigan","Lenawee County",3,2,1001,515,486
050,26,091,"Michigan","Lenawee County",3,3,1061,550,511
050,26,091,"Michigan","Lenawee County",3,4,1051,541,510
050,26,091,"Michigan","Lenawee County",3,5,1126,576,550
050,26,091,"Michigan","Lenawee County",3,6,1128,556,572
050,26,091,"Michigan","Lenawee County",3,7,1136,572,564
050,26,091,"Michigan","Lenawee County",3,8,1133,585,548
050,26,091,"Michigan","Lenawee County",3,9,1107,573,534
050,26,091,"Michigan","Lenawee County",3,10,1109,583,526
050,26,091,"Michigan","Lenawee County",3,11,1151,598,553
050,26,091,"Michigan","Lenawee County",3,12,1196,626,570
050,26,091,"Michigan","Lenawee County",3,13,1264,658,606
050,26,091,"Michigan","Lenawee County",3,14,1288,677,611
050,26,091,"Michigan","Lenawee County",3,15,1262,662,600
050,26,091,"Michigan","Lenawee County",3,16,1292,670,622
050,26,091,"Michigan","Lenawee County",3,17,1263,647,616
050,26,091,"Michigan","Lenawee County",3,18,1386,726,660
050,26,091,"Michigan","Lenawee County",3,19,1388,730,658
050,26,091,"Michigan","Lenawee County",3,20,1354,720,634
050,26,091,"Michigan","Lenawee County",3,21,1314,726,588
050,26,091,"Michigan","Lenawee County",3,22,1209,659,550
050,26,091,"Michigan","Lenawee County",3,23,1154,620,534
050,26,091,"Michigan","Lenawee County",3,24,1104,604,500
050,26,091,"Michigan","Lenawee County",3,25,1085,594,491
050,26,091,"Michigan","Lenawee County",3,26,1139,626,513
050,26,091,"Michigan","Lenawee County",3,27,1155,622,533
050,26,091,"Michigan","Lenawee County",3,28,1163,628,535
050,26,091,"Michigan","Lenawee County",3,29,1211,630,581
050,26,091,"Michigan","Lenawee County",3,30,1252,667,585
050,26,091,"Michigan","Lenawee County",3,31,1229,657,572
050,26,091,"Michigan","Lenawee County",3,32,1128,592,536
050,26,091,"Michigan","Lenawee County",3,33,1160,591,569
050,26,091,"Michigan","Lenawee County",3,34,1093,586,507
050,26,091,"Michigan","Lenawee County",3,35,1141,606,535
050,26,091,"Michigan","Lenawee County",3,36,1177,614,563
050,26,091,"Michigan","Lenawee County",3,37,1186,636,550
050,26,091,"Michigan","Lenawee County",3,38,1214,646,568
050,26,091,"Michigan","Lenawee County",3,39,1216,653,563
050,26,091,"Michigan","Lenawee County",3,40,1203,637,566
050,26,091,"Michigan","Lenawee County",3,41,1221,669,552
050,26,091,"Michigan","Lenawee County",3,42,1224,673,551
050,26,091,"Michigan","Lenawee County",3,43,1206,637,569
050,26,091,"Michigan","Lenawee County",3,44,1134,575,559
050,26,091,"Michigan","Lenawee County",3,45,1095,588,507
050,26,091,"Michigan","Lenawee County",3,46,1170,634,536
050,26,091,"Michigan","Lenawee County",3,47,1155,603,552
050,26,091,"Michigan","Lenawee County",3,48,1193,617,576
050,26,091,"Michigan","Lenawee County",3,49,1301,694,607
050,26,091,"Michigan","Lenawee County",3,50,1413,735,678
050,26,091,"Michigan","Lenawee County",3,51,1347,702,645
050,26,091,"Michigan","Lenawee County",3,52,1312,683,629
050,26,091,"Michigan","Lenawee County",3,53,1292,671,621
050,26,091,"Michigan","Lenawee County",3,54,1287,652,635
050,26,091,"Michigan","Lenawee County",3,55,1280,639,641
050,26,091,"Michigan","Lenawee County",3,56,1338,677,661
050,26,091,"Michigan","Lenawee County",3,57,1398,704,694
050,26,091,"Michigan","Lenawee County",3,58,1426,716,710
050,26,091,"Michigan","Lenawee County",3,59,1434,695,739
050,26,091,"Michigan","Lenawee County",3,60,1414,693,721
050,26,091,"Michigan","Lenawee County",3,61,1384,697,687
050,26,091,"Michigan","Lenawee County",3,62,1425,703,722
050,26,091,"Michigan","Lenawee County",3,63,1492,738,754
050,26,091,"Michigan","Lenawee County",3,64,1444,720,724
050,26,091,"Michigan","Lenawee County",3,65,1379,713,666
050,26,091,"Michigan","Lenawee County",3,66,1332,665,667
050,26,091,"Michigan","Lenawee County",3,67,1278,620,658
050,26,091,"Michigan","Lenawee County",3,68,1241,592,649
050,26,091,"Michigan","Lenawee County",3,69,1274,615,659
050,26,091,"Michigan","Lenawee County",3,70,1151,554,597
050,26,091,"Michigan","Lenawee County",3,71,1101,520,581
050,26,091,"Michigan","Lenawee County",3,72,1094,521,573
050,26,091,"Michigan","Lenawee County",3,73,1042,475,567
050,26,091,"Michigan","Lenawee County",3,74,1125,532,593
050,26,091,"Michigan","Lenawee County",3,75,757,358,399
050,26,091,"Michigan","Lenawee County",3,76,707,332,375
050,26,091,"Michigan","Lenawee County",3,77,705,319,386
050,26,091,"Michigan","Lenawee County",3,78,735,323,412
050,26,091,"Michigan","Lenawee County",3,79,636,287,349
050,26,091,"Michigan","Lenawee County",3,80,517,216,301
050,26,091,"Michigan","Lenawee County",3,81,473,203,270
050,26,091,"Michigan","Lenawee County",3,82,421,170,251
050,26,091,"Michigan","Lenawee County",3,83,406,161,245
050,26,091,"Michigan","Lenawee County",3,84,353,149,204
050,26,091,"Michigan","Lenawee County",3,85,1842,646,1196
050,26,091,"Michigan","Lenawee County",4,0,821,409,412
050,26,091,"Michigan","Lenawee County",4,1,896,475,421
050,26,091,"Michigan","Lenawee County",4,2,1045,530,515
050,26,091,"Michigan","Lenawee County",4,3,1004,512,492
050,26,091,"Michigan","Lenawee County",4,4,1069,554,515
050,26,091,"Michigan","Lenawee County",4,5,1043,538,505
050,26,091,"Michigan","Lenawee County",4,6,1131,582,549
050,26,091,"Michigan","Lenawee County",4,7,1129,562,567
050,26,091,"Michigan","Lenawee County",4,8,1130,558,572
050,26,091,"Michigan","Lenawee County",4,9,1120,574,546
050,26,091,"Michigan","Lenawee County",4,10,1112,575,537
050,26,091,"Michigan","Lenawee County",4,11,1107,587,520
050,26,091,"Michigan","Lenawee County",4,12,1157,599,558
050,26,091,"Michigan","Lenawee County",4,13,1211,642,569
050,26,091,"Michigan","Lenawee County",4,14,1280,663,617
050,26,091,"Michigan","Lenawee County",4,15,1294,676,618
050,26,091,"Michigan","Lenawee County",4,16,1264,678,586
050,26,091,"Michigan","Lenawee County",4,17,1281,668,613
050,26,091,"Michigan","Lenawee County",4,18,1356,707,649
050,26,091,"Michigan","Lenawee County",4,19,1419,767,652
050,26,091,"Michigan","Lenawee County",4,20,1335,701,634
050,26,091,"Michigan","Lenawee County",4,21,1315,733,582
050,26,091,"Michigan","Lenawee County",4,22,1202,662,540
050,26,091,"Michigan","Lenawee County",4,23,1154,620,534
050,26,091,"Michigan","Lenawee County",4,24,1133,621,512
050,26,091,"Michigan","Lenawee County",4,25,1034,557,477
050,26,091,"Michigan","Lenawee County",4,26,1077,587,490
050,26,091,"Michigan","Lenawee County",4,27,1116,592,524
050,26,091,"Michigan","Lenawee County",4,28,1129,608,521
050,26,091,"Michigan","Lenawee County",4,29,1143,600,543
050,26,091,"Michigan","Lenawee County",4,30,1241,627,614
050,26,091,"Michigan","Lenawee County",4,31,1243,651,592
050,26,091,"Michigan","Lenawee County",4,32,1219,643,576
050,26,091,"Michigan","Lenawee County",4,33,1098,572,526
050,26,091,"Michigan","Lenawee County",4,34,1146,579,567
050,26,091,"Michigan","Lenawee County",4,35,1104,582,522
050,26,091,"Michigan","Lenawee County",4,36,1161,624,537
050,26,091,"Michigan","Lenawee County",4,37,1170,601,569
050,26,091,"Michigan","Lenawee County",4,38,1194,642,552
050,26,091,"Michigan","Lenawee County",4,39,1219,638,581
050,26,091,"Michigan","Lenawee County",4,40,1208,632,576
050,26,091,"Michigan","Lenawee County",4,41,1217,650,567
050,26,091,"Michigan","Lenawee County",4,42,1208,651,557
050,26,091,"Michigan","Lenawee County",4,43,1190,653,537
050,26,091,"Michigan","Lenawee County",4,44,1174,612,562
050,26,091,"Michigan","Lenawee County",4,45,1121,570,551
050,26,091,"Michigan","Lenawee County",4,46,1088,587,501
050,26,091,"Michigan","Lenawee County",4,47,1147,608,539
050,26,091,"Michigan","Lenawee County",4,48,1148,594,554
050,26,091,"Michigan","Lenawee County",4,49,1188,615,573
050,26,091,"Michigan","Lenawee County",4,50,1287,682,605
050,26,091,"Michigan","Lenawee County",4,51,1379,706,673
050,26,091,"Michigan","Lenawee County",4,52,1323,690,633
050,26,091,"Michigan","Lenawee County",4,53,1288,668,620
050,26,091,"Michigan","Lenawee County",4,54,1267,647,620
050,26,091,"Michigan","Lenawee County",4,55,1278,648,630
050,26,091,"Michigan","Lenawee County",4,56,1263,629,634
050,26,091,"Michigan","Lenawee County",4,57,1314,645,669
050,26,091,"Michigan","Lenawee County",4,58,1395,701,694
050,26,091,"Michigan","Lenawee County",4,59,1410,697,713
050,26,091,"Michigan","Lenawee County",4,60,1443,707,736
050,26,091,"Michigan","Lenawee County",4,61,1420,700,720
050,26,091,"Michigan","Lenawee County",4,62,1384,679,705
050,26,091,"Michigan","Lenawee County",4,63,1407,701,706
050,26,091,"Michigan","Lenawee County",4,64,1482,715,767
050,26,091,"Michigan","Lenawee County",4,65,1434,711,723
050,26,091,"Michigan","Lenawee County",4,66,1335,691,644
050,26,091,"Michigan","Lenawee County",4,67,1291,645,646
050,26,091,"Michigan","Lenawee County",4,68,1253,599,654
050,26,091,"Michigan","Lenawee County",4,69,1213,575,638
050,26,091,"Michigan","Lenawee County",4,70,1237,588,649
050,26,091,"Michigan","Lenawee County",4,71,1117,531,586
050,26,091,"Michigan","Lenawee County",4,72,1065,500,565
050,26,091,"Michigan","Lenawee County",4,73,1074,505,569
050,26,091,"Michigan","Lenawee County",4,74,989,453,536
050,26,091,"Michigan","Lenawee County",4,75,1074,506,568
050,26,091,"Michigan","Lenawee County",4,76,731,345,386
050,26,091,"Michigan","Lenawee County",4,77,676,308,368
050,26,091,"Michigan","Lenawee County",4,78,666,301,365
050,26,091,"Michigan","Lenawee County",4,79,704,302,402
050,26,091,"Michigan","Lenawee County",4,80,608,261,347
050,26,091,"Michigan","Lenawee County",4,81,472,203,269
050,26,091,"Michigan","Lenawee County",4,82,444,176,268
050,26,091,"Michigan","Lenawee County",4,83,399,155,244
050,26,091,"Michigan","Lenawee County",4,84,371,155,216
050,26,091,"Michigan","Lenawee County",4,85,1796,652,1144
050,26,091,"Michigan","Lenawee County",5,0,731,360,371
050,26,091,"Michigan","Lenawee County",5,1,848,414,434
050,26,091,"Michigan","Lenawee County",5,2,933,506,427
050,26,091,"Michigan","Lenawee County",5,3,1052,528,524
050,26,091,"Michigan","Lenawee County",5,4,1028,525,503
050,26,091,"Michigan","Lenawee County",5,5,1085,555,530
050,26,091,"Michigan","Lenawee County",5,6,1067,563,504
050,26,091,"Michigan","Lenawee County",5,7,1150,592,558
050,26,091,"Michigan","Lenawee County",5,8,1154,559,595
050,26,091,"Michigan","Lenawee County",5,9,1138,566,572
050,26,091,"Michigan","Lenawee County",5,10,1139,580,559
050,26,091,"Michigan","Lenawee County",5,11,1133,593,540
050,26,091,"Michigan","Lenawee County",5,12,1125,595,530
050,26,091,"Michigan","Lenawee County",5,13,1159,597,562
050,26,091,"Michigan","Lenawee County",5,14,1207,634,573
050,26,091,"Michigan","Lenawee County",5,15,1297,671,626
050,26,091,"Michigan","Lenawee County",5,16,1288,672,616
050,26,091,"Michigan","Lenawee County",5,17,1273,678,595
050,26,091,"Michigan","Lenawee County",5,18,1343,704,639
050,26,091,"Michigan","Lenawee County",5,19,1335,715,620
050,26,091,"Michigan","Lenawee County",5,20,1344,713,631
050,26,091,"Michigan","Lenawee County",5,21,1248,683,565
050,26,091,"Michigan","Lenawee County",5,22,1195,672,523
050,26,091,"Michigan","Lenawee County",5,23,1125,602,523
050,26,091,"Michigan","Lenawee County",5,24,1111,598,513
050,26,091,"Michigan","Lenawee County",5,25,1106,600,506
050,26,091,"Michigan","Lenawee County",5,26,1035,562,473
050,26,091,"Michigan","Lenawee County",5,27,1038,544,494
050,26,091,"Michigan","Lenawee County",5,28,1115,588,527
050,26,091,"Michigan","Lenawee County",5,29,1098,579,519
050,26,091,"Michigan","Lenawee County",5,30,1146,582,564
050,26,091,"Michigan","Lenawee County",5,31,1251,629,622
050,26,091,"Michigan","Lenawee County",5,32,1257,649,608
050,26,091,"Michigan","Lenawee County",5,33,1204,616,588
050,26,091,"Michigan","Lenawee County",5,34,1093,551,542
050,26,091,"Michigan","Lenawee County",5,35,1142,577,565
050,26,091,"Michigan","Lenawee County",5,36,1118,583,535
050,26,091,"Michigan","Lenawee County",5,37,1146,599,547
050,26,091,"Michigan","Lenawee County",5,38,1155,588,567
050,26,091,"Michigan","Lenawee County",5,39,1173,615,558
050,26,091,"Michigan","Lenawee County",5,40,1209,623,586
050,26,091,"Michigan","Lenawee County",5,41,1200,623,577
050,26,091,"Michigan","Lenawee County",5,42,1198,626,572
050,26,091,"Michigan","Lenawee County",5,43,1186,640,546
050,26,091,"Michigan","Lenawee County",5,44,1171,632,539
050,26,091,"Michigan","Lenawee County",5,45,1171,604,567
050,26,091,"Michigan","Lenawee County",5,46,1102,554,548
050,26,091,"Michigan","Lenawee County",5,47,1077,564,513
050,26,091,"Michigan","Lenawee County",5,48,1130,593,537
050,26,091,"Michigan","Lenawee County",5,49,1126,579,547
050,26,091,"Michigan","Lenawee County",5,50,1181,601,580
050,26,091,"Michigan","Lenawee County",5,51,1272,661,611
050,26,091,"Michigan","Lenawee County",5,52,1368,701,667
050,26,091,"Michigan","Lenawee County",5,53,1313,678,635
050,26,091,"Michigan","Lenawee County",5,54,1274,649,625
050,26,091,"Michigan","Lenawee County",5,55,1272,645,627
050,26,091,"Michigan","Lenawee County",5,56,1261,633,628
050,26,091,"Michigan","Lenawee County",5,57,1228,599,629
050,26,091,"Michigan","Lenawee County",5,58,1318,647,671
050,26,091,"Michigan","Lenawee County",5,59,1387,689,698
050,26,091,"Michigan","Lenawee County",5,60,1398,683,715
050,26,091,"Michigan","Lenawee County",5,61,1432,707,725
050,26,091,"Michigan","Lenawee County",5,62,1400,675,725
050,26,091,"Michigan","Lenawee County",5,63,1374,677,697
050,26,091,"Michigan","Lenawee County",5,64,1372,673,699
050,26,091,"Michigan","Lenawee County",5,65,1479,708,771
050,26,091,"Michigan","Lenawee County",5,66,1406,691,715
050,26,091,"Michigan","Lenawee County",5,67,1321,681,640
050,26,091,"Michigan","Lenawee County",5,68,1266,620,646
050,26,091,"Michigan","Lenawee County",5,69,1219,583,636
050,26,091,"Michigan","Lenawee County",5,70,1183,555,628
050,26,091,"Michigan","Lenawee County",5,71,1215,572,643
050,26,091,"Michigan","Lenawee County",5,72,1084,516,568
050,26,091,"Michigan","Lenawee County",5,73,1045,484,561
050,26,091,"Michigan","Lenawee County",5,74,1034,496,538
050,26,091,"Michigan","Lenawee County",5,75,955,429,526
050,26,091,"Michigan","Lenawee County",5,76,1047,491,556
050,26,091,"Michigan","Lenawee County",5,77,702,328,374
050,26,091,"Michigan","Lenawee County",5,78,634,287,347
050,26,091,"Michigan","Lenawee County",5,79,628,278,350
050,26,091,"Michigan","Lenawee County",5,80,677,273,404
050,26,091,"Michigan","Lenawee County",5,81,574,254,320
050,26,091,"Michigan","Lenawee County",5,82,451,176,275
050,26,091,"Michigan","Lenawee County",5,83,425,165,260
050,26,091,"Michigan","Lenawee County",5,84,361,148,213
050,26,091,"Michigan","Lenawee County",5,85,1809,689,1120
050,26,093,"Michigan","Livingston County",1,0,1718,881,837
050,26,093,"Michigan","Livingston County",1,1,1844,952,892
050,26,093,"Michigan","Livingston County",1,2,1930,965,965
050,26,093,"Michigan","Livingston County",1,3,1997,1024,973
050,26,093,"Michigan","Livingston County",1,4,2059,1047,1012
050,26,093,"Michigan","Livingston County",1,5,2136,1097,1039
050,26,093,"Michigan","Livingston County",1,6,2155,1129,1026
050,26,093,"Michigan","Livingston County",1,7,2113,1094,1019
050,26,093,"Michigan","Livingston County",1,8,2157,1107,1050
050,26,093,"Michigan","Livingston County",1,9,2157,1118,1039
050,26,093,"Michigan","Livingston County",1,10,2282,1180,1102
050,26,093,"Michigan","Livingston County",1,11,2415,1229,1186
050,26,093,"Michigan","Livingston County",1,12,2482,1281,1201
050,26,093,"Michigan","Livingston County",1,13,2516,1278,1238
050,26,093,"Michigan","Livingston County",1,14,2538,1279,1259
050,26,093,"Michigan","Livingston County",1,15,2613,1359,1254
050,26,093,"Michigan","Livingston County",1,16,2766,1448,1318
050,26,093,"Michigan","Livingston County",1,17,2772,1458,1314
050,26,093,"Michigan","Livingston County",1,18,2353,1251,1102
050,26,093,"Michigan","Livingston County",1,19,1935,1029,906
050,26,093,"Michigan","Livingston County",1,20,2122,1137,985
050,26,093,"Michigan","Livingston County",1,21,2163,1150,1013
050,26,093,"Michigan","Livingston County",1,22,2255,1188,1067
050,26,093,"Michigan","Livingston County",1,23,2249,1143,1106
050,26,093,"Michigan","Livingston County",1,24,2225,1158,1067
050,26,093,"Michigan","Livingston County",1,25,2178,1135,1043
050,26,093,"Michigan","Livingston County",1,26,2136,1167,969
050,26,093,"Michigan","Livingston County",1,27,2087,1105,982
050,26,093,"Michigan","Livingston County",1,28,2049,1031,1018
050,26,093,"Michigan","Livingston County",1,29,2097,1091,1006
050,26,093,"Michigan","Livingston County",1,30,2108,1072,1036
050,26,093,"Michigan","Livingston County",1,31,2084,1051,1033
050,26,093,"Michigan","Livingston County",1,32,2155,1092,1063
050,26,093,"Michigan","Livingston County",1,33,2167,1113,1054
050,26,093,"Michigan","Livingston County",1,34,2214,1122,1092
050,26,093,"Michigan","Livingston County",1,35,2222,1142,1080
050,26,093,"Michigan","Livingston County",1,36,2248,1132,1116
050,26,093,"Michigan","Livingston County",1,37,2274,1156,1118
050,26,093,"Michigan","Livingston County",1,38,2290,1161,1129
050,26,093,"Michigan","Livingston County",1,39,2336,1179,1157
050,26,093,"Michigan","Livingston County",1,40,2354,1186,1168
050,26,093,"Michigan","Livingston County",1,41,2280,1165,1115
050,26,093,"Michigan","Livingston County",1,42,2290,1193,1097
050,26,093,"Michigan","Livingston County",1,43,2177,1129,1048
050,26,093,"Michigan","Livingston County",1,44,2172,1095,1077
050,26,093,"Michigan","Livingston County",1,45,2244,1122,1122
050,26,093,"Michigan","Livingston County",1,46,2300,1149,1151
050,26,093,"Michigan","Livingston County",1,47,2309,1140,1169
050,26,093,"Michigan","Livingston County",1,48,2665,1352,1313
050,26,093,"Michigan","Livingston County",1,49,3028,1519,1509
050,26,093,"Michigan","Livingston County",1,50,2961,1469,1492
050,26,093,"Michigan","Livingston County",1,51,2922,1464,1458
050,26,093,"Michigan","Livingston County",1,52,2941,1451,1490
050,26,093,"Michigan","Livingston County",1,53,3070,1530,1540
050,26,093,"Michigan","Livingston County",1,54,3139,1567,1572
050,26,093,"Michigan","Livingston County",1,55,3270,1649,1621
050,26,093,"Michigan","Livingston County",1,56,3294,1642,1652
050,26,093,"Michigan","Livingston County",1,57,3267,1637,1630
050,26,093,"Michigan","Livingston County",1,58,3322,1694,1628
050,26,093,"Michigan","Livingston County",1,59,3236,1664,1572
050,26,093,"Michigan","Livingston County",1,60,3148,1629,1519
050,26,093,"Michigan","Livingston County",1,61,3170,1647,1523
050,26,093,"Michigan","Livingston County",1,62,3086,1551,1535
050,26,093,"Michigan","Livingston County",1,63,2894,1425,1469
050,26,093,"Michigan","Livingston County",1,64,2810,1394,1416
050,26,093,"Michigan","Livingston County",1,65,2752,1382,1370
050,26,093,"Michigan","Livingston County",1,66,2550,1255,1295
050,26,093,"Michigan","Livingston County",1,67,2434,1208,1226
050,26,093,"Michigan","Livingston County",1,68,2402,1169,1233
050,26,093,"Michigan","Livingston County",1,69,2234,1095,1139
050,26,093,"Michigan","Livingston County",1,70,2086,1008,1078
050,26,093,"Michigan","Livingston County",1,71,2006,997,1009
050,26,093,"Michigan","Livingston County",1,72,1998,1013,985
050,26,093,"Michigan","Livingston County",1,73,1999,984,1015
050,26,093,"Michigan","Livingston County",1,74,1383,659,724
050,26,093,"Michigan","Livingston County",1,75,1404,664,740
050,26,093,"Michigan","Livingston County",1,76,1413,656,757
050,26,093,"Michigan","Livingston County",1,77,1403,705,698
050,26,093,"Michigan","Livingston County",1,78,1162,568,594
050,26,093,"Michigan","Livingston County",1,79,977,460,517
050,26,093,"Michigan","Livingston County",1,80,905,429,476
050,26,093,"Michigan","Livingston County",1,81,816,396,420
050,26,093,"Michigan","Livingston County",1,82,718,320,398
050,26,093,"Michigan","Livingston County",1,83,596,260,336
050,26,093,"Michigan","Livingston County",1,84,538,243,295
050,26,093,"Michigan","Livingston County",1,85,3139,1169,1970
050,26,093,"Michigan","Livingston County",2,0,1747,889,858
050,26,093,"Michigan","Livingston County",2,1,1825,937,888
050,26,093,"Michigan","Livingston County",2,2,1924,970,954
050,26,093,"Michigan","Livingston County",2,3,1981,1009,972
050,26,093,"Michigan","Livingston County",2,4,2064,1052,1012
050,26,093,"Michigan","Livingston County",2,5,2125,1090,1035
050,26,093,"Michigan","Livingston County",2,6,2160,1129,1031
050,26,093,"Michigan","Livingston County",2,7,2136,1108,1028
050,26,093,"Michigan","Livingston County",2,8,2145,1105,1040
050,26,093,"Michigan","Livingston County",2,9,2157,1115,1042
050,26,093,"Michigan","Livingston County",2,10,2263,1169,1094
050,26,093,"Michigan","Livingston County",2,11,2380,1219,1161
050,26,093,"Michigan","Livingston County",2,12,2476,1271,1205
050,26,093,"Michigan","Livingston County",2,13,2513,1279,1234
050,26,093,"Michigan","Livingston County",2,14,2531,1278,1253
050,26,093,"Michigan","Livingston County",2,15,2597,1343,1254
050,26,093,"Michigan","Livingston County",2,16,2732,1432,1300
050,26,093,"Michigan","Livingston County",2,17,2778,1459,1319
050,26,093,"Michigan","Livingston County",2,18,2330,1250,1080
050,26,093,"Michigan","Livingston County",2,19,1919,1021,898
050,26,093,"Michigan","Livingston County",2,20,2138,1140,998
050,26,093,"Michigan","Livingston County",2,21,2166,1151,1015
050,26,093,"Michigan","Livingston County",2,22,2245,1178,1067
050,26,093,"Michigan","Livingston County",2,23,2255,1159,1096
050,26,093,"Michigan","Livingston County",2,24,2216,1148,1068
050,26,093,"Michigan","Livingston County",2,25,2173,1132,1041
050,26,093,"Michigan","Livingston County",2,26,2142,1153,989
050,26,093,"Michigan","Livingston County",2,27,2090,1113,977
050,26,093,"Michigan","Livingston County",2,28,2072,1060,1012
050,26,093,"Michigan","Livingston County",2,29,2103,1084,1019
050,26,093,"Michigan","Livingston County",2,30,2139,1092,1047
050,26,093,"Michigan","Livingston County",2,31,2097,1060,1037
050,26,093,"Michigan","Livingston County",2,32,2146,1084,1062
050,26,093,"Michigan","Livingston County",2,33,2176,1116,1060
050,26,093,"Michigan","Livingston County",2,34,2206,1121,1085
050,26,093,"Michigan","Livingston County",2,35,2253,1156,1097
050,26,093,"Michigan","Livingston County",2,36,2237,1130,1107
050,26,093,"Michigan","Livingston County",2,37,2276,1153,1123
050,26,093,"Michigan","Livingston County",2,38,2304,1171,1133
050,26,093,"Michigan","Livingston County",2,39,2328,1179,1149
050,26,093,"Michigan","Livingston County",2,40,2371,1196,1175
050,26,093,"Michigan","Livingston County",2,41,2300,1169,1131
050,26,093,"Michigan","Livingston County",2,42,2279,1186,1093
050,26,093,"Michigan","Livingston County",2,43,2218,1152,1066
050,26,093,"Michigan","Livingston County",2,44,2160,1097,1063
050,26,093,"Michigan","Livingston County",2,45,2245,1125,1120
050,26,093,"Michigan","Livingston County",2,46,2276,1135,1141
050,26,093,"Michigan","Livingston County",2,47,2297,1136,1161
050,26,093,"Michigan","Livingston County",2,48,2581,1302,1279
050,26,093,"Michigan","Livingston County",2,49,2953,1485,1468
050,26,093,"Michigan","Livingston County",2,50,2980,1482,1498
050,26,093,"Michigan","Livingston County",2,51,2923,1458,1465
050,26,093,"Michigan","Livingston County",2,52,2930,1450,1480
050,26,093,"Michigan","Livingston County",2,53,3043,1509,1534
050,26,093,"Michigan","Livingston County",2,54,3118,1554,1564
050,26,093,"Michigan","Livingston County",2,55,3237,1628,1609
050,26,093,"Michigan","Livingston County",2,56,3292,1649,1643
050,26,093,"Michigan","Livingston County",2,57,3273,1640,1633
050,26,093,"Michigan","Livingston County",2,58,3291,1672,1619
050,26,093,"Michigan","Livingston County",2,59,3267,1674,1593
050,26,093,"Michigan","Livingston County",2,60,3149,1624,1525
050,26,093,"Michigan","Livingston County",2,61,3142,1627,1515
050,26,093,"Michigan","Livingston County",2,62,3091,1566,1525
050,26,093,"Michigan","Livingston County",2,63,2961,1470,1491
050,26,093,"Michigan","Livingston County",2,64,2812,1387,1425
050,26,093,"Michigan","Livingston County",2,65,2752,1376,1376
050,26,093,"Michigan","Livingston County",2,66,2597,1286,1311
050,26,093,"Michigan","Livingston County",2,67,2450,1212,1238
050,26,093,"Michigan","Livingston County",2,68,2390,1168,1222
050,26,093,"Michigan","Livingston County",2,69,2289,1120,1169
050,26,093,"Michigan","Livingston County",2,70,2103,1018,1085
050,26,093,"Michigan","Livingston County",2,71,2016,989,1027
050,26,093,"Michigan","Livingston County",2,72,1961,987,974
050,26,093,"Michigan","Livingston County",2,73,2094,1035,1059
050,26,093,"Michigan","Livingston County",2,74,1424,686,738
050,26,093,"Michigan","Livingston County",2,75,1388,657,731
050,26,093,"Michigan","Livingston County",2,76,1395,650,745
050,26,093,"Michigan","Livingston County",2,77,1424,703,721
050,26,093,"Michigan","Livingston County",2,78,1186,584,602
050,26,093,"Michigan","Livingston County",2,79,1010,477,533
050,26,093,"Michigan","Livingston County",2,80,910,432,478
050,26,093,"Michigan","Livingston County",2,81,826,399,427
050,26,093,"Michigan","Livingston County",2,82,736,332,404
050,26,093,"Michigan","Livingston County",2,83,614,267,347
050,26,093,"Michigan","Livingston County",2,84,544,244,300
050,26,093,"Michigan","Livingston County",2,85,3125,1164,1961
050,26,093,"Michigan","Livingston County",3,0,1743,881,862
050,26,093,"Michigan","Livingston County",3,1,1842,935,907
050,26,093,"Michigan","Livingston County",3,2,1891,970,921
050,26,093,"Michigan","Livingston County",3,3,1974,998,976
050,26,093,"Michigan","Livingston County",3,4,2051,1025,1026
050,26,093,"Michigan","Livingston County",3,5,2138,1096,1042
050,26,093,"Michigan","Livingston County",3,6,2157,1110,1047
050,26,093,"Michigan","Livingston County",3,7,2210,1150,1060
050,26,093,"Michigan","Livingston County",3,8,2205,1135,1070
050,26,093,"Michigan","Livingston County",3,9,2161,1107,1054
050,26,093,"Michigan","Livingston County",3,10,2216,1149,1067
050,26,093,"Michigan","Livingston County",3,11,2296,1191,1105
050,26,093,"Michigan","Livingston County",3,12,2387,1228,1159
050,26,093,"Michigan","Livingston County",3,13,2512,1295,1217
050,26,093,"Michigan","Livingston County",3,14,2520,1289,1231
050,26,093,"Michigan","Livingston County",3,15,2533,1286,1247
050,26,093,"Michigan","Livingston County",3,16,2654,1374,1280
050,26,093,"Michigan","Livingston County",3,17,2729,1426,1303
050,26,093,"Michigan","Livingston County",3,18,2377,1293,1084
050,26,093,"Michigan","Livingston County",3,19,1848,979,869
050,26,093,"Michigan","Livingston County",3,20,2104,1114,990
050,26,093,"Michigan","Livingston County",3,21,2221,1188,1033
050,26,093,"Michigan","Livingston County",3,22,2289,1196,1093
050,26,093,"Michigan","Livingston County",3,23,2284,1212,1072
050,26,093,"Michigan","Livingston County",3,24,2179,1134,1045
050,26,093,"Michigan","Livingston County",3,25,2157,1133,1024
050,26,093,"Michigan","Livingston County",3,26,2139,1124,1015
050,26,093,"Michigan","Livingston County",3,27,2184,1190,994
050,26,093,"Michigan","Livingston County",3,28,2115,1145,970
050,26,093,"Michigan","Livingston County",3,29,2119,1083,1036
050,26,093,"Michigan","Livingston County",3,30,2156,1108,1048
050,26,093,"Michigan","Livingston County",3,31,2231,1126,1105
050,26,093,"Michigan","Livingston County",3,32,2182,1100,1082
050,26,093,"Michigan","Livingston County",3,33,2193,1111,1082
050,26,093,"Michigan","Livingston County",3,34,2270,1157,1113
050,26,093,"Michigan","Livingston County",3,35,2316,1192,1124
050,26,093,"Michigan","Livingston County",3,36,2356,1214,1142
050,26,093,"Michigan","Livingston County",3,37,2258,1130,1128
050,26,093,"Michigan","Livingston County",3,38,2349,1185,1164
050,26,093,"Michigan","Livingston County",3,39,2337,1172,1165
050,26,093,"Michigan","Livingston County",3,40,2377,1204,1173
050,26,093,"Michigan","Livingston County",3,41,2402,1218,1184
050,26,093,"Michigan","Livingston County",3,42,2336,1187,1149
050,26,093,"Michigan","Livingston County",3,43,2320,1198,1122
050,26,093,"Michigan","Livingston County",3,44,2253,1175,1078
050,26,093,"Michigan","Livingston County",3,45,2181,1117,1064
050,26,093,"Michigan","Livingston County",3,46,2253,1125,1128
050,26,093,"Michigan","Livingston County",3,47,2274,1138,1136
050,26,093,"Michigan","Livingston County",3,48,2324,1153,1171
050,26,093,"Michigan","Livingston County",3,49,2578,1292,1286
050,26,093,"Michigan","Livingston County",3,50,2972,1509,1463
050,26,093,"Michigan","Livingston County",3,51,2984,1477,1507
050,26,093,"Michigan","Livingston County",3,52,2903,1447,1456
050,26,093,"Michigan","Livingston County",3,53,2934,1450,1484
050,26,093,"Michigan","Livingston County",3,54,3033,1512,1521
050,26,093,"Michigan","Livingston County",3,55,3112,1532,1580
050,26,093,"Michigan","Livingston County",3,56,3197,1613,1584
050,26,093,"Michigan","Livingston County",3,57,3267,1634,1633
050,26,093,"Michigan","Livingston County",3,58,3231,1616,1615
050,26,093,"Michigan","Livingston County",3,59,3246,1641,1605
050,26,093,"Michigan","Livingston County",3,60,3246,1661,1585
050,26,093,"Michigan","Livingston County",3,61,3133,1611,1522
050,26,093,"Michigan","Livingston County",3,62,3082,1586,1496
050,26,093,"Michigan","Livingston County",3,63,3059,1526,1533
050,26,093,"Michigan","Livingston County",3,64,2935,1448,1487
050,26,093,"Michigan","Livingston County",3,65,2794,1386,1408
050,26,093,"Michigan","Livingston County",3,66,2733,1359,1374
050,26,093,"Michigan","Livingston County",3,67,2590,1288,1302
050,26,093,"Michigan","Livingston County",3,68,2437,1203,1234
050,26,093,"Michigan","Livingston County",3,69,2346,1140,1206
050,26,093,"Michigan","Livingston County",3,70,2269,1105,1164
050,26,093,"Michigan","Livingston County",3,71,2059,1000,1059
050,26,093,"Michigan","Livingston County",3,72,1983,967,1016
050,26,093,"Michigan","Livingston County",3,73,1941,963,978
050,26,093,"Michigan","Livingston County",3,74,2063,1013,1050
050,26,093,"Michigan","Livingston County",3,75,1388,655,733
050,26,093,"Michigan","Livingston County",3,76,1360,632,728
050,26,093,"Michigan","Livingston County",3,77,1337,629,708
050,26,093,"Michigan","Livingston County",3,78,1351,671,680
050,26,093,"Michigan","Livingston County",3,79,1151,568,583
050,26,093,"Michigan","Livingston County",3,80,951,449,502
050,26,093,"Michigan","Livingston County",3,81,855,409,446
050,26,093,"Michigan","Livingston County",3,82,779,382,397
050,26,093,"Michigan","Livingston County",3,83,693,305,388
050,26,093,"Michigan","Livingston County",3,84,578,248,330
050,26,093,"Michigan","Livingston County",3,85,3160,1204,1956
050,26,093,"Michigan","Livingston County",4,0,1764,895,869
050,26,093,"Michigan","Livingston County",4,1,1808,905,903
050,26,093,"Michigan","Livingston County",4,2,1919,990,929
050,26,093,"Michigan","Livingston County",4,3,1961,1008,953
050,26,093,"Michigan","Livingston County",4,4,2073,1048,1025
050,26,093,"Michigan","Livingston County",4,5,2083,1033,1050
050,26,093,"Michigan","Livingston County",4,6,2169,1102,1067
050,26,093,"Michigan","Livingston County",4,7,2211,1155,1056
050,26,093,"Michigan","Livingston County",4,8,2248,1175,1073
050,26,093,"Michigan","Livingston County",4,9,2224,1138,1086
050,26,093,"Michigan","Livingston County",4,10,2190,1117,1073
050,26,093,"Michigan","Livingston County",4,11,2238,1147,1091
050,26,093,"Michigan","Livingston County",4,12,2333,1196,1137
050,26,093,"Michigan","Livingston County",4,13,2399,1235,1164
050,26,093,"Michigan","Livingston County",4,14,2526,1290,1236
050,26,093,"Michigan","Livingston County",4,15,2536,1295,1241
050,26,093,"Michigan","Livingston County",4,16,2531,1291,1240
050,26,093,"Michigan","Livingston County",4,17,2627,1367,1260
050,26,093,"Michigan","Livingston County",4,18,2269,1242,1027
050,26,093,"Michigan","Livingston County",4,19,1804,985,819
050,26,093,"Michigan","Livingston County",4,20,1995,1056,939
050,26,093,"Michigan","Livingston County",4,21,2150,1130,1020
050,26,093,"Michigan","Livingston County",4,22,2301,1210,1091
050,26,093,"Michigan","Livingston County",4,23,2261,1185,1076
050,26,093,"Michigan","Livingston County",4,24,2207,1169,1038
050,26,093,"Michigan","Livingston County",4,25,1986,1025,961
050,26,093,"Michigan","Livingston County",4,26,2159,1145,1014
050,26,093,"Michigan","Livingston County",4,27,2153,1129,1024
050,26,093,"Michigan","Livingston County",4,28,2161,1175,986
050,26,093,"Michigan","Livingston County",4,29,2149,1138,1011
050,26,093,"Michigan","Livingston County",4,30,2191,1117,1074
050,26,093,"Michigan","Livingston County",4,31,2216,1120,1096
050,26,093,"Michigan","Livingston County",4,32,2354,1200,1154
050,26,093,"Michigan","Livingston County",4,33,2256,1130,1126
050,26,093,"Michigan","Livingston County",4,34,2254,1150,1104
050,26,093,"Michigan","Livingston County",4,35,2324,1169,1155
050,26,093,"Michigan","Livingston County",4,36,2386,1219,1167
050,26,093,"Michigan","Livingston County",4,37,2415,1238,1177
050,26,093,"Michigan","Livingston County",4,38,2316,1163,1153
050,26,093,"Michigan","Livingston County",4,39,2393,1203,1190
050,26,093,"Michigan","Livingston County",4,40,2391,1207,1184
050,26,093,"Michigan","Livingston County",4,41,2398,1215,1183
050,26,093,"Michigan","Livingston County",4,42,2420,1235,1185
050,26,093,"Michigan","Livingston County",4,43,2341,1187,1154
050,26,093,"Michigan","Livingston County",4,44,2345,1214,1131
050,26,093,"Michigan","Livingston County",4,45,2299,1195,1104
050,26,093,"Michigan","Livingston County",4,46,2179,1106,1073
050,26,093,"Michigan","Livingston County",4,47,2261,1134,1127
050,26,093,"Michigan","Livingston County",4,48,2287,1148,1139
050,26,093,"Michigan","Livingston County",4,49,2328,1160,1168
050,26,093,"Michigan","Livingston County",4,50,2601,1285,1316
050,26,093,"Michigan","Livingston County",4,51,2976,1507,1469
050,26,093,"Michigan","Livingston County",4,52,2989,1482,1507
050,26,093,"Michigan","Livingston County",4,53,2952,1483,1469
050,26,093,"Michigan","Livingston County",4,54,2936,1455,1481
050,26,093,"Michigan","Livingston County",4,55,3013,1509,1504
050,26,093,"Michigan","Livingston County",4,56,3103,1549,1554
050,26,093,"Michigan","Livingston County",4,57,3182,1594,1588
050,26,093,"Michigan","Livingston County",4,58,3260,1623,1637
050,26,093,"Michigan","Livingston County",4,59,3229,1610,1619
050,26,093,"Michigan","Livingston County",4,60,3256,1633,1623
050,26,093,"Michigan","Livingston County",4,61,3203,1635,1568
050,26,093,"Michigan","Livingston County",4,62,3096,1589,1507
050,26,093,"Michigan","Livingston County",4,63,3037,1547,1490
050,26,093,"Michigan","Livingston County",4,64,3038,1495,1543
050,26,093,"Michigan","Livingston County",4,65,2934,1440,1494
050,26,093,"Michigan","Livingston County",4,66,2720,1337,1383
050,26,093,"Michigan","Livingston County",4,67,2705,1345,1360
050,26,093,"Michigan","Livingston County",4,68,2572,1260,1312
050,26,093,"Michigan","Livingston County",4,69,2407,1185,1222
050,26,093,"Michigan","Livingston County",4,70,2329,1130,1199
050,26,093,"Michigan","Livingston County",4,71,2264,1097,1167
050,26,093,"Michigan","Livingston County",4,72,2028,968,1060
050,26,093,"Michigan","Livingston County",4,73,1949,940,1009
050,26,093,"Michigan","Livingston County",4,74,1893,946,947
050,26,093,"Michigan","Livingston County",4,75,1997,966,1031
050,26,093,"Michigan","Livingston County",4,76,1348,620,728
050,26,093,"Michigan","Livingston County",4,77,1308,605,703
050,26,093,"Michigan","Livingston County",4,78,1281,606,675
050,26,093,"Michigan","Livingston County",4,79,1313,646,667
050,26,093,"Michigan","Livingston County",4,80,1107,546,561
050,26,093,"Michigan","Livingston County",4,81,901,428,473
050,26,093,"Michigan","Livingston County",4,82,811,390,421
050,26,093,"Michigan","Livingston County",4,83,724,345,379
050,26,093,"Michigan","Livingston County",4,84,654,279,375
050,26,093,"Michigan","Livingston County",4,85,3229,1213,2016
050,26,093,"Michigan","Livingston County",5,0,1621,827,794
050,26,093,"Michigan","Livingston County",5,1,1866,941,925
050,26,093,"Michigan","Livingston County",5,2,1843,921,922
050,26,093,"Michigan","Livingston County",5,3,1980,1020,960
050,26,093,"Michigan","Livingston County",5,4,1993,1024,969
050,26,093,"Michigan","Livingston County",5,5,2083,1053,1030
050,26,093,"Michigan","Livingston County",5,6,2095,1029,1066
050,26,093,"Michigan","Livingston County",5,7,2197,1120,1077
050,26,093,"Michigan","Livingston County",5,8,2239,1165,1074
050,26,093,"Michigan","Livingston County",5,9,2255,1179,1076
050,26,093,"Michigan","Livingston County",5,10,2248,1154,1094
050,26,093,"Michigan","Livingston County",5,11,2214,1143,1071
050,26,093,"Michigan","Livingston County",5,12,2255,1164,1091
050,26,093,"Michigan","Livingston County",5,13,2340,1208,1132
050,26,093,"Michigan","Livingston County",5,14,2379,1212,1167
050,26,093,"Michigan","Livingston County",5,15,2577,1329,1248
050,26,093,"Michigan","Livingston County",5,16,2554,1305,1249
050,26,093,"Michigan","Livingston County",5,17,2548,1299,1249
050,26,093,"Michigan","Livingston County",5,18,2214,1209,1005
050,26,093,"Michigan","Livingston County",5,19,1743,960,783
050,26,093,"Michigan","Livingston County",5,20,1979,1069,910
050,26,093,"Michigan","Livingston County",5,21,2076,1084,992
050,26,093,"Michigan","Livingston County",5,22,2273,1195,1078
050,26,093,"Michigan","Livingston County",5,23,2365,1257,1108
050,26,093,"Michigan","Livingston County",5,24,2163,1147,1016
050,26,093,"Michigan","Livingston County",5,25,2103,1123,980
050,26,093,"Michigan","Livingston County",5,26,1975,1024,951
050,26,093,"Michigan","Livingston County",5,27,2157,1152,1005
050,26,093,"Michigan","Livingston County",5,28,2154,1111,1043
050,26,093,"Michigan","Livingston County",5,29,2174,1161,1013
050,26,093,"Michigan","Livingston County",5,30,2167,1119,1048
050,26,093,"Michigan","Livingston County",5,31,2228,1130,1098
050,26,093,"Michigan","Livingston County",5,32,2321,1181,1140
050,26,093,"Michigan","Livingston County",5,33,2395,1214,1181
050,26,093,"Michigan","Livingston County",5,34,2319,1177,1142
050,26,093,"Michigan","Livingston County",5,35,2339,1196,1143
050,26,093,"Michigan","Livingston County",5,36,2373,1202,1171
050,26,093,"Michigan","Livingston County",5,37,2407,1239,1168
050,26,093,"Michigan","Livingston County",5,38,2471,1279,1192
050,26,093,"Michigan","Livingston County",5,39,2362,1180,1182
050,26,093,"Michigan","Livingston County",5,40,2427,1215,1212
050,26,093,"Michigan","Livingston County",5,41,2406,1207,1199
050,26,093,"Michigan","Livingston County",5,42,2428,1244,1184
050,26,093,"Michigan","Livingston County",5,43,2434,1261,1173
050,26,093,"Michigan","Livingston County",5,44,2360,1184,1176
050,26,093,"Michigan","Livingston County",5,45,2351,1229,1122
050,26,093,"Michigan","Livingston County",5,46,2297,1174,1123
050,26,093,"Michigan","Livingston County",5,47,2200,1112,1088
050,26,093,"Michigan","Livingston County",5,48,2277,1145,1132
050,26,093,"Michigan","Livingston County",5,49,2277,1141,1136
050,26,093,"Michigan","Livingston County",5,50,2364,1197,1167
050,26,093,"Michigan","Livingston County",5,51,2604,1267,1337
050,26,093,"Michigan","Livingston County",5,52,2979,1510,1469
050,26,093,"Michigan","Livingston County",5,53,2989,1484,1505
050,26,093,"Michigan","Livingston County",5,54,2950,1483,1467
050,26,093,"Michigan","Livingston County",5,55,2937,1447,1490
050,26,093,"Michigan","Livingston County",5,56,2980,1487,1493
050,26,093,"Michigan","Livingston County",5,57,3087,1543,1544
050,26,093,"Michigan","Livingston County",5,58,3150,1575,1575
050,26,093,"Michigan","Livingston County",5,59,3252,1620,1632
050,26,093,"Michigan","Livingston County",5,60,3223,1595,1628
050,26,093,"Michigan","Livingston County",5,61,3211,1596,1615
050,26,093,"Michigan","Livingston County",5,62,3173,1610,1563
050,26,093,"Michigan","Livingston County",5,63,3056,1559,1497
050,26,093,"Michigan","Livingston County",5,64,2975,1504,1471
050,26,093,"Michigan","Livingston County",5,65,3028,1481,1547
050,26,093,"Michigan","Livingston County",5,66,2903,1415,1488
050,26,093,"Michigan","Livingston County",5,67,2713,1326,1387
050,26,093,"Michigan","Livingston County",5,68,2675,1311,1364
050,26,093,"Michigan","Livingston County",5,69,2573,1253,1320
050,26,093,"Michigan","Livingston County",5,70,2400,1174,1226
050,26,093,"Michigan","Livingston County",5,71,2298,1109,1189
050,26,093,"Michigan","Livingston County",5,72,2228,1081,1147
050,26,093,"Michigan","Livingston County",5,73,1985,937,1048
050,26,093,"Michigan","Livingston County",5,74,1907,924,983
050,26,093,"Michigan","Livingston County",5,75,1837,908,929
050,26,093,"Michigan","Livingston County",5,76,1949,929,1020
050,26,093,"Michigan","Livingston County",5,77,1297,595,702
050,26,093,"Michigan","Livingston County",5,78,1255,574,681
050,26,093,"Michigan","Livingston County",5,79,1234,578,656
050,26,093,"Michigan","Livingston County",5,80,1266,625,641
050,26,093,"Michigan","Livingston County",5,81,1065,532,533
050,26,093,"Michigan","Livingston County",5,82,843,405,438
050,26,093,"Michigan","Livingston County",5,83,756,349,407
050,26,093,"Michigan","Livingston County",5,84,690,320,370
050,26,093,"Michigan","Livingston County",5,85,3423,1264,2159
050,26,095,"Michigan","Luce County",1,0,53,27,26
050,26,095,"Michigan","Luce County",1,1,70,33,37
050,26,095,"Michigan","Luce County",1,2,59,32,27
050,26,095,"Michigan","Luce County",1,3,55,32,23
050,26,095,"Michigan","Luce County",1,4,45,20,25
050,26,095,"Michigan","Luce County",1,5,60,28,32
050,26,095,"Michigan","Luce County",1,6,51,22,29
050,26,095,"Michigan","Luce County",1,7,46,23,23
050,26,095,"Michigan","Luce County",1,8,47,25,22
050,26,095,"Michigan","Luce County",1,9,62,30,32
050,26,095,"Michigan","Luce County",1,10,70,37,33
050,26,095,"Michigan","Luce County",1,11,63,35,28
050,26,095,"Michigan","Luce County",1,12,66,38,28
050,26,095,"Michigan","Luce County",1,13,63,36,27
050,26,095,"Michigan","Luce County",1,14,63,32,31
050,26,095,"Michigan","Luce County",1,15,60,31,29
050,26,095,"Michigan","Luce County",1,16,59,31,28
050,26,095,"Michigan","Luce County",1,17,58,30,28
050,26,095,"Michigan","Luce County",1,18,65,38,27
050,26,095,"Michigan","Luce County",1,19,60,40,20
050,26,095,"Michigan","Luce County",1,20,59,44,15
050,26,095,"Michigan","Luce County",1,21,58,42,16
050,26,095,"Michigan","Luce County",1,22,74,51,23
050,26,095,"Michigan","Luce County",1,23,86,58,28
050,26,095,"Michigan","Luce County",1,24,84,63,21
050,26,095,"Michigan","Luce County",1,25,63,37,26
050,26,095,"Michigan","Luce County",1,26,84,52,32
050,26,095,"Michigan","Luce County",1,27,89,65,24
050,26,095,"Michigan","Luce County",1,28,93,68,25
050,26,095,"Michigan","Luce County",1,29,82,57,25
050,26,095,"Michigan","Luce County",1,30,106,69,37
050,26,095,"Michigan","Luce County",1,31,93,66,27
050,26,095,"Michigan","Luce County",1,32,80,57,23
050,26,095,"Michigan","Luce County",1,33,84,64,20
050,26,095,"Michigan","Luce County",1,34,83,63,20
050,26,095,"Michigan","Luce County",1,35,79,55,24
050,26,095,"Michigan","Luce County",1,36,82,51,31
050,26,095,"Michigan","Luce County",1,37,98,69,29
050,26,095,"Michigan","Luce County",1,38,96,70,26
050,26,095,"Michigan","Luce County",1,39,90,65,25
050,26,095,"Michigan","Luce County",1,40,93,69,24
050,26,095,"Michigan","Luce County",1,41,81,55,26
050,26,095,"Michigan","Luce County",1,42,67,46,21
050,26,095,"Michigan","Luce County",1,43,74,51,23
050,26,095,"Michigan","Luce County",1,44,86,54,32
050,26,095,"Michigan","Luce County",1,45,85,55,30
050,26,095,"Michigan","Luce County",1,46,75,48,27
050,26,095,"Michigan","Luce County",1,47,92,64,28
050,26,095,"Michigan","Luce County",1,48,88,54,34
050,26,095,"Michigan","Luce County",1,49,88,57,31
050,26,095,"Michigan","Luce County",1,50,92,59,33
050,26,095,"Michigan","Luce County",1,51,82,55,27
050,26,095,"Michigan","Luce County",1,52,78,51,27
050,26,095,"Michigan","Luce County",1,53,82,50,32
050,26,095,"Michigan","Luce County",1,54,81,46,35
050,26,095,"Michigan","Luce County",1,55,95,54,41
050,26,095,"Michigan","Luce County",1,56,83,48,35
050,26,095,"Michigan","Luce County",1,57,88,50,38
050,26,095,"Michigan","Luce County",1,58,102,58,44
050,26,095,"Michigan","Luce County",1,59,100,55,45
050,26,095,"Michigan","Luce County",1,60,90,46,44
050,26,095,"Michigan","Luce County",1,61,94,51,43
050,26,095,"Michigan","Luce County",1,62,103,58,45
050,26,095,"Michigan","Luce County",1,63,104,56,48
050,26,095,"Michigan","Luce County",1,64,110,58,52
050,26,095,"Michigan","Luce County",1,65,97,52,45
050,26,095,"Michigan","Luce County",1,66,87,45,42
050,26,095,"Michigan","Luce County",1,67,79,44,35
050,26,095,"Michigan","Luce County",1,68,77,45,32
050,26,095,"Michigan","Luce County",1,69,85,41,44
050,26,095,"Michigan","Luce County",1,70,72,36,36
050,26,095,"Michigan","Luce County",1,71,83,43,40
050,26,095,"Michigan","Luce County",1,72,75,40,35
050,26,095,"Michigan","Luce County",1,73,70,39,31
050,26,095,"Michigan","Luce County",1,74,43,23,20
050,26,095,"Michigan","Luce County",1,75,49,27,22
050,26,095,"Michigan","Luce County",1,76,42,22,20
050,26,095,"Michigan","Luce County",1,77,68,30,38
050,26,095,"Michigan","Luce County",1,78,47,19,28
050,26,095,"Michigan","Luce County",1,79,42,20,22
050,26,095,"Michigan","Luce County",1,80,43,17,26
050,26,095,"Michigan","Luce County",1,81,39,13,26
050,26,095,"Michigan","Luce County",1,82,37,19,18
050,26,095,"Michigan","Luce County",1,83,40,20,20
050,26,095,"Michigan","Luce County",1,84,38,22,16
050,26,095,"Michigan","Luce County",1,85,150,58,92
050,26,095,"Michigan","Luce County",2,0,53,28,25
050,26,095,"Michigan","Luce County",2,1,67,32,35
050,26,095,"Michigan","Luce County",2,2,62,33,29
050,26,095,"Michigan","Luce County",2,3,53,31,22
050,26,095,"Michigan","Luce County",2,4,48,23,25
050,26,095,"Michigan","Luce County",2,5,57,26,31
050,26,095,"Michigan","Luce County",2,6,54,24,30
050,26,095,"Michigan","Luce County",2,7,48,22,26
050,26,095,"Michigan","Luce County",2,8,46,24,22
050,26,095,"Michigan","Luce County",2,9,58,28,30
050,26,095,"Michigan","Luce County",2,10,69,36,33
050,26,095,"Michigan","Luce County",2,11,64,35,29
050,26,095,"Michigan","Luce County",2,12,67,37,30
050,26,095,"Michigan","Luce County",2,13,63,36,27
050,26,095,"Michigan","Luce County",2,14,63,34,29
050,26,095,"Michigan","Luce County",2,15,62,32,30
050,26,095,"Michigan","Luce County",2,16,59,31,28
050,26,095,"Michigan","Luce County",2,17,58,30,28
050,26,095,"Michigan","Luce County",2,18,63,37,26
050,26,095,"Michigan","Luce County",2,19,60,40,20
050,26,095,"Michigan","Luce County",2,20,62,46,16
050,26,095,"Michigan","Luce County",2,21,57,42,15
050,26,095,"Michigan","Luce County",2,22,75,52,23
050,26,095,"Michigan","Luce County",2,23,85,58,27
050,26,095,"Michigan","Luce County",2,24,87,64,23
050,26,095,"Michigan","Luce County",2,25,64,38,26
050,26,095,"Michigan","Luce County",2,26,85,54,31
050,26,095,"Michigan","Luce County",2,27,89,62,27
050,26,095,"Michigan","Luce County",2,28,92,67,25
050,26,095,"Michigan","Luce County",2,29,82,57,25
050,26,095,"Michigan","Luce County",2,30,103,68,35
050,26,095,"Michigan","Luce County",2,31,96,68,28
050,26,095,"Michigan","Luce County",2,32,82,58,24
050,26,095,"Michigan","Luce County",2,33,83,62,21
050,26,095,"Michigan","Luce County",2,34,83,63,20
050,26,095,"Michigan","Luce County",2,35,81,57,24
050,26,095,"Michigan","Luce County",2,36,79,50,29
050,26,095,"Michigan","Luce County",2,37,99,68,31
050,26,095,"Michigan","Luce County",2,38,96,68,28
050,26,095,"Michigan","Luce County",2,39,90,65,25
050,26,095,"Michigan","Luce County",2,40,97,72,25
050,26,095,"Michigan","Luce County",2,41,79,54,25
050,26,095,"Michigan","Luce County",2,42,68,47,21
050,26,095,"Michigan","Luce County",2,43,74,50,24
050,26,095,"Michigan","Luce County",2,44,81,51,30
050,26,095,"Michigan","Luce County",2,45,85,55,30
050,26,095,"Michigan","Luce County",2,46,76,49,27
050,26,095,"Michigan","Luce County",2,47,91,63,28
050,26,095,"Michigan","Luce County",2,48,87,55,32
050,26,095,"Michigan","Luce County",2,49,86,55,31
050,26,095,"Michigan","Luce County",2,50,91,59,32
050,26,095,"Michigan","Luce County",2,51,82,54,28
050,26,095,"Michigan","Luce County",2,52,79,51,28
050,26,095,"Michigan","Luce County",2,53,83,51,32
050,26,095,"Michigan","Luce County",2,54,80,46,34
050,26,095,"Michigan","Luce County",2,55,93,53,40
050,26,095,"Michigan","Luce County",2,56,84,48,36
050,26,095,"Michigan","Luce County",2,57,86,48,38
050,26,095,"Michigan","Luce County",2,58,99,57,42
050,26,095,"Michigan","Luce County",2,59,99,54,45
050,26,095,"Michigan","Luce County",2,60,91,47,44
050,26,095,"Michigan","Luce County",2,61,93,50,43
050,26,095,"Michigan","Luce County",2,62,101,58,43
050,26,095,"Michigan","Luce County",2,63,106,58,48
050,26,095,"Michigan","Luce County",2,64,108,57,51
050,26,095,"Michigan","Luce County",2,65,100,54,46
050,26,095,"Michigan","Luce County",2,66,90,46,44
050,26,095,"Michigan","Luce County",2,67,80,44,36
050,26,095,"Michigan","Luce County",2,68,78,45,33
050,26,095,"Michigan","Luce County",2,69,82,41,41
050,26,095,"Michigan","Luce County",2,70,74,36,38
050,26,095,"Michigan","Luce County",2,71,79,40,39
050,26,095,"Michigan","Luce County",2,72,75,40,35
050,26,095,"Michigan","Luce County",2,73,74,40,34
050,26,095,"Michigan","Luce County",2,74,45,24,21
050,26,095,"Michigan","Luce County",2,75,47,26,21
050,26,095,"Michigan","Luce County",2,76,42,22,20
050,26,095,"Michigan","Luce County",2,77,62,29,33
050,26,095,"Michigan","Luce County",2,78,51,21,30
050,26,095,"Michigan","Luce County",2,79,42,19,23
050,26,095,"Michigan","Luce County",2,80,42,17,25
050,26,095,"Michigan","Luce County",2,81,40,14,26
050,26,095,"Michigan","Luce County",2,82,39,18,21
050,26,095,"Michigan","Luce County",2,83,38,20,18
050,26,095,"Michigan","Luce County",2,84,38,22,16
050,26,095,"Michigan","Luce County",2,85,151,61,90
050,26,095,"Michigan","Luce County",3,0,53,29,24
050,26,095,"Michigan","Luce County",3,1,51,26,25
050,26,095,"Michigan","Luce County",3,2,62,32,30
050,26,095,"Michigan","Luce County",3,3,60,34,26
050,26,095,"Michigan","Luce County",3,4,54,30,24
050,26,095,"Michigan","Luce County",3,5,45,20,25
050,26,095,"Michigan","Luce County",3,6,57,25,32
050,26,095,"Michigan","Luce County",3,7,52,25,27
050,26,095,"Michigan","Luce County",3,8,49,22,27
050,26,095,"Michigan","Luce County",3,9,49,27,22
050,26,095,"Michigan","Luce County",3,10,57,30,27
050,26,095,"Michigan","Luce County",3,11,67,35,32
050,26,095,"Michigan","Luce County",3,12,64,35,29
050,26,095,"Michigan","Luce County",3,13,72,40,32
050,26,095,"Michigan","Luce County",3,14,65,36,29
050,26,095,"Michigan","Luce County",3,15,66,35,31
050,26,095,"Michigan","Luce County",3,16,61,35,26
050,26,095,"Michigan","Luce County",3,17,57,31,26
050,26,095,"Michigan","Luce County",3,18,55,30,25
050,26,095,"Michigan","Luce County",3,19,46,26,20
050,26,095,"Michigan","Luce County",3,20,62,43,19
050,26,095,"Michigan","Luce County",3,21,62,45,17
050,26,095,"Michigan","Luce County",3,22,58,42,16
050,26,095,"Michigan","Luce County",3,23,64,39,25
050,26,095,"Michigan","Luce County",3,24,78,49,29
050,26,095,"Michigan","Luce County",3,25,62,35,27
050,26,095,"Michigan","Luce County",3,26,68,41,27
050,26,095,"Michigan","Luce County",3,27,67,37,30
050,26,095,"Michigan","Luce County",3,28,78,52,26
050,26,095,"Michigan","Luce County",3,29,71,46,25
050,26,095,"Michigan","Luce County",3,30,79,52,27
050,26,095,"Michigan","Luce County",3,31,90,56,34
050,26,095,"Michigan","Luce County",3,32,79,52,27
050,26,095,"Michigan","Luce County",3,33,69,44,25
050,26,095,"Michigan","Luce County",3,34,65,48,17
050,26,095,"Michigan","Luce County",3,35,62,46,16
050,26,095,"Michigan","Luce County",3,36,62,36,26
050,26,095,"Michigan","Luce County",3,37,79,53,26
050,26,095,"Michigan","Luce County",3,38,76,45,31
050,26,095,"Michigan","Luce County",3,39,86,58,28
050,26,095,"Michigan","Luce County",3,40,93,66,27
050,26,095,"Michigan","Luce County",3,41,65,42,23
050,26,095,"Michigan","Luce County",3,42,71,42,29
050,26,095,"Michigan","Luce County",3,43,60,39,21
050,26,095,"Michigan","Luce County",3,44,63,38,25
050,26,095,"Michigan","Luce County",3,45,73,44,29
050,26,095,"Michigan","Luce County",3,46,74,46,28
050,26,095,"Michigan","Luce County",3,47,75,47,28
050,26,095,"Michigan","Luce County",3,48,74,48,26
050,26,095,"Michigan","Luce County",3,49,76,44,32
050,26,095,"Michigan","Luce County",3,50,79,47,32
050,26,095,"Michigan","Luce County",3,51,75,43,32
050,26,095,"Michigan","Luce County",3,52,71,48,23
050,26,095,"Michigan","Luce County",3,53,69,40,29
050,26,095,"Michigan","Luce County",3,54,70,41,29
050,26,095,"Michigan","Luce County",3,55,78,44,34
050,26,095,"Michigan","Luce County",3,56,86,46,40
050,26,095,"Michigan","Luce County",3,57,77,44,33
050,26,095,"Michigan","Luce County",3,58,84,44,40
050,26,095,"Michigan","Luce County",3,59,95,51,44
050,26,095,"Michigan","Luce County",3,60,87,45,42
050,26,095,"Michigan","Luce County",3,61,87,42,45
050,26,095,"Michigan","Luce County",3,62,93,50,43
050,26,095,"Michigan","Luce County",3,63,100,56,44
050,26,095,"Michigan","Luce County",3,64,108,59,49
050,26,095,"Michigan","Luce County",3,65,101,52,49
050,26,095,"Michigan","Luce County",3,66,108,58,50
050,26,095,"Michigan","Luce County",3,67,92,47,45
050,26,095,"Michigan","Luce County",3,68,79,40,39
050,26,095,"Michigan","Luce County",3,69,74,45,29
050,26,095,"Michigan","Luce County",3,70,83,41,42
050,26,095,"Michigan","Luce County",3,71,79,40,39
050,26,095,"Michigan","Luce County",3,72,71,34,37
050,26,095,"Michigan","Luce County",3,73,75,38,37
050,26,095,"Michigan","Luce County",3,74,68,34,34
050,26,095,"Michigan","Luce County",3,75,52,29,23
050,26,095,"Michigan","Luce County",3,76,47,26,21
050,26,095,"Michigan","Luce County",3,77,43,23,20
050,26,095,"Michigan","Luce County",3,78,63,30,33
050,26,095,"Michigan","Luce County",3,79,50,21,29
050,26,095,"Michigan","Luce County",3,80,40,19,21
050,26,095,"Michigan","Luce County",3,81,37,14,23
050,26,095,"Michigan","Luce County",3,82,40,13,27
050,26,095,"Michigan","Luce County",3,83,35,19,16
050,26,095,"Michigan","Luce County",3,84,33,16,17
050,26,095,"Michigan","Luce County",3,85,165,66,99
050,26,095,"Michigan","Luce County",4,0,57,32,25
050,26,095,"Michigan","Luce County",4,1,53,32,21
050,26,095,"Michigan","Luce County",4,2,55,30,25
050,26,095,"Michigan","Luce County",4,3,60,30,30
050,26,095,"Michigan","Luce County",4,4,62,35,27
050,26,095,"Michigan","Luce County",4,5,57,32,25
050,26,095,"Michigan","Luce County",4,6,46,21,25
050,26,095,"Michigan","Luce County",4,7,60,28,32
050,26,095,"Michigan","Luce County",4,8,52,26,26
050,26,095,"Michigan","Luce County",4,9,49,20,29
050,26,095,"Michigan","Luce County",4,10,51,29,22
050,26,095,"Michigan","Luce County",4,11,57,29,28
050,26,095,"Michigan","Luce County",4,12,67,37,30
050,26,095,"Michigan","Luce County",4,13,67,37,30
050,26,095,"Michigan","Luce County",4,14,68,38,30
050,26,095,"Michigan","Luce County",4,15,62,32,30
050,26,095,"Michigan","Luce County",4,16,69,37,32
050,26,095,"Michigan","Luce County",4,17,61,36,25
050,26,095,"Michigan","Luce County",4,18,56,35,21
050,26,095,"Michigan","Luce County",4,19,49,29,20
050,26,095,"Michigan","Luce County",4,20,54,34,20
050,26,095,"Michigan","Luce County",4,21,70,50,20
050,26,095,"Michigan","Luce County",4,22,83,62,21
050,26,095,"Michigan","Luce County",4,23,66,49,17
050,26,095,"Michigan","Luce County",4,24,82,56,26
050,26,095,"Michigan","Luce County",4,25,63,35,28
050,26,095,"Michigan","Luce County",4,26,76,50,26
050,26,095,"Michigan","Luce County",4,27,76,55,21
050,26,095,"Michigan","Luce County",4,28,80,50,30
050,26,095,"Michigan","Luce County",4,29,80,52,28
050,26,095,"Michigan","Luce County",4,30,83,60,23
050,26,095,"Michigan","Luce County",4,31,91,68,23
050,26,095,"Michigan","Luce County",4,32,98,64,34
050,26,095,"Michigan","Luce County",4,33,94,65,29
050,26,095,"Michigan","Luce County",4,34,85,61,24
050,26,095,"Michigan","Luce County",4,35,73,57,16
050,26,095,"Michigan","Luce County",4,36,66,48,18
050,26,095,"Michigan","Luce County",4,37,80,53,27
050,26,095,"Michigan","Luce County",4,38,84,58,26
050,26,095,"Michigan","Luce County",4,39,81,51,30
050,26,095,"Michigan","Luce County",4,40,110,82,28
050,26,095,"Michigan","Luce County",4,41,94,66,28
050,26,095,"Michigan","Luce County",4,42,63,44,19
050,26,095,"Michigan","Luce County",4,43,80,50,30
050,26,095,"Michigan","Luce County",4,44,64,42,22
050,26,095,"Michigan","Luce County",4,45,67,43,24
050,26,095,"Michigan","Luce County",4,46,69,44,25
050,26,095,"Michigan","Luce County",4,47,87,60,27
050,26,095,"Michigan","Luce County",4,48,79,51,28
050,26,095,"Michigan","Luce County",4,49,82,53,29
050,26,095,"Michigan","Luce County",4,50,87,52,35
050,26,095,"Michigan","Luce County",4,51,78,47,31
050,26,095,"Michigan","Luce County",4,52,77,49,28
050,26,095,"Michigan","Luce County",4,53,77,54,23
050,26,095,"Michigan","Luce County",4,54,69,41,28
050,26,095,"Michigan","Luce County",4,55,80,52,28
050,26,095,"Michigan","Luce County",4,56,81,46,35
050,26,095,"Michigan","Luce County",4,57,84,43,41
050,26,095,"Michigan","Luce County",4,58,81,49,32
050,26,095,"Michigan","Luce County",4,59,84,44,40
050,26,095,"Michigan","Luce County",4,60,88,46,42
050,26,095,"Michigan","Luce County",4,61,80,42,38
050,26,095,"Michigan","Luce County",4,62,83,40,43
050,26,095,"Michigan","Luce County",4,63,95,52,43
050,26,095,"Michigan","Luce County",4,64,105,58,47
050,26,095,"Michigan","Luce County",4,65,104,56,48
050,26,095,"Michigan","Luce County",4,66,101,53,48
050,26,095,"Michigan","Luce County",4,67,108,59,49
050,26,095,"Michigan","Luce County",4,68,95,51,44
050,26,095,"Michigan","Luce County",4,69,81,40,41
050,26,095,"Michigan","Luce County",4,70,78,48,30
050,26,095,"Michigan","Luce County",4,71,86,44,42
050,26,095,"Michigan","Luce County",4,72,79,40,39
050,26,095,"Michigan","Luce County",4,73,73,33,40
050,26,095,"Michigan","Luce County",4,74,71,34,37
050,26,095,"Michigan","Luce County",4,75,64,32,32
050,26,095,"Michigan","Luce County",4,76,52,30,22
050,26,095,"Michigan","Luce County",4,77,49,27,22
050,26,095,"Michigan","Luce County",4,78,38,21,17
050,26,095,"Michigan","Luce County",4,79,64,32,32
050,26,095,"Michigan","Luce County",4,80,46,16,30
050,26,095,"Michigan","Luce County",4,81,34,15,19
050,26,095,"Michigan","Luce County",4,82,37,14,23
050,26,095,"Michigan","Luce County",4,83,39,14,25
050,26,095,"Michigan","Luce County",4,84,32,16,16
050,26,095,"Michigan","Luce County",4,85,176,68,108
050,26,095,"Michigan","Luce County",5,0,57,32,25
050,26,095,"Michigan","Luce County",5,1,52,33,19
050,26,095,"Michigan","Luce County",5,2,52,32,20
050,26,095,"Michigan","Luce County",5,3,53,29,24
050,26,095,"Michigan","Luce County",5,4,57,26,31
050,26,095,"Michigan","Luce County",5,5,62,34,28
050,26,095,"Michigan","Luce County",5,6,54,32,22
050,26,095,"Michigan","Luce County",5,7,47,22,25
050,26,095,"Michigan","Luce County",5,8,59,28,31
050,26,095,"Michigan","Luce County",5,9,54,26,28
050,26,095,"Michigan","Luce County",5,10,45,19,26
050,26,095,"Michigan","Luce County",5,11,52,29,23
050,26,095,"Michigan","Luce County",5,12,58,30,28
050,26,095,"Michigan","Luce County",5,13,68,39,29
050,26,095,"Michigan","Luce County",5,14,69,39,30
050,26,095,"Michigan","Luce County",5,15,67,39,28
050,26,095,"Michigan","Luce County",5,16,64,34,30
050,26,095,"Michigan","Luce County",5,17,69,38,31
050,26,095,"Michigan","Luce County",5,18,58,36,22
050,26,095,"Michigan","Luce County",5,19,46,30,16
050,26,095,"Michigan","Luce County",5,20,58,38,20
050,26,095,"Michigan","Luce County",5,21,62,43,19
050,26,095,"Michigan","Luce County",5,22,84,65,19
050,26,095,"Michigan","Luce County",5,23,74,60,14
050,26,095,"Michigan","Luce County",5,24,87,68,19
050,26,095,"Michigan","Luce County",5,25,66,41,25
050,26,095,"Michigan","Luce County",5,26,89,59,30
050,26,095,"Michigan","Luce County",5,27,82,61,21
050,26,095,"Michigan","Luce County",5,28,84,63,21
050,26,095,"Michigan","Luce County",5,29,81,52,29
050,26,095,"Michigan","Luce County",5,30,95,67,28
050,26,095,"Michigan","Luce County",5,31,92,69,23
050,26,095,"Michigan","Luce County",5,32,92,73,19
050,26,095,"Michigan","Luce County",5,33,105,73,32
050,26,095,"Michigan","Luce County",5,34,103,76,27
050,26,095,"Michigan","Luce County",5,35,93,69,24
050,26,095,"Michigan","Luce County",5,36,76,59,17
050,26,095,"Michigan","Luce County",5,37,83,65,18
050,26,095,"Michigan","Luce County",5,38,84,55,29
050,26,095,"Michigan","Luce County",5,39,88,60,28
050,26,095,"Michigan","Luce County",5,40,101,69,32
050,26,095,"Michigan","Luce County",5,41,104,75,29
050,26,095,"Michigan","Luce County",5,42,91,63,28
050,26,095,"Michigan","Luce County",5,43,74,54,20
050,26,095,"Michigan","Luce County",5,44,84,52,32
050,26,095,"Michigan","Luce County",5,45,70,47,23
050,26,095,"Michigan","Luce County",5,46,71,46,25
050,26,095,"Michigan","Luce County",5,47,85,62,23
050,26,095,"Michigan","Luce County",5,48,83,60,23
050,26,095,"Michigan","Luce County",5,49,79,52,27
050,26,095,"Michigan","Luce County",5,50,84,59,25
050,26,095,"Michigan","Luce County",5,51,86,51,35
050,26,095,"Michigan","Luce County",5,52,80,50,30
050,26,095,"Michigan","Luce County",5,53,86,56,30
050,26,095,"Michigan","Luce County",5,54,71,51,20
050,26,095,"Michigan","Luce County",5,55,76,49,27
050,26,095,"Michigan","Luce County",5,56,69,42,27
050,26,095,"Michigan","Luce County",5,57,76,43,33
050,26,095,"Michigan","Luce County",5,58,87,48,39
050,26,095,"Michigan","Luce County",5,59,83,49,34
050,26,095,"Michigan","Luce County",5,60,80,41,39
050,26,095,"Michigan","Luce County",5,61,87,45,42
050,26,095,"Michigan","Luce County",5,62,78,42,36
050,26,095,"Michigan","Luce County",5,63,86,45,41
050,26,095,"Michigan","Luce County",5,64,95,51,44
050,26,095,"Michigan","Luce County",5,65,102,56,46
050,26,095,"Michigan","Luce County",5,66,98,51,47
050,26,095,"Michigan","Luce County",5,67,100,51,49
050,26,095,"Michigan","Luce County",5,68,108,59,49
050,26,095,"Michigan","Luce County",5,69,91,49,42
050,26,095,"Michigan","Luce County",5,70,82,41,41
050,26,095,"Michigan","Luce County",5,71,82,53,29
050,26,095,"Michigan","Luce County",5,72,86,43,43
050,26,095,"Michigan","Luce County",5,73,78,36,42
050,26,095,"Michigan","Luce County",5,74,70,29,41
050,26,095,"Michigan","Luce County",5,75,69,35,34
050,26,095,"Michigan","Luce County",5,76,60,31,29
050,26,095,"Michigan","Luce County",5,77,53,31,22
050,26,095,"Michigan","Luce County",5,78,44,25,19
050,26,095,"Michigan","Luce County",5,79,38,22,16
050,26,095,"Michigan","Luce County",5,80,56,28,28
050,26,095,"Michigan","Luce County",5,81,40,13,27
050,26,095,"Michigan","Luce County",5,82,34,15,19
050,26,095,"Michigan","Luce County",5,83,34,15,19
050,26,095,"Michigan","Luce County",5,84,35,11,24
050,26,095,"Michigan","Luce County",5,85,188,71,117
050,26,097,"Michigan","Mackinac County",1,0,94,48,46
050,26,097,"Michigan","Mackinac County",1,1,96,51,45
050,26,097,"Michigan","Mackinac County",1,2,98,46,52
050,26,097,"Michigan","Mackinac County",1,3,101,46,55
050,26,097,"Michigan","Mackinac County",1,4,80,42,38
050,26,097,"Michigan","Mackinac County",1,5,82,34,48
050,26,097,"Michigan","Mackinac County",1,6,84,38,46
050,26,097,"Michigan","Mackinac County",1,7,74,42,32
050,26,097,"Michigan","Mackinac County",1,8,82,38,44
050,26,097,"Michigan","Mackinac County",1,9,86,45,41
050,26,097,"Michigan","Mackinac County",1,10,94,59,35
050,26,097,"Michigan","Mackinac County",1,11,82,40,42
050,26,097,"Michigan","Mackinac County",1,12,96,51,45
050,26,097,"Michigan","Mackinac County",1,13,98,54,44
050,26,097,"Michigan","Mackinac County",1,14,107,58,49
050,26,097,"Michigan","Mackinac County",1,15,120,67,53
050,26,097,"Michigan","Mackinac County",1,16,118,64,54
050,26,097,"Michigan","Mackinac County",1,17,126,66,60
050,26,097,"Michigan","Mackinac County",1,18,100,53,47
050,26,097,"Michigan","Mackinac County",1,19,84,44,40
050,26,097,"Michigan","Mackinac County",1,20,90,56,34
050,26,097,"Michigan","Mackinac County",1,21,104,61,43
050,26,097,"Michigan","Mackinac County",1,22,105,55,50
050,26,097,"Michigan","Mackinac County",1,23,87,44,43
050,26,097,"Michigan","Mackinac County",1,24,97,58,39
050,26,097,"Michigan","Mackinac County",1,25,111,58,53
050,26,097,"Michigan","Mackinac County",1,26,111,56,55
050,26,097,"Michigan","Mackinac County",1,27,92,42,50
050,26,097,"Michigan","Mackinac County",1,28,123,70,53
050,26,097,"Michigan","Mackinac County",1,29,109,62,47
050,26,097,"Michigan","Mackinac County",1,30,103,50,53
050,26,097,"Michigan","Mackinac County",1,31,104,51,53
050,26,097,"Michigan","Mackinac County",1,32,91,47,44
050,26,097,"Michigan","Mackinac County",1,33,101,53,48
050,26,097,"Michigan","Mackinac County",1,34,97,57,40
050,26,097,"Michigan","Mackinac County",1,35,98,54,44
050,26,097,"Michigan","Mackinac County",1,36,92,57,35
050,26,097,"Michigan","Mackinac County",1,37,91,46,45
050,26,097,"Michigan","Mackinac County",1,38,92,43,49
050,26,097,"Michigan","Mackinac County",1,39,106,53,53
050,26,097,"Michigan","Mackinac County",1,40,112,57,55
050,26,097,"Michigan","Mackinac County",1,41,85,47,38
050,26,097,"Michigan","Mackinac County",1,42,111,57,54
050,26,097,"Michigan","Mackinac County",1,43,114,54,60
050,26,097,"Michigan","Mackinac County",1,44,111,57,54
050,26,097,"Michigan","Mackinac County",1,45,113,56,57
050,26,097,"Michigan","Mackinac County",1,46,107,54,53
050,26,097,"Michigan","Mackinac County",1,47,132,65,67
050,26,097,"Michigan","Mackinac County",1,48,135,68,67
050,26,097,"Michigan","Mackinac County",1,49,153,80,73
050,26,097,"Michigan","Mackinac County",1,50,152,78,74
050,26,097,"Michigan","Mackinac County",1,51,132,67,65
050,26,097,"Michigan","Mackinac County",1,52,142,79,63
050,26,097,"Michigan","Mackinac County",1,53,140,76,64
050,26,097,"Michigan","Mackinac County",1,54,149,85,64
050,26,097,"Michigan","Mackinac County",1,55,143,78,65
050,26,097,"Michigan","Mackinac County",1,56,171,93,78
050,26,097,"Michigan","Mackinac County",1,57,182,90,92
050,26,097,"Michigan","Mackinac County",1,58,192,98,94
050,26,097,"Michigan","Mackinac County",1,59,213,109,104
050,26,097,"Michigan","Mackinac County",1,60,194,93,101
050,26,097,"Michigan","Mackinac County",1,61,193,99,94
050,26,097,"Michigan","Mackinac County",1,62,192,95,97
050,26,097,"Michigan","Mackinac County",1,63,203,108,95
050,26,097,"Michigan","Mackinac County",1,64,204,96,108
050,26,097,"Michigan","Mackinac County",1,65,230,105,125
050,26,097,"Michigan","Mackinac County",1,66,226,112,114
050,26,097,"Michigan","Mackinac County",1,67,216,103,113
050,26,097,"Michigan","Mackinac County",1,68,207,109,98
050,26,097,"Michigan","Mackinac County",1,69,194,92,102
050,26,097,"Michigan","Mackinac County",1,70,184,92,92
050,26,097,"Michigan","Mackinac County",1,71,192,108,84
050,26,097,"Michigan","Mackinac County",1,72,184,93,91
050,26,097,"Michigan","Mackinac County",1,73,160,83,77
050,26,097,"Michigan","Mackinac County",1,74,105,50,55
050,26,097,"Michigan","Mackinac County",1,75,106,58,48
050,26,097,"Michigan","Mackinac County",1,76,129,63,66
050,26,097,"Michigan","Mackinac County",1,77,126,64,62
050,26,097,"Michigan","Mackinac County",1,78,109,62,47
050,26,097,"Michigan","Mackinac County",1,79,96,55,41
050,26,097,"Michigan","Mackinac County",1,80,97,47,50
050,26,097,"Michigan","Mackinac County",1,81,91,36,55
050,26,097,"Michigan","Mackinac County",1,82,72,39,33
050,26,097,"Michigan","Mackinac County",1,83,58,29,29
050,26,097,"Michigan","Mackinac County",1,84,54,34,20
050,26,097,"Michigan","Mackinac County",1,85,313,117,196
050,26,097,"Michigan","Mackinac County",2,0,86,43,43
050,26,097,"Michigan","Mackinac County",2,1,96,51,45
050,26,097,"Michigan","Mackinac County",2,2,98,47,51
050,26,097,"Michigan","Mackinac County",2,3,101,47,54
050,26,097,"Michigan","Mackinac County",2,4,84,43,41
050,26,097,"Michigan","Mackinac County",2,5,83,37,46
050,26,097,"Michigan","Mackinac County",2,6,81,37,44
050,26,097,"Michigan","Mackinac County",2,7,76,40,36
050,26,097,"Michigan","Mackinac County",2,8,80,39,41
050,26,097,"Michigan","Mackinac County",2,9,85,44,41
050,26,097,"Michigan","Mackinac County",2,10,94,56,38
050,26,097,"Michigan","Mackinac County",2,11,87,46,41
050,26,097,"Michigan","Mackinac County",2,12,92,48,44
050,26,097,"Michigan","Mackinac County",2,13,98,53,45
050,26,097,"Michigan","Mackinac County",2,14,105,58,47
050,26,097,"Michigan","Mackinac County",2,15,119,66,53
050,26,097,"Michigan","Mackinac County",2,16,120,66,54
050,26,097,"Michigan","Mackinac County",2,17,124,65,59
050,26,097,"Michigan","Mackinac County",2,18,100,54,46
050,26,097,"Michigan","Mackinac County",2,19,82,43,39
050,26,097,"Michigan","Mackinac County",2,20,92,56,36
050,26,097,"Michigan","Mackinac County",2,21,102,60,42
050,26,097,"Michigan","Mackinac County",2,22,104,55,49
050,26,097,"Michigan","Mackinac County",2,23,91,46,45
050,26,097,"Michigan","Mackinac County",2,24,95,54,41
050,26,097,"Michigan","Mackinac County",2,25,106,57,49
050,26,097,"Michigan","Mackinac County",2,26,106,53,53
050,26,097,"Michigan","Mackinac County",2,27,94,43,51
050,26,097,"Michigan","Mackinac County",2,28,114,62,52
050,26,097,"Michigan","Mackinac County",2,29,111,63,48
050,26,097,"Michigan","Mackinac County",2,30,106,53,53
050,26,097,"Michigan","Mackinac County",2,31,104,51,53
050,26,097,"Michigan","Mackinac County",2,32,94,49,45
050,26,097,"Michigan","Mackinac County",2,33,99,52,47
050,26,097,"Michigan","Mackinac County",2,34,97,56,41
050,26,097,"Michigan","Mackinac County",2,35,96,54,42
050,26,097,"Michigan","Mackinac County",2,36,95,57,38
050,26,097,"Michigan","Mackinac County",2,37,93,49,44
050,26,097,"Michigan","Mackinac County",2,38,94,45,49
050,26,097,"Michigan","Mackinac County",2,39,106,53,53
050,26,097,"Michigan","Mackinac County",2,40,109,56,53
050,26,097,"Michigan","Mackinac County",2,41,93,50,43
050,26,097,"Michigan","Mackinac County",2,42,105,54,51
050,26,097,"Michigan","Mackinac County",2,43,116,56,60
050,26,097,"Michigan","Mackinac County",2,44,110,57,53
050,26,097,"Michigan","Mackinac County",2,45,113,55,58
050,26,097,"Michigan","Mackinac County",2,46,111,55,56
050,26,097,"Michigan","Mackinac County",2,47,124,61,63
050,26,097,"Michigan","Mackinac County",2,48,135,68,67
050,26,097,"Michigan","Mackinac County",2,49,152,78,74
050,26,097,"Michigan","Mackinac County",2,50,153,79,74
050,26,097,"Michigan","Mackinac County",2,51,136,70,66
050,26,097,"Michigan","Mackinac County",2,52,138,76,62
050,26,097,"Michigan","Mackinac County",2,53,140,76,64
050,26,097,"Michigan","Mackinac County",2,54,146,83,63
050,26,097,"Michigan","Mackinac County",2,55,146,81,65
050,26,097,"Michigan","Mackinac County",2,56,166,90,76
050,26,097,"Michigan","Mackinac County",2,57,180,91,89
050,26,097,"Michigan","Mackinac County",2,58,191,96,95
050,26,097,"Michigan","Mackinac County",2,59,210,106,104
050,26,097,"Michigan","Mackinac County",2,60,199,95,104
050,26,097,"Michigan","Mackinac County",2,61,194,97,97
050,26,097,"Michigan","Mackinac County",2,62,194,96,98
050,26,097,"Michigan","Mackinac County",2,63,206,109,97
050,26,097,"Michigan","Mackinac County",2,64,203,98,105
050,26,097,"Michigan","Mackinac County",2,65,225,103,122
050,26,097,"Michigan","Mackinac County",2,66,228,111,117
050,26,097,"Michigan","Mackinac County",2,67,217,105,112
050,26,097,"Michigan","Mackinac County",2,68,209,108,101
050,26,097,"Michigan","Mackinac County",2,69,198,97,101
050,26,097,"Michigan","Mackinac County",2,70,189,94,95
050,26,097,"Michigan","Mackinac County",2,71,187,101,86
050,26,097,"Michigan","Mackinac County",2,72,180,93,87
050,26,097,"Michigan","Mackinac County",2,73,172,89,83
050,26,097,"Michigan","Mackinac County",2,74,109,54,55
050,26,097,"Michigan","Mackinac County",2,75,103,55,48
050,26,097,"Michigan","Mackinac County",2,76,122,61,61
050,26,097,"Michigan","Mackinac County",2,77,130,65,65
050,26,097,"Michigan","Mackinac County",2,78,110,61,49
050,26,097,"Michigan","Mackinac County",2,79,97,56,41
050,26,097,"Michigan","Mackinac County",2,80,96,48,48
050,26,097,"Michigan","Mackinac County",2,81,91,39,52
050,26,097,"Michigan","Mackinac County",2,82,75,38,37
050,26,097,"Michigan","Mackinac County",2,83,59,30,29
050,26,097,"Michigan","Mackinac County",2,84,54,32,22
050,26,097,"Michigan","Mackinac County",2,85,305,113,192
050,26,097,"Michigan","Mackinac County",3,0,77,38,39
050,26,097,"Michigan","Mackinac County",3,1,90,42,48
050,26,097,"Michigan","Mackinac County",3,2,97,49,48
050,26,097,"Michigan","Mackinac County",3,3,97,44,53
050,26,097,"Michigan","Mackinac County",3,4,101,46,55
050,26,097,"Michigan","Mackinac County",3,5,82,41,41
050,26,097,"Michigan","Mackinac County",3,6,84,36,48
050,26,097,"Michigan","Mackinac County",3,7,89,40,49
050,26,097,"Michigan","Mackinac County",3,8,81,43,38
050,26,097,"Michigan","Mackinac County",3,9,74,34,40
050,26,097,"Michigan","Mackinac County",3,10,90,47,43
050,26,097,"Michigan","Mackinac County",3,11,97,57,40
050,26,097,"Michigan","Mackinac County",3,12,79,43,36
050,26,097,"Michigan","Mackinac County",3,13,91,45,46
050,26,097,"Michigan","Mackinac County",3,14,105,59,46
050,26,097,"Michigan","Mackinac County",3,15,108,59,49
050,26,097,"Michigan","Mackinac County",3,16,122,68,54
050,26,097,"Michigan","Mackinac County",3,17,125,68,57
050,26,097,"Michigan","Mackinac County",3,18,106,54,52
050,26,097,"Michigan","Mackinac County",3,19,89,50,39
050,26,097,"Michigan","Mackinac County",3,20,89,48,41
050,26,097,"Michigan","Mackinac County",3,21,88,55,33
050,26,097,"Michigan","Mackinac County",3,22,111,69,42
050,26,097,"Michigan","Mackinac County",3,23,103,53,50
050,26,097,"Michigan","Mackinac County",3,24,99,54,45
050,26,097,"Michigan","Mackinac County",3,25,96,50,46
050,26,097,"Michigan","Mackinac County",3,26,100,49,51
050,26,097,"Michigan","Mackinac County",3,27,111,59,52
050,26,097,"Michigan","Mackinac County",3,28,96,54,42
050,26,097,"Michigan","Mackinac County",3,29,117,58,59
050,26,097,"Michigan","Mackinac County",3,30,108,59,49
050,26,097,"Michigan","Mackinac County",3,31,110,59,51
050,26,097,"Michigan","Mackinac County",3,32,111,53,58
050,26,097,"Michigan","Mackinac County",3,33,95,47,48
050,26,097,"Michigan","Mackinac County",3,34,97,53,44
050,26,097,"Michigan","Mackinac County",3,35,101,56,45
050,26,097,"Michigan","Mackinac County",3,36,104,61,43
050,26,097,"Michigan","Mackinac County",3,37,95,54,41
050,26,097,"Michigan","Mackinac County",3,38,94,53,41
050,26,097,"Michigan","Mackinac County",3,39,102,52,50
050,26,097,"Michigan","Mackinac County",3,40,111,60,51
050,26,097,"Michigan","Mackinac County",3,41,106,52,54
050,26,097,"Michigan","Mackinac County",3,42,96,49,47
050,26,097,"Michigan","Mackinac County",3,43,106,52,54
050,26,097,"Michigan","Mackinac County",3,44,124,65,59
050,26,097,"Michigan","Mackinac County",3,45,112,56,56
050,26,097,"Michigan","Mackinac County",3,46,119,57,62
050,26,097,"Michigan","Mackinac County",3,47,114,52,62
050,26,097,"Michigan","Mackinac County",3,48,139,68,71
050,26,097,"Michigan","Mackinac County",3,49,144,75,69
050,26,097,"Michigan","Mackinac County",3,50,161,81,80
050,26,097,"Michigan","Mackinac County",3,51,154,83,71
050,26,097,"Michigan","Mackinac County",3,52,132,74,58
050,26,097,"Michigan","Mackinac County",3,53,141,80,61
050,26,097,"Michigan","Mackinac County",3,54,147,83,64
050,26,097,"Michigan","Mackinac County",3,55,149,81,68
050,26,097,"Michigan","Mackinac County",3,56,148,79,69
050,26,097,"Michigan","Mackinac County",3,57,172,88,84
050,26,097,"Michigan","Mackinac County",3,58,196,100,96
050,26,097,"Michigan","Mackinac County",3,59,199,100,99
050,26,097,"Michigan","Mackinac County",3,60,219,112,107
050,26,097,"Michigan","Mackinac County",3,61,193,93,100
050,26,097,"Michigan","Mackinac County",3,62,199,99,100
050,26,097,"Michigan","Mackinac County",3,63,201,102,99
050,26,097,"Michigan","Mackinac County",3,64,224,113,111
050,26,097,"Michigan","Mackinac County",3,65,204,100,104
050,26,097,"Michigan","Mackinac County",3,66,223,100,123
050,26,097,"Michigan","Mackinac County",3,67,227,110,117
050,26,097,"Michigan","Mackinac County",3,68,215,105,110
050,26,097,"Michigan","Mackinac County",3,69,202,106,96
050,26,097,"Michigan","Mackinac County",3,70,190,91,99
050,26,097,"Michigan","Mackinac County",3,71,188,93,95
050,26,097,"Michigan","Mackinac County",3,72,185,99,86
050,26,097,"Michigan","Mackinac County",3,73,163,85,78
050,26,097,"Michigan","Mackinac County",3,74,167,85,82
050,26,097,"Michigan","Mackinac County",3,75,112,58,54
050,26,097,"Michigan","Mackinac County",3,76,98,51,47
050,26,097,"Michigan","Mackinac County",3,77,109,53,56
050,26,097,"Michigan","Mackinac County",3,78,117,59,58
050,26,097,"Michigan","Mackinac County",3,79,106,61,45
050,26,097,"Michigan","Mackinac County",3,80,91,52,39
050,26,097,"Michigan","Mackinac County",3,81,88,45,43
050,26,097,"Michigan","Mackinac County",3,82,80,33,47
050,26,097,"Michigan","Mackinac County",3,83,69,34,35
050,26,097,"Michigan","Mackinac County",3,84,60,31,29
050,26,097,"Michigan","Mackinac County",3,85,296,119,177
050,26,097,"Michigan","Mackinac County",4,0,83,39,44
050,26,097,"Michigan","Mackinac County",4,1,68,31,37
050,26,097,"Michigan","Mackinac County",4,2,95,48,47
050,26,097,"Michigan","Mackinac County",4,3,102,57,45
050,26,097,"Michigan","Mackinac County",4,4,100,51,49
050,26,097,"Michigan","Mackinac County",4,5,106,49,57
050,26,097,"Michigan","Mackinac County",4,6,80,36,44
050,26,097,"Michigan","Mackinac County",4,7,86,38,48
050,26,097,"Michigan","Mackinac County",4,8,91,38,53
050,26,097,"Michigan","Mackinac County",4,9,88,48,40
050,26,097,"Michigan","Mackinac County",4,10,77,35,42
050,26,097,"Michigan","Mackinac County",4,11,85,44,41
050,26,097,"Michigan","Mackinac County",4,12,99,56,43
050,26,097,"Michigan","Mackinac County",4,13,81,42,39
050,26,097,"Michigan","Mackinac County",4,14,94,49,45
050,26,097,"Michigan","Mackinac County",4,15,104,55,49
050,26,097,"Michigan","Mackinac County",4,16,113,59,54
050,26,097,"Michigan","Mackinac County",4,17,124,68,56
050,26,097,"Michigan","Mackinac County",4,18,103,57,46
050,26,097,"Michigan","Mackinac County",4,19,83,45,38
050,26,097,"Michigan","Mackinac County",4,20,91,51,40
050,26,097,"Michigan","Mackinac County",4,21,91,48,43
050,26,097,"Michigan","Mackinac County",4,22,96,52,44
050,26,097,"Michigan","Mackinac County",4,23,103,60,43
050,26,097,"Michigan","Mackinac County",4,24,102,49,53
050,26,097,"Michigan","Mackinac County",4,25,92,52,40
050,26,097,"Michigan","Mackinac County",4,26,95,47,48
050,26,097,"Michigan","Mackinac County",4,27,98,43,55
050,26,097,"Michigan","Mackinac County",4,28,125,61,64
050,26,097,"Michigan","Mackinac County",4,29,100,54,46
050,26,097,"Michigan","Mackinac County",4,30,123,69,54
050,26,097,"Michigan","Mackinac County",4,31,114,62,52
050,26,097,"Michigan","Mackinac County",4,32,114,62,52
050,26,097,"Michigan","Mackinac County",4,33,113,58,55
050,26,097,"Michigan","Mackinac County",4,34,98,48,50
050,26,097,"Michigan","Mackinac County",4,35,105,57,48
050,26,097,"Michigan","Mackinac County",4,36,102,59,43
050,26,097,"Michigan","Mackinac County",4,37,112,67,45
050,26,097,"Michigan","Mackinac County",4,38,99,56,43
050,26,097,"Michigan","Mackinac County",4,39,97,53,44
050,26,097,"Michigan","Mackinac County",4,40,106,53,53
050,26,097,"Michigan","Mackinac County",4,41,116,59,57
050,26,097,"Michigan","Mackinac County",4,42,109,47,62
050,26,097,"Michigan","Mackinac County",4,43,110,51,59
050,26,097,"Michigan","Mackinac County",4,44,106,55,51
050,26,097,"Michigan","Mackinac County",4,45,126,63,63
050,26,097,"Michigan","Mackinac County",4,46,120,65,55
050,26,097,"Michigan","Mackinac County",4,47,115,52,63
050,26,097,"Michigan","Mackinac County",4,48,114,49,65
050,26,097,"Michigan","Mackinac County",4,49,139,67,72
050,26,097,"Michigan","Mackinac County",4,50,140,74,66
050,26,097,"Michigan","Mackinac County",4,51,163,86,77
050,26,097,"Michigan","Mackinac County",4,52,156,82,74
050,26,097,"Michigan","Mackinac County",4,53,134,74,60
050,26,097,"Michigan","Mackinac County",4,54,145,81,64
050,26,097,"Michigan","Mackinac County",4,55,145,84,61
050,26,097,"Michigan","Mackinac County",4,56,149,76,73
050,26,097,"Michigan","Mackinac County",4,57,152,79,73
050,26,097,"Michigan","Mackinac County",4,58,172,89,83
050,26,097,"Michigan","Mackinac County",4,59,205,103,102
050,26,097,"Michigan","Mackinac County",4,60,207,109,98
050,26,097,"Michigan","Mackinac County",4,61,222,109,113
050,26,097,"Michigan","Mackinac County",4,62,197,95,102
050,26,097,"Michigan","Mackinac County",4,63,202,102,100
050,26,097,"Michigan","Mackinac County",4,64,207,105,102
050,26,097,"Michigan","Mackinac County",4,65,231,119,112
050,26,097,"Michigan","Mackinac County",4,66,200,94,106
050,26,097,"Michigan","Mackinac County",4,67,228,105,123
050,26,097,"Michigan","Mackinac County",4,68,226,108,118
050,26,097,"Michigan","Mackinac County",4,69,214,106,108
050,26,097,"Michigan","Mackinac County",4,70,194,99,95
050,26,097,"Michigan","Mackinac County",4,71,194,96,98
050,26,097,"Michigan","Mackinac County",4,72,188,93,95
050,26,097,"Michigan","Mackinac County",4,73,175,89,86
050,26,097,"Michigan","Mackinac County",4,74,156,79,77
050,26,097,"Michigan","Mackinac County",4,75,161,81,80
050,26,097,"Michigan","Mackinac County",4,76,99,49,50
050,26,097,"Michigan","Mackinac County",4,77,98,51,47
050,26,097,"Michigan","Mackinac County",4,78,101,48,53
050,26,097,"Michigan","Mackinac County",4,79,107,55,52
050,26,097,"Michigan","Mackinac County",4,80,100,57,43
050,26,097,"Michigan","Mackinac County",4,81,83,48,35
050,26,097,"Michigan","Mackinac County",4,82,80,41,39
050,26,097,"Michigan","Mackinac County",4,83,74,27,47
050,26,097,"Michigan","Mackinac County",4,84,66,34,32
050,26,097,"Michigan","Mackinac County",4,85,298,120,178
050,26,097,"Michigan","Mackinac County",5,0,81,37,44
050,26,097,"Michigan","Mackinac County",5,1,62,23,39
050,26,097,"Michigan","Mackinac County",5,2,76,36,40
050,26,097,"Michigan","Mackinac County",5,3,94,47,47
050,26,097,"Michigan","Mackinac County",5,4,105,61,44
050,26,097,"Michigan","Mackinac County",5,5,95,43,52
050,26,097,"Michigan","Mackinac County",5,6,105,47,58
050,26,097,"Michigan","Mackinac County",5,7,81,32,49
050,26,097,"Michigan","Mackinac County",5,8,89,39,50
050,26,097,"Michigan","Mackinac County",5,9,96,41,55
050,26,097,"Michigan","Mackinac County",5,10,84,44,40
050,26,097,"Michigan","Mackinac County",5,11,74,34,40
050,26,097,"Michigan","Mackinac County",5,12,88,47,41
050,26,097,"Michigan","Mackinac County",5,13,96,58,38
050,26,097,"Michigan","Mackinac County",5,14,81,42,39
050,26,097,"Michigan","Mackinac County",5,15,91,47,44
050,26,097,"Michigan","Mackinac County",5,16,106,57,49
050,26,097,"Michigan","Mackinac County",5,17,114,63,51
050,26,097,"Michigan","Mackinac County",5,18,99,59,40
050,26,097,"Michigan","Mackinac County",5,19,82,46,36
050,26,097,"Michigan","Mackinac County",5,20,96,50,46
050,26,097,"Michigan","Mackinac County",5,21,92,50,42
050,26,097,"Michigan","Mackinac County",5,22,106,60,46
050,26,097,"Michigan","Mackinac County",5,23,100,58,42
050,26,097,"Michigan","Mackinac County",5,24,89,57,32
050,26,097,"Michigan","Mackinac County",5,25,93,43,50
050,26,097,"Michigan","Mackinac County",5,26,82,50,32
050,26,097,"Michigan","Mackinac County",5,27,101,45,56
050,26,097,"Michigan","Mackinac County",5,28,99,39,60
050,26,097,"Michigan","Mackinac County",5,29,134,66,68
050,26,097,"Michigan","Mackinac County",5,30,100,56,44
050,26,097,"Michigan","Mackinac County",5,31,120,72,48
050,26,097,"Michigan","Mackinac County",5,32,109,59,50
050,26,097,"Michigan","Mackinac County",5,33,115,63,52
050,26,097,"Michigan","Mackinac County",5,34,116,61,55
050,26,097,"Michigan","Mackinac County",5,35,100,51,49
050,26,097,"Michigan","Mackinac County",5,36,97,52,45
050,26,097,"Michigan","Mackinac County",5,37,95,54,41
050,26,097,"Michigan","Mackinac County",5,38,115,69,46
050,26,097,"Michigan","Mackinac County",5,39,102,56,46
050,26,097,"Michigan","Mackinac County",5,40,102,58,44
050,26,097,"Michigan","Mackinac County",5,41,109,54,55
050,26,097,"Michigan","Mackinac County",5,42,121,59,62
050,26,097,"Michigan","Mackinac County",5,43,103,45,58
050,26,097,"Michigan","Mackinac County",5,44,117,57,60
050,26,097,"Michigan","Mackinac County",5,45,104,50,54
050,26,097,"Michigan","Mackinac County",5,46,125,60,65
050,26,097,"Michigan","Mackinac County",5,47,120,60,60
050,26,097,"Michigan","Mackinac County",5,48,116,50,66
050,26,097,"Michigan","Mackinac County",5,49,121,50,71
050,26,097,"Michigan","Mackinac County",5,50,135,65,70
050,26,097,"Michigan","Mackinac County",5,51,145,70,75
050,26,097,"Michigan","Mackinac County",5,52,162,84,78
050,26,097,"Michigan","Mackinac County",5,53,153,79,74
050,26,097,"Michigan","Mackinac County",5,54,145,82,63
050,26,097,"Michigan","Mackinac County",5,55,149,81,68
050,26,097,"Michigan","Mackinac County",5,56,145,83,62
050,26,097,"Michigan","Mackinac County",5,57,146,72,74
050,26,097,"Michigan","Mackinac County",5,58,151,79,72
050,26,097,"Michigan","Mackinac County",5,59,176,93,83
050,26,097,"Michigan","Mackinac County",5,60,206,106,100
050,26,097,"Michigan","Mackinac County",5,61,203,109,94
050,26,097,"Michigan","Mackinac County",5,62,216,106,110
050,26,097,"Michigan","Mackinac County",5,63,195,95,100
050,26,097,"Michigan","Mackinac County",5,64,201,105,96
050,26,097,"Michigan","Mackinac County",5,65,201,97,104
050,26,097,"Michigan","Mackinac County",5,66,228,116,112
050,26,097,"Michigan","Mackinac County",5,67,207,98,109
050,26,097,"Michigan","Mackinac County",5,68,223,105,118
050,26,097,"Michigan","Mackinac County",5,69,220,104,116
050,26,097,"Michigan","Mackinac County",5,70,201,99,102
050,26,097,"Michigan","Mackinac County",5,71,196,100,96
050,26,097,"Michigan","Mackinac County",5,72,191,93,98
050,26,097,"Michigan","Mackinac County",5,73,180,87,93
050,26,097,"Michigan","Mackinac County",5,74,177,87,90
050,26,097,"Michigan","Mackinac County",5,75,149,76,73
050,26,097,"Michigan","Mackinac County",5,76,150,72,78
050,26,097,"Michigan","Mackinac County",5,77,92,45,47
050,26,097,"Michigan","Mackinac County",5,78,89,45,44
050,26,097,"Michigan","Mackinac County",5,79,95,46,49
050,26,097,"Michigan","Mackinac County",5,80,104,52,52
050,26,097,"Michigan","Mackinac County",5,81,96,53,43
050,26,097,"Michigan","Mackinac County",5,82,78,46,32
050,26,097,"Michigan","Mackinac County",5,83,74,36,38
050,26,097,"Michigan","Mackinac County",5,84,69,25,44
050,26,097,"Michigan","Mackinac County",5,85,305,126,179
050,26,099,"Michigan","Macomb County",1,0,9116,4684,4432
050,26,099,"Michigan","Macomb County",1,1,9353,4811,4542
050,26,099,"Michigan","Macomb County",1,2,9581,4879,4702
050,26,099,"Michigan","Macomb County",1,3,9809,4988,4821
050,26,099,"Michigan","Macomb County",1,4,9797,5058,4739
050,26,099,"Michigan","Macomb County",1,5,9987,5137,4850
050,26,099,"Michigan","Macomb County",1,6,9931,5088,4843
050,26,099,"Michigan","Macomb County",1,7,9729,5004,4725
050,26,099,"Michigan","Macomb County",1,8,9980,5087,4893
050,26,099,"Michigan","Macomb County",1,9,10096,5142,4954
050,26,099,"Michigan","Macomb County",1,10,10412,5264,5148
050,26,099,"Michigan","Macomb County",1,11,10624,5394,5230
050,26,099,"Michigan","Macomb County",1,12,11048,5691,5357
050,26,099,"Michigan","Macomb County",1,13,11023,5707,5316
050,26,099,"Michigan","Macomb County",1,14,11093,5706,5387
050,26,099,"Michigan","Macomb County",1,15,11233,5845,5388
050,26,099,"Michigan","Macomb County",1,16,11462,5872,5590
050,26,099,"Michigan","Macomb County",1,17,11460,5844,5616
050,26,099,"Michigan","Macomb County",1,18,9793,5186,4607
050,26,099,"Michigan","Macomb County",1,19,8202,4295,3907
050,26,099,"Michigan","Macomb County",1,20,8886,4578,4308
050,26,099,"Michigan","Macomb County",1,21,9417,4760,4657
050,26,099,"Michigan","Macomb County",1,22,10272,5135,5137
050,26,099,"Michigan","Macomb County",1,23,10997,5519,5478
050,26,099,"Michigan","Macomb County",1,24,11576,5808,5768
050,26,099,"Michigan","Macomb County",1,25,11836,5917,5919
050,26,099,"Michigan","Macomb County",1,26,12176,6126,6050
050,26,099,"Michigan","Macomb County",1,27,12405,6236,6169
050,26,099,"Michigan","Macomb County",1,28,12592,6279,6313
050,26,099,"Michigan","Macomb County",1,29,13265,6596,6669
050,26,099,"Michigan","Macomb County",1,30,12821,6472,6349
050,26,099,"Michigan","Macomb County",1,31,11805,5953,5852
050,26,099,"Michigan","Macomb County",1,32,11283,5689,5594
050,26,099,"Michigan","Macomb County",1,33,10845,5435,5410
050,26,099,"Michigan","Macomb County",1,34,11024,5555,5469
050,26,099,"Michigan","Macomb County",1,35,10820,5421,5399
050,26,099,"Michigan","Macomb County",1,36,10499,5293,5206
050,26,099,"Michigan","Macomb County",1,37,10717,5259,5458
050,26,099,"Michigan","Macomb County",1,38,10654,5318,5336
050,26,099,"Michigan","Macomb County",1,39,10755,5357,5398
050,26,099,"Michigan","Macomb County",1,40,10637,5203,5434
050,26,099,"Michigan","Macomb County",1,41,10579,5154,5425
050,26,099,"Michigan","Macomb County",1,42,10580,5242,5338
050,26,099,"Michigan","Macomb County",1,43,10261,5069,5192
050,26,099,"Michigan","Macomb County",1,44,10307,5059,5248
050,26,099,"Michigan","Macomb County",1,45,10580,5215,5365
050,26,099,"Michigan","Macomb County",1,46,10617,5257,5360
050,26,099,"Michigan","Macomb County",1,47,11153,5446,5707
050,26,099,"Michigan","Macomb County",1,48,12182,6008,6174
050,26,099,"Michigan","Macomb County",1,49,13031,6429,6602
050,26,099,"Michigan","Macomb County",1,50,12408,6160,6248
050,26,099,"Michigan","Macomb County",1,51,12100,6002,6098
050,26,099,"Michigan","Macomb County",1,52,12050,5819,6231
050,26,099,"Michigan","Macomb County",1,53,12435,6016,6419
050,26,099,"Michigan","Macomb County",1,54,12762,6307,6455
050,26,099,"Michigan","Macomb County",1,55,13240,6519,6721
050,26,099,"Michigan","Macomb County",1,56,13172,6532,6640
050,26,099,"Michigan","Macomb County",1,57,13159,6536,6623
050,26,099,"Michigan","Macomb County",1,58,13376,6563,6813
050,26,099,"Michigan","Macomb County",1,59,13247,6455,6792
050,26,099,"Michigan","Macomb County",1,60,12933,6376,6557
050,26,099,"Michigan","Macomb County",1,61,12859,6357,6502
050,26,099,"Michigan","Macomb County",1,62,12697,6100,6597
050,26,099,"Michigan","Macomb County",1,63,12087,5769,6318
050,26,099,"Michigan","Macomb County",1,64,11686,5643,6043
050,26,099,"Michigan","Macomb County",1,65,11141,5405,5736
050,26,099,"Michigan","Macomb County",1,66,10518,5078,5440
050,26,099,"Michigan","Macomb County",1,67,10036,4798,5238
050,26,099,"Michigan","Macomb County",1,68,9842,4702,5140
050,26,099,"Michigan","Macomb County",1,69,8982,4207,4775
050,26,099,"Michigan","Macomb County",1,70,8663,3996,4667
050,26,099,"Michigan","Macomb County",1,71,8419,3850,4569
050,26,099,"Michigan","Macomb County",1,72,8425,3816,4609
050,26,099,"Michigan","Macomb County",1,73,8416,3832,4584
050,26,099,"Michigan","Macomb County",1,74,5873,2619,3254
050,26,099,"Michigan","Macomb County",1,75,5764,2635,3129
050,26,099,"Michigan","Macomb County",1,76,5925,2616,3309
050,26,099,"Michigan","Macomb County",1,77,5996,2580,3416
050,26,099,"Michigan","Macomb County",1,78,5075,2161,2914
050,26,099,"Michigan","Macomb County",1,79,4330,1823,2507
050,26,099,"Michigan","Macomb County",1,80,3939,1623,2316
050,26,099,"Michigan","Macomb County",1,81,3892,1623,2269
050,26,099,"Michigan","Macomb County",1,82,3508,1385,2123
050,26,099,"Michigan","Macomb County",1,83,3114,1225,1889
050,26,099,"Michigan","Macomb County",1,84,3021,1177,1844
050,26,099,"Michigan","Macomb County",1,85,17823,5921,11902
050,26,099,"Michigan","Macomb County",2,0,9170,4730,4440
050,26,099,"Michigan","Macomb County",2,1,9288,4775,4513
050,26,099,"Michigan","Macomb County",2,2,9559,4881,4678
050,26,099,"Michigan","Macomb County",2,3,9732,4957,4775
050,26,099,"Michigan","Macomb County",2,4,9828,5056,4772
050,26,099,"Michigan","Macomb County",2,5,9955,5130,4825
050,26,099,"Michigan","Macomb County",2,6,9961,5109,4852
050,26,099,"Michigan","Macomb County",2,7,9764,5006,4758
050,26,099,"Michigan","Macomb County",2,8,9895,5058,4837
050,26,099,"Michigan","Macomb County",2,9,10073,5133,4940
050,26,099,"Michigan","Macomb County",2,10,10340,5232,5108
050,26,099,"Michigan","Macomb County",2,11,10543,5347,5196
050,26,099,"Michigan","Macomb County",2,12,10987,5645,5342
050,26,099,"Michigan","Macomb County",2,13,11037,5713,5324
050,26,099,"Michigan","Macomb County",2,14,11088,5719,5369
050,26,099,"Michigan","Macomb County",2,15,11219,5818,5401
050,26,099,"Michigan","Macomb County",2,16,11430,5883,5547
050,26,099,"Michigan","Macomb County",2,17,11469,5857,5612
050,26,099,"Michigan","Macomb County",2,18,9743,5143,4600
050,26,099,"Michigan","Macomb County",2,19,8214,4303,3911
050,26,099,"Michigan","Macomb County",2,20,8987,4631,4356
050,26,099,"Michigan","Macomb County",2,21,9421,4769,4652
050,26,099,"Michigan","Macomb County",2,22,10228,5105,5123
050,26,099,"Michigan","Macomb County",2,23,10988,5500,5488
050,26,099,"Michigan","Macomb County",2,24,11457,5765,5692
050,26,099,"Michigan","Macomb County",2,25,11797,5906,5891
050,26,099,"Michigan","Macomb County",2,26,12121,6086,6035
050,26,099,"Michigan","Macomb County",2,27,12329,6199,6130
050,26,099,"Michigan","Macomb County",2,28,12568,6280,6288
050,26,099,"Michigan","Macomb County",2,29,13095,6509,6586
050,26,099,"Michigan","Macomb County",2,30,12972,6514,6458
050,26,099,"Michigan","Macomb County",2,31,12024,6072,5952
050,26,099,"Michigan","Macomb County",2,32,11360,5721,5639
050,26,099,"Michigan","Macomb County",2,33,10953,5500,5453
050,26,099,"Michigan","Macomb County",2,34,10978,5528,5450
050,26,099,"Michigan","Macomb County",2,35,10919,5475,5444
050,26,099,"Michigan","Macomb County",2,36,10521,5289,5232
050,26,099,"Michigan","Macomb County",2,37,10675,5275,5400
050,26,099,"Michigan","Macomb County",2,38,10687,5313,5374
050,26,099,"Michigan","Macomb County",2,39,10687,5324,5363
050,26,099,"Michigan","Macomb County",2,40,10718,5261,5457
050,26,099,"Michigan","Macomb County",2,41,10587,5167,5420
050,26,099,"Michigan","Macomb County",2,42,10521,5191,5330
050,26,099,"Michigan","Macomb County",2,43,10398,5140,5258
050,26,099,"Michigan","Macomb County",2,44,10191,5008,5183
050,26,099,"Michigan","Macomb County",2,45,10562,5209,5353
050,26,099,"Michigan","Macomb County",2,46,10558,5219,5339
050,26,099,"Michigan","Macomb County",2,47,10991,5380,5611
050,26,099,"Michigan","Macomb County",2,48,11908,5860,6048
050,26,099,"Michigan","Macomb County",2,49,12862,6344,6518
050,26,099,"Michigan","Macomb County",2,50,12571,6232,6339
050,26,099,"Michigan","Macomb County",2,51,12084,5989,6095
050,26,099,"Michigan","Macomb County",2,52,12004,5829,6175
050,26,099,"Michigan","Macomb County",2,53,12303,5945,6358
050,26,099,"Michigan","Macomb County",2,54,12640,6221,6419
050,26,099,"Michigan","Macomb County",2,55,13090,6446,6644
050,26,099,"Michigan","Macomb County",2,56,13187,6524,6663
050,26,099,"Michigan","Macomb County",2,57,13157,6532,6625
050,26,099,"Michigan","Macomb County",2,58,13270,6523,6747
050,26,099,"Michigan","Macomb County",2,59,13302,6496,6806
050,26,099,"Michigan","Macomb County",2,60,12926,6345,6581
050,26,099,"Michigan","Macomb County",2,61,12793,6313,6480
050,26,099,"Michigan","Macomb County",2,62,12656,6117,6539
050,26,099,"Michigan","Macomb County",2,63,12277,5864,6413
050,26,099,"Michigan","Macomb County",2,64,11673,5609,6064
050,26,099,"Michigan","Macomb County",2,65,11189,5404,5785
050,26,099,"Michigan","Macomb County",2,66,10610,5114,5496
050,26,099,"Michigan","Macomb County",2,67,10079,4811,5268
050,26,099,"Michigan","Macomb County",2,68,9779,4667,5112
050,26,099,"Michigan","Macomb County",2,69,9190,4315,4875
050,26,099,"Michigan","Macomb County",2,70,8630,3992,4638
050,26,099,"Michigan","Macomb County",2,71,8430,3850,4580
050,26,099,"Michigan","Macomb County",2,72,8229,3726,4503
050,26,099,"Michigan","Macomb County",2,73,8729,3959,4770
050,26,099,"Michigan","Macomb County",2,74,6051,2705,3346
050,26,099,"Michigan","Macomb County",2,75,5764,2613,3151
050,26,099,"Michigan","Macomb County",2,76,5749,2552,3197
050,26,099,"Michigan","Macomb County",2,77,6026,2613,3413
050,26,099,"Michigan","Macomb County",2,78,5145,2187,2958
050,26,099,"Michigan","Macomb County",2,79,4427,1866,2561
050,26,099,"Michigan","Macomb County",2,80,3961,1629,2332
050,26,099,"Michigan","Macomb County",2,81,3807,1583,2224
050,26,099,"Michigan","Macomb County",2,82,3540,1416,2124
050,26,099,"Michigan","Macomb County",2,83,3116,1217,1899
050,26,099,"Michigan","Macomb County",2,84,2948,1144,1804
050,26,099,"Michigan","Macomb County",2,85,17548,5831,11717
050,26,099,"Michigan","Macomb County",3,0,8559,4358,4201
050,26,099,"Michigan","Macomb County",3,1,9242,4805,4437
050,26,099,"Michigan","Macomb County",3,2,9361,4793,4568
050,26,099,"Michigan","Macomb County",3,3,9632,4908,4724
050,26,099,"Michigan","Macomb County",3,4,9706,4966,4740
050,26,099,"Michigan","Macomb County",3,5,9932,5096,4836
050,26,099,"Michigan","Macomb County",3,6,9934,5114,4820
050,26,099,"Michigan","Macomb County",3,7,9974,5113,4861
050,26,099,"Michigan","Macomb County",3,8,9760,4998,4762
050,26,099,"Michigan","Macomb County",3,9,9863,5051,4812
050,26,099,"Michigan","Macomb County",3,10,9998,5077,4921
050,26,099,"Michigan","Macomb County",3,11,10263,5215,5048
050,26,099,"Michigan","Macomb County",3,12,10559,5365,5194
050,26,099,"Michigan","Macomb County",3,13,11017,5660,5357
050,26,099,"Michigan","Macomb County",3,14,11080,5711,5369
050,26,099,"Michigan","Macomb County",3,15,11130,5760,5370
050,26,099,"Michigan","Macomb County",3,16,11176,5778,5398
050,26,099,"Michigan","Macomb County",3,17,11447,5922,5525
050,26,099,"Michigan","Macomb County",3,18,9791,5162,4629
050,26,099,"Michigan","Macomb County",3,19,7981,4163,3818
050,26,099,"Michigan","Macomb County",3,20,9008,4650,4358
050,26,099,"Michigan","Macomb County",3,21,9611,4890,4721
050,26,099,"Michigan","Macomb County",3,22,10281,5106,5175
050,26,099,"Michigan","Macomb County",3,23,10869,5429,5440
050,26,099,"Michigan","Macomb County",3,24,11328,5737,5591
050,26,099,"Michigan","Macomb County",3,25,11644,5881,5763
050,26,099,"Michigan","Macomb County",3,26,11966,5990,5976
050,26,099,"Michigan","Macomb County",3,27,12228,6114,6114
050,26,099,"Michigan","Macomb County",3,28,12436,6234,6202
050,26,099,"Michigan","Macomb County",3,29,12599,6308,6291
050,26,099,"Michigan","Macomb County",3,30,13044,6490,6554
050,26,099,"Michigan","Macomb County",3,31,12977,6570,6407
050,26,099,"Michigan","Macomb County",3,32,11971,6033,5938
050,26,099,"Michigan","Macomb County",3,33,11350,5733,5617
050,26,099,"Michigan","Macomb County",3,34,11042,5574,5468
050,26,099,"Michigan","Macomb County",3,35,10886,5449,5437
050,26,099,"Michigan","Macomb County",3,36,10864,5479,5385
050,26,099,"Michigan","Macomb County",3,37,10469,5252,5217
050,26,099,"Michigan","Macomb County",3,38,10610,5238,5372
050,26,099,"Michigan","Macomb County",3,39,10602,5265,5337
050,26,099,"Michigan","Macomb County",3,40,10683,5295,5388
050,26,099,"Michigan","Macomb County",3,41,10748,5268,5480
050,26,099,"Michigan","Macomb County",3,42,10551,5152,5399
050,26,099,"Michigan","Macomb County",3,43,10492,5182,5310
050,26,099,"Michigan","Macomb County",3,44,10335,5106,5229
050,26,099,"Michigan","Macomb County",3,45,10178,5012,5166
050,26,099,"Michigan","Macomb County",3,46,10530,5183,5347
050,26,099,"Michigan","Macomb County",3,47,10493,5170,5323
050,26,099,"Michigan","Macomb County",3,48,10963,5363,5600
050,26,099,"Michigan","Macomb County",3,49,11800,5784,6016
050,26,099,"Michigan","Macomb County",3,50,12815,6335,6480
050,26,099,"Michigan","Macomb County",3,51,12486,6183,6303
050,26,099,"Michigan","Macomb County",3,52,12039,5960,6079
050,26,099,"Michigan","Macomb County",3,53,11841,5714,6127
050,26,099,"Michigan","Macomb County",3,54,12113,5829,6284
050,26,099,"Michigan","Macomb County",3,55,12501,6142,6359
050,26,099,"Michigan","Macomb County",3,56,12895,6359,6536
050,26,099,"Michigan","Macomb County",3,57,13009,6428,6581
050,26,099,"Michigan","Macomb County",3,58,12929,6395,6534
050,26,099,"Michigan","Macomb County",3,59,13060,6420,6640
050,26,099,"Michigan","Macomb County",3,60,13056,6377,6679
050,26,099,"Michigan","Macomb County",3,61,12671,6203,6468
050,26,099,"Michigan","Macomb County",3,62,12519,6127,6392
050,26,099,"Michigan","Macomb County",3,63,12298,5928,6370
050,26,099,"Michigan","Macomb County",3,64,12003,5732,6271
050,26,099,"Michigan","Macomb County",3,65,11357,5431,5926
050,26,099,"Michigan","Macomb County",3,66,10932,5255,5677
050,26,099,"Michigan","Macomb County",3,67,10384,4960,5424
050,26,099,"Michigan","Macomb County",3,68,9816,4660,5156
050,26,099,"Michigan","Macomb County",3,69,9527,4520,5007
050,26,099,"Michigan","Macomb County",3,70,8980,4192,4788
050,26,099,"Michigan","Macomb County",3,71,8456,3901,4555
050,26,099,"Michigan","Macomb County",3,72,8169,3731,4438
050,26,099,"Michigan","Macomb County",3,73,7990,3567,4423
050,26,099,"Michigan","Macomb County",3,74,8424,3793,4631
050,26,099,"Michigan","Macomb County",3,75,5821,2596,3225
050,26,099,"Michigan","Macomb County",3,76,5553,2473,3080
050,26,099,"Michigan","Macomb County",3,77,5475,2430,3045
050,26,099,"Michigan","Macomb County",3,78,5778,2475,3303
050,26,099,"Michigan","Macomb County",3,79,4896,2066,2830
050,26,099,"Michigan","Macomb County",3,80,4211,1755,2456
050,26,099,"Michigan","Macomb County",3,81,3723,1496,2227
050,26,099,"Michigan","Macomb County",3,82,3574,1457,2117
050,26,099,"Michigan","Macomb County",3,83,3248,1279,1969
050,26,099,"Michigan","Macomb County",3,84,2894,1081,1813
050,26,099,"Michigan","Macomb County",3,85,17240,5738,11502
050,26,099,"Michigan","Macomb County",4,0,8686,4438,4248
050,26,099,"Michigan","Macomb County",4,1,8557,4336,4221
050,26,099,"Michigan","Macomb County",4,2,9249,4776,4473
050,26,099,"Michigan","Macomb County",4,3,9410,4836,4574
050,26,099,"Michigan","Macomb County",4,4,9670,4948,4722
050,26,099,"Michigan","Macomb County",4,5,9704,4940,4764
050,26,099,"Michigan","Macomb County",4,6,9911,5094,4817
050,26,099,"Michigan","Macomb County",4,7,9929,5125,4804
050,26,099,"Michigan","Macomb County",4,8,9998,5136,4862
050,26,099,"Michigan","Macomb County",4,9,9823,5039,4784
050,26,099,"Michigan","Macomb County",4,10,9884,5065,4819
050,26,099,"Michigan","Macomb County",4,11,10027,5108,4919
050,26,099,"Michigan","Macomb County",4,12,10344,5269,5075
050,26,099,"Michigan","Macomb County",4,13,10613,5409,5204
050,26,099,"Michigan","Macomb County",4,14,11141,5713,5428
050,26,099,"Michigan","Macomb County",4,15,11134,5714,5420
050,26,099,"Michigan","Macomb County",4,16,11191,5779,5412
050,26,099,"Michigan","Macomb County",4,17,11247,5792,5455
050,26,099,"Michigan","Macomb County",4,18,9691,5196,4495
050,26,099,"Michigan","Macomb County",4,19,7754,4084,3670
050,26,099,"Michigan","Macomb County",4,20,8548,4396,4152
050,26,099,"Michigan","Macomb County",4,21,9562,4873,4689
050,26,099,"Michigan","Macomb County",4,22,10267,5087,5180
050,26,099,"Michigan","Macomb County",4,23,10914,5397,5517
050,26,099,"Michigan","Macomb County",4,24,11240,5661,5579
050,26,099,"Michigan","Macomb County",4,25,11444,5834,5610
050,26,099,"Michigan","Macomb County",4,26,11642,5858,5784
050,26,099,"Michigan","Macomb County",4,27,12014,5990,6024
050,26,099,"Michigan","Macomb County",4,28,12270,6158,6112
050,26,099,"Michigan","Macomb County",4,29,12382,6168,6214
050,26,099,"Michigan","Macomb County",4,30,12509,6240,6269
050,26,099,"Michigan","Macomb County",4,31,12999,6497,6502
050,26,099,"Michigan","Macomb County",4,32,12873,6513,6360
050,26,099,"Michigan","Macomb County",4,33,11837,5901,5936
050,26,099,"Michigan","Macomb County",4,34,11380,5719,5661
050,26,099,"Michigan","Macomb County",4,35,11001,5527,5474
050,26,099,"Michigan","Macomb County",4,36,10891,5437,5454
050,26,099,"Michigan","Macomb County",4,37,10873,5496,5377
050,26,099,"Michigan","Macomb County",4,38,10366,5168,5198
050,26,099,"Michigan","Macomb County",4,39,10598,5234,5364
050,26,099,"Michigan","Macomb County",4,40,10544,5220,5324
050,26,099,"Michigan","Macomb County",4,41,10619,5260,5359
050,26,099,"Michigan","Macomb County",4,42,10763,5284,5479
050,26,099,"Michigan","Macomb County",4,43,10517,5144,5373
050,26,099,"Michigan","Macomb County",4,44,10490,5163,5327
050,26,099,"Michigan","Macomb County",4,45,10325,5111,5214
050,26,099,"Michigan","Macomb County",4,46,10107,4972,5135
050,26,099,"Michigan","Macomb County",4,47,10513,5164,5349
050,26,099,"Michigan","Macomb County",4,48,10461,5191,5270
050,26,099,"Michigan","Macomb County",4,49,10921,5329,5592
050,26,099,"Michigan","Macomb County",4,50,11734,5712,6022
050,26,099,"Michigan","Macomb County",4,51,12767,6316,6451
050,26,099,"Michigan","Macomb County",4,52,12429,6130,6299
050,26,099,"Michigan","Macomb County",4,53,11956,5924,6032
050,26,099,"Michigan","Macomb County",4,54,11777,5659,6118
050,26,099,"Michigan","Macomb County",4,55,11993,5775,6218
050,26,099,"Michigan","Macomb County",4,56,12367,6092,6275
050,26,099,"Michigan","Macomb County",4,57,12728,6254,6474
050,26,099,"Michigan","Macomb County",4,58,12755,6266,6489
050,26,099,"Michigan","Macomb County",4,59,12719,6250,6469
050,26,099,"Michigan","Macomb County",4,60,12767,6268,6499
050,26,099,"Michigan","Macomb County",4,61,12824,6267,6557
050,26,099,"Michigan","Macomb County",4,62,12404,6046,6358
050,26,099,"Michigan","Macomb County",4,63,12236,5992,6244
050,26,099,"Michigan","Macomb County",4,64,12025,5765,6260
050,26,099,"Michigan","Macomb County",4,65,11641,5507,6134
050,26,099,"Michigan","Macomb County",4,66,11078,5267,5811
050,26,099,"Michigan","Macomb County",4,67,10693,5094,5599
050,26,099,"Michigan","Macomb County",4,68,10160,4820,5340
050,26,099,"Michigan","Macomb County",4,69,9504,4492,5012
050,26,099,"Michigan","Macomb County",4,70,9277,4368,4909
050,26,099,"Michigan","Macomb County",4,71,8751,4060,4691
050,26,099,"Michigan","Macomb County",4,72,8198,3760,4438
050,26,099,"Michigan","Macomb County",4,73,7955,3591,4364
050,26,099,"Michigan","Macomb County",4,74,7698,3384,4314
050,26,099,"Michigan","Macomb County",4,75,8081,3602,4479
050,26,099,"Michigan","Macomb County",4,76,5631,2478,3153
050,26,099,"Michigan","Macomb County",4,77,5296,2371,2925
050,26,099,"Michigan","Macomb County",4,78,5246,2301,2945
050,26,099,"Michigan","Macomb County",4,79,5485,2338,3147
050,26,099,"Michigan","Macomb County",4,80,4627,1914,2713
050,26,099,"Michigan","Macomb County",4,81,3981,1649,2332
050,26,099,"Michigan","Macomb County",4,82,3446,1366,2080
050,26,099,"Michigan","Macomb County",4,83,3264,1314,1950
050,26,099,"Michigan","Macomb County",4,84,3040,1160,1880
050,26,099,"Michigan","Macomb County",4,85,16869,5599,11270
050,26,099,"Michigan","Macomb County",5,0,8576,4376,4200
050,26,099,"Michigan","Macomb County",5,1,8771,4453,4318
050,26,099,"Michigan","Macomb County",5,2,8651,4390,4261
050,26,099,"Michigan","Macomb County",5,3,9339,4841,4498
050,26,099,"Michigan","Macomb County",5,4,9430,4831,4599
050,26,099,"Michigan","Macomb County",5,5,9735,4963,4772
050,26,099,"Michigan","Macomb County",5,6,9718,4938,4780
050,26,099,"Michigan","Macomb County",5,7,10019,5131,4888
050,26,099,"Michigan","Macomb County",5,8,10028,5136,4892
050,26,099,"Michigan","Macomb County",5,9,10101,5187,4914
050,26,099,"Michigan","Macomb County",5,10,9874,5061,4813
050,26,099,"Michigan","Macomb County",5,11,9969,5094,4875
050,26,099,"Michigan","Macomb County",5,12,10123,5133,4990
050,26,099,"Michigan","Macomb County",5,13,10450,5308,5142
050,26,099,"Michigan","Macomb County",5,14,10707,5415,5292
050,26,099,"Michigan","Macomb County",5,15,11207,5726,5481
050,26,099,"Michigan","Macomb County",5,16,11168,5721,5447
050,26,099,"Michigan","Macomb County",5,17,11297,5843,5454
050,26,099,"Michigan","Macomb County",5,18,9487,5046,4441
050,26,099,"Michigan","Macomb County",5,19,7871,4196,3675
050,26,099,"Michigan","Macomb County",5,20,8621,4473,4148
050,26,099,"Michigan","Macomb County",5,21,9256,4692,4564
050,26,099,"Michigan","Macomb County",5,22,10262,5134,5128
050,26,099,"Michigan","Macomb County",5,23,11034,5477,5557
050,26,099,"Michigan","Macomb County",5,24,11259,5662,5597
050,26,099,"Michigan","Macomb County",5,25,11401,5776,5625
050,26,099,"Michigan","Macomb County",5,26,11520,5837,5683
050,26,099,"Michigan","Macomb County",5,27,11701,5887,5814
050,26,099,"Michigan","Macomb County",5,28,11960,5944,6016
050,26,099,"Michigan","Macomb County",5,29,12362,6177,6185
050,26,099,"Michigan","Macomb County",5,30,12402,6243,6159
050,26,099,"Michigan","Macomb County",5,31,12584,6247,6337
050,26,099,"Michigan","Macomb County",5,32,12940,6472,6468
050,26,099,"Michigan","Macomb County",5,33,12931,6462,6469
050,26,099,"Michigan","Macomb County",5,34,11877,5941,5936
050,26,099,"Michigan","Macomb County",5,35,11371,5693,5678
050,26,099,"Michigan","Macomb County",5,36,11005,5537,5468
050,26,099,"Michigan","Macomb County",5,37,10889,5438,5451
050,26,099,"Michigan","Macomb County",5,38,10862,5485,5377
050,26,099,"Michigan","Macomb County",5,39,10367,5172,5195
050,26,099,"Michigan","Macomb County",5,40,10547,5181,5366
050,26,099,"Michigan","Macomb County",5,41,10537,5202,5335
050,26,099,"Michigan","Macomb County",5,42,10640,5240,5400
050,26,099,"Michigan","Macomb County",5,43,10744,5267,5477
050,26,099,"Michigan","Macomb County",5,44,10540,5135,5405
050,26,099,"Michigan","Macomb County",5,45,10500,5161,5339
050,26,099,"Michigan","Macomb County",5,46,10344,5132,5212
050,26,099,"Michigan","Macomb County",5,47,10147,5007,5140
050,26,099,"Michigan","Macomb County",5,48,10491,5134,5357
050,26,099,"Michigan","Macomb County",5,49,10357,5092,5265
050,26,099,"Michigan","Macomb County",5,50,10923,5314,5609
050,26,099,"Michigan","Macomb County",5,51,11687,5701,5986
050,26,099,"Michigan","Macomb County",5,52,12739,6312,6427
050,26,099,"Michigan","Macomb County",5,53,12397,6110,6287
050,26,099,"Michigan","Macomb County",5,54,11861,5856,6005
050,26,099,"Michigan","Macomb County",5,55,11706,5607,6099
050,26,099,"Michigan","Macomb County",5,56,11823,5699,6124
050,26,099,"Michigan","Macomb County",5,57,12278,6043,6235
050,26,099,"Michigan","Macomb County",5,58,12594,6174,6420
050,26,099,"Michigan","Macomb County",5,59,12634,6202,6432
050,26,099,"Michigan","Macomb County",5,60,12549,6159,6390
050,26,099,"Michigan","Macomb County",5,61,12613,6168,6445
050,26,099,"Michigan","Macomb County",5,62,12605,6122,6483
050,26,099,"Michigan","Macomb County",5,63,12179,5920,6259
050,26,099,"Michigan","Macomb County",5,64,12049,5889,6160
050,26,099,"Michigan","Macomb County",5,65,11758,5624,6134
050,26,099,"Michigan","Macomb County",5,66,11456,5380,6076
050,26,099,"Michigan","Macomb County",5,67,10831,5105,5726
050,26,099,"Michigan","Macomb County",5,68,10479,4977,5502
050,26,099,"Michigan","Macomb County",5,69,9948,4671,5277
050,26,099,"Michigan","Macomb County",5,70,9341,4378,4963
050,26,099,"Michigan","Macomb County",5,71,9098,4244,4854
050,26,099,"Michigan","Macomb County",5,72,8576,3965,4611
050,26,099,"Michigan","Macomb County",5,73,7957,3622,4335
050,26,099,"Michigan","Macomb County",5,74,7716,3447,4269
050,26,099,"Michigan","Macomb County",5,75,7447,3240,4207
050,26,099,"Michigan","Macomb County",5,76,7860,3468,4392
050,26,099,"Michigan","Macomb County",5,77,5387,2373,3014
050,26,099,"Michigan","Macomb County",5,78,5093,2255,2838
050,26,099,"Michigan","Macomb County",5,79,4998,2186,2812
050,26,099,"Michigan","Macomb County",5,80,5229,2212,3017
050,26,099,"Michigan","Macomb County",5,81,4408,1811,2597
050,26,099,"Michigan","Macomb County",5,82,3739,1548,2191
050,26,099,"Michigan","Macomb County",5,83,3149,1230,1919
050,26,099,"Michigan","Macomb County",5,84,3057,1199,1858
050,26,099,"Michigan","Macomb County",5,85,16965,5667,11298
050,26,101,"Michigan","Manistee County",1,0,197,101,96
050,26,101,"Michigan","Manistee County",1,1,206,111,95
050,26,101,"Michigan","Manistee County",1,2,209,120,89
050,26,101,"Michigan","Manistee County",1,3,207,101,106
050,26,101,"Michigan","Manistee County",1,4,228,94,134
050,26,101,"Michigan","Manistee County",1,5,203,94,109
050,26,101,"Michigan","Manistee County",1,6,207,97,110
050,26,101,"Michigan","Manistee County",1,7,221,109,112
050,26,101,"Michigan","Manistee County",1,8,210,107,103
050,26,101,"Michigan","Manistee County",1,9,229,113,116
050,26,101,"Michigan","Manistee County",1,10,244,105,139
050,26,101,"Michigan","Manistee County",1,11,231,106,125
050,26,101,"Michigan","Manistee County",1,12,289,142,147
050,26,101,"Michigan","Manistee County",1,13,285,154,131
050,26,101,"Michigan","Manistee County",1,14,254,127,127
050,26,101,"Michigan","Manistee County",1,15,285,137,148
050,26,101,"Michigan","Manistee County",1,16,312,160,152
050,26,101,"Michigan","Manistee County",1,17,319,162,157
050,26,101,"Michigan","Manistee County",1,18,250,137,113
050,26,101,"Michigan","Manistee County",1,19,219,120,99
050,26,101,"Michigan","Manistee County",1,20,232,132,100
050,26,101,"Michigan","Manistee County",1,21,267,159,108
050,26,101,"Michigan","Manistee County",1,22,261,153,108
050,26,101,"Michigan","Manistee County",1,23,281,162,119
050,26,101,"Michigan","Manistee County",1,24,284,179,105
050,26,101,"Michigan","Manistee County",1,25,281,180,101
050,26,101,"Michigan","Manistee County",1,26,276,182,94
050,26,101,"Michigan","Manistee County",1,27,267,161,106
050,26,101,"Michigan","Manistee County",1,28,260,165,95
050,26,101,"Michigan","Manistee County",1,29,292,167,125
050,26,101,"Michigan","Manistee County",1,30,259,152,107
050,26,101,"Michigan","Manistee County",1,31,259,146,113
050,26,101,"Michigan","Manistee County",1,32,236,140,96
050,26,101,"Michigan","Manistee County",1,33,234,129,105
050,26,101,"Michigan","Manistee County",1,34,272,160,112
050,26,101,"Michigan","Manistee County",1,35,246,129,117
050,26,101,"Michigan","Manistee County",1,36,248,131,117
050,26,101,"Michigan","Manistee County",1,37,247,134,113
050,26,101,"Michigan","Manistee County",1,38,271,163,108
050,26,101,"Michigan","Manistee County",1,39,262,152,110
050,26,101,"Michigan","Manistee County",1,40,236,135,101
050,26,101,"Michigan","Manistee County",1,41,236,120,116
050,26,101,"Michigan","Manistee County",1,42,256,135,121
050,26,101,"Michigan","Manistee County",1,43,244,138,106
050,26,101,"Michigan","Manistee County",1,44,234,133,101
050,26,101,"Michigan","Manistee County",1,45,252,129,123
050,26,101,"Michigan","Manistee County",1,46,248,131,117
050,26,101,"Michigan","Manistee County",1,47,252,131,121
050,26,101,"Michigan","Manistee County",1,48,301,156,145
050,26,101,"Michigan","Manistee County",1,49,303,156,147
050,26,101,"Michigan","Manistee County",1,50,286,159,127
050,26,101,"Michigan","Manistee County",1,51,299,172,127
050,26,101,"Michigan","Manistee County",1,52,327,186,141
050,26,101,"Michigan","Manistee County",1,53,329,185,144
050,26,101,"Michigan","Manistee County",1,54,339,175,164
050,26,101,"Michigan","Manistee County",1,55,351,172,179
050,26,101,"Michigan","Manistee County",1,56,383,181,202
050,26,101,"Michigan","Manistee County",1,57,377,182,195
050,26,101,"Michigan","Manistee County",1,58,371,185,186
050,26,101,"Michigan","Manistee County",1,59,430,204,226
050,26,101,"Michigan","Manistee County",1,60,433,208,225
050,26,101,"Michigan","Manistee County",1,61,451,212,239
050,26,101,"Michigan","Manistee County",1,62,466,233,233
050,26,101,"Michigan","Manistee County",1,63,471,230,241
050,26,101,"Michigan","Manistee County",1,64,472,214,258
050,26,101,"Michigan","Manistee County",1,65,489,251,238
050,26,101,"Michigan","Manistee County",1,66,455,231,224
050,26,101,"Michigan","Manistee County",1,67,451,224,227
050,26,101,"Michigan","Manistee County",1,68,440,225,215
050,26,101,"Michigan","Manistee County",1,69,398,210,188
050,26,101,"Michigan","Manistee County",1,70,387,192,195
050,26,101,"Michigan","Manistee County",1,71,407,207,200
050,26,101,"Michigan","Manistee County",1,72,395,203,192
050,26,101,"Michigan","Manistee County",1,73,362,181,181
050,26,101,"Michigan","Manistee County",1,74,250,130,120
050,26,101,"Michigan","Manistee County",1,75,241,113,128
050,26,101,"Michigan","Manistee County",1,76,261,118,143
050,26,101,"Michigan","Manistee County",1,77,268,121,147
050,26,101,"Michigan","Manistee County",1,78,246,127,119
050,26,101,"Michigan","Manistee County",1,79,190,91,99
050,26,101,"Michigan","Manistee County",1,80,169,72,97
050,26,101,"Michigan","Manistee County",1,81,156,72,84
050,26,101,"Michigan","Manistee County",1,82,147,69,78
050,26,101,"Michigan","Manistee County",1,83,136,66,70
050,26,101,"Michigan","Manistee County",1,84,129,61,68
050,26,101,"Michigan","Manistee County",1,85,666,263,403
050,26,101,"Michigan","Manistee County",2,0,193,98,95
050,26,101,"Michigan","Manistee County",2,1,205,109,96
050,26,101,"Michigan","Manistee County",2,2,209,118,91
050,26,101,"Michigan","Manistee County",2,3,207,104,103
050,26,101,"Michigan","Manistee County",2,4,223,96,127
050,26,101,"Michigan","Manistee County",2,5,211,94,117
050,26,101,"Michigan","Manistee County",2,6,208,97,111
050,26,101,"Michigan","Manistee County",2,7,222,108,114
050,26,101,"Michigan","Manistee County",2,8,214,108,106
050,26,101,"Michigan","Manistee County",2,9,227,112,115
050,26,101,"Michigan","Manistee County",2,10,242,107,135
050,26,101,"Michigan","Manistee County",2,11,234,105,129
050,26,101,"Michigan","Manistee County",2,12,277,135,142
050,26,101,"Michigan","Manistee County",2,13,284,150,134
050,26,101,"Michigan","Manistee County",2,14,263,134,129
050,26,101,"Michigan","Manistee County",2,15,282,137,145
050,26,101,"Michigan","Manistee County",2,16,305,155,150
050,26,101,"Michigan","Manistee County",2,17,316,160,156
050,26,101,"Michigan","Manistee County",2,18,257,140,117
050,26,101,"Michigan","Manistee County",2,19,219,121,98
050,26,101,"Michigan","Manistee County",2,20,236,136,100
050,26,101,"Michigan","Manistee County",2,21,266,159,107
050,26,101,"Michigan","Manistee County",2,22,262,152,110
050,26,101,"Michigan","Manistee County",2,23,281,165,116
050,26,101,"Michigan","Manistee County",2,24,284,175,109
050,26,101,"Michigan","Manistee County",2,25,281,179,102
050,26,101,"Michigan","Manistee County",2,26,278,181,97
050,26,101,"Michigan","Manistee County",2,27,266,165,101
050,26,101,"Michigan","Manistee County",2,28,265,166,99
050,26,101,"Michigan","Manistee County",2,29,284,167,117
050,26,101,"Michigan","Manistee County",2,30,268,154,114
050,26,101,"Michigan","Manistee County",2,31,262,149,113
050,26,101,"Michigan","Manistee County",2,32,240,138,102
050,26,101,"Michigan","Manistee County",2,33,236,132,104
050,26,101,"Michigan","Manistee County",2,34,267,158,109
050,26,101,"Michigan","Manistee County",2,35,250,132,118
050,26,101,"Michigan","Manistee County",2,36,251,133,118
050,26,101,"Michigan","Manistee County",2,37,248,133,115
050,26,101,"Michigan","Manistee County",2,38,271,161,110
050,26,101,"Michigan","Manistee County",2,39,262,153,109
050,26,101,"Michigan","Manistee County",2,40,249,144,105
050,26,101,"Michigan","Manistee County",2,41,236,122,114
050,26,101,"Michigan","Manistee County",2,42,250,131,119
050,26,101,"Michigan","Manistee County",2,43,248,137,111
050,26,101,"Michigan","Manistee County",2,44,236,133,103
050,26,101,"Michigan","Manistee County",2,45,249,130,119
050,26,101,"Michigan","Manistee County",2,46,249,131,118
050,26,101,"Michigan","Manistee County",2,47,249,130,119
050,26,101,"Michigan","Manistee County",2,48,289,150,139
050,26,101,"Michigan","Manistee County",2,49,303,156,147
050,26,101,"Michigan","Manistee County",2,50,288,156,132
050,26,101,"Michigan","Manistee County",2,51,298,170,128
050,26,101,"Michigan","Manistee County",2,52,321,184,137
050,26,101,"Michigan","Manistee County",2,53,328,184,144
050,26,101,"Michigan","Manistee County",2,54,334,175,159
050,26,101,"Michigan","Manistee County",2,55,352,175,177
050,26,101,"Michigan","Manistee County",2,56,381,181,200
050,26,101,"Michigan","Manistee County",2,57,379,182,197
050,26,101,"Michigan","Manistee County",2,58,372,183,189
050,26,101,"Michigan","Manistee County",2,59,418,202,216
050,26,101,"Michigan","Manistee County",2,60,433,207,226
050,26,101,"Michigan","Manistee County",2,61,445,208,237
050,26,101,"Michigan","Manistee County",2,62,465,229,236
050,26,101,"Michigan","Manistee County",2,63,478,235,243
050,26,101,"Michigan","Manistee County",2,64,472,219,253
050,26,101,"Michigan","Manistee County",2,65,483,241,242
050,26,101,"Michigan","Manistee County",2,66,464,236,228
050,26,101,"Michigan","Manistee County",2,67,449,224,225
050,26,101,"Michigan","Manistee County",2,68,441,224,217
050,26,101,"Michigan","Manistee County",2,69,408,213,195
050,26,101,"Michigan","Manistee County",2,70,390,196,194
050,26,101,"Michigan","Manistee County",2,71,400,202,198
050,26,101,"Michigan","Manistee County",2,72,385,197,188
050,26,101,"Michigan","Manistee County",2,73,390,197,193
050,26,101,"Michigan","Manistee County",2,74,260,134,126
050,26,101,"Michigan","Manistee County",2,75,241,117,124
050,26,101,"Michigan","Manistee County",2,76,251,113,138
050,26,101,"Michigan","Manistee County",2,77,272,122,150
050,26,101,"Michigan","Manistee County",2,78,245,122,123
050,26,101,"Michigan","Manistee County",2,79,200,98,102
050,26,101,"Michigan","Manistee County",2,80,171,76,95
050,26,101,"Michigan","Manistee County",2,81,156,70,86
050,26,101,"Michigan","Manistee County",2,82,147,68,79
050,26,101,"Michigan","Manistee County",2,83,138,66,72
050,26,101,"Michigan","Manistee County",2,84,126,60,66
050,26,101,"Michigan","Manistee County",2,85,671,266,405
050,26,101,"Michigan","Manistee County",3,0,188,102,86
050,26,101,"Michigan","Manistee County",3,1,207,107,100
050,26,101,"Michigan","Manistee County",3,2,210,116,94
050,26,101,"Michigan","Manistee County",3,3,213,118,95
050,26,101,"Michigan","Manistee County",3,4,219,105,114
050,26,101,"Michigan","Manistee County",3,5,228,99,129
050,26,101,"Michigan","Manistee County",3,6,210,91,119
050,26,101,"Michigan","Manistee County",3,7,208,98,110
050,26,101,"Michigan","Manistee County",3,8,229,112,117
050,26,101,"Michigan","Manistee County",3,9,216,113,103
050,26,101,"Michigan","Manistee County",3,10,225,112,113
050,26,101,"Michigan","Manistee County",3,11,253,115,138
050,26,101,"Michigan","Manistee County",3,12,234,99,135
050,26,101,"Michigan","Manistee County",3,13,280,129,151
050,26,101,"Michigan","Manistee County",3,14,283,152,131
050,26,101,"Michigan","Manistee County",3,15,273,135,138
050,26,101,"Michigan","Manistee County",3,16,290,140,150
050,26,101,"Michigan","Manistee County",3,17,311,161,150
050,26,101,"Michigan","Manistee County",3,18,278,150,128
050,26,101,"Michigan","Manistee County",3,19,219,122,97
050,26,101,"Michigan","Manistee County",3,20,249,143,106
050,26,101,"Michigan","Manistee County",3,21,273,164,109
050,26,101,"Michigan","Manistee County",3,22,249,134,115
050,26,101,"Michigan","Manistee County",3,23,308,181,127
050,26,101,"Michigan","Manistee County",3,24,292,177,115
050,26,101,"Michigan","Manistee County",3,25,278,168,110
050,26,101,"Michigan","Manistee County",3,26,254,162,92
050,26,101,"Michigan","Manistee County",3,27,276,180,96
050,26,101,"Michigan","Manistee County",3,28,278,174,104
050,26,101,"Michigan","Manistee County",3,29,268,163,105
050,26,101,"Michigan","Manistee County",3,30,292,167,125
050,26,101,"Michigan","Manistee County",3,31,272,154,118
050,26,101,"Michigan","Manistee County",3,32,270,155,115
050,26,101,"Michigan","Manistee County",3,33,239,131,108
050,26,101,"Michigan","Manistee County",3,34,263,163,100
050,26,101,"Michigan","Manistee County",3,35,241,128,113
050,26,101,"Michigan","Manistee County",3,36,273,148,125
050,26,101,"Michigan","Manistee County",3,37,244,127,117
050,26,101,"Michigan","Manistee County",3,38,270,152,118
050,26,101,"Michigan","Manistee County",3,39,273,157,116
050,26,101,"Michigan","Manistee County",3,40,277,162,115
050,26,101,"Michigan","Manistee County",3,41,254,144,110
050,26,101,"Michigan","Manistee County",3,42,256,137,119
050,26,101,"Michigan","Manistee County",3,43,264,143,121
050,26,101,"Michigan","Manistee County",3,44,265,147,118
050,26,101,"Michigan","Manistee County",3,45,228,126,102
050,26,101,"Michigan","Manistee County",3,46,260,135,125
050,26,101,"Michigan","Manistee County",3,47,236,120,116
050,26,101,"Michigan","Manistee County",3,48,259,140,119
050,26,101,"Michigan","Manistee County",3,49,284,146,138
050,26,101,"Michigan","Manistee County",3,50,306,155,151
050,26,101,"Michigan","Manistee County",3,51,305,162,143
050,26,101,"Michigan","Manistee County",3,52,328,192,136
050,26,101,"Michigan","Manistee County",3,53,320,180,140
050,26,101,"Michigan","Manistee County",3,54,337,190,147
050,26,101,"Michigan","Manistee County",3,55,324,171,153
050,26,101,"Michigan","Manistee County",3,56,350,168,182
050,26,101,"Michigan","Manistee County",3,57,380,178,202
050,26,101,"Michigan","Manistee County",3,58,407,198,209
050,26,101,"Michigan","Manistee County",3,59,382,189,193
050,26,101,"Michigan","Manistee County",3,60,425,203,222
050,26,101,"Michigan","Manistee County",3,61,448,213,235
050,26,101,"Michigan","Manistee County",3,62,443,205,238
050,26,101,"Michigan","Manistee County",3,63,486,239,247
050,26,101,"Michigan","Manistee County",3,64,480,234,246
050,26,101,"Michigan","Manistee County",3,65,476,226,250
050,26,101,"Michigan","Manistee County",3,66,488,240,248
050,26,101,"Michigan","Manistee County",3,67,467,241,226
050,26,101,"Michigan","Manistee County",3,68,439,213,226
050,26,101,"Michigan","Manistee County",3,69,427,225,202
050,26,101,"Michigan","Manistee County",3,70,392,204,188
050,26,101,"Michigan","Manistee County",3,71,396,200,196
050,26,101,"Michigan","Manistee County",3,72,387,193,194
050,26,101,"Michigan","Manistee County",3,73,375,191,184
050,26,101,"Michigan","Manistee County",3,74,381,191,190
050,26,101,"Michigan","Manistee County",3,75,252,134,118
050,26,101,"Michigan","Manistee County",3,76,238,115,123
050,26,101,"Michigan","Manistee County",3,77,238,105,133
050,26,101,"Michigan","Manistee County",3,78,262,113,149
050,26,101,"Michigan","Manistee County",3,79,224,110,114
050,26,101,"Michigan","Manistee County",3,80,200,97,103
050,26,101,"Michigan","Manistee County",3,81,160,75,85
050,26,101,"Michigan","Manistee County",3,82,147,64,83
050,26,101,"Michigan","Manistee County",3,83,146,67,79
050,26,101,"Michigan","Manistee County",3,84,124,60,64
050,26,101,"Michigan","Manistee County",3,85,669,262,407
050,26,101,"Michigan","Manistee County",4,0,194,97,97
050,26,101,"Michigan","Manistee County",4,1,193,112,81
050,26,101,"Michigan","Manistee County",4,2,204,107,97
050,26,101,"Michigan","Manistee County",4,3,218,122,96
050,26,101,"Michigan","Manistee County",4,4,224,121,103
050,26,101,"Michigan","Manistee County",4,5,219,99,120
050,26,101,"Michigan","Manistee County",4,6,235,100,135
050,26,101,"Michigan","Manistee County",4,7,208,91,117
050,26,101,"Michigan","Manistee County",4,8,230,109,121
050,26,101,"Michigan","Manistee County",4,9,233,118,115
050,26,101,"Michigan","Manistee County",4,10,220,114,106
050,26,101,"Michigan","Manistee County",4,11,234,119,115
050,26,101,"Michigan","Manistee County",4,12,251,112,139
050,26,101,"Michigan","Manistee County",4,13,243,109,134
050,26,101,"Michigan","Manistee County",4,14,288,134,154
050,26,101,"Michigan","Manistee County",4,15,284,155,129
050,26,101,"Michigan","Manistee County",4,16,274,137,137
050,26,101,"Michigan","Manistee County",4,17,285,141,144
050,26,101,"Michigan","Manistee County",4,18,274,152,122
050,26,101,"Michigan","Manistee County",4,19,225,127,98
050,26,101,"Michigan","Manistee County",4,20,232,134,98
050,26,101,"Michigan","Manistee County",4,21,275,167,108
050,26,101,"Michigan","Manistee County",4,22,251,144,107
050,26,101,"Michigan","Manistee County",4,23,271,149,122
050,26,101,"Michigan","Manistee County",4,24,295,180,115
050,26,101,"Michigan","Manistee County",4,25,271,160,111
050,26,101,"Michigan","Manistee County",4,26,256,148,108
050,26,101,"Michigan","Manistee County",4,27,253,166,87
050,26,101,"Michigan","Manistee County",4,28,287,182,105
050,26,101,"Michigan","Manistee County",4,29,275,171,104
050,26,101,"Michigan","Manistee County",4,30,262,155,107
050,26,101,"Michigan","Manistee County",4,31,308,175,133
050,26,101,"Michigan","Manistee County",4,32,281,159,122
050,26,101,"Michigan","Manistee County",4,33,253,145,108
050,26,101,"Michigan","Manistee County",4,34,265,159,106
050,26,101,"Michigan","Manistee County",4,35,246,143,103
050,26,101,"Michigan","Manistee County",4,36,250,136,114
050,26,101,"Michigan","Manistee County",4,37,273,149,124
050,26,101,"Michigan","Manistee County",4,38,267,147,120
050,26,101,"Michigan","Manistee County",4,39,260,138,122
050,26,101,"Michigan","Manistee County",4,40,291,168,123
050,26,101,"Michigan","Manistee County",4,41,273,156,117
050,26,101,"Michigan","Manistee County",4,42,266,150,116
050,26,101,"Michigan","Manistee County",4,43,262,138,124
050,26,101,"Michigan","Manistee County",4,44,264,139,125
050,26,101,"Michigan","Manistee County",4,45,256,145,111
050,26,101,"Michigan","Manistee County",4,46,242,135,107
050,26,101,"Michigan","Manistee County",4,47,250,124,126
050,26,101,"Michigan","Manistee County",4,48,237,126,111
050,26,101,"Michigan","Manistee County",4,49,240,127,113
050,26,101,"Michigan","Manistee County",4,50,277,138,139
050,26,101,"Michigan","Manistee County",4,51,307,157,150
050,26,101,"Michigan","Manistee County",4,52,311,169,142
050,26,101,"Michigan","Manistee County",4,53,326,189,137
050,26,101,"Michigan","Manistee County",4,54,320,176,144
050,26,101,"Michigan","Manistee County",4,55,347,190,157
050,26,101,"Michigan","Manistee County",4,56,321,163,158
050,26,101,"Michigan","Manistee County",4,57,351,165,186
050,26,101,"Michigan","Manistee County",4,58,396,191,205
050,26,101,"Michigan","Manistee County",4,59,426,201,225
050,26,101,"Michigan","Manistee County",4,60,375,186,189
050,26,101,"Michigan","Manistee County",4,61,430,210,220
050,26,101,"Michigan","Manistee County",4,62,467,224,243
050,26,101,"Michigan","Manistee County",4,63,435,203,232
050,26,101,"Michigan","Manistee County",4,64,496,248,248
050,26,101,"Michigan","Manistee County",4,65,480,235,245
050,26,101,"Michigan","Manistee County",4,66,480,226,254
050,26,101,"Michigan","Manistee County",4,67,487,241,246
050,26,101,"Michigan","Manistee County",4,68,473,238,235
050,26,101,"Michigan","Manistee County",4,69,448,218,230
050,26,101,"Michigan","Manistee County",4,70,428,225,203
050,26,101,"Michigan","Manistee County",4,71,399,209,190
050,26,101,"Michigan","Manistee County",4,72,386,199,187
050,26,101,"Michigan","Manistee County",4,73,376,184,192
050,26,101,"Michigan","Manistee County",4,74,367,187,180
050,26,101,"Michigan","Manistee County",4,75,370,186,184
050,26,101,"Michigan","Manistee County",4,76,247,132,115
050,26,101,"Michigan","Manistee County",4,77,228,111,117
050,26,101,"Michigan","Manistee County",4,78,231,96,135
050,26,101,"Michigan","Manistee County",4,79,236,100,136
050,26,101,"Michigan","Manistee County",4,80,220,109,111
050,26,101,"Michigan","Manistee County",4,81,185,91,94
050,26,101,"Michigan","Manistee County",4,82,148,70,78
050,26,101,"Michigan","Manistee County",4,83,138,59,79
050,26,101,"Michigan","Manistee County",4,84,127,58,69
050,26,101,"Michigan","Manistee County",4,85,678,267,411
050,26,101,"Michigan","Manistee County",5,0,193,97,96
050,26,101,"Michigan","Manistee County",5,1,207,110,97
050,26,101,"Michigan","Manistee County",5,2,201,110,91
050,26,101,"Michigan","Manistee County",5,3,207,106,101
050,26,101,"Michigan","Manistee County",5,4,235,130,105
050,26,101,"Michigan","Manistee County",5,5,219,113,106
050,26,101,"Michigan","Manistee County",5,6,229,110,119
050,26,101,"Michigan","Manistee County",5,7,242,100,142
050,26,101,"Michigan","Manistee County",5,8,224,99,125
050,26,101,"Michigan","Manistee County",5,9,239,116,123
050,26,101,"Michigan","Manistee County",5,10,244,124,120
050,26,101,"Michigan","Manistee County",5,11,226,119,107
050,26,101,"Michigan","Manistee County",5,12,225,115,110
050,26,101,"Michigan","Manistee County",5,13,251,115,136
050,26,101,"Michigan","Manistee County",5,14,244,111,133
050,26,101,"Michigan","Manistee County",5,15,303,143,160
050,26,101,"Michigan","Manistee County",5,16,275,154,121
050,26,101,"Michigan","Manistee County",5,17,292,148,144
050,26,101,"Michigan","Manistee County",5,18,245,129,116
050,26,101,"Michigan","Manistee County",5,19,228,132,96
050,26,101,"Michigan","Manistee County",5,20,254,150,104
050,26,101,"Michigan","Manistee County",5,21,272,165,107
050,26,101,"Michigan","Manistee County",5,22,268,153,115
050,26,101,"Michigan","Manistee County",5,23,280,174,106
050,26,101,"Michigan","Manistee County",5,24,294,162,132
050,26,101,"Michigan","Manistee County",5,25,292,179,113
050,26,101,"Michigan","Manistee County",5,26,270,154,116
050,26,101,"Michigan","Manistee County",5,27,276,162,114
050,26,101,"Michigan","Manistee County",5,28,260,164,96
050,26,101,"Michigan","Manistee County",5,29,282,181,101
050,26,101,"Michigan","Manistee County",5,30,269,166,103
050,26,101,"Michigan","Manistee County",5,31,275,165,110
050,26,101,"Michigan","Manistee County",5,32,311,169,142
050,26,101,"Michigan","Manistee County",5,33,276,150,126
050,26,101,"Michigan","Manistee County",5,34,284,168,116
050,26,101,"Michigan","Manistee County",5,35,249,145,104
050,26,101,"Michigan","Manistee County",5,36,268,159,109
050,26,101,"Michigan","Manistee County",5,37,241,130,111
050,26,101,"Michigan","Manistee County",5,38,290,161,129
050,26,101,"Michigan","Manistee County",5,39,255,134,121
050,26,101,"Michigan","Manistee County",5,40,279,155,124
050,26,101,"Michigan","Manistee County",5,41,282,165,117
050,26,101,"Michigan","Manistee County",5,42,284,164,120
050,26,101,"Michigan","Manistee County",5,43,269,149,120
050,26,101,"Michigan","Manistee County",5,44,263,137,126
050,26,101,"Michigan","Manistee County",5,45,253,126,127
050,26,101,"Michigan","Manistee County",5,46,254,144,110
050,26,101,"Michigan","Manistee County",5,47,235,124,111
050,26,101,"Michigan","Manistee County",5,48,264,134,130
050,26,101,"Michigan","Manistee County",5,49,235,122,113
050,26,101,"Michigan","Manistee County",5,50,231,119,112
050,26,101,"Michigan","Manistee County",5,51,287,145,142
050,26,101,"Michigan","Manistee County",5,52,321,165,156
050,26,101,"Michigan","Manistee County",5,53,307,166,141
050,26,101,"Michigan","Manistee County",5,54,326,186,140
050,26,101,"Michigan","Manistee County",5,55,318,171,147
050,26,101,"Michigan","Manistee County",5,56,346,187,159
050,26,101,"Michigan","Manistee County",5,57,328,159,169
050,26,101,"Michigan","Manistee County",5,58,362,171,191
050,26,101,"Michigan","Manistee County",5,59,393,184,209
050,26,101,"Michigan","Manistee County",5,60,430,199,231
050,26,101,"Michigan","Manistee County",5,61,383,193,190
050,26,101,"Michigan","Manistee County",5,62,445,217,228
050,26,101,"Michigan","Manistee County",5,63,461,220,241
050,26,101,"Michigan","Manistee County",5,64,443,207,236
050,26,101,"Michigan","Manistee County",5,65,490,246,244
050,26,101,"Michigan","Manistee County",5,66,476,228,248
050,26,101,"Michigan","Manistee County",5,67,473,224,249
050,26,101,"Michigan","Manistee County",5,68,489,239,250
050,26,101,"Michigan","Manistee County",5,69,476,240,236
050,26,101,"Michigan","Manistee County",5,70,447,222,225
050,26,101,"Michigan","Manistee County",5,71,434,223,211
050,26,101,"Michigan","Manistee County",5,72,384,205,179
050,26,101,"Michigan","Manistee County",5,73,373,189,184
050,26,101,"Michigan","Manistee County",5,74,367,178,189
050,26,101,"Michigan","Manistee County",5,75,360,185,175
050,26,101,"Michigan","Manistee County",5,76,364,184,180
050,26,101,"Michigan","Manistee County",5,77,238,125,113
050,26,101,"Michigan","Manistee County",5,78,223,107,116
050,26,101,"Michigan","Manistee County",5,79,202,83,119
050,26,101,"Michigan","Manistee County",5,80,230,96,134
050,26,101,"Michigan","Manistee County",5,81,206,104,102
050,26,101,"Michigan","Manistee County",5,82,172,86,86
050,26,101,"Michigan","Manistee County",5,83,146,65,81
050,26,101,"Michigan","Manistee County",5,84,122,50,72
050,26,101,"Michigan","Manistee County",5,85,696,269,427
050,26,103,"Michigan","Marquette County",1,0,564,290,274
050,26,103,"Michigan","Marquette County",1,1,577,297,280
050,26,103,"Michigan","Marquette County",1,2,590,305,285
050,26,103,"Michigan","Marquette County",1,3,638,317,321
050,26,103,"Michigan","Marquette County",1,4,651,338,313
050,26,103,"Michigan","Marquette County",1,5,620,313,307
050,26,103,"Michigan","Marquette County",1,6,633,310,323
050,26,103,"Michigan","Marquette County",1,7,680,346,334
050,26,103,"Michigan","Marquette County",1,8,694,362,332
050,26,103,"Michigan","Marquette County",1,9,659,362,297
050,26,103,"Michigan","Marquette County",1,10,682,348,334
050,26,103,"Michigan","Marquette County",1,11,729,343,386
050,26,103,"Michigan","Marquette County",1,12,745,380,365
050,26,103,"Michigan","Marquette County",1,13,736,388,348
050,26,103,"Michigan","Marquette County",1,14,684,360,324
050,26,103,"Michigan","Marquette County",1,15,640,326,314
050,26,103,"Michigan","Marquette County",1,16,686,343,343
050,26,103,"Michigan","Marquette County",1,17,681,347,334
050,26,103,"Michigan","Marquette County",1,18,1064,476,588
050,26,103,"Michigan","Marquette County",1,19,1629,788,841
050,26,103,"Michigan","Marquette County",1,20,1705,852,853
050,26,103,"Michigan","Marquette County",1,21,1587,710,877
050,26,103,"Michigan","Marquette County",1,22,1516,781,735
050,26,103,"Michigan","Marquette County",1,23,1512,787,725
050,26,103,"Michigan","Marquette County",1,24,1052,567,485
050,26,103,"Michigan","Marquette County",1,25,906,483,423
050,26,103,"Michigan","Marquette County",1,26,810,436,374
050,26,103,"Michigan","Marquette County",1,27,760,397,363
050,26,103,"Michigan","Marquette County",1,28,763,411,352
050,26,103,"Michigan","Marquette County",1,29,759,386,373
050,26,103,"Michigan","Marquette County",1,30,739,381,358
050,26,103,"Michigan","Marquette County",1,31,715,386,329
050,26,103,"Michigan","Marquette County",1,32,703,369,334
050,26,103,"Michigan","Marquette County",1,33,704,361,343
050,26,103,"Michigan","Marquette County",1,34,744,396,348
050,26,103,"Michigan","Marquette County",1,35,775,411,364
050,26,103,"Michigan","Marquette County",1,36,769,399,370
050,26,103,"Michigan","Marquette County",1,37,805,424,381
050,26,103,"Michigan","Marquette County",1,38,799,430,369
050,26,103,"Michigan","Marquette County",1,39,802,422,380
050,26,103,"Michigan","Marquette County",1,40,819,438,381
050,26,103,"Michigan","Marquette County",1,41,780,410,370
050,26,103,"Michigan","Marquette County",1,42,765,398,367
050,26,103,"Michigan","Marquette County",1,43,682,351,331
050,26,103,"Michigan","Marquette County",1,44,642,328,314
050,26,103,"Michigan","Marquette County",1,45,646,340,306
050,26,103,"Michigan","Marquette County",1,46,636,348,288
050,26,103,"Michigan","Marquette County",1,47,653,358,295
050,26,103,"Michigan","Marquette County",1,48,711,375,336
050,26,103,"Michigan","Marquette County",1,49,763,407,356
050,26,103,"Michigan","Marquette County",1,50,756,388,368
050,26,103,"Michigan","Marquette County",1,51,721,373,348
050,26,103,"Michigan","Marquette County",1,52,709,383,326
050,26,103,"Michigan","Marquette County",1,53,725,378,347
050,26,103,"Michigan","Marquette County",1,54,705,349,356
050,26,103,"Michigan","Marquette County",1,55,787,397,390
050,26,103,"Michigan","Marquette County",1,56,847,431,416
050,26,103,"Michigan","Marquette County",1,57,838,414,424
050,26,103,"Michigan","Marquette County",1,58,909,479,430
050,26,103,"Michigan","Marquette County",1,59,920,445,475
050,26,103,"Michigan","Marquette County",1,60,886,430,456
050,26,103,"Michigan","Marquette County",1,61,920,440,480
050,26,103,"Michigan","Marquette County",1,62,952,472,480
050,26,103,"Michigan","Marquette County",1,63,912,446,466
050,26,103,"Michigan","Marquette County",1,64,983,515,468
050,26,103,"Michigan","Marquette County",1,65,943,472,471
050,26,103,"Michigan","Marquette County",1,66,947,462,485
050,26,103,"Michigan","Marquette County",1,67,930,453,477
050,26,103,"Michigan","Marquette County",1,68,886,448,438
050,26,103,"Michigan","Marquette County",1,69,827,434,393
050,26,103,"Michigan","Marquette County",1,70,770,401,369
050,26,103,"Michigan","Marquette County",1,71,727,375,352
050,26,103,"Michigan","Marquette County",1,72,739,380,359
050,26,103,"Michigan","Marquette County",1,73,728,377,351
050,26,103,"Michigan","Marquette County",1,74,509,267,242
050,26,103,"Michigan","Marquette County",1,75,467,231,236
050,26,103,"Michigan","Marquette County",1,76,446,219,227
050,26,103,"Michigan","Marquette County",1,77,437,227,210
050,26,103,"Michigan","Marquette County",1,78,376,182,194
050,26,103,"Michigan","Marquette County",1,79,316,151,165
050,26,103,"Michigan","Marquette County",1,80,316,133,183
050,26,103,"Michigan","Marquette County",1,81,303,138,165
050,26,103,"Michigan","Marquette County",1,82,297,128,169
050,26,103,"Michigan","Marquette County",1,83,261,119,142
050,26,103,"Michigan","Marquette County",1,84,238,119,119
050,26,103,"Michigan","Marquette County",1,85,1376,559,817
050,26,103,"Michigan","Marquette County",2,0,574,292,282
050,26,103,"Michigan","Marquette County",2,1,573,295,278
050,26,103,"Michigan","Marquette County",2,2,586,301,285
050,26,103,"Michigan","Marquette County",2,3,624,311,313
050,26,103,"Michigan","Marquette County",2,4,649,332,317
050,26,103,"Michigan","Marquette County",2,5,628,320,308
050,26,103,"Michigan","Marquette County",2,6,631,312,319
050,26,103,"Michigan","Marquette County",2,7,669,336,333
050,26,103,"Michigan","Marquette County",2,8,686,355,331
050,26,103,"Michigan","Marquette County",2,9,668,365,303
050,26,103,"Michigan","Marquette County",2,10,677,351,326
050,26,103,"Michigan","Marquette County",2,11,715,344,371
050,26,103,"Michigan","Marquette County",2,12,743,372,371
050,26,103,"Michigan","Marquette County",2,13,734,386,348
050,26,103,"Michigan","Marquette County",2,14,692,364,328
050,26,103,"Michigan","Marquette County",2,15,650,335,315
050,26,103,"Michigan","Marquette County",2,16,679,342,337
050,26,103,"Michigan","Marquette County",2,17,681,344,337
050,26,103,"Michigan","Marquette County",2,18,1049,468,581
050,26,103,"Michigan","Marquette County",2,19,1631,787,844
050,26,103,"Michigan","Marquette County",2,20,1724,864,860
050,26,103,"Michigan","Marquette County",2,21,1588,716,872
050,26,103,"Michigan","Marquette County",2,22,1507,772,735
050,26,103,"Michigan","Marquette County",2,23,1512,786,726
050,26,103,"Michigan","Marquette County",2,24,1037,562,475
050,26,103,"Michigan","Marquette County",2,25,899,484,415
050,26,103,"Michigan","Marquette County",2,26,814,435,379
050,26,103,"Michigan","Marquette County",2,27,759,400,359
050,26,103,"Michigan","Marquette County",2,28,765,409,356
050,26,103,"Michigan","Marquette County",2,29,756,391,365
050,26,103,"Michigan","Marquette County",2,30,750,386,364
050,26,103,"Michigan","Marquette County",2,31,719,384,335
050,26,103,"Michigan","Marquette County",2,32,710,374,336
050,26,103,"Michigan","Marquette County",2,33,708,364,344
050,26,103,"Michigan","Marquette County",2,34,729,385,344
050,26,103,"Michigan","Marquette County",2,35,778,413,365
050,26,103,"Michigan","Marquette County",2,36,776,408,368
050,26,103,"Michigan","Marquette County",2,37,797,419,378
050,26,103,"Michigan","Marquette County",2,38,804,433,371
050,26,103,"Michigan","Marquette County",2,39,801,423,378
050,26,103,"Michigan","Marquette County",2,40,816,436,380
050,26,103,"Michigan","Marquette County",2,41,781,410,371
050,26,103,"Michigan","Marquette County",2,42,767,402,365
050,26,103,"Michigan","Marquette County",2,43,704,364,340
050,26,103,"Michigan","Marquette County",2,44,641,326,315
050,26,103,"Michigan","Marquette County",2,45,648,340,308
050,26,103,"Michigan","Marquette County",2,46,634,346,288
050,26,103,"Michigan","Marquette County",2,47,643,352,291
050,26,103,"Michigan","Marquette County",2,48,702,375,327
050,26,103,"Michigan","Marquette County",2,49,752,400,352
050,26,103,"Michigan","Marquette County",2,50,757,393,364
050,26,103,"Michigan","Marquette County",2,51,727,375,352
050,26,103,"Michigan","Marquette County",2,52,714,382,332
050,26,103,"Michigan","Marquette County",2,53,715,376,339
050,26,103,"Michigan","Marquette County",2,54,705,353,352
050,26,103,"Michigan","Marquette County",2,55,763,384,379
050,26,103,"Michigan","Marquette County",2,56,837,427,410
050,26,103,"Michigan","Marquette County",2,57,842,419,423
050,26,103,"Michigan","Marquette County",2,58,889,462,427
050,26,103,"Michigan","Marquette County",2,59,919,453,466
050,26,103,"Michigan","Marquette County",2,60,892,433,459
050,26,103,"Michigan","Marquette County",2,61,908,435,473
050,26,103,"Michigan","Marquette County",2,62,945,465,480
050,26,103,"Michigan","Marquette County",2,63,933,459,474
050,26,103,"Michigan","Marquette County",2,64,963,497,466
050,26,103,"Michigan","Marquette County",2,65,953,480,473
050,26,103,"Michigan","Marquette County",2,66,948,464,484
050,26,103,"Michigan","Marquette County",2,67,932,455,477
050,26,103,"Michigan","Marquette County",2,68,886,446,440
050,26,103,"Michigan","Marquette County",2,69,841,437,404
050,26,103,"Michigan","Marquette County",2,70,778,406,372
050,26,103,"Michigan","Marquette County",2,71,737,382,355
050,26,103,"Michigan","Marquette County",2,72,722,372,350
050,26,103,"Michigan","Marquette County",2,73,764,396,368
050,26,103,"Michigan","Marquette County",2,74,520,273,247
050,26,103,"Michigan","Marquette County",2,75,474,240,234
050,26,103,"Michigan","Marquette County",2,76,440,214,226
050,26,103,"Michigan","Marquette County",2,77,446,229,217
050,26,103,"Michigan","Marquette County",2,78,381,186,195
050,26,103,"Michigan","Marquette County",2,79,325,159,166
050,26,103,"Michigan","Marquette County",2,80,310,134,176
050,26,103,"Michigan","Marquette County",2,81,300,136,164
050,26,103,"Michigan","Marquette County",2,82,296,128,168
050,26,103,"Michigan","Marquette County",2,83,263,118,145
050,26,103,"Michigan","Marquette County",2,84,236,117,119
050,26,103,"Michigan","Marquette County",2,85,1391,567,824
050,26,103,"Michigan","Marquette County",3,0,551,268,283
050,26,103,"Michigan","Marquette County",3,1,602,297,305
050,26,103,"Michigan","Marquette County",3,2,578,297,281
050,26,103,"Michigan","Marquette County",3,3,578,297,281
050,26,103,"Michigan","Marquette County",3,4,629,312,317
050,26,103,"Michigan","Marquette County",3,5,651,333,318
050,26,103,"Michigan","Marquette County",3,6,613,317,296
050,26,103,"Michigan","Marquette County",3,7,612,306,306
050,26,103,"Michigan","Marquette County",3,8,673,333,340
050,26,103,"Michigan","Marquette County",3,9,684,360,324
050,26,103,"Michigan","Marquette County",3,10,667,370,297
050,26,103,"Michigan","Marquette County",3,11,692,362,330
050,26,103,"Michigan","Marquette County",3,12,727,344,383
050,26,103,"Michigan","Marquette County",3,13,746,376,370
050,26,103,"Michigan","Marquette County",3,14,734,377,357
050,26,103,"Michigan","Marquette County",3,15,700,367,333
050,26,103,"Michigan","Marquette County",3,16,681,351,330
050,26,103,"Michigan","Marquette County",3,17,666,333,333
050,26,103,"Michigan","Marquette County",3,18,971,434,537
050,26,103,"Michigan","Marquette County",3,19,1499,716,783
050,26,103,"Michigan","Marquette County",3,20,1635,836,799
050,26,103,"Michigan","Marquette County",3,21,1604,713,891
050,26,103,"Michigan","Marquette County",3,22,1503,754,749
050,26,103,"Michigan","Marquette County",3,23,1540,810,730
050,26,103,"Michigan","Marquette County",3,24,1002,554,448
050,26,103,"Michigan","Marquette County",3,25,909,491,418
050,26,103,"Michigan","Marquette County",3,26,820,419,401
050,26,103,"Michigan","Marquette County",3,27,757,399,358
050,26,103,"Michigan","Marquette County",3,28,752,400,352
050,26,103,"Michigan","Marquette County",3,29,780,416,364
050,26,103,"Michigan","Marquette County",3,30,748,381,367
050,26,103,"Michigan","Marquette County",3,31,756,398,358
050,26,103,"Michigan","Marquette County",3,32,722,385,337
050,26,103,"Michigan","Marquette County",3,33,723,365,358
050,26,103,"Michigan","Marquette County",3,34,685,356,329
050,26,103,"Michigan","Marquette County",3,35,734,384,350
050,26,103,"Michigan","Marquette County",3,36,777,409,368
050,26,103,"Michigan","Marquette County",3,37,754,389,365
050,26,103,"Michigan","Marquette County",3,38,822,434,388
050,26,103,"Michigan","Marquette County",3,39,825,444,381
050,26,103,"Michigan","Marquette County",3,40,801,422,379
050,26,103,"Michigan","Marquette County",3,41,806,421,385
050,26,103,"Michigan","Marquette County",3,42,787,412,375
050,26,103,"Michigan","Marquette County",3,43,768,406,362
050,26,103,"Michigan","Marquette County",3,44,703,355,348
050,26,103,"Michigan","Marquette County",3,45,662,340,322
050,26,103,"Michigan","Marquette County",3,46,635,322,313
050,26,103,"Michigan","Marquette County",3,47,613,324,289
050,26,103,"Michigan","Marquette County",3,48,652,358,294
050,26,103,"Michigan","Marquette County",3,49,699,372,327
050,26,103,"Michigan","Marquette County",3,50,733,384,349
050,26,103,"Michigan","Marquette County",3,51,748,381,367
050,26,103,"Michigan","Marquette County",3,52,730,380,350
050,26,103,"Michigan","Marquette County",3,53,704,375,329
050,26,103,"Michigan","Marquette County",3,54,704,365,339
050,26,103,"Michigan","Marquette County",3,55,697,349,348
050,26,103,"Michigan","Marquette County",3,56,773,392,381
050,26,103,"Michigan","Marquette County",3,57,835,418,417
050,26,103,"Michigan","Marquette County",3,58,842,419,423
050,26,103,"Michigan","Marquette County",3,59,897,455,442
050,26,103,"Michigan","Marquette County",3,60,917,455,462
050,26,103,"Michigan","Marquette County",3,61,889,428,461
050,26,103,"Michigan","Marquette County",3,62,912,434,478
050,26,103,"Michigan","Marquette County",3,63,925,453,472
050,26,103,"Michigan","Marquette County",3,64,931,456,475
050,26,103,"Michigan","Marquette County",3,65,949,483,466
050,26,103,"Michigan","Marquette County",3,66,935,464,471
050,26,103,"Michigan","Marquette County",3,67,944,455,489
050,26,103,"Michigan","Marquette County",3,68,911,450,461
050,26,103,"Michigan","Marquette County",3,69,879,445,434
050,26,103,"Michigan","Marquette County",3,70,829,428,401
050,26,103,"Michigan","Marquette County",3,71,765,404,361
050,26,103,"Michigan","Marquette County",3,72,713,364,349
050,26,103,"Michigan","Marquette County",3,73,691,357,334
050,26,103,"Michigan","Marquette County",3,74,725,371,354
050,26,103,"Michigan","Marquette County",3,75,493,258,235
050,26,103,"Michigan","Marquette County",3,76,458,229,229
050,26,103,"Michigan","Marquette County",3,77,420,198,222
050,26,103,"Michigan","Marquette County",3,78,423,211,212
050,26,103,"Michigan","Marquette County",3,79,359,178,181
050,26,103,"Michigan","Marquette County",3,80,307,143,164
050,26,103,"Michigan","Marquette County",3,81,276,121,155
050,26,103,"Michigan","Marquette County",3,82,282,122,160
050,26,103,"Michigan","Marquette County",3,83,265,114,151
050,26,103,"Michigan","Marquette County",3,84,241,107,134
050,26,103,"Michigan","Marquette County",3,85,1409,593,816
050,26,103,"Michigan","Marquette County",4,0,567,288,279
050,26,103,"Michigan","Marquette County",4,1,583,273,310
050,26,103,"Michigan","Marquette County",4,2,613,320,293
050,26,103,"Michigan","Marquette County",4,3,594,295,299
050,26,103,"Michigan","Marquette County",4,4,581,303,278
050,26,103,"Michigan","Marquette County",4,5,645,329,316
050,26,103,"Michigan","Marquette County",4,6,666,332,334
050,26,103,"Michigan","Marquette County",4,7,617,323,294
050,26,103,"Michigan","Marquette County",4,8,622,299,323
050,26,103,"Michigan","Marquette County",4,9,678,341,337
050,26,103,"Michigan","Marquette County",4,10,691,357,334
050,26,103,"Michigan","Marquette County",4,11,672,374,298
050,26,103,"Michigan","Marquette County",4,12,693,366,327
050,26,103,"Michigan","Marquette County",4,13,729,355,374
050,26,103,"Michigan","Marquette County",4,14,752,374,378
050,26,103,"Michigan","Marquette County",4,15,739,384,355
050,26,103,"Michigan","Marquette County",4,16,726,384,342
050,26,103,"Michigan","Marquette County",4,17,663,344,319
050,26,103,"Michigan","Marquette County",4,18,1067,461,606
050,26,103,"Michigan","Marquette County",4,19,1692,807,885
050,26,103,"Michigan","Marquette County",4,20,1755,879,876
050,26,103,"Michigan","Marquette County",4,21,1625,749,876
050,26,103,"Michigan","Marquette County",4,22,1568,785,783
050,26,103,"Michigan","Marquette County",4,23,1565,780,785
050,26,103,"Michigan","Marquette County",4,24,1073,584,489
050,26,103,"Michigan","Marquette County",4,25,854,480,374
050,26,103,"Michigan","Marquette County",4,26,850,448,402
050,26,103,"Michigan","Marquette County",4,27,758,395,363
050,26,103,"Michigan","Marquette County",4,28,792,416,376
050,26,103,"Michigan","Marquette County",4,29,788,412,376
050,26,103,"Michigan","Marquette County",4,30,799,411,388
050,26,103,"Michigan","Marquette County",4,31,763,385,378
050,26,103,"Michigan","Marquette County",4,32,753,394,359
050,26,103,"Michigan","Marquette County",4,33,739,387,352
050,26,103,"Michigan","Marquette County",4,34,711,362,349
050,26,103,"Michigan","Marquette County",4,35,715,374,341
050,26,103,"Michigan","Marquette County",4,36,768,403,365
050,26,103,"Michigan","Marquette County",4,37,774,410,364
050,26,103,"Michigan","Marquette County",4,38,772,406,366
050,26,103,"Michigan","Marquette County",4,39,847,437,410
050,26,103,"Michigan","Marquette County",4,40,820,447,373
050,26,103,"Michigan","Marquette County",4,41,785,400,385
050,26,103,"Michigan","Marquette County",4,42,820,429,391
050,26,103,"Michigan","Marquette County",4,43,792,416,376
050,26,103,"Michigan","Marquette County",4,44,761,396,365
050,26,103,"Michigan","Marquette County",4,45,706,361,345
050,26,103,"Michigan","Marquette County",4,46,663,341,322
050,26,103,"Michigan","Marquette County",4,47,635,322,313
050,26,103,"Michigan","Marquette County",4,48,624,334,290
050,26,103,"Michigan","Marquette County",4,49,636,346,290
050,26,103,"Michigan","Marquette County",4,50,692,366,326
050,26,103,"Michigan","Marquette County",4,51,742,394,348
050,26,103,"Michigan","Marquette County",4,52,761,389,372
050,26,103,"Michigan","Marquette County",4,53,708,369,339
050,26,103,"Michigan","Marquette County",4,54,689,360,329
050,26,103,"Michigan","Marquette County",4,55,697,366,331
050,26,103,"Michigan","Marquette County",4,56,691,353,338
050,26,103,"Michigan","Marquette County",4,57,761,383,378
050,26,103,"Michigan","Marquette County",4,58,842,425,417
050,26,103,"Michigan","Marquette County",4,59,829,412,417
050,26,103,"Michigan","Marquette County",4,60,874,444,430
050,26,103,"Michigan","Marquette County",4,61,899,441,458
050,26,103,"Michigan","Marquette County",4,62,886,422,464
050,26,103,"Michigan","Marquette County",4,63,897,424,473
050,26,103,"Michigan","Marquette County",4,64,911,449,462
050,26,103,"Michigan","Marquette County",4,65,911,441,470
050,26,103,"Michigan","Marquette County",4,66,928,472,456
050,26,103,"Michigan","Marquette County",4,67,919,461,458
050,26,103,"Michigan","Marquette County",4,68,919,444,475
050,26,103,"Michigan","Marquette County",4,69,905,446,459
050,26,103,"Michigan","Marquette County",4,70,861,433,428
050,26,103,"Michigan","Marquette County",4,71,814,422,392
050,26,103,"Michigan","Marquette County",4,72,747,391,356
050,26,103,"Michigan","Marquette County",4,73,690,355,335
050,26,103,"Michigan","Marquette County",4,74,660,335,325
050,26,103,"Michigan","Marquette County",4,75,708,364,344
050,26,103,"Michigan","Marquette County",4,76,479,246,233
050,26,103,"Michigan","Marquette County",4,77,426,211,215
050,26,103,"Michigan","Marquette County",4,78,395,178,217
050,26,103,"Michigan","Marquette County",4,79,406,206,200
050,26,103,"Michigan","Marquette County",4,80,345,170,175
050,26,103,"Michigan","Marquette County",4,81,284,138,146
050,26,103,"Michigan","Marquette County",4,82,262,113,149
050,26,103,"Michigan","Marquette County",4,83,253,109,144
050,26,103,"Michigan","Marquette County",4,84,245,97,148
050,26,103,"Michigan","Marquette County",4,85,1411,587,824
050,26,103,"Michigan","Marquette County",5,0,560,283,277
050,26,103,"Michigan","Marquette County",5,1,568,289,279
050,26,103,"Michigan","Marquette County",5,2,581,273,308
050,26,103,"Michigan","Marquette County",5,3,614,319,295
050,26,103,"Michigan","Marquette County",5,4,597,296,301
050,26,103,"Michigan","Marquette County",5,5,598,311,287
050,26,103,"Michigan","Marquette County",5,6,644,321,323
050,26,103,"Michigan","Marquette County",5,7,658,335,323
050,26,103,"Michigan","Marquette County",5,8,618,324,294
050,26,103,"Michigan","Marquette County",5,9,633,309,324
050,26,103,"Michigan","Marquette County",5,10,683,342,341
050,26,103,"Michigan","Marquette County",5,11,689,354,335
050,26,103,"Michigan","Marquette County",5,12,673,368,305
050,26,103,"Michigan","Marquette County",5,13,698,371,327
050,26,103,"Michigan","Marquette County",5,14,723,346,377
050,26,103,"Michigan","Marquette County",5,15,755,383,372
050,26,103,"Michigan","Marquette County",5,16,751,385,366
050,26,103,"Michigan","Marquette County",5,17,712,374,338
050,26,103,"Michigan","Marquette County",5,18,1083,480,603
050,26,103,"Michigan","Marquette County",5,19,1738,826,912
050,26,103,"Michigan","Marquette County",5,20,1767,889,878
050,26,103,"Michigan","Marquette County",5,21,1614,728,886
050,26,103,"Michigan","Marquette County",5,22,1552,799,753
050,26,103,"Michigan","Marquette County",5,23,1592,784,808
050,26,103,"Michigan","Marquette County",5,24,1097,561,536
050,26,103,"Michigan","Marquette County",5,25,951,521,430
050,26,103,"Michigan","Marquette County",5,26,783,425,358
050,26,103,"Michigan","Marquette County",5,27,792,410,382
050,26,103,"Michigan","Marquette County",5,28,804,414,390
050,26,103,"Michigan","Marquette County",5,29,784,417,367
050,26,103,"Michigan","Marquette County",5,30,800,408,392
050,26,103,"Michigan","Marquette County",5,31,788,427,361
050,26,103,"Michigan","Marquette County",5,32,807,411,396
050,26,103,"Michigan","Marquette County",5,33,776,397,379
050,26,103,"Michigan","Marquette County",5,34,731,385,346
050,26,103,"Michigan","Marquette County",5,35,751,398,353
050,26,103,"Michigan","Marquette County",5,36,739,391,348
050,26,103,"Michigan","Marquette County",5,37,772,413,359
050,26,103,"Michigan","Marquette County",5,38,792,417,375
050,26,103,"Michigan","Marquette County",5,39,803,422,381
050,26,103,"Michigan","Marquette County",5,40,855,453,402
050,26,103,"Michigan","Marquette County",5,41,830,451,379
050,26,103,"Michigan","Marquette County",5,42,799,407,392
050,26,103,"Michigan","Marquette County",5,43,828,436,392
050,26,103,"Michigan","Marquette County",5,44,788,412,376
050,26,103,"Michigan","Marquette County",5,45,782,414,368
050,26,103,"Michigan","Marquette County",5,46,715,370,345
050,26,103,"Michigan","Marquette County",5,47,655,333,322
050,26,103,"Michigan","Marquette County",5,48,655,335,320
050,26,103,"Michigan","Marquette County",5,49,620,338,282
050,26,103,"Michigan","Marquette County",5,50,649,348,301
050,26,103,"Michigan","Marquette County",5,51,695,368,327
050,26,103,"Michigan","Marquette County",5,52,754,400,354
050,26,103,"Michigan","Marquette County",5,53,747,383,364
050,26,103,"Michigan","Marquette County",5,54,702,359,343
050,26,103,"Michigan","Marquette County",5,55,677,362,315
050,26,103,"Michigan","Marquette County",5,56,694,372,322
050,26,103,"Michigan","Marquette County",5,57,694,351,343
050,26,103,"Michigan","Marquette County",5,58,751,388,363
050,26,103,"Michigan","Marquette County",5,59,836,416,420
050,26,103,"Michigan","Marquette County",5,60,827,413,414
050,26,103,"Michigan","Marquette County",5,61,863,436,427
050,26,103,"Michigan","Marquette County",5,62,889,437,452
050,26,103,"Michigan","Marquette County",5,63,870,408,462
050,26,103,"Michigan","Marquette County",5,64,892,423,469
050,26,103,"Michigan","Marquette County",5,65,894,438,456
050,26,103,"Michigan","Marquette County",5,66,891,430,461
050,26,103,"Michigan","Marquette County",5,67,916,463,453
050,26,103,"Michigan","Marquette County",5,68,891,449,442
050,26,103,"Michigan","Marquette County",5,69,913,438,475
050,26,103,"Michigan","Marquette County",5,70,885,429,456
050,26,103,"Michigan","Marquette County",5,71,845,426,419
050,26,103,"Michigan","Marquette County",5,72,794,407,387
050,26,103,"Michigan","Marquette County",5,73,729,383,346
050,26,103,"Michigan","Marquette County",5,74,675,344,331
050,26,103,"Michigan","Marquette County",5,75,642,323,319
050,26,103,"Michigan","Marquette County",5,76,702,356,346
050,26,103,"Michigan","Marquette County",5,77,451,231,220
050,26,103,"Michigan","Marquette County",5,78,403,192,211
050,26,103,"Michigan","Marquette County",5,79,375,174,201
050,26,103,"Michigan","Marquette County",5,80,387,193,194
050,26,103,"Michigan","Marquette County",5,81,311,154,157
050,26,103,"Michigan","Marquette County",5,82,264,127,137
050,26,103,"Michigan","Marquette County",5,83,228,97,131
050,26,103,"Michigan","Marquette County",5,84,236,99,137
050,26,103,"Michigan","Marquette County",5,85,1429,578,851
050,26,105,"Michigan","Mason County",1,0,244,126,118
050,26,105,"Michigan","Mason County",1,1,266,134,132
050,26,105,"Michigan","Mason County",1,2,320,163,157
050,26,105,"Michigan","Mason County",1,3,295,160,135
050,26,105,"Michigan","Mason County",1,4,329,172,157
050,26,105,"Michigan","Mason County",1,5,320,159,161
050,26,105,"Michigan","Mason County",1,6,291,158,133
050,26,105,"Michigan","Mason County",1,7,303,160,143
050,26,105,"Michigan","Mason County",1,8,316,169,147
050,26,105,"Michigan","Mason County",1,9,339,196,143
050,26,105,"Michigan","Mason County",1,10,345,170,175
050,26,105,"Michigan","Mason County",1,11,380,183,197
050,26,105,"Michigan","Mason County",1,12,349,178,171
050,26,105,"Michigan","Mason County",1,13,393,212,181
050,26,105,"Michigan","Mason County",1,14,367,187,180
050,26,105,"Michigan","Mason County",1,15,338,168,170
050,26,105,"Michigan","Mason County",1,16,383,205,178
050,26,105,"Michigan","Mason County",1,17,348,189,159
050,26,105,"Michigan","Mason County",1,18,277,143,134
050,26,105,"Michigan","Mason County",1,19,241,129,112
050,26,105,"Michigan","Mason County",1,20,260,136,124
050,26,105,"Michigan","Mason County",1,21,291,162,129
050,26,105,"Michigan","Mason County",1,22,270,149,121
050,26,105,"Michigan","Mason County",1,23,261,149,112
050,26,105,"Michigan","Mason County",1,24,277,150,127
050,26,105,"Michigan","Mason County",1,25,309,166,143
050,26,105,"Michigan","Mason County",1,26,298,156,142
050,26,105,"Michigan","Mason County",1,27,312,155,157
050,26,105,"Michigan","Mason County",1,28,327,162,165
050,26,105,"Michigan","Mason County",1,29,315,156,159
050,26,105,"Michigan","Mason County",1,30,307,151,156
050,26,105,"Michigan","Mason County",1,31,278,145,133
050,26,105,"Michigan","Mason County",1,32,296,142,154
050,26,105,"Michigan","Mason County",1,33,287,148,139
050,26,105,"Michigan","Mason County",1,34,296,154,142
050,26,105,"Michigan","Mason County",1,35,299,151,148
050,26,105,"Michigan","Mason County",1,36,289,149,140
050,26,105,"Michigan","Mason County",1,37,338,181,157
050,26,105,"Michigan","Mason County",1,38,341,163,178
050,26,105,"Michigan","Mason County",1,39,360,170,190
050,26,105,"Michigan","Mason County",1,40,319,164,155
050,26,105,"Michigan","Mason County",1,41,305,155,150
050,26,105,"Michigan","Mason County",1,42,294,154,140
050,26,105,"Michigan","Mason County",1,43,296,141,155
050,26,105,"Michigan","Mason County",1,44,291,133,158
050,26,105,"Michigan","Mason County",1,45,289,155,134
050,26,105,"Michigan","Mason County",1,46,278,141,137
050,26,105,"Michigan","Mason County",1,47,291,151,140
050,26,105,"Michigan","Mason County",1,48,332,162,170
050,26,105,"Michigan","Mason County",1,49,360,168,192
050,26,105,"Michigan","Mason County",1,50,319,151,168
050,26,105,"Michigan","Mason County",1,51,320,175,145
050,26,105,"Michigan","Mason County",1,52,343,172,171
050,26,105,"Michigan","Mason County",1,53,345,165,180
050,26,105,"Michigan","Mason County",1,54,368,186,182
050,26,105,"Michigan","Mason County",1,55,397,196,201
050,26,105,"Michigan","Mason County",1,56,424,202,222
050,26,105,"Michigan","Mason County",1,57,450,221,229
050,26,105,"Michigan","Mason County",1,58,474,242,232
050,26,105,"Michigan","Mason County",1,59,436,210,226
050,26,105,"Michigan","Mason County",1,60,481,236,245
050,26,105,"Michigan","Mason County",1,61,509,255,254
050,26,105,"Michigan","Mason County",1,62,481,254,227
050,26,105,"Michigan","Mason County",1,63,498,241,257
050,26,105,"Michigan","Mason County",1,64,534,260,274
050,26,105,"Michigan","Mason County",1,65,528,270,258
050,26,105,"Michigan","Mason County",1,66,521,256,265
050,26,105,"Michigan","Mason County",1,67,520,253,267
050,26,105,"Michigan","Mason County",1,68,499,249,250
050,26,105,"Michigan","Mason County",1,69,447,221,226
050,26,105,"Michigan","Mason County",1,70,431,233,198
050,26,105,"Michigan","Mason County",1,71,401,201,200
050,26,105,"Michigan","Mason County",1,72,388,190,198
050,26,105,"Michigan","Mason County",1,73,395,190,205
050,26,105,"Michigan","Mason County",1,74,252,122,130
050,26,105,"Michigan","Mason County",1,75,265,128,137
050,26,105,"Michigan","Mason County",1,76,249,119,130
050,26,105,"Michigan","Mason County",1,77,272,130,142
050,26,105,"Michigan","Mason County",1,78,224,109,115
050,26,105,"Michigan","Mason County",1,79,208,97,111
050,26,105,"Michigan","Mason County",1,80,194,86,108
050,26,105,"Michigan","Mason County",1,81,189,91,98
050,26,105,"Michigan","Mason County",1,82,158,65,93
050,26,105,"Michigan","Mason County",1,83,159,61,98
050,26,105,"Michigan","Mason County",1,84,131,60,71
050,26,105,"Michigan","Mason County",1,85,733,245,488
050,26,105,"Michigan","Mason County",2,0,242,124,118
050,26,105,"Michigan","Mason County",2,1,263,133,130
050,26,105,"Michigan","Mason County",2,2,309,158,151
050,26,105,"Michigan","Mason County",2,3,298,159,139
050,26,105,"Michigan","Mason County",2,4,321,168,153
050,26,105,"Michigan","Mason County",2,5,320,162,158
050,26,105,"Michigan","Mason County",2,6,298,158,140
050,26,105,"Michigan","Mason County",2,7,300,159,141
050,26,105,"Michigan","Mason County",2,8,312,166,146
050,26,105,"Michigan","Mason County",2,9,333,188,145
050,26,105,"Michigan","Mason County",2,10,345,177,168
050,26,105,"Michigan","Mason County",2,11,370,180,190
050,26,105,"Michigan","Mason County",2,12,361,182,179
050,26,105,"Michigan","Mason County",2,13,385,204,181
050,26,105,"Michigan","Mason County",2,14,372,193,179
050,26,105,"Michigan","Mason County",2,15,347,172,175
050,26,105,"Michigan","Mason County",2,16,374,196,178
050,26,105,"Michigan","Mason County",2,17,355,192,163
050,26,105,"Michigan","Mason County",2,18,279,148,131
050,26,105,"Michigan","Mason County",2,19,237,125,112
050,26,105,"Michigan","Mason County",2,20,264,139,125
050,26,105,"Michigan","Mason County",2,21,285,156,129
050,26,105,"Michigan","Mason County",2,22,277,152,125
050,26,105,"Michigan","Mason County",2,23,265,151,114
050,26,105,"Michigan","Mason County",2,24,275,151,124
050,26,105,"Michigan","Mason County",2,25,301,165,136
050,26,105,"Michigan","Mason County",2,26,299,158,141
050,26,105,"Michigan","Mason County",2,27,308,154,154
050,26,105,"Michigan","Mason County",2,28,320,158,162
050,26,105,"Michigan","Mason County",2,29,318,158,160
050,26,105,"Michigan","Mason County",2,30,309,152,157
050,26,105,"Michigan","Mason County",2,31,283,145,138
050,26,105,"Michigan","Mason County",2,32,288,140,148
050,26,105,"Michigan","Mason County",2,33,288,147,141
050,26,105,"Michigan","Mason County",2,34,294,152,142
050,26,105,"Michigan","Mason County",2,35,299,152,147
050,26,105,"Michigan","Mason County",2,36,289,148,141
050,26,105,"Michigan","Mason County",2,37,327,175,152
050,26,105,"Michigan","Mason County",2,38,344,170,174
050,26,105,"Michigan","Mason County",2,39,355,170,185
050,26,105,"Michigan","Mason County",2,40,332,167,165
050,26,105,"Michigan","Mason County",2,41,311,159,152
050,26,105,"Michigan","Mason County",2,42,295,155,140
050,26,105,"Michigan","Mason County",2,43,296,145,151
050,26,105,"Michigan","Mason County",2,44,290,134,156
050,26,105,"Michigan","Mason County",2,45,292,151,141
050,26,105,"Michigan","Mason County",2,46,281,144,137
050,26,105,"Michigan","Mason County",2,47,286,147,139
050,26,105,"Michigan","Mason County",2,48,323,161,162
050,26,105,"Michigan","Mason County",2,49,355,167,188
050,26,105,"Michigan","Mason County",2,50,330,155,175
050,26,105,"Michigan","Mason County",2,51,321,170,151
050,26,105,"Michigan","Mason County",2,52,338,173,165
050,26,105,"Michigan","Mason County",2,53,345,167,178
050,26,105,"Michigan","Mason County",2,54,358,179,179
050,26,105,"Michigan","Mason County",2,55,386,191,195
050,26,105,"Michigan","Mason County",2,56,422,203,219
050,26,105,"Michigan","Mason County",2,57,445,217,228
050,26,105,"Michigan","Mason County",2,58,465,234,231
050,26,105,"Michigan","Mason County",2,59,451,221,230
050,26,105,"Michigan","Mason County",2,60,469,229,240
050,26,105,"Michigan","Mason County",2,61,499,248,251
050,26,105,"Michigan","Mason County",2,62,486,253,233
050,26,105,"Michigan","Mason County",2,63,501,248,253
050,26,105,"Michigan","Mason County",2,64,525,256,269
050,26,105,"Michigan","Mason County",2,65,531,268,263
050,26,105,"Michigan","Mason County",2,66,525,261,264
050,26,105,"Michigan","Mason County",2,67,521,255,266
050,26,105,"Michigan","Mason County",2,68,499,247,252
050,26,105,"Michigan","Mason County",2,69,465,231,234
050,26,105,"Michigan","Mason County",2,70,436,230,206
050,26,105,"Michigan","Mason County",2,71,405,206,199
050,26,105,"Michigan","Mason County",2,72,381,187,194
050,26,105,"Michigan","Mason County",2,73,410,199,211
050,26,105,"Michigan","Mason County",2,74,267,129,138
050,26,105,"Michigan","Mason County",2,75,263,128,135
050,26,105,"Michigan","Mason County",2,76,247,117,130
050,26,105,"Michigan","Mason County",2,77,269,127,142
050,26,105,"Michigan","Mason County",2,78,227,109,118
050,26,105,"Michigan","Mason County",2,79,207,98,109
050,26,105,"Michigan","Mason County",2,80,195,87,108
050,26,105,"Michigan","Mason County",2,81,187,89,98
050,26,105,"Michigan","Mason County",2,82,164,72,92
050,26,105,"Michigan","Mason County",2,83,155,60,95
050,26,105,"Michigan","Mason County",2,84,133,59,74
050,26,105,"Michigan","Mason County",2,85,735,248,487
050,26,105,"Michigan","Mason County",3,0,229,118,111
050,26,105,"Michigan","Mason County",3,1,248,125,123
050,26,105,"Michigan","Mason County",3,2,270,142,128
050,26,105,"Michigan","Mason County",3,3,305,161,144
050,26,105,"Michigan","Mason County",3,4,311,156,155
050,26,105,"Michigan","Mason County",3,5,325,169,156
050,26,105,"Michigan","Mason County",3,6,331,167,164
050,26,105,"Michigan","Mason County",3,7,308,168,140
050,26,105,"Michigan","Mason County",3,8,314,170,144
050,26,105,"Michigan","Mason County",3,9,317,168,149
050,26,105,"Michigan","Mason County",3,10,347,194,153
050,26,105,"Michigan","Mason County",3,11,360,186,174
050,26,105,"Michigan","Mason County",3,12,373,188,185
050,26,105,"Michigan","Mason County",3,13,371,194,177
050,26,105,"Michigan","Mason County",3,14,389,204,185
050,26,105,"Michigan","Mason County",3,15,366,189,177
050,26,105,"Michigan","Mason County",3,16,353,174,179
050,26,105,"Michigan","Mason County",3,17,375,194,181
050,26,105,"Michigan","Mason County",3,18,306,171,135
050,26,105,"Michigan","Mason County",3,19,236,122,114
050,26,105,"Michigan","Mason County",3,20,272,138,134
050,26,105,"Michigan","Mason County",3,21,280,146,134
050,26,105,"Michigan","Mason County",3,22,298,156,142
050,26,105,"Michigan","Mason County",3,23,291,163,128
050,26,105,"Michigan","Mason County",3,24,262,149,113
050,26,105,"Michigan","Mason County",3,25,302,168,134
050,26,105,"Michigan","Mason County",3,26,306,158,148
050,26,105,"Michigan","Mason County",3,27,306,150,156
050,26,105,"Michigan","Mason County",3,28,313,153,160
050,26,105,"Michigan","Mason County",3,29,329,169,160
050,26,105,"Michigan","Mason County",3,30,337,167,170
050,26,105,"Michigan","Mason County",3,31,332,160,172
050,26,105,"Michigan","Mason County",3,32,285,146,139
050,26,105,"Michigan","Mason County",3,33,298,146,152
050,26,105,"Michigan","Mason County",3,34,294,148,146
050,26,105,"Michigan","Mason County",3,35,308,156,152
050,26,105,"Michigan","Mason County",3,36,305,150,155
050,26,105,"Michigan","Mason County",3,37,291,152,139
050,26,105,"Michigan","Mason County",3,38,325,172,153
050,26,105,"Michigan","Mason County",3,39,343,171,172
050,26,105,"Michigan","Mason County",3,40,367,176,191
050,26,105,"Michigan","Mason County",3,41,340,168,172
050,26,105,"Michigan","Mason County",3,42,307,156,151
050,26,105,"Michigan","Mason County",3,43,293,147,146
050,26,105,"Michigan","Mason County",3,44,306,150,156
050,26,105,"Michigan","Mason County",3,45,303,137,166
050,26,105,"Michigan","Mason County",3,46,297,155,142
050,26,105,"Michigan","Mason County",3,47,285,145,140
050,26,105,"Michigan","Mason County",3,48,289,147,142
050,26,105,"Michigan","Mason County",3,49,327,163,164
050,26,105,"Michigan","Mason County",3,50,356,165,191
050,26,105,"Michigan","Mason County",3,51,347,164,183
050,26,105,"Michigan","Mason County",3,52,325,164,161
050,26,105,"Michigan","Mason County",3,53,330,172,158
050,26,105,"Michigan","Mason County",3,54,357,167,190
050,26,105,"Michigan","Mason County",3,55,359,179,180
050,26,105,"Michigan","Mason County",3,56,387,193,194
050,26,105,"Michigan","Mason County",3,57,430,210,220
050,26,105,"Michigan","Mason County",3,58,450,223,227
050,26,105,"Michigan","Mason County",3,59,462,230,232
050,26,105,"Michigan","Mason County",3,60,469,226,243
050,26,105,"Michigan","Mason County",3,61,479,233,246
050,26,105,"Michigan","Mason County",3,62,497,249,248
050,26,105,"Michigan","Mason County",3,63,490,251,239
050,26,105,"Michigan","Mason County",3,64,508,253,255
050,26,105,"Michigan","Mason County",3,65,537,264,273
050,26,105,"Michigan","Mason County",3,66,541,275,266
050,26,105,"Michigan","Mason County",3,67,526,262,264
050,26,105,"Michigan","Mason County",3,68,520,254,266
050,26,105,"Michigan","Mason County",3,69,498,247,251
050,26,105,"Michigan","Mason County",3,70,470,236,234
050,26,105,"Michigan","Mason County",3,71,425,228,197
050,26,105,"Michigan","Mason County",3,72,399,200,199
050,26,105,"Michigan","Mason County",3,73,367,183,184
050,26,105,"Michigan","Mason County",3,74,397,196,201
050,26,105,"Michigan","Mason County",3,75,261,128,133
050,26,105,"Michigan","Mason County",3,76,244,118,126
050,26,105,"Michigan","Mason County",3,77,234,110,124
050,26,105,"Michigan","Mason County",3,78,242,106,136
050,26,105,"Michigan","Mason County",3,79,208,99,109
050,26,105,"Michigan","Mason County",3,80,194,87,107
050,26,105,"Michigan","Mason County",3,81,186,87,99
050,26,105,"Michigan","Mason County",3,82,174,81,93
050,26,105,"Michigan","Mason County",3,83,148,59,89
050,26,105,"Michigan","Mason County",3,84,130,52,78
050,26,105,"Michigan","Mason County",3,85,767,271,496
050,26,105,"Michigan","Mason County",4,0,231,114,117
050,26,105,"Michigan","Mason County",4,1,230,114,116
050,26,105,"Michigan","Mason County",4,2,265,141,124
050,26,105,"Michigan","Mason County",4,3,277,139,138
050,26,105,"Michigan","Mason County",4,4,297,159,138
050,26,105,"Michigan","Mason County",4,5,324,172,152
050,26,105,"Michigan","Mason County",4,6,334,178,156
050,26,105,"Michigan","Mason County",4,7,323,163,160
050,26,105,"Michigan","Mason County",4,8,301,158,143
050,26,105,"Michigan","Mason County",4,9,317,169,148
050,26,105,"Michigan","Mason County",4,10,311,164,147
050,26,105,"Michigan","Mason County",4,11,342,189,153
050,26,105,"Michigan","Mason County",4,12,358,181,177
050,26,105,"Michigan","Mason County",4,13,359,178,181
050,26,105,"Michigan","Mason County",4,14,371,196,175
050,26,105,"Michigan","Mason County",4,15,390,200,190
050,26,105,"Michigan","Mason County",4,16,369,189,180
050,26,105,"Michigan","Mason County",4,17,349,176,173
050,26,105,"Michigan","Mason County",4,18,317,169,148
050,26,105,"Michigan","Mason County",4,19,239,135,104
050,26,105,"Michigan","Mason County",4,20,248,132,116
050,26,105,"Michigan","Mason County",4,21,275,136,139
050,26,105,"Michigan","Mason County",4,22,295,154,141
050,26,105,"Michigan","Mason County",4,23,323,173,150
050,26,105,"Michigan","Mason County",4,24,299,151,148
050,26,105,"Michigan","Mason County",4,25,272,158,114
050,26,105,"Michigan","Mason County",4,26,277,149,128
050,26,105,"Michigan","Mason County",4,27,311,161,150
050,26,105,"Michigan","Mason County",4,28,308,160,148
050,26,105,"Michigan","Mason County",4,29,311,158,153
050,26,105,"Michigan","Mason County",4,30,326,169,157
050,26,105,"Michigan","Mason County",4,31,341,169,172
050,26,105,"Michigan","Mason County",4,32,319,151,168
050,26,105,"Michigan","Mason County",4,33,295,149,146
050,26,105,"Michigan","Mason County",4,34,306,156,150
050,26,105,"Michigan","Mason County",4,35,301,150,151
050,26,105,"Michigan","Mason County",4,36,307,157,150
050,26,105,"Michigan","Mason County",4,37,311,150,161
050,26,105,"Michigan","Mason County",4,38,302,155,147
050,26,105,"Michigan","Mason County",4,39,337,178,159
050,26,105,"Michigan","Mason County",4,40,353,180,173
050,26,105,"Michigan","Mason County",4,41,366,173,193
050,26,105,"Michigan","Mason County",4,42,343,176,167
050,26,105,"Michigan","Mason County",4,43,316,162,154
050,26,105,"Michigan","Mason County",4,44,301,152,149
050,26,105,"Michigan","Mason County",4,45,300,143,157
050,26,105,"Michigan","Mason County",4,46,302,133,169
050,26,105,"Michigan","Mason County",4,47,300,154,146
050,26,105,"Michigan","Mason County",4,48,295,150,145
050,26,105,"Michigan","Mason County",4,49,297,150,147
050,26,105,"Michigan","Mason County",4,50,325,163,162
050,26,105,"Michigan","Mason County",4,51,369,181,188
050,26,105,"Michigan","Mason County",4,52,350,163,187
050,26,105,"Michigan","Mason County",4,53,329,171,158
050,26,105,"Michigan","Mason County",4,54,326,169,157
050,26,105,"Michigan","Mason County",4,55,355,164,191
050,26,105,"Michigan","Mason County",4,56,369,187,182
050,26,105,"Michigan","Mason County",4,57,402,202,200
050,26,105,"Michigan","Mason County",4,58,425,203,222
050,26,105,"Michigan","Mason County",4,59,450,221,229
050,26,105,"Michigan","Mason County",4,60,471,230,241
050,26,105,"Michigan","Mason County",4,61,479,227,252
050,26,105,"Michigan","Mason County",4,62,486,234,252
050,26,105,"Michigan","Mason County",4,63,498,248,250
050,26,105,"Michigan","Mason County",4,64,503,263,240
050,26,105,"Michigan","Mason County",4,65,512,257,255
050,26,105,"Michigan","Mason County",4,66,546,263,283
050,26,105,"Michigan","Mason County",4,67,549,279,270
050,26,105,"Michigan","Mason County",4,68,521,261,260
050,26,105,"Michigan","Mason County",4,69,502,242,260
050,26,105,"Michigan","Mason County",4,70,494,245,249
050,26,105,"Michigan","Mason County",4,71,451,225,226
050,26,105,"Michigan","Mason County",4,72,410,218,192
050,26,105,"Michigan","Mason County",4,73,386,197,189
050,26,105,"Michigan","Mason County",4,74,353,178,175
050,26,105,"Michigan","Mason County",4,75,389,195,194
050,26,105,"Michigan","Mason County",4,76,246,119,127
050,26,105,"Michigan","Mason County",4,77,235,109,126
050,26,105,"Michigan","Mason County",4,78,215,99,116
050,26,105,"Michigan","Mason County",4,79,228,94,134
050,26,105,"Michigan","Mason County",4,80,194,94,100
050,26,105,"Michigan","Mason County",4,81,188,86,102
050,26,105,"Michigan","Mason County",4,82,177,82,95
050,26,105,"Michigan","Mason County",4,83,161,70,91
050,26,105,"Michigan","Mason County",4,84,123,51,72
050,26,105,"Michigan","Mason County",4,85,760,266,494
050,26,105,"Michigan","Mason County",5,0,231,114,117
050,26,105,"Michigan","Mason County",5,1,222,106,116
050,26,105,"Michigan","Mason County",5,2,230,111,119
050,26,105,"Michigan","Mason County",5,3,256,133,123
050,26,105,"Michigan","Mason County",5,4,278,137,141
050,26,105,"Michigan","Mason County",5,5,293,156,137
050,26,105,"Michigan","Mason County",5,6,309,157,152
050,26,105,"Michigan","Mason County",5,7,325,168,157
050,26,105,"Michigan","Mason County",5,8,327,158,169
050,26,105,"Michigan","Mason County",5,9,304,169,135
050,26,105,"Michigan","Mason County",5,10,316,169,147
050,26,105,"Michigan","Mason County",5,11,305,159,146
050,26,105,"Michigan","Mason County",5,12,348,193,155
050,26,105,"Michigan","Mason County",5,13,348,180,168
050,26,105,"Michigan","Mason County",5,14,359,175,184
050,26,105,"Michigan","Mason County",5,15,348,185,163
050,26,105,"Michigan","Mason County",5,16,387,205,182
050,26,105,"Michigan","Mason County",5,17,367,183,184
050,26,105,"Michigan","Mason County",5,18,286,153,133
050,26,105,"Michigan","Mason County",5,19,240,130,110
050,26,105,"Michigan","Mason County",5,20,265,146,119
050,26,105,"Michigan","Mason County",5,21,256,137,119
050,26,105,"Michigan","Mason County",5,22,299,146,153
050,26,105,"Michigan","Mason County",5,23,304,156,148
050,26,105,"Michigan","Mason County",5,24,324,174,150
050,26,105,"Michigan","Mason County",5,25,274,138,136
050,26,105,"Michigan","Mason County",5,26,280,160,120
050,26,105,"Michigan","Mason County",5,27,276,140,136
050,26,105,"Michigan","Mason County",5,28,306,158,148
050,26,105,"Michigan","Mason County",5,29,311,170,141
050,26,105,"Michigan","Mason County",5,30,321,163,158
050,26,105,"Michigan","Mason County",5,31,325,165,160
050,26,105,"Michigan","Mason County",5,32,342,168,174
050,26,105,"Michigan","Mason County",5,33,318,154,164
050,26,105,"Michigan","Mason County",5,34,298,153,145
050,26,105,"Michigan","Mason County",5,35,295,148,147
050,26,105,"Michigan","Mason County",5,36,304,155,149
050,26,105,"Michigan","Mason County",5,37,303,154,149
050,26,105,"Michigan","Mason County",5,38,322,153,169
050,26,105,"Michigan","Mason County",5,39,301,153,148
050,26,105,"Michigan","Mason County",5,40,334,179,155
050,26,105,"Michigan","Mason County",5,41,368,181,187
050,26,105,"Michigan","Mason County",5,42,356,174,182
050,26,105,"Michigan","Mason County",5,43,339,177,162
050,26,105,"Michigan","Mason County",5,44,318,164,154
050,26,105,"Michigan","Mason County",5,45,303,158,145
050,26,105,"Michigan","Mason County",5,46,314,151,163
050,26,105,"Michigan","Mason County",5,47,295,132,163
050,26,105,"Michigan","Mason County",5,48,298,156,142
050,26,105,"Michigan","Mason County",5,49,289,149,140
050,26,105,"Michigan","Mason County",5,50,304,155,149
050,26,105,"Michigan","Mason County",5,51,326,169,157
050,26,105,"Michigan","Mason County",5,52,363,177,186
050,26,105,"Michigan","Mason County",5,53,355,171,184
050,26,105,"Michigan","Mason County",5,54,333,170,163
050,26,105,"Michigan","Mason County",5,55,327,169,158
050,26,105,"Michigan","Mason County",5,56,366,168,198
050,26,105,"Michigan","Mason County",5,57,379,192,187
050,26,105,"Michigan","Mason County",5,58,401,206,195
050,26,105,"Michigan","Mason County",5,59,430,205,225
050,26,105,"Michigan","Mason County",5,60,462,231,231
050,26,105,"Michigan","Mason County",5,61,485,241,244
050,26,105,"Michigan","Mason County",5,62,480,222,258
050,26,105,"Michigan","Mason County",5,63,487,238,249
050,26,105,"Michigan","Mason County",5,64,514,256,258
050,26,105,"Michigan","Mason County",5,65,509,265,244
050,26,105,"Michigan","Mason County",5,66,504,251,253
050,26,105,"Michigan","Mason County",5,67,545,262,283
050,26,105,"Michigan","Mason County",5,68,533,271,262
050,26,105,"Michigan","Mason County",5,69,515,254,261
050,26,105,"Michigan","Mason County",5,70,510,244,266
050,26,105,"Michigan","Mason County",5,71,481,236,245
050,26,105,"Michigan","Mason County",5,72,444,214,230
050,26,105,"Michigan","Mason County",5,73,402,214,188
050,26,105,"Michigan","Mason County",5,74,363,186,177
050,26,105,"Michigan","Mason County",5,75,347,175,172
050,26,105,"Michigan","Mason County",5,76,378,188,190
050,26,105,"Michigan","Mason County",5,77,240,116,124
050,26,105,"Michigan","Mason County",5,78,213,99,114
050,26,105,"Michigan","Mason County",5,79,199,85,114
050,26,105,"Michigan","Mason County",5,80,221,91,130
050,26,105,"Michigan","Mason County",5,81,183,91,92
050,26,105,"Michigan","Mason County",5,82,176,81,95
050,26,105,"Michigan","Mason County",5,83,163,69,94
050,26,105,"Michigan","Mason County",5,84,137,62,75
050,26,105,"Michigan","Mason County",5,85,767,276,491
050,26,107,"Michigan","Mecosta County",1,0,395,203,192
050,26,107,"Michigan","Mecosta County",1,1,428,221,207
050,26,107,"Michigan","Mecosta County",1,2,402,200,202
050,26,107,"Michigan","Mecosta County",1,3,426,214,212
050,26,107,"Michigan","Mecosta County",1,4,426,218,208
050,26,107,"Michigan","Mecosta County",1,5,390,209,181
050,26,107,"Michigan","Mecosta County",1,6,394,220,174
050,26,107,"Michigan","Mecosta County",1,7,405,218,187
050,26,107,"Michigan","Mecosta County",1,8,411,225,186
050,26,107,"Michigan","Mecosta County",1,9,410,201,209
050,26,107,"Michigan","Mecosta County",1,10,435,218,217
050,26,107,"Michigan","Mecosta County",1,11,460,215,245
050,26,107,"Michigan","Mecosta County",1,12,473,240,233
050,26,107,"Michigan","Mecosta County",1,13,489,254,235
050,26,107,"Michigan","Mecosta County",1,14,489,247,242
050,26,107,"Michigan","Mecosta County",1,15,438,225,213
050,26,107,"Michigan","Mecosta County",1,16,458,228,230
050,26,107,"Michigan","Mecosta County",1,17,502,243,259
050,26,107,"Michigan","Mecosta County",1,18,583,285,298
050,26,107,"Michigan","Mecosta County",1,19,686,355,331
050,26,107,"Michigan","Mecosta County",1,20,831,408,423
050,26,107,"Michigan","Mecosta County",1,21,957,530,427
050,26,107,"Michigan","Mecosta County",1,22,986,521,465
050,26,107,"Michigan","Mecosta County",1,23,723,387,336
050,26,107,"Michigan","Mecosta County",1,24,658,377,281
050,26,107,"Michigan","Mecosta County",1,25,543,294,249
050,26,107,"Michigan","Mecosta County",1,26,443,239,204
050,26,107,"Michigan","Mecosta County",1,27,455,230,225
050,26,107,"Michigan","Mecosta County",1,28,423,218,205
050,26,107,"Michigan","Mecosta County",1,29,434,231,203
050,26,107,"Michigan","Mecosta County",1,30,469,241,228
050,26,107,"Michigan","Mecosta County",1,31,445,235,210
050,26,107,"Michigan","Mecosta County",1,32,411,202,209
050,26,107,"Michigan","Mecosta County",1,33,438,233,205
050,26,107,"Michigan","Mecosta County",1,34,391,196,195
050,26,107,"Michigan","Mecosta County",1,35,380,180,200
050,26,107,"Michigan","Mecosta County",1,36,412,202,210
050,26,107,"Michigan","Mecosta County",1,37,385,198,187
050,26,107,"Michigan","Mecosta County",1,38,394,212,182
050,26,107,"Michigan","Mecosta County",1,39,440,227,213
050,26,107,"Michigan","Mecosta County",1,40,442,221,221
050,26,107,"Michigan","Mecosta County",1,41,385,199,186
050,26,107,"Michigan","Mecosta County",1,42,399,214,185
050,26,107,"Michigan","Mecosta County",1,43,400,199,201
050,26,107,"Michigan","Mecosta County",1,44,365,186,179
050,26,107,"Michigan","Mecosta County",1,45,385,184,201
050,26,107,"Michigan","Mecosta County",1,46,390,188,202
050,26,107,"Michigan","Mecosta County",1,47,381,186,195
050,26,107,"Michigan","Mecosta County",1,48,396,194,202
050,26,107,"Michigan","Mecosta County",1,49,448,219,229
050,26,107,"Michigan","Mecosta County",1,50,452,235,217
050,26,107,"Michigan","Mecosta County",1,51,461,248,213
050,26,107,"Michigan","Mecosta County",1,52,438,217,221
050,26,107,"Michigan","Mecosta County",1,53,448,215,233
050,26,107,"Michigan","Mecosta County",1,54,506,247,259
050,26,107,"Michigan","Mecosta County",1,55,519,269,250
050,26,107,"Michigan","Mecosta County",1,56,548,275,273
050,26,107,"Michigan","Mecosta County",1,57,529,269,260
050,26,107,"Michigan","Mecosta County",1,58,599,303,296
050,26,107,"Michigan","Mecosta County",1,59,623,317,306
050,26,107,"Michigan","Mecosta County",1,60,615,318,297
050,26,107,"Michigan","Mecosta County",1,61,613,303,310
050,26,107,"Michigan","Mecosta County",1,62,608,289,319
050,26,107,"Michigan","Mecosta County",1,63,595,298,297
050,26,107,"Michigan","Mecosta County",1,64,568,280,288
050,26,107,"Michigan","Mecosta County",1,65,577,290,287
050,26,107,"Michigan","Mecosta County",1,66,557,268,289
050,26,107,"Michigan","Mecosta County",1,67,556,282,274
050,26,107,"Michigan","Mecosta County",1,68,542,264,278
050,26,107,"Michigan","Mecosta County",1,69,477,231,246
050,26,107,"Michigan","Mecosta County",1,70,447,206,241
050,26,107,"Michigan","Mecosta County",1,71,444,213,231
050,26,107,"Michigan","Mecosta County",1,72,461,233,228
050,26,107,"Michigan","Mecosta County",1,73,432,213,219
050,26,107,"Michigan","Mecosta County",1,74,314,149,165
050,26,107,"Michigan","Mecosta County",1,75,306,146,160
050,26,107,"Michigan","Mecosta County",1,76,319,162,157
050,26,107,"Michigan","Mecosta County",1,77,322,149,173
050,26,107,"Michigan","Mecosta County",1,78,285,140,145
050,26,107,"Michigan","Mecosta County",1,79,265,127,138
050,26,107,"Michigan","Mecosta County",1,80,230,110,120
050,26,107,"Michigan","Mecosta County",1,81,218,97,121
050,26,107,"Michigan","Mecosta County",1,82,183,81,102
050,26,107,"Michigan","Mecosta County",1,83,145,67,78
050,26,107,"Michigan","Mecosta County",1,84,129,57,72
050,26,107,"Michigan","Mecosta County",1,85,666,232,434
050,26,107,"Michigan","Mecosta County",2,0,415,205,210
050,26,107,"Michigan","Mecosta County",2,1,423,216,207
050,26,107,"Michigan","Mecosta County",2,2,408,203,205
050,26,107,"Michigan","Mecosta County",2,3,423,212,211
050,26,107,"Michigan","Mecosta County",2,4,425,217,208
050,26,107,"Michigan","Mecosta County",2,5,397,211,186
050,26,107,"Michigan","Mecosta County",2,6,390,216,174
050,26,107,"Michigan","Mecosta County",2,7,401,216,185
050,26,107,"Michigan","Mecosta County",2,8,407,220,187
050,26,107,"Michigan","Mecosta County",2,9,408,207,201
050,26,107,"Michigan","Mecosta County",2,10,430,214,216
050,26,107,"Michigan","Mecosta County",2,11,453,216,237
050,26,107,"Michigan","Mecosta County",2,12,474,237,237
050,26,107,"Michigan","Mecosta County",2,13,487,251,236
050,26,107,"Michigan","Mecosta County",2,14,491,250,241
050,26,107,"Michigan","Mecosta County",2,15,454,233,221
050,26,107,"Michigan","Mecosta County",2,16,459,231,228
050,26,107,"Michigan","Mecosta County",2,17,495,242,253
050,26,107,"Michigan","Mecosta County",2,18,581,283,298
050,26,107,"Michigan","Mecosta County",2,19,697,356,341
050,26,107,"Michigan","Mecosta County",2,20,838,413,425
050,26,107,"Michigan","Mecosta County",2,21,950,532,418
050,26,107,"Michigan","Mecosta County",2,22,995,525,470
050,26,107,"Michigan","Mecosta County",2,23,722,388,334
050,26,107,"Michigan","Mecosta County",2,24,648,369,279
050,26,107,"Michigan","Mecosta County",2,25,548,297,251
050,26,107,"Michigan","Mecosta County",2,26,451,241,210
050,26,107,"Michigan","Mecosta County",2,27,446,228,218
050,26,107,"Michigan","Mecosta County",2,28,431,222,209
050,26,107,"Michigan","Mecosta County",2,29,430,226,204
050,26,107,"Michigan","Mecosta County",2,30,461,238,223
050,26,107,"Michigan","Mecosta County",2,31,446,234,212
050,26,107,"Michigan","Mecosta County",2,32,421,212,209
050,26,107,"Michigan","Mecosta County",2,33,429,225,204
050,26,107,"Michigan","Mecosta County",2,34,401,202,199
050,26,107,"Michigan","Mecosta County",2,35,388,187,201
050,26,107,"Michigan","Mecosta County",2,36,403,196,207
050,26,107,"Michigan","Mecosta County",2,37,390,197,193
050,26,107,"Michigan","Mecosta County",2,38,393,209,184
050,26,107,"Michigan","Mecosta County",2,39,430,225,205
050,26,107,"Michigan","Mecosta County",2,40,445,225,220
050,26,107,"Michigan","Mecosta County",2,41,400,203,197
050,26,107,"Michigan","Mecosta County",2,42,395,211,184
050,26,107,"Michigan","Mecosta County",2,43,404,206,198
050,26,107,"Michigan","Mecosta County",2,44,369,187,182
050,26,107,"Michigan","Mecosta County",2,45,383,184,199
050,26,107,"Michigan","Mecosta County",2,46,389,187,202
050,26,107,"Michigan","Mecosta County",2,47,382,185,197
050,26,107,"Michigan","Mecosta County",2,48,394,193,201
050,26,107,"Michigan","Mecosta County",2,49,441,215,226
050,26,107,"Michigan","Mecosta County",2,50,455,232,223
050,26,107,"Michigan","Mecosta County",2,51,456,243,213
050,26,107,"Michigan","Mecosta County",2,52,444,224,220
050,26,107,"Michigan","Mecosta County",2,53,447,216,231
050,26,107,"Michigan","Mecosta County",2,54,494,239,255
050,26,107,"Michigan","Mecosta County",2,55,516,264,252
050,26,107,"Michigan","Mecosta County",2,56,546,277,269
050,26,107,"Michigan","Mecosta County",2,57,538,272,266
050,26,107,"Michigan","Mecosta County",2,58,577,290,287
050,26,107,"Michigan","Mecosta County",2,59,622,318,304
050,26,107,"Michigan","Mecosta County",2,60,619,317,302
050,26,107,"Michigan","Mecosta County",2,61,616,306,310
050,26,107,"Michigan","Mecosta County",2,62,614,295,319
050,26,107,"Michigan","Mecosta County",2,63,605,299,306
050,26,107,"Michigan","Mecosta County",2,64,571,283,288
050,26,107,"Michigan","Mecosta County",2,65,576,289,287
050,26,107,"Michigan","Mecosta County",2,66,562,274,288
050,26,107,"Michigan","Mecosta County",2,67,556,279,277
050,26,107,"Michigan","Mecosta County",2,68,544,266,278
050,26,107,"Michigan","Mecosta County",2,69,491,239,252
050,26,107,"Michigan","Mecosta County",2,70,452,211,241
050,26,107,"Michigan","Mecosta County",2,71,448,213,235
050,26,107,"Michigan","Mecosta County",2,72,445,223,222
050,26,107,"Michigan","Mecosta County",2,73,461,229,232
050,26,107,"Michigan","Mecosta County",2,74,319,153,166
050,26,107,"Michigan","Mecosta County",2,75,306,147,159
050,26,107,"Michigan","Mecosta County",2,76,309,154,155
050,26,107,"Michigan","Mecosta County",2,77,325,154,171
050,26,107,"Michigan","Mecosta County",2,78,282,137,145
050,26,107,"Michigan","Mecosta County",2,79,264,126,138
050,26,107,"Michigan","Mecosta County",2,80,237,114,123
050,26,107,"Michigan","Mecosta County",2,81,214,95,119
050,26,107,"Michigan","Mecosta County",2,82,190,83,107
050,26,107,"Michigan","Mecosta County",2,83,151,68,83
050,26,107,"Michigan","Mecosta County",2,84,128,56,72
050,26,107,"Michigan","Mecosta County",2,85,669,229,440
050,26,107,"Michigan","Mecosta County",3,0,364,190,174
050,26,107,"Michigan","Mecosta County",3,1,430,213,217
050,26,107,"Michigan","Mecosta County",3,2,415,212,203
050,26,107,"Michigan","Mecosta County",3,3,420,207,213
050,26,107,"Michigan","Mecosta County",3,4,438,212,226
050,26,107,"Michigan","Mecosta County",3,5,420,213,207
050,26,107,"Michigan","Mecosta County",3,6,402,211,191
050,26,107,"Michigan","Mecosta County",3,7,390,210,180
050,26,107,"Michigan","Mecosta County",3,8,409,222,187
050,26,107,"Michigan","Mecosta County",3,9,406,226,180
050,26,107,"Michigan","Mecosta County",3,10,428,223,205
050,26,107,"Michigan","Mecosta County",3,11,425,207,218
050,26,107,"Michigan","Mecosta County",3,12,450,215,235
050,26,107,"Michigan","Mecosta County",3,13,484,235,249
050,26,107,"Michigan","Mecosta County",3,14,472,240,232
050,26,107,"Michigan","Mecosta County",3,15,495,256,239
050,26,107,"Michigan","Mecosta County",3,16,447,233,214
050,26,107,"Michigan","Mecosta County",3,17,468,241,227
050,26,107,"Michigan","Mecosta County",3,18,584,284,300
050,26,107,"Michigan","Mecosta County",3,19,728,365,363
050,26,107,"Michigan","Mecosta County",3,20,872,428,444
050,26,107,"Michigan","Mecosta County",3,21,958,543,415
050,26,107,"Michigan","Mecosta County",3,22,1010,530,480
050,26,107,"Michigan","Mecosta County",3,23,724,380,344
050,26,107,"Michigan","Mecosta County",3,24,628,356,272
050,26,107,"Michigan","Mecosta County",3,25,568,314,254
050,26,107,"Michigan","Mecosta County",3,26,444,239,205
050,26,107,"Michigan","Mecosta County",3,27,410,223,187
050,26,107,"Michigan","Mecosta County",3,28,426,228,198
050,26,107,"Michigan","Mecosta County",3,29,418,211,207
050,26,107,"Michigan","Mecosta County",3,30,448,233,215
050,26,107,"Michigan","Mecosta County",3,31,465,234,231
050,26,107,"Michigan","Mecosta County",3,32,448,231,217
050,26,107,"Michigan","Mecosta County",3,33,434,224,210
050,26,107,"Michigan","Mecosta County",3,34,424,222,202
050,26,107,"Michigan","Mecosta County",3,35,414,211,203
050,26,107,"Michigan","Mecosta County",3,36,391,186,205
050,26,107,"Michigan","Mecosta County",3,37,416,195,221
050,26,107,"Michigan","Mecosta County",3,38,385,199,186
050,26,107,"Michigan","Mecosta County",3,39,393,211,182
050,26,107,"Michigan","Mecosta County",3,40,431,228,203
050,26,107,"Michigan","Mecosta County",3,41,449,231,218
050,26,107,"Michigan","Mecosta County",3,42,390,199,191
050,26,107,"Michigan","Mecosta County",3,43,396,214,182
050,26,107,"Michigan","Mecosta County",3,44,408,203,205
050,26,107,"Michigan","Mecosta County",3,45,380,194,186
050,26,107,"Michigan","Mecosta County",3,46,395,191,204
050,26,107,"Michigan","Mecosta County",3,47,383,179,204
050,26,107,"Michigan","Mecosta County",3,48,385,190,195
050,26,107,"Michigan","Mecosta County",3,49,412,198,214
050,26,107,"Michigan","Mecosta County",3,50,452,224,228
050,26,107,"Michigan","Mecosta County",3,51,459,230,229
050,26,107,"Michigan","Mecosta County",3,52,472,248,224
050,26,107,"Michigan","Mecosta County",3,53,447,224,223
050,26,107,"Michigan","Mecosta County",3,54,480,233,247
050,26,107,"Michigan","Mecosta County",3,55,493,237,256
050,26,107,"Michigan","Mecosta County",3,56,529,273,256
050,26,107,"Michigan","Mecosta County",3,57,548,276,272
050,26,107,"Michigan","Mecosta County",3,58,554,282,272
050,26,107,"Michigan","Mecosta County",3,59,587,294,293
050,26,107,"Michigan","Mecosta County",3,60,645,325,320
050,26,107,"Michigan","Mecosta County",3,61,642,328,314
050,26,107,"Michigan","Mecosta County",3,62,636,316,320
050,26,107,"Michigan","Mecosta County",3,63,618,299,319
050,26,107,"Michigan","Mecosta County",3,64,616,308,308
050,26,107,"Michigan","Mecosta County",3,65,577,289,288
050,26,107,"Michigan","Mecosta County",3,66,575,288,287
050,26,107,"Michigan","Mecosta County",3,67,553,270,283
050,26,107,"Michigan","Mecosta County",3,68,551,272,279
050,26,107,"Michigan","Mecosta County",3,69,542,263,279
050,26,107,"Michigan","Mecosta County",3,70,479,235,244
050,26,107,"Michigan","Mecosta County",3,71,440,208,232
050,26,107,"Michigan","Mecosta County",3,72,418,195,223
050,26,107,"Michigan","Mecosta County",3,73,427,211,216
050,26,107,"Michigan","Mecosta County",3,74,452,223,229
050,26,107,"Michigan","Mecosta County",3,75,306,146,160
050,26,107,"Michigan","Mecosta County",3,76,287,134,153
050,26,107,"Michigan","Mecosta County",3,77,292,141,151
050,26,107,"Michigan","Mecosta County",3,78,307,152,155
050,26,107,"Michigan","Mecosta County",3,79,261,123,138
050,26,107,"Michigan","Mecosta County",3,80,253,124,129
050,26,107,"Michigan","Mecosta County",3,81,224,109,115
050,26,107,"Michigan","Mecosta County",3,82,182,80,102
050,26,107,"Michigan","Mecosta County",3,83,171,74,97
050,26,107,"Michigan","Mecosta County",3,84,125,41,84
050,26,107,"Michigan","Mecosta County",3,85,668,226,442
050,26,107,"Michigan","Mecosta County",4,0,424,223,201
050,26,107,"Michigan","Mecosta County",4,1,360,188,172
050,26,107,"Michigan","Mecosta County",4,2,440,229,211
050,26,107,"Michigan","Mecosta County",4,3,442,236,206
050,26,107,"Michigan","Mecosta County",4,4,442,227,215
050,26,107,"Michigan","Mecosta County",4,5,448,220,228
050,26,107,"Michigan","Mecosta County",4,6,456,227,229
050,26,107,"Michigan","Mecosta County",4,7,416,209,207
050,26,107,"Michigan","Mecosta County",4,8,410,225,185
050,26,107,"Michigan","Mecosta County",4,9,415,225,190
050,26,107,"Michigan","Mecosta County",4,10,410,232,178
050,26,107,"Michigan","Mecosta County",4,11,425,214,211
050,26,107,"Michigan","Mecosta County",4,12,444,214,230
050,26,107,"Michigan","Mecosta County",4,13,461,229,232
050,26,107,"Michigan","Mecosta County",4,14,504,248,256
050,26,107,"Michigan","Mecosta County",4,15,470,250,220
050,26,107,"Michigan","Mecosta County",4,16,506,263,243
050,26,107,"Michigan","Mecosta County",4,17,452,241,211
050,26,107,"Michigan","Mecosta County",4,18,549,278,271
050,26,107,"Michigan","Mecosta County",4,19,721,358,363
050,26,107,"Michigan","Mecosta County",4,20,869,425,444
050,26,107,"Michigan","Mecosta County",4,21,1015,561,454
050,26,107,"Michigan","Mecosta County",4,22,1035,544,491
050,26,107,"Michigan","Mecosta County",4,23,749,415,334
050,26,107,"Michigan","Mecosta County",4,24,660,357,303
050,26,107,"Michigan","Mecosta County",4,25,552,304,248
050,26,107,"Michigan","Mecosta County",4,26,470,257,213
050,26,107,"Michigan","Mecosta County",4,27,429,226,203
050,26,107,"Michigan","Mecosta County",4,28,402,223,179
050,26,107,"Michigan","Mecosta County",4,29,437,213,224
050,26,107,"Michigan","Mecosta County",4,30,429,218,211
050,26,107,"Michigan","Mecosta County",4,31,455,228,227
050,26,107,"Michigan","Mecosta County",4,32,492,253,239
050,26,107,"Michigan","Mecosta County",4,33,448,232,216
050,26,107,"Michigan","Mecosta County",4,34,431,210,221
050,26,107,"Michigan","Mecosta County",4,35,444,233,211
050,26,107,"Michigan","Mecosta County",4,36,419,212,207
050,26,107,"Michigan","Mecosta County",4,37,401,191,210
050,26,107,"Michigan","Mecosta County",4,38,420,197,223
050,26,107,"Michigan","Mecosta County",4,39,409,215,194
050,26,107,"Michigan","Mecosta County",4,40,410,225,185
050,26,107,"Michigan","Mecosta County",4,41,431,227,204
050,26,107,"Michigan","Mecosta County",4,42,466,243,223
050,26,107,"Michigan","Mecosta County",4,43,398,201,197
050,26,107,"Michigan","Mecosta County",4,44,419,219,200
050,26,107,"Michigan","Mecosta County",4,45,409,210,199
050,26,107,"Michigan","Mecosta County",4,46,389,196,193
050,26,107,"Michigan","Mecosta County",4,47,410,200,210
050,26,107,"Michigan","Mecosta County",4,48,391,184,207
050,26,107,"Michigan","Mecosta County",4,49,387,192,195
050,26,107,"Michigan","Mecosta County",4,50,413,198,215
050,26,107,"Michigan","Mecosta County",4,51,461,234,227
050,26,107,"Michigan","Mecosta County",4,52,473,245,228
050,26,107,"Michigan","Mecosta County",4,53,477,249,228
050,26,107,"Michigan","Mecosta County",4,54,455,227,228
050,26,107,"Michigan","Mecosta County",4,55,480,233,247
050,26,107,"Michigan","Mecosta County",4,56,507,250,257
050,26,107,"Michigan","Mecosta County",4,57,560,290,270
050,26,107,"Michigan","Mecosta County",4,58,552,281,271
050,26,107,"Michigan","Mecosta County",4,59,564,290,274
050,26,107,"Michigan","Mecosta County",4,60,620,308,312
050,26,107,"Michigan","Mecosta County",4,61,661,331,330
050,26,107,"Michigan","Mecosta County",4,62,657,336,321
050,26,107,"Michigan","Mecosta County",4,63,656,326,330
050,26,107,"Michigan","Mecosta County",4,64,621,298,323
050,26,107,"Michigan","Mecosta County",4,65,628,308,320
050,26,107,"Michigan","Mecosta County",4,66,587,295,292
050,26,107,"Michigan","Mecosta County",4,67,575,286,289
050,26,107,"Michigan","Mecosta County",4,68,539,257,282
050,26,107,"Michigan","Mecosta County",4,69,530,264,266
050,26,107,"Michigan","Mecosta County",4,70,543,264,279
050,26,107,"Michigan","Mecosta County",4,71,466,230,236
050,26,107,"Michigan","Mecosta County",4,72,421,203,218
050,26,107,"Michigan","Mecosta County",4,73,394,185,209
050,26,107,"Michigan","Mecosta County",4,74,416,207,209
050,26,107,"Michigan","Mecosta County",4,75,439,214,225
050,26,107,"Michigan","Mecosta County",4,76,299,139,160
050,26,107,"Michigan","Mecosta County",4,77,272,126,146
050,26,107,"Michigan","Mecosta County",4,78,279,141,138
050,26,107,"Michigan","Mecosta County",4,79,290,134,156
050,26,107,"Michigan","Mecosta County",4,80,248,114,134
050,26,107,"Michigan","Mecosta County",4,81,245,124,121
050,26,107,"Michigan","Mecosta County",4,82,199,93,106
050,26,107,"Michigan","Mecosta County",4,83,167,75,92
050,26,107,"Michigan","Mecosta County",4,84,150,54,96
050,26,107,"Michigan","Mecosta County",4,85,667,219,448
050,26,107,"Michigan","Mecosta County",5,0,413,218,195
050,26,107,"Michigan","Mecosta County",5,1,443,240,203
050,26,107,"Michigan","Mecosta County",5,2,364,191,173
050,26,107,"Michigan","Mecosta County",5,3,431,228,203
050,26,107,"Michigan","Mecosta County",5,4,439,236,203
050,26,107,"Michigan","Mecosta County",5,5,434,223,211
050,26,107,"Michigan","Mecosta County",5,6,451,221,230
050,26,107,"Michigan","Mecosta County",5,7,448,215,233
050,26,107,"Michigan","Mecosta County",5,8,434,213,221
050,26,107,"Michigan","Mecosta County",5,9,431,235,196
050,26,107,"Michigan","Mecosta County",5,10,427,233,194
050,26,107,"Michigan","Mecosta County",5,11,423,235,188
050,26,107,"Michigan","Mecosta County",5,12,423,216,207
050,26,107,"Michigan","Mecosta County",5,13,438,202,236
050,26,107,"Michigan","Mecosta County",5,14,464,230,234
050,26,107,"Michigan","Mecosta County",5,15,503,245,258
050,26,107,"Michigan","Mecosta County",5,16,469,245,224
050,26,107,"Michigan","Mecosta County",5,17,512,264,248
050,26,107,"Michigan","Mecosta County",5,18,536,273,263
050,26,107,"Michigan","Mecosta County",5,19,705,350,355
050,26,107,"Michigan","Mecosta County",5,20,867,414,453
050,26,107,"Michigan","Mecosta County",5,21,990,549,441
050,26,107,"Michigan","Mecosta County",5,22,1090,570,520
050,26,107,"Michigan","Mecosta County",5,23,795,419,376
050,26,107,"Michigan","Mecosta County",5,24,645,362,283
050,26,107,"Michigan","Mecosta County",5,25,580,291,289
050,26,107,"Michigan","Mecosta County",5,26,449,246,203
050,26,107,"Michigan","Mecosta County",5,27,436,241,195
050,26,107,"Michigan","Mecosta County",5,28,401,206,195
050,26,107,"Michigan","Mecosta County",5,29,382,209,173
050,26,107,"Michigan","Mecosta County",5,30,456,219,237
050,26,107,"Michigan","Mecosta County",5,31,419,215,204
050,26,107,"Michigan","Mecosta County",5,32,466,242,224
050,26,107,"Michigan","Mecosta County",5,33,492,249,243
050,26,107,"Michigan","Mecosta County",5,34,445,229,216
050,26,107,"Michigan","Mecosta County",5,35,421,209,212
050,26,107,"Michigan","Mecosta County",5,36,457,236,221
050,26,107,"Michigan","Mecosta County",5,37,437,216,221
050,26,107,"Michigan","Mecosta County",5,38,417,199,218
050,26,107,"Michigan","Mecosta County",5,39,417,200,217
050,26,107,"Michigan","Mecosta County",5,40,419,229,190
050,26,107,"Michigan","Mecosta County",5,41,410,217,193
050,26,107,"Michigan","Mecosta County",5,42,436,232,204
050,26,107,"Michigan","Mecosta County",5,43,478,248,230
050,26,107,"Michigan","Mecosta County",5,44,401,199,202
050,26,107,"Michigan","Mecosta County",5,45,439,226,213
050,26,107,"Michigan","Mecosta County",5,46,435,222,213
050,26,107,"Michigan","Mecosta County",5,47,390,199,191
050,26,107,"Michigan","Mecosta County",5,48,406,198,208
050,26,107,"Michigan","Mecosta County",5,49,393,186,207
050,26,107,"Michigan","Mecosta County",5,50,395,190,205
050,26,107,"Michigan","Mecosta County",5,51,421,204,217
050,26,107,"Michigan","Mecosta County",5,52,470,234,236
050,26,107,"Michigan","Mecosta County",5,53,477,244,233
050,26,107,"Michigan","Mecosta County",5,54,498,263,235
050,26,107,"Michigan","Mecosta County",5,55,469,240,229
050,26,107,"Michigan","Mecosta County",5,56,478,237,241
050,26,107,"Michigan","Mecosta County",5,57,524,259,265
050,26,107,"Michigan","Mecosta County",5,58,567,299,268
050,26,107,"Michigan","Mecosta County",5,59,557,287,270
050,26,107,"Michigan","Mecosta County",5,60,570,285,285
050,26,107,"Michigan","Mecosta County",5,61,622,307,315
050,26,107,"Michigan","Mecosta County",5,62,662,333,329
050,26,107,"Michigan","Mecosta County",5,63,677,341,336
050,26,107,"Michigan","Mecosta County",5,64,659,325,334
050,26,107,"Michigan","Mecosta County",5,65,633,303,330
050,26,107,"Michigan","Mecosta County",5,66,629,310,319
050,26,107,"Michigan","Mecosta County",5,67,579,296,283
050,26,107,"Michigan","Mecosta County",5,68,566,270,296
050,26,107,"Michigan","Mecosta County",5,69,514,248,266
050,26,107,"Michigan","Mecosta County",5,70,518,259,259
050,26,107,"Michigan","Mecosta County",5,71,535,263,272
050,26,107,"Michigan","Mecosta County",5,72,446,218,228
050,26,107,"Michigan","Mecosta County",5,73,410,197,213
050,26,107,"Michigan","Mecosta County",5,74,377,175,202
050,26,107,"Michigan","Mecosta County",5,75,406,201,205
050,26,107,"Michigan","Mecosta County",5,76,421,198,223
050,26,107,"Michigan","Mecosta County",5,77,274,124,150
050,26,107,"Michigan","Mecosta County",5,78,261,122,139
050,26,107,"Michigan","Mecosta County",5,79,264,130,134
050,26,107,"Michigan","Mecosta County",5,80,270,124,146
050,26,107,"Michigan","Mecosta County",5,81,236,109,127
050,26,107,"Michigan","Mecosta County",5,82,216,109,107
050,26,107,"Michigan","Mecosta County",5,83,196,93,103
050,26,107,"Michigan","Mecosta County",5,84,141,55,86
050,26,107,"Michigan","Mecosta County",5,85,704,224,480
050,26,109,"Michigan","Menominee County",1,0,199,102,97
050,26,109,"Michigan","Menominee County",1,1,205,99,106
050,26,109,"Michigan","Menominee County",1,2,182,91,91
050,26,109,"Michigan","Menominee County",1,3,207,105,102
050,26,109,"Michigan","Menominee County",1,4,219,121,98
050,26,109,"Michigan","Menominee County",1,5,250,147,103
050,26,109,"Michigan","Menominee County",1,6,215,118,97
050,26,109,"Michigan","Menominee County",1,7,212,99,113
050,26,109,"Michigan","Menominee County",1,8,208,107,101
050,26,109,"Michigan","Menominee County",1,9,220,115,105
050,26,109,"Michigan","Menominee County",1,10,255,126,129
050,26,109,"Michigan","Menominee County",1,11,269,143,126
050,26,109,"Michigan","Menominee County",1,12,260,134,126
050,26,109,"Michigan","Menominee County",1,13,260,131,129
050,26,109,"Michigan","Menominee County",1,14,263,130,133
050,26,109,"Michigan","Menominee County",1,15,273,151,122
050,26,109,"Michigan","Menominee County",1,16,283,154,129
050,26,109,"Michigan","Menominee County",1,17,292,164,128
050,26,109,"Michigan","Menominee County",1,18,253,140,113
050,26,109,"Michigan","Menominee County",1,19,196,104,92
050,26,109,"Michigan","Menominee County",1,20,212,106,106
050,26,109,"Michigan","Menominee County",1,21,224,118,106
050,26,109,"Michigan","Menominee County",1,22,215,112,103
050,26,109,"Michigan","Menominee County",1,23,227,110,117
050,26,109,"Michigan","Menominee County",1,24,229,113,116
050,26,109,"Michigan","Menominee County",1,25,221,120,101
050,26,109,"Michigan","Menominee County",1,26,217,118,99
050,26,109,"Michigan","Menominee County",1,27,235,127,108
050,26,109,"Michigan","Menominee County",1,28,239,117,122
050,26,109,"Michigan","Menominee County",1,29,227,116,111
050,26,109,"Michigan","Menominee County",1,30,259,140,119
050,26,109,"Michigan","Menominee County",1,31,239,128,111
050,26,109,"Michigan","Menominee County",1,32,198,104,94
050,26,109,"Michigan","Menominee County",1,33,226,120,106
050,26,109,"Michigan","Menominee County",1,34,243,133,110
050,26,109,"Michigan","Menominee County",1,35,232,130,102
050,26,109,"Michigan","Menominee County",1,36,253,135,118
050,26,109,"Michigan","Menominee County",1,37,250,134,116
050,26,109,"Michigan","Menominee County",1,38,257,146,111
050,26,109,"Michigan","Menominee County",1,39,257,142,115
050,26,109,"Michigan","Menominee County",1,40,238,126,112
050,26,109,"Michigan","Menominee County",1,41,272,147,125
050,26,109,"Michigan","Menominee County",1,42,272,141,131
050,26,109,"Michigan","Menominee County",1,43,253,132,121
050,26,109,"Michigan","Menominee County",1,44,229,116,113
050,26,109,"Michigan","Menominee County",1,45,241,122,119
050,26,109,"Michigan","Menominee County",1,46,247,140,107
050,26,109,"Michigan","Menominee County",1,47,253,135,118
050,26,109,"Michigan","Menominee County",1,48,266,134,132
050,26,109,"Michigan","Menominee County",1,49,292,151,141
050,26,109,"Michigan","Menominee County",1,50,299,163,136
050,26,109,"Michigan","Menominee County",1,51,305,155,150
050,26,109,"Michigan","Menominee County",1,52,320,154,166
050,26,109,"Michigan","Menominee County",1,53,345,172,173
050,26,109,"Michigan","Menominee County",1,54,358,194,164
050,26,109,"Michigan","Menominee County",1,55,360,194,166
050,26,109,"Michigan","Menominee County",1,56,361,197,164
050,26,109,"Michigan","Menominee County",1,57,397,206,191
050,26,109,"Michigan","Menominee County",1,58,398,192,206
050,26,109,"Michigan","Menominee County",1,59,422,211,211
050,26,109,"Michigan","Menominee County",1,60,410,211,199
050,26,109,"Michigan","Menominee County",1,61,399,212,187
050,26,109,"Michigan","Menominee County",1,62,435,226,209
050,26,109,"Michigan","Menominee County",1,63,433,230,203
050,26,109,"Michigan","Menominee County",1,64,399,211,188
050,26,109,"Michigan","Menominee County",1,65,421,213,208
050,26,109,"Michigan","Menominee County",1,66,446,225,221
050,26,109,"Michigan","Menominee County",1,67,405,204,201
050,26,109,"Michigan","Menominee County",1,68,368,196,172
050,26,109,"Michigan","Menominee County",1,69,345,174,171
050,26,109,"Michigan","Menominee County",1,70,327,161,166
050,26,109,"Michigan","Menominee County",1,71,327,166,161
050,26,109,"Michigan","Menominee County",1,72,337,171,166
050,26,109,"Michigan","Menominee County",1,73,349,172,177
050,26,109,"Michigan","Menominee County",1,74,208,101,107
050,26,109,"Michigan","Menominee County",1,75,206,105,101
050,26,109,"Michigan","Menominee County",1,76,210,106,104
050,26,109,"Michigan","Menominee County",1,77,226,109,117
050,26,109,"Michigan","Menominee County",1,78,190,87,103
050,26,109,"Michigan","Menominee County",1,79,185,91,94
050,26,109,"Michigan","Menominee County",1,80,150,78,72
050,26,109,"Michigan","Menominee County",1,81,142,63,79
050,26,109,"Michigan","Menominee County",1,82,142,72,70
050,26,109,"Michigan","Menominee County",1,83,119,52,67
050,26,109,"Michigan","Menominee County",1,84,107,54,53
050,26,109,"Michigan","Menominee County",1,85,704,280,424
050,26,109,"Michigan","Menominee County",2,0,190,105,85
050,26,109,"Michigan","Menominee County",2,1,201,98,103
050,26,109,"Michigan","Menominee County",2,2,188,94,94
050,26,109,"Michigan","Menominee County",2,3,202,102,100
050,26,109,"Michigan","Menominee County",2,4,215,117,98
050,26,109,"Michigan","Menominee County",2,5,246,143,103
050,26,109,"Michigan","Menominee County",2,6,226,126,100
050,26,109,"Michigan","Menominee County",2,7,215,104,111
050,26,109,"Michigan","Menominee County",2,8,209,106,103
050,26,109,"Michigan","Menominee County",2,9,219,114,105
050,26,109,"Michigan","Menominee County",2,10,250,125,125
050,26,109,"Michigan","Menominee County",2,11,267,140,127
050,26,109,"Michigan","Menominee County",2,12,264,139,125
050,26,109,"Michigan","Menominee County",2,13,258,131,127
050,26,109,"Michigan","Menominee County",2,14,263,131,132
050,26,109,"Michigan","Menominee County",2,15,269,145,124
050,26,109,"Michigan","Menominee County",2,16,280,153,127
050,26,109,"Michigan","Menominee County",2,17,291,163,128
050,26,109,"Michigan","Menominee County",2,18,252,140,112
050,26,109,"Michigan","Menominee County",2,19,196,108,88
050,26,109,"Michigan","Menominee County",2,20,212,107,105
050,26,109,"Michigan","Menominee County",2,21,224,118,106
050,26,109,"Michigan","Menominee County",2,22,216,113,103
050,26,109,"Michigan","Menominee County",2,23,227,111,116
050,26,109,"Michigan","Menominee County",2,24,229,113,116
050,26,109,"Michigan","Menominee County",2,25,220,117,103
050,26,109,"Michigan","Menominee County",2,26,216,119,97
050,26,109,"Michigan","Menominee County",2,27,229,123,106
050,26,109,"Michigan","Menominee County",2,28,236,121,115
050,26,109,"Michigan","Menominee County",2,29,232,116,116
050,26,109,"Michigan","Menominee County",2,30,255,136,119
050,26,109,"Michigan","Menominee County",2,31,244,130,114
050,26,109,"Michigan","Menominee County",2,32,207,109,98
050,26,109,"Michigan","Menominee County",2,33,220,118,102
050,26,109,"Michigan","Menominee County",2,34,238,130,108
050,26,109,"Michigan","Menominee County",2,35,236,132,104
050,26,109,"Michigan","Menominee County",2,36,243,132,111
050,26,109,"Michigan","Menominee County",2,37,253,135,118
050,26,109,"Michigan","Menominee County",2,38,257,143,114
050,26,109,"Michigan","Menominee County",2,39,251,141,110
050,26,109,"Michigan","Menominee County",2,40,243,131,112
050,26,109,"Michigan","Menominee County",2,41,264,142,122
050,26,109,"Michigan","Menominee County",2,42,270,142,128
050,26,109,"Michigan","Menominee County",2,43,258,135,123
050,26,109,"Michigan","Menominee County",2,44,233,119,114
050,26,109,"Michigan","Menominee County",2,45,241,123,118
050,26,109,"Michigan","Menominee County",2,46,245,136,109
050,26,109,"Michigan","Menominee County",2,47,249,134,115
050,26,109,"Michigan","Menominee County",2,48,264,134,130
050,26,109,"Michigan","Menominee County",2,49,288,148,140
050,26,109,"Michigan","Menominee County",2,50,296,160,136
050,26,109,"Michigan","Menominee County",2,51,307,159,148
050,26,109,"Michigan","Menominee County",2,52,313,152,161
050,26,109,"Michigan","Menominee County",2,53,340,167,173
050,26,109,"Michigan","Menominee County",2,54,351,187,164
050,26,109,"Michigan","Menominee County",2,55,356,191,165
050,26,109,"Michigan","Menominee County",2,56,361,198,163
050,26,109,"Michigan","Menominee County",2,57,392,206,186
050,26,109,"Michigan","Menominee County",2,58,395,194,201
050,26,109,"Michigan","Menominee County",2,59,420,207,213
050,26,109,"Michigan","Menominee County",2,60,409,209,200
050,26,109,"Michigan","Menominee County",2,61,398,210,188
050,26,109,"Michigan","Menominee County",2,62,425,223,202
050,26,109,"Michigan","Menominee County",2,63,436,230,206
050,26,109,"Michigan","Menominee County",2,64,403,213,190
050,26,109,"Michigan","Menominee County",2,65,412,210,202
050,26,109,"Michigan","Menominee County",2,66,441,224,217
050,26,109,"Michigan","Menominee County",2,67,412,207,205
050,26,109,"Michigan","Menominee County",2,68,373,196,177
050,26,109,"Michigan","Menominee County",2,69,355,181,174
050,26,109,"Michigan","Menominee County",2,70,328,162,166
050,26,109,"Michigan","Menominee County",2,71,325,163,162
050,26,109,"Michigan","Menominee County",2,72,329,167,162
050,26,109,"Michigan","Menominee County",2,73,363,180,183
050,26,109,"Michigan","Menominee County",2,74,222,108,114
050,26,109,"Michigan","Menominee County",2,75,206,105,101
050,26,109,"Michigan","Menominee County",2,76,206,104,102
050,26,109,"Michigan","Menominee County",2,77,225,110,115
050,26,109,"Michigan","Menominee County",2,78,192,89,103
050,26,109,"Michigan","Menominee County",2,79,185,89,96
050,26,109,"Michigan","Menominee County",2,80,156,79,77
050,26,109,"Michigan","Menominee County",2,81,142,66,76
050,26,109,"Michigan","Menominee County",2,82,141,70,71
050,26,109,"Michigan","Menominee County",2,83,122,55,67
050,26,109,"Michigan","Menominee County",2,84,108,53,55
050,26,109,"Michigan","Menominee County",2,85,705,282,423
050,26,109,"Michigan","Menominee County",3,0,183,94,89
050,26,109,"Michigan","Menominee County",3,1,187,96,91
050,26,109,"Michigan","Menominee County",3,2,195,97,98
050,26,109,"Michigan","Menominee County",3,3,195,98,97
050,26,109,"Michigan","Menominee County",3,4,198,102,96
050,26,109,"Michigan","Menominee County",3,5,210,111,99
050,26,109,"Michigan","Menominee County",3,6,252,147,105
050,26,109,"Michigan","Menominee County",3,7,235,129,106
050,26,109,"Michigan","Menominee County",3,8,214,103,111
050,26,109,"Michigan","Menominee County",3,9,208,108,100
050,26,109,"Michigan","Menominee County",3,10,214,114,100
050,26,109,"Michigan","Menominee County",3,11,243,120,123
050,26,109,"Michigan","Menominee County",3,12,260,137,123
050,26,109,"Michigan","Menominee County",3,13,265,141,124
050,26,109,"Michigan","Menominee County",3,14,258,127,131
050,26,109,"Michigan","Menominee County",3,15,272,132,140
050,26,109,"Michigan","Menominee County",3,16,265,146,119
050,26,109,"Michigan","Menominee County",3,17,286,157,129
050,26,109,"Michigan","Menominee County",3,18,262,149,113
050,26,109,"Michigan","Menominee County",3,19,192,113,79
050,26,109,"Michigan","Menominee County",3,20,205,119,86
050,26,109,"Michigan","Menominee County",3,21,212,107,105
050,26,109,"Michigan","Menominee County",3,22,225,119,106
050,26,109,"Michigan","Menominee County",3,23,214,108,106
050,26,109,"Michigan","Menominee County",3,24,235,116,119
050,26,109,"Michigan","Menominee County",3,25,219,114,105
050,26,109,"Michigan","Menominee County",3,26,229,113,116
050,26,109,"Michigan","Menominee County",3,27,223,118,105
050,26,109,"Michigan","Menominee County",3,28,216,113,103
050,26,109,"Michigan","Menominee County",3,29,242,140,102
050,26,109,"Michigan","Menominee County",3,30,253,124,129
050,26,109,"Michigan","Menominee County",3,31,257,134,123
050,26,109,"Michigan","Menominee County",3,32,242,127,115
050,26,109,"Michigan","Menominee County",3,33,215,119,96
050,26,109,"Michigan","Menominee County",3,34,225,121,104
050,26,109,"Michigan","Menominee County",3,35,245,134,111
050,26,109,"Michigan","Menominee County",3,36,228,127,101
050,26,109,"Michigan","Menominee County",3,37,244,129,115
050,26,109,"Michigan","Menominee County",3,38,253,131,122
050,26,109,"Michigan","Menominee County",3,39,246,143,103
050,26,109,"Michigan","Menominee County",3,40,256,143,113
050,26,109,"Michigan","Menominee County",3,41,244,134,110
050,26,109,"Michigan","Menominee County",3,42,263,139,124
050,26,109,"Michigan","Menominee County",3,43,273,140,133
050,26,109,"Michigan","Menominee County",3,44,265,137,128
050,26,109,"Michigan","Menominee County",3,45,239,119,120
050,26,109,"Michigan","Menominee County",3,46,242,126,116
050,26,109,"Michigan","Menominee County",3,47,246,134,112
050,26,109,"Michigan","Menominee County",3,48,251,138,113
050,26,109,"Michigan","Menominee County",3,49,253,126,127
050,26,109,"Michigan","Menominee County",3,50,290,144,146
050,26,109,"Michigan","Menominee County",3,51,306,163,143
050,26,109,"Michigan","Menominee County",3,52,300,160,140
050,26,109,"Michigan","Menominee County",3,53,315,156,159
050,26,109,"Michigan","Menominee County",3,54,334,162,172
050,26,109,"Michigan","Menominee County",3,55,359,188,171
050,26,109,"Michigan","Menominee County",3,56,357,193,164
050,26,109,"Michigan","Menominee County",3,57,364,204,160
050,26,109,"Michigan","Menominee County",3,58,392,211,181
050,26,109,"Michigan","Menominee County",3,59,395,195,200
050,26,109,"Michigan","Menominee County",3,60,417,205,212
050,26,109,"Michigan","Menominee County",3,61,411,211,200
050,26,109,"Michigan","Menominee County",3,62,402,210,192
050,26,109,"Michigan","Menominee County",3,63,421,219,202
050,26,109,"Michigan","Menominee County",3,64,429,230,199
050,26,109,"Michigan","Menominee County",3,65,404,210,194
050,26,109,"Michigan","Menominee County",3,66,409,209,200
050,26,109,"Michigan","Menominee County",3,67,435,219,216
050,26,109,"Michigan","Menominee County",3,68,405,205,200
050,26,109,"Michigan","Menominee County",3,69,367,193,174
050,26,109,"Michigan","Menominee County",3,70,348,178,170
050,26,109,"Michigan","Menominee County",3,71,324,158,166
050,26,109,"Michigan","Menominee County",3,72,315,157,158
050,26,109,"Michigan","Menominee County",3,73,321,164,157
050,26,109,"Michigan","Menominee County",3,74,355,180,175
050,26,109,"Michigan","Menominee County",3,75,212,106,106
050,26,109,"Michigan","Menominee County",3,76,195,98,97
050,26,109,"Michigan","Menominee County",3,77,201,104,97
050,26,109,"Michigan","Menominee County",3,78,207,96,111
050,26,109,"Michigan","Menominee County",3,79,184,86,98
050,26,109,"Michigan","Menominee County",3,80,174,84,90
050,26,109,"Michigan","Menominee County",3,81,146,75,71
050,26,109,"Michigan","Menominee County",3,82,134,66,68
050,26,109,"Michigan","Menominee County",3,83,122,55,67
050,26,109,"Michigan","Menominee County",3,84,112,50,62
050,26,109,"Michigan","Menominee County",3,85,701,288,413
050,26,109,"Michigan","Menominee County",4,0,151,74,77
050,26,109,"Michigan","Menominee County",4,1,184,94,90
050,26,109,"Michigan","Menominee County",4,2,178,102,76
050,26,109,"Michigan","Menominee County",4,3,210,106,104
050,26,109,"Michigan","Menominee County",4,4,195,98,97
050,26,109,"Michigan","Menominee County",4,5,201,109,92
050,26,109,"Michigan","Menominee County",4,6,224,120,104
050,26,109,"Michigan","Menominee County",4,7,250,145,105
050,26,109,"Michigan","Menominee County",4,8,231,122,109
050,26,109,"Michigan","Menominee County",4,9,225,112,113
050,26,109,"Michigan","Menominee County",4,10,218,108,110
050,26,109,"Michigan","Menominee County",4,11,208,109,99
050,26,109,"Michigan","Menominee County",4,12,259,126,133
050,26,109,"Michigan","Menominee County",4,13,266,147,119
050,26,109,"Michigan","Menominee County",4,14,271,141,130
050,26,109,"Michigan","Menominee County",4,15,260,128,132
050,26,109,"Michigan","Menominee County",4,16,277,139,138
050,26,109,"Michigan","Menominee County",4,17,264,139,125
050,26,109,"Michigan","Menominee County",4,18,254,145,109
050,26,109,"Michigan","Menominee County",4,19,190,115,75
050,26,109,"Michigan","Menominee County",4,20,196,114,82
050,26,109,"Michigan","Menominee County",4,21,202,117,85
050,26,109,"Michigan","Menominee County",4,22,217,103,114
050,26,109,"Michigan","Menominee County",4,23,216,117,99
050,26,109,"Michigan","Menominee County",4,24,217,113,104
050,26,109,"Michigan","Menominee County",4,25,226,113,113
050,26,109,"Michigan","Menominee County",4,26,216,119,97
050,26,109,"Michigan","Menominee County",4,27,236,110,126
050,26,109,"Michigan","Menominee County",4,28,234,136,98
050,26,109,"Michigan","Menominee County",4,29,211,112,99
050,26,109,"Michigan","Menominee County",4,30,245,134,111
050,26,109,"Michigan","Menominee County",4,31,246,119,127
050,26,109,"Michigan","Menominee County",4,32,270,144,126
050,26,109,"Michigan","Menominee County",4,33,240,123,117
050,26,109,"Michigan","Menominee County",4,34,225,124,101
050,26,109,"Michigan","Menominee County",4,35,223,116,107
050,26,109,"Michigan","Menominee County",4,36,247,133,114
050,26,109,"Michigan","Menominee County",4,37,231,131,100
050,26,109,"Michigan","Menominee County",4,38,257,129,128
050,26,109,"Michigan","Menominee County",4,39,254,135,119
050,26,109,"Michigan","Menominee County",4,40,263,153,110
050,26,109,"Michigan","Menominee County",4,41,256,143,113
050,26,109,"Michigan","Menominee County",4,42,239,129,110
050,26,109,"Michigan","Menominee County",4,43,264,138,126
050,26,109,"Michigan","Menominee County",4,44,277,137,140
050,26,109,"Michigan","Menominee County",4,45,278,135,143
050,26,109,"Michigan","Menominee County",4,46,241,123,118
050,26,109,"Michigan","Menominee County",4,47,252,129,123
050,26,109,"Michigan","Menominee County",4,48,247,136,111
050,26,109,"Michigan","Menominee County",4,49,258,141,117
050,26,109,"Michigan","Menominee County",4,50,250,124,126
050,26,109,"Michigan","Menominee County",4,51,288,141,147
050,26,109,"Michigan","Menominee County",4,52,289,160,129
050,26,109,"Michigan","Menominee County",4,53,305,163,142
050,26,109,"Michigan","Menominee County",4,54,316,157,159
050,26,109,"Michigan","Menominee County",4,55,338,161,177
050,26,109,"Michigan","Menominee County",4,56,355,188,167
050,26,109,"Michigan","Menominee County",4,57,361,196,165
050,26,109,"Michigan","Menominee County",4,58,372,214,158
050,26,109,"Michigan","Menominee County",4,59,389,204,185
050,26,109,"Michigan","Menominee County",4,60,393,188,205
050,26,109,"Michigan","Menominee County",4,61,415,205,210
050,26,109,"Michigan","Menominee County",4,62,416,219,197
050,26,109,"Michigan","Menominee County",4,63,397,206,191
050,26,109,"Michigan","Menominee County",4,64,414,215,199
050,26,109,"Michigan","Menominee County",4,65,426,223,203
050,26,109,"Michigan","Menominee County",4,66,410,215,195
050,26,109,"Michigan","Menominee County",4,67,410,214,196
050,26,109,"Michigan","Menominee County",4,68,428,215,213
050,26,109,"Michigan","Menominee County",4,69,400,199,201
050,26,109,"Michigan","Menominee County",4,70,364,190,174
050,26,109,"Michigan","Menominee County",4,71,345,175,170
050,26,109,"Michigan","Menominee County",4,72,314,153,161
050,26,109,"Michigan","Menominee County",4,73,305,153,152
050,26,109,"Michigan","Menominee County",4,74,312,162,150
050,26,109,"Michigan","Menominee County",4,75,342,174,168
050,26,109,"Michigan","Menominee County",4,76,204,101,103
050,26,109,"Michigan","Menominee County",4,77,189,97,92
050,26,109,"Michigan","Menominee County",4,78,176,86,90
050,26,109,"Michigan","Menominee County",4,79,203,95,108
050,26,109,"Michigan","Menominee County",4,80,173,82,91
050,26,109,"Michigan","Menominee County",4,81,158,76,82
050,26,109,"Michigan","Menominee County",4,82,141,74,67
050,26,109,"Michigan","Menominee County",4,83,116,51,65
050,26,109,"Michigan","Menominee County",4,84,110,47,63
050,26,109,"Michigan","Menominee County",4,85,701,284,417
050,26,109,"Michigan","Menominee County",5,0,72,35,37
050,26,109,"Michigan","Menominee County",5,1,165,88,77
050,26,109,"Michigan","Menominee County",5,2,184,97,87
050,26,109,"Michigan","Menominee County",5,3,180,110,70
050,26,109,"Michigan","Menominee County",5,4,214,111,103
050,26,109,"Michigan","Menominee County",5,5,193,98,95
050,26,109,"Michigan","Menominee County",5,6,201,105,96
050,26,109,"Michigan","Menominee County",5,7,216,117,99
050,26,109,"Michigan","Menominee County",5,8,248,143,105
050,26,109,"Michigan","Menominee County",5,9,230,120,110
050,26,109,"Michigan","Menominee County",5,10,228,116,112
050,26,109,"Michigan","Menominee County",5,11,203,102,101
050,26,109,"Michigan","Menominee County",5,12,219,115,104
050,26,109,"Michigan","Menominee County",5,13,245,116,129
050,26,109,"Michigan","Menominee County",5,14,252,131,121
050,26,109,"Michigan","Menominee County",5,15,271,137,134
050,26,109,"Michigan","Menominee County",5,16,257,127,130
050,26,109,"Michigan","Menominee County",5,17,284,140,144
050,26,109,"Michigan","Menominee County",5,18,233,126,107
050,26,109,"Michigan","Menominee County",5,19,180,103,77
050,26,109,"Michigan","Menominee County",5,20,202,119,83
050,26,109,"Michigan","Menominee County",5,21,199,115,84
050,26,109,"Michigan","Menominee County",5,22,210,119,91
050,26,109,"Michigan","Menominee County",5,23,209,102,107
050,26,109,"Michigan","Menominee County",5,24,219,125,94
050,26,109,"Michigan","Menominee County",5,25,218,118,100
050,26,109,"Michigan","Menominee County",5,26,231,116,115
050,26,109,"Michigan","Menominee County",5,27,219,110,109
050,26,109,"Michigan","Menominee County",5,28,235,111,124
050,26,109,"Michigan","Menominee County",5,29,224,137,87
050,26,109,"Michigan","Menominee County",5,30,213,112,101
050,26,109,"Michigan","Menominee County",5,31,234,130,104
050,26,109,"Michigan","Menominee County",5,32,249,122,127
050,26,109,"Michigan","Menominee County",5,33,272,137,135
050,26,109,"Michigan","Menominee County",5,34,245,126,119
050,26,109,"Michigan","Menominee County",5,35,221,119,102
050,26,109,"Michigan","Menominee County",5,36,227,119,108
050,26,109,"Michigan","Menominee County",5,37,247,133,114
050,26,109,"Michigan","Menominee County",5,38,236,134,102
050,26,109,"Michigan","Menominee County",5,39,253,126,127
050,26,109,"Michigan","Menominee County",5,40,257,137,120
050,26,109,"Michigan","Menominee County",5,41,271,158,113
050,26,109,"Michigan","Menominee County",5,42,255,141,114
050,26,109,"Michigan","Menominee County",5,43,231,121,110
050,26,109,"Michigan","Menominee County",5,44,275,146,129
050,26,109,"Michigan","Menominee County",5,45,281,136,145
050,26,109,"Michigan","Menominee County",5,46,273,136,137
050,26,109,"Michigan","Menominee County",5,47,241,124,117
050,26,109,"Michigan","Menominee County",5,48,249,128,121
050,26,109,"Michigan","Menominee County",5,49,259,143,116
050,26,109,"Michigan","Menominee County",5,50,247,138,109
050,26,109,"Michigan","Menominee County",5,51,251,122,129
050,26,109,"Michigan","Menominee County",5,52,281,141,140
050,26,109,"Michigan","Menominee County",5,53,295,161,134
050,26,109,"Michigan","Menominee County",5,54,308,163,145
050,26,109,"Michigan","Menominee County",5,55,321,161,160
050,26,109,"Michigan","Menominee County",5,56,333,158,175
050,26,109,"Michigan","Menominee County",5,57,354,190,164
050,26,109,"Michigan","Menominee County",5,58,369,196,173
050,26,109,"Michigan","Menominee County",5,59,366,204,162
050,26,109,"Michigan","Menominee County",5,60,382,203,179
050,26,109,"Michigan","Menominee County",5,61,393,187,206
050,26,109,"Michigan","Menominee County",5,62,418,207,211
050,26,109,"Michigan","Menominee County",5,63,420,223,197
050,26,109,"Michigan","Menominee County",5,64,388,203,185
050,26,109,"Michigan","Menominee County",5,65,405,207,198
050,26,109,"Michigan","Menominee County",5,66,426,223,203
050,26,109,"Michigan","Menominee County",5,67,410,216,194
050,26,109,"Michigan","Menominee County",5,68,406,214,192
050,26,109,"Michigan","Menominee County",5,69,425,214,211
050,26,109,"Michigan","Menominee County",5,70,391,193,198
050,26,109,"Michigan","Menominee County",5,71,366,190,176
050,26,109,"Michigan","Menominee County",5,72,339,174,165
050,26,109,"Michigan","Menominee County",5,73,306,150,156
050,26,109,"Michigan","Menominee County",5,74,295,149,146
050,26,109,"Michigan","Menominee County",5,75,303,158,145
050,26,109,"Michigan","Menominee County",5,76,334,168,166
050,26,109,"Michigan","Menominee County",5,77,199,100,99
050,26,109,"Michigan","Menominee County",5,78,171,84,87
050,26,109,"Michigan","Menominee County",5,79,162,79,83
050,26,109,"Michigan","Menominee County",5,80,194,91,103
050,26,109,"Michigan","Menominee County",5,81,158,77,81
050,26,109,"Michigan","Menominee County",5,82,154,77,77
050,26,109,"Michigan","Menominee County",5,83,127,61,66
050,26,109,"Michigan","Menominee County",5,84,106,43,63
050,26,109,"Michigan","Menominee County",5,85,712,285,427
050,26,111,"Michigan","Midland County",1,0,837,426,411
050,26,111,"Michigan","Midland County",1,1,891,463,428
050,26,111,"Michigan","Midland County",1,2,910,479,431
050,26,111,"Michigan","Midland County",1,3,928,469,459
050,26,111,"Michigan","Midland County",1,4,927,475,452
050,26,111,"Michigan","Midland County",1,5,983,505,478
050,26,111,"Michigan","Midland County",1,6,958,523,435
050,26,111,"Michigan","Midland County",1,7,943,504,439
050,26,111,"Michigan","Midland County",1,8,945,493,452
050,26,111,"Michigan","Midland County",1,9,971,519,452
050,26,111,"Michigan","Midland County",1,10,989,505,484
050,26,111,"Michigan","Midland County",1,11,1057,557,500
050,26,111,"Michigan","Midland County",1,12,1054,530,524
050,26,111,"Michigan","Midland County",1,13,1097,550,547
050,26,111,"Michigan","Midland County",1,14,1061,536,525
050,26,111,"Michigan","Midland County",1,15,1100,544,556
050,26,111,"Michigan","Midland County",1,16,1133,572,561
050,26,111,"Michigan","Midland County",1,17,1149,600,549
050,26,111,"Michigan","Midland County",1,18,970,522,448
050,26,111,"Michigan","Midland County",1,19,789,427,362
050,26,111,"Michigan","Midland County",1,20,844,460,384
050,26,111,"Michigan","Midland County",1,21,892,466,426
050,26,111,"Michigan","Midland County",1,22,903,449,454
050,26,111,"Michigan","Midland County",1,23,946,484,462
050,26,111,"Michigan","Midland County",1,24,934,492,442
050,26,111,"Michigan","Midland County",1,25,960,465,495
050,26,111,"Michigan","Midland County",1,26,978,489,489
050,26,111,"Michigan","Midland County",1,27,995,512,483
050,26,111,"Michigan","Midland County",1,28,1046,540,506
050,26,111,"Michigan","Midland County",1,29,1105,568,537
050,26,111,"Michigan","Midland County",1,30,1091,548,543
050,26,111,"Michigan","Midland County",1,31,1036,528,508
050,26,111,"Michigan","Midland County",1,32,1022,527,495
050,26,111,"Michigan","Midland County",1,33,1028,534,494
050,26,111,"Michigan","Midland County",1,34,1073,549,524
050,26,111,"Michigan","Midland County",1,35,1076,558,518
050,26,111,"Michigan","Midland County",1,36,1071,567,504
050,26,111,"Michigan","Midland County",1,37,1061,530,531
050,26,111,"Michigan","Midland County",1,38,1073,551,522
050,26,111,"Michigan","Midland County",1,39,1023,501,522
050,26,111,"Michigan","Midland County",1,40,1013,507,506
050,26,111,"Michigan","Midland County",1,41,1005,505,500
050,26,111,"Michigan","Midland County",1,42,999,497,502
050,26,111,"Michigan","Midland County",1,43,940,475,465
050,26,111,"Michigan","Midland County",1,44,963,491,472
050,26,111,"Michigan","Midland County",1,45,944,458,486
050,26,111,"Michigan","Midland County",1,46,942,478,464
050,26,111,"Michigan","Midland County",1,47,993,492,501
050,26,111,"Michigan","Midland County",1,48,1006,504,502
050,26,111,"Michigan","Midland County",1,49,1080,551,529
050,26,111,"Michigan","Midland County",1,50,1055,512,543
050,26,111,"Michigan","Midland County",1,51,1079,536,543
050,26,111,"Michigan","Midland County",1,52,1118,558,560
050,26,111,"Michigan","Midland County",1,53,1194,603,591
050,26,111,"Michigan","Midland County",1,54,1164,580,584
050,26,111,"Michigan","Midland County",1,55,1255,638,617
050,26,111,"Michigan","Midland County",1,56,1280,659,621
050,26,111,"Michigan","Midland County",1,57,1262,643,619
050,26,111,"Michigan","Midland County",1,58,1231,633,598
050,26,111,"Michigan","Midland County",1,59,1238,604,634
050,26,111,"Michigan","Midland County",1,60,1247,611,636
050,26,111,"Michigan","Midland County",1,61,1191,605,586
050,26,111,"Michigan","Midland County",1,62,1161,583,578
050,26,111,"Michigan","Midland County",1,63,1156,552,604
050,26,111,"Michigan","Midland County",1,64,1114,532,582
050,26,111,"Michigan","Midland County",1,65,1147,557,590
050,26,111,"Michigan","Midland County",1,66,1058,515,543
050,26,111,"Michigan","Midland County",1,67,1016,484,532
050,26,111,"Michigan","Midland County",1,68,987,467,520
050,26,111,"Michigan","Midland County",1,69,915,412,503
050,26,111,"Michigan","Midland County",1,70,906,446,460
050,26,111,"Michigan","Midland County",1,71,865,416,449
050,26,111,"Michigan","Midland County",1,72,800,380,420
050,26,111,"Michigan","Midland County",1,73,793,373,420
050,26,111,"Michigan","Midland County",1,74,549,254,295
050,26,111,"Michigan","Midland County",1,75,569,254,315
050,26,111,"Michigan","Midland County",1,76,605,270,335
050,26,111,"Michigan","Midland County",1,77,615,272,343
050,26,111,"Michigan","Midland County",1,78,548,238,310
050,26,111,"Michigan","Midland County",1,79,483,207,276
050,26,111,"Michigan","Midland County",1,80,438,193,245
050,26,111,"Michigan","Midland County",1,81,427,178,249
050,26,111,"Michigan","Midland County",1,82,420,184,236
050,26,111,"Michigan","Midland County",1,83,376,156,220
050,26,111,"Michigan","Midland County",1,84,347,152,195
050,26,111,"Michigan","Midland County",1,85,2144,759,1385
050,26,111,"Michigan","Midland County",2,0,817,413,404
050,26,111,"Michigan","Midland County",2,1,877,454,423
050,26,111,"Michigan","Midland County",2,2,910,475,435
050,26,111,"Michigan","Midland County",2,3,916,469,447
050,26,111,"Michigan","Midland County",2,4,931,477,454
050,26,111,"Michigan","Midland County",2,5,967,498,469
050,26,111,"Michigan","Midland County",2,6,966,521,445
050,26,111,"Michigan","Midland County",2,7,948,508,440
050,26,111,"Michigan","Midland County",2,8,942,495,447
050,26,111,"Michigan","Midland County",2,9,962,510,452
050,26,111,"Michigan","Midland County",2,10,984,507,477
050,26,111,"Michigan","Midland County",2,11,1039,540,499
050,26,111,"Michigan","Midland County",2,12,1060,537,523
050,26,111,"Michigan","Midland County",2,13,1089,547,542
050,26,111,"Michigan","Midland County",2,14,1071,541,530
050,26,111,"Michigan","Midland County",2,15,1092,543,549
050,26,111,"Michigan","Midland County",2,16,1129,566,563
050,26,111,"Michigan","Midland County",2,17,1148,596,552
050,26,111,"Michigan","Midland County",2,18,965,522,443
050,26,111,"Michigan","Midland County",2,19,792,428,364
050,26,111,"Michigan","Midland County",2,20,859,468,391
050,26,111,"Michigan","Midland County",2,21,888,467,421
050,26,111,"Michigan","Midland County",2,22,904,454,450
050,26,111,"Michigan","Midland County",2,23,947,483,464
050,26,111,"Michigan","Midland County",2,24,941,493,448
050,26,111,"Michigan","Midland County",2,25,958,476,482
050,26,111,"Michigan","Midland County",2,26,979,486,493
050,26,111,"Michigan","Midland County",2,27,995,508,487
050,26,111,"Michigan","Midland County",2,28,1039,536,503
050,26,111,"Michigan","Midland County",2,29,1094,563,531
050,26,111,"Michigan","Midland County",2,30,1103,554,549
050,26,111,"Michigan","Midland County",2,31,1048,533,515
050,26,111,"Michigan","Midland County",2,32,1024,526,498
050,26,111,"Michigan","Midland County",2,33,1027,533,494
050,26,111,"Michigan","Midland County",2,34,1063,545,518
050,26,111,"Michigan","Midland County",2,35,1083,558,525
050,26,111,"Michigan","Midland County",2,36,1068,562,506
050,26,111,"Michigan","Midland County",2,37,1068,540,528
050,26,111,"Michigan","Midland County",2,38,1069,544,525
050,26,111,"Michigan","Midland County",2,39,1034,510,524
050,26,111,"Michigan","Midland County",2,40,1024,508,516
050,26,111,"Michigan","Midland County",2,41,1002,503,499
050,26,111,"Michigan","Midland County",2,42,998,498,500
050,26,111,"Michigan","Midland County",2,43,962,484,478
050,26,111,"Michigan","Midland County",2,44,949,482,467
050,26,111,"Michigan","Midland County",2,45,954,471,483
050,26,111,"Michigan","Midland County",2,46,941,471,470
050,26,111,"Michigan","Midland County",2,47,974,482,492
050,26,111,"Michigan","Midland County",2,48,1004,503,501
050,26,111,"Michigan","Midland County",2,49,1067,543,524
050,26,111,"Michigan","Midland County",2,50,1065,523,542
050,26,111,"Michigan","Midland County",2,51,1069,528,541
050,26,111,"Michigan","Midland County",2,52,1104,549,555
050,26,111,"Michigan","Midland County",2,53,1173,590,583
050,26,111,"Michigan","Midland County",2,54,1167,583,584
050,26,111,"Michigan","Midland County",2,55,1228,622,606
050,26,111,"Michigan","Midland County",2,56,1275,657,618
050,26,111,"Michigan","Midland County",2,57,1267,648,619
050,26,111,"Michigan","Midland County",2,58,1230,631,599
050,26,111,"Michigan","Midland County",2,59,1242,616,626
050,26,111,"Michigan","Midland County",2,60,1238,607,631
050,26,111,"Michigan","Midland County",2,61,1192,599,593
050,26,111,"Michigan","Midland County",2,62,1163,587,576
050,26,111,"Michigan","Midland County",2,63,1163,562,601
050,26,111,"Michigan","Midland County",2,64,1115,529,586
050,26,111,"Michigan","Midland County",2,65,1132,545,587
050,26,111,"Michigan","Midland County",2,66,1078,524,554
050,26,111,"Michigan","Midland County",2,67,1023,491,532
050,26,111,"Michigan","Midland County",2,68,982,464,518
050,26,111,"Michigan","Midland County",2,69,938,429,509
050,26,111,"Michigan","Midland County",2,70,900,434,466
050,26,111,"Michigan","Midland County",2,71,875,425,450
050,26,111,"Michigan","Midland County",2,72,804,384,420
050,26,111,"Michigan","Midland County",2,73,836,392,444
050,26,111,"Michigan","Midland County",2,74,568,262,306
050,26,111,"Michigan","Midland County",2,75,565,256,309
050,26,111,"Michigan","Midland County",2,76,586,261,325
050,26,111,"Michigan","Midland County",2,77,625,273,352
050,26,111,"Michigan","Midland County",2,78,553,240,313
050,26,111,"Michigan","Midland County",2,79,493,211,282
050,26,111,"Michigan","Midland County",2,80,447,196,251
050,26,111,"Michigan","Midland County",2,81,424,179,245
050,26,111,"Michigan","Midland County",2,82,417,181,236
050,26,111,"Michigan","Midland County",2,83,383,160,223
050,26,111,"Michigan","Midland County",2,84,350,153,197
050,26,111,"Michigan","Midland County",2,85,2137,753,1384
050,26,111,"Michigan","Midland County",3,0,813,419,394
050,26,111,"Michigan","Midland County",3,1,858,435,423
050,26,111,"Michigan","Midland County",3,2,902,472,430
050,26,111,"Michigan","Midland County",3,3,925,489,436
050,26,111,"Michigan","Midland County",3,4,965,490,475
050,26,111,"Michigan","Midland County",3,5,929,475,454
050,26,111,"Michigan","Midland County",3,6,969,487,482
050,26,111,"Michigan","Midland County",3,7,975,514,461
050,26,111,"Michigan","Midland County",3,8,933,507,426
050,26,111,"Michigan","Midland County",3,9,947,502,445
050,26,111,"Michigan","Midland County",3,10,941,509,432
050,26,111,"Michigan","Midland County",3,11,989,517,472
050,26,111,"Michigan","Midland County",3,12,1038,539,499
050,26,111,"Michigan","Midland County",3,13,1075,551,524
050,26,111,"Michigan","Midland County",3,14,1085,544,541
050,26,111,"Michigan","Midland County",3,15,1085,541,544
050,26,111,"Michigan","Midland County",3,16,1078,532,546
050,26,111,"Michigan","Midland County",3,17,1132,562,570
050,26,111,"Michigan","Midland County",3,18,984,534,450
050,26,111,"Michigan","Midland County",3,19,774,412,362
050,26,111,"Michigan","Midland County",3,20,875,452,423
050,26,111,"Michigan","Midland County",3,21,918,494,424
050,26,111,"Michigan","Midland County",3,22,948,477,471
050,26,111,"Michigan","Midland County",3,23,968,463,505
050,26,111,"Michigan","Midland County",3,24,944,494,450
050,26,111,"Michigan","Midland County",3,25,960,484,476
050,26,111,"Michigan","Midland County",3,26,978,480,498
050,26,111,"Michigan","Midland County",3,27,990,507,483
050,26,111,"Michigan","Midland County",3,28,1013,549,464
050,26,111,"Michigan","Midland County",3,29,1052,538,514
050,26,111,"Michigan","Midland County",3,30,1099,556,543
050,26,111,"Michigan","Midland County",3,31,1129,577,552
050,26,111,"Michigan","Midland County",3,32,1072,542,530
050,26,111,"Michigan","Midland County",3,33,1039,526,513
050,26,111,"Michigan","Midland County",3,34,1036,547,489
050,26,111,"Michigan","Midland County",3,35,1079,555,524
050,26,111,"Michigan","Midland County",3,36,1068,551,517
050,26,111,"Michigan","Midland County",3,37,1073,564,509
050,26,111,"Michigan","Midland County",3,38,1078,555,523
050,26,111,"Michigan","Midland County",3,39,1067,536,531
050,26,111,"Michigan","Midland County",3,40,1069,540,529
050,26,111,"Michigan","Midland County",3,41,998,500,498
050,26,111,"Michigan","Midland County",3,42,1019,512,507
050,26,111,"Michigan","Midland County",3,43,996,499,497
050,26,111,"Michigan","Midland County",3,44,976,490,486
050,26,111,"Michigan","Midland County",3,45,946,482,464
050,26,111,"Michigan","Midland County",3,46,941,467,474
050,26,111,"Michigan","Midland County",3,47,933,463,470
050,26,111,"Michigan","Midland County",3,48,981,484,497
050,26,111,"Michigan","Midland County",3,49,984,501,483
050,26,111,"Michigan","Midland County",3,50,1043,538,505
050,26,111,"Michigan","Midland County",3,51,1071,523,548
050,26,111,"Michigan","Midland County",3,52,1047,519,528
050,26,111,"Michigan","Midland County",3,53,1072,527,545
050,26,111,"Michigan","Midland County",3,54,1153,576,577
050,26,111,"Michigan","Midland County",3,55,1167,573,594
050,26,111,"Michigan","Midland County",3,56,1216,618,598
050,26,111,"Michigan","Midland County",3,57,1256,647,609
050,26,111,"Michigan","Midland County",3,58,1240,627,613
050,26,111,"Michigan","Midland County",3,59,1218,626,592
050,26,111,"Michigan","Midland County",3,60,1221,615,606
050,26,111,"Michigan","Midland County",3,61,1202,592,610
050,26,111,"Michigan","Midland County",3,62,1195,601,594
050,26,111,"Michigan","Midland County",3,63,1158,579,579
050,26,111,"Michigan","Midland County",3,64,1136,543,593
050,26,111,"Michigan","Midland County",3,65,1107,525,582
050,26,111,"Michigan","Midland County",3,66,1111,535,576
050,26,111,"Michigan","Midland County",3,67,1075,518,557
050,26,111,"Michigan","Midland County",3,68,998,479,519
050,26,111,"Michigan","Midland County",3,69,951,444,507
050,26,111,"Michigan","Midland County",3,70,928,417,511
050,26,111,"Michigan","Midland County",3,71,866,417,449
050,26,111,"Michigan","Midland County",3,72,844,403,441
050,26,111,"Michigan","Midland County",3,73,802,375,427
050,26,111,"Michigan","Midland County",3,74,826,387,439
050,26,111,"Michigan","Midland County",3,75,555,257,298
050,26,111,"Michigan","Midland County",3,76,531,245,286
050,26,111,"Michigan","Midland County",3,77,563,246,317
050,26,111,"Michigan","Midland County",3,78,613,261,352
050,26,111,"Michigan","Midland County",3,79,532,227,305
050,26,111,"Michigan","Midland County",3,80,456,190,266
050,26,111,"Michigan","Midland County",3,81,412,182,230
050,26,111,"Michigan","Midland County",3,82,399,167,232
050,26,111,"Michigan","Midland County",3,83,393,160,233
050,26,111,"Michigan","Midland County",3,84,352,149,203
050,26,111,"Michigan","Midland County",3,85,2144,750,1394
050,26,111,"Michigan","Midland County",4,0,861,453,408
050,26,111,"Michigan","Midland County",4,1,833,404,429
050,26,111,"Michigan","Midland County",4,2,874,435,439
050,26,111,"Michigan","Midland County",4,3,937,504,433
050,26,111,"Michigan","Midland County",4,4,949,503,446
050,26,111,"Michigan","Midland County",4,5,968,489,479
050,26,111,"Michigan","Midland County",4,6,931,485,446
050,26,111,"Michigan","Midland County",4,7,1013,512,501
050,26,111,"Michigan","Midland County",4,8,972,520,452
050,26,111,"Michigan","Midland County",4,9,962,525,437
050,26,111,"Michigan","Midland County",4,10,981,530,451
050,26,111,"Michigan","Midland County",4,11,966,516,450
050,26,111,"Michigan","Midland County",4,12,999,513,486
050,26,111,"Michigan","Midland County",4,13,1037,544,493
050,26,111,"Michigan","Midland County",4,14,1059,536,523
050,26,111,"Michigan","Midland County",4,15,1081,532,549
050,26,111,"Michigan","Midland County",4,16,1065,530,535
050,26,111,"Michigan","Midland County",4,17,1069,521,548
050,26,111,"Michigan","Midland County",4,18,953,501,452
050,26,111,"Michigan","Midland County",4,19,751,415,336
050,26,111,"Michigan","Midland County",4,20,830,430,400
050,26,111,"Michigan","Midland County",4,21,923,459,464
050,26,111,"Michigan","Midland County",4,22,967,520,447
050,26,111,"Michigan","Midland County",4,23,958,501,457
050,26,111,"Michigan","Midland County",4,24,963,476,487
050,26,111,"Michigan","Midland County",4,25,933,481,452
050,26,111,"Michigan","Midland County",4,26,971,481,490
050,26,111,"Michigan","Midland County",4,27,1006,492,514
050,26,111,"Michigan","Midland County",4,28,993,508,485
050,26,111,"Michigan","Midland County",4,29,1040,552,488
050,26,111,"Michigan","Midland County",4,30,1043,520,523
050,26,111,"Michigan","Midland County",4,31,1137,590,547
050,26,111,"Michigan","Midland County",4,32,1170,599,571
050,26,111,"Michigan","Midland County",4,33,1088,553,535
050,26,111,"Michigan","Midland County",4,34,1055,547,508
050,26,111,"Michigan","Midland County",4,35,1053,536,517
050,26,111,"Michigan","Midland County",4,36,1075,557,518
050,26,111,"Michigan","Midland County",4,37,1074,561,513
050,26,111,"Michigan","Midland County",4,38,1088,577,511
050,26,111,"Michigan","Midland County",4,39,1090,542,548
050,26,111,"Michigan","Midland County",4,40,1074,546,528
050,26,111,"Michigan","Midland County",4,41,1082,550,532
050,26,111,"Michigan","Midland County",4,42,1006,508,498
050,26,111,"Michigan","Midland County",4,43,1030,507,523
050,26,111,"Michigan","Midland County",4,44,1004,502,502
050,26,111,"Michigan","Midland County",4,45,980,503,477
050,26,111,"Michigan","Midland County",4,46,978,505,473
050,26,111,"Michigan","Midland County",4,47,943,462,481
050,26,111,"Michigan","Midland County",4,48,923,458,465
050,26,111,"Michigan","Midland County",4,49,973,490,483
050,26,111,"Michigan","Midland County",4,50,991,503,488
050,26,111,"Michigan","Midland County",4,51,1033,524,509
050,26,111,"Michigan","Midland County",4,52,1060,517,543
050,26,111,"Michigan","Midland County",4,53,1045,521,524
050,26,111,"Michigan","Midland County",4,54,1073,531,542
050,26,111,"Michigan","Midland County",4,55,1146,573,573
050,26,111,"Michigan","Midland County",4,56,1160,580,580
050,26,111,"Michigan","Midland County",4,57,1205,595,610
050,26,111,"Michigan","Midland County",4,58,1233,632,601
050,26,111,"Michigan","Midland County",4,59,1250,634,616
050,26,111,"Michigan","Midland County",4,60,1175,613,562
050,26,111,"Michigan","Midland County",4,61,1195,589,606
050,26,111,"Michigan","Midland County",4,62,1182,580,602
050,26,111,"Michigan","Midland County",4,63,1195,593,602
050,26,111,"Michigan","Midland County",4,64,1149,581,568
050,26,111,"Michigan","Midland County",4,65,1123,535,588
050,26,111,"Michigan","Midland County",4,66,1087,513,574
050,26,111,"Michigan","Midland County",4,67,1101,532,569
050,26,111,"Michigan","Midland County",4,68,1064,517,547
050,26,111,"Michigan","Midland County",4,69,978,465,513
050,26,111,"Michigan","Midland County",4,70,947,436,511
050,26,111,"Michigan","Midland County",4,71,910,412,498
050,26,111,"Michigan","Midland County",4,72,849,402,447
050,26,111,"Michigan","Midland County",4,73,828,386,442
050,26,111,"Michigan","Midland County",4,74,795,369,426
050,26,111,"Michigan","Midland County",4,75,820,384,436
050,26,111,"Michigan","Midland County",4,76,533,246,287
050,26,111,"Michigan","Midland County",4,77,516,237,279
050,26,111,"Michigan","Midland County",4,78,544,236,308
050,26,111,"Michigan","Midland County",4,79,616,262,354
050,26,111,"Michigan","Midland County",4,80,513,219,294
050,26,111,"Michigan","Midland County",4,81,429,177,252
050,26,111,"Michigan","Midland County",4,82,398,176,222
050,26,111,"Michigan","Midland County",4,83,383,155,228
050,26,111,"Michigan","Midland County",4,84,357,152,205
050,26,111,"Michigan","Midland County",4,85,2168,760,1408
050,26,111,"Michigan","Midland County",5,0,859,451,408
050,26,111,"Michigan","Midland County",5,1,840,447,393
050,26,111,"Michigan","Midland County",5,2,865,422,443
050,26,111,"Michigan","Midland County",5,3,894,449,445
050,26,111,"Michigan","Midland County",5,4,959,506,453
050,26,111,"Michigan","Midland County",5,5,954,499,455
050,26,111,"Michigan","Midland County",5,6,984,499,485
050,26,111,"Michigan","Midland County",5,7,958,496,462
050,26,111,"Michigan","Midland County",5,8,1022,508,514
050,26,111,"Michigan","Midland County",5,9,973,513,460
050,26,111,"Michigan","Midland County",5,10,972,531,441
050,26,111,"Michigan","Midland County",5,11,968,533,435
050,26,111,"Michigan","Midland County",5,12,958,513,445
050,26,111,"Michigan","Midland County",5,13,1008,503,505
050,26,111,"Michigan","Midland County",5,14,1055,558,497
050,26,111,"Michigan","Midland County",5,15,1089,556,533
050,26,111,"Michigan","Midland County",5,16,1069,528,541
050,26,111,"Michigan","Midland County",5,17,1082,546,536
050,26,111,"Michigan","Midland County",5,18,892,456,436
050,26,111,"Michigan","Midland County",5,19,758,406,352
050,26,111,"Michigan","Midland County",5,20,821,443,378
050,26,111,"Michigan","Midland County",5,21,910,469,441
050,26,111,"Michigan","Midland County",5,22,965,481,484
050,26,111,"Michigan","Midland County",5,23,986,525,461
050,26,111,"Michigan","Midland County",5,24,972,515,457
050,26,111,"Michigan","Midland County",5,25,954,473,481
050,26,111,"Michigan","Midland County",5,26,960,496,464
050,26,111,"Michigan","Midland County",5,27,941,477,464
050,26,111,"Michigan","Midland County",5,28,1019,498,521
050,26,111,"Michigan","Midland County",5,29,1000,500,500
050,26,111,"Michigan","Midland County",5,30,1043,546,497
050,26,111,"Michigan","Midland County",5,31,1063,522,541
050,26,111,"Michigan","Midland County",5,32,1162,604,558
050,26,111,"Michigan","Midland County",5,33,1196,616,580
050,26,111,"Michigan","Midland County",5,34,1122,568,554
050,26,111,"Michigan","Midland County",5,35,1080,567,513
050,26,111,"Michigan","Midland County",5,36,1074,540,534
050,26,111,"Michigan","Midland County",5,37,1102,551,551
050,26,111,"Michigan","Midland County",5,38,1095,584,511
050,26,111,"Michigan","Midland County",5,39,1085,573,512
050,26,111,"Michigan","Midland County",5,40,1105,548,557
050,26,111,"Michigan","Midland County",5,41,1059,548,511
050,26,111,"Michigan","Midland County",5,42,1087,558,529
050,26,111,"Michigan","Midland County",5,43,999,501,498
050,26,111,"Michigan","Midland County",5,44,1018,505,513
050,26,111,"Michigan","Midland County",5,45,993,492,501
050,26,111,"Michigan","Midland County",5,46,997,518,479
050,26,111,"Michigan","Midland County",5,47,969,497,472
050,26,111,"Michigan","Midland County",5,48,959,477,482
050,26,111,"Michigan","Midland County",5,49,909,451,458
050,26,111,"Michigan","Midland County",5,50,943,478,465
050,26,111,"Michigan","Midland County",5,51,1008,518,490
050,26,111,"Michigan","Midland County",5,52,1027,519,508
050,26,111,"Michigan","Midland County",5,53,1044,504,540
050,26,111,"Michigan","Midland County",5,54,1034,511,523
050,26,111,"Michigan","Midland County",5,55,1071,530,541
050,26,111,"Michigan","Midland County",5,56,1134,570,564
050,26,111,"Michigan","Midland County",5,57,1134,568,566
050,26,111,"Michigan","Midland County",5,58,1175,582,593
050,26,111,"Michigan","Midland County",5,59,1242,633,609
050,26,111,"Michigan","Midland County",5,60,1241,630,611
050,26,111,"Michigan","Midland County",5,61,1164,604,560
050,26,111,"Michigan","Midland County",5,62,1172,578,594
050,26,111,"Michigan","Midland County",5,63,1189,583,606
050,26,111,"Michigan","Midland County",5,64,1187,589,598
050,26,111,"Michigan","Midland County",5,65,1135,575,560
050,26,111,"Michigan","Midland County",5,66,1096,529,567
050,26,111,"Michigan","Midland County",5,67,1077,507,570
050,26,111,"Michigan","Midland County",5,68,1095,532,563
050,26,111,"Michigan","Midland County",5,69,1047,500,547
050,26,111,"Michigan","Midland County",5,70,971,458,513
050,26,111,"Michigan","Midland County",5,71,936,436,500
050,26,111,"Michigan","Midland County",5,72,891,401,490
050,26,111,"Michigan","Midland County",5,73,842,393,449
050,26,111,"Michigan","Midland County",5,74,830,385,445
050,26,111,"Michigan","Midland County",5,75,789,370,419
050,26,111,"Michigan","Midland County",5,76,781,364,417
050,26,111,"Michigan","Midland County",5,77,508,233,275
050,26,111,"Michigan","Midland County",5,78,495,228,267
050,26,111,"Michigan","Midland County",5,79,536,228,308
050,26,111,"Michigan","Midland County",5,80,596,256,340
050,26,111,"Michigan","Midland County",5,81,486,205,281
050,26,111,"Michigan","Midland County",5,82,411,167,244
050,26,111,"Michigan","Midland County",5,83,383,163,220
050,26,111,"Michigan","Midland County",5,84,354,149,205
050,26,111,"Michigan","Midland County",5,85,2211,780,1431
050,26,113,"Michigan","Missaukee County",1,0,174,91,83
050,26,113,"Michigan","Missaukee County",1,1,159,84,75
050,26,113,"Michigan","Missaukee County",1,2,167,74,93
050,26,113,"Michigan","Missaukee County",1,3,183,82,101
050,26,113,"Michigan","Missaukee County",1,4,199,101,98
050,26,113,"Michigan","Missaukee County",1,5,183,97,86
050,26,113,"Michigan","Missaukee County",1,6,196,99,97
050,26,113,"Michigan","Missaukee County",1,7,198,99,99
050,26,113,"Michigan","Missaukee County",1,8,206,106,100
050,26,113,"Michigan","Missaukee County",1,9,184,94,90
050,26,113,"Michigan","Missaukee County",1,10,179,85,94
050,26,113,"Michigan","Missaukee County",1,11,196,102,94
050,26,113,"Michigan","Missaukee County",1,12,203,111,92
050,26,113,"Michigan","Missaukee County",1,13,207,110,97
050,26,113,"Michigan","Missaukee County",1,14,213,105,108
050,26,113,"Michigan","Missaukee County",1,15,187,94,93
050,26,113,"Michigan","Missaukee County",1,16,208,104,104
050,26,113,"Michigan","Missaukee County",1,17,208,109,99
050,26,113,"Michigan","Missaukee County",1,18,178,102,76
050,26,113,"Michigan","Missaukee County",1,19,127,72,55
050,26,113,"Michigan","Missaukee County",1,20,142,81,61
050,26,113,"Michigan","Missaukee County",1,21,119,66,53
050,26,113,"Michigan","Missaukee County",1,22,136,68,68
050,26,113,"Michigan","Missaukee County",1,23,145,72,73
050,26,113,"Michigan","Missaukee County",1,24,167,85,82
050,26,113,"Michigan","Missaukee County",1,25,177,86,91
050,26,113,"Michigan","Missaukee County",1,26,171,92,79
050,26,113,"Michigan","Missaukee County",1,27,179,89,90
050,26,113,"Michigan","Missaukee County",1,28,174,99,75
050,26,113,"Michigan","Missaukee County",1,29,174,88,86
050,26,113,"Michigan","Missaukee County",1,30,164,81,83
050,26,113,"Michigan","Missaukee County",1,31,164,80,84
050,26,113,"Michigan","Missaukee County",1,32,172,80,92
050,26,113,"Michigan","Missaukee County",1,33,160,78,82
050,26,113,"Michigan","Missaukee County",1,34,172,90,82
050,26,113,"Michigan","Missaukee County",1,35,166,88,78
050,26,113,"Michigan","Missaukee County",1,36,181,102,79
050,26,113,"Michigan","Missaukee County",1,37,164,83,81
050,26,113,"Michigan","Missaukee County",1,38,172,88,84
050,26,113,"Michigan","Missaukee County",1,39,185,92,93
050,26,113,"Michigan","Missaukee County",1,40,162,73,89
050,26,113,"Michigan","Missaukee County",1,41,163,80,83
050,26,113,"Michigan","Missaukee County",1,42,154,75,79
050,26,113,"Michigan","Missaukee County",1,43,143,63,80
050,26,113,"Michigan","Missaukee County",1,44,135,73,62
050,26,113,"Michigan","Missaukee County",1,45,130,73,57
050,26,113,"Michigan","Missaukee County",1,46,136,67,69
050,26,113,"Michigan","Missaukee County",1,47,156,76,80
050,26,113,"Michigan","Missaukee County",1,48,183,92,91
050,26,113,"Michigan","Missaukee County",1,49,191,101,90
050,26,113,"Michigan","Missaukee County",1,50,182,97,85
050,26,113,"Michigan","Missaukee County",1,51,179,97,82
050,26,113,"Michigan","Missaukee County",1,52,187,81,106
050,26,113,"Michigan","Missaukee County",1,53,188,92,96
050,26,113,"Michigan","Missaukee County",1,54,200,104,96
050,26,113,"Michigan","Missaukee County",1,55,231,115,116
050,26,113,"Michigan","Missaukee County",1,56,238,121,117
050,26,113,"Michigan","Missaukee County",1,57,256,134,122
050,26,113,"Michigan","Missaukee County",1,58,244,135,109
050,26,113,"Michigan","Missaukee County",1,59,231,125,106
050,26,113,"Michigan","Missaukee County",1,60,213,111,102
050,26,113,"Michigan","Missaukee County",1,61,252,126,126
050,26,113,"Michigan","Missaukee County",1,62,255,131,124
050,26,113,"Michigan","Missaukee County",1,63,239,121,118
050,26,113,"Michigan","Missaukee County",1,64,234,126,108
050,26,113,"Michigan","Missaukee County",1,65,229,111,118
050,26,113,"Michigan","Missaukee County",1,66,204,109,95
050,26,113,"Michigan","Missaukee County",1,67,214,109,105
050,26,113,"Michigan","Missaukee County",1,68,214,113,101
050,26,113,"Michigan","Missaukee County",1,69,190,95,95
050,26,113,"Michigan","Missaukee County",1,70,182,93,89
050,26,113,"Michigan","Missaukee County",1,71,180,87,93
050,26,113,"Michigan","Missaukee County",1,72,174,87,87
050,26,113,"Michigan","Missaukee County",1,73,183,88,95
050,26,113,"Michigan","Missaukee County",1,74,130,61,69
050,26,113,"Michigan","Missaukee County",1,75,124,64,60
050,26,113,"Michigan","Missaukee County",1,76,123,70,53
050,26,113,"Michigan","Missaukee County",1,77,120,63,57
050,26,113,"Michigan","Missaukee County",1,78,114,57,57
050,26,113,"Michigan","Missaukee County",1,79,84,39,45
050,26,113,"Michigan","Missaukee County",1,80,86,43,43
050,26,113,"Michigan","Missaukee County",1,81,87,39,48
050,26,113,"Michigan","Missaukee County",1,82,69,30,39
050,26,113,"Michigan","Missaukee County",1,83,78,39,39
050,26,113,"Michigan","Missaukee County",1,84,65,33,32
050,26,113,"Michigan","Missaukee County",1,85,284,103,181
050,26,113,"Michigan","Missaukee County",2,0,166,92,74
050,26,113,"Michigan","Missaukee County",2,1,160,84,76
050,26,113,"Michigan","Missaukee County",2,2,164,76,88
050,26,113,"Michigan","Missaukee County",2,3,176,79,97
050,26,113,"Michigan","Missaukee County",2,4,194,96,98
050,26,113,"Michigan","Missaukee County",2,5,186,97,89
050,26,113,"Michigan","Missaukee County",2,6,194,100,94
050,26,113,"Michigan","Missaukee County",2,7,196,97,99
050,26,113,"Michigan","Missaukee County",2,8,205,105,100
050,26,113,"Michigan","Missaukee County",2,9,189,96,93
050,26,113,"Michigan","Missaukee County",2,10,181,87,94
050,26,113,"Michigan","Missaukee County",2,11,191,98,93
050,26,113,"Michigan","Missaukee County",2,12,202,110,92
050,26,113,"Michigan","Missaukee County",2,13,208,111,97
050,26,113,"Michigan","Missaukee County",2,14,212,107,105
050,26,113,"Michigan","Missaukee County",2,15,192,97,95
050,26,113,"Michigan","Missaukee County",2,16,208,104,104
050,26,113,"Michigan","Missaukee County",2,17,209,108,101
050,26,113,"Michigan","Missaukee County",2,18,176,99,77
050,26,113,"Michigan","Missaukee County",2,19,131,75,56
050,26,113,"Michigan","Missaukee County",2,20,144,82,62
050,26,113,"Michigan","Missaukee County",2,21,124,69,55
050,26,113,"Michigan","Missaukee County",2,22,132,67,65
050,26,113,"Michigan","Missaukee County",2,23,146,72,74
050,26,113,"Michigan","Missaukee County",2,24,166,84,82
050,26,113,"Michigan","Missaukee County",2,25,174,85,89
050,26,113,"Michigan","Missaukee County",2,26,174,93,81
050,26,113,"Michigan","Missaukee County",2,27,178,92,86
050,26,113,"Michigan","Missaukee County",2,28,177,98,79
050,26,113,"Michigan","Missaukee County",2,29,174,90,84
050,26,113,"Michigan","Missaukee County",2,30,169,84,85
050,26,113,"Michigan","Missaukee County",2,31,164,80,84
050,26,113,"Michigan","Missaukee County",2,32,170,79,91
050,26,113,"Michigan","Missaukee County",2,33,167,81,86
050,26,113,"Michigan","Missaukee County",2,34,173,89,84
050,26,113,"Michigan","Missaukee County",2,35,169,90,79
050,26,113,"Michigan","Missaukee County",2,36,178,99,79
050,26,113,"Michigan","Missaukee County",2,37,167,86,81
050,26,113,"Michigan","Missaukee County",2,38,172,87,85
050,26,113,"Michigan","Missaukee County",2,39,182,91,91
050,26,113,"Michigan","Missaukee County",2,40,169,78,91
050,26,113,"Michigan","Missaukee County",2,41,160,79,81
050,26,113,"Michigan","Missaukee County",2,42,155,75,80
050,26,113,"Michigan","Missaukee County",2,43,149,67,82
050,26,113,"Michigan","Missaukee County",2,44,134,69,65
050,26,113,"Michigan","Missaukee County",2,45,133,74,59
050,26,113,"Michigan","Missaukee County",2,46,133,68,65
050,26,113,"Michigan","Missaukee County",2,47,153,76,77
050,26,113,"Michigan","Missaukee County",2,48,177,89,88
050,26,113,"Michigan","Missaukee County",2,49,190,99,91
050,26,113,"Michigan","Missaukee County",2,50,183,96,87
050,26,113,"Michigan","Missaukee County",2,51,180,96,84
050,26,113,"Michigan","Missaukee County",2,52,187,87,100
050,26,113,"Michigan","Missaukee County",2,53,186,90,96
050,26,113,"Michigan","Missaukee County",2,54,198,101,97
050,26,113,"Michigan","Missaukee County",2,55,223,112,111
050,26,113,"Michigan","Missaukee County",2,56,235,119,116
050,26,113,"Michigan","Missaukee County",2,57,252,129,123
050,26,113,"Michigan","Missaukee County",2,58,244,133,111
050,26,113,"Michigan","Missaukee County",2,59,236,128,108
050,26,113,"Michigan","Missaukee County",2,60,219,115,104
050,26,113,"Michigan","Missaukee County",2,61,243,122,121
050,26,113,"Michigan","Missaukee County",2,62,253,131,122
050,26,113,"Michigan","Missaukee County",2,63,245,125,120
050,26,113,"Michigan","Missaukee County",2,64,234,124,110
050,26,113,"Michigan","Missaukee County",2,65,231,114,117
050,26,113,"Michigan","Missaukee County",2,66,209,109,100
050,26,113,"Michigan","Missaukee County",2,67,210,109,101
050,26,113,"Michigan","Missaukee County",2,68,213,112,101
050,26,113,"Michigan","Missaukee County",2,69,198,101,97
050,26,113,"Michigan","Missaukee County",2,70,183,92,91
050,26,113,"Michigan","Missaukee County",2,71,179,88,91
050,26,113,"Michigan","Missaukee County",2,72,171,87,84
050,26,113,"Michigan","Missaukee County",2,73,191,92,99
050,26,113,"Michigan","Missaukee County",2,74,131,63,68
050,26,113,"Michigan","Missaukee County",2,75,126,64,62
050,26,113,"Michigan","Missaukee County",2,76,120,66,54
050,26,113,"Michigan","Missaukee County",2,77,122,64,58
050,26,113,"Michigan","Missaukee County",2,78,113,58,55
050,26,113,"Michigan","Missaukee County",2,79,89,42,47
050,26,113,"Michigan","Missaukee County",2,80,86,42,44
050,26,113,"Michigan","Missaukee County",2,81,83,37,46
050,26,113,"Michigan","Missaukee County",2,82,73,31,42
050,26,113,"Michigan","Missaukee County",2,83,72,34,38
050,26,113,"Michigan","Missaukee County",2,84,66,34,32
050,26,113,"Michigan","Missaukee County",2,85,288,105,183
050,26,113,"Michigan","Missaukee County",3,0,160,97,63
050,26,113,"Michigan","Missaukee County",3,1,168,97,71
050,26,113,"Michigan","Missaukee County",3,2,160,86,74
050,26,113,"Michigan","Missaukee County",3,3,183,85,98
050,26,113,"Michigan","Missaukee County",3,4,177,77,100
050,26,113,"Michigan","Missaukee County",3,5,203,102,101
050,26,113,"Michigan","Missaukee County",3,6,188,97,91
050,26,113,"Michigan","Missaukee County",3,7,196,100,96
050,26,113,"Michigan","Missaukee County",3,8,198,98,100
050,26,113,"Michigan","Missaukee County",3,9,201,99,102
050,26,113,"Michigan","Missaukee County",3,10,185,94,91
050,26,113,"Michigan","Missaukee County",3,11,175,82,93
050,26,113,"Michigan","Missaukee County",3,12,196,95,101
050,26,113,"Michigan","Missaukee County",3,13,198,107,91
050,26,113,"Michigan","Missaukee County",3,14,213,109,104
050,26,113,"Michigan","Missaukee County",3,15,213,107,106
050,26,113,"Michigan","Missaukee County",3,16,197,98,99
050,26,113,"Michigan","Missaukee County",3,17,204,101,103
050,26,113,"Michigan","Missaukee County",3,18,168,91,77
050,26,113,"Michigan","Missaukee County",3,19,130,74,56
050,26,113,"Michigan","Missaukee County",3,20,147,88,59
050,26,113,"Michigan","Missaukee County",3,21,151,82,69
050,26,113,"Michigan","Missaukee County",3,22,131,70,61
050,26,113,"Michigan","Missaukee County",3,23,134,71,63
050,26,113,"Michigan","Missaukee County",3,24,160,81,79
050,26,113,"Michigan","Missaukee County",3,25,165,82,83
050,26,113,"Michigan","Missaukee County",3,26,175,87,88
050,26,113,"Michigan","Missaukee County",3,27,195,102,93
050,26,113,"Michigan","Missaukee County",3,28,178,93,85
050,26,113,"Michigan","Missaukee County",3,29,180,101,79
050,26,113,"Michigan","Missaukee County",3,30,182,90,92
050,26,113,"Michigan","Missaukee County",3,31,170,82,88
050,26,113,"Michigan","Missaukee County",3,32,170,83,87
050,26,113,"Michigan","Missaukee County",3,33,174,87,87
050,26,113,"Michigan","Missaukee County",3,34,175,87,88
050,26,113,"Michigan","Missaukee County",3,35,175,88,87
050,26,113,"Michigan","Missaukee County",3,36,169,95,74
050,26,113,"Michigan","Missaukee County",3,37,190,104,86
050,26,113,"Michigan","Missaukee County",3,38,175,90,85
050,26,113,"Michigan","Missaukee County",3,39,168,84,84
050,26,113,"Michigan","Missaukee County",3,40,188,91,97
050,26,113,"Michigan","Missaukee County",3,41,161,76,85
050,26,113,"Michigan","Missaukee County",3,42,161,77,84
050,26,113,"Michigan","Missaukee County",3,43,151,73,78
050,26,113,"Michigan","Missaukee County",3,44,147,69,78
050,26,113,"Michigan","Missaukee County",3,45,134,70,64
050,26,113,"Michigan","Missaukee County",3,46,142,77,65
050,26,113,"Michigan","Missaukee County",3,47,135,69,66
050,26,113,"Michigan","Missaukee County",3,48,159,84,75
050,26,113,"Michigan","Missaukee County",3,49,173,86,87
050,26,113,"Michigan","Missaukee County",3,50,192,94,98
050,26,113,"Michigan","Missaukee County",3,51,190,94,96
050,26,113,"Michigan","Missaukee County",3,52,181,96,85
050,26,113,"Michigan","Missaukee County",3,53,182,83,99
050,26,113,"Michigan","Missaukee County",3,54,184,92,92
050,26,113,"Michigan","Missaukee County",3,55,188,99,89
050,26,113,"Michigan","Missaukee County",3,56,227,114,113
050,26,113,"Michigan","Missaukee County",3,57,251,127,124
050,26,113,"Michigan","Missaukee County",3,58,257,134,123
050,26,113,"Michigan","Missaukee County",3,59,257,133,124
050,26,113,"Michigan","Missaukee County",3,60,245,135,110
050,26,113,"Michigan","Missaukee County",3,61,223,112,111
050,26,113,"Michigan","Missaukee County",3,62,238,123,115
050,26,113,"Michigan","Missaukee County",3,63,246,128,118
050,26,113,"Michigan","Missaukee County",3,64,249,126,123
050,26,113,"Michigan","Missaukee County",3,65,228,121,107
050,26,113,"Michigan","Missaukee County",3,66,228,115,113
050,26,113,"Michigan","Missaukee County",3,67,198,111,87
050,26,113,"Michigan","Missaukee County",3,68,211,112,99
050,26,113,"Michigan","Missaukee County",3,69,212,110,102
050,26,113,"Michigan","Missaukee County",3,70,190,93,97
050,26,113,"Michigan","Missaukee County",3,71,172,85,87
050,26,113,"Michigan","Missaukee County",3,72,178,89,89
050,26,113,"Michigan","Missaukee County",3,73,171,87,84
050,26,113,"Michigan","Missaukee County",3,74,184,90,94
050,26,113,"Michigan","Missaukee County",3,75,131,65,66
050,26,113,"Michigan","Missaukee County",3,76,118,60,58
050,26,113,"Michigan","Missaukee County",3,77,119,64,55
050,26,113,"Michigan","Missaukee County",3,78,122,65,57
050,26,113,"Michigan","Missaukee County",3,79,108,58,50
050,26,113,"Michigan","Missaukee County",3,80,83,41,42
050,26,113,"Michigan","Missaukee County",3,81,82,41,41
050,26,113,"Michigan","Missaukee County",3,82,72,31,41
050,26,113,"Michigan","Missaukee County",3,83,73,30,43
050,26,113,"Michigan","Missaukee County",3,84,61,27,34
050,26,113,"Michigan","Missaukee County",3,85,294,111,183
050,26,113,"Michigan","Missaukee County",4,0,164,98,66
050,26,113,"Michigan","Missaukee County",4,1,162,86,76
050,26,113,"Michigan","Missaukee County",4,2,174,103,71
050,26,113,"Michigan","Missaukee County",4,3,167,90,77
050,26,113,"Michigan","Missaukee County",4,4,181,87,94
050,26,113,"Michigan","Missaukee County",4,5,189,82,107
050,26,113,"Michigan","Missaukee County",4,6,209,109,100
050,26,113,"Michigan","Missaukee County",4,7,186,102,84
050,26,113,"Michigan","Missaukee County",4,8,203,107,96
050,26,113,"Michigan","Missaukee County",4,9,202,101,101
050,26,113,"Michigan","Missaukee County",4,10,209,107,102
050,26,113,"Michigan","Missaukee County",4,11,188,98,90
050,26,113,"Michigan","Missaukee County",4,12,176,88,88
050,26,113,"Michigan","Missaukee County",4,13,208,105,103
050,26,113,"Michigan","Missaukee County",4,14,192,108,84
050,26,113,"Michigan","Missaukee County",4,15,204,105,99
050,26,113,"Michigan","Missaukee County",4,16,213,106,107
050,26,113,"Michigan","Missaukee County",4,17,191,93,98
050,26,113,"Michigan","Missaukee County",4,18,170,89,81
050,26,113,"Michigan","Missaukee County",4,19,124,65,59
050,26,113,"Michigan","Missaukee County",4,20,144,86,58
050,26,113,"Michigan","Missaukee County",4,21,136,81,55
050,26,113,"Michigan","Missaukee County",4,22,145,75,70
050,26,113,"Michigan","Missaukee County",4,23,136,75,61
050,26,113,"Michigan","Missaukee County",4,24,142,77,65
050,26,113,"Michigan","Missaukee County",4,25,155,70,85
050,26,113,"Michigan","Missaukee County",4,26,172,85,87
050,26,113,"Michigan","Missaukee County",4,27,183,91,92
050,26,113,"Michigan","Missaukee County",4,28,204,111,93
050,26,113,"Michigan","Missaukee County",4,29,186,98,88
050,26,113,"Michigan","Missaukee County",4,30,179,95,84
050,26,113,"Michigan","Missaukee County",4,31,187,98,89
050,26,113,"Michigan","Missaukee County",4,32,175,82,93
050,26,113,"Michigan","Missaukee County",4,33,180,86,94
050,26,113,"Michigan","Missaukee County",4,34,180,87,93
050,26,113,"Michigan","Missaukee County",4,35,173,84,89
050,26,113,"Michigan","Missaukee County",4,36,172,90,82
050,26,113,"Michigan","Missaukee County",4,37,163,88,75
050,26,113,"Michigan","Missaukee County",4,38,185,106,79
050,26,113,"Michigan","Missaukee County",4,39,174,89,85
050,26,113,"Michigan","Missaukee County",4,40,176,87,89
050,26,113,"Michigan","Missaukee County",4,41,179,91,88
050,26,113,"Michigan","Missaukee County",4,42,160,74,86
050,26,113,"Michigan","Missaukee County",4,43,165,83,82
050,26,113,"Michigan","Missaukee County",4,44,147,72,75
050,26,113,"Michigan","Missaukee County",4,45,151,68,83
050,26,113,"Michigan","Missaukee County",4,46,137,71,66
050,26,113,"Michigan","Missaukee County",4,47,146,80,66
050,26,113,"Michigan","Missaukee County",4,48,137,70,67
050,26,113,"Michigan","Missaukee County",4,49,160,83,77
050,26,113,"Michigan","Missaukee County",4,50,164,80,84
050,26,113,"Michigan","Missaukee County",4,51,195,93,102
050,26,113,"Michigan","Missaukee County",4,52,198,93,105
050,26,113,"Michigan","Missaukee County",4,53,184,97,87
050,26,113,"Michigan","Missaukee County",4,54,185,86,99
050,26,113,"Michigan","Missaukee County",4,55,180,90,90
050,26,113,"Michigan","Missaukee County",4,56,191,100,91
050,26,113,"Michigan","Missaukee County",4,57,235,117,118
050,26,113,"Michigan","Missaukee County",4,58,248,127,121
050,26,113,"Michigan","Missaukee County",4,59,273,142,131
050,26,113,"Michigan","Missaukee County",4,60,251,129,122
050,26,113,"Michigan","Missaukee County",4,61,253,137,116
050,26,113,"Michigan","Missaukee County",4,62,220,111,109
050,26,113,"Michigan","Missaukee County",4,63,236,121,115
050,26,113,"Michigan","Missaukee County",4,64,245,123,122
050,26,113,"Michigan","Missaukee County",4,65,255,132,123
050,26,113,"Michigan","Missaukee County",4,66,227,121,106
050,26,113,"Michigan","Missaukee County",4,67,224,111,113
050,26,113,"Michigan","Missaukee County",4,68,198,109,89
050,26,113,"Michigan","Missaukee County",4,69,213,114,99
050,26,113,"Michigan","Missaukee County",4,70,202,104,98
050,26,113,"Michigan","Missaukee County",4,71,184,89,95
050,26,113,"Michigan","Missaukee County",4,72,170,85,85
050,26,113,"Michigan","Missaukee County",4,73,177,88,89
050,26,113,"Michigan","Missaukee County",4,74,166,84,82
050,26,113,"Michigan","Missaukee County",4,75,176,84,92
050,26,113,"Michigan","Missaukee County",4,76,119,59,60
050,26,113,"Michigan","Missaukee County",4,77,117,58,59
050,26,113,"Michigan","Missaukee County",4,78,108,56,52
050,26,113,"Michigan","Missaukee County",4,79,125,69,56
050,26,113,"Michigan","Missaukee County",4,80,103,54,49
050,26,113,"Michigan","Missaukee County",4,81,77,39,38
050,26,113,"Michigan","Missaukee County",4,82,72,32,40
050,26,113,"Michigan","Missaukee County",4,83,68,29,39
050,26,113,"Michigan","Missaukee County",4,84,65,25,40
050,26,113,"Michigan","Missaukee County",4,85,287,103,184
050,26,113,"Michigan","Missaukee County",5,0,159,96,63
050,26,113,"Michigan","Missaukee County",5,1,163,100,63
050,26,113,"Michigan","Missaukee County",5,2,166,91,75
050,26,113,"Michigan","Missaukee County",5,3,174,103,71
050,26,113,"Michigan","Missaukee County",5,4,180,91,89
050,26,113,"Michigan","Missaukee County",5,5,175,85,90
050,26,113,"Michigan","Missaukee County",5,6,181,78,103
050,26,113,"Michigan","Missaukee County",5,7,208,109,99
050,26,113,"Michigan","Missaukee County",5,8,183,102,81
050,26,113,"Michigan","Missaukee County",5,9,207,107,100
050,26,113,"Michigan","Missaukee County",5,10,195,90,105
050,26,113,"Michigan","Missaukee County",5,11,208,101,107
050,26,113,"Michigan","Missaukee County",5,12,189,101,88
050,26,113,"Michigan","Missaukee County",5,13,176,88,88
050,26,113,"Michigan","Missaukee County",5,14,203,103,100
050,26,113,"Michigan","Missaukee County",5,15,191,103,88
050,26,113,"Michigan","Missaukee County",5,16,206,103,103
050,26,113,"Michigan","Missaukee County",5,17,217,107,110
050,26,113,"Michigan","Missaukee County",5,18,161,81,80
050,26,113,"Michigan","Missaukee County",5,19,124,66,58
050,26,113,"Michigan","Missaukee County",5,20,143,77,66
050,26,113,"Michigan","Missaukee County",5,21,140,78,62
050,26,113,"Michigan","Missaukee County",5,22,156,84,72
050,26,113,"Michigan","Missaukee County",5,23,160,89,71
050,26,113,"Michigan","Missaukee County",5,24,146,78,68
050,26,113,"Michigan","Missaukee County",5,25,150,80,70
050,26,113,"Michigan","Missaukee County",5,26,158,71,87
050,26,113,"Michigan","Missaukee County",5,27,187,93,94
050,26,113,"Michigan","Missaukee County",5,28,177,84,93
050,26,113,"Michigan","Missaukee County",5,29,191,107,84
050,26,113,"Michigan","Missaukee County",5,30,182,93,89
050,26,113,"Michigan","Missaukee County",5,31,190,100,90
050,26,113,"Michigan","Missaukee County",5,32,189,95,94
050,26,113,"Michigan","Missaukee County",5,33,179,83,96
050,26,113,"Michigan","Missaukee County",5,34,186,91,95
050,26,113,"Michigan","Missaukee County",5,35,180,82,98
050,26,113,"Michigan","Missaukee County",5,36,174,84,90
050,26,113,"Michigan","Missaukee County",5,37,165,83,82
050,26,113,"Michigan","Missaukee County",5,38,168,89,79
050,26,113,"Michigan","Missaukee County",5,39,191,112,79
050,26,113,"Michigan","Missaukee County",5,40,178,85,93
050,26,113,"Michigan","Missaukee County",5,41,176,95,81
050,26,113,"Michigan","Missaukee County",5,42,179,94,85
050,26,113,"Michigan","Missaukee County",5,43,162,72,90
050,26,113,"Michigan","Missaukee County",5,44,166,85,81
050,26,113,"Michigan","Missaukee County",5,45,150,77,73
050,26,113,"Michigan","Missaukee County",5,46,146,68,78
050,26,113,"Michigan","Missaukee County",5,47,144,78,66
050,26,113,"Michigan","Missaukee County",5,48,142,77,65
050,26,113,"Michigan","Missaukee County",5,49,137,68,69
050,26,113,"Michigan","Missaukee County",5,50,156,80,76
050,26,113,"Michigan","Missaukee County",5,51,164,82,82
050,26,113,"Michigan","Missaukee County",5,52,203,99,104
050,26,113,"Michigan","Missaukee County",5,53,200,96,104
050,26,113,"Michigan","Missaukee County",5,54,184,100,84
050,26,113,"Michigan","Missaukee County",5,55,183,82,101
050,26,113,"Michigan","Missaukee County",5,56,178,89,89
050,26,113,"Michigan","Missaukee County",5,57,199,100,99
050,26,113,"Michigan","Missaukee County",5,58,239,121,118
050,26,113,"Michigan","Missaukee County",5,59,245,124,121
050,26,113,"Michigan","Missaukee County",5,60,275,142,133
050,26,113,"Michigan","Missaukee County",5,61,256,131,125
050,26,113,"Michigan","Missaukee County",5,62,252,136,116
050,26,113,"Michigan","Missaukee County",5,63,228,118,110
050,26,113,"Michigan","Missaukee County",5,64,231,118,113
050,26,113,"Michigan","Missaukee County",5,65,235,118,117
050,26,113,"Michigan","Missaukee County",5,66,253,128,125
050,26,113,"Michigan","Missaukee County",5,67,229,123,106
050,26,113,"Michigan","Missaukee County",5,68,228,113,115
050,26,113,"Michigan","Missaukee County",5,69,200,107,93
050,26,113,"Michigan","Missaukee County",5,70,204,106,98
050,26,113,"Michigan","Missaukee County",5,71,196,100,96
050,26,113,"Michigan","Missaukee County",5,72,183,88,95
050,26,113,"Michigan","Missaukee County",5,73,175,87,88
050,26,113,"Michigan","Missaukee County",5,74,172,86,86
050,26,113,"Michigan","Missaukee County",5,75,168,83,85
050,26,113,"Michigan","Missaukee County",5,76,170,77,93
050,26,113,"Michigan","Missaukee County",5,77,114,56,58
050,26,113,"Michigan","Missaukee County",5,78,112,56,56
050,26,113,"Michigan","Missaukee County",5,79,108,55,53
050,26,113,"Michigan","Missaukee County",5,80,121,65,56
050,26,113,"Michigan","Missaukee County",5,81,96,52,44
050,26,113,"Michigan","Missaukee County",5,82,72,32,40
050,26,113,"Michigan","Missaukee County",5,83,68,31,37
050,26,113,"Michigan","Missaukee County",5,84,56,24,32
050,26,113,"Michigan","Missaukee County",5,85,300,105,195
050,26,115,"Michigan","Monroe County",1,0,1472,755,717
050,26,115,"Michigan","Monroe County",1,1,1552,792,760
050,26,115,"Michigan","Monroe County",1,2,1596,822,774
050,26,115,"Michigan","Monroe County",1,3,1667,856,811
050,26,115,"Michigan","Monroe County",1,4,1703,874,829
050,26,115,"Michigan","Monroe County",1,5,1710,885,825
050,26,115,"Michigan","Monroe County",1,6,1776,912,864
050,26,115,"Michigan","Monroe County",1,7,1771,922,849
050,26,115,"Michigan","Monroe County",1,8,1807,927,880
050,26,115,"Michigan","Monroe County",1,9,1848,946,902
050,26,115,"Michigan","Monroe County",1,10,1953,1021,932
050,26,115,"Michigan","Monroe County",1,11,1945,986,959
050,26,115,"Michigan","Monroe County",1,12,1977,998,979
050,26,115,"Michigan","Monroe County",1,13,1982,995,987
050,26,115,"Michigan","Monroe County",1,14,2029,1018,1011
050,26,115,"Michigan","Monroe County",1,15,2024,1009,1015
050,26,115,"Michigan","Monroe County",1,16,2100,1041,1059
050,26,115,"Michigan","Monroe County",1,17,2106,1040,1066
050,26,115,"Michigan","Monroe County",1,18,1792,927,865
050,26,115,"Michigan","Monroe County",1,19,1496,805,691
050,26,115,"Michigan","Monroe County",1,20,1586,846,740
050,26,115,"Michigan","Monroe County",1,21,1681,902,779
050,26,115,"Michigan","Monroe County",1,22,1762,899,863
050,26,115,"Michigan","Monroe County",1,23,1780,900,880
050,26,115,"Michigan","Monroe County",1,24,1803,915,888
050,26,115,"Michigan","Monroe County",1,25,1841,994,847
050,26,115,"Michigan","Monroe County",1,26,1780,926,854
050,26,115,"Michigan","Monroe County",1,27,1817,933,884
050,26,115,"Michigan","Monroe County",1,28,1946,967,979
050,26,115,"Michigan","Monroe County",1,29,1982,1006,976
050,26,115,"Michigan","Monroe County",1,30,1918,980,938
050,26,115,"Michigan","Monroe County",1,31,1827,954,873
050,26,115,"Michigan","Monroe County",1,32,1748,902,846
050,26,115,"Michigan","Monroe County",1,33,1708,869,839
050,26,115,"Michigan","Monroe County",1,34,1769,885,884
050,26,115,"Michigan","Monroe County",1,35,1757,866,891
050,26,115,"Michigan","Monroe County",1,36,1840,917,923
050,26,115,"Michigan","Monroe County",1,37,1853,945,908
050,26,115,"Michigan","Monroe County",1,38,1837,916,921
050,26,115,"Michigan","Monroe County",1,39,1862,938,924
050,26,115,"Michigan","Monroe County",1,40,1871,907,964
050,26,115,"Michigan","Monroe County",1,41,1808,900,908
050,26,115,"Michigan","Monroe County",1,42,1840,904,936
050,26,115,"Michigan","Monroe County",1,43,1791,891,900
050,26,115,"Michigan","Monroe County",1,44,1803,913,890
050,26,115,"Michigan","Monroe County",1,45,1895,935,960
050,26,115,"Michigan","Monroe County",1,46,1850,934,916
050,26,115,"Michigan","Monroe County",1,47,1899,995,904
050,26,115,"Michigan","Monroe County",1,48,2084,1057,1027
050,26,115,"Michigan","Monroe County",1,49,2207,1113,1094
050,26,115,"Michigan","Monroe County",1,50,2121,1086,1035
050,26,115,"Michigan","Monroe County",1,51,2033,1033,1000
050,26,115,"Michigan","Monroe County",1,52,2092,1058,1034
050,26,115,"Michigan","Monroe County",1,53,2211,1093,1118
050,26,115,"Michigan","Monroe County",1,54,2252,1111,1141
050,26,115,"Michigan","Monroe County",1,55,2269,1122,1147
050,26,115,"Michigan","Monroe County",1,56,2395,1218,1177
050,26,115,"Michigan","Monroe County",1,57,2465,1210,1255
050,26,115,"Michigan","Monroe County",1,58,2475,1237,1238
050,26,115,"Michigan","Monroe County",1,59,2480,1264,1216
050,26,115,"Michigan","Monroe County",1,60,2407,1220,1187
050,26,115,"Michigan","Monroe County",1,61,2381,1201,1180
050,26,115,"Michigan","Monroe County",1,62,2405,1188,1217
050,26,115,"Michigan","Monroe County",1,63,2334,1193,1141
050,26,115,"Michigan","Monroe County",1,64,2254,1130,1124
050,26,115,"Michigan","Monroe County",1,65,2139,1051,1088
050,26,115,"Michigan","Monroe County",1,66,2058,1012,1046
050,26,115,"Michigan","Monroe County",1,67,1974,979,995
050,26,115,"Michigan","Monroe County",1,68,1957,990,967
050,26,115,"Michigan","Monroe County",1,69,1817,876,941
050,26,115,"Michigan","Monroe County",1,70,1704,851,853
050,26,115,"Michigan","Monroe County",1,71,1648,808,840
050,26,115,"Michigan","Monroe County",1,72,1623,776,847
050,26,115,"Michigan","Monroe County",1,73,1618,754,864
050,26,115,"Michigan","Monroe County",1,74,1070,506,564
050,26,115,"Michigan","Monroe County",1,75,1017,483,534
050,26,115,"Michigan","Monroe County",1,76,1030,486,544
050,26,115,"Michigan","Monroe County",1,77,1136,519,617
050,26,115,"Michigan","Monroe County",1,78,963,429,534
050,26,115,"Michigan","Monroe County",1,79,818,356,462
050,26,115,"Michigan","Monroe County",1,80,754,333,421
050,26,115,"Michigan","Monroe County",1,81,691,306,385
050,26,115,"Michigan","Monroe County",1,82,644,285,359
050,26,115,"Michigan","Monroe County",1,83,591,236,355
050,26,115,"Michigan","Monroe County",1,84,537,214,323
050,26,115,"Michigan","Monroe County",1,85,2988,1007,1981
050,26,115,"Michigan","Monroe County",2,0,1510,765,745
050,26,115,"Michigan","Monroe County",2,1,1531,781,750
050,26,115,"Michigan","Monroe County",2,2,1598,819,779
050,26,115,"Michigan","Monroe County",2,3,1651,847,804
050,26,115,"Michigan","Monroe County",2,4,1713,880,833
050,26,115,"Michigan","Monroe County",2,5,1720,887,833
050,26,115,"Michigan","Monroe County",2,6,1772,916,856
050,26,115,"Michigan","Monroe County",2,7,1779,925,854
050,26,115,"Michigan","Monroe County",2,8,1801,924,877
050,26,115,"Michigan","Monroe County",2,9,1845,944,901
050,26,115,"Michigan","Monroe County",2,10,1932,1003,929
050,26,115,"Michigan","Monroe County",2,11,1950,998,952
050,26,115,"Michigan","Monroe County",2,12,1983,1001,982
050,26,115,"Michigan","Monroe County",2,13,1986,996,990
050,26,115,"Michigan","Monroe County",2,14,2018,1009,1009
050,26,115,"Michigan","Monroe County",2,15,2027,1009,1018
050,26,115,"Michigan","Monroe County",2,16,2085,1036,1049
050,26,115,"Michigan","Monroe County",2,17,2103,1041,1062
050,26,115,"Michigan","Monroe County",2,18,1782,923,859
050,26,115,"Michigan","Monroe County",2,19,1490,795,695
050,26,115,"Michigan","Monroe County",2,20,1606,853,753
050,26,115,"Michigan","Monroe County",2,21,1680,900,780
050,26,115,"Michigan","Monroe County",2,22,1755,903,852
050,26,115,"Michigan","Monroe County",2,23,1792,909,883
050,26,115,"Michigan","Monroe County",2,24,1790,910,880
050,26,115,"Michigan","Monroe County",2,25,1830,980,850
050,26,115,"Michigan","Monroe County",2,26,1795,940,855
050,26,115,"Michigan","Monroe County",2,27,1816,935,881
050,26,115,"Michigan","Monroe County",2,28,1926,966,960
050,26,115,"Michigan","Monroe County",2,29,1980,1000,980
050,26,115,"Michigan","Monroe County",2,30,1951,995,956
050,26,115,"Michigan","Monroe County",2,31,1860,967,893
050,26,115,"Michigan","Monroe County",2,32,1766,914,852
050,26,115,"Michigan","Monroe County",2,33,1723,884,839
050,26,115,"Michigan","Monroe County",2,34,1769,890,879
050,26,115,"Michigan","Monroe County",2,35,1778,878,900
050,26,115,"Michigan","Monroe County",2,36,1811,900,911
050,26,115,"Michigan","Monroe County",2,37,1861,946,915
050,26,115,"Michigan","Monroe County",2,38,1851,927,924
050,26,115,"Michigan","Monroe County",2,39,1860,933,927
050,26,115,"Michigan","Monroe County",2,40,1885,922,963
050,26,115,"Michigan","Monroe County",2,41,1828,906,922
050,26,115,"Michigan","Monroe County",2,42,1823,897,926
050,26,115,"Michigan","Monroe County",2,43,1817,901,916
050,26,115,"Michigan","Monroe County",2,44,1784,901,883
050,26,115,"Michigan","Monroe County",2,45,1880,934,946
050,26,115,"Michigan","Monroe County",2,46,1852,932,920
050,26,115,"Michigan","Monroe County",2,47,1885,981,904
050,26,115,"Michigan","Monroe County",2,48,2034,1037,997
050,26,115,"Michigan","Monroe County",2,49,2191,1110,1081
050,26,115,"Michigan","Monroe County",2,50,2144,1093,1051
050,26,115,"Michigan","Monroe County",2,51,2042,1040,1002
050,26,115,"Michigan","Monroe County",2,52,2062,1043,1019
050,26,115,"Michigan","Monroe County",2,53,2178,1083,1095
050,26,115,"Michigan","Monroe County",2,54,2231,1100,1131
050,26,115,"Michigan","Monroe County",2,55,2260,1117,1143
050,26,115,"Michigan","Monroe County",2,56,2369,1196,1173
050,26,115,"Michigan","Monroe County",2,57,2443,1206,1237
050,26,115,"Michigan","Monroe County",2,58,2461,1220,1241
050,26,115,"Michigan","Monroe County",2,59,2492,1265,1227
050,26,115,"Michigan","Monroe County",2,60,2411,1224,1187
050,26,115,"Michigan","Monroe County",2,61,2369,1192,1177
050,26,115,"Michigan","Monroe County",2,62,2383,1181,1202
050,26,115,"Michigan","Monroe County",2,63,2362,1198,1164
050,26,115,"Michigan","Monroe County",2,64,2252,1131,1121
050,26,115,"Michigan","Monroe County",2,65,2156,1063,1093
050,26,115,"Michigan","Monroe County",2,66,2076,1019,1057
050,26,115,"Michigan","Monroe County",2,67,1976,977,999
050,26,115,"Michigan","Monroe County",2,68,1939,975,964
050,26,115,"Michigan","Monroe County",2,69,1862,910,952
050,26,115,"Michigan","Monroe County",2,70,1723,853,870
050,26,115,"Michigan","Monroe County",2,71,1656,816,840
050,26,115,"Michigan","Monroe County",2,72,1599,765,834
050,26,115,"Michigan","Monroe County",2,73,1691,790,901
050,26,115,"Michigan","Monroe County",2,74,1112,521,591
050,26,115,"Michigan","Monroe County",2,75,1031,488,543
050,26,115,"Michigan","Monroe County",2,76,1004,473,531
050,26,115,"Michigan","Monroe County",2,77,1123,517,606
050,26,115,"Michigan","Monroe County",2,78,974,430,544
050,26,115,"Michigan","Monroe County",2,79,834,366,468
050,26,115,"Michigan","Monroe County",2,80,758,331,427
050,26,115,"Michigan","Monroe County",2,81,692,308,384
050,26,115,"Michigan","Monroe County",2,82,652,290,362
050,26,115,"Michigan","Monroe County",2,83,592,239,353
050,26,115,"Michigan","Monroe County",2,84,540,218,322
050,26,115,"Michigan","Monroe County",2,85,2992,1007,1985
050,26,115,"Michigan","Monroe County",3,0,1513,797,716
050,26,115,"Michigan","Monroe County",3,1,1563,781,782
050,26,115,"Michigan","Monroe County",3,2,1567,793,774
050,26,115,"Michigan","Monroe County",3,3,1621,830,791
050,26,115,"Michigan","Monroe County",3,4,1694,863,831
050,26,115,"Michigan","Monroe County",3,5,1749,879,870
050,26,115,"Michigan","Monroe County",3,6,1781,906,875
050,26,115,"Michigan","Monroe County",3,7,1837,961,876
050,26,115,"Michigan","Monroe County",3,8,1803,932,871
050,26,115,"Michigan","Monroe County",3,9,1831,945,886
050,26,115,"Michigan","Monroe County",3,10,1854,948,906
050,26,115,"Michigan","Monroe County",3,11,1969,1022,947
050,26,115,"Michigan","Monroe County",3,12,1955,1002,953
050,26,115,"Michigan","Monroe County",3,13,2025,1018,1007
050,26,115,"Michigan","Monroe County",3,14,2009,1009,1000
050,26,115,"Michigan","Monroe County",3,15,2023,1002,1021
050,26,115,"Michigan","Monroe County",3,16,2029,1021,1008
050,26,115,"Michigan","Monroe County",3,17,2104,1040,1064
050,26,115,"Michigan","Monroe County",3,18,1770,906,864
050,26,115,"Michigan","Monroe County",3,19,1454,773,681
050,26,115,"Michigan","Monroe County",3,20,1598,831,767
050,26,115,"Michigan","Monroe County",3,21,1705,907,798
050,26,115,"Michigan","Monroe County",3,22,1776,934,842
050,26,115,"Michigan","Monroe County",3,23,1845,951,894
050,26,115,"Michigan","Monroe County",3,24,1799,915,884
050,26,115,"Michigan","Monroe County",3,25,1795,931,864
050,26,115,"Michigan","Monroe County",3,26,1821,967,854
050,26,115,"Michigan","Monroe County",3,27,1834,979,855
050,26,115,"Michigan","Monroe County",3,28,1839,941,898
050,26,115,"Michigan","Monroe County",3,29,1932,966,966
050,26,115,"Michigan","Monroe County",3,30,2024,1021,1003
050,26,115,"Michigan","Monroe County",3,31,1996,1015,981
050,26,115,"Michigan","Monroe County",3,32,1892,959,933
050,26,115,"Michigan","Monroe County",3,33,1829,975,854
050,26,115,"Michigan","Monroe County",3,34,1768,923,845
050,26,115,"Michigan","Monroe County",3,35,1807,909,898
050,26,115,"Michigan","Monroe County",3,36,1822,895,927
050,26,115,"Michigan","Monroe County",3,37,1875,933,942
050,26,115,"Michigan","Monroe County",3,38,1866,943,923
050,26,115,"Michigan","Monroe County",3,39,1862,929,933
050,26,115,"Michigan","Monroe County",3,40,1890,944,946
050,26,115,"Michigan","Monroe County",3,41,1894,938,956
050,26,115,"Michigan","Monroe County",3,42,1858,921,937
050,26,115,"Michigan","Monroe County",3,43,1846,916,930
050,26,115,"Michigan","Monroe County",3,44,1834,898,936
050,26,115,"Michigan","Monroe County",3,45,1812,904,908
050,26,115,"Michigan","Monroe County",3,46,1880,948,932
050,26,115,"Michigan","Monroe County",3,47,1867,935,932
050,26,115,"Michigan","Monroe County",3,48,1884,979,905
050,26,115,"Michigan","Monroe County",3,49,2026,1031,995
050,26,115,"Michigan","Monroe County",3,50,2193,1108,1085
050,26,115,"Michigan","Monroe County",3,51,2150,1093,1057
050,26,115,"Michigan","Monroe County",3,52,2045,1034,1011
050,26,115,"Michigan","Monroe County",3,53,2054,1039,1015
050,26,115,"Michigan","Monroe County",3,54,2147,1070,1077
050,26,115,"Michigan","Monroe County",3,55,2226,1101,1125
050,26,115,"Michigan","Monroe County",3,56,2227,1105,1122
050,26,115,"Michigan","Monroe County",3,57,2331,1176,1155
050,26,115,"Michigan","Monroe County",3,58,2401,1189,1212
050,26,115,"Michigan","Monroe County",3,59,2435,1197,1238
050,26,115,"Michigan","Monroe County",3,60,2483,1267,1216
050,26,115,"Michigan","Monroe County",3,61,2371,1199,1172
050,26,115,"Michigan","Monroe County",3,62,2320,1163,1157
050,26,115,"Michigan","Monroe County",3,63,2360,1164,1196
050,26,115,"Michigan","Monroe County",3,64,2330,1186,1144
050,26,115,"Michigan","Monroe County",3,65,2212,1094,1118
050,26,115,"Michigan","Monroe County",3,66,2094,1022,1072
050,26,115,"Michigan","Monroe County",3,67,2059,1003,1056
050,26,115,"Michigan","Monroe County",3,68,1933,950,983
050,26,115,"Michigan","Monroe County",3,69,1889,937,952
050,26,115,"Michigan","Monroe County",3,70,1823,889,934
050,26,115,"Michigan","Monroe County",3,71,1683,833,850
050,26,115,"Michigan","Monroe County",3,72,1616,783,833
050,26,115,"Michigan","Monroe County",3,73,1537,728,809
050,26,115,"Michigan","Monroe County",3,74,1634,759,875
050,26,115,"Michigan","Monroe County",3,75,1089,500,589
050,26,115,"Michigan","Monroe County",3,76,991,467,524
050,26,115,"Michigan","Monroe County",3,77,974,451,523
050,26,115,"Michigan","Monroe County",3,78,1080,480,600
050,26,115,"Michigan","Monroe County",3,79,894,406,488
050,26,115,"Michigan","Monroe County",3,80,821,353,468
050,26,115,"Michigan","Monroe County",3,81,718,317,401
050,26,115,"Michigan","Monroe County",3,82,642,276,366
050,26,115,"Michigan","Monroe County",3,83,632,269,363
050,26,115,"Michigan","Monroe County",3,84,528,203,325
050,26,115,"Michigan","Monroe County",3,85,2985,996,1989
050,26,115,"Michigan","Monroe County",4,0,1405,738,667
050,26,115,"Michigan","Monroe County",4,1,1568,841,727
050,26,115,"Michigan","Monroe County",4,2,1599,801,798
050,26,115,"Michigan","Monroe County",4,3,1597,816,781
050,26,115,"Michigan","Monroe County",4,4,1648,840,808
050,26,115,"Michigan","Monroe County",4,5,1699,864,835
050,26,115,"Michigan","Monroe County",4,6,1753,881,872
050,26,115,"Michigan","Monroe County",4,7,1805,940,865
050,26,115,"Michigan","Monroe County",4,8,1851,969,882
050,26,115,"Michigan","Monroe County",4,9,1827,953,874
050,26,115,"Michigan","Monroe County",4,10,1846,956,890
050,26,115,"Michigan","Monroe County",4,11,1864,958,906
050,26,115,"Michigan","Monroe County",4,12,1990,1026,964
050,26,115,"Michigan","Monroe County",4,13,1960,1009,951
050,26,115,"Michigan","Monroe County",4,14,2013,1023,990
050,26,115,"Michigan","Monroe County",4,15,2016,1018,998
050,26,115,"Michigan","Monroe County",4,16,2034,1007,1027
050,26,115,"Michigan","Monroe County",4,17,2035,1018,1017
050,26,115,"Michigan","Monroe County",4,18,1766,924,842
050,26,115,"Michigan","Monroe County",4,19,1377,719,658
050,26,115,"Michigan","Monroe County",4,20,1513,778,735
050,26,115,"Michigan","Monroe County",4,21,1634,853,781
050,26,115,"Michigan","Monroe County",4,22,1789,939,850
050,26,115,"Michigan","Monroe County",4,23,1846,977,869
050,26,115,"Michigan","Monroe County",4,24,1809,931,878
050,26,115,"Michigan","Monroe County",4,25,1815,936,879
050,26,115,"Michigan","Monroe County",4,26,1778,914,864
050,26,115,"Michigan","Monroe County",4,27,1797,949,848
050,26,115,"Michigan","Monroe County",4,28,1780,930,850
050,26,115,"Michigan","Monroe County",4,29,1860,952,908
050,26,115,"Michigan","Monroe County",4,30,1957,962,995
050,26,115,"Michigan","Monroe County",4,31,2034,1028,1006
050,26,115,"Michigan","Monroe County",4,32,2001,997,1004
050,26,115,"Michigan","Monroe County",4,33,1918,955,963
050,26,115,"Michigan","Monroe County",4,34,1853,985,868
050,26,115,"Michigan","Monroe County",4,35,1807,933,874
050,26,115,"Michigan","Monroe County",4,36,1846,913,933
050,26,115,"Michigan","Monroe County",4,37,1836,919,917
050,26,115,"Michigan","Monroe County",4,38,1885,941,944
050,26,115,"Michigan","Monroe County",4,39,1889,968,921
050,26,115,"Michigan","Monroe County",4,40,1886,923,963
050,26,115,"Michigan","Monroe County",4,41,1879,934,945
050,26,115,"Michigan","Monroe County",4,42,1897,938,959
050,26,115,"Michigan","Monroe County",4,43,1852,903,949
050,26,115,"Michigan","Monroe County",4,44,1859,926,933
050,26,115,"Michigan","Monroe County",4,45,1853,912,941
050,26,115,"Michigan","Monroe County",4,46,1819,914,905
050,26,115,"Michigan","Monroe County",4,47,1893,960,933
050,26,115,"Michigan","Monroe County",4,48,1841,906,935
050,26,115,"Michigan","Monroe County",4,49,1902,994,908
050,26,115,"Michigan","Monroe County",4,50,2043,1053,990
050,26,115,"Michigan","Monroe County",4,51,2196,1107,1089
050,26,115,"Michigan","Monroe County",4,52,2153,1093,1060
050,26,115,"Michigan","Monroe County",4,53,2049,1033,1016
050,26,115,"Michigan","Monroe County",4,54,2033,1025,1008
050,26,115,"Michigan","Monroe County",4,55,2155,1071,1084
050,26,115,"Michigan","Monroe County",4,56,2192,1084,1108
050,26,115,"Michigan","Monroe County",4,57,2219,1101,1118
050,26,115,"Michigan","Monroe County",4,58,2325,1164,1161
050,26,115,"Michigan","Monroe County",4,59,2376,1172,1204
050,26,115,"Michigan","Monroe County",4,60,2396,1176,1220
050,26,115,"Michigan","Monroe County",4,61,2441,1247,1194
050,26,115,"Michigan","Monroe County",4,62,2331,1163,1168
050,26,115,"Michigan","Monroe County",4,63,2283,1150,1133
050,26,115,"Michigan","Monroe County",4,64,2312,1134,1178
050,26,115,"Michigan","Monroe County",4,65,2283,1151,1132
050,26,115,"Michigan","Monroe County",4,66,2165,1061,1104
050,26,115,"Michigan","Monroe County",4,67,2053,1010,1043
050,26,115,"Michigan","Monroe County",4,68,2005,980,1025
050,26,115,"Michigan","Monroe County",4,69,1905,938,967
050,26,115,"Michigan","Monroe County",4,70,1858,921,937
050,26,115,"Michigan","Monroe County",4,71,1802,873,929
050,26,115,"Michigan","Monroe County",4,72,1639,807,832
050,26,115,"Michigan","Monroe County",4,73,1585,754,831
050,26,115,"Michigan","Monroe County",4,74,1481,699,782
050,26,115,"Michigan","Monroe County",4,75,1582,725,857
050,26,115,"Michigan","Monroe County",4,76,1034,475,559
050,26,115,"Michigan","Monroe County",4,77,966,453,513
050,26,115,"Michigan","Monroe County",4,78,949,423,526
050,26,115,"Michigan","Monroe County",4,79,997,453,544
050,26,115,"Michigan","Monroe County",4,80,862,383,479
050,26,115,"Michigan","Monroe County",4,81,782,342,440
050,26,115,"Michigan","Monroe County",4,82,662,280,382
050,26,115,"Michigan","Monroe County",4,83,611,246,365
050,26,115,"Michigan","Monroe County",4,84,576,239,337
050,26,115,"Michigan","Monroe County",4,85,2953,980,1973
050,26,115,"Michigan","Monroe County",5,0,1133,598,535
050,26,115,"Michigan","Monroe County",5,1,1456,770,686
050,26,115,"Michigan","Monroe County",5,2,1585,834,751
050,26,115,"Michigan","Monroe County",5,3,1655,819,836
050,26,115,"Michigan","Monroe County",5,4,1634,831,803
050,26,115,"Michigan","Monroe County",5,5,1651,844,807
050,26,115,"Michigan","Monroe County",5,6,1734,864,870
050,26,115,"Michigan","Monroe County",5,7,1790,897,893
050,26,115,"Michigan","Monroe County",5,8,1833,957,876
050,26,115,"Michigan","Monroe County",5,9,1839,974,865
050,26,115,"Michigan","Monroe County",5,10,1824,947,877
050,26,115,"Michigan","Monroe County",5,11,1861,962,899
050,26,115,"Michigan","Monroe County",5,12,1856,948,908
050,26,115,"Michigan","Monroe County",5,13,2015,1047,968
050,26,115,"Michigan","Monroe County",5,14,1937,985,952
050,26,115,"Michigan","Monroe County",5,15,2020,1027,993
050,26,115,"Michigan","Monroe County",5,16,2028,1013,1015
050,26,115,"Michigan","Monroe County",5,17,2021,1014,1007
050,26,115,"Michigan","Monroe County",5,18,1685,889,796
050,26,115,"Michigan","Monroe County",5,19,1400,737,663
050,26,115,"Michigan","Monroe County",5,20,1501,763,738
050,26,115,"Michigan","Monroe County",5,21,1613,824,789
050,26,115,"Michigan","Monroe County",5,22,1743,888,855
050,26,115,"Michigan","Monroe County",5,23,1859,984,875
050,26,115,"Michigan","Monroe County",5,24,1840,969,871
050,26,115,"Michigan","Monroe County",5,25,1805,931,874
050,26,115,"Michigan","Monroe County",5,26,1812,925,887
050,26,115,"Michigan","Monroe County",5,27,1755,903,852
050,26,115,"Michigan","Monroe County",5,28,1794,950,844
050,26,115,"Michigan","Monroe County",5,29,1820,954,866
050,26,115,"Michigan","Monroe County",5,30,1917,992,925
050,26,115,"Michigan","Monroe County",5,31,2001,998,1003
050,26,115,"Michigan","Monroe County",5,32,2062,1022,1040
050,26,115,"Michigan","Monroe County",5,33,2039,1033,1006
050,26,115,"Michigan","Monroe County",5,34,1934,970,964
050,26,115,"Michigan","Monroe County",5,35,1833,979,854
050,26,115,"Michigan","Monroe County",5,36,1817,920,897
050,26,115,"Michigan","Monroe County",5,37,1842,913,929
050,26,115,"Michigan","Monroe County",5,38,1857,927,930
050,26,115,"Michigan","Monroe County",5,39,1891,936,955
050,26,115,"Michigan","Monroe County",5,40,1912,984,928
050,26,115,"Michigan","Monroe County",5,41,1883,936,947
050,26,115,"Michigan","Monroe County",5,42,1867,926,941
050,26,115,"Michigan","Monroe County",5,43,1908,937,971
050,26,115,"Michigan","Monroe County",5,44,1861,919,942
050,26,115,"Michigan","Monroe County",5,45,1863,934,929
050,26,115,"Michigan","Monroe County",5,46,1864,918,946
050,26,115,"Michigan","Monroe County",5,47,1813,908,905
050,26,115,"Michigan","Monroe County",5,48,1868,938,930
050,26,115,"Michigan","Monroe County",5,49,1826,910,916
050,26,115,"Michigan","Monroe County",5,50,1905,995,910
050,26,115,"Michigan","Monroe County",5,51,2042,1057,985
050,26,115,"Michigan","Monroe County",5,52,2177,1099,1078
050,26,115,"Michigan","Monroe County",5,53,2144,1094,1050
050,26,115,"Michigan","Monroe County",5,54,2066,1047,1019
050,26,115,"Michigan","Monroe County",5,55,2039,1039,1000
050,26,115,"Michigan","Monroe County",5,56,2115,1043,1072
050,26,115,"Michigan","Monroe County",5,57,2197,1095,1102
050,26,115,"Michigan","Monroe County",5,58,2202,1082,1120
050,26,115,"Michigan","Monroe County",5,59,2312,1166,1146
050,26,115,"Michigan","Monroe County",5,60,2356,1165,1191
050,26,115,"Michigan","Monroe County",5,61,2386,1158,1228
050,26,115,"Michigan","Monroe County",5,62,2386,1210,1176
050,26,115,"Michigan","Monroe County",5,63,2313,1134,1179
050,26,115,"Michigan","Monroe County",5,64,2274,1147,1127
050,26,115,"Michigan","Monroe County",5,65,2266,1107,1159
050,26,115,"Michigan","Monroe County",5,66,2237,1130,1107
050,26,115,"Michigan","Monroe County",5,67,2136,1047,1089
050,26,115,"Michigan","Monroe County",5,68,2024,997,1027
050,26,115,"Michigan","Monroe County",5,69,1983,955,1028
050,26,115,"Michigan","Monroe County",5,70,1858,907,951
050,26,115,"Michigan","Monroe County",5,71,1814,892,922
050,26,115,"Michigan","Monroe County",5,72,1784,866,918
050,26,115,"Michigan","Monroe County",5,73,1603,774,829
050,26,115,"Michigan","Monroe County",5,74,1536,730,806
050,26,115,"Michigan","Monroe County",5,75,1437,673,764
050,26,115,"Michigan","Monroe County",5,76,1525,698,827
050,26,115,"Michigan","Monroe County",5,77,1006,458,548
050,26,115,"Michigan","Monroe County",5,78,942,429,513
050,26,115,"Michigan","Monroe County",5,79,872,390,482
050,26,115,"Michigan","Monroe County",5,80,979,437,542
050,26,115,"Michigan","Monroe County",5,81,802,368,434
050,26,115,"Michigan","Monroe County",5,82,745,314,431
050,26,115,"Michigan","Monroe County",5,83,632,253,379
050,26,115,"Michigan","Monroe County",5,84,558,223,335
050,26,115,"Michigan","Monroe County",5,85,3035,1022,2013
050,26,117,"Michigan","Montcalm County",1,0,696,356,340
050,26,117,"Michigan","Montcalm County",1,1,669,339,330
050,26,117,"Michigan","Montcalm County",1,2,710,351,359
050,26,117,"Michigan","Montcalm County",1,3,737,372,365
050,26,117,"Michigan","Montcalm County",1,4,744,393,351
050,26,117,"Michigan","Montcalm County",1,5,735,360,375
050,26,117,"Michigan","Montcalm County",1,6,767,370,397
050,26,117,"Michigan","Montcalm County",1,7,779,375,404
050,26,117,"Michigan","Montcalm County",1,8,774,389,385
050,26,117,"Michigan","Montcalm County",1,9,799,420,379
050,26,117,"Michigan","Montcalm County",1,10,826,442,384
050,26,117,"Michigan","Montcalm County",1,11,868,466,402
050,26,117,"Michigan","Montcalm County",1,12,851,447,404
050,26,117,"Michigan","Montcalm County",1,13,810,421,389
050,26,117,"Michigan","Montcalm County",1,14,845,447,398
050,26,117,"Michigan","Montcalm County",1,15,888,448,440
050,26,117,"Michigan","Montcalm County",1,16,853,441,412
050,26,117,"Michigan","Montcalm County",1,17,837,423,414
050,26,117,"Michigan","Montcalm County",1,18,760,399,361
050,26,117,"Michigan","Montcalm County",1,19,676,395,281
050,26,117,"Michigan","Montcalm County",1,20,732,433,299
050,26,117,"Michigan","Montcalm County",1,21,732,429,303
050,26,117,"Michigan","Montcalm County",1,22,750,434,316
050,26,117,"Michigan","Montcalm County",1,23,804,476,328
050,26,117,"Michigan","Montcalm County",1,24,792,472,320
050,26,117,"Michigan","Montcalm County",1,25,885,531,354
050,26,117,"Michigan","Montcalm County",1,26,837,492,345
050,26,117,"Michigan","Montcalm County",1,27,872,498,374
050,26,117,"Michigan","Montcalm County",1,28,900,508,392
050,26,117,"Michigan","Montcalm County",1,29,974,560,414
050,26,117,"Michigan","Montcalm County",1,30,921,531,390
050,26,117,"Michigan","Montcalm County",1,31,830,459,371
050,26,117,"Michigan","Montcalm County",1,32,848,488,360
050,26,117,"Michigan","Montcalm County",1,33,826,491,335
050,26,117,"Michigan","Montcalm County",1,34,854,500,354
050,26,117,"Michigan","Montcalm County",1,35,877,505,372
050,26,117,"Michigan","Montcalm County",1,36,901,537,364
050,26,117,"Michigan","Montcalm County",1,37,899,543,356
050,26,117,"Michigan","Montcalm County",1,38,813,473,340
050,26,117,"Michigan","Montcalm County",1,39,889,502,387
050,26,117,"Michigan","Montcalm County",1,40,859,481,378
050,26,117,"Michigan","Montcalm County",1,41,916,543,373
050,26,117,"Michigan","Montcalm County",1,42,889,533,356
050,26,117,"Michigan","Montcalm County",1,43,805,475,330
050,26,117,"Michigan","Montcalm County",1,44,779,466,313
050,26,117,"Michigan","Montcalm County",1,45,773,459,314
050,26,117,"Michigan","Montcalm County",1,46,801,472,329
050,26,117,"Michigan","Montcalm County",1,47,884,493,391
050,26,117,"Michigan","Montcalm County",1,48,925,555,370
050,26,117,"Michigan","Montcalm County",1,49,1002,572,430
050,26,117,"Michigan","Montcalm County",1,50,916,536,380
050,26,117,"Michigan","Montcalm County",1,51,871,487,384
050,26,117,"Michigan","Montcalm County",1,52,862,471,391
050,26,117,"Michigan","Montcalm County",1,53,898,486,412
050,26,117,"Michigan","Montcalm County",1,54,896,481,415
050,26,117,"Michigan","Montcalm County",1,55,954,519,435
050,26,117,"Michigan","Montcalm County",1,56,944,507,437
050,26,117,"Michigan","Montcalm County",1,57,981,533,448
050,26,117,"Michigan","Montcalm County",1,58,1001,544,457
050,26,117,"Michigan","Montcalm County",1,59,931,501,430
050,26,117,"Michigan","Montcalm County",1,60,923,493,430
050,26,117,"Michigan","Montcalm County",1,61,934,483,451
050,26,117,"Michigan","Montcalm County",1,62,987,525,462
050,26,117,"Michigan","Montcalm County",1,63,965,486,479
050,26,117,"Michigan","Montcalm County",1,64,883,438,445
050,26,117,"Michigan","Montcalm County",1,65,854,437,417
050,26,117,"Michigan","Montcalm County",1,66,818,414,404
050,26,117,"Michigan","Montcalm County",1,67,823,399,424
050,26,117,"Michigan","Montcalm County",1,68,765,381,384
050,26,117,"Michigan","Montcalm County",1,69,709,370,339
050,26,117,"Michigan","Montcalm County",1,70,663,331,332
050,26,117,"Michigan","Montcalm County",1,71,628,293,335
050,26,117,"Michigan","Montcalm County",1,72,630,313,317
050,26,117,"Michigan","Montcalm County",1,73,633,322,311
050,26,117,"Michigan","Montcalm County",1,74,462,233,229
050,26,117,"Michigan","Montcalm County",1,75,441,207,234
050,26,117,"Michigan","Montcalm County",1,76,457,208,249
050,26,117,"Michigan","Montcalm County",1,77,447,209,238
050,26,117,"Michigan","Montcalm County",1,78,369,164,205
050,26,117,"Michigan","Montcalm County",1,79,339,163,176
050,26,117,"Michigan","Montcalm County",1,80,289,142,147
050,26,117,"Michigan","Montcalm County",1,81,302,140,162
050,26,117,"Michigan","Montcalm County",1,82,266,116,150
050,26,117,"Michigan","Montcalm County",1,83,234,110,124
050,26,117,"Michigan","Montcalm County",1,84,218,97,121
050,26,117,"Michigan","Montcalm County",1,85,1118,403,715
050,26,117,"Michigan","Montcalm County",2,0,714,363,351
050,26,117,"Michigan","Montcalm County",2,1,675,342,333
050,26,117,"Michigan","Montcalm County",2,2,705,352,353
050,26,117,"Michigan","Montcalm County",2,3,733,370,363
050,26,117,"Michigan","Montcalm County",2,4,750,391,359
050,26,117,"Michigan","Montcalm County",2,5,738,367,371
050,26,117,"Michigan","Montcalm County",2,6,762,368,394
050,26,117,"Michigan","Montcalm County",2,7,772,373,399
050,26,117,"Michigan","Montcalm County",2,8,774,386,388
050,26,117,"Michigan","Montcalm County",2,9,792,413,379
050,26,117,"Michigan","Montcalm County",2,10,817,436,381
050,26,117,"Michigan","Montcalm County",2,11,850,455,395
050,26,117,"Michigan","Montcalm County",2,12,856,452,404
050,26,117,"Michigan","Montcalm County",2,13,814,424,390
050,26,117,"Michigan","Montcalm County",2,14,835,439,396
050,26,117,"Michigan","Montcalm County",2,15,876,447,429
050,26,117,"Michigan","Montcalm County",2,16,861,441,420
050,26,117,"Michigan","Montcalm County",2,17,841,425,416
050,26,117,"Michigan","Montcalm County",2,18,752,397,355
050,26,117,"Michigan","Montcalm County",2,19,672,386,286
050,26,117,"Michigan","Montcalm County",2,20,736,434,302
050,26,117,"Michigan","Montcalm County",2,21,730,430,300
050,26,117,"Michigan","Montcalm County",2,22,749,434,315
050,26,117,"Michigan","Montcalm County",2,23,802,477,325
050,26,117,"Michigan","Montcalm County",2,24,793,470,323
050,26,117,"Michigan","Montcalm County",2,25,875,529,346
050,26,117,"Michigan","Montcalm County",2,26,849,499,350
050,26,117,"Michigan","Montcalm County",2,27,870,505,365
050,26,117,"Michigan","Montcalm County",2,28,890,506,384
050,26,117,"Michigan","Montcalm County",2,29,960,550,410
050,26,117,"Michigan","Montcalm County",2,30,939,538,401
050,26,117,"Michigan","Montcalm County",2,31,839,465,374
050,26,117,"Michigan","Montcalm County",2,32,852,486,366
050,26,117,"Michigan","Montcalm County",2,33,831,488,343
050,26,117,"Michigan","Montcalm County",2,34,842,493,349
050,26,117,"Michigan","Montcalm County",2,35,883,512,371
050,26,117,"Michigan","Montcalm County",2,36,892,532,360
050,26,117,"Michigan","Montcalm County",2,37,904,548,356
050,26,117,"Michigan","Montcalm County",2,38,827,479,348
050,26,117,"Michigan","Montcalm County",2,39,869,495,374
050,26,117,"Michigan","Montcalm County",2,40,866,484,382
050,26,117,"Michigan","Montcalm County",2,41,910,539,371
050,26,117,"Michigan","Montcalm County",2,42,890,532,358
050,26,117,"Michigan","Montcalm County",2,43,824,486,338
050,26,117,"Michigan","Montcalm County",2,44,776,461,315
050,26,117,"Michigan","Montcalm County",2,45,778,463,315
050,26,117,"Michigan","Montcalm County",2,46,794,468,326
050,26,117,"Michigan","Montcalm County",2,47,860,487,373
050,26,117,"Michigan","Montcalm County",2,48,925,546,379
050,26,117,"Michigan","Montcalm County",2,49,983,566,417
050,26,117,"Michigan","Montcalm County",2,50,933,542,391
050,26,117,"Michigan","Montcalm County",2,51,867,487,380
050,26,117,"Michigan","Montcalm County",2,52,856,468,388
050,26,117,"Michigan","Montcalm County",2,53,886,480,406
050,26,117,"Michigan","Montcalm County",2,54,886,474,412
050,26,117,"Michigan","Montcalm County",2,55,948,518,430
050,26,117,"Michigan","Montcalm County",2,56,947,507,440
050,26,117,"Michigan","Montcalm County",2,57,979,534,445
050,26,117,"Michigan","Montcalm County",2,58,987,533,454
050,26,117,"Michigan","Montcalm County",2,59,944,504,440
050,26,117,"Michigan","Montcalm County",2,60,921,493,428
050,26,117,"Michigan","Montcalm County",2,61,927,483,444
050,26,117,"Michigan","Montcalm County",2,62,973,515,458
050,26,117,"Michigan","Montcalm County",2,63,980,501,479
050,26,117,"Michigan","Montcalm County",2,64,892,443,449
050,26,117,"Michigan","Montcalm County",2,65,861,439,422
050,26,117,"Michigan","Montcalm County",2,66,830,419,411
050,26,117,"Michigan","Montcalm County",2,67,819,401,418
050,26,117,"Michigan","Montcalm County",2,68,773,383,390
050,26,117,"Michigan","Montcalm County",2,69,726,373,353
050,26,117,"Michigan","Montcalm County",2,70,672,337,335
050,26,117,"Michigan","Montcalm County",2,71,635,299,336
050,26,117,"Michigan","Montcalm County",2,72,620,303,317
050,26,117,"Michigan","Montcalm County",2,73,658,331,327
050,26,117,"Michigan","Montcalm County",2,74,469,236,233
050,26,117,"Michigan","Montcalm County",2,75,447,213,234
050,26,117,"Michigan","Montcalm County",2,76,448,205,243
050,26,117,"Michigan","Montcalm County",2,77,459,212,247
050,26,117,"Michigan","Montcalm County",2,78,380,170,210
050,26,117,"Michigan","Montcalm County",2,79,339,159,180
050,26,117,"Michigan","Montcalm County",2,80,300,145,155
050,26,117,"Michigan","Montcalm County",2,81,294,139,155
050,26,117,"Michigan","Montcalm County",2,82,272,121,151
050,26,117,"Michigan","Montcalm County",2,83,239,108,131
050,26,117,"Michigan","Montcalm County",2,84,218,98,120
050,26,117,"Michigan","Montcalm County",2,85,1123,403,720
050,26,117,"Michigan","Montcalm County",3,0,640,317,323
050,26,117,"Michigan","Montcalm County",3,1,739,386,353
050,26,117,"Michigan","Montcalm County",3,2,684,340,344
050,26,117,"Michigan","Montcalm County",3,3,719,356,363
050,26,117,"Michigan","Montcalm County",3,4,765,385,380
050,26,117,"Michigan","Montcalm County",3,5,763,396,367
050,26,117,"Michigan","Montcalm County",3,6,745,379,366
050,26,117,"Michigan","Montcalm County",3,7,792,390,402
050,26,117,"Michigan","Montcalm County",3,8,785,390,395
050,26,117,"Michigan","Montcalm County",3,9,782,387,395
050,26,117,"Michigan","Montcalm County",3,10,799,419,380
050,26,117,"Michigan","Montcalm County",3,11,831,434,397
050,26,117,"Michigan","Montcalm County",3,12,844,449,395
050,26,117,"Michigan","Montcalm County",3,13,865,450,415
050,26,117,"Michigan","Montcalm County",3,14,820,430,390
050,26,117,"Michigan","Montcalm County",3,15,861,452,409
050,26,117,"Michigan","Montcalm County",3,16,892,457,435
050,26,117,"Michigan","Montcalm County",3,17,888,456,432
050,26,117,"Michigan","Montcalm County",3,18,783,420,363
050,26,117,"Michigan","Montcalm County",3,19,654,370,284
050,26,117,"Michigan","Montcalm County",3,20,725,418,307
050,26,117,"Michigan","Montcalm County",3,21,761,457,304
050,26,117,"Michigan","Montcalm County",3,22,765,437,328
050,26,117,"Michigan","Montcalm County",3,23,843,492,351
050,26,117,"Michigan","Montcalm County",3,24,811,475,336
050,26,117,"Michigan","Montcalm County",3,25,877,540,337
050,26,117,"Michigan","Montcalm County",3,26,864,513,351
050,26,117,"Michigan","Montcalm County",3,27,891,548,343
050,26,117,"Michigan","Montcalm County",3,28,885,505,380
050,26,117,"Michigan","Montcalm County",3,29,959,556,403
050,26,117,"Michigan","Montcalm County",3,30,1000,577,423
050,26,117,"Michigan","Montcalm County",3,31,920,522,398
050,26,117,"Michigan","Montcalm County",3,32,867,486,381
050,26,117,"Michigan","Montcalm County",3,33,833,473,360
050,26,117,"Michigan","Montcalm County",3,34,820,486,334
050,26,117,"Michigan","Montcalm County",3,35,879,516,363
050,26,117,"Michigan","Montcalm County",3,36,924,547,377
050,26,117,"Michigan","Montcalm County",3,37,915,558,357
050,26,117,"Michigan","Montcalm County",3,38,862,502,360
050,26,117,"Michigan","Montcalm County",3,39,860,509,351
050,26,117,"Michigan","Montcalm County",3,40,855,487,368
050,26,117,"Michigan","Montcalm County",3,41,907,523,384
050,26,117,"Michigan","Montcalm County",3,42,922,538,384
050,26,117,"Michigan","Montcalm County",3,43,864,500,364
050,26,117,"Michigan","Montcalm County",3,44,828,474,354
050,26,117,"Michigan","Montcalm County",3,45,791,476,315
050,26,117,"Michigan","Montcalm County",3,46,794,475,319
050,26,117,"Michigan","Montcalm County",3,47,802,462,340
050,26,117,"Michigan","Montcalm County",3,48,906,524,382
050,26,117,"Michigan","Montcalm County",3,49,908,529,379
050,26,117,"Michigan","Montcalm County",3,50,975,563,412
050,26,117,"Michigan","Montcalm County",3,51,902,515,387
050,26,117,"Michigan","Montcalm County",3,52,866,476,390
050,26,117,"Michigan","Montcalm County",3,53,855,467,388
050,26,117,"Michigan","Montcalm County",3,54,870,467,403
050,26,117,"Michigan","Montcalm County",3,55,925,512,413
050,26,117,"Michigan","Montcalm County",3,56,941,502,439
050,26,117,"Michigan","Montcalm County",3,57,965,519,446
050,26,117,"Michigan","Montcalm County",3,58,942,495,447
050,26,117,"Michigan","Montcalm County",3,59,970,509,461
050,26,117,"Michigan","Montcalm County",3,60,949,507,442
050,26,117,"Michigan","Montcalm County",3,61,941,499,442
050,26,117,"Michigan","Montcalm County",3,62,938,495,443
050,26,117,"Michigan","Montcalm County",3,63,967,510,457
050,26,117,"Michigan","Montcalm County",3,64,954,479,475
050,26,117,"Michigan","Montcalm County",3,65,872,434,438
050,26,117,"Michigan","Montcalm County",3,66,844,427,417
050,26,117,"Michigan","Montcalm County",3,67,819,408,411
050,26,117,"Michigan","Montcalm County",3,68,803,391,412
050,26,117,"Michigan","Montcalm County",3,69,760,375,385
050,26,117,"Michigan","Montcalm County",3,70,697,355,342
050,26,117,"Michigan","Montcalm County",3,71,662,325,337
050,26,117,"Michigan","Montcalm County",3,72,641,306,335
050,26,117,"Michigan","Montcalm County",3,73,589,279,310
050,26,117,"Michigan","Montcalm County",3,74,630,324,306
050,26,117,"Michigan","Montcalm County",3,75,450,226,224
050,26,117,"Michigan","Montcalm County",3,76,424,204,220
050,26,117,"Michigan","Montcalm County",3,77,425,197,228
050,26,117,"Michigan","Montcalm County",3,78,433,197,236
050,26,117,"Michigan","Montcalm County",3,79,353,161,192
050,26,117,"Michigan","Montcalm County",3,80,314,145,169
050,26,117,"Michigan","Montcalm County",3,81,279,134,145
050,26,117,"Michigan","Montcalm County",3,82,264,120,144
050,26,117,"Michigan","Montcalm County",3,83,244,105,139
050,26,117,"Michigan","Montcalm County",3,84,225,100,125
050,26,117,"Michigan","Montcalm County",3,85,1143,403,740
050,26,117,"Michigan","Montcalm County",4,0,682,329,353
050,26,117,"Michigan","Montcalm County",4,1,661,308,353
050,26,117,"Michigan","Montcalm County",4,2,753,391,362
050,26,117,"Michigan","Montcalm County",4,3,696,336,360
050,26,117,"Michigan","Montcalm County",4,4,730,366,364
050,26,117,"Michigan","Montcalm County",4,5,774,395,379
050,26,117,"Michigan","Montcalm County",4,6,768,390,378
050,26,117,"Michigan","Montcalm County",4,7,757,386,371
050,26,117,"Michigan","Montcalm County",4,8,784,392,392
050,26,117,"Michigan","Montcalm County",4,9,779,383,396
050,26,117,"Michigan","Montcalm County",4,10,797,393,404
050,26,117,"Michigan","Montcalm County",4,11,823,430,393
050,26,117,"Michigan","Montcalm County",4,12,836,435,401
050,26,117,"Michigan","Montcalm County",4,13,847,444,403
050,26,117,"Michigan","Montcalm County",4,14,887,470,417
050,26,117,"Michigan","Montcalm County",4,15,799,414,385
050,26,117,"Michigan","Montcalm County",4,16,858,450,408
050,26,117,"Michigan","Montcalm County",4,17,901,462,439
050,26,117,"Michigan","Montcalm County",4,18,799,430,369
050,26,117,"Michigan","Montcalm County",4,19,642,369,273
050,26,117,"Michigan","Montcalm County",4,20,682,378,304
050,26,117,"Michigan","Montcalm County",4,21,743,428,315
050,26,117,"Michigan","Montcalm County",4,22,762,451,311
050,26,117,"Michigan","Montcalm County",4,23,833,472,361
050,26,117,"Michigan","Montcalm County",4,24,827,473,354
050,26,117,"Michigan","Montcalm County",4,25,858,504,354
050,26,117,"Michigan","Montcalm County",4,26,840,492,348
050,26,117,"Michigan","Montcalm County",4,27,913,557,356
050,26,117,"Michigan","Montcalm County",4,28,908,532,376
050,26,117,"Michigan","Montcalm County",4,29,900,514,386
050,26,117,"Michigan","Montcalm County",4,30,959,550,409
050,26,117,"Michigan","Montcalm County",4,31,992,546,446
050,26,117,"Michigan","Montcalm County",4,32,963,541,422
050,26,117,"Michigan","Montcalm County",4,33,869,480,389
050,26,117,"Michigan","Montcalm County",4,34,819,459,360
050,26,117,"Michigan","Montcalm County",4,35,852,509,343
050,26,117,"Michigan","Montcalm County",4,36,909,530,379
050,26,117,"Michigan","Montcalm County",4,37,931,558,373
050,26,117,"Michigan","Montcalm County",4,38,843,492,351
050,26,117,"Michigan","Montcalm County",4,39,864,498,366
050,26,117,"Michigan","Montcalm County",4,40,822,468,354
050,26,117,"Michigan","Montcalm County",4,41,900,523,377
050,26,117,"Michigan","Montcalm County",4,42,881,500,381
050,26,117,"Michigan","Montcalm County",4,43,887,511,376
050,26,117,"Michigan","Montcalm County",4,44,828,475,353
050,26,117,"Michigan","Montcalm County",4,45,810,452,358
050,26,117,"Michigan","Montcalm County",4,46,795,474,321
050,26,117,"Michigan","Montcalm County",4,47,791,470,321
050,26,117,"Michigan","Montcalm County",4,48,815,472,343
050,26,117,"Michigan","Montcalm County",4,49,876,489,387
050,26,117,"Michigan","Montcalm County",4,50,881,512,369
050,26,117,"Michigan","Montcalm County",4,51,941,524,417
050,26,117,"Michigan","Montcalm County",4,52,890,500,390
050,26,117,"Michigan","Montcalm County",4,53,851,459,392
050,26,117,"Michigan","Montcalm County",4,54,847,445,402
050,26,117,"Michigan","Montcalm County",4,55,883,492,391
050,26,117,"Michigan","Montcalm County",4,56,915,497,418
050,26,117,"Michigan","Montcalm County",4,57,960,514,446
050,26,117,"Michigan","Montcalm County",4,58,943,494,449
050,26,117,"Michigan","Montcalm County",4,59,907,463,444
050,26,117,"Michigan","Montcalm County",4,60,968,502,466
050,26,117,"Michigan","Montcalm County",4,61,933,483,450
050,26,117,"Michigan","Montcalm County",4,62,937,494,443
050,26,117,"Michigan","Montcalm County",4,63,943,496,447
050,26,117,"Michigan","Montcalm County",4,64,944,490,454
050,26,117,"Michigan","Montcalm County",4,65,955,478,477
050,26,117,"Michigan","Montcalm County",4,66,849,418,431
050,26,117,"Michigan","Montcalm County",4,67,825,419,406
050,26,117,"Michigan","Montcalm County",4,68,811,403,408
050,26,117,"Michigan","Montcalm County",4,69,788,381,407
050,26,117,"Michigan","Montcalm County",4,70,735,365,370
050,26,117,"Michigan","Montcalm County",4,71,675,336,339
050,26,117,"Michigan","Montcalm County",4,72,649,321,328
050,26,117,"Michigan","Montcalm County",4,73,629,289,340
050,26,117,"Michigan","Montcalm County",4,74,563,265,298
050,26,117,"Michigan","Montcalm County",4,75,607,310,297
050,26,117,"Michigan","Montcalm County",4,76,441,222,219
050,26,117,"Michigan","Montcalm County",4,77,408,197,211
050,26,117,"Michigan","Montcalm County",4,78,402,182,220
050,26,117,"Michigan","Montcalm County",4,79,399,184,215
050,26,117,"Michigan","Montcalm County",4,80,341,152,189
050,26,117,"Michigan","Montcalm County",4,81,296,133,163
050,26,117,"Michigan","Montcalm County",4,82,249,119,130
050,26,117,"Michigan","Montcalm County",4,83,238,105,133
050,26,117,"Michigan","Montcalm County",4,84,225,94,131
050,26,117,"Michigan","Montcalm County",4,85,1136,408,728
050,26,117,"Michigan","Montcalm County",5,0,679,325,354
050,26,117,"Michigan","Montcalm County",5,1,668,317,351
050,26,117,"Michigan","Montcalm County",5,2,669,321,348
050,26,117,"Michigan","Montcalm County",5,3,765,405,360
050,26,117,"Michigan","Montcalm County",5,4,691,328,363
050,26,117,"Michigan","Montcalm County",5,5,755,382,373
050,26,117,"Michigan","Montcalm County",5,6,784,403,381
050,26,117,"Michigan","Montcalm County",5,7,792,405,387
050,26,117,"Michigan","Montcalm County",5,8,754,393,361
050,26,117,"Michigan","Montcalm County",5,9,785,401,384
050,26,117,"Michigan","Montcalm County",5,10,786,380,406
050,26,117,"Michigan","Montcalm County",5,11,804,399,405
050,26,117,"Michigan","Montcalm County",5,12,820,420,400
050,26,117,"Michigan","Montcalm County",5,13,832,436,396
050,26,117,"Michigan","Montcalm County",5,14,866,454,412
050,26,117,"Michigan","Montcalm County",5,15,888,466,422
050,26,117,"Michigan","Montcalm County",5,16,810,418,392
050,26,117,"Michigan","Montcalm County",5,17,869,463,406
050,26,117,"Michigan","Montcalm County",5,18,796,431,365
050,26,117,"Michigan","Montcalm County",5,19,670,388,282
050,26,117,"Michigan","Montcalm County",5,20,705,418,287
050,26,117,"Michigan","Montcalm County",5,21,701,400,301
050,26,117,"Michigan","Montcalm County",5,22,810,448,362
050,26,117,"Michigan","Montcalm County",5,23,821,483,338
050,26,117,"Michigan","Montcalm County",5,24,866,489,377
050,26,117,"Michigan","Montcalm County",5,25,885,531,354
050,26,117,"Michigan","Montcalm County",5,26,835,478,357
050,26,117,"Michigan","Montcalm County",5,27,915,545,370
050,26,117,"Michigan","Montcalm County",5,28,939,569,370
050,26,117,"Michigan","Montcalm County",5,29,959,578,381
050,26,117,"Michigan","Montcalm County",5,30,966,567,399
050,26,117,"Michigan","Montcalm County",5,31,967,547,420
050,26,117,"Michigan","Montcalm County",5,32,1037,571,466
050,26,117,"Michigan","Montcalm County",5,33,961,551,410
050,26,117,"Michigan","Montcalm County",5,34,872,482,390
050,26,117,"Michigan","Montcalm County",5,35,884,511,373
050,26,117,"Michigan","Montcalm County",5,36,890,548,342
050,26,117,"Michigan","Montcalm County",5,37,948,575,373
050,26,117,"Michigan","Montcalm County",5,38,893,514,379
050,26,117,"Michigan","Montcalm County",5,39,883,514,369
050,26,117,"Michigan","Montcalm County",5,40,874,495,379
050,26,117,"Michigan","Montcalm County",5,41,900,534,366
050,26,117,"Michigan","Montcalm County",5,42,897,528,369
050,26,117,"Michigan","Montcalm County",5,43,881,494,387
050,26,117,"Michigan","Montcalm County",5,44,885,507,378
050,26,117,"Michigan","Montcalm County",5,45,846,493,353
050,26,117,"Michigan","Montcalm County",5,46,823,475,348
050,26,117,"Michigan","Montcalm County",5,47,815,484,331
050,26,117,"Michigan","Montcalm County",5,48,838,513,325
050,26,117,"Michigan","Montcalm County",5,49,809,466,343
050,26,117,"Michigan","Montcalm County",5,50,871,498,373
050,26,117,"Michigan","Montcalm County",5,51,880,496,384
050,26,117,"Michigan","Montcalm County",5,52,948,524,424
050,26,117,"Michigan","Montcalm County",5,53,889,509,380
050,26,117,"Michigan","Montcalm County",5,54,859,454,405
050,26,117,"Michigan","Montcalm County",5,55,877,479,398
050,26,117,"Michigan","Montcalm County",5,56,890,489,401
050,26,117,"Michigan","Montcalm County",5,57,928,510,418
050,26,117,"Michigan","Montcalm County",5,58,946,502,444
050,26,117,"Michigan","Montcalm County",5,59,928,476,452
050,26,117,"Michigan","Montcalm County",5,60,923,474,449
050,26,117,"Michigan","Montcalm County",5,61,983,505,478
050,26,117,"Michigan","Montcalm County",5,62,947,498,449
050,26,117,"Michigan","Montcalm County",5,63,939,499,440
050,26,117,"Michigan","Montcalm County",5,64,928,481,447
050,26,117,"Michigan","Montcalm County",5,65,952,491,461
050,26,117,"Michigan","Montcalm County",5,66,941,469,472
050,26,117,"Michigan","Montcalm County",5,67,852,418,434
050,26,117,"Michigan","Montcalm County",5,68,816,411,405
050,26,117,"Michigan","Montcalm County",5,69,812,405,407
050,26,117,"Michigan","Montcalm County",5,70,767,368,399
050,26,117,"Michigan","Montcalm County",5,71,717,352,365
050,26,117,"Michigan","Montcalm County",5,72,670,338,332
050,26,117,"Michigan","Montcalm County",5,73,629,302,327
050,26,117,"Michigan","Montcalm County",5,74,602,275,327
050,26,117,"Michigan","Montcalm County",5,75,542,256,286
050,26,117,"Michigan","Montcalm County",5,76,590,298,292
050,26,117,"Michigan","Montcalm County",5,77,426,212,214
050,26,117,"Michigan","Montcalm County",5,78,381,182,199
050,26,117,"Michigan","Montcalm County",5,79,376,168,208
050,26,117,"Michigan","Montcalm County",5,80,378,171,207
050,26,117,"Michigan","Montcalm County",5,81,310,135,175
050,26,117,"Michigan","Montcalm County",5,82,269,123,146
050,26,117,"Michigan","Montcalm County",5,83,216,100,116
050,26,117,"Michigan","Montcalm County",5,84,225,101,124
050,26,117,"Michigan","Montcalm County",5,85,1159,424,735
050,26,119,"Michigan","Montmorency County",1,0,81,43,38
050,26,119,"Michigan","Montmorency County",1,1,85,47,38
050,26,119,"Michigan","Montmorency County",1,2,61,34,27
050,26,119,"Michigan","Montmorency County",1,3,72,39,33
050,26,119,"Michigan","Montmorency County",1,4,82,41,41
050,26,119,"Michigan","Montmorency County",1,5,56,22,34
050,26,119,"Michigan","Montmorency County",1,6,73,39,34
050,26,119,"Michigan","Montmorency County",1,7,68,38,30
050,26,119,"Michigan","Montmorency County",1,8,81,38,43
050,26,119,"Michigan","Montmorency County",1,9,74,37,37
050,26,119,"Michigan","Montmorency County",1,10,73,40,33
050,26,119,"Michigan","Montmorency County",1,11,85,49,36
050,26,119,"Michigan","Montmorency County",1,12,103,58,45
050,26,119,"Michigan","Montmorency County",1,13,92,47,45
050,26,119,"Michigan","Montmorency County",1,14,96,53,43
050,26,119,"Michigan","Montmorency County",1,15,67,40,27
050,26,119,"Michigan","Montmorency County",1,16,86,45,41
050,26,119,"Michigan","Montmorency County",1,17,90,51,39
050,26,119,"Michigan","Montmorency County",1,18,84,53,31
050,26,119,"Michigan","Montmorency County",1,19,59,33,26
050,26,119,"Michigan","Montmorency County",1,20,64,33,31
050,26,119,"Michigan","Montmorency County",1,21,75,36,39
050,26,119,"Michigan","Montmorency County",1,22,68,30,38
050,26,119,"Michigan","Montmorency County",1,23,65,33,32
050,26,119,"Michigan","Montmorency County",1,24,70,31,39
050,26,119,"Michigan","Montmorency County",1,25,65,33,32
050,26,119,"Michigan","Montmorency County",1,26,72,41,31
050,26,119,"Michigan","Montmorency County",1,27,68,37,31
050,26,119,"Michigan","Montmorency County",1,28,70,35,35
050,26,119,"Michigan","Montmorency County",1,29,74,38,36
050,26,119,"Michigan","Montmorency County",1,30,75,39,36
050,26,119,"Michigan","Montmorency County",1,31,70,41,29
050,26,119,"Michigan","Montmorency County",1,32,62,32,30
050,26,119,"Michigan","Montmorency County",1,33,66,36,30
050,26,119,"Michigan","Montmorency County",1,34,67,37,30
050,26,119,"Michigan","Montmorency County",1,35,88,41,47
050,26,119,"Michigan","Montmorency County",1,36,72,35,37
050,26,119,"Michigan","Montmorency County",1,37,67,33,34
050,26,119,"Michigan","Montmorency County",1,38,79,42,37
050,26,119,"Michigan","Montmorency County",1,39,86,39,47
050,26,119,"Michigan","Montmorency County",1,40,86,42,44
050,26,119,"Michigan","Montmorency County",1,41,97,48,49
050,26,119,"Michigan","Montmorency County",1,42,74,39,35
050,26,119,"Michigan","Montmorency County",1,43,81,40,41
050,26,119,"Michigan","Montmorency County",1,44,68,35,33
050,26,119,"Michigan","Montmorency County",1,45,78,42,36
050,26,119,"Michigan","Montmorency County",1,46,87,46,41
050,26,119,"Michigan","Montmorency County",1,47,85,43,42
050,26,119,"Michigan","Montmorency County",1,48,103,50,53
050,26,119,"Michigan","Montmorency County",1,49,110,62,48
050,26,119,"Michigan","Montmorency County",1,50,104,61,43
050,26,119,"Michigan","Montmorency County",1,51,107,59,48
050,26,119,"Michigan","Montmorency County",1,52,112,58,54
050,26,119,"Michigan","Montmorency County",1,53,111,53,58
050,26,119,"Michigan","Montmorency County",1,54,122,60,62
050,26,119,"Michigan","Montmorency County",1,55,141,66,75
050,26,119,"Michigan","Montmorency County",1,56,149,77,72
050,26,119,"Michigan","Montmorency County",1,57,144,66,78
050,26,119,"Michigan","Montmorency County",1,58,157,73,84
050,26,119,"Michigan","Montmorency County",1,59,179,85,94
050,26,119,"Michigan","Montmorency County",1,60,186,89,97
050,26,119,"Michigan","Montmorency County",1,61,203,107,96
050,26,119,"Michigan","Montmorency County",1,62,209,124,85
050,26,119,"Michigan","Montmorency County",1,63,192,102,90
050,26,119,"Michigan","Montmorency County",1,64,241,111,130
050,26,119,"Michigan","Montmorency County",1,65,241,129,112
050,26,119,"Michigan","Montmorency County",1,66,205,104,101
050,26,119,"Michigan","Montmorency County",1,67,212,113,99
050,26,119,"Michigan","Montmorency County",1,68,210,115,95
050,26,119,"Michigan","Montmorency County",1,69,183,93,90
050,26,119,"Michigan","Montmorency County",1,70,174,92,82
050,26,119,"Michigan","Montmorency County",1,71,179,92,87
050,26,119,"Michigan","Montmorency County",1,72,166,99,67
050,26,119,"Michigan","Montmorency County",1,73,176,106,70
050,26,119,"Michigan","Montmorency County",1,74,119,56,63
050,26,119,"Michigan","Montmorency County",1,75,114,53,61
050,26,119,"Michigan","Montmorency County",1,76,99,53,46
050,26,119,"Michigan","Montmorency County",1,77,98,49,49
050,26,119,"Michigan","Montmorency County",1,78,98,46,52
050,26,119,"Michigan","Montmorency County",1,79,92,44,48
050,26,119,"Michigan","Montmorency County",1,80,83,44,39
050,26,119,"Michigan","Montmorency County",1,81,76,33,43
050,26,119,"Michigan","Montmorency County",1,82,64,31,33
050,26,119,"Michigan","Montmorency County",1,83,63,34,29
050,26,119,"Michigan","Montmorency County",1,84,56,28,28
050,26,119,"Michigan","Montmorency County",1,85,233,97,136
050,26,119,"Michigan","Montmorency County",2,0,81,45,36
050,26,119,"Michigan","Montmorency County",2,1,83,45,38
050,26,119,"Michigan","Montmorency County",2,2,68,37,31
050,26,119,"Michigan","Montmorency County",2,3,70,38,32
050,26,119,"Michigan","Montmorency County",2,4,78,40,38
050,26,119,"Michigan","Montmorency County",2,5,64,28,36
050,26,119,"Michigan","Montmorency County",2,6,69,34,35
050,26,119,"Michigan","Montmorency County",2,7,70,38,32
050,26,119,"Michigan","Montmorency County",2,8,79,38,41
050,26,119,"Michigan","Montmorency County",2,9,74,36,38
050,26,119,"Michigan","Montmorency County",2,10,72,39,33
050,26,119,"Michigan","Montmorency County",2,11,85,48,37
050,26,119,"Michigan","Montmorency County",2,12,99,57,42
050,26,119,"Michigan","Montmorency County",2,13,94,50,44
050,26,119,"Michigan","Montmorency County",2,14,95,53,42
050,26,119,"Michigan","Montmorency County",2,15,75,43,32
050,26,119,"Michigan","Montmorency County",2,16,83,45,38
050,26,119,"Michigan","Montmorency County",2,17,88,49,39
050,26,119,"Michigan","Montmorency County",2,18,80,50,30
050,26,119,"Michigan","Montmorency County",2,19,61,35,26
050,26,119,"Michigan","Montmorency County",2,20,66,35,31
050,26,119,"Michigan","Montmorency County",2,21,73,35,38
050,26,119,"Michigan","Montmorency County",2,22,69,31,38
050,26,119,"Michigan","Montmorency County",2,23,67,33,34
050,26,119,"Michigan","Montmorency County",2,24,69,31,38
050,26,119,"Michigan","Montmorency County",2,25,67,33,34
050,26,119,"Michigan","Montmorency County",2,26,70,40,30
050,26,119,"Michigan","Montmorency County",2,27,70,38,32
050,26,119,"Michigan","Montmorency County",2,28,70,36,34
050,26,119,"Michigan","Montmorency County",2,29,74,38,36
050,26,119,"Michigan","Montmorency County",2,30,77,40,37
050,26,119,"Michigan","Montmorency County",2,31,71,41,30
050,26,119,"Michigan","Montmorency County",2,32,66,36,30
050,26,119,"Michigan","Montmorency County",2,33,65,35,30
050,26,119,"Michigan","Montmorency County",2,34,67,37,30
050,26,119,"Michigan","Montmorency County",2,35,85,41,44
050,26,119,"Michigan","Montmorency County",2,36,74,36,38
050,26,119,"Michigan","Montmorency County",2,37,69,34,35
050,26,119,"Michigan","Montmorency County",2,38,78,40,38
050,26,119,"Michigan","Montmorency County",2,39,84,39,45
050,26,119,"Michigan","Montmorency County",2,40,87,42,45
050,26,119,"Michigan","Montmorency County",2,41,94,47,47
050,26,119,"Michigan","Montmorency County",2,42,79,41,38
050,26,119,"Michigan","Montmorency County",2,43,80,39,41
050,26,119,"Michigan","Montmorency County",2,44,70,36,34
050,26,119,"Michigan","Montmorency County",2,45,77,41,36
050,26,119,"Michigan","Montmorency County",2,46,83,44,39
050,26,119,"Michigan","Montmorency County",2,47,85,43,42
050,26,119,"Michigan","Montmorency County",2,48,99,48,51
050,26,119,"Michigan","Montmorency County",2,49,111,60,51
050,26,119,"Michigan","Montmorency County",2,50,105,60,45
050,26,119,"Michigan","Montmorency County",2,51,105,59,46
050,26,119,"Michigan","Montmorency County",2,52,109,57,52
050,26,119,"Michigan","Montmorency County",2,53,113,56,57
050,26,119,"Michigan","Montmorency County",2,54,120,58,62
050,26,119,"Michigan","Montmorency County",2,55,135,64,71
050,26,119,"Michigan","Montmorency County",2,56,149,75,74
050,26,119,"Michigan","Montmorency County",2,57,147,69,78
050,26,119,"Michigan","Montmorency County",2,58,157,73,84
050,26,119,"Michigan","Montmorency County",2,59,177,83,94
050,26,119,"Michigan","Montmorency County",2,60,188,89,99
050,26,119,"Michigan","Montmorency County",2,61,201,104,97
050,26,119,"Michigan","Montmorency County",2,62,210,121,89
050,26,119,"Michigan","Montmorency County",2,63,198,108,90
050,26,119,"Michigan","Montmorency County",2,64,227,108,119
050,26,119,"Michigan","Montmorency County",2,65,241,126,115
050,26,119,"Michigan","Montmorency County",2,66,216,111,105
050,26,119,"Michigan","Montmorency County",2,67,209,110,99
050,26,119,"Michigan","Montmorency County",2,68,207,112,95
050,26,119,"Michigan","Montmorency County",2,69,191,99,92
050,26,119,"Michigan","Montmorency County",2,70,177,93,84
050,26,119,"Michigan","Montmorency County",2,71,177,92,85
050,26,119,"Michigan","Montmorency County",2,72,164,96,68
050,26,119,"Michigan","Montmorency County",2,73,183,110,73
050,26,119,"Michigan","Montmorency County",2,74,123,63,60
050,26,119,"Michigan","Montmorency County",2,75,116,54,62
050,26,119,"Michigan","Montmorency County",2,76,101,52,49
050,26,119,"Michigan","Montmorency County",2,77,98,51,47
050,26,119,"Michigan","Montmorency County",2,78,94,45,49
050,26,119,"Michigan","Montmorency County",2,79,91,43,48
050,26,119,"Michigan","Montmorency County",2,80,86,44,42
050,26,119,"Michigan","Montmorency County",2,81,73,33,40
050,26,119,"Michigan","Montmorency County",2,82,66,31,35
050,26,119,"Michigan","Montmorency County",2,83,62,32,30
050,26,119,"Michigan","Montmorency County",2,84,57,29,28
050,26,119,"Michigan","Montmorency County",2,85,233,96,137
050,26,119,"Michigan","Montmorency County",3,0,76,35,41
050,26,119,"Michigan","Montmorency County",3,1,84,52,32
050,26,119,"Michigan","Montmorency County",3,2,82,45,37
050,26,119,"Michigan","Montmorency County",3,3,69,35,34
050,26,119,"Michigan","Montmorency County",3,4,73,36,37
050,26,119,"Michigan","Montmorency County",3,5,84,44,40
050,26,119,"Michigan","Montmorency County",3,6,69,38,31
050,26,119,"Michigan","Montmorency County",3,7,68,34,34
050,26,119,"Michigan","Montmorency County",3,8,68,38,30
050,26,119,"Michigan","Montmorency County",3,9,82,38,44
050,26,119,"Michigan","Montmorency County",3,10,73,35,38
050,26,119,"Michigan","Montmorency County",3,11,78,40,38
050,26,119,"Michigan","Montmorency County",3,12,86,46,40
050,26,119,"Michigan","Montmorency County",3,13,94,55,39
050,26,119,"Michigan","Montmorency County",3,14,97,53,44
050,26,119,"Michigan","Montmorency County",3,15,102,55,47
050,26,119,"Michigan","Montmorency County",3,16,73,39,34
050,26,119,"Michigan","Montmorency County",3,17,85,42,43
050,26,119,"Michigan","Montmorency County",3,18,71,41,30
050,26,119,"Michigan","Montmorency County",3,19,61,37,24
050,26,119,"Michigan","Montmorency County",3,20,67,43,24
050,26,119,"Michigan","Montmorency County",3,21,68,29,39
050,26,119,"Michigan","Montmorency County",3,22,70,37,33
050,26,119,"Michigan","Montmorency County",3,23,72,36,36
050,26,119,"Michigan","Montmorency County",3,24,63,32,31
050,26,119,"Michigan","Montmorency County",3,25,68,31,37
050,26,119,"Michigan","Montmorency County",3,26,64,30,34
050,26,119,"Michigan","Montmorency County",3,27,78,45,33
050,26,119,"Michigan","Montmorency County",3,28,70,39,31
050,26,119,"Michigan","Montmorency County",3,29,76,40,36
050,26,119,"Michigan","Montmorency County",3,30,67,35,32
050,26,119,"Michigan","Montmorency County",3,31,85,46,39
050,26,119,"Michigan","Montmorency County",3,32,69,38,31
050,26,119,"Michigan","Montmorency County",3,33,72,39,33
050,26,119,"Michigan","Montmorency County",3,34,73,38,35
050,26,119,"Michigan","Montmorency County",3,35,67,38,29
050,26,119,"Michigan","Montmorency County",3,36,87,44,43
050,26,119,"Michigan","Montmorency County",3,37,73,33,40
050,26,119,"Michigan","Montmorency County",3,38,71,35,36
050,26,119,"Michigan","Montmorency County",3,39,79,38,41
050,26,119,"Michigan","Montmorency County",3,40,91,42,49
050,26,119,"Michigan","Montmorency County",3,41,92,44,48
050,26,119,"Michigan","Montmorency County",3,42,91,44,47
050,26,119,"Michigan","Montmorency County",3,43,76,37,39
050,26,119,"Michigan","Montmorency County",3,44,79,42,37
050,26,119,"Michigan","Montmorency County",3,45,67,34,33
050,26,119,"Michigan","Montmorency County",3,46,82,45,37
050,26,119,"Michigan","Montmorency County",3,47,78,42,36
050,26,119,"Michigan","Montmorency County",3,48,87,44,43
050,26,119,"Michigan","Montmorency County",3,49,104,53,51
050,26,119,"Michigan","Montmorency County",3,50,110,58,52
050,26,119,"Michigan","Montmorency County",3,51,113,67,46
050,26,119,"Michigan","Montmorency County",3,52,117,63,54
050,26,119,"Michigan","Montmorency County",3,53,120,59,61
050,26,119,"Michigan","Montmorency County",3,54,122,63,59
050,26,119,"Michigan","Montmorency County",3,55,140,71,69
050,26,119,"Michigan","Montmorency County",3,56,140,67,73
050,26,119,"Michigan","Montmorency County",3,57,161,84,77
050,26,119,"Michigan","Montmorency County",3,58,170,78,92
050,26,119,"Michigan","Montmorency County",3,59,165,78,87
050,26,119,"Michigan","Montmorency County",3,60,186,88,98
050,26,119,"Michigan","Montmorency County",3,61,198,95,103
050,26,119,"Michigan","Montmorency County",3,62,205,110,95
050,26,119,"Michigan","Montmorency County",3,63,222,128,94
050,26,119,"Michigan","Montmorency County",3,64,206,117,89
050,26,119,"Michigan","Montmorency County",3,65,237,109,128
050,26,119,"Michigan","Montmorency County",3,66,248,129,119
050,26,119,"Michigan","Montmorency County",3,67,220,113,107
050,26,119,"Michigan","Montmorency County",3,68,204,108,96
050,26,119,"Michigan","Montmorency County",3,69,216,117,99
050,26,119,"Michigan","Montmorency County",3,70,181,95,86
050,26,119,"Michigan","Montmorency County",3,71,178,95,83
050,26,119,"Michigan","Montmorency County",3,72,176,91,85
050,26,119,"Michigan","Montmorency County",3,73,152,93,59
050,26,119,"Michigan","Montmorency County",3,74,178,105,73
050,26,119,"Michigan","Montmorency County",3,75,113,57,56
050,26,119,"Michigan","Montmorency County",3,76,111,51,60
050,26,119,"Michigan","Montmorency County",3,77,90,43,47
050,26,119,"Michigan","Montmorency County",3,78,95,50,45
050,26,119,"Michigan","Montmorency County",3,79,91,46,45
050,26,119,"Michigan","Montmorency County",3,80,84,41,43
050,26,119,"Michigan","Montmorency County",3,81,75,40,35
050,26,119,"Michigan","Montmorency County",3,82,72,36,36
050,26,119,"Michigan","Montmorency County",3,83,61,27,34
050,26,119,"Michigan","Montmorency County",3,84,56,30,26
050,26,119,"Michigan","Montmorency County",3,85,228,96,132
050,26,119,"Michigan","Montmorency County",4,0,75,35,40
050,26,119,"Michigan","Montmorency County",4,1,82,41,41
050,26,119,"Michigan","Montmorency County",4,2,73,40,33
050,26,119,"Michigan","Montmorency County",4,3,89,49,40
050,26,119,"Michigan","Montmorency County",4,4,69,34,35
050,26,119,"Michigan","Montmorency County",4,5,71,34,37
050,26,119,"Michigan","Montmorency County",4,6,86,44,42
050,26,119,"Michigan","Montmorency County",4,7,73,40,33
050,26,119,"Michigan","Montmorency County",4,8,69,33,36
050,26,119,"Michigan","Montmorency County",4,9,74,39,35
050,26,119,"Michigan","Montmorency County",4,10,83,41,42
050,26,119,"Michigan","Montmorency County",4,11,80,37,43
050,26,119,"Michigan","Montmorency County",4,12,80,39,41
050,26,119,"Michigan","Montmorency County",4,13,97,51,46
050,26,119,"Michigan","Montmorency County",4,14,100,60,40
050,26,119,"Michigan","Montmorency County",4,15,95,52,43
050,26,119,"Michigan","Montmorency County",4,16,100,54,46
050,26,119,"Michigan","Montmorency County",4,17,76,40,36
050,26,119,"Michigan","Montmorency County",4,18,65,37,28
050,26,119,"Michigan","Montmorency County",4,19,58,33,25
050,26,119,"Michigan","Montmorency County",4,20,71,43,28
050,26,119,"Michigan","Montmorency County",4,21,79,48,31
050,26,119,"Michigan","Montmorency County",4,22,72,32,40
050,26,119,"Michigan","Montmorency County",4,23,86,44,42
050,26,119,"Michigan","Montmorency County",4,24,80,39,41
050,26,119,"Michigan","Montmorency County",4,25,68,34,34
050,26,119,"Michigan","Montmorency County",4,26,63,29,34
050,26,119,"Michigan","Montmorency County",4,27,64,35,29
050,26,119,"Michigan","Montmorency County",4,28,83,45,38
050,26,119,"Michigan","Montmorency County",4,29,72,36,36
050,26,119,"Michigan","Montmorency County",4,30,74,41,33
050,26,119,"Michigan","Montmorency County",4,31,76,38,38
050,26,119,"Michigan","Montmorency County",4,32,85,47,38
050,26,119,"Michigan","Montmorency County",4,33,81,46,35
050,26,119,"Michigan","Montmorency County",4,34,77,43,34
050,26,119,"Michigan","Montmorency County",4,35,78,39,39
050,26,119,"Michigan","Montmorency County",4,36,81,42,39
050,26,119,"Michigan","Montmorency County",4,37,94,49,45
050,26,119,"Michigan","Montmorency County",4,38,77,37,40
050,26,119,"Michigan","Montmorency County",4,39,79,41,38
050,26,119,"Michigan","Montmorency County",4,40,86,38,48
050,26,119,"Michigan","Montmorency County",4,41,96,44,52
050,26,119,"Michigan","Montmorency County",4,42,98,53,45
050,26,119,"Michigan","Montmorency County",4,43,95,45,50
050,26,119,"Michigan","Montmorency County",4,44,74,36,38
050,26,119,"Michigan","Montmorency County",4,45,84,46,38
050,26,119,"Michigan","Montmorency County",4,46,69,33,36
050,26,119,"Michigan","Montmorency County",4,47,86,46,40
050,26,119,"Michigan","Montmorency County",4,48,88,49,39
050,26,119,"Michigan","Montmorency County",4,49,91,45,46
050,26,119,"Michigan","Montmorency County",4,50,103,46,57
050,26,119,"Michigan","Montmorency County",4,51,108,59,49
050,26,119,"Michigan","Montmorency County",4,52,115,67,48
050,26,119,"Michigan","Montmorency County",4,53,120,65,55
050,26,119,"Michigan","Montmorency County",4,54,128,67,61
050,26,119,"Michigan","Montmorency County",4,55,132,64,68
050,26,119,"Michigan","Montmorency County",4,56,143,67,76
050,26,119,"Michigan","Montmorency County",4,57,153,72,81
050,26,119,"Michigan","Montmorency County",4,58,171,88,83
050,26,119,"Michigan","Montmorency County",4,59,185,86,99
050,26,119,"Michigan","Montmorency County",4,60,181,85,96
050,26,119,"Michigan","Montmorency County",4,61,201,96,105
050,26,119,"Michigan","Montmorency County",4,62,205,103,102
050,26,119,"Michigan","Montmorency County",4,63,219,115,104
050,26,119,"Michigan","Montmorency County",4,64,257,151,106
050,26,119,"Michigan","Montmorency County",4,65,207,116,91
050,26,119,"Michigan","Montmorency County",4,66,235,103,132
050,26,119,"Michigan","Montmorency County",4,67,248,131,117
050,26,119,"Michigan","Montmorency County",4,68,213,109,104
050,26,119,"Michigan","Montmorency County",4,69,205,106,99
050,26,119,"Michigan","Montmorency County",4,70,212,115,97
050,26,119,"Michigan","Montmorency County",4,71,175,90,85
050,26,119,"Michigan","Montmorency County",4,72,173,91,82
050,26,119,"Michigan","Montmorency County",4,73,167,90,77
050,26,119,"Michigan","Montmorency County",4,74,150,93,57
050,26,119,"Michigan","Montmorency County",4,75,176,103,73
050,26,119,"Michigan","Montmorency County",4,76,106,52,54
050,26,119,"Michigan","Montmorency County",4,77,103,46,57
050,26,119,"Michigan","Montmorency County",4,78,82,42,40
050,26,119,"Michigan","Montmorency County",4,79,86,47,39
050,26,119,"Michigan","Montmorency County",4,80,88,41,47
050,26,119,"Michigan","Montmorency County",4,81,73,36,37
050,26,119,"Michigan","Montmorency County",4,82,71,39,32
050,26,119,"Michigan","Montmorency County",4,83,68,34,34
050,26,119,"Michigan","Montmorency County",4,84,55,25,30
050,26,119,"Michigan","Montmorency County",4,85,241,108,133
050,26,119,"Michigan","Montmorency County",5,0,73,35,38
050,26,119,"Michigan","Montmorency County",5,1,66,27,39
050,26,119,"Michigan","Montmorency County",5,2,76,33,43
050,26,119,"Michigan","Montmorency County",5,3,82,43,39
050,26,119,"Michigan","Montmorency County",5,4,90,51,39
050,26,119,"Michigan","Montmorency County",5,5,70,35,35
050,26,119,"Michigan","Montmorency County",5,6,74,38,36
050,26,119,"Michigan","Montmorency County",5,7,95,50,45
050,26,119,"Michigan","Montmorency County",5,8,76,41,35
050,26,119,"Michigan","Montmorency County",5,9,75,36,39
050,26,119,"Michigan","Montmorency County",5,10,76,40,36
050,26,119,"Michigan","Montmorency County",5,11,87,43,44
050,26,119,"Michigan","Montmorency County",5,12,82,39,43
050,26,119,"Michigan","Montmorency County",5,13,85,44,41
050,26,119,"Michigan","Montmorency County",5,14,98,51,47
050,26,119,"Michigan","Montmorency County",5,15,98,58,40
050,26,119,"Michigan","Montmorency County",5,16,107,58,49
050,26,119,"Michigan","Montmorency County",5,17,103,57,46
050,26,119,"Michigan","Montmorency County",5,18,74,41,33
050,26,119,"Michigan","Montmorency County",5,19,49,27,22
050,26,119,"Michigan","Montmorency County",5,20,64,36,28
050,26,119,"Michigan","Montmorency County",5,21,70,41,29
050,26,119,"Michigan","Montmorency County",5,22,75,42,33
050,26,119,"Michigan","Montmorency County",5,23,79,35,44
050,26,119,"Michigan","Montmorency County",5,24,86,46,40
050,26,119,"Michigan","Montmorency County",5,25,80,42,38
050,26,119,"Michigan","Montmorency County",5,26,66,31,35
050,26,119,"Michigan","Montmorency County",5,27,66,27,39
050,26,119,"Michigan","Montmorency County",5,28,70,36,34
050,26,119,"Michigan","Montmorency County",5,29,80,39,41
050,26,119,"Michigan","Montmorency County",5,30,69,36,33
050,26,119,"Michigan","Montmorency County",5,31,76,43,33
050,26,119,"Michigan","Montmorency County",5,32,84,44,40
050,26,119,"Michigan","Montmorency County",5,33,92,50,42
050,26,119,"Michigan","Montmorency County",5,34,75,40,35
050,26,119,"Michigan","Montmorency County",5,35,73,38,35
050,26,119,"Michigan","Montmorency County",5,36,81,42,39
050,26,119,"Michigan","Montmorency County",5,37,75,40,35
050,26,119,"Michigan","Montmorency County",5,38,96,50,46
050,26,119,"Michigan","Montmorency County",5,39,77,39,38
050,26,119,"Michigan","Montmorency County",5,40,77,40,37
050,26,119,"Michigan","Montmorency County",5,41,83,37,46
050,26,119,"Michigan","Montmorency County",5,42,102,46,56
050,26,119,"Michigan","Montmorency County",5,43,96,50,46
050,26,119,"Michigan","Montmorency County",5,44,99,48,51
050,26,119,"Michigan","Montmorency County",5,45,78,38,40
050,26,119,"Michigan","Montmorency County",5,46,97,50,47
050,26,119,"Michigan","Montmorency County",5,47,73,35,38
050,26,119,"Michigan","Montmorency County",5,48,87,45,42
050,26,119,"Michigan","Montmorency County",5,49,87,48,39
050,26,119,"Michigan","Montmorency County",5,50,95,45,50
050,26,119,"Michigan","Montmorency County",5,51,109,50,59
050,26,119,"Michigan","Montmorency County",5,52,116,62,54
050,26,119,"Michigan","Montmorency County",5,53,132,79,53
050,26,119,"Michigan","Montmorency County",5,54,130,70,60
050,26,119,"Michigan","Montmorency County",5,55,140,70,70
050,26,119,"Michigan","Montmorency County",5,56,151,74,77
050,26,119,"Michigan","Montmorency County",5,57,151,69,82
050,26,119,"Michigan","Montmorency County",5,58,161,79,82
050,26,119,"Michigan","Montmorency County",5,59,175,87,88
050,26,119,"Michigan","Montmorency County",5,60,195,96,99
050,26,119,"Michigan","Montmorency County",5,61,192,91,101
050,26,119,"Michigan","Montmorency County",5,62,207,99,108
050,26,119,"Michigan","Montmorency County",5,63,223,110,113
050,26,119,"Michigan","Montmorency County",5,64,233,127,106
050,26,119,"Michigan","Montmorency County",5,65,257,151,106
050,26,119,"Michigan","Montmorency County",5,66,207,115,92
050,26,119,"Michigan","Montmorency County",5,67,228,100,128
050,26,119,"Michigan","Montmorency County",5,68,241,130,111
050,26,119,"Michigan","Montmorency County",5,69,208,104,104
050,26,119,"Michigan","Montmorency County",5,70,195,98,97
050,26,119,"Michigan","Montmorency County",5,71,209,110,99
050,26,119,"Michigan","Montmorency County",5,72,171,86,85
050,26,119,"Michigan","Montmorency County",5,73,171,92,79
050,26,119,"Michigan","Montmorency County",5,74,160,88,72
050,26,119,"Michigan","Montmorency County",5,75,146,89,57
050,26,119,"Michigan","Montmorency County",5,76,162,92,70
050,26,119,"Michigan","Montmorency County",5,77,102,50,52
050,26,119,"Michigan","Montmorency County",5,78,101,47,54
050,26,119,"Michigan","Montmorency County",5,79,74,41,33
050,26,119,"Michigan","Montmorency County",5,80,79,41,38
050,26,119,"Michigan","Montmorency County",5,81,72,36,36
050,26,119,"Michigan","Montmorency County",5,82,64,33,31
050,26,119,"Michigan","Montmorency County",5,83,68,36,32
050,26,119,"Michigan","Montmorency County",5,84,60,32,28
050,26,119,"Michigan","Montmorency County",5,85,244,110,134
050,26,121,"Michigan","Muskegon County",1,0,1998,1017,981
050,26,121,"Michigan","Muskegon County",1,1,2040,1033,1007
050,26,121,"Michigan","Muskegon County",1,2,2116,1077,1039
050,26,121,"Michigan","Muskegon County",1,3,2123,1078,1045
050,26,121,"Michigan","Muskegon County",1,4,2149,1095,1054
050,26,121,"Michigan","Muskegon County",1,5,2184,1112,1072
050,26,121,"Michigan","Muskegon County",1,6,2154,1104,1050
050,26,121,"Michigan","Muskegon County",1,7,2168,1093,1075
050,26,121,"Michigan","Muskegon County",1,8,2227,1157,1070
050,26,121,"Michigan","Muskegon County",1,9,2213,1123,1090
050,26,121,"Michigan","Muskegon County",1,10,2324,1183,1141
050,26,121,"Michigan","Muskegon County",1,11,2388,1211,1177
050,26,121,"Michigan","Muskegon County",1,12,2360,1221,1139
050,26,121,"Michigan","Muskegon County",1,13,2409,1238,1171
050,26,121,"Michigan","Muskegon County",1,14,2332,1215,1117
050,26,121,"Michigan","Muskegon County",1,15,2300,1167,1133
050,26,121,"Michigan","Muskegon County",1,16,2365,1186,1179
050,26,121,"Michigan","Muskegon County",1,17,2365,1201,1164
050,26,121,"Michigan","Muskegon County",1,18,2098,1119,979
050,26,121,"Michigan","Muskegon County",1,19,1816,953,863
050,26,121,"Michigan","Muskegon County",1,20,1902,1012,890
050,26,121,"Michigan","Muskegon County",1,21,1945,1015,930
050,26,121,"Michigan","Muskegon County",1,22,2027,1028,999
050,26,121,"Michigan","Muskegon County",1,23,2063,1038,1025
050,26,121,"Michigan","Muskegon County",1,24,2168,1127,1041
050,26,121,"Michigan","Muskegon County",1,25,2276,1175,1101
050,26,121,"Michigan","Muskegon County",1,26,2284,1160,1124
050,26,121,"Michigan","Muskegon County",1,27,2328,1176,1152
050,26,121,"Michigan","Muskegon County",1,28,2389,1255,1134
050,26,121,"Michigan","Muskegon County",1,29,2420,1261,1159
050,26,121,"Michigan","Muskegon County",1,30,2371,1207,1164
050,26,121,"Michigan","Muskegon County",1,31,2275,1172,1103
050,26,121,"Michigan","Muskegon County",1,32,2138,1084,1054
050,26,121,"Michigan","Muskegon County",1,33,2100,1056,1044
050,26,121,"Michigan","Muskegon County",1,34,2194,1134,1060
050,26,121,"Michigan","Muskegon County",1,35,2210,1115,1095
050,26,121,"Michigan","Muskegon County",1,36,2240,1141,1099
050,26,121,"Michigan","Muskegon County",1,37,2221,1109,1112
050,26,121,"Michigan","Muskegon County",1,38,2187,1067,1120
050,26,121,"Michigan","Muskegon County",1,39,2207,1092,1115
050,26,121,"Michigan","Muskegon County",1,40,2208,1101,1107
050,26,121,"Michigan","Muskegon County",1,41,2141,1090,1051
050,26,121,"Michigan","Muskegon County",1,42,2098,1064,1034
050,26,121,"Michigan","Muskegon County",1,43,2035,1058,977
050,26,121,"Michigan","Muskegon County",1,44,1969,1010,959
050,26,121,"Michigan","Muskegon County",1,45,1948,983,965
050,26,121,"Michigan","Muskegon County",1,46,1918,980,938
050,26,121,"Michigan","Muskegon County",1,47,1958,1040,918
050,26,121,"Michigan","Muskegon County",1,48,2066,1075,991
050,26,121,"Michigan","Muskegon County",1,49,2263,1169,1094
050,26,121,"Michigan","Muskegon County",1,50,2136,1071,1065
050,26,121,"Michigan","Muskegon County",1,51,2116,1076,1040
050,26,121,"Michigan","Muskegon County",1,52,2073,1047,1026
050,26,121,"Michigan","Muskegon County",1,53,2184,1104,1080
050,26,121,"Michigan","Muskegon County",1,54,2178,1095,1083
050,26,121,"Michigan","Muskegon County",1,55,2313,1160,1153
050,26,121,"Michigan","Muskegon County",1,56,2432,1205,1227
050,26,121,"Michigan","Muskegon County",1,57,2466,1229,1237
050,26,121,"Michigan","Muskegon County",1,58,2581,1282,1299
050,26,121,"Michigan","Muskegon County",1,59,2545,1225,1320
050,26,121,"Michigan","Muskegon County",1,60,2573,1241,1332
050,26,121,"Michigan","Muskegon County",1,61,2509,1229,1280
050,26,121,"Michigan","Muskegon County",1,62,2561,1268,1293
050,26,121,"Michigan","Muskegon County",1,63,2464,1212,1252
050,26,121,"Michigan","Muskegon County",1,64,2339,1142,1197
050,26,121,"Michigan","Muskegon County",1,65,2296,1129,1167
050,26,121,"Michigan","Muskegon County",1,66,2274,1090,1184
050,26,121,"Michigan","Muskegon County",1,67,2223,1068,1155
050,26,121,"Michigan","Muskegon County",1,68,2073,970,1103
050,26,121,"Michigan","Muskegon County",1,69,1863,894,969
050,26,121,"Michigan","Muskegon County",1,70,1790,865,925
050,26,121,"Michigan","Muskegon County",1,71,1755,826,929
050,26,121,"Michigan","Muskegon County",1,72,1709,801,908
050,26,121,"Michigan","Muskegon County",1,73,1717,795,922
050,26,121,"Michigan","Muskegon County",1,74,1188,540,648
050,26,121,"Michigan","Muskegon County",1,75,1193,559,634
050,26,121,"Michigan","Muskegon County",1,76,1153,535,618
050,26,121,"Michigan","Muskegon County",1,77,1074,485,589
050,26,121,"Michigan","Muskegon County",1,78,960,436,524
050,26,121,"Michigan","Muskegon County",1,79,829,377,452
050,26,121,"Michigan","Muskegon County",1,80,759,322,437
050,26,121,"Michigan","Muskegon County",1,81,727,305,422
050,26,121,"Michigan","Muskegon County",1,82,699,291,408
050,26,121,"Michigan","Muskegon County",1,83,598,242,356
050,26,121,"Michigan","Muskegon County",1,84,556,223,333
050,26,121,"Michigan","Muskegon County",1,85,3152,1086,2066
050,26,121,"Michigan","Muskegon County",2,0,2003,1032,971
050,26,121,"Michigan","Muskegon County",2,1,2035,1034,1001
050,26,121,"Michigan","Muskegon County",2,2,2113,1076,1037
050,26,121,"Michigan","Muskegon County",2,3,2122,1080,1042
050,26,121,"Michigan","Muskegon County",2,4,2143,1090,1053
050,26,121,"Michigan","Muskegon County",2,5,2178,1109,1069
050,26,121,"Michigan","Muskegon County",2,6,2164,1108,1056
050,26,121,"Michigan","Muskegon County",2,7,2161,1095,1066
050,26,121,"Michigan","Muskegon County",2,8,2203,1137,1066
050,26,121,"Michigan","Muskegon County",2,9,2212,1129,1083
050,26,121,"Michigan","Muskegon County",2,10,2299,1169,1130
050,26,121,"Michigan","Muskegon County",2,11,2364,1202,1162
050,26,121,"Michigan","Muskegon County",2,12,2381,1225,1156
050,26,121,"Michigan","Muskegon County",2,13,2398,1235,1163
050,26,121,"Michigan","Muskegon County",2,14,2341,1216,1125
050,26,121,"Michigan","Muskegon County",2,15,2309,1181,1128
050,26,121,"Michigan","Muskegon County",2,16,2351,1181,1170
050,26,121,"Michigan","Muskegon County",2,17,2360,1195,1165
050,26,121,"Michigan","Muskegon County",2,18,2082,1106,976
050,26,121,"Michigan","Muskegon County",2,19,1823,964,859
050,26,121,"Michigan","Muskegon County",2,20,1928,1020,908
050,26,121,"Michigan","Muskegon County",2,21,1943,1011,932
050,26,121,"Michigan","Muskegon County",2,22,2038,1040,998
050,26,121,"Michigan","Muskegon County",2,23,2075,1042,1033
050,26,121,"Michigan","Muskegon County",2,24,2149,1112,1037
050,26,121,"Michigan","Muskegon County",2,25,2260,1165,1095
050,26,121,"Michigan","Muskegon County",2,26,2296,1172,1124
050,26,121,"Michigan","Muskegon County",2,27,2312,1171,1141
050,26,121,"Michigan","Muskegon County",2,28,2384,1243,1141
050,26,121,"Michigan","Muskegon County",2,29,2410,1255,1155
050,26,121,"Michigan","Muskegon County",2,30,2393,1222,1171
050,26,121,"Michigan","Muskegon County",2,31,2300,1180,1120
050,26,121,"Michigan","Muskegon County",2,32,2173,1102,1071
050,26,121,"Michigan","Muskegon County",2,33,2101,1058,1043
050,26,121,"Michigan","Muskegon County",2,34,2175,1121,1054
050,26,121,"Michigan","Muskegon County",2,35,2223,1128,1095
050,26,121,"Michigan","Muskegon County",2,36,2226,1135,1091
050,26,121,"Michigan","Muskegon County",2,37,2221,1110,1111
050,26,121,"Michigan","Muskegon County",2,38,2206,1086,1120
050,26,121,"Michigan","Muskegon County",2,39,2197,1084,1113
050,26,121,"Michigan","Muskegon County",2,40,2222,1107,1115
050,26,121,"Michigan","Muskegon County",2,41,2147,1085,1062
050,26,121,"Michigan","Muskegon County",2,42,2104,1072,1032
050,26,121,"Michigan","Muskegon County",2,43,2059,1065,994
050,26,121,"Michigan","Muskegon County",2,44,1967,1014,953
050,26,121,"Michigan","Muskegon County",2,45,1961,990,971
050,26,121,"Michigan","Muskegon County",2,46,1921,982,939
050,26,121,"Michigan","Muskegon County",2,47,1940,1019,921
050,26,121,"Michigan","Muskegon County",2,48,2037,1064,973
050,26,121,"Michigan","Muskegon County",2,49,2228,1156,1072
050,26,121,"Michigan","Muskegon County",2,50,2169,1095,1074
050,26,121,"Michigan","Muskegon County",2,51,2114,1069,1045
050,26,121,"Michigan","Muskegon County",2,52,2080,1050,1030
050,26,121,"Michigan","Muskegon County",2,53,2158,1087,1071
050,26,121,"Michigan","Muskegon County",2,54,2169,1091,1078
050,26,121,"Michigan","Muskegon County",2,55,2278,1143,1135
050,26,121,"Michigan","Muskegon County",2,56,2406,1195,1211
050,26,121,"Michigan","Muskegon County",2,57,2452,1222,1230
050,26,121,"Michigan","Muskegon County",2,58,2561,1272,1289
050,26,121,"Michigan","Muskegon County",2,59,2564,1241,1323
050,26,121,"Michigan","Muskegon County",2,60,2562,1236,1326
050,26,121,"Michigan","Muskegon County",2,61,2516,1225,1291
050,26,121,"Michigan","Muskegon County",2,62,2542,1253,1289
050,26,121,"Michigan","Muskegon County",2,63,2505,1233,1272
050,26,121,"Michigan","Muskegon County",2,64,2351,1149,1202
050,26,121,"Michigan","Muskegon County",2,65,2298,1130,1168
050,26,121,"Michigan","Muskegon County",2,66,2274,1095,1179
050,26,121,"Michigan","Muskegon County",2,67,2219,1064,1155
050,26,121,"Michigan","Muskegon County",2,68,2090,982,1108
050,26,121,"Michigan","Muskegon County",2,69,1922,913,1009
050,26,121,"Michigan","Muskegon County",2,70,1794,862,932
050,26,121,"Michigan","Muskegon County",2,71,1753,832,921
050,26,121,"Michigan","Muskegon County",2,72,1678,792,886
050,26,121,"Michigan","Muskegon County",2,73,1791,836,955
050,26,121,"Michigan","Muskegon County",2,74,1227,561,666
050,26,121,"Michigan","Muskegon County",2,75,1177,546,631
050,26,121,"Michigan","Muskegon County",2,76,1132,528,604
050,26,121,"Michigan","Muskegon County",2,77,1100,499,601
050,26,121,"Michigan","Muskegon County",2,78,960,436,524
050,26,121,"Michigan","Muskegon County",2,79,839,380,459
050,26,121,"Michigan","Muskegon County",2,80,766,332,434
050,26,121,"Michigan","Muskegon County",2,81,715,299,416
050,26,121,"Michigan","Muskegon County",2,82,697,287,410
050,26,121,"Michigan","Muskegon County",2,83,608,250,358
050,26,121,"Michigan","Muskegon County",2,84,549,219,330
050,26,121,"Michigan","Muskegon County",2,85,3130,1086,2044
050,26,121,"Michigan","Muskegon County",3,0,1824,950,874
050,26,121,"Michigan","Muskegon County",3,1,2070,1063,1007
050,26,121,"Michigan","Muskegon County",3,2,2050,1050,1000
050,26,121,"Michigan","Muskegon County",3,3,2121,1078,1043
050,26,121,"Michigan","Muskegon County",3,4,2148,1096,1052
050,26,121,"Michigan","Muskegon County",3,5,2183,1109,1074
050,26,121,"Michigan","Muskegon County",3,6,2190,1115,1075
050,26,121,"Michigan","Muskegon County",3,7,2201,1130,1071
050,26,121,"Michigan","Muskegon County",3,8,2210,1108,1102
050,26,121,"Michigan","Muskegon County",3,9,2222,1134,1088
050,26,121,"Michigan","Muskegon County",3,10,2261,1136,1125
050,26,121,"Michigan","Muskegon County",3,11,2289,1167,1122
050,26,121,"Michigan","Muskegon County",3,12,2393,1226,1167
050,26,121,"Michigan","Muskegon County",3,13,2386,1235,1151
050,26,121,"Michigan","Muskegon County",3,14,2397,1266,1131
050,26,121,"Michigan","Muskegon County",3,15,2362,1223,1139
050,26,121,"Michigan","Muskegon County",3,16,2316,1185,1131
050,26,121,"Michigan","Muskegon County",3,17,2351,1187,1164
050,26,121,"Michigan","Muskegon County",3,18,2089,1092,997
050,26,121,"Michigan","Muskegon County",3,19,1811,953,858
050,26,121,"Michigan","Muskegon County",3,20,1953,1026,927
050,26,121,"Michigan","Muskegon County",3,21,1987,1024,963
050,26,121,"Michigan","Muskegon County",3,22,2060,1058,1002
050,26,121,"Michigan","Muskegon County",3,23,2120,1091,1029
050,26,121,"Michigan","Muskegon County",3,24,2147,1094,1053
050,26,121,"Michigan","Muskegon County",3,25,2128,1106,1022
050,26,121,"Michigan","Muskegon County",3,26,2304,1180,1124
050,26,121,"Michigan","Muskegon County",3,27,2284,1162,1122
050,26,121,"Michigan","Muskegon County",3,28,2387,1234,1153
050,26,121,"Michigan","Muskegon County",3,29,2399,1251,1148
050,26,121,"Michigan","Muskegon County",3,30,2481,1286,1195
050,26,121,"Michigan","Muskegon County",3,31,2433,1255,1178
050,26,121,"Michigan","Muskegon County",3,32,2302,1168,1134
050,26,121,"Michigan","Muskegon County",3,33,2181,1099,1082
050,26,121,"Michigan","Muskegon County",3,34,2146,1083,1063
050,26,121,"Michigan","Muskegon County",3,35,2181,1122,1059
050,26,121,"Michigan","Muskegon County",3,36,2259,1174,1085
050,26,121,"Michigan","Muskegon County",3,37,2221,1119,1102
050,26,121,"Michigan","Muskegon County",3,38,2234,1133,1101
050,26,121,"Michigan","Muskegon County",3,39,2216,1101,1115
050,26,121,"Michigan","Muskegon County",3,40,2222,1093,1129
050,26,121,"Michigan","Muskegon County",3,41,2194,1094,1100
050,26,121,"Michigan","Muskegon County",3,42,2178,1099,1079
050,26,121,"Michigan","Muskegon County",3,43,2105,1078,1027
050,26,121,"Michigan","Muskegon County",3,44,2064,1084,980
050,26,121,"Michigan","Muskegon County",3,45,1965,1003,962
050,26,121,"Michigan","Muskegon County",3,46,1981,997,984
050,26,121,"Michigan","Muskegon County",3,47,1915,970,945
050,26,121,"Michigan","Muskegon County",3,48,1939,1007,932
050,26,121,"Michigan","Muskegon County",3,49,2049,1073,976
050,26,121,"Michigan","Muskegon County",3,50,2222,1148,1074
050,26,121,"Michigan","Muskegon County",3,51,2168,1095,1073
050,26,121,"Michigan","Muskegon County",3,52,2104,1060,1044
050,26,121,"Michigan","Muskegon County",3,53,2086,1060,1026
050,26,121,"Michigan","Muskegon County",3,54,2149,1079,1070
050,26,121,"Michigan","Muskegon County",3,55,2187,1111,1076
050,26,121,"Michigan","Muskegon County",3,56,2287,1134,1153
050,26,121,"Michigan","Muskegon County",3,57,2390,1177,1213
050,26,121,"Michigan","Muskegon County",3,58,2449,1221,1228
050,26,121,"Michigan","Muskegon County",3,59,2526,1249,1277
050,26,121,"Michigan","Muskegon County",3,60,2578,1237,1341
050,26,121,"Michigan","Muskegon County",3,61,2531,1214,1317
050,26,121,"Michigan","Muskegon County",3,62,2477,1206,1271
050,26,121,"Michigan","Muskegon County",3,63,2519,1246,1273
050,26,121,"Michigan","Muskegon County",3,64,2461,1214,1247
050,26,121,"Michigan","Muskegon County",3,65,2335,1135,1200
050,26,121,"Michigan","Muskegon County",3,66,2244,1085,1159
050,26,121,"Michigan","Muskegon County",3,67,2244,1083,1161
050,26,121,"Michigan","Muskegon County",3,68,2166,1033,1133
050,26,121,"Michigan","Muskegon County",3,69,2038,952,1086
050,26,121,"Michigan","Muskegon County",3,70,1871,887,984
050,26,121,"Michigan","Muskegon County",3,71,1749,830,919
050,26,121,"Michigan","Muskegon County",3,72,1715,809,906
050,26,121,"Michigan","Muskegon County",3,73,1632,764,868
050,26,121,"Michigan","Muskegon County",3,74,1733,807,926
050,26,121,"Michigan","Muskegon County",3,75,1165,529,636
050,26,121,"Michigan","Muskegon County",3,76,1132,521,611
050,26,121,"Michigan","Muskegon County",3,77,1056,490,566
050,26,121,"Michigan","Muskegon County",3,78,1063,478,585
050,26,121,"Michigan","Muskegon County",3,79,890,402,488
050,26,121,"Michigan","Muskegon County",3,80,783,343,440
050,26,121,"Michigan","Muskegon County",3,81,741,318,423
050,26,121,"Michigan","Muskegon County",3,82,677,270,407
050,26,121,"Michigan","Muskegon County",3,83,626,262,364
050,26,121,"Michigan","Muskegon County",3,84,570,229,341
050,26,121,"Michigan","Muskegon County",3,85,3077,1073,2004
050,26,121,"Michigan","Muskegon County",4,0,1849,958,891
050,26,121,"Michigan","Muskegon County",4,1,1859,974,885
050,26,121,"Michigan","Muskegon County",4,2,2079,1060,1019
050,26,121,"Michigan","Muskegon County",4,3,2040,1038,1002
050,26,121,"Michigan","Muskegon County",4,4,2087,1062,1025
050,26,121,"Michigan","Muskegon County",4,5,2156,1100,1056
050,26,121,"Michigan","Muskegon County",4,6,2166,1101,1065
050,26,121,"Michigan","Muskegon County",4,7,2187,1099,1088
050,26,121,"Michigan","Muskegon County",4,8,2167,1107,1060
050,26,121,"Michigan","Muskegon County",4,9,2199,1111,1088
050,26,121,"Michigan","Muskegon County",4,10,2226,1129,1097
050,26,121,"Michigan","Muskegon County",4,11,2258,1140,1118
050,26,121,"Michigan","Muskegon County",4,12,2294,1170,1124
050,26,121,"Michigan","Muskegon County",4,13,2382,1210,1172
050,26,121,"Michigan","Muskegon County",4,14,2355,1218,1137
050,26,121,"Michigan","Muskegon County",4,15,2411,1266,1145
050,26,121,"Michigan","Muskegon County",4,16,2370,1231,1139
050,26,121,"Michigan","Muskegon County",4,17,2302,1170,1132
050,26,121,"Michigan","Muskegon County",4,18,2021,1061,960
050,26,121,"Michigan","Muskegon County",4,19,1742,939,803
050,26,121,"Michigan","Muskegon County",4,20,1890,987,903
050,26,121,"Michigan","Muskegon County",4,21,1948,1001,947
050,26,121,"Michigan","Muskegon County",4,22,2093,1074,1019
050,26,121,"Michigan","Muskegon County",4,23,2138,1106,1032
050,26,121,"Michigan","Muskegon County",4,24,2148,1114,1034
050,26,121,"Michigan","Muskegon County",4,25,2114,1083,1031
050,26,121,"Michigan","Muskegon County",4,26,2169,1147,1022
050,26,121,"Michigan","Muskegon County",4,27,2328,1202,1126
050,26,121,"Michigan","Muskegon County",4,28,2333,1202,1131
050,26,121,"Michigan","Muskegon County",4,29,2443,1253,1190
050,26,121,"Michigan","Muskegon County",4,30,2425,1254,1171
050,26,121,"Michigan","Muskegon County",4,31,2523,1313,1210
050,26,121,"Michigan","Muskegon County",4,32,2481,1298,1183
050,26,121,"Michigan","Muskegon County",4,33,2294,1173,1121
050,26,121,"Michigan","Muskegon County",4,34,2229,1124,1105
050,26,121,"Michigan","Muskegon County",4,35,2177,1088,1089
050,26,121,"Michigan","Muskegon County",4,36,2215,1159,1056
050,26,121,"Michigan","Muskegon County",4,37,2288,1175,1113
050,26,121,"Michigan","Muskegon County",4,38,2266,1134,1132
050,26,121,"Michigan","Muskegon County",4,39,2241,1138,1103
050,26,121,"Michigan","Muskegon County",4,40,2226,1110,1116
050,26,121,"Michigan","Muskegon County",4,41,2211,1085,1126
050,26,121,"Michigan","Muskegon County",4,42,2214,1111,1103
050,26,121,"Michigan","Muskegon County",4,43,2174,1086,1088
050,26,121,"Michigan","Muskegon County",4,44,2110,1073,1037
050,26,121,"Michigan","Muskegon County",4,45,2049,1069,980
050,26,121,"Michigan","Muskegon County",4,46,1986,1020,966
050,26,121,"Michigan","Muskegon County",4,47,1960,973,987
050,26,121,"Michigan","Muskegon County",4,48,1934,958,976
050,26,121,"Michigan","Muskegon County",4,49,1945,1022,923
050,26,121,"Michigan","Muskegon County",4,50,2041,1064,977
050,26,121,"Michigan","Muskegon County",4,51,2216,1134,1082
050,26,121,"Michigan","Muskegon County",4,52,2144,1077,1067
050,26,121,"Michigan","Muskegon County",4,53,2088,1049,1039
050,26,121,"Michigan","Muskegon County",4,54,2077,1049,1028
050,26,121,"Michigan","Muskegon County",4,55,2157,1086,1071
050,26,121,"Michigan","Muskegon County",4,56,2164,1098,1066
050,26,121,"Michigan","Muskegon County",4,57,2270,1126,1144
050,26,121,"Michigan","Muskegon County",4,58,2392,1172,1220
050,26,121,"Michigan","Muskegon County",4,59,2393,1171,1222
050,26,121,"Michigan","Muskegon County",4,60,2515,1246,1269
050,26,121,"Michigan","Muskegon County",4,61,2533,1204,1329
050,26,121,"Michigan","Muskegon County",4,62,2514,1214,1300
050,26,121,"Michigan","Muskegon County",4,63,2474,1193,1281
050,26,121,"Michigan","Muskegon County",4,64,2487,1214,1273
050,26,121,"Michigan","Muskegon County",4,65,2434,1221,1213
050,26,121,"Michigan","Muskegon County",4,66,2279,1109,1170
050,26,121,"Michigan","Muskegon County",4,67,2234,1079,1155
050,26,121,"Michigan","Muskegon County",4,68,2185,1049,1136
050,26,121,"Michigan","Muskegon County",4,69,2111,1001,1110
050,26,121,"Michigan","Muskegon County",4,70,1970,918,1052
050,26,121,"Michigan","Muskegon County",4,71,1832,865,967
050,26,121,"Michigan","Muskegon County",4,72,1703,808,895
050,26,121,"Michigan","Muskegon County",4,73,1668,775,893
050,26,121,"Michigan","Muskegon County",4,74,1575,740,835
050,26,121,"Michigan","Muskegon County",4,75,1663,772,891
050,26,121,"Michigan","Muskegon County",4,76,1110,498,612
050,26,121,"Michigan","Muskegon County",4,77,1076,497,579
050,26,121,"Michigan","Muskegon County",4,78,1031,473,558
050,26,121,"Michigan","Muskegon County",4,79,1006,459,547
050,26,121,"Michigan","Muskegon County",4,80,837,361,476
050,26,121,"Michigan","Muskegon County",4,81,735,321,414
050,26,121,"Michigan","Muskegon County",4,82,719,299,420
050,26,121,"Michigan","Muskegon County",4,83,614,242,372
050,26,121,"Michigan","Muskegon County",4,84,566,229,337
050,26,121,"Michigan","Muskegon County",4,85,3024,1066,1958
050,26,121,"Michigan","Muskegon County",5,0,1855,960,895
050,26,121,"Michigan","Muskegon County",5,1,1886,970,916
050,26,121,"Michigan","Muskegon County",5,2,1863,979,884
050,26,121,"Michigan","Muskegon County",5,3,2112,1072,1040
050,26,121,"Michigan","Muskegon County",5,4,2091,1066,1025
050,26,121,"Michigan","Muskegon County",5,5,2117,1082,1035
050,26,121,"Michigan","Muskegon County",5,6,2183,1130,1053
050,26,121,"Michigan","Muskegon County",5,7,2199,1127,1072
050,26,121,"Michigan","Muskegon County",5,8,2248,1138,1110
050,26,121,"Michigan","Muskegon County",5,9,2205,1123,1082
050,26,121,"Michigan","Muskegon County",5,10,2215,1113,1102
050,26,121,"Michigan","Muskegon County",5,11,2241,1152,1089
050,26,121,"Michigan","Muskegon County",5,12,2273,1141,1132
050,26,121,"Michigan","Muskegon County",5,13,2288,1157,1131
050,26,121,"Michigan","Muskegon County",5,14,2377,1214,1163
050,26,121,"Michigan","Muskegon County",5,15,2377,1240,1137
050,26,121,"Michigan","Muskegon County",5,16,2394,1245,1149
050,26,121,"Michigan","Muskegon County",5,17,2370,1240,1130
050,26,121,"Michigan","Muskegon County",5,18,2010,1058,952
050,26,121,"Michigan","Muskegon County",5,19,1730,923,807
050,26,121,"Michigan","Muskegon County",5,20,1833,977,856
050,26,121,"Michigan","Muskegon County",5,21,1948,1000,948
050,26,121,"Michigan","Muskegon County",5,22,2101,1090,1011
050,26,121,"Michigan","Muskegon County",5,23,2153,1097,1056
050,26,121,"Michigan","Muskegon County",5,24,2184,1149,1035
050,26,121,"Michigan","Muskegon County",5,25,2142,1089,1053
050,26,121,"Michigan","Muskegon County",5,26,2222,1134,1088
050,26,121,"Michigan","Muskegon County",5,27,2218,1184,1034
050,26,121,"Michigan","Muskegon County",5,28,2370,1229,1141
050,26,121,"Michigan","Muskegon County",5,29,2383,1223,1160
050,26,121,"Michigan","Muskegon County",5,30,2473,1254,1219
050,26,121,"Michigan","Muskegon County",5,31,2462,1292,1170
050,26,121,"Michigan","Muskegon County",5,32,2554,1319,1235
050,26,121,"Michigan","Muskegon County",5,33,2505,1302,1203
050,26,121,"Michigan","Muskegon County",5,34,2310,1198,1112
050,26,121,"Michigan","Muskegon County",5,35,2225,1116,1109
050,26,121,"Michigan","Muskegon County",5,36,2211,1114,1097
050,26,121,"Michigan","Muskegon County",5,37,2226,1155,1071
050,26,121,"Michigan","Muskegon County",5,38,2297,1181,1116
050,26,121,"Michigan","Muskegon County",5,39,2281,1146,1135
050,26,121,"Michigan","Muskegon County",5,40,2252,1147,1105
050,26,121,"Michigan","Muskegon County",5,41,2241,1111,1130
050,26,121,"Michigan","Muskegon County",5,42,2231,1100,1131
050,26,121,"Michigan","Muskegon County",5,43,2223,1102,1121
050,26,121,"Michigan","Muskegon County",5,44,2189,1099,1090
050,26,121,"Michigan","Muskegon County",5,45,2103,1078,1025
050,26,121,"Michigan","Muskegon County",5,46,2077,1094,983
050,26,121,"Michigan","Muskegon County",5,47,1996,1017,979
050,26,121,"Michigan","Muskegon County",5,48,1973,965,1008
050,26,121,"Michigan","Muskegon County",5,49,1926,954,972
050,26,121,"Michigan","Muskegon County",5,50,1955,1016,939
050,26,121,"Michigan","Muskegon County",5,51,2037,1060,977
050,26,121,"Michigan","Muskegon County",5,52,2211,1129,1082
050,26,121,"Michigan","Muskegon County",5,53,2120,1051,1069
050,26,121,"Michigan","Muskegon County",5,54,2085,1043,1042
050,26,121,"Michigan","Muskegon County",5,55,2087,1051,1036
050,26,121,"Michigan","Muskegon County",5,56,2125,1066,1059
050,26,121,"Michigan","Muskegon County",5,57,2152,1085,1067
050,26,121,"Michigan","Muskegon County",5,58,2289,1138,1151
050,26,121,"Michigan","Muskegon County",5,59,2354,1139,1215
050,26,121,"Michigan","Muskegon County",5,60,2383,1169,1214
050,26,121,"Michigan","Muskegon County",5,61,2488,1219,1269
050,26,121,"Michigan","Muskegon County",5,62,2522,1197,1325
050,26,121,"Michigan","Muskegon County",5,63,2509,1203,1306
050,26,121,"Michigan","Muskegon County",5,64,2467,1189,1278
050,26,121,"Michigan","Muskegon County",5,65,2455,1200,1255
050,26,121,"Michigan","Muskegon County",5,66,2383,1189,1194
050,26,121,"Michigan","Muskegon County",5,67,2266,1109,1157
050,26,121,"Michigan","Muskegon County",5,68,2197,1051,1146
050,26,121,"Michigan","Muskegon County",5,69,2134,1015,1119
050,26,121,"Michigan","Muskegon County",5,70,2057,972,1085
050,26,121,"Michigan","Muskegon County",5,71,1933,905,1028
050,26,121,"Michigan","Muskegon County",5,72,1787,845,942
050,26,121,"Michigan","Muskegon County",5,73,1674,782,892
050,26,121,"Michigan","Muskegon County",5,74,1628,755,873
050,26,121,"Michigan","Muskegon County",5,75,1523,710,813
050,26,121,"Michigan","Muskegon County",5,76,1608,736,872
050,26,121,"Michigan","Muskegon County",5,77,1059,473,586
050,26,121,"Michigan","Muskegon County",5,78,1058,484,574
050,26,121,"Michigan","Muskegon County",5,79,987,458,529
050,26,121,"Michigan","Muskegon County",5,80,952,421,531
050,26,121,"Michigan","Muskegon County",5,81,794,342,452
050,26,121,"Michigan","Muskegon County",5,82,708,300,408
050,26,121,"Michigan","Muskegon County",5,83,657,272,385
050,26,121,"Michigan","Muskegon County",5,84,553,207,346
050,26,121,"Michigan","Muskegon County",5,85,3024,1074,1950
050,26,123,"Michigan","Newaygo County",1,0,501,256,245
050,26,123,"Michigan","Newaygo County",1,1,534,279,255
050,26,123,"Michigan","Newaygo County",1,2,580,282,298
050,26,123,"Michigan","Newaygo County",1,3,600,276,324
050,26,123,"Michigan","Newaygo County",1,4,597,285,312
050,26,123,"Michigan","Newaygo County",1,5,598,291,307
050,26,123,"Michigan","Newaygo County",1,6,629,315,314
050,26,123,"Michigan","Newaygo County",1,7,601,329,272
050,26,123,"Michigan","Newaygo County",1,8,589,305,284
050,26,123,"Michigan","Newaygo County",1,9,597,316,281
050,26,123,"Michigan","Newaygo County",1,10,607,316,291
050,26,123,"Michigan","Newaygo County",1,11,637,348,289
050,26,123,"Michigan","Newaygo County",1,12,698,372,326
050,26,123,"Michigan","Newaygo County",1,13,675,328,347
050,26,123,"Michigan","Newaygo County",1,14,715,340,375
050,26,123,"Michigan","Newaygo County",1,15,708,359,349
050,26,123,"Michigan","Newaygo County",1,16,684,346,338
050,26,123,"Michigan","Newaygo County",1,17,686,362,324
050,26,123,"Michigan","Newaygo County",1,18,577,312,265
050,26,123,"Michigan","Newaygo County",1,19,462,240,222
050,26,123,"Michigan","Newaygo County",1,20,458,247,211
050,26,123,"Michigan","Newaygo County",1,21,514,267,247
050,26,123,"Michigan","Newaygo County",1,22,531,275,256
050,26,123,"Michigan","Newaygo County",1,23,537,294,243
050,26,123,"Michigan","Newaygo County",1,24,538,297,241
050,26,123,"Michigan","Newaygo County",1,25,524,272,252
050,26,123,"Michigan","Newaygo County",1,26,539,283,256
050,26,123,"Michigan","Newaygo County",1,27,544,285,259
050,26,123,"Michigan","Newaygo County",1,28,570,304,266
050,26,123,"Michigan","Newaygo County",1,29,646,333,313
050,26,123,"Michigan","Newaygo County",1,30,651,334,317
050,26,123,"Michigan","Newaygo County",1,31,584,302,282
050,26,123,"Michigan","Newaygo County",1,32,576,298,278
050,26,123,"Michigan","Newaygo County",1,33,551,271,280
050,26,123,"Michigan","Newaygo County",1,34,570,270,300
050,26,123,"Michigan","Newaygo County",1,35,574,300,274
050,26,123,"Michigan","Newaygo County",1,36,529,280,249
050,26,123,"Michigan","Newaygo County",1,37,563,281,282
050,26,123,"Michigan","Newaygo County",1,38,549,264,285
050,26,123,"Michigan","Newaygo County",1,39,576,286,290
050,26,123,"Michigan","Newaygo County",1,40,557,282,275
050,26,123,"Michigan","Newaygo County",1,41,543,277,266
050,26,123,"Michigan","Newaygo County",1,42,562,298,264
050,26,123,"Michigan","Newaygo County",1,43,543,283,260
050,26,123,"Michigan","Newaygo County",1,44,532,265,267
050,26,123,"Michigan","Newaygo County",1,45,540,280,260
050,26,123,"Michigan","Newaygo County",1,46,517,271,246
050,26,123,"Michigan","Newaygo County",1,47,502,271,231
050,26,123,"Michigan","Newaygo County",1,48,569,298,271
050,26,123,"Michigan","Newaygo County",1,49,652,341,311
050,26,123,"Michigan","Newaygo County",1,50,623,305,318
050,26,123,"Michigan","Newaygo County",1,51,625,303,322
050,26,123,"Michigan","Newaygo County",1,52,656,318,338
050,26,123,"Michigan","Newaygo County",1,53,670,330,340
050,26,123,"Michigan","Newaygo County",1,54,647,337,310
050,26,123,"Michigan","Newaygo County",1,55,738,367,371
050,26,123,"Michigan","Newaygo County",1,56,808,404,404
050,26,123,"Michigan","Newaygo County",1,57,835,426,409
050,26,123,"Michigan","Newaygo County",1,58,871,460,411
050,26,123,"Michigan","Newaygo County",1,59,847,443,404
050,26,123,"Michigan","Newaygo County",1,60,803,412,391
050,26,123,"Michigan","Newaygo County",1,61,813,407,406
050,26,123,"Michigan","Newaygo County",1,62,791,406,385
050,26,123,"Michigan","Newaygo County",1,63,739,379,360
050,26,123,"Michigan","Newaygo County",1,64,759,385,374
050,26,123,"Michigan","Newaygo County",1,65,741,369,372
050,26,123,"Michigan","Newaygo County",1,66,760,398,362
050,26,123,"Michigan","Newaygo County",1,67,668,329,339
050,26,123,"Michigan","Newaygo County",1,68,668,344,324
050,26,123,"Michigan","Newaygo County",1,69,599,311,288
050,26,123,"Michigan","Newaygo County",1,70,570,290,280
050,26,123,"Michigan","Newaygo County",1,71,579,304,275
050,26,123,"Michigan","Newaygo County",1,72,558,289,269
050,26,123,"Michigan","Newaygo County",1,73,530,266,264
050,26,123,"Michigan","Newaygo County",1,74,367,183,184
050,26,123,"Michigan","Newaygo County",1,75,370,194,176
050,26,123,"Michigan","Newaygo County",1,76,382,185,197
050,26,123,"Michigan","Newaygo County",1,77,379,185,194
050,26,123,"Michigan","Newaygo County",1,78,334,158,176
050,26,123,"Michigan","Newaygo County",1,79,284,133,151
050,26,123,"Michigan","Newaygo County",1,80,262,127,135
050,26,123,"Michigan","Newaygo County",1,81,260,120,140
050,26,123,"Michigan","Newaygo County",1,82,227,109,118
050,26,123,"Michigan","Newaygo County",1,83,191,85,106
050,26,123,"Michigan","Newaygo County",1,84,184,94,90
050,26,123,"Michigan","Newaygo County",1,85,928,340,588
050,26,123,"Michigan","Newaygo County",2,0,515,266,249
050,26,123,"Michigan","Newaygo County",2,1,528,273,255
050,26,123,"Michigan","Newaygo County",2,2,574,284,290
050,26,123,"Michigan","Newaygo County",2,3,597,278,319
050,26,123,"Michigan","Newaygo County",2,4,602,284,318
050,26,123,"Michigan","Newaygo County",2,5,603,291,312
050,26,123,"Michigan","Newaygo County",2,6,623,313,310
050,26,123,"Michigan","Newaygo County",2,7,608,327,281
050,26,123,"Michigan","Newaygo County",2,8,592,311,281
050,26,123,"Michigan","Newaygo County",2,9,595,314,281
050,26,123,"Michigan","Newaygo County",2,10,607,319,288
050,26,123,"Michigan","Newaygo County",2,11,631,341,290
050,26,123,"Michigan","Newaygo County",2,12,688,370,318
050,26,123,"Michigan","Newaygo County",2,13,684,339,345
050,26,123,"Michigan","Newaygo County",2,14,705,336,369
050,26,123,"Michigan","Newaygo County",2,15,710,353,357
050,26,123,"Michigan","Newaygo County",2,16,692,350,342
050,26,123,"Michigan","Newaygo County",2,17,687,360,327
050,26,123,"Michigan","Newaygo County",2,18,573,311,262
050,26,123,"Michigan","Newaygo County",2,19,462,242,220
050,26,123,"Michigan","Newaygo County",2,20,469,250,219
050,26,123,"Michigan","Newaygo County",2,21,512,265,247
050,26,123,"Michigan","Newaygo County",2,22,534,278,256
050,26,123,"Michigan","Newaygo County",2,23,545,293,252
050,26,123,"Michigan","Newaygo County",2,24,543,298,245
050,26,123,"Michigan","Newaygo County",2,25,532,282,250
050,26,123,"Michigan","Newaygo County",2,26,534,279,255
050,26,123,"Michigan","Newaygo County",2,27,541,285,256
050,26,123,"Michigan","Newaygo County",2,28,567,301,266
050,26,123,"Michigan","Newaygo County",2,29,631,329,302
050,26,123,"Michigan","Newaygo County",2,30,655,337,318
050,26,123,"Michigan","Newaygo County",2,31,605,314,291
050,26,123,"Michigan","Newaygo County",2,32,580,298,282
050,26,123,"Michigan","Newaygo County",2,33,560,279,281
050,26,123,"Michigan","Newaygo County",2,34,569,273,296
050,26,123,"Michigan","Newaygo County",2,35,577,295,282
050,26,123,"Michigan","Newaygo County",2,36,538,285,253
050,26,123,"Michigan","Newaygo County",2,37,556,279,277
050,26,123,"Michigan","Newaygo County",2,38,555,269,286
050,26,123,"Michigan","Newaygo County",2,39,566,279,287
050,26,123,"Michigan","Newaygo County",2,40,567,285,282
050,26,123,"Michigan","Newaygo County",2,41,549,281,268
050,26,123,"Michigan","Newaygo County",2,42,557,292,265
050,26,123,"Michigan","Newaygo County",2,43,555,291,264
050,26,123,"Michigan","Newaygo County",2,44,534,272,262
050,26,123,"Michigan","Newaygo County",2,45,543,279,264
050,26,123,"Michigan","Newaygo County",2,46,521,272,249
050,26,123,"Michigan","Newaygo County",2,47,506,272,234
050,26,123,"Michigan","Newaygo County",2,48,553,293,260
050,26,123,"Michigan","Newaygo County",2,49,634,333,301
050,26,123,"Michigan","Newaygo County",2,50,630,311,319
050,26,123,"Michigan","Newaygo County",2,51,623,304,319
050,26,123,"Michigan","Newaygo County",2,52,648,313,335
050,26,123,"Michigan","Newaygo County",2,53,663,326,337
050,26,123,"Michigan","Newaygo County",2,54,652,334,318
050,26,123,"Michigan","Newaygo County",2,55,717,359,358
050,26,123,"Michigan","Newaygo County",2,56,793,396,397
050,26,123,"Michigan","Newaygo County",2,57,832,424,408
050,26,123,"Michigan","Newaygo County",2,58,868,454,414
050,26,123,"Michigan","Newaygo County",2,59,860,453,407
050,26,123,"Michigan","Newaygo County",2,60,815,421,394
050,26,123,"Michigan","Newaygo County",2,61,813,409,404
050,26,123,"Michigan","Newaygo County",2,62,795,406,389
050,26,123,"Michigan","Newaygo County",2,63,767,393,374
050,26,123,"Michigan","Newaygo County",2,64,745,380,365
050,26,123,"Michigan","Newaygo County",2,65,744,371,373
050,26,123,"Michigan","Newaygo County",2,66,756,391,365
050,26,123,"Michigan","Newaygo County",2,67,684,340,344
050,26,123,"Michigan","Newaygo County",2,68,664,339,325
050,26,123,"Michigan","Newaygo County",2,69,622,321,301
050,26,123,"Michigan","Newaygo County",2,70,573,295,278
050,26,123,"Michigan","Newaygo County",2,71,576,301,275
050,26,123,"Michigan","Newaygo County",2,72,550,284,266
050,26,123,"Michigan","Newaygo County",2,73,565,285,280
050,26,123,"Michigan","Newaygo County",2,74,376,187,189
050,26,123,"Michigan","Newaygo County",2,75,370,192,178
050,26,123,"Michigan","Newaygo County",2,76,373,183,190
050,26,123,"Michigan","Newaygo County",2,77,384,185,199
050,26,123,"Michigan","Newaygo County",2,78,336,160,176
050,26,123,"Michigan","Newaygo County",2,79,288,134,154
050,26,123,"Michigan","Newaygo County",2,80,265,127,138
050,26,123,"Michigan","Newaygo County",2,81,256,121,135
050,26,123,"Michigan","Newaygo County",2,82,237,111,126
050,26,123,"Michigan","Newaygo County",2,83,192,87,105
050,26,123,"Michigan","Newaygo County",2,84,180,90,90
050,26,123,"Michigan","Newaygo County",2,85,935,346,589
050,26,123,"Michigan","Newaygo County",3,0,490,239,251
050,26,123,"Michigan","Newaygo County",3,1,498,249,249
050,26,123,"Michigan","Newaygo County",3,2,528,268,260
050,26,123,"Michigan","Newaygo County",3,3,580,291,289
050,26,123,"Michigan","Newaygo County",3,4,608,290,318
050,26,123,"Michigan","Newaygo County",3,5,596,280,316
050,26,123,"Michigan","Newaygo County",3,6,605,287,318
050,26,123,"Michigan","Newaygo County",3,7,624,311,313
050,26,123,"Michigan","Newaygo County",3,8,604,318,286
050,26,123,"Michigan","Newaygo County",3,9,601,310,291
050,26,123,"Michigan","Newaygo County",3,10,612,317,295
050,26,123,"Michigan","Newaygo County",3,11,628,328,300
050,26,123,"Michigan","Newaygo County",3,12,647,349,298
050,26,123,"Michigan","Newaygo County",3,13,687,374,313
050,26,123,"Michigan","Newaygo County",3,14,676,336,340
050,26,123,"Michigan","Newaygo County",3,15,715,347,368
050,26,123,"Michigan","Newaygo County",3,16,708,354,354
050,26,123,"Michigan","Newaygo County",3,17,702,350,352
050,26,123,"Michigan","Newaygo County",3,18,578,319,259
050,26,123,"Michigan","Newaygo County",3,19,469,252,217
050,26,123,"Michigan","Newaygo County",3,20,487,258,229
050,26,123,"Michigan","Newaygo County",3,21,508,270,238
050,26,123,"Michigan","Newaygo County",3,22,527,270,257
050,26,123,"Michigan","Newaygo County",3,23,548,279,269
050,26,123,"Michigan","Newaygo County",3,24,554,305,249
050,26,123,"Michigan","Newaygo County",3,25,530,302,228
050,26,123,"Michigan","Newaygo County",3,26,551,294,257
050,26,123,"Michigan","Newaygo County",3,27,555,288,267
050,26,123,"Michigan","Newaygo County",3,28,587,312,275
050,26,123,"Michigan","Newaygo County",3,29,577,312,265
050,26,123,"Michigan","Newaygo County",3,30,659,332,327
050,26,123,"Michigan","Newaygo County",3,31,680,350,330
050,26,123,"Michigan","Newaygo County",3,32,598,314,284
050,26,123,"Michigan","Newaygo County",3,33,583,302,281
050,26,123,"Michigan","Newaygo County",3,34,586,291,295
050,26,123,"Michigan","Newaygo County",3,35,571,278,293
050,26,123,"Michigan","Newaygo County",3,36,582,301,281
050,26,123,"Michigan","Newaygo County",3,37,541,293,248
050,26,123,"Michigan","Newaygo County",3,38,544,269,275
050,26,123,"Michigan","Newaygo County",3,39,587,293,294
050,26,123,"Michigan","Newaygo County",3,40,568,281,287
050,26,123,"Michigan","Newaygo County",3,41,586,293,293
050,26,123,"Michigan","Newaygo County",3,42,552,281,271
050,26,123,"Michigan","Newaygo County",3,43,574,304,270
050,26,123,"Michigan","Newaygo County",3,44,569,302,267
050,26,123,"Michigan","Newaygo County",3,45,523,271,252
050,26,123,"Michigan","Newaygo County",3,46,550,280,270
050,26,123,"Michigan","Newaygo County",3,47,533,280,253
050,26,123,"Michigan","Newaygo County",3,48,515,280,235
050,26,123,"Michigan","Newaygo County",3,49,556,292,264
050,26,123,"Michigan","Newaygo County",3,50,645,338,307
050,26,123,"Michigan","Newaygo County",3,51,631,310,321
050,26,123,"Michigan","Newaygo County",3,52,633,311,322
050,26,123,"Michigan","Newaygo County",3,53,651,314,337
050,26,123,"Michigan","Newaygo County",3,54,661,330,331
050,26,123,"Michigan","Newaygo County",3,55,664,332,332
050,26,123,"Michigan","Newaygo County",3,56,723,368,355
050,26,123,"Michigan","Newaygo County",3,57,795,397,398
050,26,123,"Michigan","Newaygo County",3,58,833,417,416
050,26,123,"Michigan","Newaygo County",3,59,873,455,418
050,26,123,"Michigan","Newaygo County",3,60,860,455,405
050,26,123,"Michigan","Newaygo County",3,61,816,424,392
050,26,123,"Michigan","Newaygo County",3,62,812,405,407
050,26,123,"Michigan","Newaygo County",3,63,807,415,392
050,26,123,"Michigan","Newaygo County",3,64,758,385,373
050,26,123,"Michigan","Newaygo County",3,65,743,377,366
050,26,123,"Michigan","Newaygo County",3,66,743,373,370
050,26,123,"Michigan","Newaygo County",3,67,760,393,367
050,26,123,"Michigan","Newaygo County",3,68,667,335,332
050,26,123,"Michigan","Newaygo County",3,69,648,331,317
050,26,123,"Michigan","Newaygo County",3,70,613,316,297
050,26,123,"Michigan","Newaygo County",3,71,557,285,272
050,26,123,"Michigan","Newaygo County",3,72,547,285,262
050,26,123,"Michigan","Newaygo County",3,73,533,270,263
050,26,123,"Michigan","Newaygo County",3,74,553,276,277
050,26,123,"Michigan","Newaygo County",3,75,357,176,181
050,26,123,"Michigan","Newaygo County",3,76,354,181,173
050,26,123,"Michigan","Newaygo County",3,77,349,175,174
050,26,123,"Michigan","Newaygo County",3,78,377,178,199
050,26,123,"Michigan","Newaygo County",3,79,321,149,172
050,26,123,"Michigan","Newaygo County",3,80,270,124,146
050,26,123,"Michigan","Newaygo County",3,81,255,123,132
050,26,123,"Michigan","Newaygo County",3,82,227,104,123
050,26,123,"Michigan","Newaygo County",3,83,212,100,112
050,26,123,"Michigan","Newaygo County",3,84,173,80,93
050,26,123,"Michigan","Newaygo County",3,85,955,359,596
050,26,123,"Michigan","Newaygo County",4,0,493,244,249
050,26,123,"Michigan","Newaygo County",4,1,503,249,254
050,26,123,"Michigan","Newaygo County",4,2,522,260,262
050,26,123,"Michigan","Newaygo County",4,3,567,288,279
050,26,123,"Michigan","Newaygo County",4,4,587,288,299
050,26,123,"Michigan","Newaygo County",4,5,615,301,314
050,26,123,"Michigan","Newaygo County",4,6,617,288,329
050,26,123,"Michigan","Newaygo County",4,7,616,287,329
050,26,123,"Michigan","Newaygo County",4,8,646,328,318
050,26,123,"Michigan","Newaygo County",4,9,640,338,302
050,26,123,"Michigan","Newaygo County",4,10,620,321,299
050,26,123,"Michigan","Newaygo County",4,11,618,327,291
050,26,123,"Michigan","Newaygo County",4,12,630,328,302
050,26,123,"Michigan","Newaygo County",4,13,644,349,295
050,26,123,"Michigan","Newaygo County",4,14,695,384,311
050,26,123,"Michigan","Newaygo County",4,15,686,343,343
050,26,123,"Michigan","Newaygo County",4,16,715,350,365
050,26,123,"Michigan","Newaygo County",4,17,715,363,352
050,26,123,"Michigan","Newaygo County",4,18,602,317,285
050,26,123,"Michigan","Newaygo County",4,19,466,262,204
050,26,123,"Michigan","Newaygo County",4,20,484,271,213
050,26,123,"Michigan","Newaygo County",4,21,521,270,251
050,26,123,"Michigan","Newaygo County",4,22,498,268,230
050,26,123,"Michigan","Newaygo County",4,23,560,274,286
050,26,123,"Michigan","Newaygo County",4,24,555,283,272
050,26,123,"Michigan","Newaygo County",4,25,580,329,251
050,26,123,"Michigan","Newaygo County",4,26,559,312,247
050,26,123,"Michigan","Newaygo County",4,27,548,283,265
050,26,123,"Michigan","Newaygo County",4,28,544,282,262
050,26,123,"Michigan","Newaygo County",4,29,595,325,270
050,26,123,"Michigan","Newaygo County",4,30,616,320,296
050,26,123,"Michigan","Newaygo County",4,31,627,305,322
050,26,123,"Michigan","Newaygo County",4,32,673,339,334
050,26,123,"Michigan","Newaygo County",4,33,597,309,288
050,26,123,"Michigan","Newaygo County",4,34,610,321,289
050,26,123,"Michigan","Newaygo County",4,35,599,295,304
050,26,123,"Michigan","Newaygo County",4,36,575,278,297
050,26,123,"Michigan","Newaygo County",4,37,617,315,302
050,26,123,"Michigan","Newaygo County",4,38,544,292,252
050,26,123,"Michigan","Newaygo County",4,39,551,273,278
050,26,123,"Michigan","Newaygo County",4,40,600,296,304
050,26,123,"Michigan","Newaygo County",4,41,587,289,298
050,26,123,"Michigan","Newaygo County",4,42,585,290,295
050,26,123,"Michigan","Newaygo County",4,43,547,283,264
050,26,123,"Michigan","Newaygo County",4,44,577,299,278
050,26,123,"Michigan","Newaygo County",4,45,580,299,281
050,26,123,"Michigan","Newaygo County",4,46,512,264,248
050,26,123,"Michigan","Newaygo County",4,47,562,281,281
050,26,123,"Michigan","Newaygo County",4,48,535,279,256
050,26,123,"Michigan","Newaygo County",4,49,514,280,234
050,26,123,"Michigan","Newaygo County",4,50,567,297,270
050,26,123,"Michigan","Newaygo County",4,51,664,355,309
050,26,123,"Michigan","Newaygo County",4,52,642,315,327
050,26,123,"Michigan","Newaygo County",4,53,642,320,322
050,26,123,"Michigan","Newaygo County",4,54,641,309,332
050,26,123,"Michigan","Newaygo County",4,55,677,332,345
050,26,123,"Michigan","Newaygo County",4,56,676,343,333
050,26,123,"Michigan","Newaygo County",4,57,726,371,355
050,26,123,"Michigan","Newaygo County",4,58,805,395,410
050,26,123,"Michigan","Newaygo County",4,59,833,421,412
050,26,123,"Michigan","Newaygo County",4,60,866,457,409
050,26,123,"Michigan","Newaygo County",4,61,860,462,398
050,26,123,"Michigan","Newaygo County",4,62,819,428,391
050,26,123,"Michigan","Newaygo County",4,63,840,419,421
050,26,123,"Michigan","Newaygo County",4,64,789,408,381
050,26,123,"Michigan","Newaygo County",4,65,749,382,367
050,26,123,"Michigan","Newaygo County",4,66,747,378,369
050,26,123,"Michigan","Newaygo County",4,67,732,364,368
050,26,123,"Michigan","Newaygo County",4,68,730,380,350
050,26,123,"Michigan","Newaygo County",4,69,649,318,331
050,26,123,"Michigan","Newaygo County",4,70,630,327,303
050,26,123,"Michigan","Newaygo County",4,71,609,313,296
050,26,123,"Michigan","Newaygo County",4,72,536,273,263
050,26,123,"Michigan","Newaygo County",4,73,525,267,258
050,26,123,"Michigan","Newaygo County",4,74,520,263,257
050,26,123,"Michigan","Newaygo County",4,75,525,260,265
050,26,123,"Michigan","Newaygo County",4,76,340,168,172
050,26,123,"Michigan","Newaygo County",4,77,329,162,167
050,26,123,"Michigan","Newaygo County",4,78,343,170,173
050,26,123,"Michigan","Newaygo County",4,79,344,158,186
050,26,123,"Michigan","Newaygo County",4,80,298,129,169
050,26,123,"Michigan","Newaygo County",4,81,251,110,141
050,26,123,"Michigan","Newaygo County",4,82,231,109,122
050,26,123,"Michigan","Newaygo County",4,83,207,94,113
050,26,123,"Michigan","Newaygo County",4,84,196,98,98
050,26,123,"Michigan","Newaygo County",4,85,941,351,590
050,26,123,"Michigan","Newaygo County",5,0,490,244,246
050,26,123,"Michigan","Newaygo County",5,1,494,262,232
050,26,123,"Michigan","Newaygo County",5,2,499,250,249
050,26,123,"Michigan","Newaygo County",5,3,533,267,266
050,26,123,"Michigan","Newaygo County",5,4,581,300,281
050,26,123,"Michigan","Newaygo County",5,5,605,302,303
050,26,123,"Michigan","Newaygo County",5,6,616,304,312
050,26,123,"Michigan","Newaygo County",5,7,618,285,333
050,26,123,"Michigan","Newaygo County",5,8,639,301,338
050,26,123,"Michigan","Newaygo County",5,9,633,320,313
050,26,123,"Michigan","Newaygo County",5,10,639,334,305
050,26,123,"Michigan","Newaygo County",5,11,631,330,301
050,26,123,"Michigan","Newaygo County",5,12,629,335,294
050,26,123,"Michigan","Newaygo County",5,13,642,343,299
050,26,123,"Michigan","Newaygo County",5,14,653,355,298
050,26,123,"Michigan","Newaygo County",5,15,689,385,304
050,26,123,"Michigan","Newaygo County",5,16,691,344,347
050,26,123,"Michigan","Newaygo County",5,17,741,363,378
050,26,123,"Michigan","Newaygo County",5,18,594,308,286
050,26,123,"Michigan","Newaygo County",5,19,493,268,225
050,26,123,"Michigan","Newaygo County",5,20,488,279,209
050,26,123,"Michigan","Newaygo County",5,21,517,275,242
050,26,123,"Michigan","Newaygo County",5,22,502,266,236
050,26,123,"Michigan","Newaygo County",5,23,525,276,249
050,26,123,"Michigan","Newaygo County",5,24,557,275,282
050,26,123,"Michigan","Newaygo County",5,25,563,290,273
050,26,123,"Michigan","Newaygo County",5,26,609,336,273
050,26,123,"Michigan","Newaygo County",5,27,574,308,266
050,26,123,"Michigan","Newaygo County",5,28,552,286,266
050,26,123,"Michigan","Newaygo County",5,29,546,287,259
050,26,123,"Michigan","Newaygo County",5,30,623,332,291
050,26,123,"Michigan","Newaygo County",5,31,620,314,306
050,26,123,"Michigan","Newaygo County",5,32,646,305,341
050,26,123,"Michigan","Newaygo County",5,33,674,342,332
050,26,123,"Michigan","Newaygo County",5,34,621,330,291
050,26,123,"Michigan","Newaygo County",5,35,609,319,290
050,26,123,"Michigan","Newaygo County",5,36,607,311,296
050,26,123,"Michigan","Newaygo County",5,37,589,280,309
050,26,123,"Michigan","Newaygo County",5,38,623,320,303
050,26,123,"Michigan","Newaygo County",5,39,548,292,256
050,26,123,"Michigan","Newaygo County",5,40,557,274,283
050,26,123,"Michigan","Newaygo County",5,41,615,306,309
050,26,123,"Michigan","Newaygo County",5,42,601,293,308
050,26,123,"Michigan","Newaygo County",5,43,578,287,291
050,26,123,"Michigan","Newaygo County",5,44,543,291,252
050,26,123,"Michigan","Newaygo County",5,45,565,286,279
050,26,123,"Michigan","Newaygo County",5,46,598,316,282
050,26,123,"Michigan","Newaygo County",5,47,521,272,249
050,26,123,"Michigan","Newaygo County",5,48,565,274,291
050,26,123,"Michigan","Newaygo County",5,49,550,281,269
050,26,123,"Michigan","Newaygo County",5,50,530,291,239
050,26,123,"Michigan","Newaygo County",5,51,577,306,271
050,26,123,"Michigan","Newaygo County",5,52,666,355,311
050,26,123,"Michigan","Newaygo County",5,53,648,316,332
050,26,123,"Michigan","Newaygo County",5,54,655,331,324
050,26,123,"Michigan","Newaygo County",5,55,658,316,342
050,26,123,"Michigan","Newaygo County",5,56,682,338,344
050,26,123,"Michigan","Newaygo County",5,57,686,346,340
050,26,123,"Michigan","Newaygo County",5,58,727,371,356
050,26,123,"Michigan","Newaygo County",5,59,823,405,418
050,26,123,"Michigan","Newaygo County",5,60,848,427,421
050,26,123,"Michigan","Newaygo County",5,61,872,454,418
050,26,123,"Michigan","Newaygo County",5,62,876,479,397
050,26,123,"Michigan","Newaygo County",5,63,849,434,415
050,26,123,"Michigan","Newaygo County",5,64,827,406,421
050,26,123,"Michigan","Newaygo County",5,65,786,410,376
050,26,123,"Michigan","Newaygo County",5,66,747,381,366
050,26,123,"Michigan","Newaygo County",5,67,748,367,381
050,26,123,"Michigan","Newaygo County",5,68,718,362,356
050,26,123,"Michigan","Newaygo County",5,69,731,375,356
050,26,123,"Michigan","Newaygo County",5,70,635,314,321
050,26,123,"Michigan","Newaygo County",5,71,625,326,299
050,26,123,"Michigan","Newaygo County",5,72,601,308,293
050,26,123,"Michigan","Newaygo County",5,73,522,262,260
050,26,123,"Michigan","Newaygo County",5,74,511,260,251
050,26,123,"Michigan","Newaygo County",5,75,506,252,254
050,26,123,"Michigan","Newaygo County",5,76,504,251,253
050,26,123,"Michigan","Newaygo County",5,77,319,158,161
050,26,123,"Michigan","Newaygo County",5,78,326,158,168
050,26,123,"Michigan","Newaygo County",5,79,313,154,159
050,26,123,"Michigan","Newaygo County",5,80,318,142,176
050,26,123,"Michigan","Newaygo County",5,81,283,119,164
050,26,123,"Michigan","Newaygo County",5,82,227,98,129
050,26,123,"Michigan","Newaygo County",5,83,210,100,110
050,26,123,"Michigan","Newaygo County",5,84,187,88,99
050,26,123,"Michigan","Newaygo County",5,85,971,368,603
050,26,125,"Michigan","Oakland County",1,0,13151,6723,6428
050,26,125,"Michigan","Oakland County",1,1,13120,6703,6417
050,26,125,"Michigan","Oakland County",1,2,13307,6751,6556
050,26,125,"Michigan","Oakland County",1,3,13797,7122,6675
050,26,125,"Michigan","Oakland County",1,4,14143,7277,6866
050,26,125,"Michigan","Oakland County",1,5,14213,7302,6911
050,26,125,"Michigan","Oakland County",1,6,14045,7230,6815
050,26,125,"Michigan","Oakland County",1,7,14028,7168,6860
050,26,125,"Michigan","Oakland County",1,8,14132,7178,6954
050,26,125,"Michigan","Oakland County",1,9,14231,7284,6947
050,26,125,"Michigan","Oakland County",1,10,14782,7606,7176
050,26,125,"Michigan","Oakland County",1,11,15312,7696,7616
050,26,125,"Michigan","Oakland County",1,12,15776,8015,7761
050,26,125,"Michigan","Oakland County",1,13,16002,8246,7756
050,26,125,"Michigan","Oakland County",1,14,15788,8147,7641
050,26,125,"Michigan","Oakland County",1,15,16265,8261,8004
050,26,125,"Michigan","Oakland County",1,16,16694,8511,8183
050,26,125,"Michigan","Oakland County",1,17,16501,8459,8042
050,26,125,"Michigan","Oakland County",1,18,14985,7760,7225
050,26,125,"Michigan","Oakland County",1,19,12956,6559,6397
050,26,125,"Michigan","Oakland County",1,20,13188,6769,6419
050,26,125,"Michigan","Oakland County",1,21,13867,7097,6770
050,26,125,"Michigan","Oakland County",1,22,14419,7390,7029
050,26,125,"Michigan","Oakland County",1,23,15051,7781,7270
050,26,125,"Michigan","Oakland County",1,24,16002,8378,7624
050,26,125,"Michigan","Oakland County",1,25,16729,8730,7999
050,26,125,"Michigan","Oakland County",1,26,16952,8883,8069
050,26,125,"Michigan","Oakland County",1,27,17316,9052,8264
050,26,125,"Michigan","Oakland County",1,28,17636,9199,8437
050,26,125,"Michigan","Oakland County",1,29,17923,9313,8610
050,26,125,"Michigan","Oakland County",1,30,17476,8941,8535
050,26,125,"Michigan","Oakland County",1,31,16548,8500,8048
050,26,125,"Michigan","Oakland County",1,32,16400,8475,7925
050,26,125,"Michigan","Oakland County",1,33,16392,8421,7971
050,26,125,"Michigan","Oakland County",1,34,16538,8479,8059
050,26,125,"Michigan","Oakland County",1,35,16399,8346,8053
050,26,125,"Michigan","Oakland County",1,36,16445,8348,8097
050,26,125,"Michigan","Oakland County",1,37,16663,8513,8150
050,26,125,"Michigan","Oakland County",1,38,16709,8526,8183
050,26,125,"Michigan","Oakland County",1,39,16429,8324,8105
050,26,125,"Michigan","Oakland County",1,40,16160,8065,8095
050,26,125,"Michigan","Oakland County",1,41,15959,7950,8009
050,26,125,"Michigan","Oakland County",1,42,15767,7825,7942
050,26,125,"Michigan","Oakland County",1,43,15342,7608,7734
050,26,125,"Michigan","Oakland County",1,44,15237,7513,7724
050,26,125,"Michigan","Oakland County",1,45,15705,7739,7966
050,26,125,"Michigan","Oakland County",1,46,15885,7879,8006
050,26,125,"Michigan","Oakland County",1,47,16412,8046,8366
050,26,125,"Michigan","Oakland County",1,48,17558,8622,8936
050,26,125,"Michigan","Oakland County",1,49,19131,9463,9668
050,26,125,"Michigan","Oakland County",1,50,18448,9078,9370
050,26,125,"Michigan","Oakland County",1,51,17863,8788,9075
050,26,125,"Michigan","Oakland County",1,52,17333,8625,8708
050,26,125,"Michigan","Oakland County",1,53,17696,8798,8898
050,26,125,"Michigan","Oakland County",1,54,17947,8758,9189
050,26,125,"Michigan","Oakland County",1,55,18541,9057,9484
050,26,125,"Michigan","Oakland County",1,56,19065,9421,9644
050,26,125,"Michigan","Oakland County",1,57,18886,9348,9538
050,26,125,"Michigan","Oakland County",1,58,18941,9431,9510
050,26,125,"Michigan","Oakland County",1,59,18693,9192,9501
050,26,125,"Michigan","Oakland County",1,60,18309,8869,9440
050,26,125,"Michigan","Oakland County",1,61,18328,8846,9482
050,26,125,"Michigan","Oakland County",1,62,18295,8836,9459
050,26,125,"Michigan","Oakland County",1,63,17553,8428,9125
050,26,125,"Michigan","Oakland County",1,64,16875,8124,8751
050,26,125,"Michigan","Oakland County",1,65,16149,7697,8452
050,26,125,"Michigan","Oakland County",1,66,15246,7239,8007
050,26,125,"Michigan","Oakland County",1,67,14805,7012,7793
050,26,125,"Michigan","Oakland County",1,68,14436,6807,7629
050,26,125,"Michigan","Oakland County",1,69,13279,6103,7176
050,26,125,"Michigan","Oakland County",1,70,12779,5878,6901
050,26,125,"Michigan","Oakland County",1,71,12477,5725,6752
050,26,125,"Michigan","Oakland County",1,72,12431,5677,6754
050,26,125,"Michigan","Oakland County",1,73,12416,5781,6635
050,26,125,"Michigan","Oakland County",1,74,8774,3980,4794
050,26,125,"Michigan","Oakland County",1,75,8577,3862,4715
050,26,125,"Michigan","Oakland County",1,76,8471,3785,4686
050,26,125,"Michigan","Oakland County",1,77,8528,3821,4707
050,26,125,"Michigan","Oakland County",1,78,7158,3285,3873
050,26,125,"Michigan","Oakland County",1,79,6108,2693,3415
050,26,125,"Michigan","Oakland County",1,80,5487,2404,3083
050,26,125,"Michigan","Oakland County",1,81,5078,2150,2928
050,26,125,"Michigan","Oakland County",1,82,4562,1881,2681
050,26,125,"Michigan","Oakland County",1,83,4196,1748,2448
050,26,125,"Michigan","Oakland County",1,84,3924,1572,2352
050,26,125,"Michigan","Oakland County",1,85,25282,8605,16677
050,26,125,"Michigan","Oakland County",2,0,13033,6655,6378
050,26,125,"Michigan","Oakland County",2,1,13074,6671,6403
050,26,125,"Michigan","Oakland County",2,2,13258,6740,6518
050,26,125,"Michigan","Oakland County",2,3,13628,7012,6616
050,26,125,"Michigan","Oakland County",2,4,14090,7246,6844
050,26,125,"Michigan","Oakland County",2,5,14211,7301,6910
050,26,125,"Michigan","Oakland County",2,6,14107,7263,6844
050,26,125,"Michigan","Oakland County",2,7,14001,7170,6831
050,26,125,"Michigan","Oakland County",2,8,14045,7143,6902
050,26,125,"Michigan","Oakland County",2,9,14175,7255,6920
050,26,125,"Michigan","Oakland County",2,10,14617,7507,7110
050,26,125,"Michigan","Oakland County",2,11,15113,7641,7472
050,26,125,"Michigan","Oakland County",2,12,15722,7960,7762
050,26,125,"Michigan","Oakland County",2,13,15906,8167,7739
050,26,125,"Michigan","Oakland County",2,14,15828,8156,7672
050,26,125,"Michigan","Oakland County",2,15,16142,8227,7915
050,26,125,"Michigan","Oakland County",2,16,16598,8456,8142
050,26,125,"Michigan","Oakland County",2,17,16560,8488,8072
050,26,125,"Michigan","Oakland County",2,18,14846,7685,7161
050,26,125,"Michigan","Oakland County",2,19,12981,6580,6401
050,26,125,"Michigan","Oakland County",2,20,13389,6858,6531
050,26,125,"Michigan","Oakland County",2,21,13775,7042,6733
050,26,125,"Michigan","Oakland County",2,22,14415,7378,7037
050,26,125,"Michigan","Oakland County",2,23,15059,7788,7271
050,26,125,"Michigan","Oakland County",2,24,15850,8278,7572
050,26,125,"Michigan","Oakland County",2,25,16582,8674,7908
050,26,125,"Michigan","Oakland County",2,26,16956,8878,8078
050,26,125,"Michigan","Oakland County",2,27,17237,9023,8214
050,26,125,"Michigan","Oakland County",2,28,17587,9178,8409
050,26,125,"Michigan","Oakland County",2,29,17874,9282,8592
050,26,125,"Michigan","Oakland County",2,30,17667,9069,8598
050,26,125,"Michigan","Oakland County",2,31,16763,8612,8151
050,26,125,"Michigan","Oakland County",2,32,16399,8467,7932
050,26,125,"Michigan","Oakland County",2,33,16352,8419,7933
050,26,125,"Michigan","Oakland County",2,34,16490,8458,8032
050,26,125,"Michigan","Oakland County",2,35,16494,8409,8085
050,26,125,"Michigan","Oakland County",2,36,16300,8280,8020
050,26,125,"Michigan","Oakland County",2,37,16606,8472,8134
050,26,125,"Michigan","Oakland County",2,38,16735,8546,8189
050,26,125,"Michigan","Oakland County",2,39,16428,8340,8088
050,26,125,"Michigan","Oakland County",2,40,16312,8169,8143
050,26,125,"Michigan","Oakland County",2,41,15986,7960,8026
050,26,125,"Michigan","Oakland County",2,42,15735,7813,7922
050,26,125,"Michigan","Oakland County",2,43,15540,7716,7824
050,26,125,"Michigan","Oakland County",2,44,15109,7463,7646
050,26,125,"Michigan","Oakland County",2,45,15646,7712,7934
050,26,125,"Michigan","Oakland County",2,46,15763,7800,7963
050,26,125,"Michigan","Oakland County",2,47,16225,7976,8249
050,26,125,"Michigan","Oakland County",2,48,17267,8484,8783
050,26,125,"Michigan","Oakland County",2,49,18773,9281,9492
050,26,125,"Michigan","Oakland County",2,50,18605,9167,9438
050,26,125,"Michigan","Oakland County",2,51,17906,8813,9093
050,26,125,"Michigan","Oakland County",2,52,17401,8630,8771
050,26,125,"Michigan","Oakland County",2,53,17558,8729,8829
050,26,125,"Michigan","Oakland County",2,54,17797,8728,9069
050,26,125,"Michigan","Oakland County",2,55,18348,8949,9399
050,26,125,"Michigan","Oakland County",2,56,18936,9338,9598
050,26,125,"Michigan","Oakland County",2,57,18889,9343,9546
050,26,125,"Michigan","Oakland County",2,58,18850,9365,9485
050,26,125,"Michigan","Oakland County",2,59,18763,9258,9505
050,26,125,"Michigan","Oakland County",2,60,18306,8891,9415
050,26,125,"Michigan","Oakland County",2,61,18183,8769,9414
050,26,125,"Michigan","Oakland County",2,62,18167,8768,9399
050,26,125,"Michigan","Oakland County",2,63,17776,8544,9232
050,26,125,"Michigan","Oakland County",2,64,16862,8108,8754
050,26,125,"Michigan","Oakland County",2,65,16224,7755,8469
050,26,125,"Michigan","Oakland County",2,66,15400,7305,8095
050,26,125,"Michigan","Oakland County",2,67,14777,6997,7780
050,26,125,"Michigan","Oakland County",2,68,14326,6753,7573
050,26,125,"Michigan","Oakland County",2,69,13567,6266,7301
050,26,125,"Michigan","Oakland County",2,70,12784,5873,6911
050,26,125,"Michigan","Oakland County",2,71,12481,5721,6760
050,26,125,"Michigan","Oakland County",2,72,12172,5557,6615
050,26,125,"Michigan","Oakland County",2,73,12871,5960,6911
050,26,125,"Michigan","Oakland County",2,74,9043,4120,4923
050,26,125,"Michigan","Oakland County",2,75,8570,3860,4710
050,26,125,"Michigan","Oakland County",2,76,8347,3728,4619
050,26,125,"Michigan","Oakland County",2,77,8614,3849,4765
050,26,125,"Michigan","Oakland County",2,78,7268,3307,3961
050,26,125,"Michigan","Oakland County",2,79,6271,2784,3487
050,26,125,"Michigan","Oakland County",2,80,5562,2427,3135
050,26,125,"Michigan","Oakland County",2,81,5079,2163,2916
050,26,125,"Michigan","Oakland County",2,82,4605,1914,2691
050,26,125,"Michigan","Oakland County",2,83,4190,1733,2457
050,26,125,"Michigan","Oakland County",2,84,3891,1564,2327
050,26,125,"Michigan","Oakland County",2,85,24855,8459,16396
050,26,125,"Michigan","Oakland County",3,0,12323,6371,5952
050,26,125,"Michigan","Oakland County",3,1,13118,6673,6445
050,26,125,"Michigan","Oakland County",3,2,13181,6757,6424
050,26,125,"Michigan","Oakland County",3,3,13297,6807,6490
050,26,125,"Michigan","Oakland County",3,4,13756,7106,6650
050,26,125,"Michigan","Oakland County",3,5,14075,7215,6860
050,26,125,"Michigan","Oakland County",3,6,14250,7293,6957
050,26,125,"Michigan","Oakland County",3,7,14130,7260,6870
050,26,125,"Michigan","Oakland County",3,8,13998,7149,6849
050,26,125,"Michigan","Oakland County",3,9,14116,7146,6970
050,26,125,"Michigan","Oakland County",3,10,14230,7244,6986
050,26,125,"Michigan","Oakland County",3,11,14632,7482,7150
050,26,125,"Michigan","Oakland County",3,12,15151,7632,7519
050,26,125,"Michigan","Oakland County",3,13,15661,7919,7742
050,26,125,"Michigan","Oakland County",3,14,15966,8167,7799
050,26,125,"Michigan","Oakland County",3,15,15856,8149,7707
050,26,125,"Michigan","Oakland County",3,16,16153,8257,7896
050,26,125,"Michigan","Oakland County",3,17,16614,8482,8132
050,26,125,"Michigan","Oakland County",3,18,14805,7701,7104
050,26,125,"Michigan","Oakland County",3,19,12627,6436,6191
050,26,125,"Michigan","Oakland County",3,20,13623,6907,6716
050,26,125,"Michigan","Oakland County",3,21,14026,7112,6914
050,26,125,"Michigan","Oakland County",3,22,14489,7357,7132
050,26,125,"Michigan","Oakland County",3,23,15230,7857,7373
050,26,125,"Michigan","Oakland County",3,24,15784,8168,7616
050,26,125,"Michigan","Oakland County",3,25,16355,8494,7861
050,26,125,"Michigan","Oakland County",3,26,16865,8752,8113
050,26,125,"Michigan","Oakland County",3,27,17216,8989,8227
050,26,125,"Michigan","Oakland County",3,28,17402,9154,8248
050,26,125,"Michigan","Oakland County",3,29,17756,9232,8524
050,26,125,"Michigan","Oakland County",3,30,18035,9326,8709
050,26,125,"Michigan","Oakland County",3,31,17825,9121,8704
050,26,125,"Michigan","Oakland County",3,32,16920,8720,8200
050,26,125,"Michigan","Oakland County",3,33,16478,8470,8008
050,26,125,"Michigan","Oakland County",3,34,16423,8440,7983
050,26,125,"Michigan","Oakland County",3,35,16502,8487,8015
050,26,125,"Michigan","Oakland County",3,36,16592,8421,8171
050,26,125,"Michigan","Oakland County",3,37,16345,8253,8092
050,26,125,"Michigan","Oakland County",3,38,16646,8464,8182
050,26,125,"Michigan","Oakland County",3,39,16790,8610,8180
050,26,125,"Michigan","Oakland County",3,40,16330,8291,8039
050,26,125,"Michigan","Oakland County",3,41,16269,8132,8137
050,26,125,"Michigan","Oakland County",3,42,15981,7954,8027
050,26,125,"Michigan","Oakland County",3,43,15752,7799,7953
050,26,125,"Michigan","Oakland County",3,44,15519,7713,7806
050,26,125,"Michigan","Oakland County",3,45,15040,7439,7601
050,26,125,"Michigan","Oakland County",3,46,15629,7693,7936
050,26,125,"Michigan","Oakland County",3,47,15675,7765,7910
050,26,125,"Michigan","Oakland County",3,48,16199,7969,8230
050,26,125,"Michigan","Oakland County",3,49,17115,8380,8735
050,26,125,"Michigan","Oakland County",3,50,18741,9221,9520
050,26,125,"Michigan","Oakland County",3,51,18552,9189,9363
050,26,125,"Michigan","Oakland County",3,52,17786,8760,9026
050,26,125,"Michigan","Oakland County",3,53,17251,8550,8701
050,26,125,"Michigan","Oakland County",3,54,17398,8675,8723
050,26,125,"Michigan","Oakland County",3,55,17571,8642,8929
050,26,125,"Michigan","Oakland County",3,56,18139,8858,9281
050,26,125,"Michigan","Oakland County",3,57,18719,9246,9473
050,26,125,"Michigan","Oakland County",3,58,18550,9184,9366
050,26,125,"Michigan","Oakland County",3,59,18583,9248,9335
050,26,125,"Michigan","Oakland County",3,60,18462,9057,9405
050,26,125,"Michigan","Oakland County",3,61,17969,8739,9230
050,26,125,"Michigan","Oakland County",3,62,17766,8526,9240
050,26,125,"Michigan","Oakland County",3,63,17817,8570,9247
050,26,125,"Michigan","Oakland County",3,64,17377,8314,9063
050,26,125,"Michigan","Oakland County",3,65,16414,7880,8534
050,26,125,"Michigan","Oakland County",3,66,15863,7535,8328
050,26,125,"Michigan","Oakland County",3,67,15089,7134,7955
050,26,125,"Michigan","Oakland County",3,68,14453,6798,7655
050,26,125,"Michigan","Oakland County",3,69,14049,6572,7477
050,26,125,"Michigan","Oakland County",3,70,13280,6096,7184
050,26,125,"Michigan","Oakland County",3,71,12444,5673,6771
050,26,125,"Michigan","Oakland County",3,72,12137,5518,6619
050,26,125,"Michigan","Oakland County",3,73,11869,5358,6511
050,26,125,"Michigan","Oakland County",3,74,12514,5749,6765
050,26,125,"Michigan","Oakland County",3,75,8751,3942,4809
050,26,125,"Michigan","Oakland County",3,76,8302,3725,4577
050,26,125,"Michigan","Oakland County",3,77,8063,3583,4480
050,26,125,"Michigan","Oakland County",3,78,8254,3640,4614
050,26,125,"Michigan","Oakland County",3,79,7000,3145,3855
050,26,125,"Michigan","Oakland County",3,80,5991,2649,3342
050,26,125,"Michigan","Oakland County",3,81,5268,2268,3000
050,26,125,"Michigan","Oakland County",3,82,4699,1969,2730
050,26,125,"Michigan","Oakland County",3,83,4362,1787,2575
050,26,125,"Michigan","Oakland County",3,84,3915,1580,2335
050,26,125,"Michigan","Oakland County",3,85,24482,8373,16109
050,26,125,"Michigan","Oakland County",4,0,12884,6640,6244
050,26,125,"Michigan","Oakland County",4,1,12416,6404,6012
050,26,125,"Michigan","Oakland County",4,2,13169,6696,6473
050,26,125,"Michigan","Oakland County",4,3,13307,6879,6428
050,26,125,"Michigan","Oakland County",4,4,13368,6809,6559
050,26,125,"Michigan","Oakland County",4,5,13772,7085,6687
050,26,125,"Michigan","Oakland County",4,6,14136,7230,6906
050,26,125,"Michigan","Oakland County",4,7,14339,7317,7022
050,26,125,"Michigan","Oakland County",4,8,14188,7304,6884
050,26,125,"Michigan","Oakland County",4,9,14042,7150,6892
050,26,125,"Michigan","Oakland County",4,10,14120,7148,6972
050,26,125,"Michigan","Oakland County",4,11,14260,7267,6993
050,26,125,"Michigan","Oakland County",4,12,14708,7496,7212
050,26,125,"Michigan","Oakland County",4,13,15175,7643,7532
050,26,125,"Michigan","Oakland County",4,14,15699,7938,7761
050,26,125,"Michigan","Oakland County",4,15,15926,8159,7767
050,26,125,"Michigan","Oakland County",4,16,15825,8153,7672
050,26,125,"Michigan","Oakland County",4,17,16134,8291,7843
050,26,125,"Michigan","Oakland County",4,18,14692,7592,7100
050,26,125,"Michigan","Oakland County",4,19,12365,6340,6025
050,26,125,"Michigan","Oakland County",4,20,12991,6681,6310
050,26,125,"Michigan","Oakland County",4,21,14119,7058,7061
050,26,125,"Michigan","Oakland County",4,22,14734,7390,7344
050,26,125,"Michigan","Oakland County",4,23,15022,7785,7237
050,26,125,"Michigan","Oakland County",4,24,15628,8110,7518
050,26,125,"Michigan","Oakland County",4,25,16079,8289,7790
050,26,125,"Michigan","Oakland County",4,26,16353,8449,7904
050,26,125,"Michigan","Oakland County",4,27,16950,8799,8151
050,26,125,"Michigan","Oakland County",4,28,17346,9049,8297
050,26,125,"Michigan","Oakland County",4,29,17578,9264,8314
050,26,125,"Michigan","Oakland County",4,30,17805,9165,8640
050,26,125,"Michigan","Oakland County",4,31,18180,9389,8791
050,26,125,"Michigan","Oakland County",4,32,17952,9226,8726
050,26,125,"Michigan","Oakland County",4,33,16913,8662,8251
050,26,125,"Michigan","Oakland County",4,34,16590,8493,8097
050,26,125,"Michigan","Oakland County",4,35,16454,8419,8035
050,26,125,"Michigan","Oakland County",4,36,16352,8368,7984
050,26,125,"Michigan","Oakland County",4,37,16563,8349,8214
050,26,125,"Michigan","Oakland County",4,38,16405,8277,8128
050,26,125,"Michigan","Oakland County",4,39,16666,8491,8175
050,26,125,"Michigan","Oakland County",4,40,16807,8614,8193
050,26,125,"Michigan","Oakland County",4,41,16319,8288,8031
050,26,125,"Michigan","Oakland County",4,42,16379,8205,8174
050,26,125,"Michigan","Oakland County",4,43,16024,8019,8005
050,26,125,"Michigan","Oakland County",4,44,15737,7805,7932
050,26,125,"Michigan","Oakland County",4,45,15574,7750,7824
050,26,125,"Michigan","Oakland County",4,46,15013,7389,7624
050,26,125,"Michigan","Oakland County",4,47,15508,7643,7865
050,26,125,"Michigan","Oakland County",4,48,15618,7733,7885
050,26,125,"Michigan","Oakland County",4,49,16115,7891,8224
050,26,125,"Michigan","Oakland County",4,50,17075,8368,8707
050,26,125,"Michigan","Oakland County",4,51,18621,9158,9463
050,26,125,"Michigan","Oakland County",4,52,18280,9016,9264
050,26,125,"Michigan","Oakland County",4,53,17534,8629,8905
050,26,125,"Michigan","Oakland County",4,54,17066,8499,8567
050,26,125,"Michigan","Oakland County",4,55,17270,8584,8686
050,26,125,"Michigan","Oakland County",4,56,17304,8501,8803
050,26,125,"Michigan","Oakland County",4,57,17966,8776,9190
050,26,125,"Michigan","Oakland County",4,58,18441,9106,9335
050,26,125,"Michigan","Oakland County",4,59,18208,8987,9221
050,26,125,"Michigan","Oakland County",4,60,18191,9036,9155
050,26,125,"Michigan","Oakland County",4,61,18157,8877,9280
050,26,125,"Michigan","Oakland County",4,62,17530,8430,9100
050,26,125,"Michigan","Oakland County",4,63,17370,8330,9040
050,26,125,"Michigan","Oakland County",4,64,17478,8366,9112
050,26,125,"Michigan","Oakland County",4,65,17011,8144,8867
050,26,125,"Michigan","Oakland County",4,66,16033,7655,8378
050,26,125,"Michigan","Oakland County",4,67,15544,7350,8194
050,26,125,"Michigan","Oakland County",4,68,14765,6963,7802
050,26,125,"Michigan","Oakland County",4,69,14131,6613,7518
050,26,125,"Michigan","Oakland County",4,70,13775,6407,7368
050,26,125,"Michigan","Oakland County",4,71,13006,5935,7071
050,26,125,"Michigan","Oakland County",4,72,12107,5461,6646
050,26,125,"Michigan","Oakland County",4,73,11816,5337,6479
050,26,125,"Michigan","Oakland County",4,74,11597,5157,6440
050,26,125,"Michigan","Oakland County",4,75,12151,5507,6644
050,26,125,"Michigan","Oakland County",4,76,8438,3800,4638
050,26,125,"Michigan","Oakland County",4,77,8011,3576,4435
050,26,125,"Michigan","Oakland County",4,78,7706,3378,4328
050,26,125,"Michigan","Oakland County",4,79,7991,3487,4504
050,26,125,"Michigan","Oakland County",4,80,6702,2989,3713
050,26,125,"Michigan","Oakland County",4,81,5766,2512,3254
050,26,125,"Michigan","Oakland County",4,82,4940,2113,2827
050,26,125,"Michigan","Oakland County",4,83,4432,1832,2600
050,26,125,"Michigan","Oakland County",4,84,4053,1624,2429
050,26,125,"Michigan","Oakland County",4,85,24260,8408,15852
050,26,125,"Michigan","Oakland County",5,0,12745,6576,6169
050,26,125,"Michigan","Oakland County",5,1,12760,6590,6170
050,26,125,"Michigan","Oakland County",5,2,12444,6419,6025
050,26,125,"Michigan","Oakland County",5,3,13160,6713,6447
050,26,125,"Michigan","Oakland County",5,4,13312,6869,6443
050,26,125,"Michigan","Oakland County",5,5,13473,6877,6596
050,26,125,"Michigan","Oakland County",5,6,13808,7082,6726
050,26,125,"Michigan","Oakland County",5,7,14216,7247,6969
050,26,125,"Michigan","Oakland County",5,8,14380,7364,7016
050,26,125,"Michigan","Oakland County",5,9,14291,7330,6961
050,26,125,"Michigan","Oakland County",5,10,14004,7136,6868
050,26,125,"Michigan","Oakland County",5,11,14116,7174,6942
050,26,125,"Michigan","Oakland County",5,12,14383,7290,7093
050,26,125,"Michigan","Oakland County",5,13,14784,7548,7236
050,26,125,"Michigan","Oakland County",5,14,15206,7658,7548
050,26,125,"Michigan","Oakland County",5,15,15671,7905,7766
050,26,125,"Michigan","Oakland County",5,16,15961,8198,7763
050,26,125,"Michigan","Oakland County",5,17,15943,8273,7670
050,26,125,"Michigan","Oakland County",5,18,14322,7465,6857
050,26,125,"Michigan","Oakland County",5,19,12456,6344,6112
050,26,125,"Michigan","Oakland County",5,20,13045,6744,6301
050,26,125,"Michigan","Oakland County",5,21,13666,6914,6752
050,26,125,"Michigan","Oakland County",5,22,14675,7275,7400
050,26,125,"Michigan","Oakland County",5,23,15196,7792,7404
050,26,125,"Michigan","Oakland County",5,24,15389,8019,7370
050,26,125,"Michigan","Oakland County",5,25,15774,8140,7634
050,26,125,"Michigan","Oakland County",5,26,16044,8232,7812
050,26,125,"Michigan","Oakland County",5,27,16312,8441,7871
050,26,125,"Michigan","Oakland County",5,28,16945,8823,8122
050,26,125,"Michigan","Oakland County",5,29,17373,8977,8396
050,26,125,"Michigan","Oakland County",5,30,17514,9181,8333
050,26,125,"Michigan","Oakland County",5,31,17886,9197,8689
050,26,125,"Michigan","Oakland County",5,32,18258,9419,8839
050,26,125,"Michigan","Oakland County",5,33,17937,9252,8685
050,26,125,"Michigan","Oakland County",5,34,16972,8658,8314
050,26,125,"Michigan","Oakland County",5,35,16520,8390,8130
050,26,125,"Michigan","Oakland County",5,36,16473,8406,8067
050,26,125,"Michigan","Oakland County",5,37,16426,8353,8073
050,26,125,"Michigan","Oakland County",5,38,16600,8355,8245
050,26,125,"Michigan","Oakland County",5,39,16393,8301,8092
050,26,125,"Michigan","Oakland County",5,40,16694,8517,8177
050,26,125,"Michigan","Oakland County",5,41,16780,8583,8197
050,26,125,"Michigan","Oakland County",5,42,16364,8318,8046
050,26,125,"Michigan","Oakland County",5,43,16275,8166,8109
050,26,125,"Michigan","Oakland County",5,44,15997,7995,8002
050,26,125,"Michigan","Oakland County",5,45,15679,7761,7918
050,26,125,"Michigan","Oakland County",5,46,15509,7671,7838
050,26,125,"Michigan","Oakland County",5,47,14955,7352,7603
050,26,125,"Michigan","Oakland County",5,48,15521,7639,7882
050,26,125,"Michigan","Oakland County",5,49,15583,7746,7837
050,26,125,"Michigan","Oakland County",5,50,15980,7854,8126
050,26,125,"Michigan","Oakland County",5,51,17067,8375,8692
050,26,125,"Michigan","Oakland County",5,52,18498,9071,9427
050,26,125,"Michigan","Oakland County",5,53,18088,8936,9152
050,26,125,"Michigan","Oakland County",5,54,17305,8552,8753
050,26,125,"Michigan","Oakland County",5,55,16910,8438,8472
050,26,125,"Michigan","Oakland County",5,56,17031,8485,8546
050,26,125,"Michigan","Oakland County",5,57,17135,8413,8722
050,26,125,"Michigan","Oakland County",5,58,17672,8572,9100
050,26,125,"Michigan","Oakland County",5,59,18217,8965,9252
050,26,125,"Michigan","Oakland County",5,60,17901,8830,9071
050,26,125,"Michigan","Oakland County",5,61,17935,8901,9034
050,26,125,"Michigan","Oakland County",5,62,17780,8680,9100
050,26,125,"Michigan","Oakland County",5,63,17218,8285,8933
050,26,125,"Michigan","Oakland County",5,64,17091,8194,8897
050,26,125,"Michigan","Oakland County",5,65,17118,8176,8942
050,26,125,"Michigan","Oakland County",5,66,16664,7939,8725
050,26,125,"Michigan","Oakland County",5,67,15779,7536,8243
050,26,125,"Michigan","Oakland County",5,68,15313,7204,8109
050,26,125,"Michigan","Oakland County",5,69,14513,6793,7720
050,26,125,"Michigan","Oakland County",5,70,13959,6521,7438
050,26,125,"Michigan","Oakland County",5,71,13501,6271,7230
050,26,125,"Michigan","Oakland County",5,72,12715,5782,6933
050,26,125,"Michigan","Oakland County",5,73,11854,5303,6551
050,26,125,"Michigan","Oakland County",5,74,11590,5200,6390
050,26,125,"Michigan","Oakland County",5,75,11292,4969,6323
050,26,125,"Michigan","Oakland County",5,76,11799,5363,6436
050,26,125,"Michigan","Oakland County",5,77,8190,3676,4514
050,26,125,"Michigan","Oakland County",5,78,7667,3411,4256
050,26,125,"Michigan","Oakland County",5,79,7456,3238,4218
050,26,125,"Michigan","Oakland County",5,80,7689,3335,4354
050,26,125,"Michigan","Oakland County",5,81,6456,2854,3602
050,26,125,"Michigan","Oakland County",5,82,5459,2358,3101
050,26,125,"Michigan","Oakland County",5,83,4705,1999,2706
050,26,125,"Michigan","Oakland County",5,84,4149,1677,2472
050,26,125,"Michigan","Oakland County",5,85,24540,8598,15942
050,26,127,"Michigan","Oceana County",1,0,258,130,128
050,26,127,"Michigan","Oceana County",1,1,268,129,139
050,26,127,"Michigan","Oceana County",1,2,253,125,128
050,26,127,"Michigan","Oceana County",1,3,295,164,131
050,26,127,"Michigan","Oceana County",1,4,322,155,167
050,26,127,"Michigan","Oceana County",1,5,289,142,147
050,26,127,"Michigan","Oceana County",1,6,288,156,132
050,26,127,"Michigan","Oceana County",1,7,339,159,180
050,26,127,"Michigan","Oceana County",1,8,328,164,164
050,26,127,"Michigan","Oceana County",1,9,349,168,181
050,26,127,"Michigan","Oceana County",1,10,371,192,179
050,26,127,"Michigan","Oceana County",1,11,360,178,182
050,26,127,"Michigan","Oceana County",1,12,363,200,163
050,26,127,"Michigan","Oceana County",1,13,360,194,166
050,26,127,"Michigan","Oceana County",1,14,381,206,175
050,26,127,"Michigan","Oceana County",1,15,390,209,181
050,26,127,"Michigan","Oceana County",1,16,351,188,163
050,26,127,"Michigan","Oceana County",1,17,355,191,164
050,26,127,"Michigan","Oceana County",1,18,301,163,138
050,26,127,"Michigan","Oceana County",1,19,266,143,123
050,26,127,"Michigan","Oceana County",1,20,289,148,141
050,26,127,"Michigan","Oceana County",1,21,261,129,132
050,26,127,"Michigan","Oceana County",1,22,282,143,139
050,26,127,"Michigan","Oceana County",1,23,282,162,120
050,26,127,"Michigan","Oceana County",1,24,282,154,128
050,26,127,"Michigan","Oceana County",1,25,295,163,132
050,26,127,"Michigan","Oceana County",1,26,310,177,133
050,26,127,"Michigan","Oceana County",1,27,281,161,120
050,26,127,"Michigan","Oceana County",1,28,296,153,143
050,26,127,"Michigan","Oceana County",1,29,300,154,146
050,26,127,"Michigan","Oceana County",1,30,273,142,131
050,26,127,"Michigan","Oceana County",1,31,258,138,120
050,26,127,"Michigan","Oceana County",1,32,274,146,128
050,26,127,"Michigan","Oceana County",1,33,290,147,143
050,26,127,"Michigan","Oceana County",1,34,285,151,134
050,26,127,"Michigan","Oceana County",1,35,296,165,131
050,26,127,"Michigan","Oceana County",1,36,333,175,158
050,26,127,"Michigan","Oceana County",1,37,302,157,145
050,26,127,"Michigan","Oceana County",1,38,291,152,139
050,26,127,"Michigan","Oceana County",1,39,306,159,147
050,26,127,"Michigan","Oceana County",1,40,300,145,155
050,26,127,"Michigan","Oceana County",1,41,278,138,140
050,26,127,"Michigan","Oceana County",1,42,300,136,164
050,26,127,"Michigan","Oceana County",1,43,294,132,162
050,26,127,"Michigan","Oceana County",1,44,257,139,118
050,26,127,"Michigan","Oceana County",1,45,265,142,123
050,26,127,"Michigan","Oceana County",1,46,264,134,130
050,26,127,"Michigan","Oceana County",1,47,284,146,138
050,26,127,"Michigan","Oceana County",1,48,289,146,143
050,26,127,"Michigan","Oceana County",1,49,310,160,150
050,26,127,"Michigan","Oceana County",1,50,312,159,153
050,26,127,"Michigan","Oceana County",1,51,316,162,154
050,26,127,"Michigan","Oceana County",1,52,339,182,157
050,26,127,"Michigan","Oceana County",1,53,347,176,171
050,26,127,"Michigan","Oceana County",1,54,336,160,176
050,26,127,"Michigan","Oceana County",1,55,357,186,171
050,26,127,"Michigan","Oceana County",1,56,412,220,192
050,26,127,"Michigan","Oceana County",1,57,445,229,216
050,26,127,"Michigan","Oceana County",1,58,446,234,212
050,26,127,"Michigan","Oceana County",1,59,442,228,214
050,26,127,"Michigan","Oceana County",1,60,424,215,209
050,26,127,"Michigan","Oceana County",1,61,446,234,212
050,26,127,"Michigan","Oceana County",1,62,451,224,227
050,26,127,"Michigan","Oceana County",1,63,409,202,207
050,26,127,"Michigan","Oceana County",1,64,394,184,210
050,26,127,"Michigan","Oceana County",1,65,421,212,209
050,26,127,"Michigan","Oceana County",1,66,401,193,208
050,26,127,"Michigan","Oceana County",1,67,367,181,186
050,26,127,"Michigan","Oceana County",1,68,379,199,180
050,26,127,"Michigan","Oceana County",1,69,340,166,174
050,26,127,"Michigan","Oceana County",1,70,350,176,174
050,26,127,"Michigan","Oceana County",1,71,353,184,169
050,26,127,"Michigan","Oceana County",1,72,337,171,166
050,26,127,"Michigan","Oceana County",1,73,305,167,138
050,26,127,"Michigan","Oceana County",1,74,206,100,106
050,26,127,"Michigan","Oceana County",1,75,203,98,105
050,26,127,"Michigan","Oceana County",1,76,224,104,120
050,26,127,"Michigan","Oceana County",1,77,234,117,117
050,26,127,"Michigan","Oceana County",1,78,185,96,89
050,26,127,"Michigan","Oceana County",1,79,191,100,91
050,26,127,"Michigan","Oceana County",1,80,145,68,77
050,26,127,"Michigan","Oceana County",1,81,136,67,69
050,26,127,"Michigan","Oceana County",1,82,124,54,70
050,26,127,"Michigan","Oceana County",1,83,121,55,66
050,26,127,"Michigan","Oceana County",1,84,110,48,62
050,26,127,"Michigan","Oceana County",1,85,534,232,302
050,26,127,"Michigan","Oceana County",2,0,267,138,129
050,26,127,"Michigan","Oceana County",2,1,264,128,136
050,26,127,"Michigan","Oceana County",2,2,258,127,131
050,26,127,"Michigan","Oceana County",2,3,287,157,130
050,26,127,"Michigan","Oceana County",2,4,315,155,160
050,26,127,"Michigan","Oceana County",2,5,295,144,151
050,26,127,"Michigan","Oceana County",2,6,291,153,138
050,26,127,"Michigan","Oceana County",2,7,329,158,171
050,26,127,"Michigan","Oceana County",2,8,326,161,165
050,26,127,"Michigan","Oceana County",2,9,343,168,175
050,26,127,"Michigan","Oceana County",2,10,364,185,179
050,26,127,"Michigan","Oceana County",2,11,360,179,181
050,26,127,"Michigan","Oceana County",2,12,363,196,167
050,26,127,"Michigan","Oceana County",2,13,358,194,164
050,26,127,"Michigan","Oceana County",2,14,378,203,175
050,26,127,"Michigan","Oceana County",2,15,388,210,178
050,26,127,"Michigan","Oceana County",2,16,363,196,167
050,26,127,"Michigan","Oceana County",2,17,359,193,166
050,26,127,"Michigan","Oceana County",2,18,301,164,137
050,26,127,"Michigan","Oceana County",2,19,267,145,122
050,26,127,"Michigan","Oceana County",2,20,293,151,142
050,26,127,"Michigan","Oceana County",2,21,268,134,134
050,26,127,"Michigan","Oceana County",2,22,280,142,138
050,26,127,"Michigan","Oceana County",2,23,284,159,125
050,26,127,"Michigan","Oceana County",2,24,282,156,126
050,26,127,"Michigan","Oceana County",2,25,292,159,133
050,26,127,"Michigan","Oceana County",2,26,307,172,135
050,26,127,"Michigan","Oceana County",2,27,287,165,122
050,26,127,"Michigan","Oceana County",2,28,295,156,139
050,26,127,"Michigan","Oceana County",2,29,301,154,147
050,26,127,"Michigan","Oceana County",2,30,284,147,137
050,26,127,"Michigan","Oceana County",2,31,259,139,120
050,26,127,"Michigan","Oceana County",2,32,274,148,126
050,26,127,"Michigan","Oceana County",2,33,286,145,141
050,26,127,"Michigan","Oceana County",2,34,288,152,136
050,26,127,"Michigan","Oceana County",2,35,292,161,131
050,26,127,"Michigan","Oceana County",2,36,320,170,150
050,26,127,"Michigan","Oceana County",2,37,311,161,150
050,26,127,"Michigan","Oceana County",2,38,299,157,142
050,26,127,"Michigan","Oceana County",2,39,299,153,146
050,26,127,"Michigan","Oceana County",2,40,306,152,154
050,26,127,"Michigan","Oceana County",2,41,285,141,144
050,26,127,"Michigan","Oceana County",2,42,294,136,158
050,26,127,"Michigan","Oceana County",2,43,299,136,163
050,26,127,"Michigan","Oceana County",2,44,264,137,127
050,26,127,"Michigan","Oceana County",2,45,264,143,121
050,26,127,"Michigan","Oceana County",2,46,263,135,128
050,26,127,"Michigan","Oceana County",2,47,281,143,138
050,26,127,"Michigan","Oceana County",2,48,286,145,141
050,26,127,"Michigan","Oceana County",2,49,307,158,149
050,26,127,"Michigan","Oceana County",2,50,312,160,152
050,26,127,"Michigan","Oceana County",2,51,314,163,151
050,26,127,"Michigan","Oceana County",2,52,335,178,157
050,26,127,"Michigan","Oceana County",2,53,348,180,168
050,26,127,"Michigan","Oceana County",2,54,341,166,175
050,26,127,"Michigan","Oceana County",2,55,354,181,173
050,26,127,"Michigan","Oceana County",2,56,403,215,188
050,26,127,"Michigan","Oceana County",2,57,442,230,212
050,26,127,"Michigan","Oceana County",2,58,448,233,215
050,26,127,"Michigan","Oceana County",2,59,450,231,219
050,26,127,"Michigan","Oceana County",2,60,427,219,208
050,26,127,"Michigan","Oceana County",2,61,442,228,214
050,26,127,"Michigan","Oceana County",2,62,450,226,224
050,26,127,"Michigan","Oceana County",2,63,428,212,216
050,26,127,"Michigan","Oceana County",2,64,399,189,210
050,26,127,"Michigan","Oceana County",2,65,414,205,209
050,26,127,"Michigan","Oceana County",2,66,405,197,208
050,26,127,"Michigan","Oceana County",2,67,376,185,191
050,26,127,"Michigan","Oceana County",2,68,372,192,180
050,26,127,"Michigan","Oceana County",2,69,353,176,177
050,26,127,"Michigan","Oceana County",2,70,345,174,171
050,26,127,"Michigan","Oceana County",2,71,352,182,170
050,26,127,"Michigan","Oceana County",2,72,331,170,161
050,26,127,"Michigan","Oceana County",2,73,323,174,149
050,26,127,"Michigan","Oceana County",2,74,215,108,107
050,26,127,"Michigan","Oceana County",2,75,203,99,104
050,26,127,"Michigan","Oceana County",2,76,216,99,117
050,26,127,"Michigan","Oceana County",2,77,235,117,118
050,26,127,"Michigan","Oceana County",2,78,190,98,92
050,26,127,"Michigan","Oceana County",2,79,183,94,89
050,26,127,"Michigan","Oceana County",2,80,155,75,80
050,26,127,"Michigan","Oceana County",2,81,134,65,69
050,26,127,"Michigan","Oceana County",2,82,124,53,71
050,26,127,"Michigan","Oceana County",2,83,116,54,62
050,26,127,"Michigan","Oceana County",2,84,109,49,60
050,26,127,"Michigan","Oceana County",2,85,542,232,310
050,26,127,"Michigan","Oceana County",3,0,258,118,140
050,26,127,"Michigan","Oceana County",3,1,265,144,121
050,26,127,"Michigan","Oceana County",3,2,277,133,144
050,26,127,"Michigan","Oceana County",3,3,263,136,127
050,26,127,"Michigan","Oceana County",3,4,289,152,137
050,26,127,"Michigan","Oceana County",3,5,328,164,164
050,26,127,"Michigan","Oceana County",3,6,308,155,153
050,26,127,"Michigan","Oceana County",3,7,308,163,145
050,26,127,"Michigan","Oceana County",3,8,316,156,160
050,26,127,"Michigan","Oceana County",3,9,314,165,149
050,26,127,"Michigan","Oceana County",3,10,337,170,167
050,26,127,"Michigan","Oceana County",3,11,369,185,184
050,26,127,"Michigan","Oceana County",3,12,342,173,169
050,26,127,"Michigan","Oceana County",3,13,364,187,177
050,26,127,"Michigan","Oceana County",3,14,368,192,176
050,26,127,"Michigan","Oceana County",3,15,374,201,173
050,26,127,"Michigan","Oceana County",3,16,379,204,175
050,26,127,"Michigan","Oceana County",3,17,377,206,171
050,26,127,"Michigan","Oceana County",3,18,311,169,142
050,26,127,"Michigan","Oceana County",3,19,254,149,105
050,26,127,"Michigan","Oceana County",3,20,292,154,138
050,26,127,"Michigan","Oceana County",3,21,290,149,141
050,26,127,"Michigan","Oceana County",3,22,279,145,134
050,26,127,"Michigan","Oceana County",3,23,298,150,148
050,26,127,"Michigan","Oceana County",3,24,286,153,133
050,26,127,"Michigan","Oceana County",3,25,287,156,131
050,26,127,"Michigan","Oceana County",3,26,307,170,137
050,26,127,"Michigan","Oceana County",3,27,315,177,138
050,26,127,"Michigan","Oceana County",3,28,292,167,125
050,26,127,"Michigan","Oceana County",3,29,297,154,143
050,26,127,"Michigan","Oceana County",3,30,314,169,145
050,26,127,"Michigan","Oceana County",3,31,276,134,142
050,26,127,"Michigan","Oceana County",3,32,277,151,126
050,26,127,"Michigan","Oceana County",3,33,278,145,133
050,26,127,"Michigan","Oceana County",3,34,285,140,145
050,26,127,"Michigan","Oceana County",3,35,287,152,135
050,26,127,"Michigan","Oceana County",3,36,300,161,139
050,26,127,"Michigan","Oceana County",3,37,316,167,149
050,26,127,"Michigan","Oceana County",3,38,317,171,146
050,26,127,"Michigan","Oceana County",3,39,295,151,144
050,26,127,"Michigan","Oceana County",3,40,313,162,151
050,26,127,"Michigan","Oceana County",3,41,316,150,166
050,26,127,"Michigan","Oceana County",3,42,295,151,144
050,26,127,"Michigan","Oceana County",3,43,292,140,152
050,26,127,"Michigan","Oceana County",3,44,308,140,168
050,26,127,"Michigan","Oceana County",3,45,258,133,125
050,26,127,"Michigan","Oceana County",3,46,267,142,125
050,26,127,"Michigan","Oceana County",3,47,265,131,134
050,26,127,"Michigan","Oceana County",3,48,280,150,130
050,26,127,"Michigan","Oceana County",3,49,275,138,137
050,26,127,"Michigan","Oceana County",3,50,308,154,154
050,26,127,"Michigan","Oceana County",3,51,316,165,151
050,26,127,"Michigan","Oceana County",3,52,323,170,153
050,26,127,"Michigan","Oceana County",3,53,329,167,162
050,26,127,"Michigan","Oceana County",3,54,357,180,177
050,26,127,"Michigan","Oceana County",3,55,342,167,175
050,26,127,"Michigan","Oceana County",3,56,357,186,171
050,26,127,"Michigan","Oceana County",3,57,407,218,189
050,26,127,"Michigan","Oceana County",3,58,441,234,207
050,26,127,"Michigan","Oceana County",3,59,477,240,237
050,26,127,"Michigan","Oceana County",3,60,450,236,214
050,26,127,"Michigan","Oceana County",3,61,446,229,217
050,26,127,"Michigan","Oceana County",3,62,446,224,222
050,26,127,"Michigan","Oceana County",3,63,451,224,227
050,26,127,"Michigan","Oceana County",3,64,440,214,226
050,26,127,"Michigan","Oceana County",3,65,406,196,210
050,26,127,"Michigan","Oceana County",3,66,414,206,208
050,26,127,"Michigan","Oceana County",3,67,406,201,205
050,26,127,"Michigan","Oceana County",3,68,372,183,189
050,26,127,"Michigan","Oceana County",3,69,362,182,180
050,26,127,"Michigan","Oceana County",3,70,339,170,169
050,26,127,"Michigan","Oceana County",3,71,341,171,170
050,26,127,"Michigan","Oceana County",3,72,347,183,164
050,26,127,"Michigan","Oceana County",3,73,316,164,152
050,26,127,"Michigan","Oceana County",3,74,309,167,142
050,26,127,"Michigan","Oceana County",3,75,210,105,105
050,26,127,"Michigan","Oceana County",3,76,195,93,102
050,26,127,"Michigan","Oceana County",3,77,205,96,109
050,26,127,"Michigan","Oceana County",3,78,212,98,114
050,26,127,"Michigan","Oceana County",3,79,180,90,90
050,26,127,"Michigan","Oceana County",3,80,174,85,89
050,26,127,"Michigan","Oceana County",3,81,151,74,77
050,26,127,"Michigan","Oceana County",3,82,120,55,65
050,26,127,"Michigan","Oceana County",3,83,108,50,58
050,26,127,"Michigan","Oceana County",3,84,107,52,55
050,26,127,"Michigan","Oceana County",3,85,538,232,306
050,26,127,"Michigan","Oceana County",4,0,261,139,122
050,26,127,"Michigan","Oceana County",4,1,253,124,129
050,26,127,"Michigan","Oceana County",4,2,257,136,121
050,26,127,"Michigan","Oceana County",4,3,283,137,146
050,26,127,"Michigan","Oceana County",4,4,265,132,133
050,26,127,"Michigan","Oceana County",4,5,291,145,146
050,26,127,"Michigan","Oceana County",4,6,325,165,160
050,26,127,"Michigan","Oceana County",4,7,323,157,166
050,26,127,"Michigan","Oceana County",4,8,298,158,140
050,26,127,"Michigan","Oceana County",4,9,318,160,158
050,26,127,"Michigan","Oceana County",4,10,327,173,154
050,26,127,"Michigan","Oceana County",4,11,350,164,186
050,26,127,"Michigan","Oceana County",4,12,361,182,179
050,26,127,"Michigan","Oceana County",4,13,349,178,171
050,26,127,"Michigan","Oceana County",4,14,371,192,179
050,26,127,"Michigan","Oceana County",4,15,373,199,174
050,26,127,"Michigan","Oceana County",4,16,363,196,167
050,26,127,"Michigan","Oceana County",4,17,389,209,180
050,26,127,"Michigan","Oceana County",4,18,315,174,141
050,26,127,"Michigan","Oceana County",4,19,258,143,115
050,26,127,"Michigan","Oceana County",4,20,265,156,109
050,26,127,"Michigan","Oceana County",4,21,285,144,141
050,26,127,"Michigan","Oceana County",4,22,302,156,146
050,26,127,"Michigan","Oceana County",4,23,280,148,132
050,26,127,"Michigan","Oceana County",4,24,294,150,144
050,26,127,"Michigan","Oceana County",4,25,281,157,124
050,26,127,"Michigan","Oceana County",4,26,296,156,140
050,26,127,"Michigan","Oceana County",4,27,294,167,127
050,26,127,"Michigan","Oceana County",4,28,325,179,146
050,26,127,"Michigan","Oceana County",4,29,311,175,136
050,26,127,"Michigan","Oceana County",4,30,291,153,138
050,26,127,"Michigan","Oceana County",4,31,316,168,148
050,26,127,"Michigan","Oceana County",4,32,291,145,146
050,26,127,"Michigan","Oceana County",4,33,275,150,125
050,26,127,"Michigan","Oceana County",4,34,292,157,135
050,26,127,"Michigan","Oceana County",4,35,271,138,133
050,26,127,"Michigan","Oceana County",4,36,289,156,133
050,26,127,"Michigan","Oceana County",4,37,282,150,132
050,26,127,"Michigan","Oceana County",4,38,324,171,153
050,26,127,"Michigan","Oceana County",4,39,308,161,147
050,26,127,"Michigan","Oceana County",4,40,298,154,144
050,26,127,"Michigan","Oceana County",4,41,323,165,158
050,26,127,"Michigan","Oceana County",4,42,310,150,160
050,26,127,"Michigan","Oceana County",4,43,296,156,140
050,26,127,"Michigan","Oceana County",4,44,296,142,154
050,26,127,"Michigan","Oceana County",4,45,306,140,166
050,26,127,"Michigan","Oceana County",4,46,265,137,128
050,26,127,"Michigan","Oceana County",4,47,266,141,125
050,26,127,"Michigan","Oceana County",4,48,251,117,134
050,26,127,"Michigan","Oceana County",4,49,287,148,139
050,26,127,"Michigan","Oceana County",4,50,287,141,146
050,26,127,"Michigan","Oceana County",4,51,317,162,155
050,26,127,"Michigan","Oceana County",4,52,324,167,157
050,26,127,"Michigan","Oceana County",4,53,324,172,152
050,26,127,"Michigan","Oceana County",4,54,318,161,157
050,26,127,"Michigan","Oceana County",4,55,364,183,181
050,26,127,"Michigan","Oceana County",4,56,342,164,178
050,26,127,"Michigan","Oceana County",4,57,380,196,184
050,26,127,"Michigan","Oceana County",4,58,418,222,196
050,26,127,"Michigan","Oceana County",4,59,438,229,209
050,26,127,"Michigan","Oceana County",4,60,470,240,230
050,26,127,"Michigan","Oceana County",4,61,459,227,232
050,26,127,"Michigan","Oceana County",4,62,458,225,233
050,26,127,"Michigan","Oceana County",4,63,450,228,222
050,26,127,"Michigan","Oceana County",4,64,459,224,235
050,26,127,"Michigan","Oceana County",4,65,434,212,222
050,26,127,"Michigan","Oceana County",4,66,397,191,206
050,26,127,"Michigan","Oceana County",4,67,415,207,208
050,26,127,"Michigan","Oceana County",4,68,405,198,207
050,26,127,"Michigan","Oceana County",4,69,368,178,190
050,26,127,"Michigan","Oceana County",4,70,359,181,178
050,26,127,"Michigan","Oceana County",4,71,334,167,167
050,26,127,"Michigan","Oceana County",4,72,335,173,162
050,26,127,"Michigan","Oceana County",4,73,334,177,157
050,26,127,"Michigan","Oceana County",4,74,305,154,151
050,26,127,"Michigan","Oceana County",4,75,297,162,135
050,26,127,"Michigan","Oceana County",4,76,201,97,104
050,26,127,"Michigan","Oceana County",4,77,183,89,94
050,26,127,"Michigan","Oceana County",4,78,188,83,105
050,26,127,"Michigan","Oceana County",4,79,200,92,108
050,26,127,"Michigan","Oceana County",4,80,169,84,85
050,26,127,"Michigan","Oceana County",4,81,166,81,85
050,26,127,"Michigan","Oceana County",4,82,144,66,78
050,26,127,"Michigan","Oceana County",4,83,105,48,57
050,26,127,"Michigan","Oceana County",4,84,105,50,55
050,26,127,"Michigan","Oceana County",4,85,568,242,326
050,26,127,"Michigan","Oceana County",5,0,263,140,123
050,26,127,"Michigan","Oceana County",5,1,290,159,131
050,26,127,"Michigan","Oceana County",5,2,263,125,138
050,26,127,"Michigan","Oceana County",5,3,273,156,117
050,26,127,"Michigan","Oceana County",5,4,269,131,138
050,26,127,"Michigan","Oceana County",5,5,253,124,129
050,26,127,"Michigan","Oceana County",5,6,288,143,145
050,26,127,"Michigan","Oceana County",5,7,331,163,168
050,26,127,"Michigan","Oceana County",5,8,307,155,152
050,26,127,"Michigan","Oceana County",5,9,297,156,141
050,26,127,"Michigan","Oceana County",5,10,306,149,157
050,26,127,"Michigan","Oceana County",5,11,318,158,160
050,26,127,"Michigan","Oceana County",5,12,348,170,178
050,26,127,"Michigan","Oceana County",5,13,362,178,184
050,26,127,"Michigan","Oceana County",5,14,358,181,177
050,26,127,"Michigan","Oceana County",5,15,379,196,183
050,26,127,"Michigan","Oceana County",5,16,360,195,165
050,26,127,"Michigan","Oceana County",5,17,371,199,172
050,26,127,"Michigan","Oceana County",5,18,331,182,149
050,26,127,"Michigan","Oceana County",5,19,279,157,122
050,26,127,"Michigan","Oceana County",5,20,282,146,136
050,26,127,"Michigan","Oceana County",5,21,270,152,118
050,26,127,"Michigan","Oceana County",5,22,297,147,150
050,26,127,"Michigan","Oceana County",5,23,320,171,149
050,26,127,"Michigan","Oceana County",5,24,281,158,123
050,26,127,"Michigan","Oceana County",5,25,293,150,143
050,26,127,"Michigan","Oceana County",5,26,285,155,130
050,26,127,"Michigan","Oceana County",5,27,271,147,124
050,26,127,"Michigan","Oceana County",5,28,312,183,129
050,26,127,"Michigan","Oceana County",5,29,326,183,143
050,26,127,"Michigan","Oceana County",5,30,291,168,123
050,26,127,"Michigan","Oceana County",5,31,282,145,137
050,26,127,"Michigan","Oceana County",5,32,312,175,137
050,26,127,"Michigan","Oceana County",5,33,297,140,157
050,26,127,"Michigan","Oceana County",5,34,294,161,133
050,26,127,"Michigan","Oceana County",5,35,295,154,141
050,26,127,"Michigan","Oceana County",5,36,278,142,136
050,26,127,"Michigan","Oceana County",5,37,297,160,137
050,26,127,"Michigan","Oceana County",5,38,291,162,129
050,26,127,"Michigan","Oceana County",5,39,319,162,157
050,26,127,"Michigan","Oceana County",5,40,317,159,158
050,26,127,"Michigan","Oceana County",5,41,299,153,146
050,26,127,"Michigan","Oceana County",5,42,328,171,157
050,26,127,"Michigan","Oceana County",5,43,314,153,161
050,26,127,"Michigan","Oceana County",5,44,300,158,142
050,26,127,"Michigan","Oceana County",5,45,301,144,157
050,26,127,"Michigan","Oceana County",5,46,333,150,183
050,26,127,"Michigan","Oceana County",5,47,273,141,132
050,26,127,"Michigan","Oceana County",5,48,263,143,120
050,26,127,"Michigan","Oceana County",5,49,259,125,134
050,26,127,"Michigan","Oceana County",5,50,287,144,143
050,26,127,"Michigan","Oceana County",5,51,292,148,144
050,26,127,"Michigan","Oceana County",5,52,306,157,149
050,26,127,"Michigan","Oceana County",5,53,317,164,153
050,26,127,"Michigan","Oceana County",5,54,328,176,152
050,26,127,"Michigan","Oceana County",5,55,320,164,156
050,26,127,"Michigan","Oceana County",5,56,364,186,178
050,26,127,"Michigan","Oceana County",5,57,359,171,188
050,26,127,"Michigan","Oceana County",5,58,376,190,186
050,26,127,"Michigan","Oceana County",5,59,417,212,205
050,26,127,"Michigan","Oceana County",5,60,435,234,201
050,26,127,"Michigan","Oceana County",5,61,460,228,232
050,26,127,"Michigan","Oceana County",5,62,455,230,225
050,26,127,"Michigan","Oceana County",5,63,457,224,233
050,26,127,"Michigan","Oceana County",5,64,458,230,228
050,26,127,"Michigan","Oceana County",5,65,458,221,237
050,26,127,"Michigan","Oceana County",5,66,444,216,228
050,26,127,"Michigan","Oceana County",5,67,399,195,204
050,26,127,"Michigan","Oceana County",5,68,414,202,212
050,26,127,"Michigan","Oceana County",5,69,403,195,208
050,26,127,"Michigan","Oceana County",5,70,362,178,184
050,26,127,"Michigan","Oceana County",5,71,348,168,180
050,26,127,"Michigan","Oceana County",5,72,325,165,160
050,26,127,"Michigan","Oceana County",5,73,314,164,150
050,26,127,"Michigan","Oceana County",5,74,323,169,154
050,26,127,"Michigan","Oceana County",5,75,287,144,143
050,26,127,"Michigan","Oceana County",5,76,291,155,136
050,26,127,"Michigan","Oceana County",5,77,191,97,94
050,26,127,"Michigan","Oceana County",5,78,171,80,91
050,26,127,"Michigan","Oceana County",5,79,175,77,98
050,26,127,"Michigan","Oceana County",5,80,193,84,109
050,26,127,"Michigan","Oceana County",5,81,162,80,82
050,26,127,"Michigan","Oceana County",5,82,155,72,83
050,26,127,"Michigan","Oceana County",5,83,127,62,65
050,26,127,"Michigan","Oceana County",5,84,98,44,54
050,26,127,"Michigan","Oceana County",5,85,584,252,332
050,26,129,"Michigan","Ogemaw County",1,0,173,89,84
050,26,129,"Michigan","Ogemaw County",1,1,178,84,94
050,26,129,"Michigan","Ogemaw County",1,2,202,90,112
050,26,129,"Michigan","Ogemaw County",1,3,204,89,115
050,26,129,"Michigan","Ogemaw County",1,4,186,98,88
050,26,129,"Michigan","Ogemaw County",1,5,192,104,88
050,26,129,"Michigan","Ogemaw County",1,6,198,97,101
050,26,129,"Michigan","Ogemaw County",1,7,208,105,103
050,26,129,"Michigan","Ogemaw County",1,8,212,109,103
050,26,129,"Michigan","Ogemaw County",1,9,205,102,103
050,26,129,"Michigan","Ogemaw County",1,10,231,120,111
050,26,129,"Michigan","Ogemaw County",1,11,235,122,113
050,26,129,"Michigan","Ogemaw County",1,12,230,116,114
050,26,129,"Michigan","Ogemaw County",1,13,236,115,121
050,26,129,"Michigan","Ogemaw County",1,14,235,125,110
050,26,129,"Michigan","Ogemaw County",1,15,248,131,117
050,26,129,"Michigan","Ogemaw County",1,16,251,130,121
050,26,129,"Michigan","Ogemaw County",1,17,257,133,124
050,26,129,"Michigan","Ogemaw County",1,18,199,105,94
050,26,129,"Michigan","Ogemaw County",1,19,160,94,66
050,26,129,"Michigan","Ogemaw County",1,20,179,94,85
050,26,129,"Michigan","Ogemaw County",1,21,177,86,91
050,26,129,"Michigan","Ogemaw County",1,22,184,96,88
050,26,129,"Michigan","Ogemaw County",1,23,193,103,90
050,26,129,"Michigan","Ogemaw County",1,24,191,98,93
050,26,129,"Michigan","Ogemaw County",1,25,209,105,104
050,26,129,"Michigan","Ogemaw County",1,26,207,107,100
050,26,129,"Michigan","Ogemaw County",1,27,206,97,109
050,26,129,"Michigan","Ogemaw County",1,28,209,97,112
050,26,129,"Michigan","Ogemaw County",1,29,229,118,111
050,26,129,"Michigan","Ogemaw County",1,30,201,107,94
050,26,129,"Michigan","Ogemaw County",1,31,191,95,96
050,26,129,"Michigan","Ogemaw County",1,32,186,88,98
050,26,129,"Michigan","Ogemaw County",1,33,186,92,94
050,26,129,"Michigan","Ogemaw County",1,34,193,99,94
050,26,129,"Michigan","Ogemaw County",1,35,224,111,113
050,26,129,"Michigan","Ogemaw County",1,36,217,104,113
050,26,129,"Michigan","Ogemaw County",1,37,221,111,110
050,26,129,"Michigan","Ogemaw County",1,38,229,127,102
050,26,129,"Michigan","Ogemaw County",1,39,208,119,89
050,26,129,"Michigan","Ogemaw County",1,40,208,106,102
050,26,129,"Michigan","Ogemaw County",1,41,192,94,98
050,26,129,"Michigan","Ogemaw County",1,42,184,90,94
050,26,129,"Michigan","Ogemaw County",1,43,193,97,96
050,26,129,"Michigan","Ogemaw County",1,44,203,106,97
050,26,129,"Michigan","Ogemaw County",1,45,216,109,107
050,26,129,"Michigan","Ogemaw County",1,46,195,105,90
050,26,129,"Michigan","Ogemaw County",1,47,209,110,99
050,26,129,"Michigan","Ogemaw County",1,48,228,120,108
050,26,129,"Michigan","Ogemaw County",1,49,246,121,125
050,26,129,"Michigan","Ogemaw County",1,50,248,130,118
050,26,129,"Michigan","Ogemaw County",1,51,238,120,118
050,26,129,"Michigan","Ogemaw County",1,52,241,114,127
050,26,129,"Michigan","Ogemaw County",1,53,237,111,126
050,26,129,"Michigan","Ogemaw County",1,54,269,141,128
050,26,129,"Michigan","Ogemaw County",1,55,302,157,145
050,26,129,"Michigan","Ogemaw County",1,56,329,163,166
050,26,129,"Michigan","Ogemaw County",1,57,348,174,174
050,26,129,"Michigan","Ogemaw County",1,58,392,181,211
050,26,129,"Michigan","Ogemaw County",1,59,362,165,197
050,26,129,"Michigan","Ogemaw County",1,60,373,186,187
050,26,129,"Michigan","Ogemaw County",1,61,415,203,212
050,26,129,"Michigan","Ogemaw County",1,62,417,222,195
050,26,129,"Michigan","Ogemaw County",1,63,424,221,203
050,26,129,"Michigan","Ogemaw County",1,64,438,216,222
050,26,129,"Michigan","Ogemaw County",1,65,409,206,203
050,26,129,"Michigan","Ogemaw County",1,66,389,206,183
050,26,129,"Michigan","Ogemaw County",1,67,377,193,184
050,26,129,"Michigan","Ogemaw County",1,68,351,177,174
050,26,129,"Michigan","Ogemaw County",1,69,316,167,149
050,26,129,"Michigan","Ogemaw County",1,70,297,149,148
050,26,129,"Michigan","Ogemaw County",1,71,317,154,163
050,26,129,"Michigan","Ogemaw County",1,72,283,132,151
050,26,129,"Michigan","Ogemaw County",1,73,276,130,146
050,26,129,"Michigan","Ogemaw County",1,74,204,103,101
050,26,129,"Michigan","Ogemaw County",1,75,220,110,110
050,26,129,"Michigan","Ogemaw County",1,76,232,125,107
050,26,129,"Michigan","Ogemaw County",1,77,243,117,126
050,26,129,"Michigan","Ogemaw County",1,78,184,92,92
050,26,129,"Michigan","Ogemaw County",1,79,157,67,90
050,26,129,"Michigan","Ogemaw County",1,80,152,70,82
050,26,129,"Michigan","Ogemaw County",1,81,147,74,73
050,26,129,"Michigan","Ogemaw County",1,82,125,78,47
050,26,129,"Michigan","Ogemaw County",1,83,122,67,55
050,26,129,"Michigan","Ogemaw County",1,84,110,55,55
050,26,129,"Michigan","Ogemaw County",1,85,470,188,282
050,26,129,"Michigan","Ogemaw County",2,0,172,88,84
050,26,129,"Michigan","Ogemaw County",2,1,176,84,92
050,26,129,"Michigan","Ogemaw County",2,2,198,90,108
050,26,129,"Michigan","Ogemaw County",2,3,203,90,113
050,26,129,"Michigan","Ogemaw County",2,4,190,97,93
050,26,129,"Michigan","Ogemaw County",2,5,191,103,88
050,26,129,"Michigan","Ogemaw County",2,6,197,99,98
050,26,129,"Michigan","Ogemaw County",2,7,205,102,103
050,26,129,"Michigan","Ogemaw County",2,8,212,108,104
050,26,129,"Michigan","Ogemaw County",2,9,208,106,102
050,26,129,"Michigan","Ogemaw County",2,10,225,116,109
050,26,129,"Michigan","Ogemaw County",2,11,234,122,112
050,26,129,"Michigan","Ogemaw County",2,12,232,117,115
050,26,129,"Michigan","Ogemaw County",2,13,234,115,119
050,26,129,"Michigan","Ogemaw County",2,14,234,121,113
050,26,129,"Michigan","Ogemaw County",2,15,247,132,115
050,26,129,"Michigan","Ogemaw County",2,16,253,132,121
050,26,129,"Michigan","Ogemaw County",2,17,251,129,122
050,26,129,"Michigan","Ogemaw County",2,18,200,107,93
050,26,129,"Michigan","Ogemaw County",2,19,162,93,69
050,26,129,"Michigan","Ogemaw County",2,20,179,97,82
050,26,129,"Michigan","Ogemaw County",2,21,177,86,91
050,26,129,"Michigan","Ogemaw County",2,22,187,96,91
050,26,129,"Michigan","Ogemaw County",2,23,192,102,90
050,26,129,"Michigan","Ogemaw County",2,24,194,100,94
050,26,129,"Michigan","Ogemaw County",2,25,207,104,103
050,26,129,"Michigan","Ogemaw County",2,26,209,107,102
050,26,129,"Michigan","Ogemaw County",2,27,204,97,107
050,26,129,"Michigan","Ogemaw County",2,28,209,98,111
050,26,129,"Michigan","Ogemaw County",2,29,222,112,110
050,26,129,"Michigan","Ogemaw County",2,30,208,110,98
050,26,129,"Michigan","Ogemaw County",2,31,194,99,95
050,26,129,"Michigan","Ogemaw County",2,32,186,89,97
050,26,129,"Michigan","Ogemaw County",2,33,187,92,95
050,26,129,"Michigan","Ogemaw County",2,34,192,98,94
050,26,129,"Michigan","Ogemaw County",2,35,221,110,111
050,26,129,"Michigan","Ogemaw County",2,36,220,107,113
050,26,129,"Michigan","Ogemaw County",2,37,221,109,112
050,26,129,"Michigan","Ogemaw County",2,38,230,126,104
050,26,129,"Michigan","Ogemaw County",2,39,212,120,92
050,26,129,"Michigan","Ogemaw County",2,40,208,109,99
050,26,129,"Michigan","Ogemaw County",2,41,196,96,100
050,26,129,"Michigan","Ogemaw County",2,42,185,91,94
050,26,129,"Michigan","Ogemaw County",2,43,193,96,97
050,26,129,"Michigan","Ogemaw County",2,44,198,102,96
050,26,129,"Michigan","Ogemaw County",2,45,215,111,104
050,26,129,"Michigan","Ogemaw County",2,46,196,104,92
050,26,129,"Michigan","Ogemaw County",2,47,205,108,97
050,26,129,"Michigan","Ogemaw County",2,48,224,119,105
050,26,129,"Michigan","Ogemaw County",2,49,244,123,121
050,26,129,"Michigan","Ogemaw County",2,50,246,129,117
050,26,129,"Michigan","Ogemaw County",2,51,240,123,117
050,26,129,"Michigan","Ogemaw County",2,52,237,113,124
050,26,129,"Michigan","Ogemaw County",2,53,239,113,126
050,26,129,"Michigan","Ogemaw County",2,54,263,134,129
050,26,129,"Michigan","Ogemaw County",2,55,299,155,144
050,26,129,"Michigan","Ogemaw County",2,56,326,163,163
050,26,129,"Michigan","Ogemaw County",2,57,347,172,175
050,26,129,"Michigan","Ogemaw County",2,58,384,181,203
050,26,129,"Michigan","Ogemaw County",2,59,373,170,203
050,26,129,"Michigan","Ogemaw County",2,60,373,182,191
050,26,129,"Michigan","Ogemaw County",2,61,408,202,206
050,26,129,"Michigan","Ogemaw County",2,62,417,219,198
050,26,129,"Michigan","Ogemaw County",2,63,429,225,204
050,26,129,"Michigan","Ogemaw County",2,64,433,217,216
050,26,129,"Michigan","Ogemaw County",2,65,416,209,207
050,26,129,"Michigan","Ogemaw County",2,66,394,207,187
050,26,129,"Michigan","Ogemaw County",2,67,377,196,181
050,26,129,"Michigan","Ogemaw County",2,68,357,181,176
050,26,129,"Michigan","Ogemaw County",2,69,327,172,155
050,26,129,"Michigan","Ogemaw County",2,70,298,152,146
050,26,129,"Michigan","Ogemaw County",2,71,312,151,161
050,26,129,"Michigan","Ogemaw County",2,72,285,134,151
050,26,129,"Michigan","Ogemaw County",2,73,288,135,153
050,26,129,"Michigan","Ogemaw County",2,74,208,103,105
050,26,129,"Michigan","Ogemaw County",2,75,215,107,108
050,26,129,"Michigan","Ogemaw County",2,76,225,118,107
050,26,129,"Michigan","Ogemaw County",2,77,244,120,124
050,26,129,"Michigan","Ogemaw County",2,78,193,96,97
050,26,129,"Michigan","Ogemaw County",2,79,160,72,88
050,26,129,"Michigan","Ogemaw County",2,80,148,67,81
050,26,129,"Michigan","Ogemaw County",2,81,143,71,72
050,26,129,"Michigan","Ogemaw County",2,82,127,75,52
050,26,129,"Michigan","Ogemaw County",2,83,120,67,53
050,26,129,"Michigan","Ogemaw County",2,84,110,57,53
050,26,129,"Michigan","Ogemaw County",2,85,480,195,285
050,26,129,"Michigan","Ogemaw County",3,0,183,100,83
050,26,129,"Michigan","Ogemaw County",3,1,163,82,81
050,26,129,"Michigan","Ogemaw County",3,2,165,79,86
050,26,129,"Michigan","Ogemaw County",3,3,209,97,112
050,26,129,"Michigan","Ogemaw County",3,4,202,85,117
050,26,129,"Michigan","Ogemaw County",3,5,191,95,96
050,26,129,"Michigan","Ogemaw County",3,6,198,106,92
050,26,129,"Michigan","Ogemaw County",3,7,194,94,100
050,26,129,"Michigan","Ogemaw County",3,8,205,102,103
050,26,129,"Michigan","Ogemaw County",3,9,212,107,105
050,26,129,"Michigan","Ogemaw County",3,10,210,111,99
050,26,129,"Michigan","Ogemaw County",3,11,225,115,110
050,26,129,"Michigan","Ogemaw County",3,12,235,121,114
050,26,129,"Michigan","Ogemaw County",3,13,240,126,114
050,26,129,"Michigan","Ogemaw County",3,14,223,117,106
050,26,129,"Michigan","Ogemaw County",3,15,234,124,110
050,26,129,"Michigan","Ogemaw County",3,16,250,136,114
050,26,129,"Michigan","Ogemaw County",3,17,247,125,122
050,26,129,"Michigan","Ogemaw County",3,18,211,114,97
050,26,129,"Michigan","Ogemaw County",3,19,163,88,75
050,26,129,"Michigan","Ogemaw County",3,20,183,103,80
050,26,129,"Michigan","Ogemaw County",3,21,162,79,83
050,26,129,"Michigan","Ogemaw County",3,22,182,90,92
050,26,129,"Michigan","Ogemaw County",3,23,185,86,99
050,26,129,"Michigan","Ogemaw County",3,24,199,101,98
050,26,129,"Michigan","Ogemaw County",3,25,191,100,91
050,26,129,"Michigan","Ogemaw County",3,26,193,105,88
050,26,129,"Michigan","Ogemaw County",3,27,203,109,94
050,26,129,"Michigan","Ogemaw County",3,28,203,96,107
050,26,129,"Michigan","Ogemaw County",3,29,198,89,109
050,26,129,"Michigan","Ogemaw County",3,30,236,116,120
050,26,129,"Michigan","Ogemaw County",3,31,219,117,102
050,26,129,"Michigan","Ogemaw County",3,32,186,98,88
050,26,129,"Michigan","Ogemaw County",3,33,197,92,105
050,26,129,"Michigan","Ogemaw County",3,34,183,92,91
050,26,129,"Michigan","Ogemaw County",3,35,205,108,97
050,26,129,"Michigan","Ogemaw County",3,36,227,118,109
050,26,129,"Michigan","Ogemaw County",3,37,225,105,120
050,26,129,"Michigan","Ogemaw County",3,38,230,117,113
050,26,129,"Michigan","Ogemaw County",3,39,226,125,101
050,26,129,"Michigan","Ogemaw County",3,40,201,115,86
050,26,129,"Michigan","Ogemaw County",3,41,211,111,100
050,26,129,"Michigan","Ogemaw County",3,42,209,105,104
050,26,129,"Michigan","Ogemaw County",3,43,192,96,96
050,26,129,"Michigan","Ogemaw County",3,44,195,99,96
050,26,129,"Michigan","Ogemaw County",3,45,202,104,98
050,26,129,"Michigan","Ogemaw County",3,46,226,110,116
050,26,129,"Michigan","Ogemaw County",3,47,195,104,91
050,26,129,"Michigan","Ogemaw County",3,48,204,109,95
050,26,129,"Michigan","Ogemaw County",3,49,218,113,105
050,26,129,"Michigan","Ogemaw County",3,50,252,128,124
050,26,129,"Michigan","Ogemaw County",3,51,247,132,115
050,26,129,"Michigan","Ogemaw County",3,52,226,114,112
050,26,129,"Michigan","Ogemaw County",3,53,248,118,130
050,26,129,"Michigan","Ogemaw County",3,54,246,116,130
050,26,129,"Michigan","Ogemaw County",3,55,271,145,126
050,26,129,"Michigan","Ogemaw County",3,56,308,155,153
050,26,129,"Michigan","Ogemaw County",3,57,335,170,165
050,26,129,"Michigan","Ogemaw County",3,58,367,185,182
050,26,129,"Michigan","Ogemaw County",3,59,385,179,206
050,26,129,"Michigan","Ogemaw County",3,60,369,167,202
050,26,129,"Michigan","Ogemaw County",3,61,373,180,193
050,26,129,"Michigan","Ogemaw County",3,62,419,208,211
050,26,129,"Michigan","Ogemaw County",3,63,432,226,206
050,26,129,"Michigan","Ogemaw County",3,64,448,227,221
050,26,129,"Michigan","Ogemaw County",3,65,439,223,216
050,26,129,"Michigan","Ogemaw County",3,66,423,213,210
050,26,129,"Michigan","Ogemaw County",3,67,391,204,187
050,26,129,"Michigan","Ogemaw County",3,68,373,192,181
050,26,129,"Michigan","Ogemaw County",3,69,360,184,176
050,26,129,"Michigan","Ogemaw County",3,70,328,173,155
050,26,129,"Michigan","Ogemaw County",3,71,288,141,147
050,26,129,"Michigan","Ogemaw County",3,72,303,147,156
050,26,129,"Michigan","Ogemaw County",3,73,265,130,135
050,26,129,"Michigan","Ogemaw County",3,74,276,127,149
050,26,129,"Michigan","Ogemaw County",3,75,204,100,104
050,26,129,"Michigan","Ogemaw County",3,76,204,100,104
050,26,129,"Michigan","Ogemaw County",3,77,218,112,106
050,26,129,"Michigan","Ogemaw County",3,78,228,114,114
050,26,129,"Michigan","Ogemaw County",3,79,185,95,90
050,26,129,"Michigan","Ogemaw County",3,80,146,64,82
050,26,129,"Michigan","Ogemaw County",3,81,132,59,73
050,26,129,"Michigan","Ogemaw County",3,82,131,66,65
050,26,129,"Michigan","Ogemaw County",3,83,116,69,47
050,26,129,"Michigan","Ogemaw County",3,84,105,59,46
050,26,129,"Michigan","Ogemaw County",3,85,487,201,286
050,26,129,"Michigan","Ogemaw County",4,0,179,105,74
050,26,129,"Michigan","Ogemaw County",4,1,192,91,101
050,26,129,"Michigan","Ogemaw County",4,2,161,83,78
050,26,129,"Michigan","Ogemaw County",4,3,188,88,100
050,26,129,"Michigan","Ogemaw County",4,4,213,97,116
050,26,129,"Michigan","Ogemaw County",4,5,205,85,120
050,26,129,"Michigan","Ogemaw County",4,6,190,97,93
050,26,129,"Michigan","Ogemaw County",4,7,202,110,92
050,26,129,"Michigan","Ogemaw County",4,8,207,107,100
050,26,129,"Michigan","Ogemaw County",4,9,219,111,108
050,26,129,"Michigan","Ogemaw County",4,10,227,115,112
050,26,129,"Michigan","Ogemaw County",4,11,215,111,104
050,26,129,"Michigan","Ogemaw County",4,12,224,113,111
050,26,129,"Michigan","Ogemaw County",4,13,232,120,112
050,26,129,"Michigan","Ogemaw County",4,14,233,121,112
050,26,129,"Michigan","Ogemaw County",4,15,223,109,114
050,26,129,"Michigan","Ogemaw County",4,16,229,117,112
050,26,129,"Michigan","Ogemaw County",4,17,247,133,114
050,26,129,"Michigan","Ogemaw County",4,18,202,106,96
050,26,129,"Michigan","Ogemaw County",4,19,169,90,79
050,26,129,"Michigan","Ogemaw County",4,20,181,102,79
050,26,129,"Michigan","Ogemaw County",4,21,167,89,78
050,26,129,"Michigan","Ogemaw County",4,22,186,90,96
050,26,129,"Michigan","Ogemaw County",4,23,190,87,103
050,26,129,"Michigan","Ogemaw County",4,24,188,93,95
050,26,129,"Michigan","Ogemaw County",4,25,191,94,97
050,26,129,"Michigan","Ogemaw County",4,26,210,114,96
050,26,129,"Michigan","Ogemaw County",4,27,192,105,87
050,26,129,"Michigan","Ogemaw County",4,28,200,109,91
050,26,129,"Michigan","Ogemaw County",4,29,201,94,107
050,26,129,"Michigan","Ogemaw County",4,30,207,96,111
050,26,129,"Michigan","Ogemaw County",4,31,248,124,124
050,26,129,"Michigan","Ogemaw County",4,32,230,123,107
050,26,129,"Michigan","Ogemaw County",4,33,192,97,95
050,26,129,"Michigan","Ogemaw County",4,34,194,90,104
050,26,129,"Michigan","Ogemaw County",4,35,193,100,93
050,26,129,"Michigan","Ogemaw County",4,36,221,119,102
050,26,129,"Michigan","Ogemaw County",4,37,241,121,120
050,26,129,"Michigan","Ogemaw County",4,38,236,111,125
050,26,129,"Michigan","Ogemaw County",4,39,230,123,107
050,26,129,"Michigan","Ogemaw County",4,40,225,119,106
050,26,129,"Michigan","Ogemaw County",4,41,213,121,92
050,26,129,"Michigan","Ogemaw County",4,42,217,116,101
050,26,129,"Michigan","Ogemaw County",4,43,202,105,97
050,26,129,"Michigan","Ogemaw County",4,44,192,98,94
050,26,129,"Michigan","Ogemaw County",4,45,211,109,102
050,26,129,"Michigan","Ogemaw County",4,46,212,109,103
050,26,129,"Michigan","Ogemaw County",4,47,220,107,113
050,26,129,"Michigan","Ogemaw County",4,48,200,105,95
050,26,129,"Michigan","Ogemaw County",4,49,210,110,100
050,26,129,"Michigan","Ogemaw County",4,50,217,112,105
050,26,129,"Michigan","Ogemaw County",4,51,249,125,124
050,26,129,"Michigan","Ogemaw County",4,52,247,130,117
050,26,129,"Michigan","Ogemaw County",4,53,245,121,124
050,26,129,"Michigan","Ogemaw County",4,54,248,115,133
050,26,129,"Michigan","Ogemaw County",4,55,250,122,128
050,26,129,"Michigan","Ogemaw County",4,56,273,146,127
050,26,129,"Michigan","Ogemaw County",4,57,311,153,158
050,26,129,"Michigan","Ogemaw County",4,58,332,174,158
050,26,129,"Michigan","Ogemaw County",4,59,371,187,184
050,26,129,"Michigan","Ogemaw County",4,60,400,190,210
050,26,129,"Michigan","Ogemaw County",4,61,390,175,215
050,26,129,"Michigan","Ogemaw County",4,62,381,185,196
050,26,129,"Michigan","Ogemaw County",4,63,433,216,217
050,26,129,"Michigan","Ogemaw County",4,64,428,222,206
050,26,129,"Michigan","Ogemaw County",4,65,451,229,222
050,26,129,"Michigan","Ogemaw County",4,66,441,229,212
050,26,129,"Michigan","Ogemaw County",4,67,437,219,218
050,26,129,"Michigan","Ogemaw County",4,68,401,207,194
050,26,129,"Michigan","Ogemaw County",4,69,367,190,177
050,26,129,"Michigan","Ogemaw County",4,70,362,186,176
050,26,129,"Michigan","Ogemaw County",4,71,322,173,149
050,26,129,"Michigan","Ogemaw County",4,72,275,132,143
050,26,129,"Michigan","Ogemaw County",4,73,282,136,146
050,26,129,"Michigan","Ogemaw County",4,74,261,126,135
050,26,129,"Michigan","Ogemaw County",4,75,266,118,148
050,26,129,"Michigan","Ogemaw County",4,76,195,96,99
050,26,129,"Michigan","Ogemaw County",4,77,188,91,97
050,26,129,"Michigan","Ogemaw County",4,78,204,104,100
050,26,129,"Michigan","Ogemaw County",4,79,202,102,100
050,26,129,"Michigan","Ogemaw County",4,80,162,83,79
050,26,129,"Michigan","Ogemaw County",4,81,132,59,73
050,26,129,"Michigan","Ogemaw County",4,82,114,47,67
050,26,129,"Michigan","Ogemaw County",4,83,129,61,68
050,26,129,"Michigan","Ogemaw County",4,84,98,58,40
050,26,129,"Michigan","Ogemaw County",4,85,498,218,280
050,26,129,"Michigan","Ogemaw County",5,0,178,102,76
050,26,129,"Michigan","Ogemaw County",5,1,186,111,75
050,26,129,"Michigan","Ogemaw County",5,2,191,94,97
050,26,129,"Michigan","Ogemaw County",5,3,172,89,83
050,26,129,"Michigan","Ogemaw County",5,4,187,92,95
050,26,129,"Michigan","Ogemaw County",5,5,206,91,115
050,26,129,"Michigan","Ogemaw County",5,6,210,85,125
050,26,129,"Michigan","Ogemaw County",5,7,192,96,96
050,26,129,"Michigan","Ogemaw County",5,8,208,116,92
050,26,129,"Michigan","Ogemaw County",5,9,188,94,94
050,26,129,"Michigan","Ogemaw County",5,10,216,108,108
050,26,129,"Michigan","Ogemaw County",5,11,219,114,105
050,26,129,"Michigan","Ogemaw County",5,12,214,117,97
050,26,129,"Michigan","Ogemaw County",5,13,228,118,110
050,26,129,"Michigan","Ogemaw County",5,14,236,119,117
050,26,129,"Michigan","Ogemaw County",5,15,244,123,121
050,26,129,"Michigan","Ogemaw County",5,16,219,110,109
050,26,129,"Michigan","Ogemaw County",5,17,226,114,112
050,26,129,"Michigan","Ogemaw County",5,18,204,118,86
050,26,129,"Michigan","Ogemaw County",5,19,169,94,75
050,26,129,"Michigan","Ogemaw County",5,20,191,96,95
050,26,129,"Michigan","Ogemaw County",5,21,183,99,84
050,26,129,"Michigan","Ogemaw County",5,22,170,88,82
050,26,129,"Michigan","Ogemaw County",5,23,189,90,99
050,26,129,"Michigan","Ogemaw County",5,24,195,90,105
050,26,129,"Michigan","Ogemaw County",5,25,184,98,86
050,26,129,"Michigan","Ogemaw County",5,26,187,91,96
050,26,129,"Michigan","Ogemaw County",5,27,210,113,97
050,26,129,"Michigan","Ogemaw County",5,28,191,109,82
050,26,129,"Michigan","Ogemaw County",5,29,197,105,92
050,26,129,"Michigan","Ogemaw County",5,30,221,107,114
050,26,129,"Michigan","Ogemaw County",5,31,222,104,118
050,26,129,"Michigan","Ogemaw County",5,32,236,114,122
050,26,129,"Michigan","Ogemaw County",5,33,239,119,120
050,26,129,"Michigan","Ogemaw County",5,34,196,94,102
050,26,129,"Michigan","Ogemaw County",5,35,210,102,108
050,26,129,"Michigan","Ogemaw County",5,36,203,111,92
050,26,129,"Michigan","Ogemaw County",5,37,212,114,98
050,26,129,"Michigan","Ogemaw County",5,38,237,125,112
050,26,129,"Michigan","Ogemaw County",5,39,234,116,118
050,26,129,"Michigan","Ogemaw County",5,40,232,123,109
050,26,129,"Michigan","Ogemaw County",5,41,230,119,111
050,26,129,"Michigan","Ogemaw County",5,42,212,121,91
050,26,129,"Michigan","Ogemaw County",5,43,210,106,104
050,26,129,"Michigan","Ogemaw County",5,44,204,103,101
050,26,129,"Michigan","Ogemaw County",5,45,203,101,102
050,26,129,"Michigan","Ogemaw County",5,46,221,109,112
050,26,129,"Michigan","Ogemaw County",5,47,207,105,102
050,26,129,"Michigan","Ogemaw County",5,48,227,111,116
050,26,129,"Michigan","Ogemaw County",5,49,200,105,95
050,26,129,"Michigan","Ogemaw County",5,50,216,112,104
050,26,129,"Michigan","Ogemaw County",5,51,213,110,103
050,26,129,"Michigan","Ogemaw County",5,52,266,135,131
050,26,129,"Michigan","Ogemaw County",5,53,258,132,126
050,26,129,"Michigan","Ogemaw County",5,54,247,123,124
050,26,129,"Michigan","Ogemaw County",5,55,259,127,132
050,26,129,"Michigan","Ogemaw County",5,56,259,124,135
050,26,129,"Michigan","Ogemaw County",5,57,284,154,130
050,26,129,"Michigan","Ogemaw County",5,58,313,160,153
050,26,129,"Michigan","Ogemaw County",5,59,340,177,163
050,26,129,"Michigan","Ogemaw County",5,60,381,186,195
050,26,129,"Michigan","Ogemaw County",5,61,412,191,221
050,26,129,"Michigan","Ogemaw County",5,62,411,190,221
050,26,129,"Michigan","Ogemaw County",5,63,397,196,201
050,26,129,"Michigan","Ogemaw County",5,64,444,222,222
050,26,129,"Michigan","Ogemaw County",5,65,430,227,203
050,26,129,"Michigan","Ogemaw County",5,66,458,237,221
050,26,129,"Michigan","Ogemaw County",5,67,434,225,209
050,26,129,"Michigan","Ogemaw County",5,68,439,219,220
050,26,129,"Michigan","Ogemaw County",5,69,383,197,186
050,26,129,"Michigan","Ogemaw County",5,70,368,196,172
050,26,129,"Michigan","Ogemaw County",5,71,359,184,175
050,26,129,"Michigan","Ogemaw County",5,72,313,167,146
050,26,129,"Michigan","Ogemaw County",5,73,264,130,134
050,26,129,"Michigan","Ogemaw County",5,74,273,134,139
050,26,129,"Michigan","Ogemaw County",5,75,244,115,129
050,26,129,"Michigan","Ogemaw County",5,76,262,119,143
050,26,129,"Michigan","Ogemaw County",5,77,189,91,98
050,26,129,"Michigan","Ogemaw County",5,78,172,85,87
050,26,129,"Michigan","Ogemaw County",5,79,187,99,88
050,26,129,"Michigan","Ogemaw County",5,80,188,96,92
050,26,129,"Michigan","Ogemaw County",5,81,149,75,74
050,26,129,"Michigan","Ogemaw County",5,82,116,50,66
050,26,129,"Michigan","Ogemaw County",5,83,109,45,64
050,26,129,"Michigan","Ogemaw County",5,84,108,49,59
050,26,129,"Michigan","Ogemaw County",5,85,499,231,268
050,26,131,"Michigan","Ontonagon County",1,0,23,12,11
050,26,131,"Michigan","Ontonagon County",1,1,28,14,14
050,26,131,"Michigan","Ontonagon County",1,2,34,20,14
050,26,131,"Michigan","Ontonagon County",1,3,36,17,19
050,26,131,"Michigan","Ontonagon County",1,4,42,24,18
050,26,131,"Michigan","Ontonagon County",1,5,25,12,13
050,26,131,"Michigan","Ontonagon County",1,6,33,12,21
050,26,131,"Michigan","Ontonagon County",1,7,31,16,15
050,26,131,"Michigan","Ontonagon County",1,8,33,11,22
050,26,131,"Michigan","Ontonagon County",1,9,36,19,17
050,26,131,"Michigan","Ontonagon County",1,10,36,25,11
050,26,131,"Michigan","Ontonagon County",1,11,34,17,17
050,26,131,"Michigan","Ontonagon County",1,12,51,26,25
050,26,131,"Michigan","Ontonagon County",1,13,54,37,17
050,26,131,"Michigan","Ontonagon County",1,14,53,30,23
050,26,131,"Michigan","Ontonagon County",1,15,58,24,34
050,26,131,"Michigan","Ontonagon County",1,16,61,31,30
050,26,131,"Michigan","Ontonagon County",1,17,49,20,29
050,26,131,"Michigan","Ontonagon County",1,18,47,20,27
050,26,131,"Michigan","Ontonagon County",1,19,38,20,18
050,26,131,"Michigan","Ontonagon County",1,20,39,24,15
050,26,131,"Michigan","Ontonagon County",1,21,37,23,14
050,26,131,"Michigan","Ontonagon County",1,22,34,17,17
050,26,131,"Michigan","Ontonagon County",1,23,36,18,18
050,26,131,"Michigan","Ontonagon County",1,24,41,17,24
050,26,131,"Michigan","Ontonagon County",1,25,37,19,18
050,26,131,"Michigan","Ontonagon County",1,26,35,18,17
050,26,131,"Michigan","Ontonagon County",1,27,24,13,11
050,26,131,"Michigan","Ontonagon County",1,28,27,11,16
050,26,131,"Michigan","Ontonagon County",1,29,35,19,16
050,26,131,"Michigan","Ontonagon County",1,30,32,20,12
050,26,131,"Michigan","Ontonagon County",1,31,28,17,11
050,26,131,"Michigan","Ontonagon County",1,32,36,15,21
050,26,131,"Michigan","Ontonagon County",1,33,35,20,15
050,26,131,"Michigan","Ontonagon County",1,34,36,19,17
050,26,131,"Michigan","Ontonagon County",1,35,31,17,14
050,26,131,"Michigan","Ontonagon County",1,36,44,27,17
050,26,131,"Michigan","Ontonagon County",1,37,41,22,19
050,26,131,"Michigan","Ontonagon County",1,38,41,19,22
050,26,131,"Michigan","Ontonagon County",1,39,50,20,30
050,26,131,"Michigan","Ontonagon County",1,40,45,26,19
050,26,131,"Michigan","Ontonagon County",1,41,48,27,21
050,26,131,"Michigan","Ontonagon County",1,42,46,25,21
050,26,131,"Michigan","Ontonagon County",1,43,44,24,20
050,26,131,"Michigan","Ontonagon County",1,44,45,23,22
050,26,131,"Michigan","Ontonagon County",1,45,54,24,30
050,26,131,"Michigan","Ontonagon County",1,46,55,29,26
050,26,131,"Michigan","Ontonagon County",1,47,57,30,27
050,26,131,"Michigan","Ontonagon County",1,48,66,36,30
050,26,131,"Michigan","Ontonagon County",1,49,65,28,37
050,26,131,"Michigan","Ontonagon County",1,50,70,35,35
050,26,131,"Michigan","Ontonagon County",1,51,78,43,35
050,26,131,"Michigan","Ontonagon County",1,52,71,35,36
050,26,131,"Michigan","Ontonagon County",1,53,72,29,43
050,26,131,"Michigan","Ontonagon County",1,54,82,41,41
050,26,131,"Michigan","Ontonagon County",1,55,109,58,51
050,26,131,"Michigan","Ontonagon County",1,56,109,55,54
050,26,131,"Michigan","Ontonagon County",1,57,118,57,61
050,26,131,"Michigan","Ontonagon County",1,58,116,56,60
050,26,131,"Michigan","Ontonagon County",1,59,124,66,58
050,26,131,"Michigan","Ontonagon County",1,60,128,64,64
050,26,131,"Michigan","Ontonagon County",1,61,137,69,68
050,26,131,"Michigan","Ontonagon County",1,62,137,73,64
050,26,131,"Michigan","Ontonagon County",1,63,119,59,60
050,26,131,"Michigan","Ontonagon County",1,64,122,62,60
050,26,131,"Michigan","Ontonagon County",1,65,141,75,66
050,26,131,"Michigan","Ontonagon County",1,66,154,80,74
050,26,131,"Michigan","Ontonagon County",1,67,148,75,73
050,26,131,"Michigan","Ontonagon County",1,68,136,75,61
050,26,131,"Michigan","Ontonagon County",1,69,128,76,52
050,26,131,"Michigan","Ontonagon County",1,70,132,74,58
050,26,131,"Michigan","Ontonagon County",1,71,133,77,56
050,26,131,"Michigan","Ontonagon County",1,72,114,67,47
050,26,131,"Michigan","Ontonagon County",1,73,112,59,53
050,26,131,"Michigan","Ontonagon County",1,74,93,45,48
050,26,131,"Michigan","Ontonagon County",1,75,90,46,44
050,26,131,"Michigan","Ontonagon County",1,76,88,42,46
050,26,131,"Michigan","Ontonagon County",1,77,86,45,41
050,26,131,"Michigan","Ontonagon County",1,78,78,40,38
050,26,131,"Michigan","Ontonagon County",1,79,71,34,37
050,26,131,"Michigan","Ontonagon County",1,80,67,33,34
050,26,131,"Michigan","Ontonagon County",1,81,65,36,29
050,26,131,"Michigan","Ontonagon County",1,82,61,37,24
050,26,131,"Michigan","Ontonagon County",1,83,47,24,23
050,26,131,"Michigan","Ontonagon County",1,84,41,20,21
050,26,131,"Michigan","Ontonagon County",1,85,190,70,120
050,26,131,"Michigan","Ontonagon County",2,0,27,16,11
050,26,131,"Michigan","Ontonagon County",2,1,28,14,14
050,26,131,"Michigan","Ontonagon County",2,2,32,19,13
050,26,131,"Michigan","Ontonagon County",2,3,36,18,18
050,26,131,"Michigan","Ontonagon County",2,4,40,22,18
050,26,131,"Michigan","Ontonagon County",2,5,29,15,14
050,26,131,"Michigan","Ontonagon County",2,6,32,12,20
050,26,131,"Michigan","Ontonagon County",2,7,32,15,17
050,26,131,"Michigan","Ontonagon County",2,8,34,12,22
050,26,131,"Michigan","Ontonagon County",2,9,35,17,18
050,26,131,"Michigan","Ontonagon County",2,10,36,23,13
050,26,131,"Michigan","Ontonagon County",2,11,34,19,15
050,26,131,"Michigan","Ontonagon County",2,12,46,24,22
050,26,131,"Michigan","Ontonagon County",2,13,52,34,18
050,26,131,"Michigan","Ontonagon County",2,14,54,32,22
050,26,131,"Michigan","Ontonagon County",2,15,56,25,31
050,26,131,"Michigan","Ontonagon County",2,16,61,30,31
050,26,131,"Michigan","Ontonagon County",2,17,52,23,29
050,26,131,"Michigan","Ontonagon County",2,18,44,19,25
050,26,131,"Michigan","Ontonagon County",2,19,38,20,18
050,26,131,"Michigan","Ontonagon County",2,20,39,23,16
050,26,131,"Michigan","Ontonagon County",2,21,37,23,14
050,26,131,"Michigan","Ontonagon County",2,22,36,19,17
050,26,131,"Michigan","Ontonagon County",2,23,36,18,18
050,26,131,"Michigan","Ontonagon County",2,24,40,18,22
050,26,131,"Michigan","Ontonagon County",2,25,39,19,20
050,26,131,"Michigan","Ontonagon County",2,26,36,19,17
050,26,131,"Michigan","Ontonagon County",2,27,27,14,13
050,26,131,"Michigan","Ontonagon County",2,28,27,12,15
050,26,131,"Michigan","Ontonagon County",2,29,32,17,15
050,26,131,"Michigan","Ontonagon County",2,30,34,21,13
050,26,131,"Michigan","Ontonagon County",2,31,30,18,12
050,26,131,"Michigan","Ontonagon County",2,32,35,16,19
050,26,131,"Michigan","Ontonagon County",2,33,34,18,16
050,26,131,"Michigan","Ontonagon County",2,34,36,19,17
050,26,131,"Michigan","Ontonagon County",2,35,34,19,15
050,26,131,"Michigan","Ontonagon County",2,36,40,24,16
050,26,131,"Michigan","Ontonagon County",2,37,41,23,18
050,26,131,"Michigan","Ontonagon County",2,38,42,20,22
050,26,131,"Michigan","Ontonagon County",2,39,49,20,29
050,26,131,"Michigan","Ontonagon County",2,40,47,25,22
050,26,131,"Michigan","Ontonagon County",2,41,47,26,21
050,26,131,"Michigan","Ontonagon County",2,42,46,25,21
050,26,131,"Michigan","Ontonagon County",2,43,46,25,21
050,26,131,"Michigan","Ontonagon County",2,44,44,23,21
050,26,131,"Michigan","Ontonagon County",2,45,52,24,28
050,26,131,"Michigan","Ontonagon County",2,46,55,28,27
050,26,131,"Michigan","Ontonagon County",2,47,56,29,27
050,26,131,"Michigan","Ontonagon County",2,48,64,35,29
050,26,131,"Michigan","Ontonagon County",2,49,65,30,35
050,26,131,"Michigan","Ontonagon County",2,50,70,34,36
050,26,131,"Michigan","Ontonagon County",2,51,77,42,35
050,26,131,"Michigan","Ontonagon County",2,52,73,37,36
050,26,131,"Michigan","Ontonagon County",2,53,72,31,41
050,26,131,"Michigan","Ontonagon County",2,54,79,38,41
050,26,131,"Michigan","Ontonagon County",2,55,102,54,48
050,26,131,"Michigan","Ontonagon County",2,56,109,55,54
050,26,131,"Michigan","Ontonagon County",2,57,117,56,61
050,26,131,"Michigan","Ontonagon County",2,58,115,55,60
050,26,131,"Michigan","Ontonagon County",2,59,125,65,60
050,26,131,"Michigan","Ontonagon County",2,60,125,62,63
050,26,131,"Michigan","Ontonagon County",2,61,136,69,67
050,26,131,"Michigan","Ontonagon County",2,62,136,71,65
050,26,131,"Michigan","Ontonagon County",2,63,127,64,63
050,26,131,"Michigan","Ontonagon County",2,64,122,61,61
050,26,131,"Michigan","Ontonagon County",2,65,137,72,65
050,26,131,"Michigan","Ontonagon County",2,66,150,79,71
050,26,131,"Michigan","Ontonagon County",2,67,149,76,73
050,26,131,"Michigan","Ontonagon County",2,68,137,76,61
050,26,131,"Michigan","Ontonagon County",2,69,127,74,53
050,26,131,"Michigan","Ontonagon County",2,70,130,74,56
050,26,131,"Michigan","Ontonagon County",2,71,133,76,57
050,26,131,"Michigan","Ontonagon County",2,72,116,67,49
050,26,131,"Michigan","Ontonagon County",2,73,117,63,54
050,26,131,"Michigan","Ontonagon County",2,74,91,46,45
050,26,131,"Michigan","Ontonagon County",2,75,89,44,45
050,26,131,"Michigan","Ontonagon County",2,76,87,42,45
050,26,131,"Michigan","Ontonagon County",2,77,89,46,43
050,26,131,"Michigan","Ontonagon County",2,78,79,41,38
050,26,131,"Michigan","Ontonagon County",2,79,69,33,36
050,26,131,"Michigan","Ontonagon County",2,80,67,33,34
050,26,131,"Michigan","Ontonagon County",2,81,64,35,29
050,26,131,"Michigan","Ontonagon County",2,82,61,37,24
050,26,131,"Michigan","Ontonagon County",2,83,48,25,23
050,26,131,"Michigan","Ontonagon County",2,84,42,21,21
050,26,131,"Michigan","Ontonagon County",2,85,193,72,121
050,26,131,"Michigan","Ontonagon County",3,0,32,14,18
050,26,131,"Michigan","Ontonagon County",3,1,34,21,13
050,26,131,"Michigan","Ontonagon County",3,2,32,17,15
050,26,131,"Michigan","Ontonagon County",3,3,29,16,13
050,26,131,"Michigan","Ontonagon County",3,4,34,17,17
050,26,131,"Michigan","Ontonagon County",3,5,38,19,19
050,26,131,"Michigan","Ontonagon County",3,6,30,15,15
050,26,131,"Michigan","Ontonagon County",3,7,36,13,23
050,26,131,"Michigan","Ontonagon County",3,8,33,14,19
050,26,131,"Michigan","Ontonagon County",3,9,38,13,25
050,26,131,"Michigan","Ontonagon County",3,10,39,19,20
050,26,131,"Michigan","Ontonagon County",3,11,40,23,17
050,26,131,"Michigan","Ontonagon County",3,12,42,25,17
050,26,131,"Michigan","Ontonagon County",3,13,48,24,24
050,26,131,"Michigan","Ontonagon County",3,14,59,36,23
050,26,131,"Michigan","Ontonagon County",3,15,56,33,23
050,26,131,"Michigan","Ontonagon County",3,16,57,25,32
050,26,131,"Michigan","Ontonagon County",3,17,60,30,30
050,26,131,"Michigan","Ontonagon County",3,18,46,23,23
050,26,131,"Michigan","Ontonagon County",3,19,33,14,19
050,26,131,"Michigan","Ontonagon County",3,20,41,23,18
050,26,131,"Michigan","Ontonagon County",3,21,41,24,17
050,26,131,"Michigan","Ontonagon County",3,22,39,22,17
050,26,131,"Michigan","Ontonagon County",3,23,37,19,18
050,26,131,"Michigan","Ontonagon County",3,24,38,19,19
050,26,131,"Michigan","Ontonagon County",3,25,40,20,20
050,26,131,"Michigan","Ontonagon County",3,26,45,22,23
050,26,131,"Michigan","Ontonagon County",3,27,40,20,20
050,26,131,"Michigan","Ontonagon County",3,28,34,17,17
050,26,131,"Michigan","Ontonagon County",3,29,30,13,17
050,26,131,"Michigan","Ontonagon County",3,30,33,19,14
050,26,131,"Michigan","Ontonagon County",3,31,34,21,13
050,26,131,"Michigan","Ontonagon County",3,32,32,18,14
050,26,131,"Michigan","Ontonagon County",3,33,40,16,24
050,26,131,"Michigan","Ontonagon County",3,34,36,18,18
050,26,131,"Michigan","Ontonagon County",3,35,39,22,17
050,26,131,"Michigan","Ontonagon County",3,36,33,17,16
050,26,131,"Michigan","Ontonagon County",3,37,40,25,15
050,26,131,"Michigan","Ontonagon County",3,38,43,24,19
050,26,131,"Michigan","Ontonagon County",3,39,54,26,28
050,26,131,"Michigan","Ontonagon County",3,40,58,24,34
050,26,131,"Michigan","Ontonagon County",3,41,51,27,24
050,26,131,"Michigan","Ontonagon County",3,42,46,26,20
050,26,131,"Michigan","Ontonagon County",3,43,54,31,23
050,26,131,"Michigan","Ontonagon County",3,44,47,25,22
050,26,131,"Michigan","Ontonagon County",3,45,42,23,19
050,26,131,"Michigan","Ontonagon County",3,46,52,24,28
050,26,131,"Michigan","Ontonagon County",3,47,64,32,32
050,26,131,"Michigan","Ontonagon County",3,48,58,30,28
050,26,131,"Michigan","Ontonagon County",3,49,63,34,29
050,26,131,"Michigan","Ontonagon County",3,50,67,32,35
050,26,131,"Michigan","Ontonagon County",3,51,73,35,38
050,26,131,"Michigan","Ontonagon County",3,52,76,40,36
050,26,131,"Michigan","Ontonagon County",3,53,76,40,36
050,26,131,"Michigan","Ontonagon County",3,54,72,30,42
050,26,131,"Michigan","Ontonagon County",3,55,82,40,42
050,26,131,"Michigan","Ontonagon County",3,56,106,52,54
050,26,131,"Michigan","Ontonagon County",3,57,107,54,53
050,26,131,"Michigan","Ontonagon County",3,58,120,59,61
050,26,131,"Michigan","Ontonagon County",3,59,113,53,60
050,26,131,"Michigan","Ontonagon County",3,60,132,67,65
050,26,131,"Michigan","Ontonagon County",3,61,123,61,62
050,26,131,"Michigan","Ontonagon County",3,62,141,72,69
050,26,131,"Michigan","Ontonagon County",3,63,147,74,73
050,26,131,"Michigan","Ontonagon County",3,64,130,65,65
050,26,131,"Michigan","Ontonagon County",3,65,128,65,63
050,26,131,"Michigan","Ontonagon County",3,66,140,72,68
050,26,131,"Michigan","Ontonagon County",3,67,147,79,68
050,26,131,"Michigan","Ontonagon County",3,68,153,82,71
050,26,131,"Michigan","Ontonagon County",3,69,130,70,60
050,26,131,"Michigan","Ontonagon County",3,70,125,74,51
050,26,131,"Michigan","Ontonagon County",3,71,129,76,53
050,26,131,"Michigan","Ontonagon County",3,72,127,72,55
050,26,131,"Michigan","Ontonagon County",3,73,111,64,47
050,26,131,"Michigan","Ontonagon County",3,74,110,61,49
050,26,131,"Michigan","Ontonagon County",3,75,90,46,44
050,26,131,"Michigan","Ontonagon County",3,76,89,44,45
050,26,131,"Michigan","Ontonagon County",3,77,80,38,42
050,26,131,"Michigan","Ontonagon County",3,78,91,47,44
050,26,131,"Michigan","Ontonagon County",3,79,73,38,35
050,26,131,"Michigan","Ontonagon County",3,80,61,28,33
050,26,131,"Michigan","Ontonagon County",3,81,59,30,29
050,26,131,"Michigan","Ontonagon County",3,82,59,33,26
050,26,131,"Michigan","Ontonagon County",3,83,52,30,22
050,26,131,"Michigan","Ontonagon County",3,84,41,20,21
050,26,131,"Michigan","Ontonagon County",3,85,190,72,118
050,26,131,"Michigan","Ontonagon County",4,0,32,15,17
050,26,131,"Michigan","Ontonagon County",4,1,35,19,16
050,26,131,"Michigan","Ontonagon County",4,2,37,22,15
050,26,131,"Michigan","Ontonagon County",4,3,35,21,14
050,26,131,"Michigan","Ontonagon County",4,4,30,16,14
050,26,131,"Michigan","Ontonagon County",4,5,34,17,17
050,26,131,"Michigan","Ontonagon County",4,6,40,19,21
050,26,131,"Michigan","Ontonagon County",4,7,36,17,19
050,26,131,"Michigan","Ontonagon County",4,8,39,13,26
050,26,131,"Michigan","Ontonagon County",4,9,38,15,23
050,26,131,"Michigan","Ontonagon County",4,10,42,14,28
050,26,131,"Michigan","Ontonagon County",4,11,42,21,21
050,26,131,"Michigan","Ontonagon County",4,12,44,24,20
050,26,131,"Michigan","Ontonagon County",4,13,47,28,19
050,26,131,"Michigan","Ontonagon County",4,14,50,25,25
050,26,131,"Michigan","Ontonagon County",4,15,60,40,20
050,26,131,"Michigan","Ontonagon County",4,16,57,34,23
050,26,131,"Michigan","Ontonagon County",4,17,54,25,29
050,26,131,"Michigan","Ontonagon County",4,18,53,26,27
050,26,131,"Michigan","Ontonagon County",4,19,33,16,17
050,26,131,"Michigan","Ontonagon County",4,20,32,14,18
050,26,131,"Michigan","Ontonagon County",4,21,40,24,16
050,26,131,"Michigan","Ontonagon County",4,22,38,21,17
050,26,131,"Michigan","Ontonagon County",4,23,38,22,16
050,26,131,"Michigan","Ontonagon County",4,24,34,20,14
050,26,131,"Michigan","Ontonagon County",4,25,38,20,18
050,26,131,"Michigan","Ontonagon County",4,26,44,25,19
050,26,131,"Michigan","Ontonagon County",4,27,45,23,22
050,26,131,"Michigan","Ontonagon County",4,28,40,20,20
050,26,131,"Michigan","Ontonagon County",4,29,44,22,22
050,26,131,"Michigan","Ontonagon County",4,30,29,12,17
050,26,131,"Michigan","Ontonagon County",4,31,34,20,14
050,26,131,"Michigan","Ontonagon County",4,32,39,25,14
050,26,131,"Michigan","Ontonagon County",4,33,35,19,16
050,26,131,"Michigan","Ontonagon County",4,34,40,18,22
050,26,131,"Michigan","Ontonagon County",4,35,44,20,24
050,26,131,"Michigan","Ontonagon County",4,36,47,26,21
050,26,131,"Michigan","Ontonagon County",4,37,35,18,17
050,26,131,"Michigan","Ontonagon County",4,38,45,30,15
050,26,131,"Michigan","Ontonagon County",4,39,43,25,18
050,26,131,"Michigan","Ontonagon County",4,40,55,28,27
050,26,131,"Michigan","Ontonagon County",4,41,59,22,37
050,26,131,"Michigan","Ontonagon County",4,42,52,27,25
050,26,131,"Michigan","Ontonagon County",4,43,48,28,20
050,26,131,"Michigan","Ontonagon County",4,44,55,30,25
050,26,131,"Michigan","Ontonagon County",4,45,49,25,24
050,26,131,"Michigan","Ontonagon County",4,46,53,27,26
050,26,131,"Michigan","Ontonagon County",4,47,56,27,29
050,26,131,"Michigan","Ontonagon County",4,48,67,36,31
050,26,131,"Michigan","Ontonagon County",4,49,61,29,32
050,26,131,"Michigan","Ontonagon County",4,50,64,34,30
050,26,131,"Michigan","Ontonagon County",4,51,69,30,39
050,26,131,"Michigan","Ontonagon County",4,52,72,35,37
050,26,131,"Michigan","Ontonagon County",4,53,81,43,38
050,26,131,"Michigan","Ontonagon County",4,54,75,39,36
050,26,131,"Michigan","Ontonagon County",4,55,76,32,44
050,26,131,"Michigan","Ontonagon County",4,56,78,39,39
050,26,131,"Michigan","Ontonagon County",4,57,108,51,57
050,26,131,"Michigan","Ontonagon County",4,58,106,53,53
050,26,131,"Michigan","Ontonagon County",4,59,126,63,63
050,26,131,"Michigan","Ontonagon County",4,60,119,58,61
050,26,131,"Michigan","Ontonagon County",4,61,129,67,62
050,26,131,"Michigan","Ontonagon County",4,62,123,61,62
050,26,131,"Michigan","Ontonagon County",4,63,144,75,69
050,26,131,"Michigan","Ontonagon County",4,64,145,73,72
050,26,131,"Michigan","Ontonagon County",4,65,128,63,65
050,26,131,"Michigan","Ontonagon County",4,66,129,65,64
050,26,131,"Michigan","Ontonagon County",4,67,137,70,67
050,26,131,"Michigan","Ontonagon County",4,68,149,80,69
050,26,131,"Michigan","Ontonagon County",4,69,148,76,72
050,26,131,"Michigan","Ontonagon County",4,70,128,71,57
050,26,131,"Michigan","Ontonagon County",4,71,123,74,49
050,26,131,"Michigan","Ontonagon County",4,72,126,75,51
050,26,131,"Michigan","Ontonagon County",4,73,127,70,57
050,26,131,"Michigan","Ontonagon County",4,74,108,65,43
050,26,131,"Michigan","Ontonagon County",4,75,111,62,49
050,26,131,"Michigan","Ontonagon County",4,76,87,44,43
050,26,131,"Michigan","Ontonagon County",4,77,85,43,42
050,26,131,"Michigan","Ontonagon County",4,78,80,38,42
050,26,131,"Michigan","Ontonagon County",4,79,84,41,43
050,26,131,"Michigan","Ontonagon County",4,80,66,34,32
050,26,131,"Michigan","Ontonagon County",4,81,62,29,33
050,26,131,"Michigan","Ontonagon County",4,82,50,25,25
050,26,131,"Michigan","Ontonagon County",4,83,51,28,23
050,26,131,"Michigan","Ontonagon County",4,84,48,28,20
050,26,131,"Michigan","Ontonagon County",4,85,202,80,122
050,26,131,"Michigan","Ontonagon County",5,0,30,14,16
050,26,131,"Michigan","Ontonagon County",5,1,31,14,17
050,26,131,"Michigan","Ontonagon County",5,2,35,18,17
050,26,131,"Michigan","Ontonagon County",5,3,37,21,16
050,26,131,"Michigan","Ontonagon County",5,4,41,23,18
050,26,131,"Michigan","Ontonagon County",5,5,28,16,12
050,26,131,"Michigan","Ontonagon County",5,6,34,18,16
050,26,131,"Michigan","Ontonagon County",5,7,44,20,24
050,26,131,"Michigan","Ontonagon County",5,8,34,15,19
050,26,131,"Michigan","Ontonagon County",5,9,37,12,25
050,26,131,"Michigan","Ontonagon County",5,10,42,15,27
050,26,131,"Michigan","Ontonagon County",5,11,41,14,27
050,26,131,"Michigan","Ontonagon County",5,12,46,26,20
050,26,131,"Michigan","Ontonagon County",5,13,45,25,20
050,26,131,"Michigan","Ontonagon County",5,14,46,24,22
050,26,131,"Michigan","Ontonagon County",5,15,48,25,23
050,26,131,"Michigan","Ontonagon County",5,16,62,41,21
050,26,131,"Michigan","Ontonagon County",5,17,58,34,24
050,26,131,"Michigan","Ontonagon County",5,18,51,23,28
050,26,131,"Michigan","Ontonagon County",5,19,39,18,21
050,26,131,"Michigan","Ontonagon County",5,20,33,17,16
050,26,131,"Michigan","Ontonagon County",5,21,31,13,18
050,26,131,"Michigan","Ontonagon County",5,22,36,20,16
050,26,131,"Michigan","Ontonagon County",5,23,47,24,23
050,26,131,"Michigan","Ontonagon County",5,24,35,21,14
050,26,131,"Michigan","Ontonagon County",5,25,31,19,12
050,26,131,"Michigan","Ontonagon County",5,26,39,19,20
050,26,131,"Michigan","Ontonagon County",5,27,43,28,15
050,26,131,"Michigan","Ontonagon County",5,28,45,21,24
050,26,131,"Michigan","Ontonagon County",5,29,40,21,19
050,26,131,"Michigan","Ontonagon County",5,30,40,21,19
050,26,131,"Michigan","Ontonagon County",5,31,28,12,16
050,26,131,"Michigan","Ontonagon County",5,32,34,21,13
050,26,131,"Michigan","Ontonagon County",5,33,38,25,13
050,26,131,"Michigan","Ontonagon County",5,34,42,21,21
050,26,131,"Michigan","Ontonagon County",5,35,43,19,24
050,26,131,"Michigan","Ontonagon County",5,36,48,23,25
050,26,131,"Michigan","Ontonagon County",5,37,52,27,25
050,26,131,"Michigan","Ontonagon County",5,38,41,22,19
050,26,131,"Michigan","Ontonagon County",5,39,44,29,15
050,26,131,"Michigan","Ontonagon County",5,40,48,29,19
050,26,131,"Michigan","Ontonagon County",5,41,57,31,26
050,26,131,"Michigan","Ontonagon County",5,42,61,22,39
050,26,131,"Michigan","Ontonagon County",5,43,54,28,26
050,26,131,"Michigan","Ontonagon County",5,44,49,28,21
050,26,131,"Michigan","Ontonagon County",5,45,58,33,25
050,26,131,"Michigan","Ontonagon County",5,46,50,27,23
050,26,131,"Michigan","Ontonagon County",5,47,61,29,32
050,26,131,"Michigan","Ontonagon County",5,48,56,28,28
050,26,131,"Michigan","Ontonagon County",5,49,62,31,31
050,26,131,"Michigan","Ontonagon County",5,50,69,30,39
050,26,131,"Michigan","Ontonagon County",5,51,68,35,33
050,26,131,"Michigan","Ontonagon County",5,52,70,32,38
050,26,131,"Michigan","Ontonagon County",5,53,78,40,38
050,26,131,"Michigan","Ontonagon County",5,54,80,43,37
050,26,131,"Michigan","Ontonagon County",5,55,71,37,34
050,26,131,"Michigan","Ontonagon County",5,56,81,32,49
050,26,131,"Michigan","Ontonagon County",5,57,80,41,39
050,26,131,"Michigan","Ontonagon County",5,58,102,48,54
050,26,131,"Michigan","Ontonagon County",5,59,112,59,53
050,26,131,"Michigan","Ontonagon County",5,60,123,62,61
050,26,131,"Michigan","Ontonagon County",5,61,115,56,59
050,26,131,"Michigan","Ontonagon County",5,62,129,68,61
050,26,131,"Michigan","Ontonagon County",5,63,130,65,65
050,26,131,"Michigan","Ontonagon County",5,64,138,73,65
050,26,131,"Michigan","Ontonagon County",5,65,150,76,74
050,26,131,"Michigan","Ontonagon County",5,66,132,66,66
050,26,131,"Michigan","Ontonagon County",5,67,124,62,62
050,26,131,"Michigan","Ontonagon County",5,68,139,71,68
050,26,131,"Michigan","Ontonagon County",5,69,136,71,65
050,26,131,"Michigan","Ontonagon County",5,70,146,74,72
050,26,131,"Michigan","Ontonagon County",5,71,127,70,57
050,26,131,"Michigan","Ontonagon County",5,72,120,70,50
050,26,131,"Michigan","Ontonagon County",5,73,123,75,48
050,26,131,"Michigan","Ontonagon County",5,74,122,68,54
050,26,131,"Michigan","Ontonagon County",5,75,101,61,40
050,26,131,"Michigan","Ontonagon County",5,76,109,61,48
050,26,131,"Michigan","Ontonagon County",5,77,80,41,39
050,26,131,"Michigan","Ontonagon County",5,78,87,44,43
050,26,131,"Michigan","Ontonagon County",5,79,75,34,41
050,26,131,"Michigan","Ontonagon County",5,80,77,39,38
050,26,131,"Michigan","Ontonagon County",5,81,65,35,30
050,26,131,"Michigan","Ontonagon County",5,82,55,25,30
050,26,131,"Michigan","Ontonagon County",5,83,43,21,22
050,26,131,"Michigan","Ontonagon County",5,84,49,28,21
050,26,131,"Michigan","Ontonagon County",5,85,225,97,128
050,26,133,"Michigan","Osceola County",1,0,279,142,137
050,26,133,"Michigan","Osceola County",1,1,244,126,118
050,26,133,"Michigan","Osceola County",1,2,233,115,118
050,26,133,"Michigan","Osceola County",1,3,259,137,122
050,26,133,"Michigan","Osceola County",1,4,248,128,120
050,26,133,"Michigan","Osceola County",1,5,273,148,125
050,26,133,"Michigan","Osceola County",1,6,270,137,133
050,26,133,"Michigan","Osceola County",1,7,280,156,124
050,26,133,"Michigan","Osceola County",1,8,258,141,117
050,26,133,"Michigan","Osceola County",1,9,261,130,131
050,26,133,"Michigan","Osceola County",1,10,289,143,146
050,26,133,"Michigan","Osceola County",1,11,294,158,136
050,26,133,"Michigan","Osceola County",1,12,297,149,148
050,26,133,"Michigan","Osceola County",1,13,332,171,161
050,26,133,"Michigan","Osceola County",1,14,341,195,146
050,26,133,"Michigan","Osceola County",1,15,347,190,157
050,26,133,"Michigan","Osceola County",1,16,373,200,173
050,26,133,"Michigan","Osceola County",1,17,342,178,164
050,26,133,"Michigan","Osceola County",1,18,265,145,120
050,26,133,"Michigan","Osceola County",1,19,210,114,96
050,26,133,"Michigan","Osceola County",1,20,208,109,99
050,26,133,"Michigan","Osceola County",1,21,229,114,115
050,26,133,"Michigan","Osceola County",1,22,221,109,112
050,26,133,"Michigan","Osceola County",1,23,223,121,102
050,26,133,"Michigan","Osceola County",1,24,251,138,113
050,26,133,"Michigan","Osceola County",1,25,231,120,111
050,26,133,"Michigan","Osceola County",1,26,232,113,119
050,26,133,"Michigan","Osceola County",1,27,270,130,140
050,26,133,"Michigan","Osceola County",1,28,264,146,118
050,26,133,"Michigan","Osceola County",1,29,272,142,130
050,26,133,"Michigan","Osceola County",1,30,265,138,127
050,26,133,"Michigan","Osceola County",1,31,244,121,123
050,26,133,"Michigan","Osceola County",1,32,235,119,116
050,26,133,"Michigan","Osceola County",1,33,230,111,119
050,26,133,"Michigan","Osceola County",1,34,233,110,123
050,26,133,"Michigan","Osceola County",1,35,236,119,117
050,26,133,"Michigan","Osceola County",1,36,240,121,119
050,26,133,"Michigan","Osceola County",1,37,229,120,109
050,26,133,"Michigan","Osceola County",1,38,264,122,142
050,26,133,"Michigan","Osceola County",1,39,269,128,141
050,26,133,"Michigan","Osceola County",1,40,267,135,132
050,26,133,"Michigan","Osceola County",1,41,251,133,118
050,26,133,"Michigan","Osceola County",1,42,247,119,128
050,26,133,"Michigan","Osceola County",1,43,230,117,113
050,26,133,"Michigan","Osceola County",1,44,235,122,113
050,26,133,"Michigan","Osceola County",1,45,223,120,103
050,26,133,"Michigan","Osceola County",1,46,226,108,118
050,26,133,"Michigan","Osceola County",1,47,253,128,125
050,26,133,"Michigan","Osceola County",1,48,277,138,139
050,26,133,"Michigan","Osceola County",1,49,281,134,147
050,26,133,"Michigan","Osceola County",1,50,274,138,136
050,26,133,"Michigan","Osceola County",1,51,278,153,125
050,26,133,"Michigan","Osceola County",1,52,280,154,126
050,26,133,"Michigan","Osceola County",1,53,313,169,144
050,26,133,"Michigan","Osceola County",1,54,319,163,156
050,26,133,"Michigan","Osceola County",1,55,314,168,146
050,26,133,"Michigan","Osceola County",1,56,344,175,169
050,26,133,"Michigan","Osceola County",1,57,346,178,168
050,26,133,"Michigan","Osceola County",1,58,372,196,176
050,26,133,"Michigan","Osceola County",1,59,351,178,173
050,26,133,"Michigan","Osceola County",1,60,353,177,176
050,26,133,"Michigan","Osceola County",1,61,373,183,190
050,26,133,"Michigan","Osceola County",1,62,370,190,180
050,26,133,"Michigan","Osceola County",1,63,369,191,178
050,26,133,"Michigan","Osceola County",1,64,361,162,199
050,26,133,"Michigan","Osceola County",1,65,337,169,168
050,26,133,"Michigan","Osceola County",1,66,313,149,164
050,26,133,"Michigan","Osceola County",1,67,337,169,168
050,26,133,"Michigan","Osceola County",1,68,321,164,157
050,26,133,"Michigan","Osceola County",1,69,299,157,142
050,26,133,"Michigan","Osceola County",1,70,272,134,138
050,26,133,"Michigan","Osceola County",1,71,271,126,145
050,26,133,"Michigan","Osceola County",1,72,292,154,138
050,26,133,"Michigan","Osceola County",1,73,263,137,126
050,26,133,"Michigan","Osceola County",1,74,184,96,88
050,26,133,"Michigan","Osceola County",1,75,185,95,90
050,26,133,"Michigan","Osceola County",1,76,208,106,102
050,26,133,"Michigan","Osceola County",1,77,194,92,102
050,26,133,"Michigan","Osceola County",1,78,182,83,99
050,26,133,"Michigan","Osceola County",1,79,138,69,69
050,26,133,"Michigan","Osceola County",1,80,130,64,66
050,26,133,"Michigan","Osceola County",1,81,122,56,66
050,26,133,"Michigan","Osceola County",1,82,130,57,73
050,26,133,"Michigan","Osceola County",1,83,109,48,61
050,26,133,"Michigan","Osceola County",1,84,102,52,50
050,26,133,"Michigan","Osceola County",1,85,455,178,277
050,26,133,"Michigan","Osceola County",2,0,274,139,135
050,26,133,"Michigan","Osceola County",2,1,249,130,119
050,26,133,"Michigan","Osceola County",2,2,238,119,119
050,26,133,"Michigan","Osceola County",2,3,252,131,121
050,26,133,"Michigan","Osceola County",2,4,255,133,122
050,26,133,"Michigan","Osceola County",2,5,269,144,125
050,26,133,"Michigan","Osceola County",2,6,273,141,132
050,26,133,"Michigan","Osceola County",2,7,276,150,126
050,26,133,"Michigan","Osceola County",2,8,263,144,119
050,26,133,"Michigan","Osceola County",2,9,261,132,129
050,26,133,"Michigan","Osceola County",2,10,285,143,142
050,26,133,"Michigan","Osceola County",2,11,294,155,139
050,26,133,"Michigan","Osceola County",2,12,301,154,147
050,26,133,"Michigan","Osceola County",2,13,322,165,157
050,26,133,"Michigan","Osceola County",2,14,342,192,150
050,26,133,"Michigan","Osceola County",2,15,350,194,156
050,26,133,"Michigan","Osceola County",2,16,371,202,169
050,26,133,"Michigan","Osceola County",2,17,339,173,166
050,26,133,"Michigan","Osceola County",2,18,262,143,119
050,26,133,"Michigan","Osceola County",2,19,209,113,96
050,26,133,"Michigan","Osceola County",2,20,215,113,102
050,26,133,"Michigan","Osceola County",2,21,225,113,112
050,26,133,"Michigan","Osceola County",2,22,225,112,113
050,26,133,"Michigan","Osceola County",2,23,225,120,105
050,26,133,"Michigan","Osceola County",2,24,243,134,109
050,26,133,"Michigan","Osceola County",2,25,234,124,110
050,26,133,"Michigan","Osceola County",2,26,233,116,117
050,26,133,"Michigan","Osceola County",2,27,260,128,132
050,26,133,"Michigan","Osceola County",2,28,269,144,125
050,26,133,"Michigan","Osceola County",2,29,273,146,127
050,26,133,"Michigan","Osceola County",2,30,272,142,130
050,26,133,"Michigan","Osceola County",2,31,248,124,124
050,26,133,"Michigan","Osceola County",2,32,239,119,120
050,26,133,"Michigan","Osceola County",2,33,231,112,119
050,26,133,"Michigan","Osceola County",2,34,232,109,123
050,26,133,"Michigan","Osceola County",2,35,239,119,120
050,26,133,"Michigan","Osceola County",2,36,238,120,118
050,26,133,"Michigan","Osceola County",2,37,233,120,113
050,26,133,"Michigan","Osceola County",2,38,258,122,136
050,26,133,"Michigan","Osceola County",2,39,270,129,141
050,26,133,"Michigan","Osceola County",2,40,270,136,134
050,26,133,"Michigan","Osceola County",2,41,258,136,122
050,26,133,"Michigan","Osceola County",2,42,246,121,125
050,26,133,"Michigan","Osceola County",2,43,236,119,117
050,26,133,"Michigan","Osceola County",2,44,231,120,111
050,26,133,"Michigan","Osceola County",2,45,228,121,107
050,26,133,"Michigan","Osceola County",2,46,222,109,113
050,26,133,"Michigan","Osceola County",2,47,245,122,123
050,26,133,"Michigan","Osceola County",2,48,271,136,135
050,26,133,"Michigan","Osceola County",2,49,284,136,148
050,26,133,"Michigan","Osceola County",2,50,280,138,142
050,26,133,"Michigan","Osceola County",2,51,277,149,128
050,26,133,"Michigan","Osceola County",2,52,280,154,126
050,26,133,"Michigan","Osceola County",2,53,307,166,141
050,26,133,"Michigan","Osceola County",2,54,317,165,152
050,26,133,"Michigan","Osceola County",2,55,315,166,149
050,26,133,"Michigan","Osceola County",2,56,335,171,164
050,26,133,"Michigan","Osceola County",2,57,345,177,168
050,26,133,"Michigan","Osceola County",2,58,367,192,175
050,26,133,"Michigan","Osceola County",2,59,359,185,174
050,26,133,"Michigan","Osceola County",2,60,350,176,174
050,26,133,"Michigan","Osceola County",2,61,369,183,186
050,26,133,"Michigan","Osceola County",2,62,368,187,181
050,26,133,"Michigan","Osceola County",2,63,374,192,182
050,26,133,"Michigan","Osceola County",2,64,359,169,190
050,26,133,"Michigan","Osceola County",2,65,339,166,173
050,26,133,"Michigan","Osceola County",2,66,316,151,165
050,26,133,"Michigan","Osceola County",2,67,332,165,167
050,26,133,"Michigan","Osceola County",2,68,321,164,157
050,26,133,"Michigan","Osceola County",2,69,303,157,146
050,26,133,"Michigan","Osceola County",2,70,274,138,136
050,26,133,"Michigan","Osceola County",2,71,266,124,142
050,26,133,"Michigan","Osceola County",2,72,282,144,138
050,26,133,"Michigan","Osceola County",2,73,283,148,135
050,26,133,"Michigan","Osceola County",2,74,191,99,92
050,26,133,"Michigan","Osceola County",2,75,185,95,90
050,26,133,"Michigan","Osceola County",2,76,197,99,98
050,26,133,"Michigan","Osceola County",2,77,202,98,104
050,26,133,"Michigan","Osceola County",2,78,180,84,96
050,26,133,"Michigan","Osceola County",2,79,146,71,75
050,26,133,"Michigan","Osceola County",2,80,131,64,67
050,26,133,"Michigan","Osceola County",2,81,124,58,66
050,26,133,"Michigan","Osceola County",2,82,128,56,72
050,26,133,"Michigan","Osceola County",2,83,111,48,63
050,26,133,"Michigan","Osceola County",2,84,101,49,52
050,26,133,"Michigan","Osceola County",2,85,457,178,279
050,26,133,"Michigan","Osceola County",3,0,237,119,118
050,26,133,"Michigan","Osceola County",3,1,282,159,123
050,26,133,"Michigan","Osceola County",3,2,242,130,112
050,26,133,"Michigan","Osceola County",3,3,254,123,131
050,26,133,"Michigan","Osceola County",3,4,247,134,113
050,26,133,"Michigan","Osceola County",3,5,272,135,137
050,26,133,"Michigan","Osceola County",3,6,278,151,127
050,26,133,"Michigan","Osceola County",3,7,284,140,144
050,26,133,"Michigan","Osceola County",3,8,280,152,128
050,26,133,"Michigan","Osceola County",3,9,274,152,122
050,26,133,"Michigan","Osceola County",3,10,261,132,129
050,26,133,"Michigan","Osceola County",3,11,304,162,142
050,26,133,"Michigan","Osceola County",3,12,302,166,136
050,26,133,"Michigan","Osceola County",3,13,301,160,141
050,26,133,"Michigan","Osceola County",3,14,333,177,156
050,26,133,"Michigan","Osceola County",3,15,359,195,164
050,26,133,"Michigan","Osceola County",3,16,375,217,158
050,26,133,"Michigan","Osceola County",3,17,328,166,162
050,26,133,"Michigan","Osceola County",3,18,289,154,135
050,26,133,"Michigan","Osceola County",3,19,210,110,100
050,26,133,"Michigan","Osceola County",3,20,216,116,100
050,26,133,"Michigan","Osceola County",3,21,214,105,109
050,26,133,"Michigan","Osceola County",3,22,238,122,116
050,26,133,"Michigan","Osceola County",3,23,234,121,113
050,26,133,"Michigan","Osceola County",3,24,226,117,109
050,26,133,"Michigan","Osceola County",3,25,254,136,118
050,26,133,"Michigan","Osceola County",3,26,243,126,117
050,26,133,"Michigan","Osceola County",3,27,244,124,120
050,26,133,"Michigan","Osceola County",3,28,264,125,139
050,26,133,"Michigan","Osceola County",3,29,277,142,135
050,26,133,"Michigan","Osceola County",3,30,278,145,133
050,26,133,"Michigan","Osceola County",3,31,278,138,140
050,26,133,"Michigan","Osceola County",3,32,243,121,122
050,26,133,"Michigan","Osceola County",3,33,252,126,126
050,26,133,"Michigan","Osceola County",3,34,249,128,121
050,26,133,"Michigan","Osceola County",3,35,247,111,136
050,26,133,"Michigan","Osceola County",3,36,249,127,122
050,26,133,"Michigan","Osceola County",3,37,246,123,123
050,26,133,"Michigan","Osceola County",3,38,243,123,120
050,26,133,"Michigan","Osceola County",3,39,253,124,129
050,26,133,"Michigan","Osceola County",3,40,281,137,144
050,26,133,"Michigan","Osceola County",3,41,274,137,137
050,26,133,"Michigan","Osceola County",3,42,262,139,123
050,26,133,"Michigan","Osceola County",3,43,253,121,132
050,26,133,"Michigan","Osceola County",3,44,250,126,124
050,26,133,"Michigan","Osceola County",3,45,234,124,110
050,26,133,"Michigan","Osceola County",3,46,226,119,107
050,26,133,"Michigan","Osceola County",3,47,224,109,115
050,26,133,"Michigan","Osceola County",3,48,248,128,120
050,26,133,"Michigan","Osceola County",3,49,278,135,143
050,26,133,"Michigan","Osceola County",3,50,290,135,155
050,26,133,"Michigan","Osceola County",3,51,286,140,146
050,26,133,"Michigan","Osceola County",3,52,276,151,125
050,26,133,"Michigan","Osceola County",3,53,278,149,129
050,26,133,"Michigan","Osceola County",3,54,293,157,136
050,26,133,"Michigan","Osceola County",3,55,320,165,155
050,26,133,"Michigan","Osceola County",3,56,324,168,156
050,26,133,"Michigan","Osceola County",3,57,345,179,166
050,26,133,"Michigan","Osceola County",3,58,348,180,168
050,26,133,"Michigan","Osceola County",3,59,378,196,182
050,26,133,"Michigan","Osceola County",3,60,353,176,177
050,26,133,"Michigan","Osceola County",3,61,365,184,181
050,26,133,"Michigan","Osceola County",3,62,369,184,185
050,26,133,"Michigan","Osceola County",3,63,374,186,188
050,26,133,"Michigan","Osceola County",3,64,387,196,191
050,26,133,"Michigan","Osceola County",3,65,369,179,190
050,26,133,"Michigan","Osceola County",3,66,341,168,173
050,26,133,"Michigan","Osceola County",3,67,322,156,166
050,26,133,"Michigan","Osceola County",3,68,323,165,158
050,26,133,"Michigan","Osceola County",3,69,315,160,155
050,26,133,"Michigan","Osceola County",3,70,301,157,144
050,26,133,"Michigan","Osceola County",3,71,266,140,126
050,26,133,"Michigan","Osceola County",3,72,262,121,141
050,26,133,"Michigan","Osceola County",3,73,266,136,130
050,26,133,"Michigan","Osceola County",3,74,276,145,131
050,26,133,"Michigan","Osceola County",3,75,184,92,92
050,26,133,"Michigan","Osceola County",3,76,176,88,88
050,26,133,"Michigan","Osceola County",3,77,191,94,97
050,26,133,"Michigan","Osceola County",3,78,198,98,100
050,26,133,"Michigan","Osceola County",3,79,167,77,90
050,26,133,"Michigan","Osceola County",3,80,140,66,74
050,26,133,"Michigan","Osceola County",3,81,123,62,61
050,26,133,"Michigan","Osceola County",3,82,118,50,68
050,26,133,"Michigan","Osceola County",3,83,117,53,64
050,26,133,"Michigan","Osceola County",3,84,98,39,59
050,26,133,"Michigan","Osceola County",3,85,467,183,284
050,26,133,"Michigan","Osceola County",4,0,246,122,124
050,26,133,"Michigan","Osceola County",4,1,241,131,110
050,26,133,"Michigan","Osceola County",4,2,288,158,130
050,26,133,"Michigan","Osceola County",4,3,233,124,109
050,26,133,"Michigan","Osceola County",4,4,261,127,134
050,26,133,"Michigan","Osceola County",4,5,259,140,119
050,26,133,"Michigan","Osceola County",4,6,258,128,130
050,26,133,"Michigan","Osceola County",4,7,284,152,132
050,26,133,"Michigan","Osceola County",4,8,274,134,140
050,26,133,"Michigan","Osceola County",4,9,285,154,131
050,26,133,"Michigan","Osceola County",4,10,279,159,120
050,26,133,"Michigan","Osceola County",4,11,281,141,140
050,26,133,"Michigan","Osceola County",4,12,302,167,135
050,26,133,"Michigan","Osceola County",4,13,302,161,141
050,26,133,"Michigan","Osceola County",4,14,318,172,146
050,26,133,"Michigan","Osceola County",4,15,352,186,166
050,26,133,"Michigan","Osceola County",4,16,375,212,163
050,26,133,"Michigan","Osceola County",4,17,347,194,153
050,26,133,"Michigan","Osceola County",4,18,254,140,114
050,26,133,"Michigan","Osceola County",4,19,201,110,91
050,26,133,"Michigan","Osceola County",4,20,222,119,103
050,26,133,"Michigan","Osceola County",4,21,218,116,102
050,26,133,"Michigan","Osceola County",4,22,233,115,118
050,26,133,"Michigan","Osceola County",4,23,240,128,112
050,26,133,"Michigan","Osceola County",4,24,234,119,115
050,26,133,"Michigan","Osceola County",4,25,226,120,106
050,26,133,"Michigan","Osceola County",4,26,235,121,114
050,26,133,"Michigan","Osceola County",4,27,256,125,131
050,26,133,"Michigan","Osceola County",4,28,240,118,122
050,26,133,"Michigan","Osceola County",4,29,279,128,151
050,26,133,"Michigan","Osceola County",4,30,289,148,141
050,26,133,"Michigan","Osceola County",4,31,288,151,137
050,26,133,"Michigan","Osceola County",4,32,267,137,130
050,26,133,"Michigan","Osceola County",4,33,246,123,123
050,26,133,"Michigan","Osceola County",4,34,261,140,121
050,26,133,"Michigan","Osceola County",4,35,245,121,124
050,26,133,"Michigan","Osceola County",4,36,259,118,141
050,26,133,"Michigan","Osceola County",4,37,241,120,121
050,26,133,"Michigan","Osceola County",4,38,253,125,128
050,26,133,"Michigan","Osceola County",4,39,254,127,127
050,26,133,"Michigan","Osceola County",4,40,252,123,129
050,26,133,"Michigan","Osceola County",4,41,278,131,147
050,26,133,"Michigan","Osceola County",4,42,273,137,136
050,26,133,"Michigan","Osceola County",4,43,272,143,129
050,26,133,"Michigan","Osceola County",4,44,255,123,132
050,26,133,"Michigan","Osceola County",4,45,252,125,127
050,26,133,"Michigan","Osceola County",4,46,244,129,115
050,26,133,"Michigan","Osceola County",4,47,228,119,109
050,26,133,"Michigan","Osceola County",4,48,223,116,107
050,26,133,"Michigan","Osceola County",4,49,253,131,122
050,26,133,"Michigan","Osceola County",4,50,278,133,145
050,26,133,"Michigan","Osceola County",4,51,296,135,161
050,26,133,"Michigan","Osceola County",4,52,284,142,142
050,26,133,"Michigan","Osceola County",4,53,286,159,127
050,26,133,"Michigan","Osceola County",4,54,284,156,128
050,26,133,"Michigan","Osceola County",4,55,290,156,134
050,26,133,"Michigan","Osceola County",4,56,330,170,160
050,26,133,"Michigan","Osceola County",4,57,335,172,163
050,26,133,"Michigan","Osceola County",4,58,347,179,168
050,26,133,"Michigan","Osceola County",4,59,350,178,172
050,26,133,"Michigan","Osceola County",4,60,396,200,196
050,26,133,"Michigan","Osceola County",4,61,362,179,183
050,26,133,"Michigan","Osceola County",4,62,369,183,186
050,26,133,"Michigan","Osceola County",4,63,378,194,184
050,26,133,"Michigan","Osceola County",4,64,371,193,178
050,26,133,"Michigan","Osceola County",4,65,387,200,187
050,26,133,"Michigan","Osceola County",4,66,371,185,186
050,26,133,"Michigan","Osceola County",4,67,353,177,176
050,26,133,"Michigan","Osceola County",4,68,317,157,160
050,26,133,"Michigan","Osceola County",4,69,322,163,159
050,26,133,"Michigan","Osceola County",4,70,314,158,156
050,26,133,"Michigan","Osceola County",4,71,297,152,145
050,26,133,"Michigan","Osceola County",4,72,261,135,126
050,26,133,"Michigan","Osceola County",4,73,254,123,131
050,26,133,"Michigan","Osceola County",4,74,259,134,125
050,26,133,"Michigan","Osceola County",4,75,257,136,121
050,26,133,"Michigan","Osceola County",4,76,167,80,87
050,26,133,"Michigan","Osceola County",4,77,166,87,79
050,26,133,"Michigan","Osceola County",4,78,177,89,88
050,26,133,"Michigan","Osceola County",4,79,183,88,95
050,26,133,"Michigan","Osceola County",4,80,156,69,87
050,26,133,"Michigan","Osceola County",4,81,129,57,72
050,26,133,"Michigan","Osceola County",4,82,112,55,57
050,26,133,"Michigan","Osceola County",4,83,110,51,59
050,26,133,"Michigan","Osceola County",4,84,103,47,56
050,26,133,"Michigan","Osceola County",4,85,472,182,290
050,26,133,"Michigan","Osceola County",5,0,228,112,116
050,26,133,"Michigan","Osceola County",5,1,264,134,130
050,26,133,"Michigan","Osceola County",5,2,234,120,114
050,26,133,"Michigan","Osceola County",5,3,278,157,121
050,26,133,"Michigan","Osceola County",5,4,232,127,105
050,26,133,"Michigan","Osceola County",5,5,262,128,134
050,26,133,"Michigan","Osceola County",5,6,267,142,125
050,26,133,"Michigan","Osceola County",5,7,268,135,133
050,26,133,"Michigan","Osceola County",5,8,288,158,130
050,26,133,"Michigan","Osceola County",5,9,269,136,133
050,26,133,"Michigan","Osceola County",5,10,276,148,128
050,26,133,"Michigan","Osceola County",5,11,295,166,129
050,26,133,"Michigan","Osceola County",5,12,289,149,140
050,26,133,"Michigan","Osceola County",5,13,304,167,137
050,26,133,"Michigan","Osceola County",5,14,323,177,146
050,26,133,"Michigan","Osceola County",5,15,328,172,156
050,26,133,"Michigan","Osceola County",5,16,373,206,167
050,26,133,"Michigan","Osceola County",5,17,334,178,156
050,26,133,"Michigan","Osceola County",5,18,269,156,113
050,26,133,"Michigan","Osceola County",5,19,192,105,87
050,26,133,"Michigan","Osceola County",5,20,222,118,104
050,26,133,"Michigan","Osceola County",5,21,220,112,108
050,26,133,"Michigan","Osceola County",5,22,236,132,104
050,26,133,"Michigan","Osceola County",5,23,236,119,117
050,26,133,"Michigan","Osceola County",5,24,232,122,110
050,26,133,"Michigan","Osceola County",5,25,229,122,107
050,26,133,"Michigan","Osceola County",5,26,229,122,107
050,26,133,"Michigan","Osceola County",5,27,234,111,123
050,26,133,"Michigan","Osceola County",5,28,252,127,125
050,26,133,"Michigan","Osceola County",5,29,232,121,111
050,26,133,"Michigan","Osceola County",5,30,284,139,145
050,26,133,"Michigan","Osceola County",5,31,277,143,134
050,26,133,"Michigan","Osceola County",5,32,290,155,135
050,26,133,"Michigan","Osceola County",5,33,270,137,133
050,26,133,"Michigan","Osceola County",5,34,260,130,130
050,26,133,"Michigan","Osceola County",5,35,253,139,114
050,26,133,"Michigan","Osceola County",5,36,253,128,125
050,26,133,"Michigan","Osceola County",5,37,266,121,145
050,26,133,"Michigan","Osceola County",5,38,242,120,122
050,26,133,"Michigan","Osceola County",5,39,262,135,127
050,26,133,"Michigan","Osceola County",5,40,251,123,128
050,26,133,"Michigan","Osceola County",5,41,275,135,140
050,26,133,"Michigan","Osceola County",5,42,291,138,153
050,26,133,"Michigan","Osceola County",5,43,281,141,140
050,26,133,"Michigan","Osceola County",5,44,273,148,125
050,26,133,"Michigan","Osceola County",5,45,260,133,127
050,26,133,"Michigan","Osceola County",5,46,232,116,116
050,26,133,"Michigan","Osceola County",5,47,239,126,113
050,26,133,"Michigan","Osceola County",5,48,237,125,112
050,26,133,"Michigan","Osceola County",5,49,225,115,110
050,26,133,"Michigan","Osceola County",5,50,260,133,127
050,26,133,"Michigan","Osceola County",5,51,280,135,145
050,26,133,"Michigan","Osceola County",5,52,301,137,164
050,26,133,"Michigan","Osceola County",5,53,293,149,144
050,26,133,"Michigan","Osceola County",5,54,284,153,131
050,26,133,"Michigan","Osceola County",5,55,289,162,127
050,26,133,"Michigan","Osceola County",5,56,298,154,144
050,26,133,"Michigan","Osceola County",5,57,326,164,162
050,26,133,"Michigan","Osceola County",5,58,327,169,158
050,26,133,"Michigan","Osceola County",5,59,349,182,167
050,26,133,"Michigan","Osceola County",5,60,354,176,178
050,26,133,"Michigan","Osceola County",5,61,397,196,201
050,26,133,"Michigan","Osceola County",5,62,358,177,181
050,26,133,"Michigan","Osceola County",5,63,374,188,186
050,26,133,"Michigan","Osceola County",5,64,377,199,178
050,26,133,"Michigan","Osceola County",5,65,373,197,176
050,26,133,"Michigan","Osceola County",5,66,388,209,179
050,26,133,"Michigan","Osceola County",5,67,382,193,189
050,26,133,"Michigan","Osceola County",5,68,352,179,173
050,26,133,"Michigan","Osceola County",5,69,310,150,160
050,26,133,"Michigan","Osceola County",5,70,321,159,162
050,26,133,"Michigan","Osceola County",5,71,303,157,146
050,26,133,"Michigan","Osceola County",5,72,293,147,146
050,26,133,"Michigan","Osceola County",5,73,261,133,128
050,26,133,"Michigan","Osceola County",5,74,249,121,128
050,26,133,"Michigan","Osceola County",5,75,246,125,121
050,26,133,"Michigan","Osceola County",5,76,244,120,124
050,26,133,"Michigan","Osceola County",5,77,163,81,82
050,26,133,"Michigan","Osceola County",5,78,160,84,76
050,26,133,"Michigan","Osceola County",5,79,163,78,85
050,26,133,"Michigan","Osceola County",5,80,174,80,94
050,26,133,"Michigan","Osceola County",5,81,150,67,83
050,26,133,"Michigan","Osceola County",5,82,117,50,67
050,26,133,"Michigan","Osceola County",5,83,106,55,51
050,26,133,"Michigan","Osceola County",5,84,98,44,54
050,26,133,"Michigan","Osceola County",5,85,494,194,300
050,26,135,"Michigan","Oscoda County",1,0,87,45,42
050,26,135,"Michigan","Oscoda County",1,1,78,40,38
050,26,135,"Michigan","Oscoda County",1,2,90,44,46
050,26,135,"Michigan","Oscoda County",1,3,100,43,57
050,26,135,"Michigan","Oscoda County",1,4,88,38,50
050,26,135,"Michigan","Oscoda County",1,5,99,50,49
050,26,135,"Michigan","Oscoda County",1,6,84,45,39
050,26,135,"Michigan","Oscoda County",1,7,87,46,41
050,26,135,"Michigan","Oscoda County",1,8,88,49,39
050,26,135,"Michigan","Oscoda County",1,9,90,51,39
050,26,135,"Michigan","Oscoda County",1,10,93,53,40
050,26,135,"Michigan","Oscoda County",1,11,98,49,49
050,26,135,"Michigan","Oscoda County",1,12,96,59,37
050,26,135,"Michigan","Oscoda County",1,13,89,45,44
050,26,135,"Michigan","Oscoda County",1,14,88,45,43
050,26,135,"Michigan","Oscoda County",1,15,97,56,41
050,26,135,"Michigan","Oscoda County",1,16,92,51,41
050,26,135,"Michigan","Oscoda County",1,17,92,56,36
050,26,135,"Michigan","Oscoda County",1,18,83,48,35
050,26,135,"Michigan","Oscoda County",1,19,62,36,26
050,26,135,"Michigan","Oscoda County",1,20,64,41,23
050,26,135,"Michigan","Oscoda County",1,21,64,32,32
050,26,135,"Michigan","Oscoda County",1,22,63,28,35
050,26,135,"Michigan","Oscoda County",1,23,67,31,36
050,26,135,"Michigan","Oscoda County",1,24,64,29,35
050,26,135,"Michigan","Oscoda County",1,25,77,43,34
050,26,135,"Michigan","Oscoda County",1,26,71,35,36
050,26,135,"Michigan","Oscoda County",1,27,80,41,39
050,26,135,"Michigan","Oscoda County",1,28,61,31,30
050,26,135,"Michigan","Oscoda County",1,29,74,38,36
050,26,135,"Michigan","Oscoda County",1,30,76,37,39
050,26,135,"Michigan","Oscoda County",1,31,74,31,43
050,26,135,"Michigan","Oscoda County",1,32,69,32,37
050,26,135,"Michigan","Oscoda County",1,33,59,27,32
050,26,135,"Michigan","Oscoda County",1,34,71,38,33
050,26,135,"Michigan","Oscoda County",1,35,80,45,35
050,26,135,"Michigan","Oscoda County",1,36,82,43,39
050,26,135,"Michigan","Oscoda County",1,37,84,45,39
050,26,135,"Michigan","Oscoda County",1,38,77,39,38
050,26,135,"Michigan","Oscoda County",1,39,78,36,42
050,26,135,"Michigan","Oscoda County",1,40,82,37,45
050,26,135,"Michigan","Oscoda County",1,41,61,35,26
050,26,135,"Michigan","Oscoda County",1,42,51,25,26
050,26,135,"Michigan","Oscoda County",1,43,62,28,34
050,26,135,"Michigan","Oscoda County",1,44,65,32,33
050,26,135,"Michigan","Oscoda County",1,45,64,34,30
050,26,135,"Michigan","Oscoda County",1,46,73,38,35
050,26,135,"Michigan","Oscoda County",1,47,76,40,36
050,26,135,"Michigan","Oscoda County",1,48,83,41,42
050,26,135,"Michigan","Oscoda County",1,49,68,29,39
050,26,135,"Michigan","Oscoda County",1,50,75,41,34
050,26,135,"Michigan","Oscoda County",1,51,86,43,43
050,26,135,"Michigan","Oscoda County",1,52,101,55,46
050,26,135,"Michigan","Oscoda County",1,53,89,43,46
050,26,135,"Michigan","Oscoda County",1,54,98,49,49
050,26,135,"Michigan","Oscoda County",1,55,115,64,51
050,26,135,"Michigan","Oscoda County",1,56,106,53,53
050,26,135,"Michigan","Oscoda County",1,57,137,59,78
050,26,135,"Michigan","Oscoda County",1,58,153,85,68
050,26,135,"Michigan","Oscoda County",1,59,177,99,78
050,26,135,"Michigan","Oscoda County",1,60,179,92,87
050,26,135,"Michigan","Oscoda County",1,61,172,81,91
050,26,135,"Michigan","Oscoda County",1,62,176,78,98
050,26,135,"Michigan","Oscoda County",1,63,178,87,91
050,26,135,"Michigan","Oscoda County",1,64,183,94,89
050,26,135,"Michigan","Oscoda County",1,65,161,82,79
050,26,135,"Michigan","Oscoda County",1,66,163,80,83
050,26,135,"Michigan","Oscoda County",1,67,170,91,79
050,26,135,"Michigan","Oscoda County",1,68,154,80,74
050,26,135,"Michigan","Oscoda County",1,69,132,65,67
050,26,135,"Michigan","Oscoda County",1,70,130,70,60
050,26,135,"Michigan","Oscoda County",1,71,129,74,55
050,26,135,"Michigan","Oscoda County",1,72,136,74,62
050,26,135,"Michigan","Oscoda County",1,73,129,71,58
050,26,135,"Michigan","Oscoda County",1,74,90,45,45
050,26,135,"Michigan","Oscoda County",1,75,84,39,45
050,26,135,"Michigan","Oscoda County",1,76,99,52,47
050,26,135,"Michigan","Oscoda County",1,77,95,47,48
050,26,135,"Michigan","Oscoda County",1,78,87,43,44
050,26,135,"Michigan","Oscoda County",1,79,73,37,36
050,26,135,"Michigan","Oscoda County",1,80,65,35,30
050,26,135,"Michigan","Oscoda County",1,81,61,32,29
050,26,135,"Michigan","Oscoda County",1,82,45,23,22
050,26,135,"Michigan","Oscoda County",1,83,39,14,25
050,26,135,"Michigan","Oscoda County",1,84,47,26,21
050,26,135,"Michigan","Oscoda County",1,85,205,90,115
050,26,135,"Michigan","Oscoda County",2,0,91,45,46
050,26,135,"Michigan","Oscoda County",2,1,82,42,40
050,26,135,"Michigan","Oscoda County",2,2,87,43,44
050,26,135,"Michigan","Oscoda County",2,3,98,43,55
050,26,135,"Michigan","Oscoda County",2,4,93,41,52
050,26,135,"Michigan","Oscoda County",2,5,96,47,49
050,26,135,"Michigan","Oscoda County",2,6,88,47,41
050,26,135,"Michigan","Oscoda County",2,7,87,46,41
050,26,135,"Michigan","Oscoda County",2,8,90,50,40
050,26,135,"Michigan","Oscoda County",2,9,91,52,39
050,26,135,"Michigan","Oscoda County",2,10,92,52,40
050,26,135,"Michigan","Oscoda County",2,11,97,50,47
050,26,135,"Michigan","Oscoda County",2,12,99,58,41
050,26,135,"Michigan","Oscoda County",2,13,90,49,41
050,26,135,"Michigan","Oscoda County",2,14,89,46,43
050,26,135,"Michigan","Oscoda County",2,15,94,54,40
050,26,135,"Michigan","Oscoda County",2,16,93,52,41
050,26,135,"Michigan","Oscoda County",2,17,94,57,37
050,26,135,"Michigan","Oscoda County",2,18,80,48,32
050,26,135,"Michigan","Oscoda County",2,19,64,38,26
050,26,135,"Michigan","Oscoda County",2,20,66,40,26
050,26,135,"Michigan","Oscoda County",2,21,63,34,29
050,26,135,"Michigan","Oscoda County",2,22,63,29,34
050,26,135,"Michigan","Oscoda County",2,23,65,30,35
050,26,135,"Michigan","Oscoda County",2,24,65,30,35
050,26,135,"Michigan","Oscoda County",2,25,72,39,33
050,26,135,"Michigan","Oscoda County",2,26,73,37,36
050,26,135,"Michigan","Oscoda County",2,27,78,40,38
050,26,135,"Michigan","Oscoda County",2,28,65,34,31
050,26,135,"Michigan","Oscoda County",2,29,73,38,35
050,26,135,"Michigan","Oscoda County",2,30,75,37,38
050,26,135,"Michigan","Oscoda County",2,31,76,33,43
050,26,135,"Michigan","Oscoda County",2,32,70,32,38
050,26,135,"Michigan","Oscoda County",2,33,62,28,34
050,26,135,"Michigan","Oscoda County",2,34,68,35,33
050,26,135,"Michigan","Oscoda County",2,35,80,45,35
050,26,135,"Michigan","Oscoda County",2,36,82,44,38
050,26,135,"Michigan","Oscoda County",2,37,83,44,39
050,26,135,"Michigan","Oscoda County",2,38,79,40,39
050,26,135,"Michigan","Oscoda County",2,39,79,37,42
050,26,135,"Michigan","Oscoda County",2,40,82,38,44
050,26,135,"Michigan","Oscoda County",2,41,67,36,31
050,26,135,"Michigan","Oscoda County",2,42,53,27,26
050,26,135,"Michigan","Oscoda County",2,43,61,29,32
050,26,135,"Michigan","Oscoda County",2,44,63,31,32
050,26,135,"Michigan","Oscoda County",2,45,64,33,31
050,26,135,"Michigan","Oscoda County",2,46,71,36,35
050,26,135,"Michigan","Oscoda County",2,47,76,40,36
050,26,135,"Michigan","Oscoda County",2,48,80,39,41
050,26,135,"Michigan","Oscoda County",2,49,73,33,40
050,26,135,"Michigan","Oscoda County",2,50,75,39,36
050,26,135,"Michigan","Oscoda County",2,51,83,43,40
050,26,135,"Michigan","Oscoda County",2,52,98,53,45
050,26,135,"Michigan","Oscoda County",2,53,90,44,46
050,26,135,"Michigan","Oscoda County",2,54,98,48,50
050,26,135,"Michigan","Oscoda County",2,55,111,62,49
050,26,135,"Michigan","Oscoda County",2,56,110,56,54
050,26,135,"Michigan","Oscoda County",2,57,128,57,71
050,26,135,"Michigan","Oscoda County",2,58,150,79,71
050,26,135,"Michigan","Oscoda County",2,59,172,95,77
050,26,135,"Michigan","Oscoda County",2,60,178,93,85
050,26,135,"Michigan","Oscoda County",2,61,174,83,91
050,26,135,"Michigan","Oscoda County",2,62,176,79,97
050,26,135,"Michigan","Oscoda County",2,63,182,88,94
050,26,135,"Michigan","Oscoda County",2,64,183,93,90
050,26,135,"Michigan","Oscoda County",2,65,166,85,81
050,26,135,"Michigan","Oscoda County",2,66,162,82,80
050,26,135,"Michigan","Oscoda County",2,67,165,87,78
050,26,135,"Michigan","Oscoda County",2,68,156,83,73
050,26,135,"Michigan","Oscoda County",2,69,136,69,67
050,26,135,"Michigan","Oscoda County",2,70,131,70,61
050,26,135,"Michigan","Oscoda County",2,71,128,72,56
050,26,135,"Michigan","Oscoda County",2,72,130,71,59
050,26,135,"Michigan","Oscoda County",2,73,136,74,62
050,26,135,"Michigan","Oscoda County",2,74,92,47,45
050,26,135,"Michigan","Oscoda County",2,75,85,38,47
050,26,135,"Michigan","Oscoda County",2,76,93,47,46
050,26,135,"Michigan","Oscoda County",2,77,95,49,46
050,26,135,"Michigan","Oscoda County",2,78,87,43,44
050,26,135,"Michigan","Oscoda County",2,79,76,38,38
050,26,135,"Michigan","Oscoda County",2,80,66,34,32
050,26,135,"Michigan","Oscoda County",2,81,61,33,28
050,26,135,"Michigan","Oscoda County",2,82,48,24,24
050,26,135,"Michigan","Oscoda County",2,83,38,14,24
050,26,135,"Michigan","Oscoda County",2,84,44,22,22
050,26,135,"Michigan","Oscoda County",2,85,210,95,115
050,26,135,"Michigan","Oscoda County",3,0,94,49,45
050,26,135,"Michigan","Oscoda County",3,1,96,46,50
050,26,135,"Michigan","Oscoda County",3,2,80,38,42
050,26,135,"Michigan","Oscoda County",3,3,85,42,43
050,26,135,"Michigan","Oscoda County",3,4,95,42,53
050,26,135,"Michigan","Oscoda County",3,5,88,44,44
050,26,135,"Michigan","Oscoda County",3,6,94,47,47
050,26,135,"Michigan","Oscoda County",3,7,91,49,42
050,26,135,"Michigan","Oscoda County",3,8,89,45,44
050,26,135,"Michigan","Oscoda County",3,9,92,51,41
050,26,135,"Michigan","Oscoda County",3,10,91,54,37
050,26,135,"Michigan","Oscoda County",3,11,96,54,42
050,26,135,"Michigan","Oscoda County",3,12,97,50,47
050,26,135,"Michigan","Oscoda County",3,13,101,56,45
050,26,135,"Michigan","Oscoda County",3,14,95,48,47
050,26,135,"Michigan","Oscoda County",3,15,90,46,44
050,26,135,"Michigan","Oscoda County",3,16,94,59,35
050,26,135,"Michigan","Oscoda County",3,17,94,54,40
050,26,135,"Michigan","Oscoda County",3,18,81,49,32
050,26,135,"Michigan","Oscoda County",3,19,56,31,25
050,26,135,"Michigan","Oscoda County",3,20,71,37,34
050,26,135,"Michigan","Oscoda County",3,21,66,43,23
050,26,135,"Michigan","Oscoda County",3,22,66,36,30
050,26,135,"Michigan","Oscoda County",3,23,64,28,36
050,26,135,"Michigan","Oscoda County",3,24,63,30,33
050,26,135,"Michigan","Oscoda County",3,25,66,26,40
050,26,135,"Michigan","Oscoda County",3,26,77,42,35
050,26,135,"Michigan","Oscoda County",3,27,66,30,36
050,26,135,"Michigan","Oscoda County",3,28,76,41,35
050,26,135,"Michigan","Oscoda County",3,29,72,32,40
050,26,135,"Michigan","Oscoda County",3,30,78,41,37
050,26,135,"Michigan","Oscoda County",3,31,82,37,45
050,26,135,"Michigan","Oscoda County",3,32,82,36,46
050,26,135,"Michigan","Oscoda County",3,33,68,32,36
050,26,135,"Michigan","Oscoda County",3,34,63,28,35
050,26,135,"Michigan","Oscoda County",3,35,74,40,34
050,26,135,"Michigan","Oscoda County",3,36,78,43,35
050,26,135,"Michigan","Oscoda County",3,37,81,43,38
050,26,135,"Michigan","Oscoda County",3,38,85,50,35
050,26,135,"Michigan","Oscoda County",3,39,82,43,39
050,26,135,"Michigan","Oscoda County",3,40,79,35,44
050,26,135,"Michigan","Oscoda County",3,41,85,38,47
050,26,135,"Michigan","Oscoda County",3,42,67,37,30
050,26,135,"Michigan","Oscoda County",3,43,54,26,28
050,26,135,"Michigan","Oscoda County",3,44,65,31,34
050,26,135,"Michigan","Oscoda County",3,45,71,34,37
050,26,135,"Michigan","Oscoda County",3,46,67,33,34
050,26,135,"Michigan","Oscoda County",3,47,73,38,35
050,26,135,"Michigan","Oscoda County",3,48,80,43,37
050,26,135,"Michigan","Oscoda County",3,49,89,44,45
050,26,135,"Michigan","Oscoda County",3,50,76,38,38
050,26,135,"Michigan","Oscoda County",3,51,86,43,43
050,26,135,"Michigan","Oscoda County",3,52,86,41,45
050,26,135,"Michigan","Oscoda County",3,53,102,55,47
050,26,135,"Michigan","Oscoda County",3,54,90,46,44
050,26,135,"Michigan","Oscoda County",3,55,95,43,52
050,26,135,"Michigan","Oscoda County",3,56,114,64,50
050,26,135,"Michigan","Oscoda County",3,57,110,55,55
050,26,135,"Michigan","Oscoda County",3,58,130,61,69
050,26,135,"Michigan","Oscoda County",3,59,151,77,74
050,26,135,"Michigan","Oscoda County",3,60,184,101,83
050,26,135,"Michigan","Oscoda County",3,61,184,97,87
050,26,135,"Michigan","Oscoda County",3,62,178,90,88
050,26,135,"Michigan","Oscoda County",3,63,183,83,100
050,26,135,"Michigan","Oscoda County",3,64,205,94,111
050,26,135,"Michigan","Oscoda County",3,65,182,94,88
050,26,135,"Michigan","Oscoda County",3,66,176,93,83
050,26,135,"Michigan","Oscoda County",3,67,165,86,79
050,26,135,"Michigan","Oscoda County",3,68,154,78,76
050,26,135,"Michigan","Oscoda County",3,69,157,82,75
050,26,135,"Michigan","Oscoda County",3,70,139,71,68
050,26,135,"Michigan","Oscoda County",3,71,123,67,56
050,26,135,"Michigan","Oscoda County",3,72,125,72,53
050,26,135,"Michigan","Oscoda County",3,73,121,66,55
050,26,135,"Michigan","Oscoda County",3,74,128,73,55
050,26,135,"Michigan","Oscoda County",3,75,95,46,49
050,26,135,"Michigan","Oscoda County",3,76,76,33,43
050,26,135,"Michigan","Oscoda County",3,77,81,37,44
050,26,135,"Michigan","Oscoda County",3,78,88,44,44
050,26,135,"Michigan","Oscoda County",3,79,86,45,41
050,26,135,"Michigan","Oscoda County",3,80,68,33,35
050,26,135,"Michigan","Oscoda County",3,81,60,31,29
050,26,135,"Michigan","Oscoda County",3,82,51,26,25
050,26,135,"Michigan","Oscoda County",3,83,44,22,22
050,26,135,"Michigan","Oscoda County",3,84,34,13,21
050,26,135,"Michigan","Oscoda County",3,85,204,91,113
050,26,135,"Michigan","Oscoda County",4,0,79,44,35
050,26,135,"Michigan","Oscoda County",4,1,93,52,41
050,26,135,"Michigan","Oscoda County",4,2,91,42,49
050,26,135,"Michigan","Oscoda County",4,3,80,39,41
050,26,135,"Michigan","Oscoda County",4,4,84,41,43
050,26,135,"Michigan","Oscoda County",4,5,93,41,52
050,26,135,"Michigan","Oscoda County",4,6,88,44,44
050,26,135,"Michigan","Oscoda County",4,7,95,46,49
050,26,135,"Michigan","Oscoda County",4,8,85,44,41
050,26,135,"Michigan","Oscoda County",4,9,91,47,44
050,26,135,"Michigan","Oscoda County",4,10,88,49,39
050,26,135,"Michigan","Oscoda County",4,11,95,54,41
050,26,135,"Michigan","Oscoda County",4,12,102,56,46
050,26,135,"Michigan","Oscoda County",4,13,99,49,50
050,26,135,"Michigan","Oscoda County",4,14,99,56,43
050,26,135,"Michigan","Oscoda County",4,15,98,51,47
050,26,135,"Michigan","Oscoda County",4,16,88,46,42
050,26,135,"Michigan","Oscoda County",4,17,96,61,35
050,26,135,"Michigan","Oscoda County",4,18,82,48,34
050,26,135,"Michigan","Oscoda County",4,19,60,34,26
050,26,135,"Michigan","Oscoda County",4,20,58,28,30
050,26,135,"Michigan","Oscoda County",4,21,71,40,31
050,26,135,"Michigan","Oscoda County",4,22,68,43,25
050,26,135,"Michigan","Oscoda County",4,23,65,36,29
050,26,135,"Michigan","Oscoda County",4,24,68,30,38
050,26,135,"Michigan","Oscoda County",4,25,64,32,32
050,26,135,"Michigan","Oscoda County",4,26,59,21,38
050,26,135,"Michigan","Oscoda County",4,27,68,38,30
050,26,135,"Michigan","Oscoda County",4,28,68,32,36
050,26,135,"Michigan","Oscoda County",4,29,83,46,37
050,26,135,"Michigan","Oscoda County",4,30,67,27,40
050,26,135,"Michigan","Oscoda County",4,31,81,45,36
050,26,135,"Michigan","Oscoda County",4,32,77,34,43
050,26,135,"Michigan","Oscoda County",4,33,87,36,51
050,26,135,"Michigan","Oscoda County",4,34,74,36,38
050,26,135,"Michigan","Oscoda County",4,35,70,31,39
050,26,135,"Michigan","Oscoda County",4,36,72,39,33
050,26,135,"Michigan","Oscoda County",4,37,78,41,37
050,26,135,"Michigan","Oscoda County",4,38,86,48,38
050,26,135,"Michigan","Oscoda County",4,39,88,52,36
050,26,135,"Michigan","Oscoda County",4,40,78,46,32
050,26,135,"Michigan","Oscoda County",4,41,82,37,45
050,26,135,"Michigan","Oscoda County",4,42,94,46,48
050,26,135,"Michigan","Oscoda County",4,43,79,45,34
050,26,135,"Michigan","Oscoda County",4,44,55,28,27
050,26,135,"Michigan","Oscoda County",4,45,65,33,32
050,26,135,"Michigan","Oscoda County",4,46,72,28,44
050,26,135,"Michigan","Oscoda County",4,47,75,39,36
050,26,135,"Michigan","Oscoda County",4,48,71,41,30
050,26,135,"Michigan","Oscoda County",4,49,83,43,40
050,26,135,"Michigan","Oscoda County",4,50,98,49,49
050,26,135,"Michigan","Oscoda County",4,51,83,42,41
050,26,135,"Michigan","Oscoda County",4,52,93,46,47
050,26,135,"Michigan","Oscoda County",4,53,85,38,47
050,26,135,"Michigan","Oscoda County",4,54,102,54,48
050,26,135,"Michigan","Oscoda County",4,55,97,51,46
050,26,135,"Michigan","Oscoda County",4,56,107,50,57
050,26,135,"Michigan","Oscoda County",4,57,120,66,54
050,26,135,"Michigan","Oscoda County",4,58,117,58,59
050,26,135,"Michigan","Oscoda County",4,59,141,70,71
050,26,135,"Michigan","Oscoda County",4,60,154,76,78
050,26,135,"Michigan","Oscoda County",4,61,190,101,89
050,26,135,"Michigan","Oscoda County",4,62,190,107,83
050,26,135,"Michigan","Oscoda County",4,63,189,94,95
050,26,135,"Michigan","Oscoda County",4,64,199,92,107
050,26,135,"Michigan","Oscoda County",4,65,213,94,119
050,26,135,"Michigan","Oscoda County",4,66,183,94,89
050,26,135,"Michigan","Oscoda County",4,67,184,99,85
050,26,135,"Michigan","Oscoda County",4,68,165,88,77
050,26,135,"Michigan","Oscoda County",4,69,146,70,76
050,26,135,"Michigan","Oscoda County",4,70,151,81,70
050,26,135,"Michigan","Oscoda County",4,71,138,72,66
050,26,135,"Michigan","Oscoda County",4,72,112,59,53
050,26,135,"Michigan","Oscoda County",4,73,117,67,50
050,26,135,"Michigan","Oscoda County",4,74,123,68,55
050,26,135,"Michigan","Oscoda County",4,75,120,65,55
050,26,135,"Michigan","Oscoda County",4,76,90,43,47
050,26,135,"Michigan","Oscoda County",4,77,69,30,39
050,26,135,"Michigan","Oscoda County",4,78,71,28,43
050,26,135,"Michigan","Oscoda County",4,79,83,44,39
050,26,135,"Michigan","Oscoda County",4,80,82,42,40
050,26,135,"Michigan","Oscoda County",4,81,59,30,29
050,26,135,"Michigan","Oscoda County",4,82,52,25,27
050,26,135,"Michigan","Oscoda County",4,83,47,25,22
050,26,135,"Michigan","Oscoda County",4,84,43,23,20
050,26,135,"Michigan","Oscoda County",4,85,186,78,108
050,26,135,"Michigan","Oscoda County",5,0,76,41,35
050,26,135,"Michigan","Oscoda County",5,1,96,53,43
050,26,135,"Michigan","Oscoda County",5,2,103,57,46
050,26,135,"Michigan","Oscoda County",5,3,85,38,47
050,26,135,"Michigan","Oscoda County",5,4,83,40,43
050,26,135,"Michigan","Oscoda County",5,5,87,41,46
050,26,135,"Michigan","Oscoda County",5,6,101,48,53
050,26,135,"Michigan","Oscoda County",5,7,92,48,44
050,26,135,"Michigan","Oscoda County",5,8,107,50,57
050,26,135,"Michigan","Oscoda County",5,9,90,49,41
050,26,135,"Michigan","Oscoda County",5,10,94,45,49
050,26,135,"Michigan","Oscoda County",5,11,90,50,40
050,26,135,"Michigan","Oscoda County",5,12,101,59,42
050,26,135,"Michigan","Oscoda County",5,13,99,57,42
050,26,135,"Michigan","Oscoda County",5,14,105,49,56
050,26,135,"Michigan","Oscoda County",5,15,102,57,45
050,26,135,"Michigan","Oscoda County",5,16,96,50,46
050,26,135,"Michigan","Oscoda County",5,17,90,50,40
050,26,135,"Michigan","Oscoda County",5,18,80,49,31
050,26,135,"Michigan","Oscoda County",5,19,59,37,22
050,26,135,"Michigan","Oscoda County",5,20,62,33,29
050,26,135,"Michigan","Oscoda County",5,21,55,26,29
050,26,135,"Michigan","Oscoda County",5,22,78,39,39
050,26,135,"Michigan","Oscoda County",5,23,65,44,21
050,26,135,"Michigan","Oscoda County",5,24,73,37,36
050,26,135,"Michigan","Oscoda County",5,25,67,29,38
050,26,135,"Michigan","Oscoda County",5,26,67,35,32
050,26,135,"Michigan","Oscoda County",5,27,66,28,38
050,26,135,"Michigan","Oscoda County",5,28,79,45,34
050,26,135,"Michigan","Oscoda County",5,29,76,37,39
050,26,135,"Michigan","Oscoda County",5,30,87,45,42
050,26,135,"Michigan","Oscoda County",5,31,69,28,41
050,26,135,"Michigan","Oscoda County",5,32,87,49,38
050,26,135,"Michigan","Oscoda County",5,33,81,37,44
050,26,135,"Michigan","Oscoda County",5,34,88,36,52
050,26,135,"Michigan","Oscoda County",5,35,72,37,35
050,26,135,"Michigan","Oscoda County",5,36,70,32,38
050,26,135,"Michigan","Oscoda County",5,37,74,38,36
050,26,135,"Michigan","Oscoda County",5,38,85,45,40
050,26,135,"Michigan","Oscoda County",5,39,81,42,39
050,26,135,"Michigan","Oscoda County",5,40,91,55,36
050,26,135,"Michigan","Oscoda County",5,41,85,50,35
050,26,135,"Michigan","Oscoda County",5,42,84,40,44
050,26,135,"Michigan","Oscoda County",5,43,94,46,48
050,26,135,"Michigan","Oscoda County",5,44,84,46,38
050,26,135,"Michigan","Oscoda County",5,45,57,26,31
050,26,135,"Michigan","Oscoda County",5,46,68,34,34
050,26,135,"Michigan","Oscoda County",5,47,73,29,44
050,26,135,"Michigan","Oscoda County",5,48,76,40,36
050,26,135,"Michigan","Oscoda County",5,49,70,39,31
050,26,135,"Michigan","Oscoda County",5,50,98,50,48
050,26,135,"Michigan","Oscoda County",5,51,108,58,50
050,26,135,"Michigan","Oscoda County",5,52,87,43,44
050,26,135,"Michigan","Oscoda County",5,53,95,48,47
050,26,135,"Michigan","Oscoda County",5,54,86,42,44
050,26,135,"Michigan","Oscoda County",5,55,103,53,50
050,26,135,"Michigan","Oscoda County",5,56,93,45,48
050,26,135,"Michigan","Oscoda County",5,57,111,55,56
050,26,135,"Michigan","Oscoda County",5,58,126,65,61
050,26,135,"Michigan","Oscoda County",5,59,126,67,59
050,26,135,"Michigan","Oscoda County",5,60,148,73,75
050,26,135,"Michigan","Oscoda County",5,61,164,81,83
050,26,135,"Michigan","Oscoda County",5,62,189,100,89
050,26,135,"Michigan","Oscoda County",5,63,190,104,86
050,26,135,"Michigan","Oscoda County",5,64,197,99,98
050,26,135,"Michigan","Oscoda County",5,65,202,94,108
050,26,135,"Michigan","Oscoda County",5,66,214,89,125
050,26,135,"Michigan","Oscoda County",5,67,185,98,87
050,26,135,"Michigan","Oscoda County",5,68,177,98,79
050,26,135,"Michigan","Oscoda County",5,69,165,89,76
050,26,135,"Michigan","Oscoda County",5,70,148,72,76
050,26,135,"Michigan","Oscoda County",5,71,150,79,71
050,26,135,"Michigan","Oscoda County",5,72,135,70,65
050,26,135,"Michigan","Oscoda County",5,73,102,52,50
050,26,135,"Michigan","Oscoda County",5,74,112,62,50
050,26,135,"Michigan","Oscoda County",5,75,114,59,55
050,26,135,"Michigan","Oscoda County",5,76,113,58,55
050,26,135,"Michigan","Oscoda County",5,77,84,40,44
050,26,135,"Michigan","Oscoda County",5,78,63,25,38
050,26,135,"Michigan","Oscoda County",5,79,68,27,41
050,26,135,"Michigan","Oscoda County",5,80,80,43,37
050,26,135,"Michigan","Oscoda County",5,81,75,39,36
050,26,135,"Michigan","Oscoda County",5,82,54,26,28
050,26,135,"Michigan","Oscoda County",5,83,45,21,24
050,26,135,"Michigan","Oscoda County",5,84,50,29,21
050,26,135,"Michigan","Oscoda County",5,85,188,82,106
050,26,137,"Michigan","Otsego County",1,0,229,117,112
050,26,137,"Michigan","Otsego County",1,1,257,125,132
050,26,137,"Michigan","Otsego County",1,2,259,125,134
050,26,137,"Michigan","Otsego County",1,3,272,137,135
050,26,137,"Michigan","Otsego County",1,4,285,152,133
050,26,137,"Michigan","Otsego County",1,5,272,141,131
050,26,137,"Michigan","Otsego County",1,6,291,163,128
050,26,137,"Michigan","Otsego County",1,7,293,163,130
050,26,137,"Michigan","Otsego County",1,8,307,176,131
050,26,137,"Michigan","Otsego County",1,9,308,167,141
050,26,137,"Michigan","Otsego County",1,10,314,158,156
050,26,137,"Michigan","Otsego County",1,11,315,164,151
050,26,137,"Michigan","Otsego County",1,12,314,163,151
050,26,137,"Michigan","Otsego County",1,13,320,151,169
050,26,137,"Michigan","Otsego County",1,14,317,153,164
050,26,137,"Michigan","Otsego County",1,15,295,156,139
050,26,137,"Michigan","Otsego County",1,16,318,165,153
050,26,137,"Michigan","Otsego County",1,17,321,153,168
050,26,137,"Michigan","Otsego County",1,18,294,156,138
050,26,137,"Michigan","Otsego County",1,19,228,133,95
050,26,137,"Michigan","Otsego County",1,20,234,125,109
050,26,137,"Michigan","Otsego County",1,21,253,123,130
050,26,137,"Michigan","Otsego County",1,22,256,122,134
050,26,137,"Michigan","Otsego County",1,23,259,127,132
050,26,137,"Michigan","Otsego County",1,24,254,128,126
050,26,137,"Michigan","Otsego County",1,25,259,132,127
050,26,137,"Michigan","Otsego County",1,26,280,152,128
050,26,137,"Michigan","Otsego County",1,27,283,147,136
050,26,137,"Michigan","Otsego County",1,28,321,164,157
050,26,137,"Michigan","Otsego County",1,29,317,163,154
050,26,137,"Michigan","Otsego County",1,30,293,141,152
050,26,137,"Michigan","Otsego County",1,31,282,145,137
050,26,137,"Michigan","Otsego County",1,32,274,139,135
050,26,137,"Michigan","Otsego County",1,33,278,134,144
050,26,137,"Michigan","Otsego County",1,34,268,133,135
050,26,137,"Michigan","Otsego County",1,35,287,149,138
050,26,137,"Michigan","Otsego County",1,36,258,125,133
050,26,137,"Michigan","Otsego County",1,37,285,149,136
050,26,137,"Michigan","Otsego County",1,38,293,157,136
050,26,137,"Michigan","Otsego County",1,39,271,122,149
050,26,137,"Michigan","Otsego County",1,40,289,133,156
050,26,137,"Michigan","Otsego County",1,41,272,129,143
050,26,137,"Michigan","Otsego County",1,42,259,126,133
050,26,137,"Michigan","Otsego County",1,43,272,138,134
050,26,137,"Michigan","Otsego County",1,44,253,131,122
050,26,137,"Michigan","Otsego County",1,45,237,123,114
050,26,137,"Michigan","Otsego County",1,46,250,123,127
050,26,137,"Michigan","Otsego County",1,47,280,137,143
050,26,137,"Michigan","Otsego County",1,48,310,149,161
050,26,137,"Michigan","Otsego County",1,49,340,173,167
050,26,137,"Michigan","Otsego County",1,50,307,149,158
050,26,137,"Michigan","Otsego County",1,51,328,176,152
050,26,137,"Michigan","Otsego County",1,52,362,190,172
050,26,137,"Michigan","Otsego County",1,53,366,174,192
050,26,137,"Michigan","Otsego County",1,54,366,197,169
050,26,137,"Michigan","Otsego County",1,55,387,199,188
050,26,137,"Michigan","Otsego County",1,56,384,201,183
050,26,137,"Michigan","Otsego County",1,57,367,170,197
050,26,137,"Michigan","Otsego County",1,58,381,189,192
050,26,137,"Michigan","Otsego County",1,59,387,194,193
050,26,137,"Michigan","Otsego County",1,60,395,194,201
050,26,137,"Michigan","Otsego County",1,61,405,199,206
050,26,137,"Michigan","Otsego County",1,62,416,206,210
050,26,137,"Michigan","Otsego County",1,63,406,226,180
050,26,137,"Michigan","Otsego County",1,64,362,191,171
050,26,137,"Michigan","Otsego County",1,65,381,199,182
050,26,137,"Michigan","Otsego County",1,66,373,185,188
050,26,137,"Michigan","Otsego County",1,67,366,176,190
050,26,137,"Michigan","Otsego County",1,68,350,169,181
050,26,137,"Michigan","Otsego County",1,69,339,172,167
050,26,137,"Michigan","Otsego County",1,70,331,168,163
050,26,137,"Michigan","Otsego County",1,71,331,154,177
050,26,137,"Michigan","Otsego County",1,72,305,162,143
050,26,137,"Michigan","Otsego County",1,73,321,173,148
050,26,137,"Michigan","Otsego County",1,74,218,107,111
050,26,137,"Michigan","Otsego County",1,75,208,91,117
050,26,137,"Michigan","Otsego County",1,76,193,88,105
050,26,137,"Michigan","Otsego County",1,77,194,98,96
050,26,137,"Michigan","Otsego County",1,78,180,85,95
050,26,137,"Michigan","Otsego County",1,79,162,75,87
050,26,137,"Michigan","Otsego County",1,80,139,48,91
050,26,137,"Michigan","Otsego County",1,81,138,63,75
050,26,137,"Michigan","Otsego County",1,82,137,63,74
050,26,137,"Michigan","Otsego County",1,83,107,55,52
050,26,137,"Michigan","Otsego County",1,84,95,43,52
050,26,137,"Michigan","Otsego County",1,85,526,211,315
050,26,137,"Michigan","Otsego County",2,0,241,128,113
050,26,137,"Michigan","Otsego County",2,1,251,123,128
050,26,137,"Michigan","Otsego County",2,2,259,126,133
050,26,137,"Michigan","Otsego County",2,3,268,135,133
050,26,137,"Michigan","Otsego County",2,4,288,152,136
050,26,137,"Michigan","Otsego County",2,5,280,147,133
050,26,137,"Michigan","Otsego County",2,6,289,161,128
050,26,137,"Michigan","Otsego County",2,7,294,165,129
050,26,137,"Michigan","Otsego County",2,8,306,175,131
050,26,137,"Michigan","Otsego County",2,9,312,172,140
050,26,137,"Michigan","Otsego County",2,10,315,163,152
050,26,137,"Michigan","Otsego County",2,11,314,163,151
050,26,137,"Michigan","Otsego County",2,12,315,164,151
050,26,137,"Michigan","Otsego County",2,13,319,155,164
050,26,137,"Michigan","Otsego County",2,14,319,153,166
050,26,137,"Michigan","Otsego County",2,15,301,155,146
050,26,137,"Michigan","Otsego County",2,16,312,162,150
050,26,137,"Michigan","Otsego County",2,17,322,157,165
050,26,137,"Michigan","Otsego County",2,18,288,151,137
050,26,137,"Michigan","Otsego County",2,19,230,131,99
050,26,137,"Michigan","Otsego County",2,20,238,128,110
050,26,137,"Michigan","Otsego County",2,21,252,125,127
050,26,137,"Michigan","Otsego County",2,22,258,124,134
050,26,137,"Michigan","Otsego County",2,23,258,126,132
050,26,137,"Michigan","Otsego County",2,24,252,127,125
050,26,137,"Michigan","Otsego County",2,25,261,133,128
050,26,137,"Michigan","Otsego County",2,26,278,149,129
050,26,137,"Michigan","Otsego County",2,27,280,146,134
050,26,137,"Michigan","Otsego County",2,28,312,161,151
050,26,137,"Michigan","Otsego County",2,29,319,162,157
050,26,137,"Michigan","Otsego County",2,30,301,147,154
050,26,137,"Michigan","Otsego County",2,31,284,144,140
050,26,137,"Michigan","Otsego County",2,32,278,140,138
050,26,137,"Michigan","Otsego County",2,33,278,135,143
050,26,137,"Michigan","Otsego County",2,34,270,133,137
050,26,137,"Michigan","Otsego County",2,35,285,147,138
050,26,137,"Michigan","Otsego County",2,36,265,131,134
050,26,137,"Michigan","Otsego County",2,37,279,142,137
050,26,137,"Michigan","Otsego County",2,38,292,155,137
050,26,137,"Michigan","Otsego County",2,39,274,129,145
050,26,137,"Michigan","Otsego County",2,40,289,132,157
050,26,137,"Michigan","Otsego County",2,41,275,129,146
050,26,137,"Michigan","Otsego County",2,42,260,126,134
050,26,137,"Michigan","Otsego County",2,43,272,137,135
050,26,137,"Michigan","Otsego County",2,44,255,131,124
050,26,137,"Michigan","Otsego County",2,45,245,128,117
050,26,137,"Michigan","Otsego County",2,46,245,122,123
050,26,137,"Michigan","Otsego County",2,47,274,135,139
050,26,137,"Michigan","Otsego County",2,48,304,145,159
050,26,137,"Michigan","Otsego County",2,49,338,171,167
050,26,137,"Michigan","Otsego County",2,50,312,153,159
050,26,137,"Michigan","Otsego County",2,51,323,170,153
050,26,137,"Michigan","Otsego County",2,52,355,187,168
050,26,137,"Michigan","Otsego County",2,53,366,177,189
050,26,137,"Michigan","Otsego County",2,54,368,193,175
050,26,137,"Michigan","Otsego County",2,55,383,199,184
050,26,137,"Michigan","Otsego County",2,56,390,203,187
050,26,137,"Michigan","Otsego County",2,57,369,176,193
050,26,137,"Michigan","Otsego County",2,58,373,182,191
050,26,137,"Michigan","Otsego County",2,59,388,193,195
050,26,137,"Michigan","Otsego County",2,60,395,196,199
050,26,137,"Michigan","Otsego County",2,61,403,197,206
050,26,137,"Michigan","Otsego County",2,62,409,202,207
050,26,137,"Michigan","Otsego County",2,63,412,224,188
050,26,137,"Michigan","Otsego County",2,64,370,198,172
050,26,137,"Michigan","Otsego County",2,65,381,201,180
050,26,137,"Michigan","Otsego County",2,66,374,189,185
050,26,137,"Michigan","Otsego County",2,67,363,178,185
050,26,137,"Michigan","Otsego County",2,68,350,167,183
050,26,137,"Michigan","Otsego County",2,69,347,174,173
050,26,137,"Michigan","Otsego County",2,70,333,170,163
050,26,137,"Michigan","Otsego County",2,71,332,157,175
050,26,137,"Michigan","Otsego County",2,72,306,157,149
050,26,137,"Michigan","Otsego County",2,73,333,177,156
050,26,137,"Michigan","Otsego County",2,74,224,115,109
050,26,137,"Michigan","Otsego County",2,75,210,94,116
050,26,137,"Michigan","Otsego County",2,76,192,87,105
050,26,137,"Michigan","Otsego County",2,77,195,95,100
050,26,137,"Michigan","Otsego County",2,78,177,85,92
050,26,137,"Michigan","Otsego County",2,79,167,77,90
050,26,137,"Michigan","Otsego County",2,80,140,53,87
050,26,137,"Michigan","Otsego County",2,81,136,58,78
050,26,137,"Michigan","Otsego County",2,82,136,62,74
050,26,137,"Michigan","Otsego County",2,83,109,53,56
050,26,137,"Michigan","Otsego County",2,84,93,43,50
050,26,137,"Michigan","Otsego County",2,85,525,208,317
050,26,137,"Michigan","Otsego County",3,0,233,113,120
050,26,137,"Michigan","Otsego County",3,1,249,132,117
050,26,137,"Michigan","Otsego County",3,2,247,123,124
050,26,137,"Michigan","Otsego County",3,3,270,135,135
050,26,137,"Michigan","Otsego County",3,4,264,128,136
050,26,137,"Michigan","Otsego County",3,5,296,150,146
050,26,137,"Michigan","Otsego County",3,6,279,148,131
050,26,137,"Michigan","Otsego County",3,7,285,154,131
050,26,137,"Michigan","Otsego County",3,8,308,175,133
050,26,137,"Michigan","Otsego County",3,9,307,175,132
050,26,137,"Michigan","Otsego County",3,10,310,170,140
050,26,137,"Michigan","Otsego County",3,11,314,159,155
050,26,137,"Michigan","Otsego County",3,12,311,163,148
050,26,137,"Michigan","Otsego County",3,13,315,160,155
050,26,137,"Michigan","Otsego County",3,14,334,166,168
050,26,137,"Michigan","Otsego County",3,15,311,147,164
050,26,137,"Michigan","Otsego County",3,16,305,153,152
050,26,137,"Michigan","Otsego County",3,17,315,161,154
050,26,137,"Michigan","Otsego County",3,18,288,148,140
050,26,137,"Michigan","Otsego County",3,19,240,136,104
050,26,137,"Michigan","Otsego County",3,20,238,130,108
050,26,137,"Michigan","Otsego County",3,21,255,142,113
050,26,137,"Michigan","Otsego County",3,22,268,143,125
050,26,137,"Michigan","Otsego County",3,23,272,132,140
050,26,137,"Michigan","Otsego County",3,24,255,125,130
050,26,137,"Michigan","Otsego County",3,25,249,124,125
050,26,137,"Michigan","Otsego County",3,26,264,127,137
050,26,137,"Michigan","Otsego County",3,27,269,145,124
050,26,137,"Michigan","Otsego County",3,28,279,142,137
050,26,137,"Michigan","Otsego County",3,29,315,161,154
050,26,137,"Michigan","Otsego County",3,30,344,174,170
050,26,137,"Michigan","Otsego County",3,31,318,158,160
050,26,137,"Michigan","Otsego County",3,32,290,143,147
050,26,137,"Michigan","Otsego County",3,33,311,158,153
050,26,137,"Michigan","Otsego County",3,34,273,139,134
050,26,137,"Michigan","Otsego County",3,35,275,138,137
050,26,137,"Michigan","Otsego County",3,36,297,153,144
050,26,137,"Michigan","Otsego County",3,37,269,132,137
050,26,137,"Michigan","Otsego County",3,38,290,152,138
050,26,137,"Michigan","Otsego County",3,39,290,151,139
050,26,137,"Michigan","Otsego County",3,40,283,134,149
050,26,137,"Michigan","Otsego County",3,41,290,130,160
050,26,137,"Michigan","Otsego County",3,42,272,130,142
050,26,137,"Michigan","Otsego County",3,43,266,135,131
050,26,137,"Michigan","Otsego County",3,44,271,135,136
050,26,137,"Michigan","Otsego County",3,45,252,133,119
050,26,137,"Michigan","Otsego County",3,46,244,125,119
050,26,137,"Michigan","Otsego County",3,47,260,130,130
050,26,137,"Michigan","Otsego County",3,48,287,143,144
050,26,137,"Michigan","Otsego County",3,49,310,153,157
050,26,137,"Michigan","Otsego County",3,50,341,169,172
050,26,137,"Michigan","Otsego County",3,51,328,167,161
050,26,137,"Michigan","Otsego County",3,52,322,169,153
050,26,137,"Michigan","Otsego County",3,53,348,179,169
050,26,137,"Michigan","Otsego County",3,54,370,185,185
050,26,137,"Michigan","Otsego County",3,55,381,201,180
050,26,137,"Michigan","Otsego County",3,56,389,202,187
050,26,137,"Michigan","Otsego County",3,57,391,200,191
050,26,137,"Michigan","Otsego County",3,58,363,172,191
050,26,137,"Michigan","Otsego County",3,59,367,179,188
050,26,137,"Michigan","Otsego County",3,60,399,197,202
050,26,137,"Michigan","Otsego County",3,61,401,192,209
050,26,137,"Michigan","Otsego County",3,62,411,207,204
050,26,137,"Michigan","Otsego County",3,63,423,213,210
050,26,137,"Michigan","Otsego County",3,64,414,221,193
050,26,137,"Michigan","Otsego County",3,65,383,210,173
050,26,137,"Michigan","Otsego County",3,66,379,196,183
050,26,137,"Michigan","Otsego County",3,67,360,182,178
050,26,137,"Michigan","Otsego County",3,68,360,172,188
050,26,137,"Michigan","Otsego County",3,69,347,169,178
050,26,137,"Michigan","Otsego County",3,70,348,177,171
050,26,137,"Michigan","Otsego County",3,71,323,163,160
050,26,137,"Michigan","Otsego County",3,72,321,153,168
050,26,137,"Michigan","Otsego County",3,73,296,147,149
050,26,137,"Michigan","Otsego County",3,74,324,172,152
050,26,137,"Michigan","Otsego County",3,75,217,112,105
050,26,137,"Michigan","Otsego County",3,76,198,88,110
050,26,137,"Michigan","Otsego County",3,77,182,81,101
050,26,137,"Michigan","Otsego County",3,78,187,97,90
050,26,137,"Michigan","Otsego County",3,79,167,78,89
050,26,137,"Michigan","Otsego County",3,80,154,72,82
050,26,137,"Michigan","Otsego County",3,81,135,52,83
050,26,137,"Michigan","Otsego County",3,82,122,52,70
050,26,137,"Michigan","Otsego County",3,83,123,53,70
050,26,137,"Michigan","Otsego County",3,84,98,48,50
050,26,137,"Michigan","Otsego County",3,85,515,204,311
050,26,137,"Michigan","Otsego County",4,0,235,117,118
050,26,137,"Michigan","Otsego County",4,1,242,113,129
050,26,137,"Michigan","Otsego County",4,2,260,137,123
050,26,137,"Michigan","Otsego County",4,3,261,128,133
050,26,137,"Michigan","Otsego County",4,4,282,142,140
050,26,137,"Michigan","Otsego County",4,5,281,142,139
050,26,137,"Michigan","Otsego County",4,6,309,158,151
050,26,137,"Michigan","Otsego County",4,7,284,156,128
050,26,137,"Michigan","Otsego County",4,8,288,158,130
050,26,137,"Michigan","Otsego County",4,9,307,172,135
050,26,137,"Michigan","Otsego County",4,10,310,171,139
050,26,137,"Michigan","Otsego County",4,11,326,179,147
050,26,137,"Michigan","Otsego County",4,12,310,162,148
050,26,137,"Michigan","Otsego County",4,13,316,170,146
050,26,137,"Michigan","Otsego County",4,14,317,165,152
050,26,137,"Michigan","Otsego County",4,15,342,172,170
050,26,137,"Michigan","Otsego County",4,16,326,156,170
050,26,137,"Michigan","Otsego County",4,17,302,150,152
050,26,137,"Michigan","Otsego County",4,18,270,142,128
050,26,137,"Michigan","Otsego County",4,19,220,115,105
050,26,137,"Michigan","Otsego County",4,20,240,129,111
050,26,137,"Michigan","Otsego County",4,21,244,138,106
050,26,137,"Michigan","Otsego County",4,22,269,151,118
050,26,137,"Michigan","Otsego County",4,23,289,159,130
050,26,137,"Michigan","Otsego County",4,24,266,129,137
050,26,137,"Michigan","Otsego County",4,25,251,126,125
050,26,137,"Michigan","Otsego County",4,26,260,126,134
050,26,137,"Michigan","Otsego County",4,27,292,147,145
050,26,137,"Michigan","Otsego County",4,28,306,161,145
050,26,137,"Michigan","Otsego County",4,29,291,138,153
050,26,137,"Michigan","Otsego County",4,30,308,156,152
050,26,137,"Michigan","Otsego County",4,31,355,180,175
050,26,137,"Michigan","Otsego County",4,32,324,162,162
050,26,137,"Michigan","Otsego County",4,33,287,140,147
050,26,137,"Michigan","Otsego County",4,34,320,168,152
050,26,137,"Michigan","Otsego County",4,35,283,143,140
050,26,137,"Michigan","Otsego County",4,36,286,146,140
050,26,137,"Michigan","Otsego County",4,37,289,144,145
050,26,137,"Michigan","Otsego County",4,38,288,140,148
050,26,137,"Michigan","Otsego County",4,39,298,152,146
050,26,137,"Michigan","Otsego County",4,40,303,154,149
050,26,137,"Michigan","Otsego County",4,41,289,135,154
050,26,137,"Michigan","Otsego County",4,42,291,138,153
050,26,137,"Michigan","Otsego County",4,43,273,130,143
050,26,137,"Michigan","Otsego County",4,44,269,133,136
050,26,137,"Michigan","Otsego County",4,45,266,140,126
050,26,137,"Michigan","Otsego County",4,46,250,129,121
050,26,137,"Michigan","Otsego County",4,47,250,136,114
050,26,137,"Michigan","Otsego County",4,48,259,124,135
050,26,137,"Michigan","Otsego County",4,49,290,148,142
050,26,137,"Michigan","Otsego County",4,50,291,140,151
050,26,137,"Michigan","Otsego County",4,51,347,171,176
050,26,137,"Michigan","Otsego County",4,52,331,174,157
050,26,137,"Michigan","Otsego County",4,53,321,158,163
050,26,137,"Michigan","Otsego County",4,54,354,185,169
050,26,137,"Michigan","Otsego County",4,55,366,176,190
050,26,137,"Michigan","Otsego County",4,56,368,194,174
050,26,137,"Michigan","Otsego County",4,57,406,204,202
050,26,137,"Michigan","Otsego County",4,58,403,212,191
050,26,137,"Michigan","Otsego County",4,59,354,166,188
050,26,137,"Michigan","Otsego County",4,60,366,179,187
050,26,137,"Michigan","Otsego County",4,61,422,200,222
050,26,137,"Michigan","Otsego County",4,62,401,203,198
050,26,137,"Michigan","Otsego County",4,63,426,208,218
050,26,137,"Michigan","Otsego County",4,64,432,220,212
050,26,137,"Michigan","Otsego County",4,65,435,233,202
050,26,137,"Michigan","Otsego County",4,66,379,204,175
050,26,137,"Michigan","Otsego County",4,67,369,184,185
050,26,137,"Michigan","Otsego County",4,68,360,180,180
050,26,137,"Michigan","Otsego County",4,69,370,173,197
050,26,137,"Michigan","Otsego County",4,70,349,171,178
050,26,137,"Michigan","Otsego County",4,71,341,172,169
050,26,137,"Michigan","Otsego County",4,72,318,165,153
050,26,137,"Michigan","Otsego County",4,73,305,140,165
050,26,137,"Michigan","Otsego County",4,74,284,141,143
050,26,137,"Michigan","Otsego County",4,75,307,162,145
050,26,137,"Michigan","Otsego County",4,76,214,110,104
050,26,137,"Michigan","Otsego County",4,77,183,79,104
050,26,137,"Michigan","Otsego County",4,78,176,84,92
050,26,137,"Michigan","Otsego County",4,79,169,87,82
050,26,137,"Michigan","Otsego County",4,80,151,69,82
050,26,137,"Michigan","Otsego County",4,81,142,70,72
050,26,137,"Michigan","Otsego County",4,82,124,48,76
050,26,137,"Michigan","Otsego County",4,83,117,51,66
050,26,137,"Michigan","Otsego County",4,84,117,48,69
050,26,137,"Michigan","Otsego County",4,85,489,192,297
050,26,137,"Michigan","Otsego County",5,0,237,118,119
050,26,137,"Michigan","Otsego County",5,1,237,115,122
050,26,137,"Michigan","Otsego County",5,2,247,118,129
050,26,137,"Michigan","Otsego County",5,3,276,149,127
050,26,137,"Michigan","Otsego County",5,4,269,135,134
050,26,137,"Michigan","Otsego County",5,5,299,154,145
050,26,137,"Michigan","Otsego County",5,6,293,142,151
050,26,137,"Michigan","Otsego County",5,7,321,164,157
050,26,137,"Michigan","Otsego County",5,8,292,162,130
050,26,137,"Michigan","Otsego County",5,9,284,159,125
050,26,137,"Michigan","Otsego County",5,10,308,174,134
050,26,137,"Michigan","Otsego County",5,11,316,175,141
050,26,137,"Michigan","Otsego County",5,12,331,183,148
050,26,137,"Michigan","Otsego County",5,13,314,162,152
050,26,137,"Michigan","Otsego County",5,14,312,170,142
050,26,137,"Michigan","Otsego County",5,15,321,164,157
050,26,137,"Michigan","Otsego County",5,16,331,173,158
050,26,137,"Michigan","Otsego County",5,17,329,155,174
050,26,137,"Michigan","Otsego County",5,18,261,139,122
050,26,137,"Michigan","Otsego County",5,19,203,112,91
050,26,137,"Michigan","Otsego County",5,20,225,111,114
050,26,137,"Michigan","Otsego County",5,21,258,141,117
050,26,137,"Michigan","Otsego County",5,22,276,154,122
050,26,137,"Michigan","Otsego County",5,23,277,159,118
050,26,137,"Michigan","Otsego County",5,24,272,152,120
050,26,137,"Michigan","Otsego County",5,25,279,144,135
050,26,137,"Michigan","Otsego County",5,26,264,130,134
050,26,137,"Michigan","Otsego County",5,27,264,129,135
050,26,137,"Michigan","Otsego County",5,28,300,154,146
050,26,137,"Michigan","Otsego County",5,29,299,155,144
050,26,137,"Michigan","Otsego County",5,30,313,152,161
050,26,137,"Michigan","Otsego County",5,31,321,167,154
050,26,137,"Michigan","Otsego County",5,32,355,178,177
050,26,137,"Michigan","Otsego County",5,33,348,171,177
050,26,137,"Michigan","Otsego County",5,34,293,146,147
050,26,137,"Michigan","Otsego County",5,35,315,160,155
050,26,137,"Michigan","Otsego County",5,36,289,142,147
050,26,137,"Michigan","Otsego County",5,37,292,150,142
050,26,137,"Michigan","Otsego County",5,38,292,142,150
050,26,137,"Michigan","Otsego County",5,39,296,142,154
050,26,137,"Michigan","Otsego County",5,40,302,161,141
050,26,137,"Michigan","Otsego County",5,41,308,156,152
050,26,137,"Michigan","Otsego County",5,42,286,138,148
050,26,137,"Michigan","Otsego County",5,43,294,144,150
050,26,137,"Michigan","Otsego County",5,44,271,127,144
050,26,137,"Michigan","Otsego County",5,45,271,135,136
050,26,137,"Michigan","Otsego County",5,46,266,134,132
050,26,137,"Michigan","Otsego County",5,47,252,128,124
050,26,137,"Michigan","Otsego County",5,48,261,133,128
050,26,137,"Michigan","Otsego County",5,49,267,129,138
050,26,137,"Michigan","Otsego County",5,50,289,152,137
050,26,137,"Michigan","Otsego County",5,51,300,144,156
050,26,137,"Michigan","Otsego County",5,52,357,178,179
050,26,137,"Michigan","Otsego County",5,53,317,166,151
050,26,137,"Michigan","Otsego County",5,54,330,165,165
050,26,137,"Michigan","Otsego County",5,55,362,185,177
050,26,137,"Michigan","Otsego County",5,56,363,177,186
050,26,137,"Michigan","Otsego County",5,57,381,200,181
050,26,137,"Michigan","Otsego County",5,58,398,204,194
050,26,137,"Michigan","Otsego County",5,59,413,217,196
050,26,137,"Michigan","Otsego County",5,60,372,166,206
050,26,137,"Michigan","Otsego County",5,61,386,191,195
050,26,137,"Michigan","Otsego County",5,62,427,208,219
050,26,137,"Michigan","Otsego County",5,63,396,204,192
050,26,137,"Michigan","Otsego County",5,64,416,198,218
050,26,137,"Michigan","Otsego County",5,65,441,230,211
050,26,137,"Michigan","Otsego County",5,66,430,226,204
050,26,137,"Michigan","Otsego County",5,67,368,191,177
050,26,137,"Michigan","Otsego County",5,68,362,180,182
050,26,137,"Michigan","Otsego County",5,69,359,185,174
050,26,137,"Michigan","Otsego County",5,70,356,170,186
050,26,137,"Michigan","Otsego County",5,71,341,166,175
050,26,137,"Michigan","Otsego County",5,72,323,167,156
050,26,137,"Michigan","Otsego County",5,73,313,161,152
050,26,137,"Michigan","Otsego County",5,74,288,131,157
050,26,137,"Michigan","Otsego County",5,75,278,137,141
050,26,137,"Michigan","Otsego County",5,76,296,155,141
050,26,137,"Michigan","Otsego County",5,77,196,99,97
050,26,137,"Michigan","Otsego County",5,78,177,79,98
050,26,137,"Michigan","Otsego County",5,79,164,77,87
050,26,137,"Michigan","Otsego County",5,80,152,78,74
050,26,137,"Michigan","Otsego County",5,81,141,70,71
050,26,137,"Michigan","Otsego County",5,82,132,67,65
050,26,137,"Michigan","Otsego County",5,83,121,46,75
050,26,137,"Michigan","Otsego County",5,84,111,48,63
050,26,137,"Michigan","Otsego County",5,85,504,195,309
050,26,139,"Michigan","Ottawa County",1,0,3102,1587,1515
050,26,139,"Michigan","Ottawa County",1,1,3285,1681,1604
050,26,139,"Michigan","Ottawa County",1,2,3520,1798,1722
050,26,139,"Michigan","Ottawa County",1,3,3652,1872,1780
050,26,139,"Michigan","Ottawa County",1,4,3719,1939,1780
050,26,139,"Michigan","Ottawa County",1,5,3849,2000,1849
050,26,139,"Michigan","Ottawa County",1,6,3920,2010,1910
050,26,139,"Michigan","Ottawa County",1,7,3973,2036,1937
050,26,139,"Michigan","Ottawa County",1,8,3894,1997,1897
050,26,139,"Michigan","Ottawa County",1,9,3967,2053,1914
050,26,139,"Michigan","Ottawa County",1,10,4089,2090,1999
050,26,139,"Michigan","Ottawa County",1,11,4190,2202,1988
050,26,139,"Michigan","Ottawa County",1,12,4331,2250,2081
050,26,139,"Michigan","Ottawa County",1,13,4304,2208,2096
050,26,139,"Michigan","Ottawa County",1,14,4115,2090,2025
050,26,139,"Michigan","Ottawa County",1,15,4117,2078,2039
050,26,139,"Michigan","Ottawa County",1,16,4250,2161,2089
050,26,139,"Michigan","Ottawa County",1,17,4056,2079,1977
050,26,139,"Michigan","Ottawa County",1,18,5813,2611,3202
050,26,139,"Michigan","Ottawa County",1,19,6906,3120,3786
050,26,139,"Michigan","Ottawa County",1,20,6414,3043,3371
050,26,139,"Michigan","Ottawa County",1,21,6094,3122,2972
050,26,139,"Michigan","Ottawa County",1,22,5233,2706,2527
050,26,139,"Michigan","Ottawa County",1,23,4593,2258,2335
050,26,139,"Michigan","Ottawa County",1,24,4018,2064,1954
050,26,139,"Michigan","Ottawa County",1,25,3767,1974,1793
050,26,139,"Michigan","Ottawa County",1,26,3598,1816,1782
050,26,139,"Michigan","Ottawa County",1,27,3629,1838,1791
050,26,139,"Michigan","Ottawa County",1,28,3703,1875,1828
050,26,139,"Michigan","Ottawa County",1,29,3636,1816,1820
050,26,139,"Michigan","Ottawa County",1,30,3506,1727,1779
050,26,139,"Michigan","Ottawa County",1,31,3465,1704,1761
050,26,139,"Michigan","Ottawa County",1,32,3410,1653,1757
050,26,139,"Michigan","Ottawa County",1,33,3429,1770,1659
050,26,139,"Michigan","Ottawa County",1,34,3586,1850,1736
050,26,139,"Michigan","Ottawa County",1,35,3625,1827,1798
050,26,139,"Michigan","Ottawa County",1,36,3656,1828,1828
050,26,139,"Michigan","Ottawa County",1,37,3780,1904,1876
050,26,139,"Michigan","Ottawa County",1,38,3714,1869,1845
050,26,139,"Michigan","Ottawa County",1,39,3709,1843,1866
050,26,139,"Michigan","Ottawa County",1,40,3645,1861,1784
050,26,139,"Michigan","Ottawa County",1,41,3562,1801,1761
050,26,139,"Michigan","Ottawa County",1,42,3470,1773,1697
050,26,139,"Michigan","Ottawa County",1,43,3304,1672,1632
050,26,139,"Michigan","Ottawa County",1,44,3184,1622,1562
050,26,139,"Michigan","Ottawa County",1,45,3279,1645,1634
050,26,139,"Michigan","Ottawa County",1,46,3075,1552,1523
050,26,139,"Michigan","Ottawa County",1,47,3083,1574,1509
050,26,139,"Michigan","Ottawa County",1,48,3364,1705,1659
050,26,139,"Michigan","Ottawa County",1,49,3536,1818,1718
050,26,139,"Michigan","Ottawa County",1,50,3410,1689,1721
050,26,139,"Michigan","Ottawa County",1,51,3320,1643,1677
050,26,139,"Michigan","Ottawa County",1,52,3283,1679,1604
050,26,139,"Michigan","Ottawa County",1,53,3485,1747,1738
050,26,139,"Michigan","Ottawa County",1,54,3516,1774,1742
050,26,139,"Michigan","Ottawa County",1,55,3550,1761,1789
050,26,139,"Michigan","Ottawa County",1,56,3699,1823,1876
050,26,139,"Michigan","Ottawa County",1,57,3705,1849,1856
050,26,139,"Michigan","Ottawa County",1,58,3831,1933,1898
050,26,139,"Michigan","Ottawa County",1,59,3700,1844,1856
050,26,139,"Michigan","Ottawa County",1,60,3645,1789,1856
050,26,139,"Michigan","Ottawa County",1,61,3578,1772,1806
050,26,139,"Michigan","Ottawa County",1,62,3527,1767,1760
050,26,139,"Michigan","Ottawa County",1,63,3357,1655,1702
050,26,139,"Michigan","Ottawa County",1,64,3291,1617,1674
050,26,139,"Michigan","Ottawa County",1,65,3270,1615,1655
050,26,139,"Michigan","Ottawa County",1,66,3164,1532,1632
050,26,139,"Michigan","Ottawa County",1,67,3070,1504,1566
050,26,139,"Michigan","Ottawa County",1,68,3058,1485,1573
050,26,139,"Michigan","Ottawa County",1,69,2756,1321,1435
050,26,139,"Michigan","Ottawa County",1,70,2600,1249,1351
050,26,139,"Michigan","Ottawa County",1,71,2542,1195,1347
050,26,139,"Michigan","Ottawa County",1,72,2513,1192,1321
050,26,139,"Michigan","Ottawa County",1,73,2551,1255,1296
050,26,139,"Michigan","Ottawa County",1,74,1758,824,934
050,26,139,"Michigan","Ottawa County",1,75,1728,809,919
050,26,139,"Michigan","Ottawa County",1,76,1766,810,956
050,26,139,"Michigan","Ottawa County",1,77,1749,787,962
050,26,139,"Michigan","Ottawa County",1,78,1591,742,849
050,26,139,"Michigan","Ottawa County",1,79,1396,637,759
050,26,139,"Michigan","Ottawa County",1,80,1203,533,670
050,26,139,"Michigan","Ottawa County",1,81,1143,512,631
050,26,139,"Michigan","Ottawa County",1,82,1062,463,599
050,26,139,"Michigan","Ottawa County",1,83,989,424,565
050,26,139,"Michigan","Ottawa County",1,84,905,369,536
050,26,139,"Michigan","Ottawa County",1,85,5373,1934,3439
050,26,139,"Michigan","Ottawa County",2,0,3096,1570,1526
050,26,139,"Michigan","Ottawa County",2,1,3261,1666,1595
050,26,139,"Michigan","Ottawa County",2,2,3486,1778,1708
050,26,139,"Michigan","Ottawa County",2,3,3621,1855,1766
050,26,139,"Michigan","Ottawa County",2,4,3731,1940,1791
050,26,139,"Michigan","Ottawa County",2,5,3839,1997,1842
050,26,139,"Michigan","Ottawa County",2,6,3928,2027,1901
050,26,139,"Michigan","Ottawa County",2,7,3963,2029,1934
050,26,139,"Michigan","Ottawa County",2,8,3921,2008,1913
050,26,139,"Michigan","Ottawa County",2,9,3960,2045,1915
050,26,139,"Michigan","Ottawa County",2,10,4072,2087,1985
050,26,139,"Michigan","Ottawa County",2,11,4157,2173,1984
050,26,139,"Michigan","Ottawa County",2,12,4311,2242,2069
050,26,139,"Michigan","Ottawa County",2,13,4305,2212,2093
050,26,139,"Michigan","Ottawa County",2,14,4168,2120,2048
050,26,139,"Michigan","Ottawa County",2,15,4126,2086,2040
050,26,139,"Michigan","Ottawa County",2,16,4223,2143,2080
050,26,139,"Michigan","Ottawa County",2,17,4113,2102,2011
050,26,139,"Michigan","Ottawa County",2,18,5807,2603,3204
050,26,139,"Michigan","Ottawa County",2,19,6904,3111,3793
050,26,139,"Michigan","Ottawa County",2,20,6479,3071,3408
050,26,139,"Michigan","Ottawa County",2,21,6067,3113,2954
050,26,139,"Michigan","Ottawa County",2,22,5214,2698,2516
050,26,139,"Michigan","Ottawa County",2,23,4617,2268,2349
050,26,139,"Michigan","Ottawa County",2,24,4023,2064,1959
050,26,139,"Michigan","Ottawa County",2,25,3748,1955,1793
050,26,139,"Michigan","Ottawa County",2,26,3617,1839,1778
050,26,139,"Michigan","Ottawa County",2,27,3607,1820,1787
050,26,139,"Michigan","Ottawa County",2,28,3710,1877,1833
050,26,139,"Michigan","Ottawa County",2,29,3670,1840,1830
050,26,139,"Michigan","Ottawa County",2,30,3582,1778,1804
050,26,139,"Michigan","Ottawa County",2,31,3489,1719,1770
050,26,139,"Michigan","Ottawa County",2,32,3440,1675,1765
050,26,139,"Michigan","Ottawa County",2,33,3441,1752,1689
050,26,139,"Michigan","Ottawa County",2,34,3579,1848,1731
050,26,139,"Michigan","Ottawa County",2,35,3651,1851,1800
050,26,139,"Michigan","Ottawa County",2,36,3637,1823,1814
050,26,139,"Michigan","Ottawa County",2,37,3764,1892,1872
050,26,139,"Michigan","Ottawa County",2,38,3742,1880,1862
050,26,139,"Michigan","Ottawa County",2,39,3708,1848,1860
050,26,139,"Michigan","Ottawa County",2,40,3687,1869,1818
050,26,139,"Michigan","Ottawa County",2,41,3585,1814,1771
050,26,139,"Michigan","Ottawa County",2,42,3471,1768,1703
050,26,139,"Michigan","Ottawa County",2,43,3368,1705,1663
050,26,139,"Michigan","Ottawa County",2,44,3194,1625,1569
050,26,139,"Michigan","Ottawa County",2,45,3271,1651,1620
050,26,139,"Michigan","Ottawa County",2,46,3117,1571,1546
050,26,139,"Michigan","Ottawa County",2,47,3078,1566,1512
050,26,139,"Michigan","Ottawa County",2,48,3297,1677,1620
050,26,139,"Michigan","Ottawa County",2,49,3512,1800,1712
050,26,139,"Michigan","Ottawa County",2,50,3453,1726,1727
050,26,139,"Michigan","Ottawa County",2,51,3323,1646,1677
050,26,139,"Michigan","Ottawa County",2,52,3279,1665,1614
050,26,139,"Michigan","Ottawa County",2,53,3445,1736,1709
050,26,139,"Michigan","Ottawa County",2,54,3495,1763,1732
050,26,139,"Michigan","Ottawa County",2,55,3543,1764,1779
050,26,139,"Michigan","Ottawa County",2,56,3671,1814,1857
050,26,139,"Michigan","Ottawa County",2,57,3715,1849,1866
050,26,139,"Michigan","Ottawa County",2,58,3789,1908,1881
050,26,139,"Michigan","Ottawa County",2,59,3750,1878,1872
050,26,139,"Michigan","Ottawa County",2,60,3652,1800,1852
050,26,139,"Michigan","Ottawa County",2,61,3586,1770,1816
050,26,139,"Michigan","Ottawa County",2,62,3539,1768,1771
050,26,139,"Michigan","Ottawa County",2,63,3420,1694,1726
050,26,139,"Michigan","Ottawa County",2,64,3291,1615,1676
050,26,139,"Michigan","Ottawa County",2,65,3268,1609,1659
050,26,139,"Michigan","Ottawa County",2,66,3192,1551,1641
050,26,139,"Michigan","Ottawa County",2,67,3088,1509,1579
050,26,139,"Michigan","Ottawa County",2,68,3045,1485,1560
050,26,139,"Michigan","Ottawa County",2,69,2848,1365,1483
050,26,139,"Michigan","Ottawa County",2,70,2632,1264,1368
050,26,139,"Michigan","Ottawa County",2,71,2563,1211,1352
050,26,139,"Michigan","Ottawa County",2,72,2477,1168,1309
050,26,139,"Michigan","Ottawa County",2,73,2667,1301,1366
050,26,139,"Michigan","Ottawa County",2,74,1820,864,956
050,26,139,"Michigan","Ottawa County",2,75,1729,810,919
050,26,139,"Michigan","Ottawa County",2,76,1728,798,930
050,26,139,"Michigan","Ottawa County",2,77,1792,810,982
050,26,139,"Michigan","Ottawa County",2,78,1586,732,854
050,26,139,"Michigan","Ottawa County",2,79,1429,653,776
050,26,139,"Michigan","Ottawa County",2,80,1238,548,690
050,26,139,"Michigan","Ottawa County",2,81,1143,513,630
050,26,139,"Michigan","Ottawa County",2,82,1073,472,601
050,26,139,"Michigan","Ottawa County",2,83,989,423,566
050,26,139,"Michigan","Ottawa County",2,84,917,377,540
050,26,139,"Michigan","Ottawa County",2,85,5375,1932,3443
050,26,139,"Michigan","Ottawa County",3,0,3092,1591,1501
050,26,139,"Michigan","Ottawa County",3,1,3175,1625,1550
050,26,139,"Michigan","Ottawa County",3,2,3368,1710,1658
050,26,139,"Michigan","Ottawa County",3,3,3543,1799,1744
050,26,139,"Michigan","Ottawa County",3,4,3648,1844,1804
050,26,139,"Michigan","Ottawa County",3,5,3753,1967,1786
050,26,139,"Michigan","Ottawa County",3,6,3895,2037,1858
050,26,139,"Michigan","Ottawa County",3,7,3938,2040,1898
050,26,139,"Michigan","Ottawa County",3,8,4000,2038,1962
050,26,139,"Michigan","Ottawa County",3,9,3946,2021,1925
050,26,139,"Michigan","Ottawa County",3,10,4001,2065,1936
050,26,139,"Michigan","Ottawa County",3,11,4172,2144,2028
050,26,139,"Michigan","Ottawa County",3,12,4175,2176,1999
050,26,139,"Michigan","Ottawa County",3,13,4318,2246,2072
050,26,139,"Michigan","Ottawa County",3,14,4348,2232,2116
050,26,139,"Michigan","Ottawa County",3,15,4189,2161,2028
050,26,139,"Michigan","Ottawa County",3,16,4142,2075,2067
050,26,139,"Michigan","Ottawa County",3,17,4221,2136,2085
050,26,139,"Michigan","Ottawa County",3,18,5577,2533,3044
050,26,139,"Michigan","Ottawa County",3,19,6374,2884,3490
050,26,139,"Michigan","Ottawa County",3,20,6371,3047,3324
050,26,139,"Michigan","Ottawa County",3,21,6039,3132,2907
050,26,139,"Michigan","Ottawa County",3,22,5182,2695,2487
050,26,139,"Michigan","Ottawa County",3,23,4699,2320,2379
050,26,139,"Michigan","Ottawa County",3,24,4106,2093,2013
050,26,139,"Michigan","Ottawa County",3,25,3735,1949,1786
050,26,139,"Michigan","Ottawa County",3,26,3615,1879,1736
050,26,139,"Michigan","Ottawa County",3,27,3570,1820,1750
050,26,139,"Michigan","Ottawa County",3,28,3642,1848,1794
050,26,139,"Michigan","Ottawa County",3,29,3750,1895,1855
050,26,139,"Michigan","Ottawa County",3,30,3767,1886,1881
050,26,139,"Michigan","Ottawa County",3,31,3586,1766,1820
050,26,139,"Michigan","Ottawa County",3,32,3600,1774,1826
050,26,139,"Michigan","Ottawa County",3,33,3550,1757,1793
050,26,139,"Michigan","Ottawa County",3,34,3553,1815,1738
050,26,139,"Michigan","Ottawa County",3,35,3631,1889,1742
050,26,139,"Michigan","Ottawa County",3,36,3716,1886,1830
050,26,139,"Michigan","Ottawa County",3,37,3671,1843,1828
050,26,139,"Michigan","Ottawa County",3,38,3842,1907,1935
050,26,139,"Michigan","Ottawa County",3,39,3786,1897,1889
050,26,139,"Michigan","Ottawa County",3,40,3748,1862,1886
050,26,139,"Michigan","Ottawa County",3,41,3741,1898,1843
050,26,139,"Michigan","Ottawa County",3,42,3607,1845,1762
050,26,139,"Michigan","Ottawa County",3,43,3496,1771,1725
050,26,139,"Michigan","Ottawa County",3,44,3365,1711,1654
050,26,139,"Michigan","Ottawa County",3,45,3206,1639,1567
050,26,139,"Michigan","Ottawa County",3,46,3237,1618,1619
050,26,139,"Michigan","Ottawa County",3,47,3105,1571,1534
050,26,139,"Michigan","Ottawa County",3,48,3074,1570,1504
050,26,139,"Michigan","Ottawa County",3,49,3295,1659,1636
050,26,139,"Michigan","Ottawa County",3,50,3489,1787,1702
050,26,139,"Michigan","Ottawa County",3,51,3426,1706,1720
050,26,139,"Michigan","Ottawa County",3,52,3334,1651,1683
050,26,139,"Michigan","Ottawa County",3,53,3302,1674,1628
050,26,139,"Michigan","Ottawa County",3,54,3450,1740,1710
050,26,139,"Michigan","Ottawa County",3,55,3460,1742,1718
050,26,139,"Michigan","Ottawa County",3,56,3533,1749,1784
050,26,139,"Michigan","Ottawa County",3,57,3680,1817,1863
050,26,139,"Michigan","Ottawa County",3,58,3720,1861,1859
050,26,139,"Michigan","Ottawa County",3,59,3762,1906,1856
050,26,139,"Michigan","Ottawa County",3,60,3749,1868,1881
050,26,139,"Michigan","Ottawa County",3,61,3641,1779,1862
050,26,139,"Michigan","Ottawa County",3,62,3584,1776,1808
050,26,139,"Michigan","Ottawa County",3,63,3506,1749,1757
050,26,139,"Michigan","Ottawa County",3,64,3423,1684,1739
050,26,139,"Michigan","Ottawa County",3,65,3256,1588,1668
050,26,139,"Michigan","Ottawa County",3,66,3261,1621,1640
050,26,139,"Michigan","Ottawa County",3,67,3161,1531,1630
050,26,139,"Michigan","Ottawa County",3,68,3084,1499,1585
050,26,139,"Michigan","Ottawa County",3,69,3013,1442,1571
050,26,139,"Michigan","Ottawa County",3,70,2810,1350,1460
050,26,139,"Michigan","Ottawa County",3,71,2606,1255,1351
050,26,139,"Michigan","Ottawa County",3,72,2541,1186,1355
050,26,139,"Michigan","Ottawa County",3,73,2471,1157,1314
050,26,139,"Michigan","Ottawa County",3,74,2605,1254,1351
050,26,139,"Michigan","Ottawa County",3,75,1784,838,946
050,26,139,"Michigan","Ottawa County",3,76,1683,783,900
050,26,139,"Michigan","Ottawa County",3,77,1688,760,928
050,26,139,"Michigan","Ottawa County",3,78,1749,781,968
050,26,139,"Michigan","Ottawa County",3,79,1532,696,836
050,26,139,"Michigan","Ottawa County",3,80,1353,608,745
050,26,139,"Michigan","Ottawa County",3,81,1186,519,667
050,26,139,"Michigan","Ottawa County",3,82,1077,484,593
050,26,139,"Michigan","Ottawa County",3,83,1020,446,574
050,26,139,"Michigan","Ottawa County",3,84,925,376,549
050,26,139,"Michigan","Ottawa County",3,85,5369,1958,3411
050,26,139,"Michigan","Ottawa County",4,0,3110,1604,1506
050,26,139,"Michigan","Ottawa County",4,1,3227,1639,1588
050,26,139,"Michigan","Ottawa County",4,2,3264,1679,1585
050,26,139,"Michigan","Ottawa County",4,3,3438,1766,1672
050,26,139,"Michigan","Ottawa County",4,4,3604,1834,1770
050,26,139,"Michigan","Ottawa County",4,5,3659,1876,1783
050,26,139,"Michigan","Ottawa County",4,6,3821,1992,1829
050,26,139,"Michigan","Ottawa County",4,7,3897,2024,1873
050,26,139,"Michigan","Ottawa County",4,8,3961,2069,1892
050,26,139,"Michigan","Ottawa County",4,9,4015,2034,1981
050,26,139,"Michigan","Ottawa County",4,10,3987,2034,1953
050,26,139,"Michigan","Ottawa County",4,11,4016,2077,1939
050,26,139,"Michigan","Ottawa County",4,12,4181,2155,2026
050,26,139,"Michigan","Ottawa County",4,13,4155,2150,2005
050,26,139,"Michigan","Ottawa County",4,14,4299,2224,2075
050,26,139,"Michigan","Ottawa County",4,15,4329,2213,2116
050,26,139,"Michigan","Ottawa County",4,16,4166,2130,2036
050,26,139,"Michigan","Ottawa County",4,17,4174,2089,2085
050,26,139,"Michigan","Ottawa County",4,18,5708,2568,3140
050,26,139,"Michigan","Ottawa County",4,19,6534,2947,3587
050,26,139,"Michigan","Ottawa County",4,20,6214,2948,3266
050,26,139,"Michigan","Ottawa County",4,21,6109,3131,2978
050,26,139,"Michigan","Ottawa County",4,22,5257,2707,2550
050,26,139,"Michigan","Ottawa County",4,23,4744,2356,2388
050,26,139,"Michigan","Ottawa County",4,24,4209,2203,2006
050,26,139,"Michigan","Ottawa County",4,25,3762,1958,1804
050,26,139,"Michigan","Ottawa County",4,26,3610,1880,1730
050,26,139,"Michigan","Ottawa County",4,27,3526,1829,1697
050,26,139,"Michigan","Ottawa County",4,28,3680,1859,1821
050,26,139,"Michigan","Ottawa County",4,29,3633,1853,1780
050,26,139,"Michigan","Ottawa County",4,30,3808,1943,1865
050,26,139,"Michigan","Ottawa County",4,31,3835,1910,1925
050,26,139,"Michigan","Ottawa County",4,32,3702,1832,1870
050,26,139,"Michigan","Ottawa County",4,33,3689,1826,1863
050,26,139,"Michigan","Ottawa County",4,34,3598,1793,1805
050,26,139,"Michigan","Ottawa County",4,35,3626,1857,1769
050,26,139,"Michigan","Ottawa County",4,36,3683,1923,1760
050,26,139,"Michigan","Ottawa County",4,37,3812,1943,1869
050,26,139,"Michigan","Ottawa County",4,38,3718,1864,1854
050,26,139,"Michigan","Ottawa County",4,39,3941,1948,1993
050,26,139,"Michigan","Ottawa County",4,40,3832,1927,1905
050,26,139,"Michigan","Ottawa County",4,41,3810,1917,1893
050,26,139,"Michigan","Ottawa County",4,42,3761,1909,1852
050,26,139,"Michigan","Ottawa County",4,43,3592,1831,1761
050,26,139,"Michigan","Ottawa County",4,44,3486,1760,1726
050,26,139,"Michigan","Ottawa County",4,45,3389,1736,1653
050,26,139,"Michigan","Ottawa County",4,46,3191,1621,1570
050,26,139,"Michigan","Ottawa County",4,47,3221,1617,1604
050,26,139,"Michigan","Ottawa County",4,48,3098,1572,1526
050,26,139,"Michigan","Ottawa County",4,49,3090,1574,1516
050,26,139,"Michigan","Ottawa County",4,50,3279,1637,1642
050,26,139,"Michigan","Ottawa County",4,51,3487,1777,1710
050,26,139,"Michigan","Ottawa County",4,52,3413,1706,1707
050,26,139,"Michigan","Ottawa County",4,53,3299,1620,1679
050,26,139,"Michigan","Ottawa County",4,54,3293,1669,1624
050,26,139,"Michigan","Ottawa County",4,55,3441,1733,1708
050,26,139,"Michigan","Ottawa County",4,56,3472,1739,1733
050,26,139,"Michigan","Ottawa County",4,57,3525,1740,1785
050,26,139,"Michigan","Ottawa County",4,58,3647,1797,1850
050,26,139,"Michigan","Ottawa County",4,59,3703,1824,1879
050,26,139,"Michigan","Ottawa County",4,60,3743,1880,1863
050,26,139,"Michigan","Ottawa County",4,61,3752,1851,1901
050,26,139,"Michigan","Ottawa County",4,62,3635,1774,1861
050,26,139,"Michigan","Ottawa County",4,63,3539,1753,1786
050,26,139,"Michigan","Ottawa County",4,64,3486,1728,1758
050,26,139,"Michigan","Ottawa County",4,65,3385,1661,1724
050,26,139,"Michigan","Ottawa County",4,66,3218,1561,1657
050,26,139,"Michigan","Ottawa County",4,67,3216,1598,1618
050,26,139,"Michigan","Ottawa County",4,68,3142,1516,1626
050,26,139,"Michigan","Ottawa County",4,69,3070,1485,1585
050,26,139,"Michigan","Ottawa County",4,70,2994,1424,1570
050,26,139,"Michigan","Ottawa County",4,71,2782,1343,1439
050,26,139,"Michigan","Ottawa County",4,72,2583,1226,1357
050,26,139,"Michigan","Ottawa County",4,73,2565,1187,1378
050,26,139,"Michigan","Ottawa County",4,74,2443,1136,1307
050,26,139,"Michigan","Ottawa County",4,75,2577,1228,1349
050,26,139,"Michigan","Ottawa County",4,76,1756,817,939
050,26,139,"Michigan","Ottawa County",4,77,1662,771,891
050,26,139,"Michigan","Ottawa County",4,78,1669,756,913
050,26,139,"Michigan","Ottawa County",4,79,1703,744,959
050,26,139,"Michigan","Ottawa County",4,80,1455,642,813
050,26,139,"Michigan","Ottawa County",4,81,1303,573,730
050,26,139,"Michigan","Ottawa County",4,82,1132,491,641
050,26,139,"Michigan","Ottawa County",4,83,1016,455,561
050,26,139,"Michigan","Ottawa County",4,84,962,414,548
050,26,139,"Michigan","Ottawa County",4,85,5400,1987,3413
050,26,139,"Michigan","Ottawa County",5,0,3095,1596,1499
050,26,139,"Michigan","Ottawa County",5,1,3218,1657,1561
050,26,139,"Michigan","Ottawa County",5,2,3295,1700,1595
050,26,139,"Michigan","Ottawa County",5,3,3333,1718,1615
050,26,139,"Michigan","Ottawa County",5,4,3466,1777,1689
050,26,139,"Michigan","Ottawa County",5,5,3618,1842,1776
050,26,139,"Michigan","Ottawa County",5,6,3708,1903,1805
050,26,139,"Michigan","Ottawa County",5,7,3863,2026,1837
050,26,139,"Michigan","Ottawa County",5,8,3906,2027,1879
050,26,139,"Michigan","Ottawa County",5,9,3998,2064,1934
050,26,139,"Michigan","Ottawa County",5,10,4023,2039,1984
050,26,139,"Michigan","Ottawa County",5,11,4005,2039,1966
050,26,139,"Michigan","Ottawa County",5,12,4021,2072,1949
050,26,139,"Michigan","Ottawa County",5,13,4196,2163,2033
050,26,139,"Michigan","Ottawa County",5,14,4175,2161,2014
050,26,139,"Michigan","Ottawa County",5,15,4282,2201,2081
050,26,139,"Michigan","Ottawa County",5,16,4373,2213,2160
050,26,139,"Michigan","Ottawa County",5,17,4169,2136,2033
050,26,139,"Michigan","Ottawa County",5,18,5694,2538,3156
050,26,139,"Michigan","Ottawa County",5,19,6621,2944,3677
050,26,139,"Michigan","Ottawa County",5,20,6363,2998,3365
050,26,139,"Michigan","Ottawa County",5,21,5996,3065,2931
050,26,139,"Michigan","Ottawa County",5,22,5374,2767,2607
050,26,139,"Michigan","Ottawa County",5,23,4831,2396,2435
050,26,139,"Michigan","Ottawa County",5,24,4192,2169,2023
050,26,139,"Michigan","Ottawa County",5,25,3933,2098,1835
050,26,139,"Michigan","Ottawa County",5,26,3615,1866,1749
050,26,139,"Michigan","Ottawa County",5,27,3546,1838,1708
050,26,139,"Michigan","Ottawa County",5,28,3584,1875,1709
050,26,139,"Michigan","Ottawa County",5,29,3692,1879,1813
050,26,139,"Michigan","Ottawa County",5,30,3640,1857,1783
050,26,139,"Michigan","Ottawa County",5,31,3874,1951,1923
050,26,139,"Michigan","Ottawa County",5,32,3865,1926,1939
050,26,139,"Michigan","Ottawa County",5,33,3785,1881,1904
050,26,139,"Michigan","Ottawa County",5,34,3782,1864,1918
050,26,139,"Michigan","Ottawa County",5,35,3657,1820,1837
050,26,139,"Michigan","Ottawa County",5,36,3690,1872,1818
050,26,139,"Michigan","Ottawa County",5,37,3745,1972,1773
050,26,139,"Michigan","Ottawa County",5,38,3838,1946,1892
050,26,139,"Michigan","Ottawa County",5,39,3795,1912,1883
050,26,139,"Michigan","Ottawa County",5,40,3924,1950,1974
050,26,139,"Michigan","Ottawa County",5,41,3827,1919,1908
050,26,139,"Michigan","Ottawa County",5,42,3809,1939,1870
050,26,139,"Michigan","Ottawa County",5,43,3743,1897,1846
050,26,139,"Michigan","Ottawa County",5,44,3594,1815,1779
050,26,139,"Michigan","Ottawa County",5,45,3527,1772,1755
050,26,139,"Michigan","Ottawa County",5,46,3389,1730,1659
050,26,139,"Michigan","Ottawa County",5,47,3206,1640,1566
050,26,139,"Michigan","Ottawa County",5,48,3238,1639,1599
050,26,139,"Michigan","Ottawa County",5,49,3128,1574,1554
050,26,139,"Michigan","Ottawa County",5,50,3089,1558,1531
050,26,139,"Michigan","Ottawa County",5,51,3266,1628,1638
050,26,139,"Michigan","Ottawa County",5,52,3469,1781,1688
050,26,139,"Michigan","Ottawa County",5,53,3393,1692,1701
050,26,139,"Michigan","Ottawa County",5,54,3270,1598,1672
050,26,139,"Michigan","Ottawa County",5,55,3296,1675,1621
050,26,139,"Michigan","Ottawa County",5,56,3457,1741,1716
050,26,139,"Michigan","Ottawa County",5,57,3465,1731,1734
050,26,139,"Michigan","Ottawa County",5,58,3504,1710,1794
050,26,139,"Michigan","Ottawa County",5,59,3632,1794,1838
050,26,139,"Michigan","Ottawa County",5,60,3694,1801,1893
050,26,139,"Michigan","Ottawa County",5,61,3739,1881,1858
050,26,139,"Michigan","Ottawa County",5,62,3709,1824,1885
050,26,139,"Michigan","Ottawa County",5,63,3593,1750,1843
050,26,139,"Michigan","Ottawa County",5,64,3545,1731,1814
050,26,139,"Michigan","Ottawa County",5,65,3437,1686,1751
050,26,139,"Michigan","Ottawa County",5,66,3402,1673,1729
050,26,139,"Michigan","Ottawa County",5,67,3178,1537,1641
050,26,139,"Michigan","Ottawa County",5,68,3230,1604,1626
050,26,139,"Michigan","Ottawa County",5,69,3116,1484,1632
050,26,139,"Michigan","Ottawa County",5,70,3061,1482,1579
050,26,139,"Michigan","Ottawa County",5,71,2961,1413,1548
050,26,139,"Michigan","Ottawa County",5,72,2749,1323,1426
050,26,139,"Michigan","Ottawa County",5,73,2564,1214,1350
050,26,139,"Michigan","Ottawa County",5,74,2544,1168,1376
050,26,139,"Michigan","Ottawa County",5,75,2411,1112,1299
050,26,139,"Michigan","Ottawa County",5,76,2501,1187,1314
050,26,139,"Michigan","Ottawa County",5,77,1721,791,930
050,26,139,"Michigan","Ottawa County",5,78,1636,755,881
050,26,139,"Michigan","Ottawa County",5,79,1626,721,905
050,26,139,"Michigan","Ottawa County",5,80,1647,710,937
050,26,139,"Michigan","Ottawa County",5,81,1417,625,792
050,26,139,"Michigan","Ottawa County",5,82,1259,558,701
050,26,139,"Michigan","Ottawa County",5,83,1085,464,621
050,26,139,"Michigan","Ottawa County",5,84,950,422,528
050,26,139,"Michigan","Ottawa County",5,85,5515,2096,3419
050,26,141,"Michigan","Presque Isle County",1,0,89,45,44
050,26,141,"Michigan","Presque Isle County",1,1,83,41,42
050,26,141,"Michigan","Presque Isle County",1,2,104,54,50
050,26,141,"Michigan","Presque Isle County",1,3,112,62,50
050,26,141,"Michigan","Presque Isle County",1,4,95,45,50
050,26,141,"Michigan","Presque Isle County",1,5,106,51,55
050,26,141,"Michigan","Presque Isle County",1,6,114,55,59
050,26,141,"Michigan","Presque Isle County",1,7,109,49,60
050,26,141,"Michigan","Presque Isle County",1,8,106,53,53
050,26,141,"Michigan","Presque Isle County",1,9,108,63,45
050,26,141,"Michigan","Presque Isle County",1,10,113,60,53
050,26,141,"Michigan","Presque Isle County",1,11,105,52,53
050,26,141,"Michigan","Presque Isle County",1,12,114,54,60
050,26,141,"Michigan","Presque Isle County",1,13,127,59,68
050,26,141,"Michigan","Presque Isle County",1,14,119,61,58
050,26,141,"Michigan","Presque Isle County",1,15,125,66,59
050,26,141,"Michigan","Presque Isle County",1,16,138,73,65
050,26,141,"Michigan","Presque Isle County",1,17,134,66,68
050,26,141,"Michigan","Presque Isle County",1,18,119,57,62
050,26,141,"Michigan","Presque Isle County",1,19,94,45,49
050,26,141,"Michigan","Presque Isle County",1,20,106,50,56
050,26,141,"Michigan","Presque Isle County",1,21,114,67,47
050,26,141,"Michigan","Presque Isle County",1,22,107,54,53
050,26,141,"Michigan","Presque Isle County",1,23,100,46,54
050,26,141,"Michigan","Presque Isle County",1,24,103,48,55
050,26,141,"Michigan","Presque Isle County",1,25,102,50,52
050,26,141,"Michigan","Presque Isle County",1,26,108,57,51
050,26,141,"Michigan","Presque Isle County",1,27,104,52,52
050,26,141,"Michigan","Presque Isle County",1,28,104,54,50
050,26,141,"Michigan","Presque Isle County",1,29,100,43,57
050,26,141,"Michigan","Presque Isle County",1,30,107,50,57
050,26,141,"Michigan","Presque Isle County",1,31,94,45,49
050,26,141,"Michigan","Presque Isle County",1,32,92,46,46
050,26,141,"Michigan","Presque Isle County",1,33,92,45,47
050,26,141,"Michigan","Presque Isle County",1,34,95,50,45
050,26,141,"Michigan","Presque Isle County",1,35,91,51,40
050,26,141,"Michigan","Presque Isle County",1,36,112,56,56
050,26,141,"Michigan","Presque Isle County",1,37,122,61,61
050,26,141,"Michigan","Presque Isle County",1,38,127,66,61
050,26,141,"Michigan","Presque Isle County",1,39,118,60,58
050,26,141,"Michigan","Presque Isle County",1,40,125,61,64
050,26,141,"Michigan","Presque Isle County",1,41,122,59,63
050,26,141,"Michigan","Presque Isle County",1,42,126,66,60
050,26,141,"Michigan","Presque Isle County",1,43,127,71,56
050,26,141,"Michigan","Presque Isle County",1,44,106,52,54
050,26,141,"Michigan","Presque Isle County",1,45,115,55,60
050,26,141,"Michigan","Presque Isle County",1,46,131,69,62
050,26,141,"Michigan","Presque Isle County",1,47,137,77,60
050,26,141,"Michigan","Presque Isle County",1,48,141,66,75
050,26,141,"Michigan","Presque Isle County",1,49,155,82,73
050,26,141,"Michigan","Presque Isle County",1,50,141,71,70
050,26,141,"Michigan","Presque Isle County",1,51,132,70,62
050,26,141,"Michigan","Presque Isle County",1,52,157,79,78
050,26,141,"Michigan","Presque Isle County",1,53,133,64,69
050,26,141,"Michigan","Presque Isle County",1,54,156,68,88
050,26,141,"Michigan","Presque Isle County",1,55,180,81,99
050,26,141,"Michigan","Presque Isle County",1,56,206,104,102
050,26,141,"Michigan","Presque Isle County",1,57,238,123,115
050,26,141,"Michigan","Presque Isle County",1,58,252,118,134
050,26,141,"Michigan","Presque Isle County",1,59,258,117,141
050,26,141,"Michigan","Presque Isle County",1,60,254,124,130
050,26,141,"Michigan","Presque Isle County",1,61,242,131,111
050,26,141,"Michigan","Presque Isle County",1,62,273,141,132
050,26,141,"Michigan","Presque Isle County",1,63,278,141,137
050,26,141,"Michigan","Presque Isle County",1,64,297,147,150
050,26,141,"Michigan","Presque Isle County",1,65,282,140,142
050,26,141,"Michigan","Presque Isle County",1,66,305,159,146
050,26,141,"Michigan","Presque Isle County",1,67,301,150,151
050,26,141,"Michigan","Presque Isle County",1,68,294,152,142
050,26,141,"Michigan","Presque Isle County",1,69,266,141,125
050,26,141,"Michigan","Presque Isle County",1,70,233,125,108
050,26,141,"Michigan","Presque Isle County",1,71,240,128,112
050,26,141,"Michigan","Presque Isle County",1,72,232,115,117
050,26,141,"Michigan","Presque Isle County",1,73,228,113,115
050,26,141,"Michigan","Presque Isle County",1,74,148,81,67
050,26,141,"Michigan","Presque Isle County",1,75,168,93,75
050,26,141,"Michigan","Presque Isle County",1,76,164,84,80
050,26,141,"Michigan","Presque Isle County",1,77,165,85,80
050,26,141,"Michigan","Presque Isle County",1,78,155,81,74
050,26,141,"Michigan","Presque Isle County",1,79,129,71,58
050,26,141,"Michigan","Presque Isle County",1,80,112,56,56
050,26,141,"Michigan","Presque Isle County",1,81,124,63,61
050,26,141,"Michigan","Presque Isle County",1,82,91,36,55
050,26,141,"Michigan","Presque Isle County",1,83,70,32,38
050,26,141,"Michigan","Presque Isle County",1,84,61,27,34
050,26,141,"Michigan","Presque Isle County",1,85,426,189,237
050,26,141,"Michigan","Presque Isle County",2,0,88,43,45
050,26,141,"Michigan","Presque Isle County",2,1,84,41,43
050,26,141,"Michigan","Presque Isle County",2,2,100,51,49
050,26,141,"Michigan","Presque Isle County",2,3,110,60,50
050,26,141,"Michigan","Presque Isle County",2,4,100,50,50
050,26,141,"Michigan","Presque Isle County",2,5,104,50,54
050,26,141,"Michigan","Presque Isle County",2,6,115,55,60
050,26,141,"Michigan","Presque Isle County",2,7,111,50,61
050,26,141,"Michigan","Presque Isle County",2,8,108,53,55
050,26,141,"Michigan","Presque Isle County",2,9,109,62,47
050,26,141,"Michigan","Presque Isle County",2,10,112,61,51
050,26,141,"Michigan","Presque Isle County",2,11,105,52,53
050,26,141,"Michigan","Presque Isle County",2,12,115,56,59
050,26,141,"Michigan","Presque Isle County",2,13,124,58,66
050,26,141,"Michigan","Presque Isle County",2,14,122,62,60
050,26,141,"Michigan","Presque Isle County",2,15,123,64,59
050,26,141,"Michigan","Presque Isle County",2,16,135,71,64
050,26,141,"Michigan","Presque Isle County",2,17,131,65,66
050,26,141,"Michigan","Presque Isle County",2,18,116,57,59
050,26,141,"Michigan","Presque Isle County",2,19,93,44,49
050,26,141,"Michigan","Presque Isle County",2,20,108,50,58
050,26,141,"Michigan","Presque Isle County",2,21,110,63,47
050,26,141,"Michigan","Presque Isle County",2,22,108,58,50
050,26,141,"Michigan","Presque Isle County",2,23,102,48,54
050,26,141,"Michigan","Presque Isle County",2,24,102,47,55
050,26,141,"Michigan","Presque Isle County",2,25,105,51,54
050,26,141,"Michigan","Presque Isle County",2,26,106,55,51
050,26,141,"Michigan","Presque Isle County",2,27,105,54,51
050,26,141,"Michigan","Presque Isle County",2,28,107,55,52
050,26,141,"Michigan","Presque Isle County",2,29,104,47,57
050,26,141,"Michigan","Presque Isle County",2,30,106,48,58
050,26,141,"Michigan","Presque Isle County",2,31,98,47,51
050,26,141,"Michigan","Presque Isle County",2,32,93,46,47
050,26,141,"Michigan","Presque Isle County",2,33,93,45,48
050,26,141,"Michigan","Presque Isle County",2,34,94,49,45
050,26,141,"Michigan","Presque Isle County",2,35,95,53,42
050,26,141,"Michigan","Presque Isle County",2,36,106,55,51
050,26,141,"Michigan","Presque Isle County",2,37,122,60,62
050,26,141,"Michigan","Presque Isle County",2,38,127,66,61
050,26,141,"Michigan","Presque Isle County",2,39,120,61,59
050,26,141,"Michigan","Presque Isle County",2,40,125,61,64
050,26,141,"Michigan","Presque Isle County",2,41,122,59,63
050,26,141,"Michigan","Presque Isle County",2,42,126,65,61
050,26,141,"Michigan","Presque Isle County",2,43,129,72,57
050,26,141,"Michigan","Presque Isle County",2,44,111,56,55
050,26,141,"Michigan","Presque Isle County",2,45,114,55,59
050,26,141,"Michigan","Presque Isle County",2,46,126,65,61
050,26,141,"Michigan","Presque Isle County",2,47,135,75,60
050,26,141,"Michigan","Presque Isle County",2,48,139,69,70
050,26,141,"Michigan","Presque Isle County",2,49,151,78,73
050,26,141,"Michigan","Presque Isle County",2,50,144,74,70
050,26,141,"Michigan","Presque Isle County",2,51,134,69,65
050,26,141,"Michigan","Presque Isle County",2,52,151,77,74
050,26,141,"Michigan","Presque Isle County",2,53,137,66,71
050,26,141,"Michigan","Presque Isle County",2,54,149,66,83
050,26,141,"Michigan","Presque Isle County",2,55,178,79,99
050,26,141,"Michigan","Presque Isle County",2,56,203,100,103
050,26,141,"Michigan","Presque Isle County",2,57,233,119,114
050,26,141,"Michigan","Presque Isle County",2,58,250,120,130
050,26,141,"Michigan","Presque Isle County",2,59,262,119,143
050,26,141,"Michigan","Presque Isle County",2,60,255,122,133
050,26,141,"Michigan","Presque Isle County",2,61,248,131,117
050,26,141,"Michigan","Presque Isle County",2,62,264,138,126
050,26,141,"Michigan","Presque Isle County",2,63,282,143,139
050,26,141,"Michigan","Presque Isle County",2,64,293,146,147
050,26,141,"Michigan","Presque Isle County",2,65,290,144,146
050,26,141,"Michigan","Presque Isle County",2,66,300,154,146
050,26,141,"Michigan","Presque Isle County",2,67,302,152,150
050,26,141,"Michigan","Presque Isle County",2,68,294,150,144
050,26,141,"Michigan","Presque Isle County",2,69,276,145,131
050,26,141,"Michigan","Presque Isle County",2,70,240,129,111
050,26,141,"Michigan","Presque Isle County",2,71,239,128,111
050,26,141,"Michigan","Presque Isle County",2,72,230,116,114
050,26,141,"Michigan","Presque Isle County",2,73,239,120,119
050,26,141,"Michigan","Presque Isle County",2,74,154,83,71
050,26,141,"Michigan","Presque Isle County",2,75,164,91,73
050,26,141,"Michigan","Presque Isle County",2,76,163,84,79
050,26,141,"Michigan","Presque Isle County",2,77,169,86,83
050,26,141,"Michigan","Presque Isle County",2,78,153,80,73
050,26,141,"Michigan","Presque Isle County",2,79,135,73,62
050,26,141,"Michigan","Presque Isle County",2,80,112,58,54
050,26,141,"Michigan","Presque Isle County",2,81,119,61,58
050,26,141,"Michigan","Presque Isle County",2,82,99,42,57
050,26,141,"Michigan","Presque Isle County",2,83,72,31,41
050,26,141,"Michigan","Presque Isle County",2,84,60,27,33
050,26,141,"Michigan","Presque Isle County",2,85,418,188,230
050,26,141,"Michigan","Presque Isle County",3,0,91,49,42
050,26,141,"Michigan","Presque Isle County",3,1,92,45,47
050,26,141,"Michigan","Presque Isle County",3,2,87,45,42
050,26,141,"Michigan","Presque Isle County",3,3,108,55,53
050,26,141,"Michigan","Presque Isle County",3,4,117,64,53
050,26,141,"Michigan","Presque Isle County",3,5,102,54,48
050,26,141,"Michigan","Presque Isle County",3,6,106,49,57
050,26,141,"Michigan","Presque Isle County",3,7,112,57,55
050,26,141,"Michigan","Presque Isle County",3,8,103,46,57
050,26,141,"Michigan","Presque Isle County",3,9,107,53,54
050,26,141,"Michigan","Presque Isle County",3,10,105,57,48
050,26,141,"Michigan","Presque Isle County",3,11,114,58,56
050,26,141,"Michigan","Presque Isle County",3,12,110,56,54
050,26,141,"Michigan","Presque Isle County",3,13,119,59,60
050,26,141,"Michigan","Presque Isle County",3,14,120,57,63
050,26,141,"Michigan","Presque Isle County",3,15,128,63,65
050,26,141,"Michigan","Presque Isle County",3,16,127,65,62
050,26,141,"Michigan","Presque Isle County",3,17,140,67,73
050,26,141,"Michigan","Presque Isle County",3,18,110,57,53
050,26,141,"Michigan","Presque Isle County",3,19,94,49,45
050,26,141,"Michigan","Presque Isle County",3,20,113,49,64
050,26,141,"Michigan","Presque Isle County",3,21,106,49,57
050,26,141,"Michigan","Presque Isle County",3,22,110,62,48
050,26,141,"Michigan","Presque Isle County",3,23,118,64,54
050,26,141,"Michigan","Presque Isle County",3,24,100,46,54
050,26,141,"Michigan","Presque Isle County",3,25,89,46,43
050,26,141,"Michigan","Presque Isle County",3,26,109,55,54
050,26,141,"Michigan","Presque Isle County",3,27,107,59,48
050,26,141,"Michigan","Presque Isle County",3,28,119,63,56
050,26,141,"Michigan","Presque Isle County",3,29,116,58,58
050,26,141,"Michigan","Presque Isle County",3,30,102,43,59
050,26,141,"Michigan","Presque Isle County",3,31,117,55,62
050,26,141,"Michigan","Presque Isle County",3,32,107,51,56
050,26,141,"Michigan","Presque Isle County",3,33,104,50,54
050,26,141,"Michigan","Presque Isle County",3,34,98,50,48
050,26,141,"Michigan","Presque Isle County",3,35,103,55,48
050,26,141,"Michigan","Presque Isle County",3,36,99,56,43
050,26,141,"Michigan","Presque Isle County",3,37,113,60,53
050,26,141,"Michigan","Presque Isle County",3,38,128,64,64
050,26,141,"Michigan","Presque Isle County",3,39,129,62,67
050,26,141,"Michigan","Presque Isle County",3,40,130,69,61
050,26,141,"Michigan","Presque Isle County",3,41,130,65,65
050,26,141,"Michigan","Presque Isle County",3,42,122,58,64
050,26,141,"Michigan","Presque Isle County",3,43,134,71,63
050,26,141,"Michigan","Presque Isle County",3,44,133,71,62
050,26,141,"Michigan","Presque Isle County",3,45,108,55,53
050,26,141,"Michigan","Presque Isle County",3,46,110,52,58
050,26,141,"Michigan","Presque Isle County",3,47,131,66,65
050,26,141,"Michigan","Presque Isle County",3,48,137,74,63
050,26,141,"Michigan","Presque Isle County",3,49,140,72,68
050,26,141,"Michigan","Presque Isle County",3,50,154,75,79
050,26,141,"Michigan","Presque Isle County",3,51,143,74,69
050,26,141,"Michigan","Presque Isle County",3,52,142,73,69
050,26,141,"Michigan","Presque Isle County",3,53,156,85,71
050,26,141,"Michigan","Presque Isle County",3,54,134,63,71
050,26,141,"Michigan","Presque Isle County",3,55,161,73,88
050,26,141,"Michigan","Presque Isle County",3,56,180,79,101
050,26,141,"Michigan","Presque Isle County",3,57,209,102,107
050,26,141,"Michigan","Presque Isle County",3,58,236,121,115
050,26,141,"Michigan","Presque Isle County",3,59,253,123,130
050,26,141,"Michigan","Presque Isle County",3,60,287,128,159
050,26,141,"Michigan","Presque Isle County",3,61,270,129,141
050,26,141,"Michigan","Presque Isle County",3,62,262,134,128
050,26,141,"Michigan","Presque Isle County",3,63,274,139,135
050,26,141,"Michigan","Presque Isle County",3,64,302,152,150
050,26,141,"Michigan","Presque Isle County",3,65,296,152,144
050,26,141,"Michigan","Presque Isle County",3,66,296,150,146
050,26,141,"Michigan","Presque Isle County",3,67,299,152,147
050,26,141,"Michigan","Presque Isle County",3,68,295,148,147
050,26,141,"Michigan","Presque Isle County",3,69,291,146,145
050,26,141,"Michigan","Presque Isle County",3,70,271,143,128
050,26,141,"Michigan","Presque Isle County",3,71,234,127,107
050,26,141,"Michigan","Presque Isle County",3,72,241,129,112
050,26,141,"Michigan","Presque Isle County",3,73,225,110,115
050,26,141,"Michigan","Presque Isle County",3,74,232,116,116
050,26,141,"Michigan","Presque Isle County",3,75,154,84,70
050,26,141,"Michigan","Presque Isle County",3,76,155,85,70
050,26,141,"Michigan","Presque Isle County",3,77,160,82,78
050,26,141,"Michigan","Presque Isle County",3,78,153,80,73
050,26,141,"Michigan","Presque Isle County",3,79,145,76,69
050,26,141,"Michigan","Presque Isle County",3,80,125,68,57
050,26,141,"Michigan","Presque Isle County",3,81,109,57,52
050,26,141,"Michigan","Presque Isle County",3,82,116,57,59
050,26,141,"Michigan","Presque Isle County",3,83,85,36,49
050,26,141,"Michigan","Presque Isle County",3,84,68,30,38
050,26,141,"Michigan","Presque Isle County",3,85,405,178,227
050,26,141,"Michigan","Presque Isle County",4,0,87,43,44
050,26,141,"Michigan","Presque Isle County",4,1,94,53,41
050,26,141,"Michigan","Presque Isle County",4,2,92,45,47
050,26,141,"Michigan","Presque Isle County",4,3,93,44,49
050,26,141,"Michigan","Presque Isle County",4,4,120,65,55
050,26,141,"Michigan","Presque Isle County",4,5,126,67,59
050,26,141,"Michigan","Presque Isle County",4,6,105,49,56
050,26,141,"Michigan","Presque Isle County",4,7,113,57,56
050,26,141,"Michigan","Presque Isle County",4,8,116,59,57
050,26,141,"Michigan","Presque Isle County",4,9,114,57,57
050,26,141,"Michigan","Presque Isle County",4,10,116,60,56
050,26,141,"Michigan","Presque Isle County",4,11,112,62,50
050,26,141,"Michigan","Presque Isle County",4,12,126,66,60
050,26,141,"Michigan","Presque Isle County",4,13,116,59,57
050,26,141,"Michigan","Presque Isle County",4,14,121,60,61
050,26,141,"Michigan","Presque Isle County",4,15,122,56,66
050,26,141,"Michigan","Presque Isle County",4,16,131,64,67
050,26,141,"Michigan","Presque Isle County",4,17,132,67,65
050,26,141,"Michigan","Presque Isle County",4,18,114,61,53
050,26,141,"Michigan","Presque Isle County",4,19,83,39,44
050,26,141,"Michigan","Presque Isle County",4,20,102,51,51
050,26,141,"Michigan","Presque Isle County",4,21,106,52,54
050,26,141,"Michigan","Presque Isle County",4,22,114,58,56
050,26,141,"Michigan","Presque Isle County",4,23,117,66,51
050,26,141,"Michigan","Presque Isle County",4,24,117,65,52
050,26,141,"Michigan","Presque Isle County",4,25,97,44,53
050,26,141,"Michigan","Presque Isle County",4,26,99,50,49
050,26,141,"Michigan","Presque Isle County",4,27,111,53,58
050,26,141,"Michigan","Presque Isle County",4,28,99,54,45
050,26,141,"Michigan","Presque Isle County",4,29,119,64,55
050,26,141,"Michigan","Presque Isle County",4,30,116,58,58
050,26,141,"Michigan","Presque Isle County",4,31,115,48,67
050,26,141,"Michigan","Presque Isle County",4,32,117,54,63
050,26,141,"Michigan","Presque Isle County",4,33,107,51,56
050,26,141,"Michigan","Presque Isle County",4,34,109,55,54
050,26,141,"Michigan","Presque Isle County",4,35,104,51,53
050,26,141,"Michigan","Presque Isle County",4,36,111,65,46
050,26,141,"Michigan","Presque Isle County",4,37,101,57,44
050,26,141,"Michigan","Presque Isle County",4,38,115,60,55
050,26,141,"Michigan","Presque Isle County",4,39,131,61,70
050,26,141,"Michigan","Presque Isle County",4,40,132,68,64
050,26,141,"Michigan","Presque Isle County",4,41,123,60,63
050,26,141,"Michigan","Presque Isle County",4,42,134,66,68
050,26,141,"Michigan","Presque Isle County",4,43,135,67,68
050,26,141,"Michigan","Presque Isle County",4,44,145,77,68
050,26,141,"Michigan","Presque Isle County",4,45,135,73,62
050,26,141,"Michigan","Presque Isle County",4,46,113,58,55
050,26,141,"Michigan","Presque Isle County",4,47,121,61,60
050,26,141,"Michigan","Presque Isle County",4,48,131,63,68
050,26,141,"Michigan","Presque Isle County",4,49,144,77,67
050,26,141,"Michigan","Presque Isle County",4,50,147,75,72
050,26,141,"Michigan","Presque Isle County",4,51,157,76,81
050,26,141,"Michigan","Presque Isle County",4,52,153,78,75
050,26,141,"Michigan","Presque Isle County",4,53,141,73,68
050,26,141,"Michigan","Presque Isle County",4,54,152,81,71
050,26,141,"Michigan","Presque Isle County",4,55,145,71,74
050,26,141,"Michigan","Presque Isle County",4,56,161,76,85
050,26,141,"Michigan","Presque Isle County",4,57,191,85,106
050,26,141,"Michigan","Presque Isle County",4,58,210,104,106
050,26,141,"Michigan","Presque Isle County",4,59,242,123,119
050,26,141,"Michigan","Presque Isle County",4,60,262,127,135
050,26,141,"Michigan","Presque Isle County",4,61,284,130,154
050,26,141,"Michigan","Presque Isle County",4,62,278,137,141
050,26,141,"Michigan","Presque Isle County",4,63,272,141,131
050,26,141,"Michigan","Presque Isle County",4,64,291,141,150
050,26,141,"Michigan","Presque Isle County",4,65,311,157,154
050,26,141,"Michigan","Presque Isle County",4,66,298,157,141
050,26,141,"Michigan","Presque Isle County",4,67,301,153,148
050,26,141,"Michigan","Presque Isle County",4,68,301,151,150
050,26,141,"Michigan","Presque Isle County",4,69,292,150,142
050,26,141,"Michigan","Presque Isle County",4,70,281,139,142
050,26,141,"Michigan","Presque Isle County",4,71,272,142,130
050,26,141,"Michigan","Presque Isle County",4,72,232,126,106
050,26,141,"Michigan","Presque Isle County",4,73,240,130,110
050,26,141,"Michigan","Presque Isle County",4,74,217,103,114
050,26,141,"Michigan","Presque Isle County",4,75,232,118,114
050,26,141,"Michigan","Presque Isle County",4,76,144,77,67
050,26,141,"Michigan","Presque Isle County",4,77,149,82,67
050,26,141,"Michigan","Presque Isle County",4,78,148,74,74
050,26,141,"Michigan","Presque Isle County",4,79,142,76,66
050,26,141,"Michigan","Presque Isle County",4,80,134,72,62
050,26,141,"Michigan","Presque Isle County",4,81,118,61,57
050,26,141,"Michigan","Presque Isle County",4,82,102,49,53
050,26,141,"Michigan","Presque Isle County",4,83,103,50,53
050,26,141,"Michigan","Presque Isle County",4,84,78,37,41
050,26,141,"Michigan","Presque Isle County",4,85,409,180,229
050,26,141,"Michigan","Presque Isle County",5,0,88,43,45
050,26,141,"Michigan","Presque Isle County",5,1,80,38,42
050,26,141,"Michigan","Presque Isle County",5,2,94,54,40
050,26,141,"Michigan","Presque Isle County",5,3,94,46,48
050,26,141,"Michigan","Presque Isle County",5,4,91,42,49
050,26,141,"Michigan","Presque Isle County",5,5,118,59,59
050,26,141,"Michigan","Presque Isle County",5,6,124,68,56
050,26,141,"Michigan","Presque Isle County",5,7,109,51,58
050,26,141,"Michigan","Presque Isle County",5,8,116,53,63
050,26,141,"Michigan","Presque Isle County",5,9,115,55,60
050,26,141,"Michigan","Presque Isle County",5,10,120,61,59
050,26,141,"Michigan","Presque Isle County",5,11,120,58,62
050,26,141,"Michigan","Presque Isle County",5,12,110,59,51
050,26,141,"Michigan","Presque Isle County",5,13,125,63,62
050,26,141,"Michigan","Presque Isle County",5,14,121,60,61
050,26,141,"Michigan","Presque Isle County",5,15,119,64,55
050,26,141,"Michigan","Presque Isle County",5,16,123,55,68
050,26,141,"Michigan","Presque Isle County",5,17,130,60,70
050,26,141,"Michigan","Presque Isle County",5,18,108,57,51
050,26,141,"Michigan","Presque Isle County",5,19,88,45,43
050,26,141,"Michigan","Presque Isle County",5,20,100,44,56
050,26,141,"Michigan","Presque Isle County",5,21,98,54,44
050,26,141,"Michigan","Presque Isle County",5,22,111,57,54
050,26,141,"Michigan","Presque Isle County",5,23,118,58,60
050,26,141,"Michigan","Presque Isle County",5,24,118,65,53
050,26,141,"Michigan","Presque Isle County",5,25,106,60,46
050,26,141,"Michigan","Presque Isle County",5,26,100,47,53
050,26,141,"Michigan","Presque Isle County",5,27,105,51,54
050,26,141,"Michigan","Presque Isle County",5,28,107,52,55
050,26,141,"Michigan","Presque Isle County",5,29,100,54,46
050,26,141,"Michigan","Presque Isle County",5,30,119,64,55
050,26,141,"Michigan","Presque Isle County",5,31,122,62,60
050,26,141,"Michigan","Presque Isle County",5,32,116,53,63
050,26,141,"Michigan","Presque Isle County",5,33,117,55,62
050,26,141,"Michigan","Presque Isle County",5,34,110,57,53
050,26,141,"Michigan","Presque Isle County",5,35,107,55,52
050,26,141,"Michigan","Presque Isle County",5,36,106,52,54
050,26,141,"Michigan","Presque Isle County",5,37,111,64,47
050,26,141,"Michigan","Presque Isle County",5,38,112,63,49
050,26,141,"Michigan","Presque Isle County",5,39,119,63,56
050,26,141,"Michigan","Presque Isle County",5,40,138,67,71
050,26,141,"Michigan","Presque Isle County",5,41,126,64,62
050,26,141,"Michigan","Presque Isle County",5,42,121,58,63
050,26,141,"Michigan","Presque Isle County",5,43,137,67,70
050,26,141,"Michigan","Presque Isle County",5,44,129,62,67
050,26,141,"Michigan","Presque Isle County",5,45,139,77,62
050,26,141,"Michigan","Presque Isle County",5,46,136,72,64
050,26,141,"Michigan","Presque Isle County",5,47,110,56,54
050,26,141,"Michigan","Presque Isle County",5,48,118,57,61
050,26,141,"Michigan","Presque Isle County",5,49,133,64,69
050,26,141,"Michigan","Presque Isle County",5,50,144,78,66
050,26,141,"Michigan","Presque Isle County",5,51,148,74,74
050,26,141,"Michigan","Presque Isle County",5,52,169,80,89
050,26,141,"Michigan","Presque Isle County",5,53,147,78,69
050,26,141,"Michigan","Presque Isle County",5,54,136,69,67
050,26,141,"Michigan","Presque Isle County",5,55,159,87,72
050,26,141,"Michigan","Presque Isle County",5,56,139,65,74
050,26,141,"Michigan","Presque Isle County",5,57,168,80,88
050,26,141,"Michigan","Presque Isle County",5,58,198,93,105
050,26,141,"Michigan","Presque Isle County",5,59,217,107,110
050,26,141,"Michigan","Presque Isle County",5,60,241,124,117
050,26,141,"Michigan","Presque Isle County",5,61,261,130,131
050,26,141,"Michigan","Presque Isle County",5,62,283,135,148
050,26,141,"Michigan","Presque Isle County",5,63,283,140,143
050,26,141,"Michigan","Presque Isle County",5,64,284,144,140
050,26,141,"Michigan","Presque Isle County",5,65,286,137,149
050,26,141,"Michigan","Presque Isle County",5,66,320,163,157
050,26,141,"Michigan","Presque Isle County",5,67,293,156,137
050,26,141,"Michigan","Presque Isle County",5,68,294,154,140
050,26,141,"Michigan","Presque Isle County",5,69,293,147,146
050,26,141,"Michigan","Presque Isle County",5,70,288,145,143
050,26,141,"Michigan","Presque Isle County",5,71,289,143,146
050,26,141,"Michigan","Presque Isle County",5,72,276,141,135
050,26,141,"Michigan","Presque Isle County",5,73,228,124,104
050,26,141,"Michigan","Presque Isle County",5,74,230,126,104
050,26,141,"Michigan","Presque Isle County",5,75,218,106,112
050,26,141,"Michigan","Presque Isle County",5,76,218,108,110
050,26,141,"Michigan","Presque Isle County",5,77,137,72,65
050,26,141,"Michigan","Presque Isle County",5,78,139,78,61
050,26,141,"Michigan","Presque Isle County",5,79,139,72,67
050,26,141,"Michigan","Presque Isle County",5,80,133,71,62
050,26,141,"Michigan","Presque Isle County",5,81,127,70,57
050,26,141,"Michigan","Presque Isle County",5,82,116,57,59
050,26,141,"Michigan","Presque Isle County",5,83,88,41,47
050,26,141,"Michigan","Presque Isle County",5,84,93,47,46
050,26,141,"Michigan","Presque Isle County",5,85,421,188,233
050,26,143,"Michigan","Roscommon County",1,0,155,76,79
050,26,143,"Michigan","Roscommon County",1,1,163,73,90
050,26,143,"Michigan","Roscommon County",1,2,166,87,79
050,26,143,"Michigan","Roscommon County",1,3,166,85,81
050,26,143,"Michigan","Roscommon County",1,4,165,91,74
050,26,143,"Michigan","Roscommon County",1,5,187,99,88
050,26,143,"Michigan","Roscommon County",1,6,173,87,86
050,26,143,"Michigan","Roscommon County",1,7,195,110,85
050,26,143,"Michigan","Roscommon County",1,8,206,105,101
050,26,143,"Michigan","Roscommon County",1,9,185,96,89
050,26,143,"Michigan","Roscommon County",1,10,196,96,100
050,26,143,"Michigan","Roscommon County",1,11,207,112,95
050,26,143,"Michigan","Roscommon County",1,12,234,126,108
050,26,143,"Michigan","Roscommon County",1,13,224,120,104
050,26,143,"Michigan","Roscommon County",1,14,225,112,113
050,26,143,"Michigan","Roscommon County",1,15,209,103,106
050,26,143,"Michigan","Roscommon County",1,16,199,107,92
050,26,143,"Michigan","Roscommon County",1,17,206,114,92
050,26,143,"Michigan","Roscommon County",1,18,205,111,94
050,26,143,"Michigan","Roscommon County",1,19,133,73,60
050,26,143,"Michigan","Roscommon County",1,20,166,91,75
050,26,143,"Michigan","Roscommon County",1,21,159,87,72
050,26,143,"Michigan","Roscommon County",1,22,171,82,89
050,26,143,"Michigan","Roscommon County",1,23,162,77,85
050,26,143,"Michigan","Roscommon County",1,24,181,88,93
050,26,143,"Michigan","Roscommon County",1,25,207,108,99
050,26,143,"Michigan","Roscommon County",1,26,215,114,101
050,26,143,"Michigan","Roscommon County",1,27,199,99,100
050,26,143,"Michigan","Roscommon County",1,28,186,103,83
050,26,143,"Michigan","Roscommon County",1,29,205,104,101
050,26,143,"Michigan","Roscommon County",1,30,190,93,97
050,26,143,"Michigan","Roscommon County",1,31,176,82,94
050,26,143,"Michigan","Roscommon County",1,32,182,89,93
050,26,143,"Michigan","Roscommon County",1,33,197,94,103
050,26,143,"Michigan","Roscommon County",1,34,203,94,109
050,26,143,"Michigan","Roscommon County",1,35,190,90,100
050,26,143,"Michigan","Roscommon County",1,36,203,103,100
050,26,143,"Michigan","Roscommon County",1,37,183,91,92
050,26,143,"Michigan","Roscommon County",1,38,201,108,93
050,26,143,"Michigan","Roscommon County",1,39,191,101,90
050,26,143,"Michigan","Roscommon County",1,40,188,99,89
050,26,143,"Michigan","Roscommon County",1,41,203,103,100
050,26,143,"Michigan","Roscommon County",1,42,193,100,93
050,26,143,"Michigan","Roscommon County",1,43,191,90,101
050,26,143,"Michigan","Roscommon County",1,44,169,73,96
050,26,143,"Michigan","Roscommon County",1,45,194,92,102
050,26,143,"Michigan","Roscommon County",1,46,225,122,103
050,26,143,"Michigan","Roscommon County",1,47,215,115,100
050,26,143,"Michigan","Roscommon County",1,48,244,118,126
050,26,143,"Michigan","Roscommon County",1,49,280,134,146
050,26,143,"Michigan","Roscommon County",1,50,272,138,134
050,26,143,"Michigan","Roscommon County",1,51,283,142,141
050,26,143,"Michigan","Roscommon County",1,52,261,139,122
050,26,143,"Michigan","Roscommon County",1,53,319,165,154
050,26,143,"Michigan","Roscommon County",1,54,326,156,170
050,26,143,"Michigan","Roscommon County",1,55,338,159,179
050,26,143,"Michigan","Roscommon County",1,56,360,175,185
050,26,143,"Michigan","Roscommon County",1,57,431,209,222
050,26,143,"Michigan","Roscommon County",1,58,437,198,239
050,26,143,"Michigan","Roscommon County",1,59,461,234,227
050,26,143,"Michigan","Roscommon County",1,60,466,248,218
050,26,143,"Michigan","Roscommon County",1,61,490,251,239
050,26,143,"Michigan","Roscommon County",1,62,499,243,256
050,26,143,"Michigan","Roscommon County",1,63,542,273,269
050,26,143,"Michigan","Roscommon County",1,64,567,282,285
050,26,143,"Michigan","Roscommon County",1,65,591,297,294
050,26,143,"Michigan","Roscommon County",1,66,585,301,284
050,26,143,"Michigan","Roscommon County",1,67,510,264,246
050,26,143,"Michigan","Roscommon County",1,68,493,271,222
050,26,143,"Michigan","Roscommon County",1,69,463,248,215
050,26,143,"Michigan","Roscommon County",1,70,466,226,240
050,26,143,"Michigan","Roscommon County",1,71,453,209,244
050,26,143,"Michigan","Roscommon County",1,72,467,248,219
050,26,143,"Michigan","Roscommon County",1,73,453,238,215
050,26,143,"Michigan","Roscommon County",1,74,297,164,133
050,26,143,"Michigan","Roscommon County",1,75,326,172,154
050,26,143,"Michigan","Roscommon County",1,76,339,178,161
050,26,143,"Michigan","Roscommon County",1,77,344,179,165
050,26,143,"Michigan","Roscommon County",1,78,254,130,124
050,26,143,"Michigan","Roscommon County",1,79,235,127,108
050,26,143,"Michigan","Roscommon County",1,80,209,105,104
050,26,143,"Michigan","Roscommon County",1,81,199,92,107
050,26,143,"Michigan","Roscommon County",1,82,173,81,92
050,26,143,"Michigan","Roscommon County",1,83,158,75,83
050,26,143,"Michigan","Roscommon County",1,84,130,62,68
050,26,143,"Michigan","Roscommon County",1,85,590,265,325
050,26,143,"Michigan","Roscommon County",2,0,157,77,80
050,26,143,"Michigan","Roscommon County",2,1,161,74,87
050,26,143,"Michigan","Roscommon County",2,2,164,83,81
050,26,143,"Michigan","Roscommon County",2,3,164,86,78
050,26,143,"Michigan","Roscommon County",2,4,165,90,75
050,26,143,"Michigan","Roscommon County",2,5,183,96,87
050,26,143,"Michigan","Roscommon County",2,6,178,90,88
050,26,143,"Michigan","Roscommon County",2,7,190,105,85
050,26,143,"Michigan","Roscommon County",2,8,201,105,96
050,26,143,"Michigan","Roscommon County",2,9,190,98,92
050,26,143,"Michigan","Roscommon County",2,10,191,95,96
050,26,143,"Michigan","Roscommon County",2,11,205,108,97
050,26,143,"Michigan","Roscommon County",2,12,226,122,104
050,26,143,"Michigan","Roscommon County",2,13,227,121,106
050,26,143,"Michigan","Roscommon County",2,14,223,114,109
050,26,143,"Michigan","Roscommon County",2,15,214,106,108
050,26,143,"Michigan","Roscommon County",2,16,201,106,95
050,26,143,"Michigan","Roscommon County",2,17,207,114,93
050,26,143,"Michigan","Roscommon County",2,18,193,107,86
050,26,143,"Michigan","Roscommon County",2,19,141,78,63
050,26,143,"Michigan","Roscommon County",2,20,162,89,73
050,26,143,"Michigan","Roscommon County",2,21,161,87,74
050,26,143,"Michigan","Roscommon County",2,22,169,83,86
050,26,143,"Michigan","Roscommon County",2,23,169,81,88
050,26,143,"Michigan","Roscommon County",2,24,182,89,93
050,26,143,"Michigan","Roscommon County",2,25,202,103,99
050,26,143,"Michigan","Roscommon County",2,26,215,112,103
050,26,143,"Michigan","Roscommon County",2,27,204,104,100
050,26,143,"Michigan","Roscommon County",2,28,188,103,85
050,26,143,"Michigan","Roscommon County",2,29,198,103,95
050,26,143,"Michigan","Roscommon County",2,30,195,95,100
050,26,143,"Michigan","Roscommon County",2,31,179,84,95
050,26,143,"Michigan","Roscommon County",2,32,182,88,94
050,26,143,"Michigan","Roscommon County",2,33,192,92,100
050,26,143,"Michigan","Roscommon County",2,34,202,95,107
050,26,143,"Michigan","Roscommon County",2,35,194,92,102
050,26,143,"Michigan","Roscommon County",2,36,199,101,98
050,26,143,"Michigan","Roscommon County",2,37,189,94,95
050,26,143,"Michigan","Roscommon County",2,38,198,106,92
050,26,143,"Michigan","Roscommon County",2,39,193,102,91
050,26,143,"Michigan","Roscommon County",2,40,189,99,90
050,26,143,"Michigan","Roscommon County",2,41,200,102,98
050,26,143,"Michigan","Roscommon County",2,42,196,102,94
050,26,143,"Michigan","Roscommon County",2,43,193,93,100
050,26,143,"Michigan","Roscommon County",2,44,176,77,99
050,26,143,"Michigan","Roscommon County",2,45,191,89,102
050,26,143,"Michigan","Roscommon County",2,46,215,113,102
050,26,143,"Michigan","Roscommon County",2,47,217,117,100
050,26,143,"Michigan","Roscommon County",2,48,235,116,119
050,26,143,"Michigan","Roscommon County",2,49,273,130,143
050,26,143,"Michigan","Roscommon County",2,50,276,139,137
050,26,143,"Michigan","Roscommon County",2,51,276,142,134
050,26,143,"Michigan","Roscommon County",2,52,267,141,126
050,26,143,"Michigan","Roscommon County",2,53,308,160,148
050,26,143,"Michigan","Roscommon County",2,54,325,159,166
050,26,143,"Michigan","Roscommon County",2,55,337,157,180
050,26,143,"Michigan","Roscommon County",2,56,364,176,188
050,26,143,"Michigan","Roscommon County",2,57,423,204,219
050,26,143,"Michigan","Roscommon County",2,58,438,202,236
050,26,143,"Michigan","Roscommon County",2,59,467,232,235
050,26,143,"Michigan","Roscommon County",2,60,467,245,222
050,26,143,"Michigan","Roscommon County",2,61,485,249,236
050,26,143,"Michigan","Roscommon County",2,62,503,249,254
050,26,143,"Michigan","Roscommon County",2,63,536,268,268
050,26,143,"Michigan","Roscommon County",2,64,561,280,281
050,26,143,"Michigan","Roscommon County",2,65,590,296,294
050,26,143,"Michigan","Roscommon County",2,66,589,302,287
050,26,143,"Michigan","Roscommon County",2,67,528,273,255
050,26,143,"Michigan","Roscommon County",2,68,493,266,227
050,26,143,"Michigan","Roscommon County",2,69,473,255,218
050,26,143,"Michigan","Roscommon County",2,70,461,229,232
050,26,143,"Michigan","Roscommon County",2,71,456,213,243
050,26,143,"Michigan","Roscommon County",2,72,453,233,220
050,26,143,"Michigan","Roscommon County",2,73,477,253,224
050,26,143,"Michigan","Roscommon County",2,74,311,171,140
050,26,143,"Michigan","Roscommon County",2,75,318,169,149
050,26,143,"Michigan","Roscommon County",2,76,331,176,155
050,26,143,"Michigan","Roscommon County",2,77,349,181,168
050,26,143,"Michigan","Roscommon County",2,78,265,137,128
050,26,143,"Michigan","Roscommon County",2,79,236,125,111
050,26,143,"Michigan","Roscommon County",2,80,213,110,103
050,26,143,"Michigan","Roscommon County",2,81,199,94,105
050,26,143,"Michigan","Roscommon County",2,82,176,82,94
050,26,143,"Michigan","Roscommon County",2,83,157,74,83
050,26,143,"Michigan","Roscommon County",2,84,133,62,71
050,26,143,"Michigan","Roscommon County",2,85,592,269,323
050,26,143,"Michigan","Roscommon County",3,0,132,82,50
050,26,143,"Michigan","Roscommon County",3,1,159,78,81
050,26,143,"Michigan","Roscommon County",3,2,182,84,98
050,26,143,"Michigan","Roscommon County",3,3,162,81,81
050,26,143,"Michigan","Roscommon County",3,4,170,91,79
050,26,143,"Michigan","Roscommon County",3,5,174,96,78
050,26,143,"Michigan","Roscommon County",3,6,197,101,96
050,26,143,"Michigan","Roscommon County",3,7,173,95,78
050,26,143,"Michigan","Roscommon County",3,8,206,112,94
050,26,143,"Michigan","Roscommon County",3,9,206,106,100
050,26,143,"Michigan","Roscommon County",3,10,196,101,95
050,26,143,"Michigan","Roscommon County",3,11,197,98,99
050,26,143,"Michigan","Roscommon County",3,12,221,111,110
050,26,143,"Michigan","Roscommon County",3,13,229,125,104
050,26,143,"Michigan","Roscommon County",3,14,232,127,105
050,26,143,"Michigan","Roscommon County",3,15,221,118,103
050,26,143,"Michigan","Roscommon County",3,16,222,103,119
050,26,143,"Michigan","Roscommon County",3,17,205,108,97
050,26,143,"Michigan","Roscommon County",3,18,180,98,82
050,26,143,"Michigan","Roscommon County",3,19,163,92,71
050,26,143,"Michigan","Roscommon County",3,20,148,85,63
050,26,143,"Michigan","Roscommon County",3,21,164,84,80
050,26,143,"Michigan","Roscommon County",3,22,170,93,77
050,26,143,"Michigan","Roscommon County",3,23,176,90,86
050,26,143,"Michigan","Roscommon County",3,24,178,82,96
050,26,143,"Michigan","Roscommon County",3,25,181,90,91
050,26,143,"Michigan","Roscommon County",3,26,190,91,99
050,26,143,"Michigan","Roscommon County",3,27,226,115,111
050,26,143,"Michigan","Roscommon County",3,28,214,109,105
050,26,143,"Michigan","Roscommon County",3,29,195,104,91
050,26,143,"Michigan","Roscommon County",3,30,204,109,95
050,26,143,"Michigan","Roscommon County",3,31,206,96,110
050,26,143,"Michigan","Roscommon County",3,32,192,90,102
050,26,143,"Michigan","Roscommon County",3,33,187,90,97
050,26,143,"Michigan","Roscommon County",3,34,197,95,102
050,26,143,"Michigan","Roscommon County",3,35,210,103,107
050,26,143,"Michigan","Roscommon County",3,36,195,94,101
050,26,143,"Michigan","Roscommon County",3,37,201,99,102
050,26,143,"Michigan","Roscommon County",3,38,198,100,98
050,26,143,"Michigan","Roscommon County",3,39,203,108,95
050,26,143,"Michigan","Roscommon County",3,40,192,99,93
050,26,143,"Michigan","Roscommon County",3,41,197,103,94
050,26,143,"Michigan","Roscommon County",3,42,208,104,104
050,26,143,"Michigan","Roscommon County",3,43,208,110,98
050,26,143,"Michigan","Roscommon County",3,44,197,91,106
050,26,143,"Michigan","Roscommon County",3,45,182,81,101
050,26,143,"Michigan","Roscommon County",3,46,193,93,100
050,26,143,"Michigan","Roscommon County",3,47,219,116,103
050,26,143,"Michigan","Roscommon County",3,48,218,116,102
050,26,143,"Michigan","Roscommon County",3,49,250,127,123
050,26,143,"Michigan","Roscommon County",3,50,281,130,151
050,26,143,"Michigan","Roscommon County",3,51,285,142,143
050,26,143,"Michigan","Roscommon County",3,52,293,147,146
050,26,143,"Michigan","Roscommon County",3,53,289,151,138
050,26,143,"Michigan","Roscommon County",3,54,327,168,159
050,26,143,"Michigan","Roscommon County",3,55,335,163,172
050,26,143,"Michigan","Roscommon County",3,56,353,168,185
050,26,143,"Michigan","Roscommon County",3,57,397,195,202
050,26,143,"Michigan","Roscommon County",3,58,419,209,210
050,26,143,"Michigan","Roscommon County",3,59,451,209,242
050,26,143,"Michigan","Roscommon County",3,60,483,239,244
050,26,143,"Michigan","Roscommon County",3,61,508,270,238
050,26,143,"Michigan","Roscommon County",3,62,507,261,246
050,26,143,"Michigan","Roscommon County",3,63,526,255,271
050,26,143,"Michigan","Roscommon County",3,64,549,278,271
050,26,143,"Michigan","Roscommon County",3,65,580,294,286
050,26,143,"Michigan","Roscommon County",3,66,607,307,300
050,26,143,"Michigan","Roscommon County",3,67,587,299,288
050,26,143,"Michigan","Roscommon County",3,68,525,270,255
050,26,143,"Michigan","Roscommon County",3,69,488,267,221
050,26,143,"Michigan","Roscommon County",3,70,464,246,218
050,26,143,"Michigan","Roscommon County",3,71,445,212,233
050,26,143,"Michigan","Roscommon County",3,72,435,206,229
050,26,143,"Michigan","Roscommon County",3,73,430,226,204
050,26,143,"Michigan","Roscommon County",3,74,461,246,215
050,26,143,"Michigan","Roscommon County",3,75,296,158,138
050,26,143,"Michigan","Roscommon County",3,76,292,151,141
050,26,143,"Michigan","Roscommon County",3,77,316,167,149
050,26,143,"Michigan","Roscommon County",3,78,321,169,152
050,26,143,"Michigan","Roscommon County",3,79,244,125,119
050,26,143,"Michigan","Roscommon County",3,80,211,112,99
050,26,143,"Michigan","Roscommon County",3,81,196,102,94
050,26,143,"Michigan","Roscommon County",3,82,183,91,92
050,26,143,"Michigan","Roscommon County",3,83,146,65,81
050,26,143,"Michigan","Roscommon County",3,84,132,66,66
050,26,143,"Michigan","Roscommon County",3,85,565,238,327
050,26,143,"Michigan","Roscommon County",4,0,152,93,59
050,26,143,"Michigan","Roscommon County",4,1,140,77,63
050,26,143,"Michigan","Roscommon County",4,2,153,71,82
050,26,143,"Michigan","Roscommon County",4,3,168,74,94
050,26,143,"Michigan","Roscommon County",4,4,169,86,83
050,26,143,"Michigan","Roscommon County",4,5,171,92,79
050,26,143,"Michigan","Roscommon County",4,6,174,96,78
050,26,143,"Michigan","Roscommon County",4,7,197,104,93
050,26,143,"Michigan","Roscommon County",4,8,161,85,76
050,26,143,"Michigan","Roscommon County",4,9,200,111,89
050,26,143,"Michigan","Roscommon County",4,10,206,114,92
050,26,143,"Michigan","Roscommon County",4,11,203,102,101
050,26,143,"Michigan","Roscommon County",4,12,190,96,94
050,26,143,"Michigan","Roscommon County",4,13,222,109,113
050,26,143,"Michigan","Roscommon County",4,14,227,120,107
050,26,143,"Michigan","Roscommon County",4,15,235,123,112
050,26,143,"Michigan","Roscommon County",4,16,228,120,108
050,26,143,"Michigan","Roscommon County",4,17,221,104,117
050,26,143,"Michigan","Roscommon County",4,18,171,89,82
050,26,143,"Michigan","Roscommon County",4,19,136,71,65
050,26,143,"Michigan","Roscommon County",4,20,185,101,84
050,26,143,"Michigan","Roscommon County",4,21,160,89,71
050,26,143,"Michigan","Roscommon County",4,22,167,91,76
050,26,143,"Michigan","Roscommon County",4,23,171,94,77
050,26,143,"Michigan","Roscommon County",4,24,183,94,89
050,26,143,"Michigan","Roscommon County",4,25,174,82,92
050,26,143,"Michigan","Roscommon County",4,26,175,91,84
050,26,143,"Michigan","Roscommon County",4,27,176,86,90
050,26,143,"Michigan","Roscommon County",4,28,230,117,113
050,26,143,"Michigan","Roscommon County",4,29,204,100,104
050,26,143,"Michigan","Roscommon County",4,30,206,108,98
050,26,143,"Michigan","Roscommon County",4,31,202,104,98
050,26,143,"Michigan","Roscommon County",4,32,206,98,108
050,26,143,"Michigan","Roscommon County",4,33,187,86,101
050,26,143,"Michigan","Roscommon County",4,34,188,94,94
050,26,143,"Michigan","Roscommon County",4,35,195,95,100
050,26,143,"Michigan","Roscommon County",4,36,207,99,108
050,26,143,"Michigan","Roscommon County",4,37,195,96,99
050,26,143,"Michigan","Roscommon County",4,38,214,112,102
050,26,143,"Michigan","Roscommon County",4,39,197,99,98
050,26,143,"Michigan","Roscommon County",4,40,200,105,95
050,26,143,"Michigan","Roscommon County",4,41,191,97,94
050,26,143,"Michigan","Roscommon County",4,42,183,88,95
050,26,143,"Michigan","Roscommon County",4,43,209,106,103
050,26,143,"Michigan","Roscommon County",4,44,206,110,96
050,26,143,"Michigan","Roscommon County",4,45,197,94,103
050,26,143,"Michigan","Roscommon County",4,46,183,84,99
050,26,143,"Michigan","Roscommon County",4,47,190,89,101
050,26,143,"Michigan","Roscommon County",4,48,236,128,108
050,26,143,"Michigan","Roscommon County",4,49,226,109,117
050,26,143,"Michigan","Roscommon County",4,50,259,128,131
050,26,143,"Michigan","Roscommon County",4,51,294,138,156
050,26,143,"Michigan","Roscommon County",4,52,308,156,152
050,26,143,"Michigan","Roscommon County",4,53,298,149,149
050,26,143,"Michigan","Roscommon County",4,54,312,159,153
050,26,143,"Michigan","Roscommon County",4,55,334,172,162
050,26,143,"Michigan","Roscommon County",4,56,374,180,194
050,26,143,"Michigan","Roscommon County",4,57,379,173,206
050,26,143,"Michigan","Roscommon County",4,58,406,199,207
050,26,143,"Michigan","Roscommon County",4,59,456,228,228
050,26,143,"Michigan","Roscommon County",4,60,470,217,253
050,26,143,"Michigan","Roscommon County",4,61,496,248,248
050,26,143,"Michigan","Roscommon County",4,62,536,286,250
050,26,143,"Michigan","Roscommon County",4,63,548,281,267
050,26,143,"Michigan","Roscommon County",4,64,567,279,288
050,26,143,"Michigan","Roscommon County",4,65,586,301,285
050,26,143,"Michigan","Roscommon County",4,66,576,294,282
050,26,143,"Michigan","Roscommon County",4,67,603,305,298
050,26,143,"Michigan","Roscommon County",4,68,577,289,288
050,26,143,"Michigan","Roscommon County",4,69,517,266,251
050,26,143,"Michigan","Roscommon County",4,70,480,256,224
050,26,143,"Michigan","Roscommon County",4,71,456,246,210
050,26,143,"Michigan","Roscommon County",4,72,435,211,224
050,26,143,"Michigan","Roscommon County",4,73,420,200,220
050,26,143,"Michigan","Roscommon County",4,74,406,213,193
050,26,143,"Michigan","Roscommon County",4,75,442,236,206
050,26,143,"Michigan","Roscommon County",4,76,277,152,125
050,26,143,"Michigan","Roscommon County",4,77,279,147,132
050,26,143,"Michigan","Roscommon County",4,78,302,156,146
050,26,143,"Michigan","Roscommon County",4,79,294,152,142
050,26,143,"Michigan","Roscommon County",4,80,231,118,113
050,26,143,"Michigan","Roscommon County",4,81,192,101,91
050,26,143,"Michigan","Roscommon County",4,82,175,96,79
050,26,143,"Michigan","Roscommon County",4,83,156,77,79
050,26,143,"Michigan","Roscommon County",4,84,116,54,62
050,26,143,"Michigan","Roscommon County",4,85,558,242,316
050,26,143,"Michigan","Roscommon County",5,0,149,89,60
050,26,143,"Michigan","Roscommon County",5,1,175,109,66
050,26,143,"Michigan","Roscommon County",5,2,130,68,62
050,26,143,"Michigan","Roscommon County",5,3,158,75,83
050,26,143,"Michigan","Roscommon County",5,4,160,72,88
050,26,143,"Michigan","Roscommon County",5,5,175,90,85
050,26,143,"Michigan","Roscommon County",5,6,166,91,75
050,26,143,"Michigan","Roscommon County",5,7,178,96,82
050,26,143,"Michigan","Roscommon County",5,8,191,103,88
050,26,143,"Michigan","Roscommon County",5,9,167,89,78
050,26,143,"Michigan","Roscommon County",5,10,203,109,94
050,26,143,"Michigan","Roscommon County",5,11,209,115,94
050,26,143,"Michigan","Roscommon County",5,12,209,106,103
050,26,143,"Michigan","Roscommon County",5,13,187,91,96
050,26,143,"Michigan","Roscommon County",5,14,230,115,115
050,26,143,"Michigan","Roscommon County",5,15,234,125,109
050,26,143,"Michigan","Roscommon County",5,16,228,124,104
050,26,143,"Michigan","Roscommon County",5,17,235,126,109
050,26,143,"Michigan","Roscommon County",5,18,183,85,98
050,26,143,"Michigan","Roscommon County",5,19,146,77,69
050,26,143,"Michigan","Roscommon County",5,20,157,82,75
050,26,143,"Michigan","Roscommon County",5,21,194,101,93
050,26,143,"Michigan","Roscommon County",5,22,172,97,75
050,26,143,"Michigan","Roscommon County",5,23,177,94,83
050,26,143,"Michigan","Roscommon County",5,24,183,102,81
050,26,143,"Michigan","Roscommon County",5,25,181,95,86
050,26,143,"Michigan","Roscommon County",5,26,176,80,96
050,26,143,"Michigan","Roscommon County",5,27,167,87,80
050,26,143,"Michigan","Roscommon County",5,28,185,93,92
050,26,143,"Michigan","Roscommon County",5,29,234,120,114
050,26,143,"Michigan","Roscommon County",5,30,211,99,112
050,26,143,"Michigan","Roscommon County",5,31,194,100,94
050,26,143,"Michigan","Roscommon County",5,32,202,111,91
050,26,143,"Michigan","Roscommon County",5,33,213,98,115
050,26,143,"Michigan","Roscommon County",5,34,204,97,107
050,26,143,"Michigan","Roscommon County",5,35,190,92,98
050,26,143,"Michigan","Roscommon County",5,36,207,99,108
050,26,143,"Michigan","Roscommon County",5,37,213,105,108
050,26,143,"Michigan","Roscommon County",5,38,198,98,100
050,26,143,"Michigan","Roscommon County",5,39,217,112,105
050,26,143,"Michigan","Roscommon County",5,40,204,103,101
050,26,143,"Michigan","Roscommon County",5,41,214,111,103
050,26,143,"Michigan","Roscommon County",5,42,208,105,103
050,26,143,"Michigan","Roscommon County",5,43,191,94,97
050,26,143,"Michigan","Roscommon County",5,44,215,107,108
050,26,143,"Michigan","Roscommon County",5,45,207,112,95
050,26,143,"Michigan","Roscommon County",5,46,201,97,104
050,26,143,"Michigan","Roscommon County",5,47,201,103,98
050,26,143,"Michigan","Roscommon County",5,48,205,98,107
050,26,143,"Michigan","Roscommon County",5,49,238,127,111
050,26,143,"Michigan","Roscommon County",5,50,227,105,122
050,26,143,"Michigan","Roscommon County",5,51,274,139,135
050,26,143,"Michigan","Roscommon County",5,52,304,145,159
050,26,143,"Michigan","Roscommon County",5,53,325,162,163
050,26,143,"Michigan","Roscommon County",5,54,307,151,156
050,26,143,"Michigan","Roscommon County",5,55,306,149,157
050,26,143,"Michigan","Roscommon County",5,56,337,176,161
050,26,143,"Michigan","Roscommon County",5,57,402,203,199
050,26,143,"Michigan","Roscommon County",5,58,385,170,215
050,26,143,"Michigan","Roscommon County",5,59,441,215,226
050,26,143,"Michigan","Roscommon County",5,60,473,239,234
050,26,143,"Michigan","Roscommon County",5,61,478,225,253
050,26,143,"Michigan","Roscommon County",5,62,517,254,263
050,26,143,"Michigan","Roscommon County",5,63,553,287,266
050,26,143,"Michigan","Roscommon County",5,64,566,285,281
050,26,143,"Michigan","Roscommon County",5,65,600,302,298
050,26,143,"Michigan","Roscommon County",5,66,601,305,296
050,26,143,"Michigan","Roscommon County",5,67,575,292,283
050,26,143,"Michigan","Roscommon County",5,68,602,304,298
050,26,143,"Michigan","Roscommon County",5,69,571,289,282
050,26,143,"Michigan","Roscommon County",5,70,488,249,239
050,26,143,"Michigan","Roscommon County",5,71,467,245,222
050,26,143,"Michigan","Roscommon County",5,72,438,236,202
050,26,143,"Michigan","Roscommon County",5,73,419,201,218
050,26,143,"Michigan","Roscommon County",5,74,393,189,204
050,26,143,"Michigan","Roscommon County",5,75,394,204,190
050,26,143,"Michigan","Roscommon County",5,76,435,230,205
050,26,143,"Michigan","Roscommon County",5,77,268,148,120
050,26,143,"Michigan","Roscommon County",5,78,264,142,122
050,26,143,"Michigan","Roscommon County",5,79,287,149,138
050,26,143,"Michigan","Roscommon County",5,80,271,140,131
050,26,143,"Michigan","Roscommon County",5,81,207,105,102
050,26,143,"Michigan","Roscommon County",5,82,175,96,79
050,26,143,"Michigan","Roscommon County",5,83,152,83,69
050,26,143,"Michigan","Roscommon County",5,84,137,70,67
050,26,143,"Michigan","Roscommon County",5,85,552,236,316
050,26,145,"Michigan","Saginaw County",1,0,2101,1077,1024
050,26,145,"Michigan","Saginaw County",1,1,2142,1107,1035
050,26,145,"Michigan","Saginaw County",1,2,2232,1176,1056
050,26,145,"Michigan","Saginaw County",1,3,2200,1134,1066
050,26,145,"Michigan","Saginaw County",1,4,2266,1149,1117
050,26,145,"Michigan","Saginaw County",1,5,2177,1125,1052
050,26,145,"Michigan","Saginaw County",1,6,2225,1142,1083
050,26,145,"Michigan","Saginaw County",1,7,2248,1160,1088
050,26,145,"Michigan","Saginaw County",1,8,2263,1188,1075
050,26,145,"Michigan","Saginaw County",1,9,2162,1105,1057
050,26,145,"Michigan","Saginaw County",1,10,2294,1177,1117
050,26,145,"Michigan","Saginaw County",1,11,2293,1178,1115
050,26,145,"Michigan","Saginaw County",1,12,2370,1196,1174
050,26,145,"Michigan","Saginaw County",1,13,2427,1241,1186
050,26,145,"Michigan","Saginaw County",1,14,2396,1238,1158
050,26,145,"Michigan","Saginaw County",1,15,2407,1265,1142
050,26,145,"Michigan","Saginaw County",1,16,2472,1264,1208
050,26,145,"Michigan","Saginaw County",1,17,2495,1250,1245
050,26,145,"Michigan","Saginaw County",1,18,2780,1370,1410
050,26,145,"Michigan","Saginaw County",1,19,2624,1280,1344
050,26,145,"Michigan","Saginaw County",1,20,2440,1219,1221
050,26,145,"Michigan","Saginaw County",1,21,2392,1195,1197
050,26,145,"Michigan","Saginaw County",1,22,2465,1231,1234
050,26,145,"Michigan","Saginaw County",1,23,2316,1194,1122
050,26,145,"Michigan","Saginaw County",1,24,2361,1203,1158
050,26,145,"Michigan","Saginaw County",1,25,2431,1226,1205
050,26,145,"Michigan","Saginaw County",1,26,2470,1260,1210
050,26,145,"Michigan","Saginaw County",1,27,2544,1279,1265
050,26,145,"Michigan","Saginaw County",1,28,2548,1262,1286
050,26,145,"Michigan","Saginaw County",1,29,2616,1312,1304
050,26,145,"Michigan","Saginaw County",1,30,2496,1239,1257
050,26,145,"Michigan","Saginaw County",1,31,2246,1079,1167
050,26,145,"Michigan","Saginaw County",1,32,2182,1071,1111
050,26,145,"Michigan","Saginaw County",1,33,2152,1066,1086
050,26,145,"Michigan","Saginaw County",1,34,2152,1093,1059
050,26,145,"Michigan","Saginaw County",1,35,2068,1066,1002
050,26,145,"Michigan","Saginaw County",1,36,2024,1030,994
050,26,145,"Michigan","Saginaw County",1,37,2072,1025,1047
050,26,145,"Michigan","Saginaw County",1,38,2137,1059,1078
050,26,145,"Michigan","Saginaw County",1,39,2174,1065,1109
050,26,145,"Michigan","Saginaw County",1,40,2193,1090,1103
050,26,145,"Michigan","Saginaw County",1,41,2137,1059,1078
050,26,145,"Michigan","Saginaw County",1,42,2051,1036,1015
050,26,145,"Michigan","Saginaw County",1,43,2036,1018,1018
050,26,145,"Michigan","Saginaw County",1,44,2011,994,1017
050,26,145,"Michigan","Saginaw County",1,45,2041,1008,1033
050,26,145,"Michigan","Saginaw County",1,46,2042,968,1074
050,26,145,"Michigan","Saginaw County",1,47,2118,1004,1114
050,26,145,"Michigan","Saginaw County",1,48,2351,1152,1199
050,26,145,"Michigan","Saginaw County",1,49,2420,1180,1240
050,26,145,"Michigan","Saginaw County",1,50,2326,1144,1182
050,26,145,"Michigan","Saginaw County",1,51,2342,1166,1176
050,26,145,"Michigan","Saginaw County",1,52,2321,1152,1169
050,26,145,"Michigan","Saginaw County",1,53,2425,1203,1222
050,26,145,"Michigan","Saginaw County",1,54,2506,1257,1249
050,26,145,"Michigan","Saginaw County",1,55,2577,1270,1307
050,26,145,"Michigan","Saginaw County",1,56,2663,1325,1338
050,26,145,"Michigan","Saginaw County",1,57,2648,1294,1354
050,26,145,"Michigan","Saginaw County",1,58,2722,1306,1416
050,26,145,"Michigan","Saginaw County",1,59,2748,1320,1428
050,26,145,"Michigan","Saginaw County",1,60,2701,1296,1405
050,26,145,"Michigan","Saginaw County",1,61,2717,1319,1398
050,26,145,"Michigan","Saginaw County",1,62,2721,1291,1430
050,26,145,"Michigan","Saginaw County",1,63,2714,1277,1437
050,26,145,"Michigan","Saginaw County",1,64,2620,1255,1365
050,26,145,"Michigan","Saginaw County",1,65,2522,1174,1348
050,26,145,"Michigan","Saginaw County",1,66,2397,1115,1282
050,26,145,"Michigan","Saginaw County",1,67,2409,1120,1289
050,26,145,"Michigan","Saginaw County",1,68,2414,1120,1294
050,26,145,"Michigan","Saginaw County",1,69,2258,1081,1177
050,26,145,"Michigan","Saginaw County",1,70,2167,1017,1150
050,26,145,"Michigan","Saginaw County",1,71,2079,970,1109
050,26,145,"Michigan","Saginaw County",1,72,2047,965,1082
050,26,145,"Michigan","Saginaw County",1,73,2015,927,1088
050,26,145,"Michigan","Saginaw County",1,74,1431,659,772
050,26,145,"Michigan","Saginaw County",1,75,1440,674,766
050,26,145,"Michigan","Saginaw County",1,76,1465,640,825
050,26,145,"Michigan","Saginaw County",1,77,1464,631,833
050,26,145,"Michigan","Saginaw County",1,78,1224,535,689
050,26,145,"Michigan","Saginaw County",1,79,1117,499,618
050,26,145,"Michigan","Saginaw County",1,80,980,443,537
050,26,145,"Michigan","Saginaw County",1,81,947,413,534
050,26,145,"Michigan","Saginaw County",1,82,860,370,490
050,26,145,"Michigan","Saginaw County",1,83,761,311,450
050,26,145,"Michigan","Saginaw County",1,84,714,260,454
050,26,145,"Michigan","Saginaw County",1,85,4407,1506,2901
050,26,145,"Michigan","Saginaw County",2,0,2087,1052,1035
050,26,145,"Michigan","Saginaw County",2,1,2135,1105,1030
050,26,145,"Michigan","Saginaw County",2,2,2209,1157,1052
050,26,145,"Michigan","Saginaw County",2,3,2204,1140,1064
050,26,145,"Michigan","Saginaw County",2,4,2247,1141,1106
050,26,145,"Michigan","Saginaw County",2,5,2196,1128,1068
050,26,145,"Michigan","Saginaw County",2,6,2215,1139,1076
050,26,145,"Michigan","Saginaw County",2,7,2241,1155,1086
050,26,145,"Michigan","Saginaw County",2,8,2256,1174,1082
050,26,145,"Michigan","Saginaw County",2,9,2190,1127,1063
050,26,145,"Michigan","Saginaw County",2,10,2258,1157,1101
050,26,145,"Michigan","Saginaw County",2,11,2289,1175,1114
050,26,145,"Michigan","Saginaw County",2,12,2363,1198,1165
050,26,145,"Michigan","Saginaw County",2,13,2406,1226,1180
050,26,145,"Michigan","Saginaw County",2,14,2399,1236,1163
050,26,145,"Michigan","Saginaw County",2,15,2405,1261,1144
050,26,145,"Michigan","Saginaw County",2,16,2462,1269,1193
050,26,145,"Michigan","Saginaw County",2,17,2496,1257,1239
050,26,145,"Michigan","Saginaw County",2,18,2764,1355,1409
050,26,145,"Michigan","Saginaw County",2,19,2638,1289,1349
050,26,145,"Michigan","Saginaw County",2,20,2460,1222,1238
050,26,145,"Michigan","Saginaw County",2,21,2382,1191,1191
050,26,145,"Michigan","Saginaw County",2,22,2455,1230,1225
050,26,145,"Michigan","Saginaw County",2,23,2346,1204,1142
050,26,145,"Michigan","Saginaw County",2,24,2346,1192,1154
050,26,145,"Michigan","Saginaw County",2,25,2412,1218,1194
050,26,145,"Michigan","Saginaw County",2,26,2465,1254,1211
050,26,145,"Michigan","Saginaw County",2,27,2515,1269,1246
050,26,145,"Michigan","Saginaw County",2,28,2548,1270,1278
050,26,145,"Michigan","Saginaw County",2,29,2601,1300,1301
050,26,145,"Michigan","Saginaw County",2,30,2526,1252,1274
050,26,145,"Michigan","Saginaw County",2,31,2296,1112,1184
050,26,145,"Michigan","Saginaw County",2,32,2193,1070,1123
050,26,145,"Michigan","Saginaw County",2,33,2160,1069,1091
050,26,145,"Michigan","Saginaw County",2,34,2153,1088,1065
050,26,145,"Michigan","Saginaw County",2,35,2092,1076,1016
050,26,145,"Michigan","Saginaw County",2,36,2019,1031,988
050,26,145,"Michigan","Saginaw County",2,37,2069,1032,1037
050,26,145,"Michigan","Saginaw County",2,38,2125,1052,1073
050,26,145,"Michigan","Saginaw County",2,39,2155,1059,1096
050,26,145,"Michigan","Saginaw County",2,40,2199,1089,1110
050,26,145,"Michigan","Saginaw County",2,41,2150,1068,1082
050,26,145,"Michigan","Saginaw County",2,42,2066,1040,1026
050,26,145,"Michigan","Saginaw County",2,43,2054,1027,1027
050,26,145,"Michigan","Saginaw County",2,44,1998,993,1005
050,26,145,"Michigan","Saginaw County",2,45,2038,1004,1034
050,26,145,"Michigan","Saginaw County",2,46,2027,972,1055
050,26,145,"Michigan","Saginaw County",2,47,2095,994,1101
050,26,145,"Michigan","Saginaw County",2,48,2288,1116,1172
050,26,145,"Michigan","Saginaw County",2,49,2407,1176,1231
050,26,145,"Michigan","Saginaw County",2,50,2347,1151,1196
050,26,145,"Michigan","Saginaw County",2,51,2323,1152,1171
050,26,145,"Michigan","Saginaw County",2,52,2323,1154,1169
050,26,145,"Michigan","Saginaw County",2,53,2394,1186,1208
050,26,145,"Michigan","Saginaw County",2,54,2478,1239,1239
050,26,145,"Michigan","Saginaw County",2,55,2552,1262,1290
050,26,145,"Michigan","Saginaw County",2,56,2633,1305,1328
050,26,145,"Michigan","Saginaw County",2,57,2653,1303,1350
050,26,145,"Michigan","Saginaw County",2,58,2692,1299,1393
050,26,145,"Michigan","Saginaw County",2,59,2735,1313,1422
050,26,145,"Michigan","Saginaw County",2,60,2692,1290,1402
050,26,145,"Michigan","Saginaw County",2,61,2693,1297,1396
050,26,145,"Michigan","Saginaw County",2,62,2706,1290,1416
050,26,145,"Michigan","Saginaw County",2,63,2729,1285,1444
050,26,145,"Michigan","Saginaw County",2,64,2612,1244,1368
050,26,145,"Michigan","Saginaw County",2,65,2532,1183,1349
050,26,145,"Michigan","Saginaw County",2,66,2420,1124,1296
050,26,145,"Michigan","Saginaw County",2,67,2390,1106,1284
050,26,145,"Michigan","Saginaw County",2,68,2381,1104,1277
050,26,145,"Michigan","Saginaw County",2,69,2300,1090,1210
050,26,145,"Michigan","Saginaw County",2,70,2172,1020,1152
050,26,145,"Michigan","Saginaw County",2,71,2093,976,1117
050,26,145,"Michigan","Saginaw County",2,72,2017,943,1074
050,26,145,"Michigan","Saginaw County",2,73,2095,969,1126
050,26,145,"Michigan","Saginaw County",2,74,1477,679,798
050,26,145,"Michigan","Saginaw County",2,75,1423,660,763
050,26,145,"Michigan","Saginaw County",2,76,1435,635,800
050,26,145,"Michigan","Saginaw County",2,77,1484,642,842
050,26,145,"Michigan","Saginaw County",2,78,1242,536,706
050,26,145,"Michigan","Saginaw County",2,79,1118,496,622
050,26,145,"Michigan","Saginaw County",2,80,1000,450,550
050,26,145,"Michigan","Saginaw County",2,81,932,410,522
050,26,145,"Michigan","Saginaw County",2,82,873,374,499
050,26,145,"Michigan","Saginaw County",2,83,763,314,449
050,26,145,"Michigan","Saginaw County",2,84,708,260,448
050,26,145,"Michigan","Saginaw County",2,85,4365,1479,2886
050,26,145,"Michigan","Saginaw County",3,0,1938,976,962
050,26,145,"Michigan","Saginaw County",3,1,2105,1055,1050
050,26,145,"Michigan","Saginaw County",3,2,2182,1137,1045
050,26,145,"Michigan","Saginaw County",3,3,2272,1188,1084
050,26,145,"Michigan","Saginaw County",3,4,2227,1162,1065
050,26,145,"Michigan","Saginaw County",3,5,2274,1167,1107
050,26,145,"Michigan","Saginaw County",3,6,2226,1148,1078
050,26,145,"Michigan","Saginaw County",3,7,2244,1143,1101
050,26,145,"Michigan","Saginaw County",3,8,2278,1158,1120
050,26,145,"Michigan","Saginaw County",3,9,2282,1190,1092
050,26,145,"Michigan","Saginaw County",3,10,2189,1136,1053
050,26,145,"Michigan","Saginaw County",3,11,2280,1170,1110
050,26,145,"Michigan","Saginaw County",3,12,2331,1199,1132
050,26,145,"Michigan","Saginaw County",3,13,2382,1204,1178
050,26,145,"Michigan","Saginaw County",3,14,2418,1223,1195
050,26,145,"Michigan","Saginaw County",3,15,2406,1252,1154
050,26,145,"Michigan","Saginaw County",3,16,2413,1267,1146
050,26,145,"Michigan","Saginaw County",3,17,2474,1276,1198
050,26,145,"Michigan","Saginaw County",3,18,2753,1347,1406
050,26,145,"Michigan","Saginaw County",3,19,2630,1283,1347
050,26,145,"Michigan","Saginaw County",3,20,2448,1211,1237
050,26,145,"Michigan","Saginaw County",3,21,2413,1198,1215
050,26,145,"Michigan","Saginaw County",3,22,2448,1213,1235
050,26,145,"Michigan","Saginaw County",3,23,2391,1200,1191
050,26,145,"Michigan","Saginaw County",3,24,2324,1161,1163
050,26,145,"Michigan","Saginaw County",3,25,2318,1187,1131
050,26,145,"Michigan","Saginaw County",3,26,2378,1194,1184
050,26,145,"Michigan","Saginaw County",3,27,2479,1293,1186
050,26,145,"Michigan","Saginaw County",3,28,2521,1236,1285
050,26,145,"Michigan","Saginaw County",3,29,2553,1274,1279
050,26,145,"Michigan","Saginaw County",3,30,2620,1315,1305
050,26,145,"Michigan","Saginaw County",3,31,2530,1255,1275
050,26,145,"Michigan","Saginaw County",3,32,2325,1140,1185
050,26,145,"Michigan","Saginaw County",3,33,2187,1056,1131
050,26,145,"Michigan","Saginaw County",3,34,2178,1075,1103
050,26,145,"Michigan","Saginaw County",3,35,2133,1080,1053
050,26,145,"Michigan","Saginaw County",3,36,2100,1072,1028
050,26,145,"Michigan","Saginaw County",3,37,2033,1046,987
050,26,145,"Michigan","Saginaw County",3,38,2086,1039,1047
050,26,145,"Michigan","Saginaw County",3,39,2131,1045,1086
050,26,145,"Michigan","Saginaw County",3,40,2165,1058,1107
050,26,145,"Michigan","Saginaw County",3,41,2218,1107,1111
050,26,145,"Michigan","Saginaw County",3,42,2163,1081,1082
050,26,145,"Michigan","Saginaw County",3,43,2064,1041,1023
050,26,145,"Michigan","Saginaw County",3,44,2066,1033,1033
050,26,145,"Michigan","Saginaw County",3,45,1975,982,993
050,26,145,"Michigan","Saginaw County",3,46,1991,971,1020
050,26,145,"Michigan","Saginaw County",3,47,2041,982,1059
050,26,145,"Michigan","Saginaw County",3,48,2080,979,1101
050,26,145,"Michigan","Saginaw County",3,49,2281,1114,1167
050,26,145,"Michigan","Saginaw County",3,50,2382,1160,1222
050,26,145,"Michigan","Saginaw County",3,51,2354,1156,1198
050,26,145,"Michigan","Saginaw County",3,52,2302,1134,1168
050,26,145,"Michigan","Saginaw County",3,53,2293,1139,1154
050,26,145,"Michigan","Saginaw County",3,54,2387,1182,1205
050,26,145,"Michigan","Saginaw County",3,55,2438,1223,1215
050,26,145,"Michigan","Saginaw County",3,56,2523,1245,1278
050,26,145,"Michigan","Saginaw County",3,57,2599,1288,1311
050,26,145,"Michigan","Saginaw County",3,58,2638,1281,1357
050,26,145,"Michigan","Saginaw County",3,59,2645,1285,1360
050,26,145,"Michigan","Saginaw County",3,60,2677,1293,1384
050,26,145,"Michigan","Saginaw County",3,61,2677,1268,1409
050,26,145,"Michigan","Saginaw County",3,62,2648,1272,1376
050,26,145,"Michigan","Saginaw County",3,63,2630,1253,1377
050,26,145,"Michigan","Saginaw County",3,64,2688,1253,1435
050,26,145,"Michigan","Saginaw County",3,65,2550,1212,1338
050,26,145,"Michigan","Saginaw County",3,66,2469,1148,1321
050,26,145,"Michigan","Saginaw County",3,67,2367,1088,1279
050,26,145,"Michigan","Saginaw County",3,68,2335,1090,1245
050,26,145,"Michigan","Saginaw County",3,69,2317,1062,1255
050,26,145,"Michigan","Saginaw County",3,70,2251,1064,1187
050,26,145,"Michigan","Saginaw County",3,71,2093,980,1113
050,26,145,"Michigan","Saginaw County",3,72,2042,945,1097
050,26,145,"Michigan","Saginaw County",3,73,1951,909,1042
050,26,145,"Michigan","Saginaw County",3,74,2042,940,1102
050,26,145,"Michigan","Saginaw County",3,75,1404,630,774
050,26,145,"Michigan","Saginaw County",3,76,1365,630,735
050,26,145,"Michigan","Saginaw County",3,77,1377,612,765
050,26,145,"Michigan","Saginaw County",3,78,1390,601,789
050,26,145,"Michigan","Saginaw County",3,79,1194,513,681
050,26,145,"Michigan","Saginaw County",3,80,1026,445,581
050,26,145,"Michigan","Saginaw County",3,81,937,408,529
050,26,145,"Michigan","Saginaw County",3,82,862,379,483
050,26,145,"Michigan","Saginaw County",3,83,802,339,463
050,26,145,"Michigan","Saginaw County",3,84,697,272,425
050,26,145,"Michigan","Saginaw County",3,85,4220,1431,2789
050,26,145,"Michigan","Saginaw County",4,0,1991,1003,988
050,26,145,"Michigan","Saginaw County",4,1,1941,986,955
050,26,145,"Michigan","Saginaw County",4,2,2095,1062,1033
050,26,145,"Michigan","Saginaw County",4,3,2186,1150,1036
050,26,145,"Michigan","Saginaw County",4,4,2252,1162,1090
050,26,145,"Michigan","Saginaw County",4,5,2245,1183,1062
050,26,145,"Michigan","Saginaw County",4,6,2274,1168,1106
050,26,145,"Michigan","Saginaw County",4,7,2231,1161,1070
050,26,145,"Michigan","Saginaw County",4,8,2258,1142,1116
050,26,145,"Michigan","Saginaw County",4,9,2268,1158,1110
050,26,145,"Michigan","Saginaw County",4,10,2266,1193,1073
050,26,145,"Michigan","Saginaw County",4,11,2166,1126,1040
050,26,145,"Michigan","Saginaw County",4,12,2230,1137,1093
050,26,145,"Michigan","Saginaw County",4,13,2293,1185,1108
050,26,145,"Michigan","Saginaw County",4,14,2368,1199,1169
050,26,145,"Michigan","Saginaw County",4,15,2395,1216,1179
050,26,145,"Michigan","Saginaw County",4,16,2422,1259,1163
050,26,145,"Michigan","Saginaw County",4,17,2407,1268,1139
050,26,145,"Michigan","Saginaw County",4,18,2716,1359,1357
050,26,145,"Michigan","Saginaw County",4,19,2577,1272,1305
050,26,145,"Michigan","Saginaw County",4,20,2393,1171,1222
050,26,145,"Michigan","Saginaw County",4,21,2396,1190,1206
050,26,145,"Michigan","Saginaw County",4,22,2434,1202,1232
050,26,145,"Michigan","Saginaw County",4,23,2392,1194,1198
050,26,145,"Michigan","Saginaw County",4,24,2406,1202,1204
050,26,145,"Michigan","Saginaw County",4,25,2284,1139,1145
050,26,145,"Michigan","Saginaw County",4,26,2301,1171,1130
050,26,145,"Michigan","Saginaw County",4,27,2354,1203,1151
050,26,145,"Michigan","Saginaw County",4,28,2454,1269,1185
050,26,145,"Michigan","Saginaw County",4,29,2468,1212,1256
050,26,145,"Michigan","Saginaw County",4,30,2505,1241,1264
050,26,145,"Michigan","Saginaw County",4,31,2583,1311,1272
050,26,145,"Michigan","Saginaw County",4,32,2513,1238,1275
050,26,145,"Michigan","Saginaw County",4,33,2310,1139,1171
050,26,145,"Michigan","Saginaw County",4,34,2176,1050,1126
050,26,145,"Michigan","Saginaw County",4,35,2158,1059,1099
050,26,145,"Michigan","Saginaw County",4,36,2115,1062,1053
050,26,145,"Michigan","Saginaw County",4,37,2130,1091,1039
050,26,145,"Michigan","Saginaw County",4,38,2047,1057,990
050,26,145,"Michigan","Saginaw County",4,39,2087,1042,1045
050,26,145,"Michigan","Saginaw County",4,40,2107,1031,1076
050,26,145,"Michigan","Saginaw County",4,41,2181,1061,1120
050,26,145,"Michigan","Saginaw County",4,42,2196,1095,1101
050,26,145,"Michigan","Saginaw County",4,43,2172,1077,1095
050,26,145,"Michigan","Saginaw County",4,44,2081,1043,1038
050,26,145,"Michigan","Saginaw County",4,45,2067,1018,1049
050,26,145,"Michigan","Saginaw County",4,46,1925,953,972
050,26,145,"Michigan","Saginaw County",4,47,2018,990,1028
050,26,145,"Michigan","Saginaw County",4,48,2018,950,1068
050,26,145,"Michigan","Saginaw County",4,49,2063,971,1092
050,26,145,"Michigan","Saginaw County",4,50,2255,1101,1154
050,26,145,"Michigan","Saginaw County",4,51,2414,1193,1221
050,26,145,"Michigan","Saginaw County",4,52,2327,1132,1195
050,26,145,"Michigan","Saginaw County",4,53,2282,1134,1148
050,26,145,"Michigan","Saginaw County",4,54,2273,1125,1148
050,26,145,"Michigan","Saginaw County",4,55,2375,1184,1191
050,26,145,"Michigan","Saginaw County",4,56,2414,1209,1205
050,26,145,"Michigan","Saginaw County",4,57,2499,1225,1274
050,26,145,"Michigan","Saginaw County",4,58,2582,1278,1304
050,26,145,"Michigan","Saginaw County",4,59,2619,1265,1354
050,26,145,"Michigan","Saginaw County",4,60,2641,1259,1382
050,26,145,"Michigan","Saginaw County",4,61,2629,1261,1368
050,26,145,"Michigan","Saginaw County",4,62,2644,1256,1388
050,26,145,"Michigan","Saginaw County",4,63,2590,1238,1352
050,26,145,"Michigan","Saginaw County",4,64,2597,1230,1367
050,26,145,"Michigan","Saginaw County",4,65,2628,1210,1418
050,26,145,"Michigan","Saginaw County",4,66,2504,1179,1325
050,26,145,"Michigan","Saginaw County",4,67,2409,1100,1309
050,26,145,"Michigan","Saginaw County",4,68,2287,1059,1228
050,26,145,"Michigan","Saginaw County",4,69,2289,1076,1213
050,26,145,"Michigan","Saginaw County",4,70,2264,1031,1233
050,26,145,"Michigan","Saginaw County",4,71,2185,1021,1164
050,26,145,"Michigan","Saginaw County",4,72,2034,953,1081
050,26,145,"Michigan","Saginaw County",4,73,1986,909,1077
050,26,145,"Michigan","Saginaw County",4,74,1906,882,1024
050,26,145,"Michigan","Saginaw County",4,75,1952,885,1067
050,26,145,"Michigan","Saginaw County",4,76,1360,602,758
050,26,145,"Michigan","Saginaw County",4,77,1330,620,710
050,26,145,"Michigan","Saginaw County",4,78,1296,571,725
050,26,145,"Michigan","Saginaw County",4,79,1331,573,758
050,26,145,"Michigan","Saginaw County",4,80,1114,473,641
050,26,145,"Michigan","Saginaw County",4,81,951,399,552
050,26,145,"Michigan","Saginaw County",4,82,869,378,491
050,26,145,"Michigan","Saginaw County",4,83,798,350,448
050,26,145,"Michigan","Saginaw County",4,84,756,315,441
050,26,145,"Michigan","Saginaw County",4,85,4068,1391,2677
050,26,145,"Michigan","Saginaw County",5,0,1981,996,985
050,26,145,"Michigan","Saginaw County",5,1,1942,972,970
050,26,145,"Michigan","Saginaw County",5,2,1960,991,969
050,26,145,"Michigan","Saginaw County",5,3,2110,1082,1028
050,26,145,"Michigan","Saginaw County",5,4,2187,1161,1026
050,26,145,"Michigan","Saginaw County",5,5,2266,1174,1092
050,26,145,"Michigan","Saginaw County",5,6,2237,1179,1058
050,26,145,"Michigan","Saginaw County",5,7,2247,1158,1089
050,26,145,"Michigan","Saginaw County",5,8,2227,1168,1059
050,26,145,"Michigan","Saginaw County",5,9,2258,1136,1122
050,26,145,"Michigan","Saginaw County",5,10,2274,1158,1116
050,26,145,"Michigan","Saginaw County",5,11,2263,1186,1077
050,26,145,"Michigan","Saginaw County",5,12,2178,1129,1049
050,26,145,"Michigan","Saginaw County",5,13,2210,1137,1073
050,26,145,"Michigan","Saginaw County",5,14,2298,1189,1109
050,26,145,"Michigan","Saginaw County",5,15,2378,1213,1165
050,26,145,"Michigan","Saginaw County",5,16,2428,1218,1210
050,26,145,"Michigan","Saginaw County",5,17,2430,1273,1157
050,26,145,"Michigan","Saginaw County",5,18,2727,1378,1349
050,26,145,"Michigan","Saginaw County",5,19,2613,1308,1305
050,26,145,"Michigan","Saginaw County",5,20,2399,1185,1214
050,26,145,"Michigan","Saginaw County",5,21,2339,1137,1202
050,26,145,"Michigan","Saginaw County",5,22,2416,1205,1211
050,26,145,"Michigan","Saginaw County",5,23,2407,1200,1207
050,26,145,"Michigan","Saginaw County",5,24,2356,1178,1178
050,26,145,"Michigan","Saginaw County",5,25,2295,1163,1132
050,26,145,"Michigan","Saginaw County",5,26,2241,1106,1135
050,26,145,"Michigan","Saginaw County",5,27,2227,1131,1096
050,26,145,"Michigan","Saginaw County",5,28,2295,1162,1133
050,26,145,"Michigan","Saginaw County",5,29,2402,1244,1158
050,26,145,"Michigan","Saginaw County",5,30,2477,1191,1286
050,26,145,"Michigan","Saginaw County",5,31,2493,1225,1268
050,26,145,"Michigan","Saginaw County",5,32,2575,1323,1252
050,26,145,"Michigan","Saginaw County",5,33,2524,1246,1278
050,26,145,"Michigan","Saginaw County",5,34,2339,1156,1183
050,26,145,"Michigan","Saginaw County",5,35,2169,1042,1127
050,26,145,"Michigan","Saginaw County",5,36,2165,1061,1104
050,26,145,"Michigan","Saginaw County",5,37,2132,1074,1058
050,26,145,"Michigan","Saginaw County",5,38,2146,1100,1046
050,26,145,"Michigan","Saginaw County",5,39,2031,1039,992
050,26,145,"Michigan","Saginaw County",5,40,2072,1036,1036
050,26,145,"Michigan","Saginaw County",5,41,2113,1027,1086
050,26,145,"Michigan","Saginaw County",5,42,2170,1053,1117
050,26,145,"Michigan","Saginaw County",5,43,2177,1073,1104
050,26,145,"Michigan","Saginaw County",5,44,2171,1076,1095
050,26,145,"Michigan","Saginaw County",5,45,2057,1026,1031
050,26,145,"Michigan","Saginaw County",5,46,2034,1000,1034
050,26,145,"Michigan","Saginaw County",5,47,1923,956,967
050,26,145,"Michigan","Saginaw County",5,48,2006,971,1035
050,26,145,"Michigan","Saginaw County",5,49,1994,943,1051
050,26,145,"Michigan","Saginaw County",5,50,2054,967,1087
050,26,145,"Michigan","Saginaw County",5,51,2264,1109,1155
050,26,145,"Michigan","Saginaw County",5,52,2403,1186,1217
050,26,145,"Michigan","Saginaw County",5,53,2306,1123,1183
050,26,145,"Michigan","Saginaw County",5,54,2258,1103,1155
050,26,145,"Michigan","Saginaw County",5,55,2280,1144,1136
050,26,145,"Michigan","Saginaw County",5,56,2366,1184,1182
050,26,145,"Michigan","Saginaw County",5,57,2408,1196,1212
050,26,145,"Michigan","Saginaw County",5,58,2476,1218,1258
050,26,145,"Michigan","Saginaw County",5,59,2540,1256,1284
050,26,145,"Michigan","Saginaw County",5,60,2593,1250,1343
050,26,145,"Michigan","Saginaw County",5,61,2614,1239,1375
050,26,145,"Michigan","Saginaw County",5,62,2589,1233,1356
050,26,145,"Michigan","Saginaw County",5,63,2592,1222,1370
050,26,145,"Michigan","Saginaw County",5,64,2567,1220,1347
050,26,145,"Michigan","Saginaw County",5,65,2559,1196,1363
050,26,145,"Michigan","Saginaw County",5,66,2577,1187,1390
050,26,145,"Michigan","Saginaw County",5,67,2461,1143,1318
050,26,145,"Michigan","Saginaw County",5,68,2364,1071,1293
050,26,145,"Michigan","Saginaw County",5,69,2258,1047,1211
050,26,145,"Michigan","Saginaw County",5,70,2245,1047,1198
050,26,145,"Michigan","Saginaw County",5,71,2193,993,1200
050,26,145,"Michigan","Saginaw County",5,72,2137,999,1138
050,26,145,"Michigan","Saginaw County",5,73,1996,928,1068
050,26,145,"Michigan","Saginaw County",5,74,1927,878,1049
050,26,145,"Michigan","Saginaw County",5,75,1825,825,1000
050,26,145,"Michigan","Saginaw County",5,76,1886,846,1040
050,26,145,"Michigan","Saginaw County",5,77,1326,587,739
050,26,145,"Michigan","Saginaw County",5,78,1277,590,687
050,26,145,"Michigan","Saginaw County",5,79,1246,543,703
050,26,145,"Michigan","Saginaw County",5,80,1250,533,717
050,26,145,"Michigan","Saginaw County",5,81,1054,437,617
050,26,145,"Michigan","Saginaw County",5,82,889,365,524
050,26,145,"Michigan","Saginaw County",5,83,812,346,466
050,26,145,"Michigan","Saginaw County",5,84,751,323,428
050,26,145,"Michigan","Saginaw County",5,85,4080,1446,2634
050,26,147,"Michigan","St. Clair County",1,0,1528,778,750
050,26,147,"Michigan","St. Clair County",1,1,1553,771,782
050,26,147,"Michigan","St. Clair County",1,2,1589,795,794
050,26,147,"Michigan","St. Clair County",1,3,1652,854,798
050,26,147,"Michigan","St. Clair County",1,4,1738,901,837
050,26,147,"Michigan","St. Clair County",1,5,1668,848,820
050,26,147,"Michigan","St. Clair County",1,6,1740,906,834
050,26,147,"Michigan","St. Clair County",1,7,1683,870,813
050,26,147,"Michigan","St. Clair County",1,8,1806,931,875
050,26,147,"Michigan","St. Clair County",1,9,1799,914,885
050,26,147,"Michigan","St. Clair County",1,10,1913,1001,912
050,26,147,"Michigan","St. Clair County",1,11,1959,1019,940
050,26,147,"Michigan","St. Clair County",1,12,2056,1049,1007
050,26,147,"Michigan","St. Clair County",1,13,2072,1071,1001
050,26,147,"Michigan","St. Clair County",1,14,2126,1092,1034
050,26,147,"Michigan","St. Clair County",1,15,2145,1105,1040
050,26,147,"Michigan","St. Clair County",1,16,2189,1134,1055
050,26,147,"Michigan","St. Clair County",1,17,2173,1126,1047
050,26,147,"Michigan","St. Clair County",1,18,1879,1018,861
050,26,147,"Michigan","St. Clair County",1,19,1535,825,710
050,26,147,"Michigan","St. Clair County",1,20,1638,830,808
050,26,147,"Michigan","St. Clair County",1,21,1726,898,828
050,26,147,"Michigan","St. Clair County",1,22,1760,903,857
050,26,147,"Michigan","St. Clair County",1,23,1790,934,856
050,26,147,"Michigan","St. Clair County",1,24,1829,948,881
050,26,147,"Michigan","St. Clair County",1,25,1845,978,867
050,26,147,"Michigan","St. Clair County",1,26,1895,1008,887
050,26,147,"Michigan","St. Clair County",1,27,1908,980,928
050,26,147,"Michigan","St. Clair County",1,28,1898,976,922
050,26,147,"Michigan","St. Clair County",1,29,1883,949,934
050,26,147,"Michigan","St. Clair County",1,30,1817,890,927
050,26,147,"Michigan","St. Clair County",1,31,1719,898,821
050,26,147,"Michigan","St. Clair County",1,32,1744,909,835
050,26,147,"Michigan","St. Clair County",1,33,1667,840,827
050,26,147,"Michigan","St. Clair County",1,34,1769,887,882
050,26,147,"Michigan","St. Clair County",1,35,1731,858,873
050,26,147,"Michigan","St. Clair County",1,36,1706,871,835
050,26,147,"Michigan","St. Clair County",1,37,1873,936,937
050,26,147,"Michigan","St. Clair County",1,38,1843,904,939
050,26,147,"Michigan","St. Clair County",1,39,1763,873,890
050,26,147,"Michigan","St. Clair County",1,40,1809,905,904
050,26,147,"Michigan","St. Clair County",1,41,1852,922,930
050,26,147,"Michigan","St. Clair County",1,42,1854,897,957
050,26,147,"Michigan","St. Clair County",1,43,1823,900,923
050,26,147,"Michigan","St. Clair County",1,44,1762,863,899
050,26,147,"Michigan","St. Clair County",1,45,1796,905,891
050,26,147,"Michigan","St. Clair County",1,46,1905,965,940
050,26,147,"Michigan","St. Clair County",1,47,1998,1000,998
050,26,147,"Michigan","St. Clair County",1,48,2164,1066,1098
050,26,147,"Michigan","St. Clair County",1,49,2386,1197,1189
050,26,147,"Michigan","St. Clair County",1,50,2292,1137,1155
050,26,147,"Michigan","St. Clair County",1,51,2283,1161,1122
050,26,147,"Michigan","St. Clair County",1,52,2257,1141,1116
050,26,147,"Michigan","St. Clair County",1,53,2424,1224,1200
050,26,147,"Michigan","St. Clair County",1,54,2503,1258,1245
050,26,147,"Michigan","St. Clair County",1,55,2634,1339,1295
050,26,147,"Michigan","St. Clair County",1,56,2664,1351,1313
050,26,147,"Michigan","St. Clair County",1,57,2636,1354,1282
050,26,147,"Michigan","St. Clair County",1,58,2689,1367,1322
050,26,147,"Michigan","St. Clair County",1,59,2585,1307,1278
050,26,147,"Michigan","St. Clair County",1,60,2589,1301,1288
050,26,147,"Michigan","St. Clair County",1,61,2628,1296,1332
050,26,147,"Michigan","St. Clair County",1,62,2567,1283,1284
050,26,147,"Michigan","St. Clair County",1,63,2483,1255,1228
050,26,147,"Michigan","St. Clair County",1,64,2346,1182,1164
050,26,147,"Michigan","St. Clair County",1,65,2256,1111,1145
050,26,147,"Michigan","St. Clair County",1,66,2214,1100,1114
050,26,147,"Michigan","St. Clair County",1,67,2148,1054,1094
050,26,147,"Michigan","St. Clair County",1,68,2028,997,1031
050,26,147,"Michigan","St. Clair County",1,69,1886,904,982
050,26,147,"Michigan","St. Clair County",1,70,1837,906,931
050,26,147,"Michigan","St. Clair County",1,71,1823,886,937
050,26,147,"Michigan","St. Clair County",1,72,1779,862,917
050,26,147,"Michigan","St. Clair County",1,73,1704,836,868
050,26,147,"Michigan","St. Clair County",1,74,1189,573,616
050,26,147,"Michigan","St. Clair County",1,75,1193,547,646
050,26,147,"Michigan","St. Clair County",1,76,1210,562,648
050,26,147,"Michigan","St. Clair County",1,77,1217,584,633
050,26,147,"Michigan","St. Clair County",1,78,1043,470,573
050,26,147,"Michigan","St. Clair County",1,79,914,404,510
050,26,147,"Michigan","St. Clair County",1,80,804,365,439
050,26,147,"Michigan","St. Clair County",1,81,792,353,439
050,26,147,"Michigan","St. Clair County",1,82,681,285,396
050,26,147,"Michigan","St. Clair County",1,83,572,248,324
050,26,147,"Michigan","St. Clair County",1,84,523,229,294
050,26,147,"Michigan","St. Clair County",1,85,3030,1086,1944
050,26,147,"Michigan","St. Clair County",2,0,1527,784,743
050,26,147,"Michigan","St. Clair County",2,1,1548,773,775
050,26,147,"Michigan","St. Clair County",2,2,1588,790,798
050,26,147,"Michigan","St. Clair County",2,3,1645,841,804
050,26,147,"Michigan","St. Clair County",2,4,1729,893,836
050,26,147,"Michigan","St. Clair County",2,5,1697,868,829
050,26,147,"Michigan","St. Clair County",2,6,1732,898,834
050,26,147,"Michigan","St. Clair County",2,7,1704,881,823
050,26,147,"Michigan","St. Clair County",2,8,1768,912,856
050,26,147,"Michigan","St. Clair County",2,9,1802,922,880
050,26,147,"Michigan","St. Clair County",2,10,1887,981,906
050,26,147,"Michigan","St. Clair County",2,11,1946,1012,934
050,26,147,"Michigan","St. Clair County",2,12,2044,1047,997
050,26,147,"Michigan","St. Clair County",2,13,2071,1066,1005
050,26,147,"Michigan","St. Clair County",2,14,2117,1085,1032
050,26,147,"Michigan","St. Clair County",2,15,2145,1102,1043
050,26,147,"Michigan","St. Clair County",2,16,2186,1131,1055
050,26,147,"Michigan","St. Clair County",2,17,2183,1132,1051
050,26,147,"Michigan","St. Clair County",2,18,1860,1005,855
050,26,147,"Michigan","St. Clair County",2,19,1539,829,710
050,26,147,"Michigan","St. Clair County",2,20,1651,846,805
050,26,147,"Michigan","St. Clair County",2,21,1727,890,837
050,26,147,"Michigan","St. Clair County",2,22,1773,911,862
050,26,147,"Michigan","St. Clair County",2,23,1796,933,863
050,26,147,"Michigan","St. Clair County",2,24,1812,938,874
050,26,147,"Michigan","St. Clair County",2,25,1842,972,870
050,26,147,"Michigan","St. Clair County",2,26,1892,1006,886
050,26,147,"Michigan","St. Clair County",2,27,1903,982,921
050,26,147,"Michigan","St. Clair County",2,28,1899,975,924
050,26,147,"Michigan","St. Clair County",2,29,1883,951,932
050,26,147,"Michigan","St. Clair County",2,30,1851,916,935
050,26,147,"Michigan","St. Clair County",2,31,1745,896,849
050,26,147,"Michigan","St. Clair County",2,32,1736,900,836
050,26,147,"Michigan","St. Clair County",2,33,1694,860,834
050,26,147,"Michigan","St. Clair County",2,34,1747,876,871
050,26,147,"Michigan","St. Clair County",2,35,1755,873,882
050,26,147,"Michigan","St. Clair County",2,36,1709,867,842
050,26,147,"Michigan","St. Clair County",2,37,1848,929,919
050,26,147,"Michigan","St. Clair County",2,38,1858,915,943
050,26,147,"Michigan","St. Clair County",2,39,1784,883,901
050,26,147,"Michigan","St. Clair County",2,40,1812,905,907
050,26,147,"Michigan","St. Clair County",2,41,1839,915,924
050,26,147,"Michigan","St. Clair County",2,42,1844,898,946
050,26,147,"Michigan","St. Clair County",2,43,1845,906,939
050,26,147,"Michigan","St. Clair County",2,44,1758,862,896
050,26,147,"Michigan","St. Clair County",2,45,1801,902,899
050,26,147,"Michigan","St. Clair County",2,46,1868,944,924
050,26,147,"Michigan","St. Clair County",2,47,1972,991,981
050,26,147,"Michigan","St. Clair County",2,48,2128,1049,1079
050,26,147,"Michigan","St. Clair County",2,49,2345,1171,1174
050,26,147,"Michigan","St. Clair County",2,50,2320,1153,1167
050,26,147,"Michigan","St. Clair County",2,51,2280,1152,1128
050,26,147,"Michigan","St. Clair County",2,52,2253,1139,1114
050,26,147,"Michigan","St. Clair County",2,53,2382,1201,1181
050,26,147,"Michigan","St. Clair County",2,54,2467,1242,1225
050,26,147,"Michigan","St. Clair County",2,55,2600,1316,1284
050,26,147,"Michigan","St. Clair County",2,56,2657,1350,1307
050,26,147,"Michigan","St. Clair County",2,57,2647,1355,1292
050,26,147,"Michigan","St. Clair County",2,58,2665,1355,1310
050,26,147,"Michigan","St. Clair County",2,59,2622,1328,1294
050,26,147,"Michigan","St. Clair County",2,60,2570,1291,1279
050,26,147,"Michigan","St. Clair County",2,61,2604,1289,1315
050,26,147,"Michigan","St. Clair County",2,62,2568,1280,1288
050,26,147,"Michigan","St. Clair County",2,63,2514,1266,1248
050,26,147,"Michigan","St. Clair County",2,64,2358,1189,1169
050,26,147,"Michigan","St. Clair County",2,65,2266,1119,1147
050,26,147,"Michigan","St. Clair County",2,66,2221,1100,1121
050,26,147,"Michigan","St. Clair County",2,67,2149,1056,1093
050,26,147,"Michigan","St. Clair County",2,68,2039,1001,1038
050,26,147,"Michigan","St. Clair County",2,69,1930,930,1000
050,26,147,"Michigan","St. Clair County",2,70,1830,894,936
050,26,147,"Michigan","St. Clair County",2,71,1821,888,933
050,26,147,"Michigan","St. Clair County",2,72,1745,839,906
050,26,147,"Michigan","St. Clair County",2,73,1799,879,920
050,26,147,"Michigan","St. Clair County",2,74,1221,591,630
050,26,147,"Michigan","St. Clair County",2,75,1189,547,642
050,26,147,"Michigan","St. Clair County",2,76,1184,550,634
050,26,147,"Michigan","St. Clair County",2,77,1234,588,646
050,26,147,"Michigan","St. Clair County",2,78,1053,482,571
050,26,147,"Michigan","St. Clair County",2,79,920,408,512
050,26,147,"Michigan","St. Clair County",2,80,818,367,451
050,26,147,"Michigan","St. Clair County",2,81,785,350,435
050,26,147,"Michigan","St. Clair County",2,82,699,299,400
050,26,147,"Michigan","St. Clair County",2,83,581,246,335
050,26,147,"Michigan","St. Clair County",2,84,524,230,294
050,26,147,"Michigan","St. Clair County",2,85,3030,1102,1928
050,26,147,"Michigan","St. Clair County",3,0,1481,725,756
050,26,147,"Michigan","St. Clair County",3,1,1516,790,726
050,26,147,"Michigan","St. Clair County",3,2,1586,796,790
050,26,147,"Michigan","St. Clair County",3,3,1603,793,810
050,26,147,"Michigan","St. Clair County",3,4,1684,858,826
050,26,147,"Michigan","St. Clair County",3,5,1780,923,857
050,26,147,"Michigan","St. Clair County",3,6,1712,884,828
050,26,147,"Michigan","St. Clair County",3,7,1754,903,851
050,26,147,"Michigan","St. Clair County",3,8,1707,886,821
050,26,147,"Michigan","St. Clair County",3,9,1791,928,863
050,26,147,"Michigan","St. Clair County",3,10,1814,916,898
050,26,147,"Michigan","St. Clair County",3,11,1917,998,919
050,26,147,"Michigan","St. Clair County",3,12,1972,1024,948
050,26,147,"Michigan","St. Clair County",3,13,2072,1065,1007
050,26,147,"Michigan","St. Clair County",3,14,2085,1075,1010
050,26,147,"Michigan","St. Clair County",3,15,2107,1073,1034
050,26,147,"Michigan","St. Clair County",3,16,2149,1107,1042
050,26,147,"Michigan","St. Clair County",3,17,2216,1153,1063
050,26,147,"Michigan","St. Clair County",3,18,1887,997,890
050,26,147,"Michigan","St. Clair County",3,19,1511,818,693
050,26,147,"Michigan","St. Clair County",3,20,1659,873,786
050,26,147,"Michigan","St. Clair County",3,21,1743,890,853
050,26,147,"Michigan","St. Clair County",3,22,1816,932,884
050,26,147,"Michigan","St. Clair County",3,23,1843,957,886
050,26,147,"Michigan","St. Clair County",3,24,1780,923,857
050,26,147,"Michigan","St. Clair County",3,25,1799,950,849
050,26,147,"Michigan","St. Clair County",3,26,1852,1007,845
050,26,147,"Michigan","St. Clair County",3,27,1879,992,887
050,26,147,"Michigan","St. Clair County",3,28,1927,996,931
050,26,147,"Michigan","St. Clair County",3,29,1912,964,948
050,26,147,"Michigan","St. Clair County",3,30,1902,973,929
050,26,147,"Michigan","St. Clair County",3,31,1893,941,952
050,26,147,"Michigan","St. Clair County",3,32,1756,903,853
050,26,147,"Michigan","St. Clair County",3,33,1771,912,859
050,26,147,"Michigan","St. Clair County",3,34,1690,843,847
050,26,147,"Michigan","St. Clair County",3,35,1756,887,869
050,26,147,"Michigan","St. Clair County",3,36,1771,879,892
050,26,147,"Michigan","St. Clair County",3,37,1742,894,848
050,26,147,"Michigan","St. Clair County",3,38,1844,929,915
050,26,147,"Michigan","St. Clair County",3,39,1884,931,953
050,26,147,"Michigan","St. Clair County",3,40,1781,885,896
050,26,147,"Michigan","St. Clair County",3,41,1787,883,904
050,26,147,"Michigan","St. Clair County",3,42,1844,926,918
050,26,147,"Michigan","St. Clair County",3,43,1834,884,950
050,26,147,"Michigan","St. Clair County",3,44,1872,923,949
050,26,147,"Michigan","St. Clair County",3,45,1782,880,902
050,26,147,"Michigan","St. Clair County",3,46,1813,896,917
050,26,147,"Michigan","St. Clair County",3,47,1877,953,924
050,26,147,"Michigan","St. Clair County",3,48,1954,980,974
050,26,147,"Michigan","St. Clair County",3,49,2125,1060,1065
050,26,147,"Michigan","St. Clair County",3,50,2358,1183,1175
050,26,147,"Michigan","St. Clair County",3,51,2339,1161,1178
050,26,147,"Michigan","St. Clair County",3,52,2247,1125,1122
050,26,147,"Michigan","St. Clair County",3,53,2257,1142,1115
050,26,147,"Michigan","St. Clair County",3,54,2393,1210,1183
050,26,147,"Michigan","St. Clair County",3,55,2460,1240,1220
050,26,147,"Michigan","St. Clair County",3,56,2582,1309,1273
050,26,147,"Michigan","St. Clair County",3,57,2630,1341,1289
050,26,147,"Michigan","St. Clair County",3,58,2623,1337,1286
050,26,147,"Michigan","St. Clair County",3,59,2647,1337,1310
050,26,147,"Michigan","St. Clair County",3,60,2622,1325,1297
050,26,147,"Michigan","St. Clair County",3,61,2545,1274,1271
050,26,147,"Michigan","St. Clair County",3,62,2556,1244,1312
050,26,147,"Michigan","St. Clair County",3,63,2546,1267,1279
050,26,147,"Michigan","St. Clair County",3,64,2475,1240,1235
050,26,147,"Michigan","St. Clair County",3,65,2316,1163,1153
050,26,147,"Michigan","St. Clair County",3,66,2249,1115,1134
050,26,147,"Michigan","St. Clair County",3,67,2184,1083,1101
050,26,147,"Michigan","St. Clair County",3,68,2104,1025,1079
050,26,147,"Michigan","St. Clair County",3,69,1993,977,1016
050,26,147,"Michigan","St. Clair County",3,70,1881,899,982
050,26,147,"Michigan","St. Clair County",3,71,1796,874,922
050,26,147,"Michigan","St. Clair County",3,72,1768,861,907
050,26,147,"Michigan","St. Clair County",3,73,1689,806,883
050,26,147,"Michigan","St. Clair County",3,74,1727,832,895
050,26,147,"Michigan","St. Clair County",3,75,1190,574,616
050,26,147,"Michigan","St. Clair County",3,76,1131,519,612
050,26,147,"Michigan","St. Clair County",3,77,1123,520,603
050,26,147,"Michigan","St. Clair County",3,78,1159,537,622
050,26,147,"Michigan","St. Clair County",3,79,985,447,538
050,26,147,"Michigan","St. Clair County",3,80,867,386,481
050,26,147,"Michigan","St. Clair County",3,81,755,337,418
050,26,147,"Michigan","St. Clair County",3,82,705,301,404
050,26,147,"Michigan","St. Clair County",3,83,643,273,370
050,26,147,"Michigan","St. Clair County",3,84,501,200,301
050,26,147,"Michigan","St. Clair County",3,85,2927,1101,1826
050,26,147,"Michigan","St. Clair County",4,0,1427,671,756
050,26,147,"Michigan","St. Clair County",4,1,1506,735,771
050,26,147,"Michigan","St. Clair County",4,2,1528,792,736
050,26,147,"Michigan","St. Clair County",4,3,1594,801,793
050,26,147,"Michigan","St. Clair County",4,4,1638,819,819
050,26,147,"Michigan","St. Clair County",4,5,1703,859,844
050,26,147,"Michigan","St. Clair County",4,6,1785,918,867
050,26,147,"Michigan","St. Clair County",4,7,1706,877,829
050,26,147,"Michigan","St. Clair County",4,8,1769,910,859
050,26,147,"Michigan","St. Clair County",4,9,1739,891,848
050,26,147,"Michigan","St. Clair County",4,10,1824,930,894
050,26,147,"Michigan","St. Clair County",4,11,1834,949,885
050,26,147,"Michigan","St. Clair County",4,12,1921,1002,919
050,26,147,"Michigan","St. Clair County",4,13,1986,1038,948
050,26,147,"Michigan","St. Clair County",4,14,2073,1067,1006
050,26,147,"Michigan","St. Clair County",4,15,2090,1070,1020
050,26,147,"Michigan","St. Clair County",4,16,2127,1089,1038
050,26,147,"Michigan","St. Clair County",4,17,2165,1134,1031
050,26,147,"Michigan","St. Clair County",4,18,1859,995,864
050,26,147,"Michigan","St. Clair County",4,19,1491,808,683
050,26,147,"Michigan","St. Clair County",4,20,1566,831,735
050,26,147,"Michigan","St. Clair County",4,21,1725,903,822
050,26,147,"Michigan","St. Clair County",4,22,1795,906,889
050,26,147,"Michigan","St. Clair County",4,23,1905,1009,896
050,26,147,"Michigan","St. Clair County",4,24,1856,980,876
050,26,147,"Michigan","St. Clair County",4,25,1740,920,820
050,26,147,"Michigan","St. Clair County",4,26,1810,973,837
050,26,147,"Michigan","St. Clair County",4,27,1821,986,835
050,26,147,"Michigan","St. Clair County",4,28,1870,977,893
050,26,147,"Michigan","St. Clair County",4,29,1915,971,944
050,26,147,"Michigan","St. Clair County",4,30,1942,992,950
050,26,147,"Michigan","St. Clair County",4,31,1951,991,960
050,26,147,"Michigan","St. Clair County",4,32,1913,951,962
050,26,147,"Michigan","St. Clair County",4,33,1777,919,858
050,26,147,"Michigan","St. Clair County",4,34,1766,910,856
050,26,147,"Michigan","St. Clair County",4,35,1704,851,853
050,26,147,"Michigan","St. Clair County",4,36,1809,925,884
050,26,147,"Michigan","St. Clair County",4,37,1783,870,913
050,26,147,"Michigan","St. Clair County",4,38,1758,904,854
050,26,147,"Michigan","St. Clair County",4,39,1840,924,916
050,26,147,"Michigan","St. Clair County",4,40,1915,950,965
050,26,147,"Michigan","St. Clair County",4,41,1817,910,907
050,26,147,"Michigan","St. Clair County",4,42,1783,866,917
050,26,147,"Michigan","St. Clair County",4,43,1833,927,906
050,26,147,"Michigan","St. Clair County",4,44,1833,881,952
050,26,147,"Michigan","St. Clair County",4,45,1885,919,966
050,26,147,"Michigan","St. Clair County",4,46,1767,868,899
050,26,147,"Michigan","St. Clair County",4,47,1816,917,899
050,26,147,"Michigan","St. Clair County",4,48,1872,940,932
050,26,147,"Michigan","St. Clair County",4,49,1958,975,983
050,26,147,"Michigan","St. Clair County",4,50,2130,1062,1068
050,26,147,"Michigan","St. Clair County",4,51,2399,1222,1177
050,26,147,"Michigan","St. Clair County",4,52,2312,1149,1163
050,26,147,"Michigan","St. Clair County",4,53,2239,1120,1119
050,26,147,"Michigan","St. Clair County",4,54,2259,1141,1118
050,26,147,"Michigan","St. Clair County",4,55,2378,1208,1170
050,26,147,"Michigan","St. Clair County",4,56,2465,1252,1213
050,26,147,"Michigan","St. Clair County",4,57,2596,1318,1278
050,26,147,"Michigan","St. Clair County",4,58,2595,1318,1277
050,26,147,"Michigan","St. Clair County",4,59,2634,1341,1293
050,26,147,"Michigan","St. Clair County",4,60,2602,1305,1297
050,26,147,"Michigan","St. Clair County",4,61,2574,1293,1281
050,26,147,"Michigan","St. Clair County",4,62,2509,1237,1272
050,26,147,"Michigan","St. Clair County",4,63,2523,1222,1301
050,26,147,"Michigan","St. Clair County",4,64,2483,1224,1259
050,26,147,"Michigan","St. Clair County",4,65,2415,1197,1218
050,26,147,"Michigan","St. Clair County",4,66,2281,1145,1136
050,26,147,"Michigan","St. Clair County",4,67,2196,1081,1115
050,26,147,"Michigan","St. Clair County",4,68,2131,1047,1084
050,26,147,"Michigan","St. Clair County",4,69,2069,1000,1069
050,26,147,"Michigan","St. Clair County",4,70,1951,953,998
050,26,147,"Michigan","St. Clair County",4,71,1843,884,959
050,26,147,"Michigan","St. Clair County",4,72,1724,845,879
050,26,147,"Michigan","St. Clair County",4,73,1717,826,891
050,26,147,"Michigan","St. Clair County",4,74,1631,771,860
050,26,147,"Michigan","St. Clair County",4,75,1680,810,870
050,26,147,"Michigan","St. Clair County",4,76,1155,558,597
050,26,147,"Michigan","St. Clair County",4,77,1086,493,593
050,26,147,"Michigan","St. Clair County",4,78,1057,476,581
050,26,147,"Michigan","St. Clair County",4,79,1079,497,582
050,26,147,"Michigan","St. Clair County",4,80,941,430,511
050,26,147,"Michigan","St. Clair County",4,81,812,360,452
050,26,147,"Michigan","St. Clair County",4,82,668,288,380
050,26,147,"Michigan","St. Clair County",4,83,640,272,368
050,26,147,"Michigan","St. Clair County",4,84,573,245,328
050,26,147,"Michigan","St. Clair County",4,85,2831,1053,1778
050,26,147,"Michigan","St. Clair County",5,0,1416,667,749
050,26,147,"Michigan","St. Clair County",5,1,1513,729,784
050,26,147,"Michigan","St. Clair County",5,2,1531,745,786
050,26,147,"Michigan","St. Clair County",5,3,1561,815,746
050,26,147,"Michigan","St. Clair County",5,4,1608,819,789
050,26,147,"Michigan","St. Clair County",5,5,1658,830,828
050,26,147,"Michigan","St. Clair County",5,6,1716,863,853
050,26,147,"Michigan","St. Clair County",5,7,1821,945,876
050,26,147,"Michigan","St. Clair County",5,8,1724,886,838
050,26,147,"Michigan","St. Clair County",5,9,1780,911,869
050,26,147,"Michigan","St. Clair County",5,10,1741,889,852
050,26,147,"Michigan","St. Clair County",5,11,1830,937,893
050,26,147,"Michigan","St. Clair County",5,12,1844,951,893
050,26,147,"Michigan","St. Clair County",5,13,1956,1027,929
050,26,147,"Michigan","St. Clair County",5,14,2003,1046,957
050,26,147,"Michigan","St. Clair County",5,15,2085,1071,1014
050,26,147,"Michigan","St. Clair County",5,16,2105,1077,1028
050,26,147,"Michigan","St. Clair County",5,17,2158,1110,1048
050,26,147,"Michigan","St. Clair County",5,18,1815,986,829
050,26,147,"Michigan","St. Clair County",5,19,1469,800,669
050,26,147,"Michigan","St. Clair County",5,20,1621,852,769
050,26,147,"Michigan","St. Clair County",5,21,1671,878,793
050,26,147,"Michigan","St. Clair County",5,22,1868,960,908
050,26,147,"Michigan","St. Clair County",5,23,1893,967,926
050,26,147,"Michigan","St. Clair County",5,24,1901,1010,891
050,26,147,"Michigan","St. Clair County",5,25,1851,978,873
050,26,147,"Michigan","St. Clair County",5,26,1729,921,808
050,26,147,"Michigan","St. Clair County",5,27,1820,973,847
050,26,147,"Michigan","St. Clair County",5,28,1835,984,851
050,26,147,"Michigan","St. Clair County",5,29,1905,987,918
050,26,147,"Michigan","St. Clair County",5,30,1923,981,942
050,26,147,"Michigan","St. Clair County",5,31,1944,978,966
050,26,147,"Michigan","St. Clair County",5,32,1975,1002,973
050,26,147,"Michigan","St. Clair County",5,33,1922,949,973
050,26,147,"Michigan","St. Clair County",5,34,1767,891,876
050,26,147,"Michigan","St. Clair County",5,35,1792,927,865
050,26,147,"Michigan","St. Clair County",5,36,1717,843,874
050,26,147,"Michigan","St. Clair County",5,37,1814,928,886
050,26,147,"Michigan","St. Clair County",5,38,1808,883,925
050,26,147,"Michigan","St. Clair County",5,39,1791,924,867
050,26,147,"Michigan","St. Clair County",5,40,1883,943,940
050,26,147,"Michigan","St. Clair County",5,41,1930,954,976
050,26,147,"Michigan","St. Clair County",5,42,1831,903,928
050,26,147,"Michigan","St. Clair County",5,43,1777,863,914
050,26,147,"Michigan","St. Clair County",5,44,1849,938,911
050,26,147,"Michigan","St. Clair County",5,45,1852,896,956
050,26,147,"Michigan","St. Clair County",5,46,1883,923,960
050,26,147,"Michigan","St. Clair County",5,47,1763,868,895
050,26,147,"Michigan","St. Clair County",5,48,1817,913,904
050,26,147,"Michigan","St. Clair County",5,49,1878,948,930
050,26,147,"Michigan","St. Clair County",5,50,1959,975,984
050,26,147,"Michigan","St. Clair County",5,51,2148,1074,1074
050,26,147,"Michigan","St. Clair County",5,52,2393,1215,1178
050,26,147,"Michigan","St. Clair County",5,53,2317,1147,1170
050,26,147,"Michigan","St. Clair County",5,54,2237,1123,1114
050,26,147,"Michigan","St. Clair County",5,55,2263,1141,1122
050,26,147,"Michigan","St. Clair County",5,56,2371,1214,1157
050,26,147,"Michigan","St. Clair County",5,57,2474,1250,1224
050,26,147,"Michigan","St. Clair County",5,58,2559,1298,1261
050,26,147,"Michigan","St. Clair County",5,59,2608,1320,1288
050,26,147,"Michigan","St. Clair County",5,60,2628,1333,1295
050,26,147,"Michigan","St. Clair County",5,61,2586,1290,1296
050,26,147,"Michigan","St. Clair County",5,62,2544,1265,1279
050,26,147,"Michigan","St. Clair County",5,63,2494,1223,1271
050,26,147,"Michigan","St. Clair County",5,64,2481,1208,1273
050,26,147,"Michigan","St. Clair County",5,65,2448,1196,1252
050,26,147,"Michigan","St. Clair County",5,66,2384,1181,1203
050,26,147,"Michigan","St. Clair County",5,67,2254,1125,1129
050,26,147,"Michigan","St. Clair County",5,68,2159,1056,1103
050,26,147,"Michigan","St. Clair County",5,69,2094,1024,1070
050,26,147,"Michigan","St. Clair County",5,70,2039,989,1050
050,26,147,"Michigan","St. Clair County",5,71,1902,928,974
050,26,147,"Michigan","St. Clair County",5,72,1796,859,937
050,26,147,"Michigan","St. Clair County",5,73,1675,807,868
050,26,147,"Michigan","St. Clair County",5,74,1657,794,863
050,26,147,"Michigan","St. Clair County",5,75,1606,760,846
050,26,147,"Michigan","St. Clair County",5,76,1605,780,825
050,26,147,"Michigan","St. Clair County",5,77,1120,543,577
050,26,147,"Michigan","St. Clair County",5,78,1035,459,576
050,26,147,"Michigan","St. Clair County",5,79,972,439,533
050,26,147,"Michigan","St. Clair County",5,80,1045,481,564
050,26,147,"Michigan","St. Clair County",5,81,886,403,483
050,26,147,"Michigan","St. Clair County",5,82,743,318,425
050,26,147,"Michigan","St. Clair County",5,83,612,264,348
050,26,147,"Michigan","St. Clair County",5,84,585,248,337
050,26,147,"Michigan","St. Clair County",5,85,2851,1083,1768
050,26,149,"Michigan","St. Joseph County",1,0,757,390,367
050,26,149,"Michigan","St. Joseph County",1,1,752,378,374
050,26,149,"Michigan","St. Joseph County",1,2,755,393,362
050,26,149,"Michigan","St. Joseph County",1,3,801,422,379
050,26,149,"Michigan","St. Joseph County",1,4,811,428,383
050,26,149,"Michigan","St. Joseph County",1,5,847,442,405
050,26,149,"Michigan","St. Joseph County",1,6,807,435,372
050,26,149,"Michigan","St. Joseph County",1,7,787,398,389
050,26,149,"Michigan","St. Joseph County",1,8,831,428,403
050,26,149,"Michigan","St. Joseph County",1,9,843,428,415
050,26,149,"Michigan","St. Joseph County",1,10,826,422,404
050,26,149,"Michigan","St. Joseph County",1,11,901,454,447
050,26,149,"Michigan","St. Joseph County",1,12,937,479,458
050,26,149,"Michigan","St. Joseph County",1,13,906,468,438
050,26,149,"Michigan","St. Joseph County",1,14,901,460,441
050,26,149,"Michigan","St. Joseph County",1,15,883,473,410
050,26,149,"Michigan","St. Joseph County",1,16,912,456,456
050,26,149,"Michigan","St. Joseph County",1,17,848,426,422
050,26,149,"Michigan","St. Joseph County",1,18,719,382,337
050,26,149,"Michigan","St. Joseph County",1,19,622,316,306
050,26,149,"Michigan","St. Joseph County",1,20,651,342,309
050,26,149,"Michigan","St. Joseph County",1,21,638,342,296
050,26,149,"Michigan","St. Joseph County",1,22,665,328,337
050,26,149,"Michigan","St. Joseph County",1,23,700,372,328
050,26,149,"Michigan","St. Joseph County",1,24,701,349,352
050,26,149,"Michigan","St. Joseph County",1,25,720,385,335
050,26,149,"Michigan","St. Joseph County",1,26,710,354,356
050,26,149,"Michigan","St. Joseph County",1,27,750,388,362
050,26,149,"Michigan","St. Joseph County",1,28,735,390,345
050,26,149,"Michigan","St. Joseph County",1,29,741,389,352
050,26,149,"Michigan","St. Joseph County",1,30,760,394,366
050,26,149,"Michigan","St. Joseph County",1,31,733,382,351
050,26,149,"Michigan","St. Joseph County",1,32,708,387,321
050,26,149,"Michigan","St. Joseph County",1,33,664,330,334
050,26,149,"Michigan","St. Joseph County",1,34,722,356,366
050,26,149,"Michigan","St. Joseph County",1,35,746,379,367
050,26,149,"Michigan","St. Joseph County",1,36,766,385,381
050,26,149,"Michigan","St. Joseph County",1,37,720,378,342
050,26,149,"Michigan","St. Joseph County",1,38,718,359,359
050,26,149,"Michigan","St. Joseph County",1,39,727,362,365
050,26,149,"Michigan","St. Joseph County",1,40,704,349,355
050,26,149,"Michigan","St. Joseph County",1,41,675,336,339
050,26,149,"Michigan","St. Joseph County",1,42,692,348,344
050,26,149,"Michigan","St. Joseph County",1,43,717,345,372
050,26,149,"Michigan","St. Joseph County",1,44,687,341,346
050,26,149,"Michigan","St. Joseph County",1,45,668,337,331
050,26,149,"Michigan","St. Joseph County",1,46,640,317,323
050,26,149,"Michigan","St. Joseph County",1,47,668,346,322
050,26,149,"Michigan","St. Joseph County",1,48,718,373,345
050,26,149,"Michigan","St. Joseph County",1,49,760,412,348
050,26,149,"Michigan","St. Joseph County",1,50,726,396,330
050,26,149,"Michigan","St. Joseph County",1,51,687,363,324
050,26,149,"Michigan","St. Joseph County",1,52,704,378,326
050,26,149,"Michigan","St. Joseph County",1,53,731,378,353
050,26,149,"Michigan","St. Joseph County",1,54,817,414,403
050,26,149,"Michigan","St. Joseph County",1,55,833,418,415
050,26,149,"Michigan","St. Joseph County",1,56,851,435,416
050,26,149,"Michigan","St. Joseph County",1,57,851,426,425
050,26,149,"Michigan","St. Joseph County",1,58,893,448,445
050,26,149,"Michigan","St. Joseph County",1,59,920,443,477
050,26,149,"Michigan","St. Joseph County",1,60,865,442,423
050,26,149,"Michigan","St. Joseph County",1,61,838,432,406
050,26,149,"Michigan","St. Joseph County",1,62,908,456,452
050,26,149,"Michigan","St. Joseph County",1,63,830,405,425
050,26,149,"Michigan","St. Joseph County",1,64,822,401,421
050,26,149,"Michigan","St. Joseph County",1,65,800,400,400
050,26,149,"Michigan","St. Joseph County",1,66,800,403,397
050,26,149,"Michigan","St. Joseph County",1,67,762,373,389
050,26,149,"Michigan","St. Joseph County",1,68,745,376,369
050,26,149,"Michigan","St. Joseph County",1,69,672,319,353
050,26,149,"Michigan","St. Joseph County",1,70,648,307,341
050,26,149,"Michigan","St. Joseph County",1,71,621,294,327
050,26,149,"Michigan","St. Joseph County",1,72,604,292,312
050,26,149,"Michigan","St. Joseph County",1,73,604,279,325
050,26,149,"Michigan","St. Joseph County",1,74,406,195,211
050,26,149,"Michigan","St. Joseph County",1,75,432,212,220
050,26,149,"Michigan","St. Joseph County",1,76,421,190,231
050,26,149,"Michigan","St. Joseph County",1,77,433,206,227
050,26,149,"Michigan","St. Joseph County",1,78,366,162,204
050,26,149,"Michigan","St. Joseph County",1,79,306,134,172
050,26,149,"Michigan","St. Joseph County",1,80,264,128,136
050,26,149,"Michigan","St. Joseph County",1,81,259,120,139
050,26,149,"Michigan","St. Joseph County",1,82,260,116,144
050,26,149,"Michigan","St. Joseph County",1,83,239,108,131
050,26,149,"Michigan","St. Joseph County",1,84,198,87,111
050,26,149,"Michigan","St. Joseph County",1,85,1176,416,760
050,26,149,"Michigan","St. Joseph County",2,0,744,386,358
050,26,149,"Michigan","St. Joseph County",2,1,752,382,370
050,26,149,"Michigan","St. Joseph County",2,2,752,387,365
050,26,149,"Michigan","St. Joseph County",2,3,790,412,378
050,26,149,"Michigan","St. Joseph County",2,4,814,427,387
050,26,149,"Michigan","St. Joseph County",2,5,841,438,403
050,26,149,"Michigan","St. Joseph County",2,6,820,436,384
050,26,149,"Michigan","St. Joseph County",2,7,792,407,385
050,26,149,"Michigan","St. Joseph County",2,8,820,419,401
050,26,149,"Michigan","St. Joseph County",2,9,841,428,413
050,26,149,"Michigan","St. Joseph County",2,10,829,425,404
050,26,149,"Michigan","St. Joseph County",2,11,882,446,436
050,26,149,"Michigan","St. Joseph County",2,12,936,476,460
050,26,149,"Michigan","St. Joseph County",2,13,917,472,445
050,26,149,"Michigan","St. Joseph County",2,14,906,466,440
050,26,149,"Michigan","St. Joseph County",2,15,891,472,419
050,26,149,"Michigan","St. Joseph County",2,16,905,460,445
050,26,149,"Michigan","St. Joseph County",2,17,861,433,428
050,26,149,"Michigan","St. Joseph County",2,18,716,379,337
050,26,149,"Michigan","St. Joseph County",2,19,614,318,296
050,26,149,"Michigan","St. Joseph County",2,20,657,342,315
050,26,149,"Michigan","St. Joseph County",2,21,642,338,304
050,26,149,"Michigan","St. Joseph County",2,22,665,336,329
050,26,149,"Michigan","St. Joseph County",2,23,696,362,334
050,26,149,"Michigan","St. Joseph County",2,24,702,355,347
050,26,149,"Michigan","St. Joseph County",2,25,714,375,339
050,26,149,"Michigan","St. Joseph County",2,26,718,366,352
050,26,149,"Michigan","St. Joseph County",2,27,736,379,357
050,26,149,"Michigan","St. Joseph County",2,28,738,389,349
050,26,149,"Michigan","St. Joseph County",2,29,743,389,354
050,26,149,"Michigan","St. Joseph County",2,30,760,394,366
050,26,149,"Michigan","St. Joseph County",2,31,738,384,354
050,26,149,"Michigan","St. Joseph County",2,32,716,386,330
050,26,149,"Michigan","St. Joseph County",2,33,674,342,332
050,26,149,"Michigan","St. Joseph County",2,34,707,349,358
050,26,149,"Michigan","St. Joseph County",2,35,742,373,369
050,26,149,"Michigan","St. Joseph County",2,36,755,378,377
050,26,149,"Michigan","St. Joseph County",2,37,733,380,353
050,26,149,"Michigan","St. Joseph County",2,38,724,367,357
050,26,149,"Michigan","St. Joseph County",2,39,723,360,363
050,26,149,"Michigan","St. Joseph County",2,40,716,355,361
050,26,149,"Michigan","St. Joseph County",2,41,682,340,342
050,26,149,"Michigan","St. Joseph County",2,42,684,343,341
050,26,149,"Michigan","St. Joseph County",2,43,715,349,366
050,26,149,"Michigan","St. Joseph County",2,44,685,338,347
050,26,149,"Michigan","St. Joseph County",2,45,673,337,336
050,26,149,"Michigan","St. Joseph County",2,46,642,321,321
050,26,149,"Michigan","St. Joseph County",2,47,658,337,321
050,26,149,"Michigan","St. Joseph County",2,48,705,366,339
050,26,149,"Michigan","St. Joseph County",2,49,754,407,347
050,26,149,"Michigan","St. Joseph County",2,50,736,400,336
050,26,149,"Michigan","St. Joseph County",2,51,699,372,327
050,26,149,"Michigan","St. Joseph County",2,52,699,373,326
050,26,149,"Michigan","St. Joseph County",2,53,723,376,347
050,26,149,"Michigan","St. Joseph County",2,54,790,401,389
050,26,149,"Michigan","St. Joseph County",2,55,825,415,410
050,26,149,"Michigan","St. Joseph County",2,56,842,427,415
050,26,149,"Michigan","St. Joseph County",2,57,853,430,423
050,26,149,"Michigan","St. Joseph County",2,58,878,438,440
050,26,149,"Michigan","St. Joseph County",2,59,912,444,468
050,26,149,"Michigan","St. Joseph County",2,60,875,441,434
050,26,149,"Michigan","St. Joseph County",2,61,841,432,409
050,26,149,"Michigan","St. Joseph County",2,62,890,451,439
050,26,149,"Michigan","St. Joseph County",2,63,851,416,435
050,26,149,"Michigan","St. Joseph County",2,64,811,394,417
050,26,149,"Michigan","St. Joseph County",2,65,802,397,405
050,26,149,"Michigan","St. Joseph County",2,66,801,401,400
050,26,149,"Michigan","St. Joseph County",2,67,763,376,387
050,26,149,"Michigan","St. Joseph County",2,68,741,371,370
050,26,149,"Michigan","St. Joseph County",2,69,698,335,363
050,26,149,"Michigan","St. Joseph County",2,70,650,307,343
050,26,149,"Michigan","St. Joseph County",2,71,624,296,328
050,26,149,"Michigan","St. Joseph County",2,72,598,287,311
050,26,149,"Michigan","St. Joseph County",2,73,633,295,338
050,26,149,"Michigan","St. Joseph County",2,74,424,200,224
050,26,149,"Michigan","St. Joseph County",2,75,424,207,217
050,26,149,"Michigan","St. Joseph County",2,76,419,193,226
050,26,149,"Michigan","St. Joseph County",2,77,437,205,232
050,26,149,"Michigan","St. Joseph County",2,78,373,168,205
050,26,149,"Michigan","St. Joseph County",2,79,314,139,175
050,26,149,"Michigan","St. Joseph County",2,80,271,127,144
050,26,149,"Michigan","St. Joseph County",2,81,255,119,136
050,26,149,"Michigan","St. Joseph County",2,82,256,116,140
050,26,149,"Michigan","St. Joseph County",2,83,237,104,133
050,26,149,"Michigan","St. Joseph County",2,84,204,89,115
050,26,149,"Michigan","St. Joseph County",2,85,1172,419,753
050,26,149,"Michigan","St. Joseph County",3,0,688,330,358
050,26,149,"Michigan","St. Joseph County",3,1,745,388,357
050,26,149,"Michigan","St. Joseph County",3,2,770,402,368
050,26,149,"Michigan","St. Joseph County",3,3,750,380,370
050,26,149,"Michigan","St. Joseph County",3,4,772,395,377
050,26,149,"Michigan","St. Joseph County",3,5,814,419,395
050,26,149,"Michigan","St. Joseph County",3,6,832,439,393
050,26,149,"Michigan","St. Joseph County",3,7,827,443,384
050,26,149,"Michigan","St. Joseph County",3,8,792,404,388
050,26,149,"Michigan","St. Joseph County",3,9,822,425,397
050,26,149,"Michigan","St. Joseph County",3,10,840,422,418
050,26,149,"Michigan","St. Joseph County",3,11,835,426,409
050,26,149,"Michigan","St. Joseph County",3,12,899,455,444
050,26,149,"Michigan","St. Joseph County",3,13,929,473,456
050,26,149,"Michigan","St. Joseph County",3,14,915,468,447
050,26,149,"Michigan","St. Joseph County",3,15,897,463,434
050,26,149,"Michigan","St. Joseph County",3,16,879,463,416
050,26,149,"Michigan","St. Joseph County",3,17,900,460,440
050,26,149,"Michigan","St. Joseph County",3,18,748,386,362
050,26,149,"Michigan","St. Joseph County",3,19,580,308,272
050,26,149,"Michigan","St. Joseph County",3,20,646,332,314
050,26,149,"Michigan","St. Joseph County",3,21,687,353,334
050,26,149,"Michigan","St. Joseph County",3,22,672,351,321
050,26,149,"Michigan","St. Joseph County",3,23,684,352,332
050,26,149,"Michigan","St. Joseph County",3,24,685,347,338
050,26,149,"Michigan","St. Joseph County",3,25,715,366,349
050,26,149,"Michigan","St. Joseph County",3,26,709,362,347
050,26,149,"Michigan","St. Joseph County",3,27,684,346,338
050,26,149,"Michigan","St. Joseph County",3,28,734,372,362
050,26,149,"Michigan","St. Joseph County",3,29,759,401,358
050,26,149,"Michigan","St. Joseph County",3,30,763,400,363
050,26,149,"Michigan","St. Joseph County",3,31,753,390,363
050,26,149,"Michigan","St. Joseph County",3,32,739,382,357
050,26,149,"Michigan","St. Joseph County",3,33,702,377,325
050,26,149,"Michigan","St. Joseph County",3,34,687,352,335
050,26,149,"Michigan","St. Joseph County",3,35,706,345,361
050,26,149,"Michigan","St. Joseph County",3,36,759,384,375
050,26,149,"Michigan","St. Joseph County",3,37,754,383,371
050,26,149,"Michigan","St. Joseph County",3,38,727,374,353
050,26,149,"Michigan","St. Joseph County",3,39,729,362,367
050,26,149,"Michigan","St. Joseph County",3,40,720,357,363
050,26,149,"Michigan","St. Joseph County",3,41,721,362,359
050,26,149,"Michigan","St. Joseph County",3,42,689,342,347
050,26,149,"Michigan","St. Joseph County",3,43,680,346,334
050,26,149,"Michigan","St. Joseph County",3,44,711,349,362
050,26,149,"Michigan","St. Joseph County",3,45,677,330,347
050,26,149,"Michigan","St. Joseph County",3,46,672,335,337
050,26,149,"Michigan","St. Joseph County",3,47,644,318,326
050,26,149,"Michigan","St. Joseph County",3,48,655,337,318
050,26,149,"Michigan","St. Joseph County",3,49,701,357,344
050,26,149,"Michigan","St. Joseph County",3,50,751,403,348
050,26,149,"Michigan","St. Joseph County",3,51,739,407,332
050,26,149,"Michigan","St. Joseph County",3,52,701,378,323
050,26,149,"Michigan","St. Joseph County",3,53,692,367,325
050,26,149,"Michigan","St. Joseph County",3,54,720,377,343
050,26,149,"Michigan","St. Joseph County",3,55,783,392,391
050,26,149,"Michigan","St. Joseph County",3,56,819,412,407
050,26,149,"Michigan","St. Joseph County",3,57,846,425,421
050,26,149,"Michigan","St. Joseph County",3,58,840,427,413
050,26,149,"Michigan","St. Joseph County",3,59,867,428,439
050,26,149,"Michigan","St. Joseph County",3,60,918,448,470
050,26,149,"Michigan","St. Joseph County",3,61,867,430,437
050,26,149,"Michigan","St. Joseph County",3,62,828,423,405
050,26,149,"Michigan","St. Joseph County",3,63,896,457,439
050,26,149,"Michigan","St. Joseph County",3,64,835,416,419
050,26,149,"Michigan","St. Joseph County",3,65,796,381,415
050,26,149,"Michigan","St. Joseph County",3,66,786,394,392
050,26,149,"Michigan","St. Joseph County",3,67,787,392,395
050,26,149,"Michigan","St. Joseph County",3,68,750,376,374
050,26,149,"Michigan","St. Joseph County",3,69,733,361,372
050,26,149,"Michigan","St. Joseph County",3,70,685,333,352
050,26,149,"Michigan","St. Joseph County",3,71,633,298,335
050,26,149,"Michigan","St. Joseph County",3,72,604,280,324
050,26,149,"Michigan","St. Joseph County",3,73,581,286,295
050,26,149,"Michigan","St. Joseph County",3,74,621,288,333
050,26,149,"Michigan","St. Joseph County",3,75,407,195,212
050,26,149,"Michigan","St. Joseph County",3,76,417,199,218
050,26,149,"Michigan","St. Joseph County",3,77,403,183,220
050,26,149,"Michigan","St. Joseph County",3,78,424,189,235
050,26,149,"Michigan","St. Joseph County",3,79,349,156,193
050,26,149,"Michigan","St. Joseph County",3,80,286,125,161
050,26,149,"Michigan","St. Joseph County",3,81,247,119,128
050,26,149,"Michigan","St. Joseph County",3,82,224,102,122
050,26,149,"Michigan","St. Joseph County",3,83,232,104,128
050,26,149,"Michigan","St. Joseph County",3,84,213,91,122
050,26,149,"Michigan","St. Joseph County",3,85,1166,423,743
050,26,149,"Michigan","St. Joseph County",4,0,660,316,344
050,26,149,"Michigan","St. Joseph County",4,1,674,322,352
050,26,149,"Michigan","St. Joseph County",4,2,748,388,360
050,26,149,"Michigan","St. Joseph County",4,3,764,399,365
050,26,149,"Michigan","St. Joseph County",4,4,757,388,369
050,26,149,"Michigan","St. Joseph County",4,5,765,387,378
050,26,149,"Michigan","St. Joseph County",4,6,820,417,403
050,26,149,"Michigan","St. Joseph County",4,7,842,434,408
050,26,149,"Michigan","St. Joseph County",4,8,827,453,374
050,26,149,"Michigan","St. Joseph County",4,9,788,402,386
050,26,149,"Michigan","St. Joseph County",4,10,814,417,397
050,26,149,"Michigan","St. Joseph County",4,11,836,434,402
050,26,149,"Michigan","St. Joseph County",4,12,836,423,413
050,26,149,"Michigan","St. Joseph County",4,13,896,455,441
050,26,149,"Michigan","St. Joseph County",4,14,942,472,470
050,26,149,"Michigan","St. Joseph County",4,15,924,475,449
050,26,149,"Michigan","St. Joseph County",4,16,901,471,430
050,26,149,"Michigan","St. Joseph County",4,17,890,470,420
050,26,149,"Michigan","St. Joseph County",4,18,766,409,357
050,26,149,"Michigan","St. Joseph County",4,19,593,307,286
050,26,149,"Michigan","St. Joseph County",4,20,607,313,294
050,26,149,"Michigan","St. Joseph County",4,21,681,358,323
050,26,149,"Michigan","St. Joseph County",4,22,739,370,369
050,26,149,"Michigan","St. Joseph County",4,23,715,379,336
050,26,149,"Michigan","St. Joseph County",4,24,696,372,324
050,26,149,"Michigan","St. Joseph County",4,25,689,355,334
050,26,149,"Michigan","St. Joseph County",4,26,729,376,353
050,26,149,"Michigan","St. Joseph County",4,27,710,365,345
050,26,149,"Michigan","St. Joseph County",4,28,697,364,333
050,26,149,"Michigan","St. Joseph County",4,29,716,361,355
050,26,149,"Michigan","St. Joseph County",4,30,776,418,358
050,26,149,"Michigan","St. Joseph County",4,31,778,411,367
050,26,149,"Michigan","St. Joseph County",4,32,761,394,367
050,26,149,"Michigan","St. Joseph County",4,33,744,380,364
050,26,149,"Michigan","St. Joseph County",4,34,702,378,324
050,26,149,"Michigan","St. Joseph County",4,35,676,348,328
050,26,149,"Michigan","St. Joseph County",4,36,702,341,361
050,26,149,"Michigan","St. Joseph County",4,37,755,380,375
050,26,149,"Michigan","St. Joseph County",4,38,730,375,355
050,26,149,"Michigan","St. Joseph County",4,39,744,379,365
050,26,149,"Michigan","St. Joseph County",4,40,741,367,374
050,26,149,"Michigan","St. Joseph County",4,41,721,355,366
050,26,149,"Michigan","St. Joseph County",4,42,735,366,369
050,26,149,"Michigan","St. Joseph County",4,43,693,343,350
050,26,149,"Michigan","St. Joseph County",4,44,682,346,336
050,26,149,"Michigan","St. Joseph County",4,45,710,352,358
050,26,149,"Michigan","St. Joseph County",4,46,688,342,346
050,26,149,"Michigan","St. Joseph County",4,47,679,342,337
050,26,149,"Michigan","St. Joseph County",4,48,648,324,324
050,26,149,"Michigan","St. Joseph County",4,49,656,336,320
050,26,149,"Michigan","St. Joseph County",4,50,694,355,339
050,26,149,"Michigan","St. Joseph County",4,51,752,407,345
050,26,149,"Michigan","St. Joseph County",4,52,738,402,336
050,26,149,"Michigan","St. Joseph County",4,53,684,377,307
050,26,149,"Michigan","St. Joseph County",4,54,694,371,323
050,26,149,"Michigan","St. Joseph County",4,55,698,364,334
050,26,149,"Michigan","St. Joseph County",4,56,781,391,390
050,26,149,"Michigan","St. Joseph County",4,57,821,417,404
050,26,149,"Michigan","St. Joseph County",4,58,841,421,420
050,26,149,"Michigan","St. Joseph County",4,59,837,431,406
050,26,149,"Michigan","St. Joseph County",4,60,865,426,439
050,26,149,"Michigan","St. Joseph County",4,61,904,442,462
050,26,149,"Michigan","St. Joseph County",4,62,855,426,429
050,26,149,"Michigan","St. Joseph County",4,63,830,426,404
050,26,149,"Michigan","St. Joseph County",4,64,886,449,437
050,26,149,"Michigan","St. Joseph County",4,65,810,401,409
050,26,149,"Michigan","St. Joseph County",4,66,779,375,404
050,26,149,"Michigan","St. Joseph County",4,67,769,381,388
050,26,149,"Michigan","St. Joseph County",4,68,774,389,385
050,26,149,"Michigan","St. Joseph County",4,69,731,363,368
050,26,149,"Michigan","St. Joseph County",4,70,708,349,359
050,26,149,"Michigan","St. Joseph County",4,71,668,318,350
050,26,149,"Michigan","St. Joseph County",4,72,616,288,328
050,26,149,"Michigan","St. Joseph County",4,73,583,273,310
050,26,149,"Michigan","St. Joseph County",4,74,558,269,289
050,26,149,"Michigan","St. Joseph County",4,75,603,280,323
050,26,149,"Michigan","St. Joseph County",4,76,398,185,213
050,26,149,"Michigan","St. Joseph County",4,77,396,186,210
050,26,149,"Michigan","St. Joseph County",4,78,384,170,214
050,26,149,"Michigan","St. Joseph County",4,79,389,168,221
050,26,149,"Michigan","St. Joseph County",4,80,322,140,182
050,26,149,"Michigan","St. Joseph County",4,81,263,117,146
050,26,149,"Michigan","St. Joseph County",4,82,222,105,117
050,26,149,"Michigan","St. Joseph County",4,83,205,90,115
050,26,149,"Michigan","St. Joseph County",4,84,200,86,114
050,26,149,"Michigan","St. Joseph County",4,85,1177,444,733
050,26,149,"Michigan","St. Joseph County",5,0,642,309,333
050,26,149,"Michigan","St. Joseph County",5,1,676,342,334
050,26,149,"Michigan","St. Joseph County",5,2,683,334,349
050,26,149,"Michigan","St. Joseph County",5,3,757,397,360
050,26,149,"Michigan","St. Joseph County",5,4,771,399,372
050,26,149,"Michigan","St. Joseph County",5,5,748,376,372
050,26,149,"Michigan","St. Joseph County",5,6,773,396,377
050,26,149,"Michigan","St. Joseph County",5,7,815,414,401
050,26,149,"Michigan","St. Joseph County",5,8,857,448,409
050,26,149,"Michigan","St. Joseph County",5,9,842,460,382
050,26,149,"Michigan","St. Joseph County",5,10,793,398,395
050,26,149,"Michigan","St. Joseph County",5,11,823,421,402
050,26,149,"Michigan","St. Joseph County",5,12,849,433,416
050,26,149,"Michigan","St. Joseph County",5,13,841,428,413
050,26,149,"Michigan","St. Joseph County",5,14,888,446,442
050,26,149,"Michigan","St. Joseph County",5,15,922,463,459
050,26,149,"Michigan","St. Joseph County",5,16,920,468,452
050,26,149,"Michigan","St. Joseph County",5,17,879,466,413
050,26,149,"Michigan","St. Joseph County",5,18,750,408,342
050,26,149,"Michigan","St. Joseph County",5,19,610,320,290
050,26,149,"Michigan","St. Joseph County",5,20,660,345,315
050,26,149,"Michigan","St. Joseph County",5,21,645,326,319
050,26,149,"Michigan","St. Joseph County",5,22,734,373,361
050,26,149,"Michigan","St. Joseph County",5,23,770,390,380
050,26,149,"Michigan","St. Joseph County",5,24,713,393,320
050,26,149,"Michigan","St. Joseph County",5,25,717,382,335
050,26,149,"Michigan","St. Joseph County",5,26,687,353,334
050,26,149,"Michigan","St. Joseph County",5,27,725,372,353
050,26,149,"Michigan","St. Joseph County",5,28,724,372,352
050,26,149,"Michigan","St. Joseph County",5,29,710,374,336
050,26,149,"Michigan","St. Joseph County",5,30,729,366,363
050,26,149,"Michigan","St. Joseph County",5,31,789,434,355
050,26,149,"Michigan","St. Joseph County",5,32,793,411,382
050,26,149,"Michigan","St. Joseph County",5,33,775,398,377
050,26,149,"Michigan","St. Joseph County",5,34,741,383,358
050,26,149,"Michigan","St. Joseph County",5,35,693,358,335
050,26,149,"Michigan","St. Joseph County",5,36,704,365,339
050,26,149,"Michigan","St. Joseph County",5,37,716,352,364
050,26,149,"Michigan","St. Joseph County",5,38,740,358,382
050,26,149,"Michigan","St. Joseph County",5,39,732,378,354
050,26,149,"Michigan","St. Joseph County",5,40,746,385,361
050,26,149,"Michigan","St. Joseph County",5,41,733,367,366
050,26,149,"Michigan","St. Joseph County",5,42,712,350,362
050,26,149,"Michigan","St. Joseph County",5,43,735,367,368
050,26,149,"Michigan","St. Joseph County",5,44,687,340,347
050,26,149,"Michigan","St. Joseph County",5,45,674,344,330
050,26,149,"Michigan","St. Joseph County",5,46,707,350,357
050,26,149,"Michigan","St. Joseph County",5,47,684,340,344
050,26,149,"Michigan","St. Joseph County",5,48,678,342,336
050,26,149,"Michigan","St. Joseph County",5,49,645,311,334
050,26,149,"Michigan","St. Joseph County",5,50,648,327,321
050,26,149,"Michigan","St. Joseph County",5,51,705,366,339
050,26,149,"Michigan","St. Joseph County",5,52,751,411,340
050,26,149,"Michigan","St. Joseph County",5,53,747,412,335
050,26,149,"Michigan","St. Joseph County",5,54,696,374,322
050,26,149,"Michigan","St. Joseph County",5,55,684,361,323
050,26,149,"Michigan","St. Joseph County",5,56,701,361,340
050,26,149,"Michigan","St. Joseph County",5,57,779,391,388
050,26,149,"Michigan","St. Joseph County",5,58,816,413,403
050,26,149,"Michigan","St. Joseph County",5,59,830,417,413
050,26,149,"Michigan","St. Joseph County",5,60,834,424,410
050,26,149,"Michigan","St. Joseph County",5,61,868,427,441
050,26,149,"Michigan","St. Joseph County",5,62,899,438,461
050,26,149,"Michigan","St. Joseph County",5,63,870,431,439
050,26,149,"Michigan","St. Joseph County",5,64,826,429,397
050,26,149,"Michigan","St. Joseph County",5,65,889,444,445
050,26,149,"Michigan","St. Joseph County",5,66,799,390,409
050,26,149,"Michigan","St. Joseph County",5,67,765,371,394
050,26,149,"Michigan","St. Joseph County",5,68,758,378,380
050,26,149,"Michigan","St. Joseph County",5,69,763,385,378
050,26,149,"Michigan","St. Joseph County",5,70,709,354,355
050,26,149,"Michigan","St. Joseph County",5,71,695,340,355
050,26,149,"Michigan","St. Joseph County",5,72,651,310,341
050,26,149,"Michigan","St. Joseph County",5,73,598,282,316
050,26,149,"Michigan","St. Joseph County",5,74,567,268,299
050,26,149,"Michigan","St. Joseph County",5,75,537,257,280
050,26,149,"Michigan","St. Joseph County",5,76,587,269,318
050,26,149,"Michigan","St. Joseph County",5,77,372,175,197
050,26,149,"Michigan","St. Joseph County",5,78,384,177,207
050,26,149,"Michigan","St. Joseph County",5,79,351,156,195
050,26,149,"Michigan","St. Joseph County",5,80,367,156,211
050,26,149,"Michigan","St. Joseph County",5,81,293,130,163
050,26,149,"Michigan","St. Joseph County",5,82,233,104,129
050,26,149,"Michigan","St. Joseph County",5,83,199,91,108
050,26,149,"Michigan","St. Joseph County",5,84,177,77,100
050,26,149,"Michigan","St. Joseph County",5,85,1193,466,727
050,26,151,"Michigan","Sanilac County",1,0,382,200,182
050,26,151,"Michigan","Sanilac County",1,1,385,214,171
050,26,151,"Michigan","Sanilac County",1,2,413,218,195
050,26,151,"Michigan","Sanilac County",1,3,427,216,211
050,26,151,"Michigan","Sanilac County",1,4,447,224,223
050,26,151,"Michigan","Sanilac County",1,5,436,237,199
050,26,151,"Michigan","Sanilac County",1,6,466,252,214
050,26,151,"Michigan","Sanilac County",1,7,466,227,239
050,26,151,"Michigan","Sanilac County",1,8,448,224,224
050,26,151,"Michigan","Sanilac County",1,9,483,253,230
050,26,151,"Michigan","Sanilac County",1,10,518,271,247
050,26,151,"Michigan","Sanilac County",1,11,530,257,273
050,26,151,"Michigan","Sanilac County",1,12,535,268,267
050,26,151,"Michigan","Sanilac County",1,13,538,266,272
050,26,151,"Michigan","Sanilac County",1,14,532,273,259
050,26,151,"Michigan","Sanilac County",1,15,567,289,278
050,26,151,"Michigan","Sanilac County",1,16,553,281,272
050,26,151,"Michigan","Sanilac County",1,17,556,280,276
050,26,151,"Michigan","Sanilac County",1,18,472,241,231
050,26,151,"Michigan","Sanilac County",1,19,354,188,166
050,26,151,"Michigan","Sanilac County",1,20,404,206,198
050,26,151,"Michigan","Sanilac County",1,21,399,200,199
050,26,151,"Michigan","Sanilac County",1,22,433,217,216
050,26,151,"Michigan","Sanilac County",1,23,430,223,207
050,26,151,"Michigan","Sanilac County",1,24,457,244,213
050,26,151,"Michigan","Sanilac County",1,25,424,235,189
050,26,151,"Michigan","Sanilac County",1,26,420,222,198
050,26,151,"Michigan","Sanilac County",1,27,447,232,215
050,26,151,"Michigan","Sanilac County",1,28,402,201,201
050,26,151,"Michigan","Sanilac County",1,29,428,212,216
050,26,151,"Michigan","Sanilac County",1,30,412,215,197
050,26,151,"Michigan","Sanilac County",1,31,420,222,198
050,26,151,"Michigan","Sanilac County",1,32,391,208,183
050,26,151,"Michigan","Sanilac County",1,33,405,205,200
050,26,151,"Michigan","Sanilac County",1,34,422,208,214
050,26,151,"Michigan","Sanilac County",1,35,399,205,194
050,26,151,"Michigan","Sanilac County",1,36,416,226,190
050,26,151,"Michigan","Sanilac County",1,37,451,233,218
050,26,151,"Michigan","Sanilac County",1,38,453,236,217
050,26,151,"Michigan","Sanilac County",1,39,426,210,216
050,26,151,"Michigan","Sanilac County",1,40,442,228,214
050,26,151,"Michigan","Sanilac County",1,41,460,245,215
050,26,151,"Michigan","Sanilac County",1,42,415,204,211
050,26,151,"Michigan","Sanilac County",1,43,432,217,215
050,26,151,"Michigan","Sanilac County",1,44,446,212,234
050,26,151,"Michigan","Sanilac County",1,45,452,230,222
050,26,151,"Michigan","Sanilac County",1,46,449,237,212
050,26,151,"Michigan","Sanilac County",1,47,427,208,219
050,26,151,"Michigan","Sanilac County",1,48,492,248,244
050,26,151,"Michigan","Sanilac County",1,49,514,262,252
050,26,151,"Michigan","Sanilac County",1,50,504,261,243
050,26,151,"Michigan","Sanilac County",1,51,502,249,253
050,26,151,"Michigan","Sanilac County",1,52,515,258,257
050,26,151,"Michigan","Sanilac County",1,53,550,266,284
050,26,151,"Michigan","Sanilac County",1,54,550,272,278
050,26,151,"Michigan","Sanilac County",1,55,592,292,300
050,26,151,"Michigan","Sanilac County",1,56,651,348,303
050,26,151,"Michigan","Sanilac County",1,57,636,352,284
050,26,151,"Michigan","Sanilac County",1,58,638,332,306
050,26,151,"Michigan","Sanilac County",1,59,665,334,331
050,26,151,"Michigan","Sanilac County",1,60,674,342,332
050,26,151,"Michigan","Sanilac County",1,61,680,340,340
050,26,151,"Michigan","Sanilac County",1,62,689,345,344
050,26,151,"Michigan","Sanilac County",1,63,672,332,340
050,26,151,"Michigan","Sanilac County",1,64,648,323,325
050,26,151,"Michigan","Sanilac County",1,65,641,321,320
050,26,151,"Michigan","Sanilac County",1,66,671,347,324
050,26,151,"Michigan","Sanilac County",1,67,589,300,289
050,26,151,"Michigan","Sanilac County",1,68,579,302,277
050,26,151,"Michigan","Sanilac County",1,69,557,287,270
050,26,151,"Michigan","Sanilac County",1,70,509,242,267
050,26,151,"Michigan","Sanilac County",1,71,505,243,262
050,26,151,"Michigan","Sanilac County",1,72,475,224,251
050,26,151,"Michigan","Sanilac County",1,73,475,227,248
050,26,151,"Michigan","Sanilac County",1,74,342,166,176
050,26,151,"Michigan","Sanilac County",1,75,354,172,182
050,26,151,"Michigan","Sanilac County",1,76,358,169,189
050,26,151,"Michigan","Sanilac County",1,77,356,171,185
050,26,151,"Michigan","Sanilac County",1,78,308,142,166
050,26,151,"Michigan","Sanilac County",1,79,290,136,154
050,26,151,"Michigan","Sanilac County",1,80,260,121,139
050,26,151,"Michigan","Sanilac County",1,81,230,103,127
050,26,151,"Michigan","Sanilac County",1,82,217,92,125
050,26,151,"Michigan","Sanilac County",1,83,190,90,100
050,26,151,"Michigan","Sanilac County",1,84,182,86,96
050,26,151,"Michigan","Sanilac County",1,85,882,351,531
050,26,151,"Michigan","Sanilac County",2,0,373,197,176
050,26,151,"Michigan","Sanilac County",2,1,382,210,172
050,26,151,"Michigan","Sanilac County",2,2,404,217,187
050,26,151,"Michigan","Sanilac County",2,3,419,213,206
050,26,151,"Michigan","Sanilac County",2,4,441,222,219
050,26,151,"Michigan","Sanilac County",2,5,438,232,206
050,26,151,"Michigan","Sanilac County",2,6,461,249,212
050,26,151,"Michigan","Sanilac County",2,7,465,234,231
050,26,151,"Michigan","Sanilac County",2,8,449,223,226
050,26,151,"Michigan","Sanilac County",2,9,473,246,227
050,26,151,"Michigan","Sanilac County",2,10,510,266,244
050,26,151,"Michigan","Sanilac County",2,11,523,257,266
050,26,151,"Michigan","Sanilac County",2,12,535,266,269
050,26,151,"Michigan","Sanilac County",2,13,540,269,271
050,26,151,"Michigan","Sanilac County",2,14,536,272,264
050,26,151,"Michigan","Sanilac County",2,15,558,283,275
050,26,151,"Michigan","Sanilac County",2,16,556,283,273
050,26,151,"Michigan","Sanilac County",2,17,552,277,275
050,26,151,"Michigan","Sanilac County",2,18,465,238,227
050,26,151,"Michigan","Sanilac County",2,19,357,188,169
050,26,151,"Michigan","Sanilac County",2,20,402,206,196
050,26,151,"Michigan","Sanilac County",2,21,402,201,201
050,26,151,"Michigan","Sanilac County",2,22,426,214,212
050,26,151,"Michigan","Sanilac County",2,23,432,222,210
050,26,151,"Michigan","Sanilac County",2,24,445,237,208
050,26,151,"Michigan","Sanilac County",2,25,429,234,195
050,26,151,"Michigan","Sanilac County",2,26,421,226,195
050,26,151,"Michigan","Sanilac County",2,27,431,224,207
050,26,151,"Michigan","Sanilac County",2,28,411,208,203
050,26,151,"Michigan","Sanilac County",2,29,420,211,209
050,26,151,"Michigan","Sanilac County",2,30,420,217,203
050,26,151,"Michigan","Sanilac County",2,31,420,222,198
050,26,151,"Michigan","Sanilac County",2,32,397,210,187
050,26,151,"Michigan","Sanilac County",2,33,400,206,194
050,26,151,"Michigan","Sanilac County",2,34,418,206,212
050,26,151,"Michigan","Sanilac County",2,35,409,209,200
050,26,151,"Michigan","Sanilac County",2,36,408,219,189
050,26,151,"Michigan","Sanilac County",2,37,445,234,211
050,26,151,"Michigan","Sanilac County",2,38,457,237,220
050,26,151,"Michigan","Sanilac County",2,39,431,218,213
050,26,151,"Michigan","Sanilac County",2,40,439,226,213
050,26,151,"Michigan","Sanilac County",2,41,450,238,212
050,26,151,"Michigan","Sanilac County",2,42,423,212,211
050,26,151,"Michigan","Sanilac County",2,43,431,215,216
050,26,151,"Michigan","Sanilac County",2,44,438,211,227
050,26,151,"Michigan","Sanilac County",2,45,451,226,225
050,26,151,"Michigan","Sanilac County",2,46,447,232,215
050,26,151,"Michigan","Sanilac County",2,47,427,211,216
050,26,151,"Michigan","Sanilac County",2,48,472,236,236
050,26,151,"Michigan","Sanilac County",2,49,510,260,250
050,26,151,"Michigan","Sanilac County",2,50,507,262,245
050,26,151,"Michigan","Sanilac County",2,51,500,252,248
050,26,151,"Michigan","Sanilac County",2,52,512,257,255
050,26,151,"Michigan","Sanilac County",2,53,543,266,277
050,26,151,"Michigan","Sanilac County",2,54,544,267,277
050,26,151,"Michigan","Sanilac County",2,55,583,288,295
050,26,151,"Michigan","Sanilac County",2,56,638,335,303
050,26,151,"Michigan","Sanilac County",2,57,639,349,290
050,26,151,"Michigan","Sanilac County",2,58,637,335,302
050,26,151,"Michigan","Sanilac County",2,59,662,335,327
050,26,151,"Michigan","Sanilac County",2,60,672,341,331
050,26,151,"Michigan","Sanilac County",2,61,677,339,338
050,26,151,"Michigan","Sanilac County",2,62,689,345,344
050,26,151,"Michigan","Sanilac County",2,63,681,338,343
050,26,151,"Michigan","Sanilac County",2,64,648,323,325
050,26,151,"Michigan","Sanilac County",2,65,640,318,322
050,26,151,"Michigan","Sanilac County",2,66,659,337,322
050,26,151,"Michigan","Sanilac County",2,67,604,309,295
050,26,151,"Michigan","Sanilac County",2,68,575,298,277
050,26,151,"Michigan","Sanilac County",2,69,563,291,272
050,26,151,"Michigan","Sanilac County",2,70,516,250,266
050,26,151,"Michigan","Sanilac County",2,71,504,241,263
050,26,151,"Michigan","Sanilac County",2,72,474,226,248
050,26,151,"Michigan","Sanilac County",2,73,497,238,259
050,26,151,"Michigan","Sanilac County",2,74,345,165,180
050,26,151,"Michigan","Sanilac County",2,75,350,169,181
050,26,151,"Michigan","Sanilac County",2,76,354,168,186
050,26,151,"Michigan","Sanilac County",2,77,360,172,188
050,26,151,"Michigan","Sanilac County",2,78,308,144,164
050,26,151,"Michigan","Sanilac County",2,79,293,138,155
050,26,151,"Michigan","Sanilac County",2,80,263,122,141
050,26,151,"Michigan","Sanilac County",2,81,230,105,125
050,26,151,"Michigan","Sanilac County",2,82,217,92,125
050,26,151,"Michigan","Sanilac County",2,83,193,89,104
050,26,151,"Michigan","Sanilac County",2,84,180,84,96
050,26,151,"Michigan","Sanilac County",2,85,893,357,536
050,26,151,"Michigan","Sanilac County",3,0,417,211,206
050,26,151,"Michigan","Sanilac County",3,1,394,210,184
050,26,151,"Michigan","Sanilac County",3,2,385,203,182
050,26,151,"Michigan","Sanilac County",3,3,418,223,195
050,26,151,"Michigan","Sanilac County",3,4,424,215,209
050,26,151,"Michigan","Sanilac County",3,5,437,223,214
050,26,151,"Michigan","Sanilac County",3,6,462,240,222
050,26,151,"Michigan","Sanilac County",3,7,476,253,223
050,26,151,"Michigan","Sanilac County",3,8,477,234,243
050,26,151,"Michigan","Sanilac County",3,9,452,230,222
050,26,151,"Michigan","Sanilac County",3,10,489,255,234
050,26,151,"Michigan","Sanilac County",3,11,521,272,249
050,26,151,"Michigan","Sanilac County",3,12,533,272,261
050,26,151,"Michigan","Sanilac County",3,13,549,285,264
050,26,151,"Michigan","Sanilac County",3,14,558,275,283
050,26,151,"Michigan","Sanilac County",3,15,530,269,261
050,26,151,"Michigan","Sanilac County",3,16,554,286,268
050,26,151,"Michigan","Sanilac County",3,17,565,289,276
050,26,151,"Michigan","Sanilac County",3,18,464,241,223
050,26,151,"Michigan","Sanilac County",3,19,361,185,176
050,26,151,"Michigan","Sanilac County",3,20,385,207,178
050,26,151,"Michigan","Sanilac County",3,21,418,209,209
050,26,151,"Michigan","Sanilac County",3,22,421,212,209
050,26,151,"Michigan","Sanilac County",3,23,442,233,209
050,26,151,"Michigan","Sanilac County",3,24,417,215,202
050,26,151,"Michigan","Sanilac County",3,25,425,226,199
050,26,151,"Michigan","Sanilac County",3,26,417,223,194
050,26,151,"Michigan","Sanilac County",3,27,416,220,196
050,26,151,"Michigan","Sanilac County",3,28,418,214,204
050,26,151,"Michigan","Sanilac County",3,29,412,206,206
050,26,151,"Michigan","Sanilac County",3,30,430,219,211
050,26,151,"Michigan","Sanilac County",3,31,426,220,206
050,26,151,"Michigan","Sanilac County",3,32,419,215,204
050,26,151,"Michigan","Sanilac County",3,33,401,213,188
050,26,151,"Michigan","Sanilac County",3,34,409,210,199
050,26,151,"Michigan","Sanilac County",3,35,418,208,210
050,26,151,"Michigan","Sanilac County",3,36,425,217,208
050,26,151,"Michigan","Sanilac County",3,37,413,220,193
050,26,151,"Michigan","Sanilac County",3,38,449,230,219
050,26,151,"Michigan","Sanilac County",3,39,462,236,226
050,26,151,"Michigan","Sanilac County",3,40,437,225,212
050,26,151,"Michigan","Sanilac County",3,41,442,226,216
050,26,151,"Michigan","Sanilac County",3,42,468,246,222
050,26,151,"Michigan","Sanilac County",3,43,432,219,213
050,26,151,"Michigan","Sanilac County",3,44,436,215,221
050,26,151,"Michigan","Sanilac County",3,45,431,209,222
050,26,151,"Michigan","Sanilac County",3,46,437,224,213
050,26,151,"Michigan","Sanilac County",3,47,447,230,217
050,26,151,"Michigan","Sanilac County",3,48,431,212,219
050,26,151,"Michigan","Sanilac County",3,49,474,239,235
050,26,151,"Michigan","Sanilac County",3,50,524,260,264
050,26,151,"Michigan","Sanilac County",3,51,519,267,252
050,26,151,"Michigan","Sanilac County",3,52,498,251,247
050,26,151,"Michigan","Sanilac County",3,53,521,266,255
050,26,151,"Michigan","Sanilac County",3,54,547,262,285
050,26,151,"Michigan","Sanilac County",3,55,551,270,281
050,26,151,"Michigan","Sanilac County",3,56,596,298,298
050,26,151,"Michigan","Sanilac County",3,57,636,331,305
050,26,151,"Michigan","Sanilac County",3,58,652,359,293
050,26,151,"Michigan","Sanilac County",3,59,640,342,298
050,26,151,"Michigan","Sanilac County",3,60,667,332,335
050,26,151,"Michigan","Sanilac County",3,61,679,343,336
050,26,151,"Michigan","Sanilac County",3,62,674,348,326
050,26,151,"Michigan","Sanilac County",3,63,690,340,350
050,26,151,"Michigan","Sanilac County",3,64,657,323,334
050,26,151,"Michigan","Sanilac County",3,65,641,322,319
050,26,151,"Michigan","Sanilac County",3,66,629,316,313
050,26,151,"Michigan","Sanilac County",3,67,657,337,320
050,26,151,"Michigan","Sanilac County",3,68,600,307,293
050,26,151,"Michigan","Sanilac County",3,69,553,280,273
050,26,151,"Michigan","Sanilac County",3,70,560,281,279
050,26,151,"Michigan","Sanilac County",3,71,500,241,259
050,26,151,"Michigan","Sanilac County",3,72,477,227,250
050,26,151,"Michigan","Sanilac County",3,73,456,212,244
050,26,151,"Michigan","Sanilac County",3,74,477,228,249
050,26,151,"Michigan","Sanilac County",3,75,341,163,178
050,26,151,"Michigan","Sanilac County",3,76,324,157,167
050,26,151,"Michigan","Sanilac County",3,77,336,159,177
050,26,151,"Michigan","Sanilac County",3,78,330,157,173
050,26,151,"Michigan","Sanilac County",3,79,293,135,158
050,26,151,"Michigan","Sanilac County",3,80,273,126,147
050,26,151,"Michigan","Sanilac County",3,81,237,109,128
050,26,151,"Michigan","Sanilac County",3,82,210,95,115
050,26,151,"Michigan","Sanilac County",3,83,197,84,113
050,26,151,"Michigan","Sanilac County",3,84,178,79,99
050,26,151,"Michigan","Sanilac County",3,85,884,361,523
050,26,151,"Michigan","Sanilac County",4,0,395,217,178
050,26,151,"Michigan","Sanilac County",4,1,427,216,211
050,26,151,"Michigan","Sanilac County",4,2,390,204,186
050,26,151,"Michigan","Sanilac County",4,3,395,211,184
050,26,151,"Michigan","Sanilac County",4,4,420,221,199
050,26,151,"Michigan","Sanilac County",4,5,430,223,207
050,26,151,"Michigan","Sanilac County",4,6,445,231,214
050,26,151,"Michigan","Sanilac County",4,7,468,246,222
050,26,151,"Michigan","Sanilac County",4,8,492,251,241
050,26,151,"Michigan","Sanilac County",4,9,480,240,240
050,26,151,"Michigan","Sanilac County",4,10,445,227,218
050,26,151,"Michigan","Sanilac County",4,11,498,258,240
050,26,151,"Michigan","Sanilac County",4,12,513,266,247
050,26,151,"Michigan","Sanilac County",4,13,535,274,261
050,26,151,"Michigan","Sanilac County",4,14,551,281,270
050,26,151,"Michigan","Sanilac County",4,15,553,271,282
050,26,151,"Michigan","Sanilac County",4,16,519,265,254
050,26,151,"Michigan","Sanilac County",4,17,567,287,280
050,26,151,"Michigan","Sanilac County",4,18,474,253,221
050,26,151,"Michigan","Sanilac County",4,19,344,178,166
050,26,151,"Michigan","Sanilac County",4,20,370,192,178
050,26,151,"Michigan","Sanilac County",4,21,397,207,190
050,26,151,"Michigan","Sanilac County",4,22,438,217,221
050,26,151,"Michigan","Sanilac County",4,23,444,219,225
050,26,151,"Michigan","Sanilac County",4,24,441,228,213
050,26,151,"Michigan","Sanilac County",4,25,422,214,208
050,26,151,"Michigan","Sanilac County",4,26,425,231,194
050,26,151,"Michigan","Sanilac County",4,27,441,233,208
050,26,151,"Michigan","Sanilac County",4,28,436,230,206
050,26,151,"Michigan","Sanilac County",4,29,429,219,210
050,26,151,"Michigan","Sanilac County",4,30,395,208,187
050,26,151,"Michigan","Sanilac County",4,31,429,215,214
050,26,151,"Michigan","Sanilac County",4,32,442,230,212
050,26,151,"Michigan","Sanilac County",4,33,427,220,207
050,26,151,"Michigan","Sanilac County",4,34,400,209,191
050,26,151,"Michigan","Sanilac County",4,35,407,208,199
050,26,151,"Michigan","Sanilac County",4,36,421,209,212
050,26,151,"Michigan","Sanilac County",4,37,431,219,212
050,26,151,"Michigan","Sanilac County",4,38,422,230,192
050,26,151,"Michigan","Sanilac County",4,39,451,235,216
050,26,151,"Michigan","Sanilac County",4,40,469,241,228
050,26,151,"Michigan","Sanilac County",4,41,427,220,207
050,26,151,"Michigan","Sanilac County",4,42,440,225,215
050,26,151,"Michigan","Sanilac County",4,43,455,240,215
050,26,151,"Michigan","Sanilac County",4,44,434,219,215
050,26,151,"Michigan","Sanilac County",4,45,445,223,222
050,26,151,"Michigan","Sanilac County",4,46,441,214,227
050,26,151,"Michigan","Sanilac County",4,47,444,225,219
050,26,151,"Michigan","Sanilac County",4,48,446,232,214
050,26,151,"Michigan","Sanilac County",4,49,417,207,210
050,26,151,"Michigan","Sanilac County",4,50,482,242,240
050,26,151,"Michigan","Sanilac County",4,51,524,259,265
050,26,151,"Michigan","Sanilac County",4,52,521,264,257
050,26,151,"Michigan","Sanilac County",4,53,492,245,247
050,26,151,"Michigan","Sanilac County",4,54,517,260,257
050,26,151,"Michigan","Sanilac County",4,55,552,265,287
050,26,151,"Michigan","Sanilac County",4,56,554,273,281
050,26,151,"Michigan","Sanilac County",4,57,595,293,302
050,26,151,"Michigan","Sanilac County",4,58,653,333,320
050,26,151,"Michigan","Sanilac County",4,59,648,354,294
050,26,151,"Michigan","Sanilac County",4,60,633,336,297
050,26,151,"Michigan","Sanilac County",4,61,672,342,330
050,26,151,"Michigan","Sanilac County",4,62,667,339,328
050,26,151,"Michigan","Sanilac County",4,63,674,345,329
050,26,151,"Michigan","Sanilac County",4,64,700,347,353
050,26,151,"Michigan","Sanilac County",4,65,643,313,330
050,26,151,"Michigan","Sanilac County",4,66,651,325,326
050,26,151,"Michigan","Sanilac County",4,67,626,319,307
050,26,151,"Michigan","Sanilac County",4,68,641,324,317
050,26,151,"Michigan","Sanilac County",4,69,593,300,293
050,26,151,"Michigan","Sanilac County",4,70,538,267,271
050,26,151,"Michigan","Sanilac County",4,71,542,274,268
050,26,151,"Michigan","Sanilac County",4,72,499,241,258
050,26,151,"Michigan","Sanilac County",4,73,459,217,242
050,26,151,"Michigan","Sanilac County",4,74,446,210,236
050,26,151,"Michigan","Sanilac County",4,75,473,226,247
050,26,151,"Michigan","Sanilac County",4,76,331,160,171
050,26,151,"Michigan","Sanilac County",4,77,300,140,160
050,26,151,"Michigan","Sanilac County",4,78,317,150,167
050,26,151,"Michigan","Sanilac County",4,79,309,141,168
050,26,151,"Michigan","Sanilac County",4,80,276,124,152
050,26,151,"Michigan","Sanilac County",4,81,253,118,135
050,26,151,"Michigan","Sanilac County",4,82,221,99,122
050,26,151,"Michigan","Sanilac County",4,83,184,85,99
050,26,151,"Michigan","Sanilac County",4,84,183,76,107
050,26,151,"Michigan","Sanilac County",4,85,886,376,510
050,26,151,"Michigan","Sanilac County",5,0,395,217,178
050,26,151,"Michigan","Sanilac County",5,1,405,226,179
050,26,151,"Michigan","Sanilac County",5,2,416,214,202
050,26,151,"Michigan","Sanilac County",5,3,401,205,196
050,26,151,"Michigan","Sanilac County",5,4,395,212,183
050,26,151,"Michigan","Sanilac County",5,5,418,217,201
050,26,151,"Michigan","Sanilac County",5,6,422,223,199
050,26,151,"Michigan","Sanilac County",5,7,456,236,220
050,26,151,"Michigan","Sanilac County",5,8,473,247,226
050,26,151,"Michigan","Sanilac County",5,9,493,252,241
050,26,151,"Michigan","Sanilac County",5,10,470,236,234
050,26,151,"Michigan","Sanilac County",5,11,460,232,228
050,26,151,"Michigan","Sanilac County",5,12,487,252,235
050,26,151,"Michigan","Sanilac County",5,13,510,272,238
050,26,151,"Michigan","Sanilac County",5,14,537,276,261
050,26,151,"Michigan","Sanilac County",5,15,549,286,263
050,26,151,"Michigan","Sanilac County",5,16,559,278,281
050,26,151,"Michigan","Sanilac County",5,17,518,265,253
050,26,151,"Michigan","Sanilac County",5,18,481,250,231
050,26,151,"Michigan","Sanilac County",5,19,363,191,172
050,26,151,"Michigan","Sanilac County",5,20,370,189,181
050,26,151,"Michigan","Sanilac County",5,21,394,196,198
050,26,151,"Michigan","Sanilac County",5,22,422,218,204
050,26,151,"Michigan","Sanilac County",5,23,464,233,231
050,26,151,"Michigan","Sanilac County",5,24,428,211,217
050,26,151,"Michigan","Sanilac County",5,25,434,226,208
050,26,151,"Michigan","Sanilac County",5,26,411,208,203
050,26,151,"Michigan","Sanilac County",5,27,428,225,203
050,26,151,"Michigan","Sanilac County",5,28,438,230,208
050,26,151,"Michigan","Sanilac County",5,29,435,228,207
050,26,151,"Michigan","Sanilac County",5,30,435,219,216
050,26,151,"Michigan","Sanilac County",5,31,407,218,189
050,26,151,"Michigan","Sanilac County",5,32,424,208,216
050,26,151,"Michigan","Sanilac County",5,33,453,246,207
050,26,151,"Michigan","Sanilac County",5,34,427,216,211
050,26,151,"Michigan","Sanilac County",5,35,405,208,197
050,26,151,"Michigan","Sanilac County",5,36,414,212,202
050,26,151,"Michigan","Sanilac County",5,37,426,212,214
050,26,151,"Michigan","Sanilac County",5,38,440,226,214
050,26,151,"Michigan","Sanilac County",5,39,415,224,191
050,26,151,"Michigan","Sanilac County",5,40,456,241,215
050,26,151,"Michigan","Sanilac County",5,41,457,231,226
050,26,151,"Michigan","Sanilac County",5,42,431,220,211
050,26,151,"Michigan","Sanilac County",5,43,441,231,210
050,26,151,"Michigan","Sanilac County",5,44,459,241,218
050,26,151,"Michigan","Sanilac County",5,45,435,221,214
050,26,151,"Michigan","Sanilac County",5,46,445,227,218
050,26,151,"Michigan","Sanilac County",5,47,440,215,225
050,26,151,"Michigan","Sanilac County",5,48,446,225,221
050,26,151,"Michigan","Sanilac County",5,49,444,230,214
050,26,151,"Michigan","Sanilac County",5,50,418,207,211
050,26,151,"Michigan","Sanilac County",5,51,490,248,242
050,26,151,"Michigan","Sanilac County",5,52,528,259,269
050,26,151,"Michigan","Sanilac County",5,53,520,263,257
050,26,151,"Michigan","Sanilac County",5,54,493,246,247
050,26,151,"Michigan","Sanilac County",5,55,525,260,265
050,26,151,"Michigan","Sanilac County",5,56,554,269,285
050,26,151,"Michigan","Sanilac County",5,57,553,275,278
050,26,151,"Michigan","Sanilac County",5,58,605,296,309
050,26,151,"Michigan","Sanilac County",5,59,642,330,312
050,26,151,"Michigan","Sanilac County",5,60,637,346,291
050,26,151,"Michigan","Sanilac County",5,61,639,341,298
050,26,151,"Michigan","Sanilac County",5,62,683,346,337
050,26,151,"Michigan","Sanilac County",5,63,673,342,331
050,26,151,"Michigan","Sanilac County",5,64,671,346,325
050,26,151,"Michigan","Sanilac County",5,65,702,344,358
050,26,151,"Michigan","Sanilac County",5,66,648,315,333
050,26,151,"Michigan","Sanilac County",5,67,632,313,319
050,26,151,"Michigan","Sanilac County",5,68,616,306,310
050,26,151,"Michigan","Sanilac County",5,69,629,320,309
050,26,151,"Michigan","Sanilac County",5,70,574,285,289
050,26,151,"Michigan","Sanilac County",5,71,517,256,261
050,26,151,"Michigan","Sanilac County",5,72,525,262,263
050,26,151,"Michigan","Sanilac County",5,73,478,236,242
050,26,151,"Michigan","Sanilac County",5,74,442,210,232
050,26,151,"Michigan","Sanilac County",5,75,431,202,229
050,26,151,"Michigan","Sanilac County",5,76,455,218,237
050,26,151,"Michigan","Sanilac County",5,77,308,146,162
050,26,151,"Michigan","Sanilac County",5,78,281,132,149
050,26,151,"Michigan","Sanilac County",5,79,307,139,168
050,26,151,"Michigan","Sanilac County",5,80,284,129,155
050,26,151,"Michigan","Sanilac County",5,81,252,112,140
050,26,151,"Michigan","Sanilac County",5,82,238,107,131
050,26,151,"Michigan","Sanilac County",5,83,199,92,107
050,26,151,"Michigan","Sanilac County",5,84,170,76,94
050,26,151,"Michigan","Sanilac County",5,85,917,397,520
050,26,153,"Michigan","Schoolcraft County",1,0,69,35,34
050,26,153,"Michigan","Schoolcraft County",1,1,74,36,38
050,26,153,"Michigan","Schoolcraft County",1,2,70,33,37
050,26,153,"Michigan","Schoolcraft County",1,3,86,41,45
050,26,153,"Michigan","Schoolcraft County",1,4,62,35,27
050,26,153,"Michigan","Schoolcraft County",1,5,64,34,30
050,26,153,"Michigan","Schoolcraft County",1,6,72,36,36
050,26,153,"Michigan","Schoolcraft County",1,7,83,37,46
050,26,153,"Michigan","Schoolcraft County",1,8,90,45,45
050,26,153,"Michigan","Schoolcraft County",1,9,77,33,44
050,26,153,"Michigan","Schoolcraft County",1,10,78,37,41
050,26,153,"Michigan","Schoolcraft County",1,11,82,43,39
050,26,153,"Michigan","Schoolcraft County",1,12,87,45,42
050,26,153,"Michigan","Schoolcraft County",1,13,83,43,40
050,26,153,"Michigan","Schoolcraft County",1,14,90,51,39
050,26,153,"Michigan","Schoolcraft County",1,15,85,45,40
050,26,153,"Michigan","Schoolcraft County",1,16,86,48,38
050,26,153,"Michigan","Schoolcraft County",1,17,80,41,39
050,26,153,"Michigan","Schoolcraft County",1,18,80,46,34
050,26,153,"Michigan","Schoolcraft County",1,19,60,31,29
050,26,153,"Michigan","Schoolcraft County",1,20,65,33,32
050,26,153,"Michigan","Schoolcraft County",1,21,70,35,35
050,26,153,"Michigan","Schoolcraft County",1,22,72,37,35
050,26,153,"Michigan","Schoolcraft County",1,23,74,36,38
050,26,153,"Michigan","Schoolcraft County",1,24,70,36,34
050,26,153,"Michigan","Schoolcraft County",1,25,78,41,37
050,26,153,"Michigan","Schoolcraft County",1,26,76,42,34
050,26,153,"Michigan","Schoolcraft County",1,27,72,37,35
050,26,153,"Michigan","Schoolcraft County",1,28,61,31,30
050,26,153,"Michigan","Schoolcraft County",1,29,62,31,31
050,26,153,"Michigan","Schoolcraft County",1,30,66,34,32
050,26,153,"Michigan","Schoolcraft County",1,31,66,38,28
050,26,153,"Michigan","Schoolcraft County",1,32,67,39,28
050,26,153,"Michigan","Schoolcraft County",1,33,68,36,32
050,26,153,"Michigan","Schoolcraft County",1,34,59,25,34
050,26,153,"Michigan","Schoolcraft County",1,35,70,33,37
050,26,153,"Michigan","Schoolcraft County",1,36,68,34,34
050,26,153,"Michigan","Schoolcraft County",1,37,71,40,31
050,26,153,"Michigan","Schoolcraft County",1,38,81,39,42
050,26,153,"Michigan","Schoolcraft County",1,39,75,36,39
050,26,153,"Michigan","Schoolcraft County",1,40,80,39,41
050,26,153,"Michigan","Schoolcraft County",1,41,72,36,36
050,26,153,"Michigan","Schoolcraft County",1,42,77,41,36
050,26,153,"Michigan","Schoolcraft County",1,43,77,37,40
050,26,153,"Michigan","Schoolcraft County",1,44,73,37,36
050,26,153,"Michigan","Schoolcraft County",1,45,78,42,36
050,26,153,"Michigan","Schoolcraft County",1,46,86,40,46
050,26,153,"Michigan","Schoolcraft County",1,47,94,42,52
050,26,153,"Michigan","Schoolcraft County",1,48,91,45,46
050,26,153,"Michigan","Schoolcraft County",1,49,113,59,54
050,26,153,"Michigan","Schoolcraft County",1,50,108,53,55
050,26,153,"Michigan","Schoolcraft County",1,51,111,56,55
050,26,153,"Michigan","Schoolcraft County",1,52,104,61,43
050,26,153,"Michigan","Schoolcraft County",1,53,105,59,46
050,26,153,"Michigan","Schoolcraft County",1,54,107,48,59
050,26,153,"Michigan","Schoolcraft County",1,55,102,54,48
050,26,153,"Michigan","Schoolcraft County",1,56,126,62,64
050,26,153,"Michigan","Schoolcraft County",1,57,141,66,75
050,26,153,"Michigan","Schoolcraft County",1,58,166,70,96
050,26,153,"Michigan","Schoolcraft County",1,59,176,83,93
050,26,153,"Michigan","Schoolcraft County",1,60,164,78,86
050,26,153,"Michigan","Schoolcraft County",1,61,167,76,91
050,26,153,"Michigan","Schoolcraft County",1,62,165,81,84
050,26,153,"Michigan","Schoolcraft County",1,63,163,86,77
050,26,153,"Michigan","Schoolcraft County",1,64,168,81,87
050,26,153,"Michigan","Schoolcraft County",1,65,177,87,90
050,26,153,"Michigan","Schoolcraft County",1,66,166,86,80
050,26,153,"Michigan","Schoolcraft County",1,67,144,82,62
050,26,153,"Michigan","Schoolcraft County",1,68,159,88,71
050,26,153,"Michigan","Schoolcraft County",1,69,134,68,66
050,26,153,"Michigan","Schoolcraft County",1,70,130,68,62
050,26,153,"Michigan","Schoolcraft County",1,71,125,65,60
050,26,153,"Michigan","Schoolcraft County",1,72,126,65,61
050,26,153,"Michigan","Schoolcraft County",1,73,117,65,52
050,26,153,"Michigan","Schoolcraft County",1,74,83,44,39
050,26,153,"Michigan","Schoolcraft County",1,75,84,34,50
050,26,153,"Michigan","Schoolcraft County",1,76,67,31,36
050,26,153,"Michigan","Schoolcraft County",1,77,77,40,37
050,26,153,"Michigan","Schoolcraft County",1,78,69,39,30
050,26,153,"Michigan","Schoolcraft County",1,79,63,36,27
050,26,153,"Michigan","Schoolcraft County",1,80,61,28,33
050,26,153,"Michigan","Schoolcraft County",1,81,48,22,26
050,26,153,"Michigan","Schoolcraft County",1,82,50,20,30
050,26,153,"Michigan","Schoolcraft County",1,83,52,22,30
050,26,153,"Michigan","Schoolcraft County",1,84,46,18,28
050,26,153,"Michigan","Schoolcraft County",1,85,209,81,128
050,26,153,"Michigan","Schoolcraft County",2,0,72,35,37
050,26,153,"Michigan","Schoolcraft County",2,1,71,35,36
050,26,153,"Michigan","Schoolcraft County",2,2,72,36,36
050,26,153,"Michigan","Schoolcraft County",2,3,83,40,43
050,26,153,"Michigan","Schoolcraft County",2,4,67,36,31
050,26,153,"Michigan","Schoolcraft County",2,5,65,35,30
050,26,153,"Michigan","Schoolcraft County",2,6,72,36,36
050,26,153,"Michigan","Schoolcraft County",2,7,83,39,44
050,26,153,"Michigan","Schoolcraft County",2,8,88,43,45
050,26,153,"Michigan","Schoolcraft County",2,9,80,36,44
050,26,153,"Michigan","Schoolcraft County",2,10,78,36,42
050,26,153,"Michigan","Schoolcraft County",2,11,81,41,40
050,26,153,"Michigan","Schoolcraft County",2,12,86,45,41
050,26,153,"Michigan","Schoolcraft County",2,13,85,45,40
050,26,153,"Michigan","Schoolcraft County",2,14,88,49,39
050,26,153,"Michigan","Schoolcraft County",2,15,85,46,39
050,26,153,"Michigan","Schoolcraft County",2,16,87,48,39
050,26,153,"Michigan","Schoolcraft County",2,17,82,44,38
050,26,153,"Michigan","Schoolcraft County",2,18,76,42,34
050,26,153,"Michigan","Schoolcraft County",2,19,63,34,29
050,26,153,"Michigan","Schoolcraft County",2,20,65,33,32
050,26,153,"Michigan","Schoolcraft County",2,21,70,34,36
050,26,153,"Michigan","Schoolcraft County",2,22,72,37,35
050,26,153,"Michigan","Schoolcraft County",2,23,75,37,38
050,26,153,"Michigan","Schoolcraft County",2,24,70,36,34
050,26,153,"Michigan","Schoolcraft County",2,25,77,40,37
050,26,153,"Michigan","Schoolcraft County",2,26,76,42,34
050,26,153,"Michigan","Schoolcraft County",2,27,71,37,34
050,26,153,"Michigan","Schoolcraft County",2,28,62,31,31
050,26,153,"Michigan","Schoolcraft County",2,29,62,32,30
050,26,153,"Michigan","Schoolcraft County",2,30,65,34,31
050,26,153,"Michigan","Schoolcraft County",2,31,67,38,29
050,26,153,"Michigan","Schoolcraft County",2,32,67,39,28
050,26,153,"Michigan","Schoolcraft County",2,33,69,38,31
050,26,153,"Michigan","Schoolcraft County",2,34,60,27,33
050,26,153,"Michigan","Schoolcraft County",2,35,68,32,36
050,26,153,"Michigan","Schoolcraft County",2,36,68,34,34
050,26,153,"Michigan","Schoolcraft County",2,37,72,40,32
050,26,153,"Michigan","Schoolcraft County",2,38,80,39,41
050,26,153,"Michigan","Schoolcraft County",2,39,75,37,38
050,26,153,"Michigan","Schoolcraft County",2,40,80,39,41
050,26,153,"Michigan","Schoolcraft County",2,41,73,36,37
050,26,153,"Michigan","Schoolcraft County",2,42,77,40,37
050,26,153,"Michigan","Schoolcraft County",2,43,78,39,39
050,26,153,"Michigan","Schoolcraft County",2,44,71,35,36
050,26,153,"Michigan","Schoolcraft County",2,45,76,41,35
050,26,153,"Michigan","Schoolcraft County",2,46,84,41,43
050,26,153,"Michigan","Schoolcraft County",2,47,92,41,51
050,26,153,"Michigan","Schoolcraft County",2,48,92,44,48
050,26,153,"Michigan","Schoolcraft County",2,49,107,55,52
050,26,153,"Michigan","Schoolcraft County",2,50,111,55,56
050,26,153,"Michigan","Schoolcraft County",2,51,110,56,54
050,26,153,"Michigan","Schoolcraft County",2,52,104,60,44
050,26,153,"Michigan","Schoolcraft County",2,53,105,58,47
050,26,153,"Michigan","Schoolcraft County",2,54,108,52,56
050,26,153,"Michigan","Schoolcraft County",2,55,104,52,52
050,26,153,"Michigan","Schoolcraft County",2,56,124,62,62
050,26,153,"Michigan","Schoolcraft County",2,57,139,65,74
050,26,153,"Michigan","Schoolcraft County",2,58,163,70,93
050,26,153,"Michigan","Schoolcraft County",2,59,176,81,95
050,26,153,"Michigan","Schoolcraft County",2,60,165,78,87
050,26,153,"Michigan","Schoolcraft County",2,61,167,77,90
050,26,153,"Michigan","Schoolcraft County",2,62,166,80,86
050,26,153,"Michigan","Schoolcraft County",2,63,167,86,81
050,26,153,"Michigan","Schoolcraft County",2,64,167,83,84
050,26,153,"Michigan","Schoolcraft County",2,65,172,85,87
050,26,153,"Michigan","Schoolcraft County",2,66,168,85,83
050,26,153,"Michigan","Schoolcraft County",2,67,151,84,67
050,26,153,"Michigan","Schoolcraft County",2,68,154,87,67
050,26,153,"Michigan","Schoolcraft County",2,69,138,71,67
050,26,153,"Michigan","Schoolcraft County",2,70,131,68,63
050,26,153,"Michigan","Schoolcraft County",2,71,123,64,59
050,26,153,"Michigan","Schoolcraft County",2,72,124,65,59
050,26,153,"Michigan","Schoolcraft County",2,73,126,69,57
050,26,153,"Michigan","Schoolcraft County",2,74,85,45,40
050,26,153,"Michigan","Schoolcraft County",2,75,85,37,48
050,26,153,"Michigan","Schoolcraft County",2,76,68,31,37
050,26,153,"Michigan","Schoolcraft County",2,77,75,37,38
050,26,153,"Michigan","Schoolcraft County",2,78,68,37,31
050,26,153,"Michigan","Schoolcraft County",2,79,62,35,27
050,26,153,"Michigan","Schoolcraft County",2,80,60,30,30
050,26,153,"Michigan","Schoolcraft County",2,81,48,21,27
050,26,153,"Michigan","Schoolcraft County",2,82,50,21,29
050,26,153,"Michigan","Schoolcraft County",2,83,52,22,30
050,26,153,"Michigan","Schoolcraft County",2,84,46,19,27
050,26,153,"Michigan","Schoolcraft County",2,85,210,83,127
050,26,153,"Michigan","Schoolcraft County",3,0,63,30,33
050,26,153,"Michigan","Schoolcraft County",3,1,79,37,42
050,26,153,"Michigan","Schoolcraft County",3,2,74,37,37
050,26,153,"Michigan","Schoolcraft County",3,3,68,37,31
050,26,153,"Michigan","Schoolcraft County",3,4,88,41,47
050,26,153,"Michigan","Schoolcraft County",3,5,66,39,27
050,26,153,"Michigan","Schoolcraft County",3,6,62,31,31
050,26,153,"Michigan","Schoolcraft County",3,7,69,34,35
050,26,153,"Michigan","Schoolcraft County",3,8,81,39,42
050,26,153,"Michigan","Schoolcraft County",3,9,86,43,43
050,26,153,"Michigan","Schoolcraft County",3,10,80,37,43
050,26,153,"Michigan","Schoolcraft County",3,11,83,34,49
050,26,153,"Michigan","Schoolcraft County",3,12,87,46,41
050,26,153,"Michigan","Schoolcraft County",3,13,92,50,42
050,26,153,"Michigan","Schoolcraft County",3,14,83,42,41
050,26,153,"Michigan","Schoolcraft County",3,15,93,53,40
050,26,153,"Michigan","Schoolcraft County",3,16,82,49,33
050,26,153,"Michigan","Schoolcraft County",3,17,85,46,39
050,26,153,"Michigan","Schoolcraft County",3,18,73,39,34
050,26,153,"Michigan","Schoolcraft County",3,19,54,32,22
050,26,153,"Michigan","Schoolcraft County",3,20,65,35,30
050,26,153,"Michigan","Schoolcraft County",3,21,60,27,33
050,26,153,"Michigan","Schoolcraft County",3,22,71,36,35
050,26,153,"Michigan","Schoolcraft County",3,23,82,39,43
050,26,153,"Michigan","Schoolcraft County",3,24,65,30,35
050,26,153,"Michigan","Schoolcraft County",3,25,79,46,33
050,26,153,"Michigan","Schoolcraft County",3,26,72,35,37
050,26,153,"Michigan","Schoolcraft County",3,27,81,47,34
050,26,153,"Michigan","Schoolcraft County",3,28,75,41,34
050,26,153,"Michigan","Schoolcraft County",3,29,63,31,32
050,26,153,"Michigan","Schoolcraft County",3,30,52,28,24
050,26,153,"Michigan","Schoolcraft County",3,31,65,32,33
050,26,153,"Michigan","Schoolcraft County",3,32,72,41,31
050,26,153,"Michigan","Schoolcraft County",3,33,66,37,29
050,26,153,"Michigan","Schoolcraft County",3,34,68,36,32
050,26,153,"Michigan","Schoolcraft County",3,35,63,27,36
050,26,153,"Michigan","Schoolcraft County",3,36,73,34,39
050,26,153,"Michigan","Schoolcraft County",3,37,69,37,32
050,26,153,"Michigan","Schoolcraft County",3,38,81,42,39
050,26,153,"Michigan","Schoolcraft County",3,39,81,43,38
050,26,153,"Michigan","Schoolcraft County",3,40,79,39,40
050,26,153,"Michigan","Schoolcraft County",3,41,78,36,42
050,26,153,"Michigan","Schoolcraft County",3,42,78,39,39
050,26,153,"Michigan","Schoolcraft County",3,43,83,47,36
050,26,153,"Michigan","Schoolcraft County",3,44,72,34,38
050,26,153,"Michigan","Schoolcraft County",3,45,70,31,39
050,26,153,"Michigan","Schoolcraft County",3,46,81,44,37
050,26,153,"Michigan","Schoolcraft County",3,47,81,38,43
050,26,153,"Michigan","Schoolcraft County",3,48,93,41,52
050,26,153,"Michigan","Schoolcraft County",3,49,90,43,47
050,26,153,"Michigan","Schoolcraft County",3,50,108,54,54
050,26,153,"Michigan","Schoolcraft County",3,51,111,54,57
050,26,153,"Michigan","Schoolcraft County",3,52,109,57,52
050,26,153,"Michigan","Schoolcraft County",3,53,99,54,45
050,26,153,"Michigan","Schoolcraft County",3,54,104,57,47
050,26,153,"Michigan","Schoolcraft County",3,55,117,58,59
050,26,153,"Michigan","Schoolcraft County",3,56,99,49,50
050,26,153,"Michigan","Schoolcraft County",3,57,130,68,62
050,26,153,"Michigan","Schoolcraft County",3,58,146,70,76
050,26,153,"Michigan","Schoolcraft County",3,59,163,76,87
050,26,153,"Michigan","Schoolcraft County",3,60,177,78,99
050,26,153,"Michigan","Schoolcraft County",3,61,168,78,90
050,26,153,"Michigan","Schoolcraft County",3,62,167,80,87
050,26,153,"Michigan","Schoolcraft County",3,63,168,83,85
050,26,153,"Michigan","Schoolcraft County",3,64,173,91,82
050,26,153,"Michigan","Schoolcraft County",3,65,163,80,83
050,26,153,"Michigan","Schoolcraft County",3,66,167,81,86
050,26,153,"Michigan","Schoolcraft County",3,67,165,87,78
050,26,153,"Michigan","Schoolcraft County",3,68,157,86,71
050,26,153,"Michigan","Schoolcraft County",3,69,152,82,70
050,26,153,"Michigan","Schoolcraft County",3,70,142,75,67
050,26,153,"Michigan","Schoolcraft County",3,71,128,62,66
050,26,153,"Michigan","Schoolcraft County",3,72,118,65,53
050,26,153,"Michigan","Schoolcraft County",3,73,120,62,58
050,26,153,"Michigan","Schoolcraft County",3,74,120,64,56
050,26,153,"Michigan","Schoolcraft County",3,75,83,40,43
050,26,153,"Michigan","Schoolcraft County",3,76,76,36,40
050,26,153,"Michigan","Schoolcraft County",3,77,64,31,33
050,26,153,"Michigan","Schoolcraft County",3,78,74,35,39
050,26,153,"Michigan","Schoolcraft County",3,79,66,34,32
050,26,153,"Michigan","Schoolcraft County",3,80,61,36,25
050,26,153,"Michigan","Schoolcraft County",3,81,51,27,24
050,26,153,"Michigan","Schoolcraft County",3,82,48,19,29
050,26,153,"Michigan","Schoolcraft County",3,83,44,20,24
050,26,153,"Michigan","Schoolcraft County",3,84,47,19,28
050,26,153,"Michigan","Schoolcraft County",3,85,207,83,124
050,26,153,"Michigan","Schoolcraft County",4,0,61,28,33
050,26,153,"Michigan","Schoolcraft County",4,1,67,35,32
050,26,153,"Michigan","Schoolcraft County",4,2,81,39,42
050,26,153,"Michigan","Schoolcraft County",4,3,83,41,42
050,26,153,"Michigan","Schoolcraft County",4,4,76,41,35
050,26,153,"Michigan","Schoolcraft County",4,5,88,42,46
050,26,153,"Michigan","Schoolcraft County",4,6,73,45,28
050,26,153,"Michigan","Schoolcraft County",4,7,65,32,33
050,26,153,"Michigan","Schoolcraft County",4,8,75,41,34
050,26,153,"Michigan","Schoolcraft County",4,9,82,41,41
050,26,153,"Michigan","Schoolcraft County",4,10,92,43,49
050,26,153,"Michigan","Schoolcraft County",4,11,83,39,44
050,26,153,"Michigan","Schoolcraft County",4,12,84,37,47
050,26,153,"Michigan","Schoolcraft County",4,13,93,48,45
050,26,153,"Michigan","Schoolcraft County",4,14,99,53,46
050,26,153,"Michigan","Schoolcraft County",4,15,90,46,44
050,26,153,"Michigan","Schoolcraft County",4,16,92,55,37
050,26,153,"Michigan","Schoolcraft County",4,17,86,52,34
050,26,153,"Michigan","Schoolcraft County",4,18,81,46,35
050,26,153,"Michigan","Schoolcraft County",4,19,52,28,24
050,26,153,"Michigan","Schoolcraft County",4,20,54,33,21
050,26,153,"Michigan","Schoolcraft County",4,21,66,34,32
050,26,153,"Michigan","Schoolcraft County",4,22,66,31,35
050,26,153,"Michigan","Schoolcraft County",4,23,76,38,38
050,26,153,"Michigan","Schoolcraft County",4,24,75,38,37
050,26,153,"Michigan","Schoolcraft County",4,25,68,31,37
050,26,153,"Michigan","Schoolcraft County",4,26,76,45,31
050,26,153,"Michigan","Schoolcraft County",4,27,77,39,38
050,26,153,"Michigan","Schoolcraft County",4,28,92,49,43
050,26,153,"Michigan","Schoolcraft County",4,29,81,44,37
050,26,153,"Michigan","Schoolcraft County",4,30,64,31,33
050,26,153,"Michigan","Schoolcraft County",4,31,53,27,26
050,26,153,"Michigan","Schoolcraft County",4,32,63,33,30
050,26,153,"Michigan","Schoolcraft County",4,33,74,43,31
050,26,153,"Michigan","Schoolcraft County",4,34,72,39,33
050,26,153,"Michigan","Schoolcraft County",4,35,70,37,33
050,26,153,"Michigan","Schoolcraft County",4,36,65,29,36
050,26,153,"Michigan","Schoolcraft County",4,37,75,34,41
050,26,153,"Michigan","Schoolcraft County",4,38,73,38,35
050,26,153,"Michigan","Schoolcraft County",4,39,81,46,35
050,26,153,"Michigan","Schoolcraft County",4,40,89,47,42
050,26,153,"Michigan","Schoolcraft County",4,41,74,35,39
050,26,153,"Michigan","Schoolcraft County",4,42,80,37,43
050,26,153,"Michigan","Schoolcraft County",4,43,85,44,41
050,26,153,"Michigan","Schoolcraft County",4,44,85,43,42
050,26,153,"Michigan","Schoolcraft County",4,45,73,35,38
050,26,153,"Michigan","Schoolcraft County",4,46,66,29,37
050,26,153,"Michigan","Schoolcraft County",4,47,82,43,39
050,26,153,"Michigan","Schoolcraft County",4,48,86,38,48
050,26,153,"Michigan","Schoolcraft County",4,49,99,45,54
050,26,153,"Michigan","Schoolcraft County",4,50,97,48,49
050,26,153,"Michigan","Schoolcraft County",4,51,106,51,55
050,26,153,"Michigan","Schoolcraft County",4,52,118,62,56
050,26,153,"Michigan","Schoolcraft County",4,53,115,58,57
050,26,153,"Michigan","Schoolcraft County",4,54,106,57,49
050,26,153,"Michigan","Schoolcraft County",4,55,109,60,49
050,26,153,"Michigan","Schoolcraft County",4,56,127,62,65
050,26,153,"Michigan","Schoolcraft County",4,57,101,53,48
050,26,153,"Michigan","Schoolcraft County",4,58,134,68,66
050,26,153,"Michigan","Schoolcraft County",4,59,148,71,77
050,26,153,"Michigan","Schoolcraft County",4,60,162,74,88
050,26,153,"Michigan","Schoolcraft County",4,61,181,81,100
050,26,153,"Michigan","Schoolcraft County",4,62,163,78,85
050,26,153,"Michigan","Schoolcraft County",4,63,163,78,85
050,26,153,"Michigan","Schoolcraft County",4,64,174,89,85
050,26,153,"Michigan","Schoolcraft County",4,65,171,88,83
050,26,153,"Michigan","Schoolcraft County",4,66,159,80,79
050,26,153,"Michigan","Schoolcraft County",4,67,170,83,87
050,26,153,"Michigan","Schoolcraft County",4,68,166,86,80
050,26,153,"Michigan","Schoolcraft County",4,69,152,83,69
050,26,153,"Michigan","Schoolcraft County",4,70,158,87,71
050,26,153,"Michigan","Schoolcraft County",4,71,139,67,72
050,26,153,"Michigan","Schoolcraft County",4,72,127,63,64
050,26,153,"Michigan","Schoolcraft County",4,73,124,68,56
050,26,153,"Michigan","Schoolcraft County",4,74,112,53,59
050,26,153,"Michigan","Schoolcraft County",4,75,121,62,59
050,26,153,"Michigan","Schoolcraft County",4,76,74,37,37
050,26,153,"Michigan","Schoolcraft County",4,77,71,34,37
050,26,153,"Michigan","Schoolcraft County",4,78,62,29,33
050,26,153,"Michigan","Schoolcraft County",4,79,71,33,38
050,26,153,"Michigan","Schoolcraft County",4,80,60,32,28
050,26,153,"Michigan","Schoolcraft County",4,81,51,30,21
050,26,153,"Michigan","Schoolcraft County",4,82,47,24,23
050,26,153,"Michigan","Schoolcraft County",4,83,42,16,26
050,26,153,"Michigan","Schoolcraft County",4,84,40,17,23
050,26,153,"Michigan","Schoolcraft County",4,85,210,82,128
050,26,153,"Michigan","Schoolcraft County",5,0,59,28,31
050,26,153,"Michigan","Schoolcraft County",5,1,64,30,34
050,26,153,"Michigan","Schoolcraft County",5,2,71,38,33
050,26,153,"Michigan","Schoolcraft County",5,3,82,41,41
050,26,153,"Michigan","Schoolcraft County",5,4,81,41,40
050,26,153,"Michigan","Schoolcraft County",5,5,78,41,37
050,26,153,"Michigan","Schoolcraft County",5,6,90,43,47
050,26,153,"Michigan","Schoolcraft County",5,7,73,44,29
050,26,153,"Michigan","Schoolcraft County",5,8,68,34,34
050,26,153,"Michigan","Schoolcraft County",5,9,74,41,33
050,26,153,"Michigan","Schoolcraft County",5,10,81,42,39
050,26,153,"Michigan","Schoolcraft County",5,11,94,43,51
050,26,153,"Michigan","Schoolcraft County",5,12,85,42,43
050,26,153,"Michigan","Schoolcraft County",5,13,87,40,47
050,26,153,"Michigan","Schoolcraft County",5,14,89,48,41
050,26,153,"Michigan","Schoolcraft County",5,15,102,57,45
050,26,153,"Michigan","Schoolcraft County",5,16,92,46,46
050,26,153,"Michigan","Schoolcraft County",5,17,95,53,42
050,26,153,"Michigan","Schoolcraft County",5,18,75,47,28
050,26,153,"Michigan","Schoolcraft County",5,19,62,33,29
050,26,153,"Michigan","Schoolcraft County",5,20,56,31,25
050,26,153,"Michigan","Schoolcraft County",5,21,61,34,27
050,26,153,"Michigan","Schoolcraft County",5,22,67,35,32
050,26,153,"Michigan","Schoolcraft County",5,23,77,36,41
050,26,153,"Michigan","Schoolcraft County",5,24,66,33,33
050,26,153,"Michigan","Schoolcraft County",5,25,65,32,33
050,26,153,"Michigan","Schoolcraft County",5,26,63,28,35
050,26,153,"Michigan","Schoolcraft County",5,27,79,45,34
050,26,153,"Michigan","Schoolcraft County",5,28,76,36,40
050,26,153,"Michigan","Schoolcraft County",5,29,100,53,47
050,26,153,"Michigan","Schoolcraft County",5,30,84,46,38
050,26,153,"Michigan","Schoolcraft County",5,31,66,33,33
050,26,153,"Michigan","Schoolcraft County",5,32,53,27,26
050,26,153,"Michigan","Schoolcraft County",5,33,65,32,33
050,26,153,"Michigan","Schoolcraft County",5,34,71,40,31
050,26,153,"Michigan","Schoolcraft County",5,35,73,43,30
050,26,153,"Michigan","Schoolcraft County",5,36,71,36,35
050,26,153,"Michigan","Schoolcraft County",5,37,69,31,38
050,26,153,"Michigan","Schoolcraft County",5,38,80,35,45
050,26,153,"Michigan","Schoolcraft County",5,39,74,42,32
050,26,153,"Michigan","Schoolcraft County",5,40,84,48,36
050,26,153,"Michigan","Schoolcraft County",5,41,86,45,41
050,26,153,"Michigan","Schoolcraft County",5,42,72,36,36
050,26,153,"Michigan","Schoolcraft County",5,43,84,41,43
050,26,153,"Michigan","Schoolcraft County",5,44,80,40,40
050,26,153,"Michigan","Schoolcraft County",5,45,76,39,37
050,26,153,"Michigan","Schoolcraft County",5,46,76,33,43
050,26,153,"Michigan","Schoolcraft County",5,47,71,32,39
050,26,153,"Michigan","Schoolcraft County",5,48,84,42,42
050,26,153,"Michigan","Schoolcraft County",5,49,84,38,46
050,26,153,"Michigan","Schoolcraft County",5,50,103,46,57
050,26,153,"Michigan","Schoolcraft County",5,51,95,48,47
050,26,153,"Michigan","Schoolcraft County",5,52,110,57,53
050,26,153,"Michigan","Schoolcraft County",5,53,111,56,55
050,26,153,"Michigan","Schoolcraft County",5,54,111,54,57
050,26,153,"Michigan","Schoolcraft County",5,55,106,58,48
050,26,153,"Michigan","Schoolcraft County",5,56,120,66,54
050,26,153,"Michigan","Schoolcraft County",5,57,135,63,72
050,26,153,"Michigan","Schoolcraft County",5,58,110,55,55
050,26,153,"Michigan","Schoolcraft County",5,59,128,65,63
050,26,153,"Michigan","Schoolcraft County",5,60,142,69,73
050,26,153,"Michigan","Schoolcraft County",5,61,161,74,87
050,26,153,"Michigan","Schoolcraft County",5,62,183,85,98
050,26,153,"Michigan","Schoolcraft County",5,63,164,76,88
050,26,153,"Michigan","Schoolcraft County",5,64,169,84,85
050,26,153,"Michigan","Schoolcraft County",5,65,177,93,84
050,26,153,"Michigan","Schoolcraft County",5,66,168,83,85
050,26,153,"Michigan","Schoolcraft County",5,67,152,76,76
050,26,153,"Michigan","Schoolcraft County",5,68,171,85,86
050,26,153,"Michigan","Schoolcraft County",5,69,162,82,80
050,26,153,"Michigan","Schoolcraft County",5,70,153,84,69
050,26,153,"Michigan","Schoolcraft County",5,71,148,78,70
050,26,153,"Michigan","Schoolcraft County",5,72,133,66,67
050,26,153,"Michigan","Schoolcraft County",5,73,126,63,63
050,26,153,"Michigan","Schoolcraft County",5,74,113,60,53
050,26,153,"Michigan","Schoolcraft County",5,75,111,51,60
050,26,153,"Michigan","Schoolcraft County",5,76,112,60,52
050,26,153,"Michigan","Schoolcraft County",5,77,68,34,34
050,26,153,"Michigan","Schoolcraft County",5,78,70,33,37
050,26,153,"Michigan","Schoolcraft County",5,79,60,27,33
050,26,153,"Michigan","Schoolcraft County",5,80,71,33,38
050,26,153,"Michigan","Schoolcraft County",5,81,53,28,25
050,26,153,"Michigan","Schoolcraft County",5,82,48,29,19
050,26,153,"Michigan","Schoolcraft County",5,83,41,21,20
050,26,153,"Michigan","Schoolcraft County",5,84,37,13,24
050,26,153,"Michigan","Schoolcraft County",5,85,212,85,127
050,26,155,"Michigan","Shiawassee County",1,0,682,349,333
050,26,155,"Michigan","Shiawassee County",1,1,730,365,365
050,26,155,"Michigan","Shiawassee County",1,2,684,354,330
050,26,155,"Michigan","Shiawassee County",1,3,727,394,333
050,26,155,"Michigan","Shiawassee County",1,4,767,379,388
050,26,155,"Michigan","Shiawassee County",1,5,762,393,369
050,26,155,"Michigan","Shiawassee County",1,6,780,401,379
050,26,155,"Michigan","Shiawassee County",1,7,765,378,387
050,26,155,"Michigan","Shiawassee County",1,8,765,377,388
050,26,155,"Michigan","Shiawassee County",1,9,743,379,364
050,26,155,"Michigan","Shiawassee County",1,10,783,424,359
050,26,155,"Michigan","Shiawassee County",1,11,819,428,391
050,26,155,"Michigan","Shiawassee County",1,12,880,450,430
050,26,155,"Michigan","Shiawassee County",1,13,859,448,411
050,26,155,"Michigan","Shiawassee County",1,14,899,467,432
050,26,155,"Michigan","Shiawassee County",1,15,893,458,435
050,26,155,"Michigan","Shiawassee County",1,16,922,451,471
050,26,155,"Michigan","Shiawassee County",1,17,928,463,465
050,26,155,"Michigan","Shiawassee County",1,18,849,443,406
050,26,155,"Michigan","Shiawassee County",1,19,648,345,303
050,26,155,"Michigan","Shiawassee County",1,20,686,356,330
050,26,155,"Michigan","Shiawassee County",1,21,694,357,337
050,26,155,"Michigan","Shiawassee County",1,22,780,406,374
050,26,155,"Michigan","Shiawassee County",1,23,785,393,392
050,26,155,"Michigan","Shiawassee County",1,24,802,412,390
050,26,155,"Michigan","Shiawassee County",1,25,805,412,393
050,26,155,"Michigan","Shiawassee County",1,26,845,439,406
050,26,155,"Michigan","Shiawassee County",1,27,831,424,407
050,26,155,"Michigan","Shiawassee County",1,28,869,461,408
050,26,155,"Michigan","Shiawassee County",1,29,920,477,443
050,26,155,"Michigan","Shiawassee County",1,30,795,398,397
050,26,155,"Michigan","Shiawassee County",1,31,757,364,393
050,26,155,"Michigan","Shiawassee County",1,32,778,408,370
050,26,155,"Michigan","Shiawassee County",1,33,775,401,374
050,26,155,"Michigan","Shiawassee County",1,34,761,375,386
050,26,155,"Michigan","Shiawassee County",1,35,761,386,375
050,26,155,"Michigan","Shiawassee County",1,36,730,369,361
050,26,155,"Michigan","Shiawassee County",1,37,797,399,398
050,26,155,"Michigan","Shiawassee County",1,38,796,401,395
050,26,155,"Michigan","Shiawassee County",1,39,801,404,397
050,26,155,"Michigan","Shiawassee County",1,40,821,395,426
050,26,155,"Michigan","Shiawassee County",1,41,780,383,397
050,26,155,"Michigan","Shiawassee County",1,42,753,388,365
050,26,155,"Michigan","Shiawassee County",1,43,794,407,387
050,26,155,"Michigan","Shiawassee County",1,44,784,387,397
050,26,155,"Michigan","Shiawassee County",1,45,748,381,367
050,26,155,"Michigan","Shiawassee County",1,46,764,387,377
050,26,155,"Michigan","Shiawassee County",1,47,814,425,389
050,26,155,"Michigan","Shiawassee County",1,48,866,447,419
050,26,155,"Michigan","Shiawassee County",1,49,965,486,479
050,26,155,"Michigan","Shiawassee County",1,50,968,501,467
050,26,155,"Michigan","Shiawassee County",1,51,959,483,476
050,26,155,"Michigan","Shiawassee County",1,52,940,495,445
050,26,155,"Michigan","Shiawassee County",1,53,976,488,488
050,26,155,"Michigan","Shiawassee County",1,54,974,489,485
050,26,155,"Michigan","Shiawassee County",1,55,1067,535,532
050,26,155,"Michigan","Shiawassee County",1,56,1120,562,558
050,26,155,"Michigan","Shiawassee County",1,57,1099,544,555
050,26,155,"Michigan","Shiawassee County",1,58,1087,535,552
050,26,155,"Michigan","Shiawassee County",1,59,1094,565,529
050,26,155,"Michigan","Shiawassee County",1,60,1063,550,513
050,26,155,"Michigan","Shiawassee County",1,61,1039,512,527
050,26,155,"Michigan","Shiawassee County",1,62,1062,505,557
050,26,155,"Michigan","Shiawassee County",1,63,1018,493,525
050,26,155,"Michigan","Shiawassee County",1,64,1000,498,502
050,26,155,"Michigan","Shiawassee County",1,65,958,456,502
050,26,155,"Michigan","Shiawassee County",1,66,971,458,513
050,26,155,"Michigan","Shiawassee County",1,67,868,409,459
050,26,155,"Michigan","Shiawassee County",1,68,864,402,462
050,26,155,"Michigan","Shiawassee County",1,69,769,366,403
050,26,155,"Michigan","Shiawassee County",1,70,778,371,407
050,26,155,"Michigan","Shiawassee County",1,71,738,357,381
050,26,155,"Michigan","Shiawassee County",1,72,719,353,366
050,26,155,"Michigan","Shiawassee County",1,73,724,339,385
050,26,155,"Michigan","Shiawassee County",1,74,499,240,259
050,26,155,"Michigan","Shiawassee County",1,75,524,248,276
050,26,155,"Michigan","Shiawassee County",1,76,527,232,295
050,26,155,"Michigan","Shiawassee County",1,77,492,212,280
050,26,155,"Michigan","Shiawassee County",1,78,431,189,242
050,26,155,"Michigan","Shiawassee County",1,79,370,170,200
050,26,155,"Michigan","Shiawassee County",1,80,329,143,186
050,26,155,"Michigan","Shiawassee County",1,81,321,147,174
050,26,155,"Michigan","Shiawassee County",1,82,288,124,164
050,26,155,"Michigan","Shiawassee County",1,83,263,113,150
050,26,155,"Michigan","Shiawassee County",1,84,245,110,135
050,26,155,"Michigan","Shiawassee County",1,85,1209,410,799
050,26,155,"Michigan","Shiawassee County",2,0,684,334,350
050,26,155,"Michigan","Shiawassee County",2,1,718,360,358
050,26,155,"Michigan","Shiawassee County",2,2,701,360,341
050,26,155,"Michigan","Shiawassee County",2,3,714,381,333
050,26,155,"Michigan","Shiawassee County",2,4,757,385,372
050,26,155,"Michigan","Shiawassee County",2,5,764,391,373
050,26,155,"Michigan","Shiawassee County",2,6,774,397,377
050,26,155,"Michigan","Shiawassee County",2,7,767,384,383
050,26,155,"Michigan","Shiawassee County",2,8,766,379,387
050,26,155,"Michigan","Shiawassee County",2,9,751,379,372
050,26,155,"Michigan","Shiawassee County",2,10,774,411,363
050,26,155,"Michigan","Shiawassee County",2,11,811,427,384
050,26,155,"Michigan","Shiawassee County",2,12,870,448,422
050,26,155,"Michigan","Shiawassee County",2,13,864,450,414
050,26,155,"Michigan","Shiawassee County",2,14,890,461,429
050,26,155,"Michigan","Shiawassee County",2,15,896,460,436
050,26,155,"Michigan","Shiawassee County",2,16,915,452,463
050,26,155,"Michigan","Shiawassee County",2,17,929,461,468
050,26,155,"Michigan","Shiawassee County",2,18,828,432,396
050,26,155,"Michigan","Shiawassee County",2,19,658,347,311
050,26,155,"Michigan","Shiawassee County",2,20,687,357,330
050,26,155,"Michigan","Shiawassee County",2,21,700,363,337
050,26,155,"Michigan","Shiawassee County",2,22,763,395,368
050,26,155,"Michigan","Shiawassee County",2,23,788,398,390
050,26,155,"Michigan","Shiawassee County",2,24,795,406,389
050,26,155,"Michigan","Shiawassee County",2,25,807,415,392
050,26,155,"Michigan","Shiawassee County",2,26,836,432,404
050,26,155,"Michigan","Shiawassee County",2,27,834,427,407
050,26,155,"Michigan","Shiawassee County",2,28,862,454,408
050,26,155,"Michigan","Shiawassee County",2,29,909,472,437
050,26,155,"Michigan","Shiawassee County",2,30,827,414,413
050,26,155,"Michigan","Shiawassee County",2,31,767,373,394
050,26,155,"Michigan","Shiawassee County",2,32,774,397,377
050,26,155,"Michigan","Shiawassee County",2,33,779,404,375
050,26,155,"Michigan","Shiawassee County",2,34,768,384,384
050,26,155,"Michigan","Shiawassee County",2,35,767,385,382
050,26,155,"Michigan","Shiawassee County",2,36,730,369,361
050,26,155,"Michigan","Shiawassee County",2,37,783,391,392
050,26,155,"Michigan","Shiawassee County",2,38,796,400,396
050,26,155,"Michigan","Shiawassee County",2,39,797,401,396
050,26,155,"Michigan","Shiawassee County",2,40,821,399,422
050,26,155,"Michigan","Shiawassee County",2,41,786,384,402
050,26,155,"Michigan","Shiawassee County",2,42,758,386,372
050,26,155,"Michigan","Shiawassee County",2,43,789,406,383
050,26,155,"Michigan","Shiawassee County",2,44,777,387,390
050,26,155,"Michigan","Shiawassee County",2,45,759,383,376
050,26,155,"Michigan","Shiawassee County",2,46,752,381,371
050,26,155,"Michigan","Shiawassee County",2,47,797,412,385
050,26,155,"Michigan","Shiawassee County",2,48,858,445,413
050,26,155,"Michigan","Shiawassee County",2,49,946,479,467
050,26,155,"Michigan","Shiawassee County",2,50,968,497,471
050,26,155,"Michigan","Shiawassee County",2,51,955,485,470
050,26,155,"Michigan","Shiawassee County",2,52,940,490,450
050,26,155,"Michigan","Shiawassee County",2,53,967,489,478
050,26,155,"Michigan","Shiawassee County",2,54,972,489,483
050,26,155,"Michigan","Shiawassee County",2,55,1044,523,521
050,26,155,"Michigan","Shiawassee County",2,56,1110,555,555
050,26,155,"Michigan","Shiawassee County",2,57,1108,550,558
050,26,155,"Michigan","Shiawassee County",2,58,1088,536,552
050,26,155,"Michigan","Shiawassee County",2,59,1099,563,536
050,26,155,"Michigan","Shiawassee County",2,60,1064,551,513
050,26,155,"Michigan","Shiawassee County",2,61,1035,515,520
050,26,155,"Michigan","Shiawassee County",2,62,1052,503,549
050,26,155,"Michigan","Shiawassee County",2,63,1031,494,537
050,26,155,"Michigan","Shiawassee County",2,64,994,491,503
050,26,155,"Michigan","Shiawassee County",2,65,968,464,504
050,26,155,"Michigan","Shiawassee County",2,66,962,450,512
050,26,155,"Michigan","Shiawassee County",2,67,892,419,473
050,26,155,"Michigan","Shiawassee County",2,68,852,395,457
050,26,155,"Michigan","Shiawassee County",2,69,792,374,418
050,26,155,"Michigan","Shiawassee County",2,70,767,364,403
050,26,155,"Michigan","Shiawassee County",2,71,748,359,389
050,26,155,"Michigan","Shiawassee County",2,72,711,347,364
050,26,155,"Michigan","Shiawassee County",2,73,752,360,392
050,26,155,"Michigan","Shiawassee County",2,74,514,245,269
050,26,155,"Michigan","Shiawassee County",2,75,518,244,274
050,26,155,"Michigan","Shiawassee County",2,76,517,231,286
050,26,155,"Michigan","Shiawassee County",2,77,500,218,282
050,26,155,"Michigan","Shiawassee County",2,78,431,186,245
050,26,155,"Michigan","Shiawassee County",2,79,371,169,202
050,26,155,"Michigan","Shiawassee County",2,80,337,148,189
050,26,155,"Michigan","Shiawassee County",2,81,316,144,172
050,26,155,"Michigan","Shiawassee County",2,82,277,118,159
050,26,155,"Michigan","Shiawassee County",2,83,266,113,153
050,26,155,"Michigan","Shiawassee County",2,84,238,104,134
050,26,155,"Michigan","Shiawassee County",2,85,1211,418,793
050,26,155,"Michigan","Shiawassee County",3,0,650,337,313
050,26,155,"Michigan","Shiawassee County",3,1,684,338,346
050,26,155,"Michigan","Shiawassee County",3,2,743,361,382
050,26,155,"Michigan","Shiawassee County",3,3,703,367,336
050,26,155,"Michigan","Shiawassee County",3,4,724,380,344
050,26,155,"Michigan","Shiawassee County",3,5,759,386,373
050,26,155,"Michigan","Shiawassee County",3,6,802,408,394
050,26,155,"Michigan","Shiawassee County",3,7,818,422,396
050,26,155,"Michigan","Shiawassee County",3,8,776,377,399
050,26,155,"Michigan","Shiawassee County",3,9,766,382,384
050,26,155,"Michigan","Shiawassee County",3,10,733,375,358
050,26,155,"Michigan","Shiawassee County",3,11,766,409,357
050,26,155,"Michigan","Shiawassee County",3,12,810,430,380
050,26,155,"Michigan","Shiawassee County",3,13,862,441,421
050,26,155,"Michigan","Shiawassee County",3,14,867,448,419
050,26,155,"Michigan","Shiawassee County",3,15,878,455,423
050,26,155,"Michigan","Shiawassee County",3,16,890,464,426
050,26,155,"Michigan","Shiawassee County",3,17,909,449,460
050,26,155,"Michigan","Shiawassee County",3,18,791,403,388
050,26,155,"Michigan","Shiawassee County",3,19,644,341,303
050,26,155,"Michigan","Shiawassee County",3,20,686,350,336
050,26,155,"Michigan","Shiawassee County",3,21,735,373,362
050,26,155,"Michigan","Shiawassee County",3,22,732,372,360
050,26,155,"Michigan","Shiawassee County",3,23,832,441,391
050,26,155,"Michigan","Shiawassee County",3,24,796,404,392
050,26,155,"Michigan","Shiawassee County",3,25,815,413,402
050,26,155,"Michigan","Shiawassee County",3,26,821,423,398
050,26,155,"Michigan","Shiawassee County",3,27,838,434,404
050,26,155,"Michigan","Shiawassee County",3,28,861,450,411
050,26,155,"Michigan","Shiawassee County",3,29,865,451,414
050,26,155,"Michigan","Shiawassee County",3,30,924,480,444
050,26,155,"Michigan","Shiawassee County",3,31,851,433,418
050,26,155,"Michigan","Shiawassee County",3,32,775,376,399
050,26,155,"Michigan","Shiawassee County",3,33,783,393,390
050,26,155,"Michigan","Shiawassee County",3,34,787,411,376
050,26,155,"Michigan","Shiawassee County",3,35,780,397,383
050,26,155,"Michigan","Shiawassee County",3,36,778,403,375
050,26,155,"Michigan","Shiawassee County",3,37,738,365,373
050,26,155,"Michigan","Shiawassee County",3,38,792,400,392
050,26,155,"Michigan","Shiawassee County",3,39,812,408,404
050,26,155,"Michigan","Shiawassee County",3,40,781,399,382
050,26,155,"Michigan","Shiawassee County",3,41,831,409,422
050,26,155,"Michigan","Shiawassee County",3,42,791,383,408
050,26,155,"Michigan","Shiawassee County",3,43,755,381,374
050,26,155,"Michigan","Shiawassee County",3,44,784,399,385
050,26,155,"Michigan","Shiawassee County",3,45,771,385,386
050,26,155,"Michigan","Shiawassee County",3,46,771,399,372
050,26,155,"Michigan","Shiawassee County",3,47,749,376,373
050,26,155,"Michigan","Shiawassee County",3,48,808,419,389
050,26,155,"Michigan","Shiawassee County",3,49,858,441,417
050,26,155,"Michigan","Shiawassee County",3,50,955,486,469
050,26,155,"Michigan","Shiawassee County",3,51,974,498,476
050,26,155,"Michigan","Shiawassee County",3,52,950,493,457
050,26,155,"Michigan","Shiawassee County",3,53,932,488,444
050,26,155,"Michigan","Shiawassee County",3,54,970,493,477
050,26,155,"Michigan","Shiawassee County",3,55,971,480,491
050,26,155,"Michigan","Shiawassee County",3,56,1046,525,521
050,26,155,"Michigan","Shiawassee County",3,57,1087,540,547
050,26,155,"Michigan","Shiawassee County",3,58,1105,552,553
050,26,155,"Michigan","Shiawassee County",3,59,1082,536,546
050,26,155,"Michigan","Shiawassee County",3,60,1093,554,539
050,26,155,"Michigan","Shiawassee County",3,61,1048,541,507
050,26,155,"Michigan","Shiawassee County",3,62,1024,505,519
050,26,155,"Michigan","Shiawassee County",3,63,1025,499,526
050,26,155,"Michigan","Shiawassee County",3,64,1011,482,529
050,26,155,"Michigan","Shiawassee County",3,65,981,483,498
050,26,155,"Michigan","Shiawassee County",3,66,947,452,495
050,26,155,"Michigan","Shiawassee County",3,67,947,445,502
050,26,155,"Michigan","Shiawassee County",3,68,878,407,471
050,26,155,"Michigan","Shiawassee County",3,69,834,388,446
050,26,155,"Michigan","Shiawassee County",3,70,772,363,409
050,26,155,"Michigan","Shiawassee County",3,71,738,352,386
050,26,155,"Michigan","Shiawassee County",3,72,722,348,374
050,26,155,"Michigan","Shiawassee County",3,73,680,326,354
050,26,155,"Michigan","Shiawassee County",3,74,733,351,382
050,26,155,"Michigan","Shiawassee County",3,75,501,236,265
050,26,155,"Michigan","Shiawassee County",3,76,482,225,257
050,26,155,"Michigan","Shiawassee County",3,77,490,219,271
050,26,155,"Michigan","Shiawassee County",3,78,479,204,275
050,26,155,"Michigan","Shiawassee County",3,79,407,173,234
050,26,155,"Michigan","Shiawassee County",3,80,361,164,197
050,26,155,"Michigan","Shiawassee County",3,81,315,138,177
050,26,155,"Michigan","Shiawassee County",3,82,283,122,161
050,26,155,"Michigan","Shiawassee County",3,83,256,98,158
050,26,155,"Michigan","Shiawassee County",3,84,241,101,140
050,26,155,"Michigan","Shiawassee County",3,85,1196,416,780
050,26,155,"Michigan","Shiawassee County",4,0,672,353,319
050,26,155,"Michigan","Shiawassee County",4,1,688,358,330
050,26,155,"Michigan","Shiawassee County",4,2,700,353,347
050,26,155,"Michigan","Shiawassee County",4,3,742,357,385
050,26,155,"Michigan","Shiawassee County",4,4,683,353,330
050,26,155,"Michigan","Shiawassee County",4,5,752,396,356
050,26,155,"Michigan","Shiawassee County",4,6,784,393,391
050,26,155,"Michigan","Shiawassee County",4,7,798,402,396
050,26,155,"Michigan","Shiawassee County",4,8,819,434,385
050,26,155,"Michigan","Shiawassee County",4,9,778,387,391
050,26,155,"Michigan","Shiawassee County",4,10,756,374,382
050,26,155,"Michigan","Shiawassee County",4,11,749,389,360
050,26,155,"Michigan","Shiawassee County",4,12,777,404,373
050,26,155,"Michigan","Shiawassee County",4,13,820,443,377
050,26,155,"Michigan","Shiawassee County",4,14,868,447,421
050,26,155,"Michigan","Shiawassee County",4,15,869,435,434
050,26,155,"Michigan","Shiawassee County",4,16,884,461,423
050,26,155,"Michigan","Shiawassee County",4,17,902,476,426
050,26,155,"Michigan","Shiawassee County",4,18,779,400,379
050,26,155,"Michigan","Shiawassee County",4,19,609,310,299
050,26,155,"Michigan","Shiawassee County",4,20,682,358,324
050,26,155,"Michigan","Shiawassee County",4,21,715,363,352
050,26,155,"Michigan","Shiawassee County",4,22,762,387,375
050,26,155,"Michigan","Shiawassee County",4,23,771,393,378
050,26,155,"Michigan","Shiawassee County",4,24,818,432,386
050,26,155,"Michigan","Shiawassee County",4,25,804,419,385
050,26,155,"Michigan","Shiawassee County",4,26,827,417,410
050,26,155,"Michigan","Shiawassee County",4,27,837,439,398
050,26,155,"Michigan","Shiawassee County",4,28,868,460,408
050,26,155,"Michigan","Shiawassee County",4,29,863,438,425
050,26,155,"Michigan","Shiawassee County",4,30,880,457,423
050,26,155,"Michigan","Shiawassee County",4,31,927,487,440
050,26,155,"Michigan","Shiawassee County",4,32,878,443,435
050,26,155,"Michigan","Shiawassee County",4,33,789,383,406
050,26,155,"Michigan","Shiawassee County",4,34,785,401,384
050,26,155,"Michigan","Shiawassee County",4,35,791,400,391
050,26,155,"Michigan","Shiawassee County",4,36,782,398,384
050,26,155,"Michigan","Shiawassee County",4,37,790,406,384
050,26,155,"Michigan","Shiawassee County",4,38,736,368,368
050,26,155,"Michigan","Shiawassee County",4,39,796,402,394
050,26,155,"Michigan","Shiawassee County",4,40,817,411,406
050,26,155,"Michigan","Shiawassee County",4,41,789,408,381
050,26,155,"Michigan","Shiawassee County",4,42,829,404,425
050,26,155,"Michigan","Shiawassee County",4,43,815,397,418
050,26,155,"Michigan","Shiawassee County",4,44,768,386,382
050,26,155,"Michigan","Shiawassee County",4,45,784,400,384
050,26,155,"Michigan","Shiawassee County",4,46,778,391,387
050,26,155,"Michigan","Shiawassee County",4,47,763,390,373
050,26,155,"Michigan","Shiawassee County",4,48,766,387,379
050,26,155,"Michigan","Shiawassee County",4,49,820,429,391
050,26,155,"Michigan","Shiawassee County",4,50,873,452,421
050,26,155,"Michigan","Shiawassee County",4,51,942,466,476
050,26,155,"Michigan","Shiawassee County",4,52,973,499,474
050,26,155,"Michigan","Shiawassee County",4,53,935,477,458
050,26,155,"Michigan","Shiawassee County",4,54,940,487,453
050,26,155,"Michigan","Shiawassee County",4,55,959,479,480
050,26,155,"Michigan","Shiawassee County",4,56,972,482,490
050,26,155,"Michigan","Shiawassee County",4,57,1036,524,512
050,26,155,"Michigan","Shiawassee County",4,58,1084,532,552
050,26,155,"Michigan","Shiawassee County",4,59,1096,550,546
050,26,155,"Michigan","Shiawassee County",4,60,1055,530,525
050,26,155,"Michigan","Shiawassee County",4,61,1073,541,532
050,26,155,"Michigan","Shiawassee County",4,62,1025,529,496
050,26,155,"Michigan","Shiawassee County",4,63,1000,494,506
050,26,155,"Michigan","Shiawassee County",4,64,991,475,516
050,26,155,"Michigan","Shiawassee County",4,65,1002,474,528
050,26,155,"Michigan","Shiawassee County",4,66,962,477,485
050,26,155,"Michigan","Shiawassee County",4,67,923,445,478
050,26,155,"Michigan","Shiawassee County",4,68,923,423,500
050,26,155,"Michigan","Shiawassee County",4,69,840,388,452
050,26,155,"Michigan","Shiawassee County",4,70,815,375,440
050,26,155,"Michigan","Shiawassee County",4,71,749,348,401
050,26,155,"Michigan","Shiawassee County",4,72,723,340,383
050,26,155,"Michigan","Shiawassee County",4,73,692,334,358
050,26,155,"Michigan","Shiawassee County",4,74,673,333,340
050,26,155,"Michigan","Shiawassee County",4,75,706,338,368
050,26,155,"Michigan","Shiawassee County",4,76,464,212,252
050,26,155,"Michigan","Shiawassee County",4,77,445,211,234
050,26,155,"Michigan","Shiawassee County",4,78,475,206,269
050,26,155,"Michigan","Shiawassee County",4,79,447,188,259
050,26,155,"Michigan","Shiawassee County",4,80,390,158,232
050,26,155,"Michigan","Shiawassee County",4,81,342,150,192
050,26,155,"Michigan","Shiawassee County",4,82,281,118,163
050,26,155,"Michigan","Shiawassee County",4,83,264,105,159
050,26,155,"Michigan","Shiawassee County",4,84,229,82,147
050,26,155,"Michigan","Shiawassee County",4,85,1209,427,782
050,26,155,"Michigan","Shiawassee County",5,0,657,345,312
050,26,155,"Michigan","Shiawassee County",5,1,706,368,338
050,26,155,"Michigan","Shiawassee County",5,2,697,363,334
050,26,155,"Michigan","Shiawassee County",5,3,698,343,355
050,26,155,"Michigan","Shiawassee County",5,4,758,358,400
050,26,155,"Michigan","Shiawassee County",5,5,712,371,341
050,26,155,"Michigan","Shiawassee County",5,6,723,380,343
050,26,155,"Michigan","Shiawassee County",5,7,802,404,398
050,26,155,"Michigan","Shiawassee County",5,8,811,411,400
050,26,155,"Michigan","Shiawassee County",5,9,831,438,393
050,26,155,"Michigan","Shiawassee County",5,10,790,388,402
050,26,155,"Michigan","Shiawassee County",5,11,784,393,391
050,26,155,"Michigan","Shiawassee County",5,12,753,393,360
050,26,155,"Michigan","Shiawassee County",5,13,780,407,373
050,26,155,"Michigan","Shiawassee County",5,14,832,458,374
050,26,155,"Michigan","Shiawassee County",5,15,881,453,428
050,26,155,"Michigan","Shiawassee County",5,16,856,435,421
050,26,155,"Michigan","Shiawassee County",5,17,897,475,422
050,26,155,"Michigan","Shiawassee County",5,18,758,407,351
050,26,155,"Michigan","Shiawassee County",5,19,607,316,291
050,26,155,"Michigan","Shiawassee County",5,20,658,329,329
050,26,155,"Michigan","Shiawassee County",5,21,741,386,355
050,26,155,"Michigan","Shiawassee County",5,22,756,386,370
050,26,155,"Michigan","Shiawassee County",5,23,761,387,374
050,26,155,"Michigan","Shiawassee County",5,24,756,392,364
050,26,155,"Michigan","Shiawassee County",5,25,815,447,368
050,26,155,"Michigan","Shiawassee County",5,26,818,421,397
050,26,155,"Michigan","Shiawassee County",5,27,828,435,393
050,26,155,"Michigan","Shiawassee County",5,28,846,451,395
050,26,155,"Michigan","Shiawassee County",5,29,878,467,411
050,26,155,"Michigan","Shiawassee County",5,30,864,443,421
050,26,155,"Michigan","Shiawassee County",5,31,902,466,436
050,26,155,"Michigan","Shiawassee County",5,32,919,487,432
050,26,155,"Michigan","Shiawassee County",5,33,878,439,439
050,26,155,"Michigan","Shiawassee County",5,34,800,387,413
050,26,155,"Michigan","Shiawassee County",5,35,799,411,388
050,26,155,"Michigan","Shiawassee County",5,36,804,404,400
050,26,155,"Michigan","Shiawassee County",5,37,807,402,405
050,26,155,"Michigan","Shiawassee County",5,38,810,421,389
050,26,155,"Michigan","Shiawassee County",5,39,748,378,370
050,26,155,"Michigan","Shiawassee County",5,40,800,396,404
050,26,155,"Michigan","Shiawassee County",5,41,806,403,403
050,26,155,"Michigan","Shiawassee County",5,42,799,425,374
050,26,155,"Michigan","Shiawassee County",5,43,838,403,435
050,26,155,"Michigan","Shiawassee County",5,44,815,404,411
050,26,155,"Michigan","Shiawassee County",5,45,783,386,397
050,26,155,"Michigan","Shiawassee County",5,46,788,405,383
050,26,155,"Michigan","Shiawassee County",5,47,764,376,388
050,26,155,"Michigan","Shiawassee County",5,48,773,392,381
050,26,155,"Michigan","Shiawassee County",5,49,758,382,376
050,26,155,"Michigan","Shiawassee County",5,50,815,428,387
050,26,155,"Michigan","Shiawassee County",5,51,851,445,406
050,26,155,"Michigan","Shiawassee County",5,52,946,470,476
050,26,155,"Michigan","Shiawassee County",5,53,966,499,467
050,26,155,"Michigan","Shiawassee County",5,54,936,484,452
050,26,155,"Michigan","Shiawassee County",5,55,919,469,450
050,26,155,"Michigan","Shiawassee County",5,56,946,468,478
050,26,155,"Michigan","Shiawassee County",5,57,963,477,486
050,26,155,"Michigan","Shiawassee County",5,58,1026,514,512
050,26,155,"Michigan","Shiawassee County",5,59,1063,526,537
050,26,155,"Michigan","Shiawassee County",5,60,1076,535,541
050,26,155,"Michigan","Shiawassee County",5,61,1031,512,519
050,26,155,"Michigan","Shiawassee County",5,62,1077,548,529
050,26,155,"Michigan","Shiawassee County",5,63,1022,532,490
050,26,155,"Michigan","Shiawassee County",5,64,996,491,505
050,26,155,"Michigan","Shiawassee County",5,65,985,476,509
050,26,155,"Michigan","Shiawassee County",5,66,989,470,519
050,26,155,"Michigan","Shiawassee County",5,67,957,474,483
050,26,155,"Michigan","Shiawassee County",5,68,912,435,477
050,26,155,"Michigan","Shiawassee County",5,69,898,417,481
050,26,155,"Michigan","Shiawassee County",5,70,824,381,443
050,26,155,"Michigan","Shiawassee County",5,71,811,367,444
050,26,155,"Michigan","Shiawassee County",5,72,736,345,391
050,26,155,"Michigan","Shiawassee County",5,73,701,327,374
050,26,155,"Michigan","Shiawassee County",5,74,677,329,348
050,26,155,"Michigan","Shiawassee County",5,75,655,325,330
050,26,155,"Michigan","Shiawassee County",5,76,661,308,353
050,26,155,"Michigan","Shiawassee County",5,77,427,198,229
050,26,155,"Michigan","Shiawassee County",5,78,422,193,229
050,26,155,"Michigan","Shiawassee County",5,79,443,191,252
050,26,155,"Michigan","Shiawassee County",5,80,423,175,248
050,26,155,"Michigan","Shiawassee County",5,81,367,146,221
050,26,155,"Michigan","Shiawassee County",5,82,307,130,177
050,26,155,"Michigan","Shiawassee County",5,83,268,102,166
050,26,155,"Michigan","Shiawassee County",5,84,237,93,144
050,26,155,"Michigan","Shiawassee County",5,85,1247,432,815
050,26,157,"Michigan","Tuscola County",1,0,530,274,256
050,26,157,"Michigan","Tuscola County",1,1,537,278,259
050,26,157,"Michigan","Tuscola County",1,2,569,298,271
050,26,157,"Michigan","Tuscola County",1,3,551,282,269
050,26,157,"Michigan","Tuscola County",1,4,556,297,259
050,26,157,"Michigan","Tuscola County",1,5,583,301,282
050,26,157,"Michigan","Tuscola County",1,6,558,286,272
050,26,157,"Michigan","Tuscola County",1,7,567,295,272
050,26,157,"Michigan","Tuscola County",1,8,534,284,250
050,26,157,"Michigan","Tuscola County",1,9,553,287,266
050,26,157,"Michigan","Tuscola County",1,10,608,310,298
050,26,157,"Michigan","Tuscola County",1,11,622,325,297
050,26,157,"Michigan","Tuscola County",1,12,666,362,304
050,26,157,"Michigan","Tuscola County",1,13,676,345,331
050,26,157,"Michigan","Tuscola County",1,14,677,357,320
050,26,157,"Michigan","Tuscola County",1,15,684,360,324
050,26,157,"Michigan","Tuscola County",1,16,777,430,347
050,26,157,"Michigan","Tuscola County",1,17,699,380,319
050,26,157,"Michigan","Tuscola County",1,18,575,321,254
050,26,157,"Michigan","Tuscola County",1,19,450,244,206
050,26,157,"Michigan","Tuscola County",1,20,482,241,241
050,26,157,"Michigan","Tuscola County",1,21,520,252,268
050,26,157,"Michigan","Tuscola County",1,22,537,264,273
050,26,157,"Michigan","Tuscola County",1,23,615,313,302
050,26,157,"Michigan","Tuscola County",1,24,604,340,264
050,26,157,"Michigan","Tuscola County",1,25,612,323,289
050,26,157,"Michigan","Tuscola County",1,26,605,293,312
050,26,157,"Michigan","Tuscola County",1,27,642,331,311
050,26,157,"Michigan","Tuscola County",1,28,619,320,299
050,26,157,"Michigan","Tuscola County",1,29,605,325,280
050,26,157,"Michigan","Tuscola County",1,30,614,315,299
050,26,157,"Michigan","Tuscola County",1,31,577,300,277
050,26,157,"Michigan","Tuscola County",1,32,557,284,273
050,26,157,"Michigan","Tuscola County",1,33,550,283,267
050,26,157,"Michigan","Tuscola County",1,34,582,302,280
050,26,157,"Michigan","Tuscola County",1,35,604,314,290
050,26,157,"Michigan","Tuscola County",1,36,567,283,284
050,26,157,"Michigan","Tuscola County",1,37,614,310,304
050,26,157,"Michigan","Tuscola County",1,38,629,326,303
050,26,157,"Michigan","Tuscola County",1,39,610,309,301
050,26,157,"Michigan","Tuscola County",1,40,615,315,300
050,26,157,"Michigan","Tuscola County",1,41,604,296,308
050,26,157,"Michigan","Tuscola County",1,42,599,315,284
050,26,157,"Michigan","Tuscola County",1,43,580,304,276
050,26,157,"Michigan","Tuscola County",1,44,557,289,268
050,26,157,"Michigan","Tuscola County",1,45,589,305,284
050,26,157,"Michigan","Tuscola County",1,46,595,318,277
050,26,157,"Michigan","Tuscola County",1,47,611,306,305
050,26,157,"Michigan","Tuscola County",1,48,682,346,336
050,26,157,"Michigan","Tuscola County",1,49,762,385,377
050,26,157,"Michigan","Tuscola County",1,50,755,375,380
050,26,157,"Michigan","Tuscola County",1,51,707,355,352
050,26,157,"Michigan","Tuscola County",1,52,701,352,349
050,26,157,"Michigan","Tuscola County",1,53,730,352,378
050,26,157,"Michigan","Tuscola County",1,54,761,385,376
050,26,157,"Michigan","Tuscola County",1,55,798,407,391
050,26,157,"Michigan","Tuscola County",1,56,873,446,427
050,26,157,"Michigan","Tuscola County",1,57,883,449,434
050,26,157,"Michigan","Tuscola County",1,58,901,475,426
050,26,157,"Michigan","Tuscola County",1,59,888,460,428
050,26,157,"Michigan","Tuscola County",1,60,849,428,421
050,26,157,"Michigan","Tuscola County",1,61,868,434,434
050,26,157,"Michigan","Tuscola County",1,62,896,458,438
050,26,157,"Michigan","Tuscola County",1,63,868,450,418
050,26,157,"Michigan","Tuscola County",1,64,851,423,428
050,26,157,"Michigan","Tuscola County",1,65,806,405,401
050,26,157,"Michigan","Tuscola County",1,66,768,381,387
050,26,157,"Michigan","Tuscola County",1,67,715,349,366
050,26,157,"Michigan","Tuscola County",1,68,694,342,352
050,26,157,"Michigan","Tuscola County",1,69,653,330,323
050,26,157,"Michigan","Tuscola County",1,70,625,311,314
050,26,157,"Michigan","Tuscola County",1,71,605,286,319
050,26,157,"Michigan","Tuscola County",1,72,612,298,314
050,26,157,"Michigan","Tuscola County",1,73,616,300,316
050,26,157,"Michigan","Tuscola County",1,74,432,213,219
050,26,157,"Michigan","Tuscola County",1,75,472,234,238
050,26,157,"Michigan","Tuscola County",1,76,460,221,239
050,26,157,"Michigan","Tuscola County",1,77,450,222,228
050,26,157,"Michigan","Tuscola County",1,78,389,182,207
050,26,157,"Michigan","Tuscola County",1,79,362,161,201
050,26,157,"Michigan","Tuscola County",1,80,312,137,175
050,26,157,"Michigan","Tuscola County",1,81,300,131,169
050,26,157,"Michigan","Tuscola County",1,82,284,125,159
050,26,157,"Michigan","Tuscola County",1,83,233,107,126
050,26,157,"Michigan","Tuscola County",1,84,205,92,113
050,26,157,"Michigan","Tuscola County",1,85,1089,408,681
050,26,157,"Michigan","Tuscola County",2,0,532,282,250
050,26,157,"Michigan","Tuscola County",2,1,537,277,260
050,26,157,"Michigan","Tuscola County",2,2,561,292,269
050,26,157,"Michigan","Tuscola County",2,3,553,286,267
050,26,157,"Michigan","Tuscola County",2,4,561,295,266
050,26,157,"Michigan","Tuscola County",2,5,577,300,277
050,26,157,"Michigan","Tuscola County",2,6,567,291,276
050,26,157,"Michigan","Tuscola County",2,7,568,294,274
050,26,157,"Michigan","Tuscola County",2,8,544,287,257
050,26,157,"Michigan","Tuscola County",2,9,547,286,261
050,26,157,"Michigan","Tuscola County",2,10,594,303,291
050,26,157,"Michigan","Tuscola County",2,11,620,322,298
050,26,157,"Michigan","Tuscola County",2,12,662,355,307
050,26,157,"Michigan","Tuscola County",2,13,672,349,323
050,26,157,"Michigan","Tuscola County",2,14,676,356,320
050,26,157,"Michigan","Tuscola County",2,15,689,364,325
050,26,157,"Michigan","Tuscola County",2,16,769,426,343
050,26,157,"Michigan","Tuscola County",2,17,707,383,324
050,26,157,"Michigan","Tuscola County",2,18,565,313,252
050,26,157,"Michigan","Tuscola County",2,19,452,245,207
050,26,157,"Michigan","Tuscola County",2,20,487,248,239
050,26,157,"Michigan","Tuscola County",2,21,516,251,265
050,26,157,"Michigan","Tuscola County",2,22,542,263,279
050,26,157,"Michigan","Tuscola County",2,23,605,306,299
050,26,157,"Michigan","Tuscola County",2,24,610,336,274
050,26,157,"Michigan","Tuscola County",2,25,607,324,283
050,26,157,"Michigan","Tuscola County",2,26,612,302,310
050,26,157,"Michigan","Tuscola County",2,27,633,320,313
050,26,157,"Michigan","Tuscola County",2,28,621,323,298
050,26,157,"Michigan","Tuscola County",2,29,607,321,286
050,26,157,"Michigan","Tuscola County",2,30,615,319,296
050,26,157,"Michigan","Tuscola County",2,31,581,300,281
050,26,157,"Michigan","Tuscola County",2,32,564,289,275
050,26,157,"Michigan","Tuscola County",2,33,554,285,269
050,26,157,"Michigan","Tuscola County",2,34,580,303,277
050,26,157,"Michigan","Tuscola County",2,35,605,316,289
050,26,157,"Michigan","Tuscola County",2,36,574,292,282
050,26,157,"Michigan","Tuscola County",2,37,601,301,300
050,26,157,"Michigan","Tuscola County",2,38,624,321,303
050,26,157,"Michigan","Tuscola County",2,39,615,314,301
050,26,157,"Michigan","Tuscola County",2,40,620,316,304
050,26,157,"Michigan","Tuscola County",2,41,606,300,306
050,26,157,"Michigan","Tuscola County",2,42,599,312,287
050,26,157,"Michigan","Tuscola County",2,43,589,309,280
050,26,157,"Michigan","Tuscola County",2,44,558,290,268
050,26,157,"Michigan","Tuscola County",2,45,583,303,280
050,26,157,"Michigan","Tuscola County",2,46,591,313,278
050,26,157,"Michigan","Tuscola County",2,47,606,308,298
050,26,157,"Michigan","Tuscola County",2,48,667,338,329
050,26,157,"Michigan","Tuscola County",2,49,748,378,370
050,26,157,"Michigan","Tuscola County",2,50,759,379,380
050,26,157,"Michigan","Tuscola County",2,51,718,357,361
050,26,157,"Michigan","Tuscola County",2,52,697,350,347
050,26,157,"Michigan","Tuscola County",2,53,722,351,371
050,26,157,"Michigan","Tuscola County",2,54,752,377,375
050,26,157,"Michigan","Tuscola County",2,55,791,403,388
050,26,157,"Michigan","Tuscola County",2,56,856,437,419
050,26,157,"Michigan","Tuscola County",2,57,882,449,433
050,26,157,"Michigan","Tuscola County",2,58,896,467,429
050,26,157,"Michigan","Tuscola County",2,59,888,463,425
050,26,157,"Michigan","Tuscola County",2,60,856,434,422
050,26,157,"Michigan","Tuscola County",2,61,856,431,425
050,26,157,"Michigan","Tuscola County",2,62,892,454,438
050,26,157,"Michigan","Tuscola County",2,63,885,458,427
050,26,157,"Michigan","Tuscola County",2,64,844,424,420
050,26,157,"Michigan","Tuscola County",2,65,812,406,406
050,26,157,"Michigan","Tuscola County",2,66,782,391,391
050,26,157,"Michigan","Tuscola County",2,67,716,349,367
050,26,157,"Michigan","Tuscola County",2,68,687,339,348
050,26,157,"Michigan","Tuscola County",2,69,666,334,332
050,26,157,"Michigan","Tuscola County",2,70,632,316,316
050,26,157,"Michigan","Tuscola County",2,71,610,291,319
050,26,157,"Michigan","Tuscola County",2,72,594,285,309
050,26,157,"Michigan","Tuscola County",2,73,638,313,325
050,26,157,"Michigan","Tuscola County",2,74,443,218,225
050,26,157,"Michigan","Tuscola County",2,75,461,227,234
050,26,157,"Michigan","Tuscola County",2,76,452,216,236
050,26,157,"Michigan","Tuscola County",2,77,461,227,234
050,26,157,"Michigan","Tuscola County",2,78,394,185,209
050,26,157,"Michigan","Tuscola County",2,79,360,160,200
050,26,157,"Michigan","Tuscola County",2,80,319,142,177
050,26,157,"Michigan","Tuscola County",2,81,292,125,167
050,26,157,"Michigan","Tuscola County",2,82,287,125,162
050,26,157,"Michigan","Tuscola County",2,83,239,110,129
050,26,157,"Michigan","Tuscola County",2,84,207,94,113
050,26,157,"Michigan","Tuscola County",2,85,1093,410,683
050,26,157,"Michigan","Tuscola County",3,0,499,269,230
050,26,157,"Michigan","Tuscola County",3,1,534,300,234
050,26,157,"Michigan","Tuscola County",3,2,528,272,256
050,26,157,"Michigan","Tuscola County",3,3,567,305,262
050,26,157,"Michigan","Tuscola County",3,4,544,268,276
050,26,157,"Michigan","Tuscola County",3,5,547,286,261
050,26,157,"Michigan","Tuscola County",3,6,589,307,282
050,26,157,"Michigan","Tuscola County",3,7,577,298,279
050,26,157,"Michigan","Tuscola County",3,8,581,294,287
050,26,157,"Michigan","Tuscola County",3,9,535,267,268
050,26,157,"Michigan","Tuscola County",3,10,548,286,262
050,26,157,"Michigan","Tuscola County",3,11,595,304,291
050,26,157,"Michigan","Tuscola County",3,12,623,333,290
050,26,157,"Michigan","Tuscola County",3,13,660,357,303
050,26,157,"Michigan","Tuscola County",3,14,657,352,305
050,26,157,"Michigan","Tuscola County",3,15,698,372,326
050,26,157,"Michigan","Tuscola County",3,16,729,412,317
050,26,157,"Michigan","Tuscola County",3,17,722,380,342
050,26,157,"Michigan","Tuscola County",3,18,583,318,265
050,26,157,"Michigan","Tuscola County",3,19,449,250,199
050,26,157,"Michigan","Tuscola County",3,20,476,256,220
050,26,157,"Michigan","Tuscola County",3,21,518,263,255
050,26,157,"Michigan","Tuscola County",3,22,539,253,286
050,26,157,"Michigan","Tuscola County",3,23,551,273,278
050,26,157,"Michigan","Tuscola County",3,24,609,317,292
050,26,157,"Michigan","Tuscola County",3,25,584,315,269
050,26,157,"Michigan","Tuscola County",3,26,592,322,270
050,26,157,"Michigan","Tuscola County",3,27,605,310,295
050,26,157,"Michigan","Tuscola County",3,28,644,330,314
050,26,157,"Michigan","Tuscola County",3,29,612,316,296
050,26,157,"Michigan","Tuscola County",3,30,609,322,287
050,26,157,"Michigan","Tuscola County",3,31,598,306,292
050,26,157,"Michigan","Tuscola County",3,32,601,310,291
050,26,157,"Michigan","Tuscola County",3,33,571,292,279
050,26,157,"Michigan","Tuscola County",3,34,555,283,272
050,26,157,"Michigan","Tuscola County",3,35,596,315,281
050,26,157,"Michigan","Tuscola County",3,36,586,306,280
050,26,157,"Michigan","Tuscola County",3,37,576,288,288
050,26,157,"Michigan","Tuscola County",3,38,609,314,295
050,26,157,"Michigan","Tuscola County",3,39,626,324,302
050,26,157,"Michigan","Tuscola County",3,40,624,309,315
050,26,157,"Michigan","Tuscola County",3,41,629,322,307
050,26,157,"Michigan","Tuscola County",3,42,615,310,305
050,26,157,"Michigan","Tuscola County",3,43,604,313,291
050,26,157,"Michigan","Tuscola County",3,44,590,309,281
050,26,157,"Michigan","Tuscola County",3,45,565,291,274
050,26,157,"Michigan","Tuscola County",3,46,582,307,275
050,26,157,"Michigan","Tuscola County",3,47,609,325,284
050,26,157,"Michigan","Tuscola County",3,48,623,315,308
050,26,157,"Michigan","Tuscola County",3,49,668,328,340
050,26,157,"Michigan","Tuscola County",3,50,739,384,355
050,26,157,"Michigan","Tuscola County",3,51,753,365,388
050,26,157,"Michigan","Tuscola County",3,52,714,356,358
050,26,157,"Michigan","Tuscola County",3,53,698,350,348
050,26,157,"Michigan","Tuscola County",3,54,728,347,381
050,26,157,"Michigan","Tuscola County",3,55,735,373,362
050,26,157,"Michigan","Tuscola County",3,56,786,396,390
050,26,157,"Michigan","Tuscola County",3,57,852,433,419
050,26,157,"Michigan","Tuscola County",3,58,879,453,426
050,26,157,"Michigan","Tuscola County",3,59,887,462,425
050,26,157,"Michigan","Tuscola County",3,60,886,468,418
050,26,157,"Michigan","Tuscola County",3,61,856,431,425
050,26,157,"Michigan","Tuscola County",3,62,842,427,415
050,26,157,"Michigan","Tuscola County",3,63,888,456,432
050,26,157,"Michigan","Tuscola County",3,64,873,448,425
050,26,157,"Michigan","Tuscola County",3,65,833,414,419
050,26,157,"Michigan","Tuscola County",3,66,798,401,397
050,26,157,"Michigan","Tuscola County",3,67,769,384,385
050,26,157,"Michigan","Tuscola County",3,68,701,340,361
050,26,157,"Michigan","Tuscola County",3,69,673,331,342
050,26,157,"Michigan","Tuscola County",3,70,652,328,324
050,26,157,"Michigan","Tuscola County",3,71,609,298,311
050,26,157,"Michigan","Tuscola County",3,72,584,279,305
050,26,157,"Michigan","Tuscola County",3,73,569,278,291
050,26,157,"Michigan","Tuscola County",3,74,612,294,318
050,26,157,"Michigan","Tuscola County",3,75,419,203,216
050,26,157,"Michigan","Tuscola County",3,76,446,221,225
050,26,157,"Michigan","Tuscola County",3,77,428,204,224
050,26,157,"Michigan","Tuscola County",3,78,439,215,224
050,26,157,"Michigan","Tuscola County",3,79,371,173,198
050,26,157,"Michigan","Tuscola County",3,80,330,144,186
050,26,157,"Michigan","Tuscola County",3,81,299,134,165
050,26,157,"Michigan","Tuscola County",3,82,263,112,151
050,26,157,"Michigan","Tuscola County",3,83,268,114,154
050,26,157,"Michigan","Tuscola County",3,84,210,97,113
050,26,157,"Michigan","Tuscola County",3,85,1114,426,688
050,26,157,"Michigan","Tuscola County",4,0,498,261,237
050,26,157,"Michigan","Tuscola County",4,1,515,275,240
050,26,157,"Michigan","Tuscola County",4,2,538,296,242
050,26,157,"Michigan","Tuscola County",4,3,518,260,258
050,26,157,"Michigan","Tuscola County",4,4,580,309,271
050,26,157,"Michigan","Tuscola County",4,5,558,284,274
050,26,157,"Michigan","Tuscola County",4,6,556,293,263
050,26,157,"Michigan","Tuscola County",4,7,598,305,293
050,26,157,"Michigan","Tuscola County",4,8,579,300,279
050,26,157,"Michigan","Tuscola County",4,9,584,299,285
050,26,157,"Michigan","Tuscola County",4,10,530,264,266
050,26,157,"Michigan","Tuscola County",4,11,550,295,255
050,26,157,"Michigan","Tuscola County",4,12,607,310,297
050,26,157,"Michigan","Tuscola County",4,13,636,332,304
050,26,157,"Michigan","Tuscola County",4,14,667,357,310
050,26,157,"Michigan","Tuscola County",4,15,686,381,305
050,26,157,"Michigan","Tuscola County",4,16,763,429,334
050,26,157,"Michigan","Tuscola County",4,17,697,385,312
050,26,157,"Michigan","Tuscola County",4,18,557,301,256
050,26,157,"Michigan","Tuscola County",4,19,432,235,197
050,26,157,"Michigan","Tuscola County",4,20,477,264,213
050,26,157,"Michigan","Tuscola County",4,21,498,273,225
050,26,157,"Michigan","Tuscola County",4,22,545,269,276
050,26,157,"Michigan","Tuscola County",4,23,589,270,319
050,26,157,"Michigan","Tuscola County",4,24,538,280,258
050,26,157,"Michigan","Tuscola County",4,25,569,296,273
050,26,157,"Michigan","Tuscola County",4,26,574,313,261
050,26,157,"Michigan","Tuscola County",4,27,599,323,276
050,26,157,"Michigan","Tuscola County",4,28,619,320,299
050,26,157,"Michigan","Tuscola County",4,29,664,348,316
050,26,157,"Michigan","Tuscola County",4,30,613,302,311
050,26,157,"Michigan","Tuscola County",4,31,627,325,302
050,26,157,"Michigan","Tuscola County",4,32,620,326,294
050,26,157,"Michigan","Tuscola County",4,33,627,324,303
050,26,157,"Michigan","Tuscola County",4,34,597,307,290
050,26,157,"Michigan","Tuscola County",4,35,563,289,274
050,26,157,"Michigan","Tuscola County",4,36,593,308,285
050,26,157,"Michigan","Tuscola County",4,37,605,325,280
050,26,157,"Michigan","Tuscola County",4,38,583,296,287
050,26,157,"Michigan","Tuscola County",4,39,633,321,312
050,26,157,"Michigan","Tuscola County",4,40,637,342,295
050,26,157,"Michigan","Tuscola County",4,41,627,305,322
050,26,157,"Michigan","Tuscola County",4,42,646,337,309
050,26,157,"Michigan","Tuscola County",4,43,625,313,312
050,26,157,"Michigan","Tuscola County",4,44,601,306,295
050,26,157,"Michigan","Tuscola County",4,45,594,305,289
050,26,157,"Michigan","Tuscola County",4,46,574,302,272
050,26,157,"Michigan","Tuscola County",4,47,589,306,283
050,26,157,"Michigan","Tuscola County",4,48,627,336,291
050,26,157,"Michigan","Tuscola County",4,49,620,314,306
050,26,157,"Michigan","Tuscola County",4,50,666,333,333
050,26,157,"Michigan","Tuscola County",4,51,734,378,356
050,26,157,"Michigan","Tuscola County",4,52,755,365,390
050,26,157,"Michigan","Tuscola County",4,53,721,359,362
050,26,157,"Michigan","Tuscola County",4,54,704,351,353
050,26,157,"Michigan","Tuscola County",4,55,720,346,374
050,26,157,"Michigan","Tuscola County",4,56,731,369,362
050,26,157,"Michigan","Tuscola County",4,57,778,402,376
050,26,157,"Michigan","Tuscola County",4,58,841,432,409
050,26,157,"Michigan","Tuscola County",4,59,870,447,423
050,26,157,"Michigan","Tuscola County",4,60,887,461,426
050,26,157,"Michigan","Tuscola County",4,61,878,463,415
050,26,157,"Michigan","Tuscola County",4,62,838,425,413
050,26,157,"Michigan","Tuscola County",4,63,847,427,420
050,26,157,"Michigan","Tuscola County",4,64,875,449,426
050,26,157,"Michigan","Tuscola County",4,65,867,440,427
050,26,157,"Michigan","Tuscola County",4,66,815,403,412
050,26,157,"Michigan","Tuscola County",4,67,777,395,382
050,26,157,"Michigan","Tuscola County",4,68,741,360,381
050,26,157,"Michigan","Tuscola County",4,69,692,336,356
050,26,157,"Michigan","Tuscola County",4,70,655,326,329
050,26,157,"Michigan","Tuscola County",4,71,624,316,308
050,26,157,"Michigan","Tuscola County",4,72,584,282,302
050,26,157,"Michigan","Tuscola County",4,73,561,273,288
050,26,157,"Michigan","Tuscola County",4,74,533,252,281
050,26,157,"Michigan","Tuscola County",4,75,574,273,301
050,26,157,"Michigan","Tuscola County",4,76,406,196,210
050,26,157,"Michigan","Tuscola County",4,77,413,204,209
050,26,157,"Michigan","Tuscola County",4,78,405,188,217
050,26,157,"Michigan","Tuscola County",4,79,412,198,214
050,26,157,"Michigan","Tuscola County",4,80,332,152,180
050,26,157,"Michigan","Tuscola County",4,81,296,130,166
050,26,157,"Michigan","Tuscola County",4,82,271,117,154
050,26,157,"Michigan","Tuscola County",4,83,241,101,140
050,26,157,"Michigan","Tuscola County",4,84,231,101,130
050,26,157,"Michigan","Tuscola County",4,85,1111,430,681
050,26,157,"Michigan","Tuscola County",5,0,489,258,231
050,26,157,"Michigan","Tuscola County",5,1,508,261,247
050,26,157,"Michigan","Tuscola County",5,2,504,262,242
050,26,157,"Michigan","Tuscola County",5,3,529,286,243
050,26,157,"Michigan","Tuscola County",5,4,519,253,266
050,26,157,"Michigan","Tuscola County",5,5,579,311,268
050,26,157,"Michigan","Tuscola County",5,6,562,280,282
050,26,157,"Michigan","Tuscola County",5,7,571,299,272
050,26,157,"Michigan","Tuscola County",5,8,583,297,286
050,26,157,"Michigan","Tuscola County",5,9,587,312,275
050,26,157,"Michigan","Tuscola County",5,10,591,304,287
050,26,157,"Michigan","Tuscola County",5,11,532,269,263
050,26,157,"Michigan","Tuscola County",5,12,554,297,257
050,26,157,"Michigan","Tuscola County",5,13,612,307,305
050,26,157,"Michigan","Tuscola County",5,14,641,332,309
050,26,157,"Michigan","Tuscola County",5,15,693,373,320
050,26,157,"Michigan","Tuscola County",5,16,745,441,304
050,26,157,"Michigan","Tuscola County",5,17,718,390,328
050,26,157,"Michigan","Tuscola County",5,18,548,304,244
050,26,157,"Michigan","Tuscola County",5,19,433,236,197
050,26,157,"Michigan","Tuscola County",5,20,469,252,217
050,26,157,"Michigan","Tuscola County",5,21,491,267,224
050,26,157,"Michigan","Tuscola County",5,22,532,280,252
050,26,157,"Michigan","Tuscola County",5,23,574,287,287
050,26,157,"Michigan","Tuscola County",5,24,585,290,295
050,26,157,"Michigan","Tuscola County",5,25,540,281,259
050,26,157,"Michigan","Tuscola County",5,26,578,305,273
050,26,157,"Michigan","Tuscola County",5,27,588,321,267
050,26,157,"Michigan","Tuscola County",5,28,625,332,293
050,26,157,"Michigan","Tuscola County",5,29,632,329,303
050,26,157,"Michigan","Tuscola County",5,30,654,351,303
050,26,157,"Michigan","Tuscola County",5,31,607,301,306
050,26,157,"Michigan","Tuscola County",5,32,655,343,312
050,26,157,"Michigan","Tuscola County",5,33,615,321,294
050,26,157,"Michigan","Tuscola County",5,34,632,321,311
050,26,157,"Michigan","Tuscola County",5,35,601,313,288
050,26,157,"Michigan","Tuscola County",5,36,583,302,281
050,26,157,"Michigan","Tuscola County",5,37,600,304,296
050,26,157,"Michigan","Tuscola County",5,38,601,332,269
050,26,157,"Michigan","Tuscola County",5,39,598,302,296
050,26,157,"Michigan","Tuscola County",5,40,639,324,315
050,26,157,"Michigan","Tuscola County",5,41,638,344,294
050,26,157,"Michigan","Tuscola County",5,42,635,309,326
050,26,157,"Michigan","Tuscola County",5,43,661,342,319
050,26,157,"Michigan","Tuscola County",5,44,625,315,310
050,26,157,"Michigan","Tuscola County",5,45,599,309,290
050,26,157,"Michigan","Tuscola County",5,46,583,304,279
050,26,157,"Michigan","Tuscola County",5,47,575,303,272
050,26,157,"Michigan","Tuscola County",5,48,606,318,288
050,26,157,"Michigan","Tuscola County",5,49,614,326,288
050,26,157,"Michigan","Tuscola County",5,50,614,313,301
050,26,157,"Michigan","Tuscola County",5,51,677,337,340
050,26,157,"Michigan","Tuscola County",5,52,724,372,352
050,26,157,"Michigan","Tuscola County",5,53,753,361,392
050,26,157,"Michigan","Tuscola County",5,54,740,369,371
050,26,157,"Michigan","Tuscola County",5,55,696,346,350
050,26,157,"Michigan","Tuscola County",5,56,725,349,376
050,26,157,"Michigan","Tuscola County",5,57,717,365,352
050,26,157,"Michigan","Tuscola County",5,58,785,407,378
050,26,157,"Michigan","Tuscola County",5,59,844,434,410
050,26,157,"Michigan","Tuscola County",5,60,855,440,415
050,26,157,"Michigan","Tuscola County",5,61,880,456,424
050,26,157,"Michigan","Tuscola County",5,62,855,448,407
050,26,157,"Michigan","Tuscola County",5,63,832,422,410
050,26,157,"Michigan","Tuscola County",5,64,840,419,421
050,26,157,"Michigan","Tuscola County",5,65,866,443,423
050,26,157,"Michigan","Tuscola County",5,66,863,443,420
050,26,157,"Michigan","Tuscola County",5,67,810,405,405
050,26,157,"Michigan","Tuscola County",5,68,748,379,369
050,26,157,"Michigan","Tuscola County",5,69,724,348,376
050,26,157,"Michigan","Tuscola County",5,70,674,333,341
050,26,157,"Michigan","Tuscola County",5,71,636,315,321
050,26,157,"Michigan","Tuscola County",5,72,605,303,302
050,26,157,"Michigan","Tuscola County",5,73,571,281,290
050,26,157,"Michigan","Tuscola County",5,74,539,258,281
050,26,157,"Michigan","Tuscola County",5,75,516,241,275
050,26,157,"Michigan","Tuscola County",5,76,554,266,288
050,26,157,"Michigan","Tuscola County",5,77,386,185,201
050,26,157,"Michigan","Tuscola County",5,78,394,193,201
050,26,157,"Michigan","Tuscola County",5,79,384,176,208
050,26,157,"Michigan","Tuscola County",5,80,379,180,199
050,26,157,"Michigan","Tuscola County",5,81,308,143,165
050,26,157,"Michigan","Tuscola County",5,82,277,123,154
050,26,157,"Michigan","Tuscola County",5,83,256,110,146
050,26,157,"Michigan","Tuscola County",5,84,210,90,120
050,26,157,"Michigan","Tuscola County",5,85,1156,450,706
050,26,159,"Michigan","Van Buren County",1,0,776,394,382
050,26,159,"Michigan","Van Buren County",1,1,869,443,426
050,26,159,"Michigan","Van Buren County",1,2,921,481,440
050,26,159,"Michigan","Van Buren County",1,3,961,500,461
050,26,159,"Michigan","Van Buren County",1,4,942,498,444
050,26,159,"Michigan","Van Buren County",1,5,949,470,479
050,26,159,"Michigan","Van Buren County",1,6,983,498,485
050,26,159,"Michigan","Van Buren County",1,7,990,510,480
050,26,159,"Michigan","Van Buren County",1,8,972,490,482
050,26,159,"Michigan","Van Buren County",1,9,982,495,487
050,26,159,"Michigan","Van Buren County",1,10,1012,508,504
050,26,159,"Michigan","Van Buren County",1,11,1000,525,475
050,26,159,"Michigan","Van Buren County",1,12,1086,545,541
050,26,159,"Michigan","Van Buren County",1,13,1079,542,537
050,26,159,"Michigan","Van Buren County",1,14,1060,515,545
050,26,159,"Michigan","Van Buren County",1,15,1053,508,545
050,26,159,"Michigan","Van Buren County",1,16,1027,524,503
050,26,159,"Michigan","Van Buren County",1,17,997,513,484
050,26,159,"Michigan","Van Buren County",1,18,932,503,429
050,26,159,"Michigan","Van Buren County",1,19,755,410,345
050,26,159,"Michigan","Van Buren County",1,20,771,398,373
050,26,159,"Michigan","Van Buren County",1,21,802,402,400
050,26,159,"Michigan","Van Buren County",1,22,803,417,386
050,26,159,"Michigan","Van Buren County",1,23,802,396,406
050,26,159,"Michigan","Van Buren County",1,24,846,435,411
050,26,159,"Michigan","Van Buren County",1,25,863,452,411
050,26,159,"Michigan","Van Buren County",1,26,818,417,401
050,26,159,"Michigan","Van Buren County",1,27,821,411,410
050,26,159,"Michigan","Van Buren County",1,28,840,427,413
050,26,159,"Michigan","Van Buren County",1,29,828,409,419
050,26,159,"Michigan","Van Buren County",1,30,845,423,422
050,26,159,"Michigan","Van Buren County",1,31,855,422,433
050,26,159,"Michigan","Van Buren County",1,32,838,442,396
050,26,159,"Michigan","Van Buren County",1,33,824,452,372
050,26,159,"Michigan","Van Buren County",1,34,845,427,418
050,26,159,"Michigan","Van Buren County",1,35,882,443,439
050,26,159,"Michigan","Van Buren County",1,36,889,437,452
050,26,159,"Michigan","Van Buren County",1,37,934,484,450
050,26,159,"Michigan","Van Buren County",1,38,927,460,467
050,26,159,"Michigan","Van Buren County",1,39,914,477,437
050,26,159,"Michigan","Van Buren County",1,40,953,454,499
050,26,159,"Michigan","Van Buren County",1,41,900,440,460
050,26,159,"Michigan","Van Buren County",1,42,882,459,423
050,26,159,"Michigan","Van Buren County",1,43,816,419,397
050,26,159,"Michigan","Van Buren County",1,44,835,402,433
050,26,159,"Michigan","Van Buren County",1,45,869,416,453
050,26,159,"Michigan","Van Buren County",1,46,840,407,433
050,26,159,"Michigan","Van Buren County",1,47,862,426,436
050,26,159,"Michigan","Van Buren County",1,48,926,442,484
050,26,159,"Michigan","Van Buren County",1,49,1018,498,520
050,26,159,"Michigan","Van Buren County",1,50,982,493,489
050,26,159,"Michigan","Van Buren County",1,51,950,475,475
050,26,159,"Michigan","Van Buren County",1,52,918,460,458
050,26,159,"Michigan","Van Buren County",1,53,991,500,491
050,26,159,"Michigan","Van Buren County",1,54,999,488,511
050,26,159,"Michigan","Van Buren County",1,55,1052,524,528
050,26,159,"Michigan","Van Buren County",1,56,1130,562,568
050,26,159,"Michigan","Van Buren County",1,57,1129,573,556
050,26,159,"Michigan","Van Buren County",1,58,1156,574,582
050,26,159,"Michigan","Van Buren County",1,59,1211,587,624
050,26,159,"Michigan","Van Buren County",1,60,1177,569,608
050,26,159,"Michigan","Van Buren County",1,61,1136,570,566
050,26,159,"Michigan","Van Buren County",1,62,1191,585,606
050,26,159,"Michigan","Van Buren County",1,63,1168,556,612
050,26,159,"Michigan","Van Buren County",1,64,1132,563,569
050,26,159,"Michigan","Van Buren County",1,65,1097,547,550
050,26,159,"Michigan","Van Buren County",1,66,1064,539,525
050,26,159,"Michigan","Van Buren County",1,67,1022,506,516
050,26,159,"Michigan","Van Buren County",1,68,1011,488,523
050,26,159,"Michigan","Van Buren County",1,69,887,445,442
050,26,159,"Michigan","Van Buren County",1,70,850,433,417
050,26,159,"Michigan","Van Buren County",1,71,854,403,451
050,26,159,"Michigan","Van Buren County",1,72,795,385,410
050,26,159,"Michigan","Van Buren County",1,73,770,386,384
050,26,159,"Michigan","Van Buren County",1,74,540,266,274
050,26,159,"Michigan","Van Buren County",1,75,537,255,282
050,26,159,"Michigan","Van Buren County",1,76,564,267,297
050,26,159,"Michigan","Van Buren County",1,77,537,266,271
050,26,159,"Michigan","Van Buren County",1,78,470,227,243
050,26,159,"Michigan","Van Buren County",1,79,383,169,214
050,26,159,"Michigan","Van Buren County",1,80,331,147,184
050,26,159,"Michigan","Van Buren County",1,81,321,147,174
050,26,159,"Michigan","Van Buren County",1,82,296,128,168
050,26,159,"Michigan","Van Buren County",1,83,233,110,123
050,26,159,"Michigan","Van Buren County",1,84,228,95,133
050,26,159,"Michigan","Van Buren County",1,85,1279,478,801
050,26,159,"Michigan","Van Buren County",2,0,772,405,367
050,26,159,"Michigan","Van Buren County",2,1,847,432,415
050,26,159,"Michigan","Van Buren County",2,2,913,473,440
050,26,159,"Michigan","Van Buren County",2,3,952,496,456
050,26,159,"Michigan","Van Buren County",2,4,955,500,455
050,26,159,"Michigan","Van Buren County",2,5,953,480,473
050,26,159,"Michigan","Van Buren County",2,6,979,494,485
050,26,159,"Michigan","Van Buren County",2,7,987,503,484
050,26,159,"Michigan","Van Buren County",2,8,975,490,485
050,26,159,"Michigan","Van Buren County",2,9,981,494,487
050,26,159,"Michigan","Van Buren County",2,10,1002,502,500
050,26,159,"Michigan","Van Buren County",2,11,996,517,479
050,26,159,"Michigan","Van Buren County",2,12,1064,540,524
050,26,159,"Michigan","Van Buren County",2,13,1078,541,537
050,26,159,"Michigan","Van Buren County",2,14,1067,522,545
050,26,159,"Michigan","Van Buren County",2,15,1053,509,544
050,26,159,"Michigan","Van Buren County",2,16,1030,519,511
050,26,159,"Michigan","Van Buren County",2,17,1003,515,488
050,26,159,"Michigan","Van Buren County",2,18,901,485,416
050,26,159,"Michigan","Van Buren County",2,19,757,410,347
050,26,159,"Michigan","Van Buren County",2,20,783,408,375
050,26,159,"Michigan","Van Buren County",2,21,796,403,393
050,26,159,"Michigan","Van Buren County",2,22,806,414,392
050,26,159,"Michigan","Van Buren County",2,23,814,407,407
050,26,159,"Michigan","Van Buren County",2,24,837,424,413
050,26,159,"Michigan","Van Buren County",2,25,860,446,414
050,26,159,"Michigan","Van Buren County",2,26,835,426,409
050,26,159,"Michigan","Van Buren County",2,27,822,412,410
050,26,159,"Michigan","Van Buren County",2,28,839,423,416
050,26,159,"Michigan","Van Buren County",2,29,829,411,418
050,26,159,"Michigan","Van Buren County",2,30,852,423,429
050,26,159,"Michigan","Van Buren County",2,31,850,421,429
050,26,159,"Michigan","Van Buren County",2,32,843,441,402
050,26,159,"Michigan","Van Buren County",2,33,828,451,377
050,26,159,"Michigan","Van Buren County",2,34,840,433,407
050,26,159,"Michigan","Van Buren County",2,35,879,440,439
050,26,159,"Michigan","Van Buren County",2,36,882,437,445
050,26,159,"Michigan","Van Buren County",2,37,925,471,454
050,26,159,"Michigan","Van Buren County",2,38,936,472,464
050,26,159,"Michigan","Van Buren County",2,39,912,470,442
050,26,159,"Michigan","Van Buren County",2,40,950,464,486
050,26,159,"Michigan","Van Buren County",2,41,911,444,467
050,26,159,"Michigan","Van Buren County",2,42,883,453,430
050,26,159,"Michigan","Van Buren County",2,43,834,430,404
050,26,159,"Michigan","Van Buren County",2,44,822,401,421
050,26,159,"Michigan","Van Buren County",2,45,863,413,450
050,26,159,"Michigan","Van Buren County",2,46,844,409,435
050,26,159,"Michigan","Van Buren County",2,47,853,417,436
050,26,159,"Michigan","Van Buren County",2,48,912,439,473
050,26,159,"Michigan","Van Buren County",2,49,1002,490,512
050,26,159,"Michigan","Van Buren County",2,50,993,495,498
050,26,159,"Michigan","Van Buren County",2,51,953,478,475
050,26,159,"Michigan","Van Buren County",2,52,923,462,461
050,26,159,"Michigan","Van Buren County",2,53,969,488,481
050,26,159,"Michigan","Van Buren County",2,54,993,491,502
050,26,159,"Michigan","Van Buren County",2,55,1046,517,529
050,26,159,"Michigan","Van Buren County",2,56,1119,556,563
050,26,159,"Michigan","Van Buren County",2,57,1134,572,562
050,26,159,"Michigan","Van Buren County",2,58,1142,570,572
050,26,159,"Michigan","Van Buren County",2,59,1197,581,616
050,26,159,"Michigan","Van Buren County",2,60,1180,569,611
050,26,159,"Michigan","Van Buren County",2,61,1143,568,575
050,26,159,"Michigan","Van Buren County",2,62,1171,578,593
050,26,159,"Michigan","Van Buren County",2,63,1182,568,614
050,26,159,"Michigan","Van Buren County",2,64,1133,556,577
050,26,159,"Michigan","Van Buren County",2,65,1108,552,556
050,26,159,"Michigan","Van Buren County",2,66,1067,537,530
050,26,159,"Michigan","Van Buren County",2,67,1024,511,513
050,26,159,"Michigan","Van Buren County",2,68,1003,487,516
050,26,159,"Michigan","Van Buren County",2,69,922,460,462
050,26,159,"Michigan","Van Buren County",2,70,852,432,420
050,26,159,"Michigan","Van Buren County",2,71,849,409,440
050,26,159,"Michigan","Van Buren County",2,72,793,381,412
050,26,159,"Michigan","Van Buren County",2,73,815,404,411
050,26,159,"Michigan","Van Buren County",2,74,556,275,281
050,26,159,"Michigan","Van Buren County",2,75,535,257,278
050,26,159,"Michigan","Van Buren County",2,76,548,258,290
050,26,159,"Michigan","Van Buren County",2,77,547,266,281
050,26,159,"Michigan","Van Buren County",2,78,472,230,242
050,26,159,"Michigan","Van Buren County",2,79,395,179,216
050,26,159,"Michigan","Van Buren County",2,80,341,151,190
050,26,159,"Michigan","Van Buren County",2,81,321,145,176
050,26,159,"Michigan","Van Buren County",2,82,300,132,168
050,26,159,"Michigan","Van Buren County",2,83,235,108,127
050,26,159,"Michigan","Van Buren County",2,84,226,99,127
050,26,159,"Michigan","Van Buren County",2,85,1280,484,796
050,26,159,"Michigan","Van Buren County",3,0,802,388,414
050,26,159,"Michigan","Van Buren County",3,1,811,416,395
050,26,159,"Michigan","Van Buren County",3,2,855,438,417
050,26,159,"Michigan","Van Buren County",3,3,925,494,431
050,26,159,"Michigan","Van Buren County",3,4,943,493,450
050,26,159,"Michigan","Van Buren County",3,5,976,496,480
050,26,159,"Michigan","Van Buren County",3,6,963,487,476
050,26,159,"Michigan","Van Buren County",3,7,991,497,494
050,26,159,"Michigan","Van Buren County",3,8,1002,517,485
050,26,159,"Michigan","Van Buren County",3,9,977,499,478
050,26,159,"Michigan","Van Buren County",3,10,995,506,489
050,26,159,"Michigan","Van Buren County",3,11,1001,492,509
050,26,159,"Michigan","Van Buren County",3,12,994,521,473
050,26,159,"Michigan","Van Buren County",3,13,1091,553,538
050,26,159,"Michigan","Van Buren County",3,14,1078,548,530
050,26,159,"Michigan","Van Buren County",3,15,1066,525,541
050,26,159,"Michigan","Van Buren County",3,16,1054,515,539
050,26,159,"Michigan","Van Buren County",3,17,1008,490,518
050,26,159,"Michigan","Van Buren County",3,18,867,460,407
050,26,159,"Michigan","Van Buren County",3,19,746,397,349
050,26,159,"Michigan","Van Buren County",3,20,780,412,368
050,26,159,"Michigan","Van Buren County",3,21,801,404,397
050,26,159,"Michigan","Van Buren County",3,22,829,417,412
050,26,159,"Michigan","Van Buren County",3,23,815,421,394
050,26,159,"Michigan","Van Buren County",3,24,825,418,407
050,26,159,"Michigan","Van Buren County",3,25,815,423,392
050,26,159,"Michigan","Van Buren County",3,26,852,443,409
050,26,159,"Michigan","Van Buren County",3,27,863,429,434
050,26,159,"Michigan","Van Buren County",3,28,863,445,418
050,26,159,"Michigan","Van Buren County",3,29,870,448,422
050,26,159,"Michigan","Van Buren County",3,30,858,418,440
050,26,159,"Michigan","Van Buren County",3,31,886,445,441
050,26,159,"Michigan","Van Buren County",3,32,877,427,450
050,26,159,"Michigan","Van Buren County",3,33,855,451,404
050,26,159,"Michigan","Van Buren County",3,34,850,464,386
050,26,159,"Michigan","Van Buren County",3,35,834,436,398
050,26,159,"Michigan","Van Buren County",3,36,897,449,448
050,26,159,"Michigan","Van Buren County",3,37,912,445,467
050,26,159,"Michigan","Van Buren County",3,38,937,469,468
050,26,159,"Michigan","Van Buren County",3,39,949,479,470
050,26,159,"Michigan","Van Buren County",3,40,922,473,449
050,26,159,"Michigan","Van Buren County",3,41,955,457,498
050,26,159,"Michigan","Van Buren County",3,42,917,435,482
050,26,159,"Michigan","Van Buren County",3,43,878,449,429
050,26,159,"Michigan","Van Buren County",3,44,823,428,395
050,26,159,"Michigan","Van Buren County",3,45,829,398,431
050,26,159,"Michigan","Van Buren County",3,46,860,418,442
050,26,159,"Michigan","Van Buren County",3,47,840,405,435
050,26,159,"Michigan","Van Buren County",3,48,851,419,432
050,26,159,"Michigan","Van Buren County",3,49,899,421,478
050,26,159,"Michigan","Van Buren County",3,50,994,487,507
050,26,159,"Michigan","Van Buren County",3,51,999,498,501
050,26,159,"Michigan","Van Buren County",3,52,954,475,479
050,26,159,"Michigan","Van Buren County",3,53,918,461,457
050,26,159,"Michigan","Van Buren County",3,54,975,491,484
050,26,159,"Michigan","Van Buren County",3,55,968,473,495
050,26,159,"Michigan","Van Buren County",3,56,1031,513,518
050,26,159,"Michigan","Van Buren County",3,57,1095,547,548
050,26,159,"Michigan","Van Buren County",3,58,1140,562,578
050,26,159,"Michigan","Van Buren County",3,59,1147,573,574
050,26,159,"Michigan","Van Buren County",3,60,1179,573,606
050,26,159,"Michigan","Van Buren County",3,61,1168,569,599
050,26,159,"Michigan","Van Buren County",3,62,1132,567,565
050,26,159,"Michigan","Van Buren County",3,63,1165,569,596
050,26,159,"Michigan","Van Buren County",3,64,1166,563,603
050,26,159,"Michigan","Van Buren County",3,65,1115,548,567
050,26,159,"Michigan","Van Buren County",3,66,1092,540,552
050,26,159,"Michigan","Van Buren County",3,67,1045,521,524
050,26,159,"Michigan","Van Buren County",3,68,1019,510,509
050,26,159,"Michigan","Van Buren County",3,69,974,475,499
050,26,159,"Michigan","Van Buren County",3,70,885,435,450
050,26,159,"Michigan","Van Buren County",3,71,825,418,407
050,26,159,"Michigan","Van Buren County",3,72,828,396,432
050,26,159,"Michigan","Van Buren County",3,73,773,374,399
050,26,159,"Michigan","Van Buren County",3,74,780,389,391
050,26,159,"Michigan","Van Buren County",3,75,529,261,268
050,26,159,"Michigan","Van Buren County",3,76,519,249,270
050,26,159,"Michigan","Van Buren County",3,77,518,246,272
050,26,159,"Michigan","Van Buren County",3,78,524,256,268
050,26,159,"Michigan","Van Buren County",3,79,448,216,232
050,26,159,"Michigan","Van Buren County",3,80,379,167,212
050,26,159,"Michigan","Van Buren County",3,81,313,140,173
050,26,159,"Michigan","Van Buren County",3,82,270,114,156
050,26,159,"Michigan","Van Buren County",3,83,264,115,149
050,26,159,"Michigan","Van Buren County",3,84,215,98,117
050,26,159,"Michigan","Van Buren County",3,85,1245,479,766
050,26,159,"Michigan","Van Buren County",4,0,806,401,405
050,26,159,"Michigan","Van Buren County",4,1,830,405,425
050,26,159,"Michigan","Van Buren County",4,2,822,413,409
050,26,159,"Michigan","Van Buren County",4,3,869,445,424
050,26,159,"Michigan","Van Buren County",4,4,926,498,428
050,26,159,"Michigan","Van Buren County",4,5,964,512,452
050,26,159,"Michigan","Van Buren County",4,6,996,515,481
050,26,159,"Michigan","Van Buren County",4,7,971,488,483
050,26,159,"Michigan","Van Buren County",4,8,1005,509,496
050,26,159,"Michigan","Van Buren County",4,9,980,505,475
050,26,159,"Michigan","Van Buren County",4,10,969,492,477
050,26,159,"Michigan","Van Buren County",4,11,982,501,481
050,26,159,"Michigan","Van Buren County",4,12,1018,501,517
050,26,159,"Michigan","Van Buren County",4,13,1008,521,487
050,26,159,"Michigan","Van Buren County",4,14,1069,547,522
050,26,159,"Michigan","Van Buren County",4,15,1075,547,528
050,26,159,"Michigan","Van Buren County",4,16,1041,512,529
050,26,159,"Michigan","Van Buren County",4,17,1056,522,534
050,26,159,"Michigan","Van Buren County",4,18,883,450,433
050,26,159,"Michigan","Van Buren County",4,19,708,379,329
050,26,159,"Michigan","Van Buren County",4,20,765,408,357
050,26,159,"Michigan","Van Buren County",4,21,769,402,367
050,26,159,"Michigan","Van Buren County",4,22,849,438,411
050,26,159,"Michigan","Van Buren County",4,23,872,438,434
050,26,159,"Michigan","Van Buren County",4,24,806,417,389
050,26,159,"Michigan","Van Buren County",4,25,844,422,422
050,26,159,"Michigan","Van Buren County",4,26,804,426,378
050,26,159,"Michigan","Van Buren County",4,27,873,455,418
050,26,159,"Michigan","Van Buren County",4,28,885,438,447
050,26,159,"Michigan","Van Buren County",4,29,867,453,414
050,26,159,"Michigan","Van Buren County",4,30,890,455,435
050,26,159,"Michigan","Van Buren County",4,31,877,423,454
050,26,159,"Michigan","Van Buren County",4,32,884,453,431
050,26,159,"Michigan","Van Buren County",4,33,889,449,440
050,26,159,"Michigan","Van Buren County",4,34,857,448,409
050,26,159,"Michigan","Van Buren County",4,35,861,467,394
050,26,159,"Michigan","Van Buren County",4,36,851,443,408
050,26,159,"Michigan","Van Buren County",4,37,894,441,453
050,26,159,"Michigan","Van Buren County",4,38,914,444,470
050,26,159,"Michigan","Van Buren County",4,39,921,469,452
050,26,159,"Michigan","Van Buren County",4,40,952,483,469
050,26,159,"Michigan","Van Buren County",4,41,927,471,456
050,26,159,"Michigan","Van Buren County",4,42,947,456,491
050,26,159,"Michigan","Van Buren County",4,43,916,436,480
050,26,159,"Michigan","Van Buren County",4,44,878,454,424
050,26,159,"Michigan","Van Buren County",4,45,804,417,387
050,26,159,"Michigan","Van Buren County",4,46,833,404,429
050,26,159,"Michigan","Van Buren County",4,47,860,422,438
050,26,159,"Michigan","Van Buren County",4,48,841,408,433
050,26,159,"Michigan","Van Buren County",4,49,855,420,435
050,26,159,"Michigan","Van Buren County",4,50,898,424,474
050,26,159,"Michigan","Van Buren County",4,51,982,485,497
050,26,159,"Michigan","Van Buren County",4,52,1003,495,508
050,26,159,"Michigan","Van Buren County",4,53,948,483,465
050,26,159,"Michigan","Van Buren County",4,54,900,459,441
050,26,159,"Michigan","Van Buren County",4,55,981,494,487
050,26,159,"Michigan","Van Buren County",4,56,946,467,479
050,26,159,"Michigan","Van Buren County",4,57,1017,501,516
050,26,159,"Michigan","Van Buren County",4,58,1092,538,554
050,26,159,"Michigan","Van Buren County",4,59,1126,553,573
050,26,159,"Michigan","Van Buren County",4,60,1129,556,573
050,26,159,"Michigan","Van Buren County",4,61,1167,564,603
050,26,159,"Michigan","Van Buren County",4,62,1161,562,599
050,26,159,"Michigan","Van Buren County",4,63,1123,558,565
050,26,159,"Michigan","Van Buren County",4,64,1167,576,591
050,26,159,"Michigan","Van Buren County",4,65,1158,563,595
050,26,159,"Michigan","Van Buren County",4,66,1111,541,570
050,26,159,"Michigan","Van Buren County",4,67,1075,528,547
050,26,159,"Michigan","Van Buren County",4,68,1030,513,517
050,26,159,"Michigan","Van Buren County",4,69,1013,510,503
050,26,159,"Michigan","Van Buren County",4,70,967,469,498
050,26,159,"Michigan","Van Buren County",4,71,872,428,444
050,26,159,"Michigan","Van Buren County",4,72,804,408,396
050,26,159,"Michigan","Van Buren County",4,73,796,377,419
050,26,159,"Michigan","Van Buren County",4,74,748,361,387
050,26,159,"Michigan","Van Buren County",4,75,747,369,378
050,26,159,"Michigan","Van Buren County",4,76,520,253,267
050,26,159,"Michigan","Van Buren County",4,77,488,232,256
050,26,159,"Michigan","Van Buren County",4,78,499,231,268
050,26,159,"Michigan","Van Buren County",4,79,476,233,243
050,26,159,"Michigan","Van Buren County",4,80,420,195,225
050,26,159,"Michigan","Van Buren County",4,81,353,154,199
050,26,159,"Michigan","Van Buren County",4,82,274,117,157
050,26,159,"Michigan","Van Buren County",4,83,247,102,145
050,26,159,"Michigan","Van Buren County",4,84,243,107,136
050,26,159,"Michigan","Van Buren County",4,85,1225,481,744
050,26,159,"Michigan","Van Buren County",5,0,806,403,403
050,26,159,"Michigan","Van Buren County",5,1,792,383,409
050,26,159,"Michigan","Van Buren County",5,2,863,427,436
050,26,159,"Michigan","Van Buren County",5,3,825,423,402
050,26,159,"Michigan","Van Buren County",5,4,890,451,439
050,26,159,"Michigan","Van Buren County",5,5,948,513,435
050,26,159,"Michigan","Van Buren County",5,6,967,503,464
050,26,159,"Michigan","Van Buren County",5,7,992,503,489
050,26,159,"Michigan","Van Buren County",5,8,989,501,488
050,26,159,"Michigan","Van Buren County",5,9,1012,507,505
050,26,159,"Michigan","Van Buren County",5,10,981,497,484
050,26,159,"Michigan","Van Buren County",5,11,991,510,481
050,26,159,"Michigan","Van Buren County",5,12,1006,511,495
050,26,159,"Michigan","Van Buren County",5,13,1018,506,512
050,26,159,"Michigan","Van Buren County",5,14,1015,521,494
050,26,159,"Michigan","Van Buren County",5,15,1082,555,527
050,26,159,"Michigan","Van Buren County",5,16,1073,548,525
050,26,159,"Michigan","Van Buren County",5,17,1044,513,531
050,26,159,"Michigan","Van Buren County",5,18,917,473,444
050,26,159,"Michigan","Van Buren County",5,19,701,372,329
050,26,159,"Michigan","Van Buren County",5,20,741,396,345
050,26,159,"Michigan","Van Buren County",5,21,785,424,361
050,26,159,"Michigan","Van Buren County",5,22,812,419,393
050,26,159,"Michigan","Van Buren County",5,23,858,443,415
050,26,159,"Michigan","Van Buren County",5,24,875,461,414
050,26,159,"Michigan","Van Buren County",5,25,830,439,391
050,26,159,"Michigan","Van Buren County",5,26,839,428,411
050,26,159,"Michigan","Van Buren County",5,27,818,422,396
050,26,159,"Michigan","Van Buren County",5,28,875,449,426
050,26,159,"Michigan","Van Buren County",5,29,907,457,450
050,26,159,"Michigan","Van Buren County",5,30,911,471,440
050,26,159,"Michigan","Van Buren County",5,31,900,453,447
050,26,159,"Michigan","Van Buren County",5,32,919,442,477
050,26,159,"Michigan","Van Buren County",5,33,890,456,434
050,26,159,"Michigan","Van Buren County",5,34,927,468,459
050,26,159,"Michigan","Van Buren County",5,35,873,454,419
050,26,159,"Michigan","Van Buren County",5,36,869,464,405
050,26,159,"Michigan","Van Buren County",5,37,846,451,395
050,26,159,"Michigan","Van Buren County",5,38,905,444,461
050,26,159,"Michigan","Van Buren County",5,39,920,456,464
050,26,159,"Michigan","Van Buren County",5,40,921,469,452
050,26,159,"Michigan","Van Buren County",5,41,947,483,464
050,26,159,"Michigan","Van Buren County",5,42,935,478,457
050,26,159,"Michigan","Van Buren County",5,43,938,447,491
050,26,159,"Michigan","Van Buren County",5,44,914,425,489
050,26,159,"Michigan","Van Buren County",5,45,882,457,425
050,26,159,"Michigan","Van Buren County",5,46,807,424,383
050,26,159,"Michigan","Van Buren County",5,47,821,401,420
050,26,159,"Michigan","Van Buren County",5,48,859,421,438
050,26,159,"Michigan","Van Buren County",5,49,853,414,439
050,26,159,"Michigan","Van Buren County",5,50,850,415,435
050,26,159,"Michigan","Van Buren County",5,51,906,430,476
050,26,159,"Michigan","Van Buren County",5,52,991,488,503
050,26,159,"Michigan","Van Buren County",5,53,996,494,502
050,26,159,"Michigan","Van Buren County",5,54,920,477,443
050,26,159,"Michigan","Van Buren County",5,55,880,445,435
050,26,159,"Michigan","Van Buren County",5,56,963,484,479
050,26,159,"Michigan","Van Buren County",5,57,930,456,474
050,26,159,"Michigan","Van Buren County",5,58,1008,488,520
050,26,159,"Michigan","Van Buren County",5,59,1096,536,560
050,26,159,"Michigan","Van Buren County",5,60,1107,537,570
050,26,159,"Michigan","Van Buren County",5,61,1099,545,554
050,26,159,"Michigan","Van Buren County",5,62,1167,569,598
050,26,159,"Michigan","Van Buren County",5,63,1123,545,578
050,26,159,"Michigan","Van Buren County",5,64,1098,548,550
050,26,159,"Michigan","Van Buren County",5,65,1158,568,590
050,26,159,"Michigan","Van Buren County",5,66,1141,551,590
050,26,159,"Michigan","Van Buren County",5,67,1088,523,565
050,26,159,"Michigan","Van Buren County",5,68,1065,516,549
050,26,159,"Michigan","Van Buren County",5,69,1013,507,506
050,26,159,"Michigan","Van Buren County",5,70,1001,497,504
050,26,159,"Michigan","Van Buren County",5,71,949,467,482
050,26,159,"Michigan","Van Buren County",5,72,843,419,424
050,26,159,"Michigan","Van Buren County",5,73,793,402,391
050,26,159,"Michigan","Van Buren County",5,74,771,361,410
050,26,159,"Michigan","Van Buren County",5,75,714,340,374
050,26,159,"Michigan","Van Buren County",5,76,734,359,375
050,26,159,"Michigan","Van Buren County",5,77,491,243,248
050,26,159,"Michigan","Van Buren County",5,78,469,221,248
050,26,159,"Michigan","Van Buren County",5,79,466,214,252
050,26,159,"Michigan","Van Buren County",5,80,444,212,232
050,26,159,"Michigan","Van Buren County",5,81,391,181,210
050,26,159,"Michigan","Van Buren County",5,82,310,135,175
050,26,159,"Michigan","Van Buren County",5,83,244,103,141
050,26,159,"Michigan","Van Buren County",5,84,228,94,134
050,26,159,"Michigan","Van Buren County",5,85,1262,501,761
050,26,161,"Michigan","Washtenaw County",1,0,3479,1774,1705
050,26,161,"Michigan","Washtenaw County",1,1,3529,1807,1722
050,26,161,"Michigan","Washtenaw County",1,2,3488,1720,1768
050,26,161,"Michigan","Washtenaw County",1,3,3619,1795,1824
050,26,161,"Michigan","Washtenaw County",1,4,3659,1894,1765
050,26,161,"Michigan","Washtenaw County",1,5,3638,1866,1772
050,26,161,"Michigan","Washtenaw County",1,6,3600,1856,1744
050,26,161,"Michigan","Washtenaw County",1,7,3700,1887,1813
050,26,161,"Michigan","Washtenaw County",1,8,3791,1952,1839
050,26,161,"Michigan","Washtenaw County",1,9,3859,2024,1835
050,26,161,"Michigan","Washtenaw County",1,10,3888,1950,1938
050,26,161,"Michigan","Washtenaw County",1,11,3906,1994,1912
050,26,161,"Michigan","Washtenaw County",1,12,4043,2083,1960
050,26,161,"Michigan","Washtenaw County",1,13,4161,2142,2019
050,26,161,"Michigan","Washtenaw County",1,14,4167,2127,2040
050,26,161,"Michigan","Washtenaw County",1,15,4112,2089,2023
050,26,161,"Michigan","Washtenaw County",1,16,4307,2202,2105
050,26,161,"Michigan","Washtenaw County",1,17,4240,2161,2079
050,26,161,"Michigan","Washtenaw County",1,18,8946,4314,4632
050,26,161,"Michigan","Washtenaw County",1,19,11917,6034,5883
050,26,161,"Michigan","Washtenaw County",1,20,10890,5360,5530
050,26,161,"Michigan","Washtenaw County",1,21,10632,5263,5369
050,26,161,"Michigan","Washtenaw County",1,22,9682,5033,4649
050,26,161,"Michigan","Washtenaw County",1,23,8153,4244,3909
050,26,161,"Michigan","Washtenaw County",1,24,7166,3724,3442
050,26,161,"Michigan","Washtenaw County",1,25,6504,3390,3114
050,26,161,"Michigan","Washtenaw County",1,26,6037,3164,2873
050,26,161,"Michigan","Washtenaw County",1,27,5582,2887,2695
050,26,161,"Michigan","Washtenaw County",1,28,5609,2936,2673
050,26,161,"Michigan","Washtenaw County",1,29,5518,2911,2607
050,26,161,"Michigan","Washtenaw County",1,30,5194,2747,2447
050,26,161,"Michigan","Washtenaw County",1,31,4982,2637,2345
050,26,161,"Michigan","Washtenaw County",1,32,4679,2475,2204
050,26,161,"Michigan","Washtenaw County",1,33,4747,2490,2257
050,26,161,"Michigan","Washtenaw County",1,34,4541,2341,2200
050,26,161,"Michigan","Washtenaw County",1,35,4517,2375,2142
050,26,161,"Michigan","Washtenaw County",1,36,4505,2373,2132
050,26,161,"Michigan","Washtenaw County",1,37,4664,2418,2246
050,26,161,"Michigan","Washtenaw County",1,38,4670,2371,2299
050,26,161,"Michigan","Washtenaw County",1,39,4569,2361,2208
050,26,161,"Michigan","Washtenaw County",1,40,4321,2190,2131
050,26,161,"Michigan","Washtenaw County",1,41,4271,2176,2095
050,26,161,"Michigan","Washtenaw County",1,42,4127,2095,2032
050,26,161,"Michigan","Washtenaw County",1,43,4098,2110,1988
050,26,161,"Michigan","Washtenaw County",1,44,4023,2023,2000
050,26,161,"Michigan","Washtenaw County",1,45,3856,1938,1918
050,26,161,"Michigan","Washtenaw County",1,46,3941,1980,1961
050,26,161,"Michigan","Washtenaw County",1,47,4016,1958,2058
050,26,161,"Michigan","Washtenaw County",1,48,4288,2135,2153
050,26,161,"Michigan","Washtenaw County",1,49,4597,2330,2267
050,26,161,"Michigan","Washtenaw County",1,50,4473,2273,2200
050,26,161,"Michigan","Washtenaw County",1,51,4355,2170,2185
050,26,161,"Michigan","Washtenaw County",1,52,4245,2099,2146
050,26,161,"Michigan","Washtenaw County",1,53,4181,2077,2104
050,26,161,"Michigan","Washtenaw County",1,54,4155,2075,2080
050,26,161,"Michigan","Washtenaw County",1,55,4328,2137,2191
050,26,161,"Michigan","Washtenaw County",1,56,4513,2197,2316
050,26,161,"Michigan","Washtenaw County",1,57,4381,2164,2217
050,26,161,"Michigan","Washtenaw County",1,58,4434,2201,2233
050,26,161,"Michigan","Washtenaw County",1,59,4271,2093,2178
050,26,161,"Michigan","Washtenaw County",1,60,4079,2014,2065
050,26,161,"Michigan","Washtenaw County",1,61,4202,2045,2157
050,26,161,"Michigan","Washtenaw County",1,62,4265,2049,2216
050,26,161,"Michigan","Washtenaw County",1,63,4058,1982,2076
050,26,161,"Michigan","Washtenaw County",1,64,3922,1875,2047
050,26,161,"Michigan","Washtenaw County",1,65,3855,1799,2056
050,26,161,"Michigan","Washtenaw County",1,66,3820,1808,2012
050,26,161,"Michigan","Washtenaw County",1,67,3651,1719,1932
050,26,161,"Michigan","Washtenaw County",1,68,3627,1700,1927
050,26,161,"Michigan","Washtenaw County",1,69,3388,1543,1845
050,26,161,"Michigan","Washtenaw County",1,70,3278,1576,1702
050,26,161,"Michigan","Washtenaw County",1,71,3168,1511,1657
050,26,161,"Michigan","Washtenaw County",1,72,3174,1480,1694
050,26,161,"Michigan","Washtenaw County",1,73,3043,1441,1602
050,26,161,"Michigan","Washtenaw County",1,74,2132,1018,1114
050,26,161,"Michigan","Washtenaw County",1,75,2087,950,1137
050,26,161,"Michigan","Washtenaw County",1,76,2062,941,1121
050,26,161,"Michigan","Washtenaw County",1,77,2046,949,1097
050,26,161,"Michigan","Washtenaw County",1,78,1743,800,943
050,26,161,"Michigan","Washtenaw County",1,79,1513,681,832
050,26,161,"Michigan","Washtenaw County",1,80,1370,591,779
050,26,161,"Michigan","Washtenaw County",1,81,1232,546,686
050,26,161,"Michigan","Washtenaw County",1,82,1096,472,624
050,26,161,"Michigan","Washtenaw County",1,83,997,422,575
050,26,161,"Michigan","Washtenaw County",1,84,903,373,530
050,26,161,"Michigan","Washtenaw County",1,85,5783,2042,3741
050,26,161,"Michigan","Washtenaw County",2,0,3498,1774,1724
050,26,161,"Michigan","Washtenaw County",2,1,3495,1786,1709
050,26,161,"Michigan","Washtenaw County",2,2,3496,1735,1761
050,26,161,"Michigan","Washtenaw County",2,3,3572,1770,1802
050,26,161,"Michigan","Washtenaw County",2,4,3650,1872,1778
050,26,161,"Michigan","Washtenaw County",2,5,3639,1874,1765
050,26,161,"Michigan","Washtenaw County",2,6,3609,1858,1751
050,26,161,"Michigan","Washtenaw County",2,7,3669,1876,1793
050,26,161,"Michigan","Washtenaw County",2,8,3752,1930,1822
050,26,161,"Michigan","Washtenaw County",2,9,3837,2002,1835
050,26,161,"Michigan","Washtenaw County",2,10,3875,1966,1909
050,26,161,"Michigan","Washtenaw County",2,11,3881,1971,1910
050,26,161,"Michigan","Washtenaw County",2,12,4033,2072,1961
050,26,161,"Michigan","Washtenaw County",2,13,4142,2135,2007
050,26,161,"Michigan","Washtenaw County",2,14,4162,2127,2035
050,26,161,"Michigan","Washtenaw County",2,15,4128,2098,2030
050,26,161,"Michigan","Washtenaw County",2,16,4255,2172,2083
050,26,161,"Michigan","Washtenaw County",2,17,4271,2180,2091
050,26,161,"Michigan","Washtenaw County",2,18,8929,4295,4634
050,26,161,"Michigan","Washtenaw County",2,19,11899,6011,5888
050,26,161,"Michigan","Washtenaw County",2,20,10974,5392,5582
050,26,161,"Michigan","Washtenaw County",2,21,10554,5238,5316
050,26,161,"Michigan","Washtenaw County",2,22,9631,4992,4639
050,26,161,"Michigan","Washtenaw County",2,23,8140,4252,3888
050,26,161,"Michigan","Washtenaw County",2,24,7117,3696,3421
050,26,161,"Michigan","Washtenaw County",2,25,6419,3335,3084
050,26,161,"Michigan","Washtenaw County",2,26,6002,3135,2867
050,26,161,"Michigan","Washtenaw County",2,27,5543,2880,2663
050,26,161,"Michigan","Washtenaw County",2,28,5553,2901,2652
050,26,161,"Michigan","Washtenaw County",2,29,5498,2894,2604
050,26,161,"Michigan","Washtenaw County",2,30,5266,2777,2489
050,26,161,"Michigan","Washtenaw County",2,31,4990,2651,2339
050,26,161,"Michigan","Washtenaw County",2,32,4728,2498,2230
050,26,161,"Michigan","Washtenaw County",2,33,4709,2478,2231
050,26,161,"Michigan","Washtenaw County",2,34,4558,2354,2204
050,26,161,"Michigan","Washtenaw County",2,35,4526,2369,2157
050,26,161,"Michigan","Washtenaw County",2,36,4476,2359,2117
050,26,161,"Michigan","Washtenaw County",2,37,4619,2400,2219
050,26,161,"Michigan","Washtenaw County",2,38,4672,2379,2293
050,26,161,"Michigan","Washtenaw County",2,39,4578,2359,2219
050,26,161,"Michigan","Washtenaw County",2,40,4388,2232,2156
050,26,161,"Michigan","Washtenaw County",2,41,4270,2174,2096
050,26,161,"Michigan","Washtenaw County",2,42,4123,2096,2027
050,26,161,"Michigan","Washtenaw County",2,43,4120,2109,2011
050,26,161,"Michigan","Washtenaw County",2,44,3993,2016,1977
050,26,161,"Michigan","Washtenaw County",2,45,3901,1957,1944
050,26,161,"Michigan","Washtenaw County",2,46,3909,1966,1943
050,26,161,"Michigan","Washtenaw County",2,47,3981,1953,2028
050,26,161,"Michigan","Washtenaw County",2,48,4219,2090,2129
050,26,161,"Michigan","Washtenaw County",2,49,4528,2290,2238
050,26,161,"Michigan","Washtenaw County",2,50,4492,2282,2210
050,26,161,"Michigan","Washtenaw County",2,51,4349,2174,2175
050,26,161,"Michigan","Washtenaw County",2,52,4264,2115,2149
050,26,161,"Michigan","Washtenaw County",2,53,4180,2076,2104
050,26,161,"Michigan","Washtenaw County",2,54,4124,2059,2065
050,26,161,"Michigan","Washtenaw County",2,55,4278,2119,2159
050,26,161,"Michigan","Washtenaw County",2,56,4464,2180,2284
050,26,161,"Michigan","Washtenaw County",2,57,4408,2171,2237
050,26,161,"Michigan","Washtenaw County",2,58,4400,2183,2217
050,26,161,"Michigan","Washtenaw County",2,59,4314,2122,2192
050,26,161,"Michigan","Washtenaw County",2,60,4093,2015,2078
050,26,161,"Michigan","Washtenaw County",2,61,4138,2019,2119
050,26,161,"Michigan","Washtenaw County",2,62,4224,2039,2185
050,26,161,"Michigan","Washtenaw County",2,63,4118,2000,2118
050,26,161,"Michigan","Washtenaw County",2,64,3919,1890,2029
050,26,161,"Michigan","Washtenaw County",2,65,3848,1801,2047
050,26,161,"Michigan","Washtenaw County",2,66,3817,1801,2016
050,26,161,"Michigan","Washtenaw County",2,67,3659,1721,1938
050,26,161,"Michigan","Washtenaw County",2,68,3589,1688,1901
050,26,161,"Michigan","Washtenaw County",2,69,3453,1582,1871
050,26,161,"Michigan","Washtenaw County",2,70,3261,1545,1716
050,26,161,"Michigan","Washtenaw County",2,71,3183,1517,1666
050,26,161,"Michigan","Washtenaw County",2,72,3115,1452,1663
050,26,161,"Michigan","Washtenaw County",2,73,3209,1516,1693
050,26,161,"Michigan","Washtenaw County",2,74,2201,1049,1152
050,26,161,"Michigan","Washtenaw County",2,75,2088,963,1125
050,26,161,"Michigan","Washtenaw County",2,76,2048,932,1116
050,26,161,"Michigan","Washtenaw County",2,77,2067,957,1110
050,26,161,"Michigan","Washtenaw County",2,78,1768,810,958
050,26,161,"Michigan","Washtenaw County",2,79,1548,699,849
050,26,161,"Michigan","Washtenaw County",2,80,1397,605,792
050,26,161,"Michigan","Washtenaw County",2,81,1237,546,691
050,26,161,"Michigan","Washtenaw County",2,82,1107,474,633
050,26,161,"Michigan","Washtenaw County",2,83,1017,434,583
050,26,161,"Michigan","Washtenaw County",2,84,914,375,539
050,26,161,"Michigan","Washtenaw County",2,85,5766,2046,3720
050,26,161,"Michigan","Washtenaw County",3,0,3175,1632,1543
050,26,161,"Michigan","Washtenaw County",3,1,3429,1721,1708
050,26,161,"Michigan","Washtenaw County",3,2,3419,1743,1676
050,26,161,"Michigan","Washtenaw County",3,3,3432,1708,1724
050,26,161,"Michigan","Washtenaw County",3,4,3544,1771,1773
050,26,161,"Michigan","Washtenaw County",3,5,3604,1833,1771
050,26,161,"Michigan","Washtenaw County",3,6,3658,1881,1777
050,26,161,"Michigan","Washtenaw County",3,7,3600,1865,1735
050,26,161,"Michigan","Washtenaw County",3,8,3619,1867,1752
050,26,161,"Michigan","Washtenaw County",3,9,3767,1921,1846
050,26,161,"Michigan","Washtenaw County",3,10,3827,1975,1852
050,26,161,"Michigan","Washtenaw County",3,11,3888,1975,1913
050,26,161,"Michigan","Washtenaw County",3,12,3856,1956,1900
050,26,161,"Michigan","Washtenaw County",3,13,3973,2028,1945
050,26,161,"Michigan","Washtenaw County",3,14,4124,2123,2001
050,26,161,"Michigan","Washtenaw County",3,15,4201,2155,2046
050,26,161,"Michigan","Washtenaw County",3,16,4129,2108,2021
050,26,161,"Michigan","Washtenaw County",3,17,4310,2202,2108
050,26,161,"Michigan","Washtenaw County",3,18,7630,3713,3917
050,26,161,"Michigan","Washtenaw County",3,19,9770,4930,4840
050,26,161,"Michigan","Washtenaw County",3,20,10082,4949,5133
050,26,161,"Michigan","Washtenaw County",3,21,10234,5059,5175
050,26,161,"Michigan","Washtenaw County",3,22,9302,4774,4528
050,26,161,"Michigan","Washtenaw County",3,23,7968,4161,3807
050,26,161,"Michigan","Washtenaw County",3,24,7005,3562,3443
050,26,161,"Michigan","Washtenaw County",3,25,6015,3071,2944
050,26,161,"Michigan","Washtenaw County",3,26,5701,2935,2766
050,26,161,"Michigan","Washtenaw County",3,27,5441,2866,2575
050,26,161,"Michigan","Washtenaw County",3,28,5337,2794,2543
050,26,161,"Michigan","Washtenaw County",3,29,5354,2814,2540
050,26,161,"Michigan","Washtenaw County",3,30,5258,2754,2504
050,26,161,"Michigan","Washtenaw County",3,31,5128,2660,2468
050,26,161,"Michigan","Washtenaw County",3,32,4748,2513,2235
050,26,161,"Michigan","Washtenaw County",3,33,4626,2443,2183
050,26,161,"Michigan","Washtenaw County",3,34,4529,2359,2170
050,26,161,"Michigan","Washtenaw County",3,35,4464,2309,2155
050,26,161,"Michigan","Washtenaw County",3,36,4492,2351,2141
050,26,161,"Michigan","Washtenaw County",3,37,4419,2320,2099
050,26,161,"Michigan","Washtenaw County",3,38,4538,2324,2214
050,26,161,"Michigan","Washtenaw County",3,39,4659,2375,2284
050,26,161,"Michigan","Washtenaw County",3,40,4538,2312,2226
050,26,161,"Michigan","Washtenaw County",3,41,4363,2198,2165
050,26,161,"Michigan","Washtenaw County",3,42,4208,2111,2097
050,26,161,"Michigan","Washtenaw County",3,43,4088,2084,2004
050,26,161,"Michigan","Washtenaw County",3,44,4091,2062,2029
050,26,161,"Michigan","Washtenaw County",3,45,3946,1962,1984
050,26,161,"Michigan","Washtenaw County",3,46,3921,1976,1945
050,26,161,"Michigan","Washtenaw County",3,47,3883,1959,1924
050,26,161,"Michigan","Washtenaw County",3,48,3986,1951,2035
050,26,161,"Michigan","Washtenaw County",3,49,4201,2092,2109
050,26,161,"Michigan","Washtenaw County",3,50,4474,2269,2205
050,26,161,"Michigan","Washtenaw County",3,51,4368,2200,2168
050,26,161,"Michigan","Washtenaw County",3,52,4350,2179,2171
050,26,161,"Michigan","Washtenaw County",3,53,4212,2091,2121
050,26,161,"Michigan","Washtenaw County",3,54,4106,2031,2075
050,26,161,"Michigan","Washtenaw County",3,55,4067,2048,2019
050,26,161,"Michigan","Washtenaw County",3,56,4259,2111,2148
050,26,161,"Michigan","Washtenaw County",3,57,4379,2133,2246
050,26,161,"Michigan","Washtenaw County",3,58,4354,2149,2205
050,26,161,"Michigan","Washtenaw County",3,59,4381,2191,2190
050,26,161,"Michigan","Washtenaw County",3,60,4248,2072,2176
050,26,161,"Michigan","Washtenaw County",3,61,4013,1981,2032
050,26,161,"Michigan","Washtenaw County",3,62,4073,1992,2081
050,26,161,"Michigan","Washtenaw County",3,63,4132,1983,2149
050,26,161,"Michigan","Washtenaw County",3,64,4046,1974,2072
050,26,161,"Michigan","Washtenaw County",3,65,3815,1823,1992
050,26,161,"Michigan","Washtenaw County",3,66,3781,1761,2020
050,26,161,"Michigan","Washtenaw County",3,67,3726,1741,1985
050,26,161,"Michigan","Washtenaw County",3,68,3585,1666,1919
050,26,161,"Michigan","Washtenaw County",3,69,3555,1661,1894
050,26,161,"Michigan","Washtenaw County",3,70,3376,1540,1836
050,26,161,"Michigan","Washtenaw County",3,71,3200,1502,1698
050,26,161,"Michigan","Washtenaw County",3,72,3134,1501,1633
050,26,161,"Michigan","Washtenaw County",3,73,3034,1421,1613
050,26,161,"Michigan","Washtenaw County",3,74,3150,1483,1667
050,26,161,"Michigan","Washtenaw County",3,75,2143,1016,1127
050,26,161,"Michigan","Washtenaw County",3,76,2043,931,1112
050,26,161,"Michigan","Washtenaw County",3,77,1958,881,1077
050,26,161,"Michigan","Washtenaw County",3,78,2002,923,1079
050,26,161,"Michigan","Washtenaw County",3,79,1720,771,949
050,26,161,"Michigan","Washtenaw County",3,80,1496,668,828
050,26,161,"Michigan","Washtenaw County",3,81,1301,556,745
050,26,161,"Michigan","Washtenaw County",3,82,1175,512,663
050,26,161,"Michigan","Washtenaw County",3,83,1068,450,618
050,26,161,"Michigan","Washtenaw County",3,84,955,402,553
050,26,161,"Michigan","Washtenaw County",3,85,5854,2107,3747
050,26,161,"Michigan","Washtenaw County",4,0,3300,1687,1613
050,26,161,"Michigan","Washtenaw County",4,1,3183,1638,1545
050,26,161,"Michigan","Washtenaw County",4,2,3435,1728,1707
050,26,161,"Michigan","Washtenaw County",4,3,3447,1771,1676
050,26,161,"Michigan","Washtenaw County",4,4,3447,1728,1719
050,26,161,"Michigan","Washtenaw County",4,5,3578,1786,1792
050,26,161,"Michigan","Washtenaw County",4,6,3616,1847,1769
050,26,161,"Michigan","Washtenaw County",4,7,3668,1921,1747
050,26,161,"Michigan","Washtenaw County",4,8,3611,1885,1726
050,26,161,"Michigan","Washtenaw County",4,9,3608,1852,1756
050,26,161,"Michigan","Washtenaw County",4,10,3720,1890,1830
050,26,161,"Michigan","Washtenaw County",4,11,3828,1967,1861
050,26,161,"Michigan","Washtenaw County",4,12,3912,2001,1911
050,26,161,"Michigan","Washtenaw County",4,13,3830,1929,1901
050,26,161,"Michigan","Washtenaw County",4,14,3998,2054,1944
050,26,161,"Michigan","Washtenaw County",4,15,4166,2151,2015
050,26,161,"Michigan","Washtenaw County",4,16,4212,2163,2049
050,26,161,"Michigan","Washtenaw County",4,17,4248,2188,2060
050,26,161,"Michigan","Washtenaw County",4,18,8211,3992,4219
050,26,161,"Michigan","Washtenaw County",4,19,10605,5358,5247
050,26,161,"Michigan","Washtenaw County",4,20,10268,5030,5238
050,26,161,"Michigan","Washtenaw County",4,21,10460,5161,5299
050,26,161,"Michigan","Washtenaw County",4,22,9471,4903,4568
050,26,161,"Michigan","Washtenaw County",4,23,7854,4093,3761
050,26,161,"Michigan","Washtenaw County",4,24,6886,3535,3351
050,26,161,"Michigan","Washtenaw County",4,25,5975,2990,2985
050,26,161,"Michigan","Washtenaw County",4,26,5469,2767,2702
050,26,161,"Michigan","Washtenaw County",4,27,5233,2681,2552
050,26,161,"Michigan","Washtenaw County",4,28,5311,2808,2503
050,26,161,"Michigan","Washtenaw County",4,29,5116,2671,2445
050,26,161,"Michigan","Washtenaw County",4,30,5151,2720,2431
050,26,161,"Michigan","Washtenaw County",4,31,5135,2666,2469
050,26,161,"Michigan","Washtenaw County",4,32,4984,2554,2430
050,26,161,"Michigan","Washtenaw County",4,33,4715,2531,2184
050,26,161,"Michigan","Washtenaw County",4,34,4466,2319,2147
050,26,161,"Michigan","Washtenaw County",4,35,4481,2309,2172
050,26,161,"Michigan","Washtenaw County",4,36,4469,2311,2158
050,26,161,"Michigan","Washtenaw County",4,37,4464,2325,2139
050,26,161,"Michigan","Washtenaw County",4,38,4383,2281,2102
050,26,161,"Michigan","Washtenaw County",4,39,4475,2302,2173
050,26,161,"Michigan","Washtenaw County",4,40,4611,2325,2286
050,26,161,"Michigan","Washtenaw County",4,41,4503,2278,2225
050,26,161,"Michigan","Washtenaw County",4,42,4300,2158,2142
050,26,161,"Michigan","Washtenaw County",4,43,4219,2127,2092
050,26,161,"Michigan","Washtenaw County",4,44,4063,2059,2004
050,26,161,"Michigan","Washtenaw County",4,45,4004,2018,1986
050,26,161,"Michigan","Washtenaw County",4,46,3950,1985,1965
050,26,161,"Michigan","Washtenaw County",4,47,3911,1972,1939
050,26,161,"Michigan","Washtenaw County",4,48,3870,1944,1926
050,26,161,"Michigan","Washtenaw County",4,49,3960,1936,2024
050,26,161,"Michigan","Washtenaw County",4,50,4197,2092,2105
050,26,161,"Michigan","Washtenaw County",4,51,4356,2190,2166
050,26,161,"Michigan","Washtenaw County",4,52,4375,2222,2153
050,26,161,"Michigan","Washtenaw County",4,53,4321,2172,2149
050,26,161,"Michigan","Washtenaw County",4,54,4113,2013,2100
050,26,161,"Michigan","Washtenaw County",4,55,4039,2008,2031
050,26,161,"Michigan","Washtenaw County",4,56,4027,2025,2002
050,26,161,"Michigan","Washtenaw County",4,57,4201,2073,2128
050,26,161,"Michigan","Washtenaw County",4,58,4325,2119,2206
050,26,161,"Michigan","Washtenaw County",4,59,4290,2126,2164
050,26,161,"Michigan","Washtenaw County",4,60,4284,2123,2161
050,26,161,"Michigan","Washtenaw County",4,61,4175,2044,2131
050,26,161,"Michigan","Washtenaw County",4,62,3925,1947,1978
050,26,161,"Michigan","Washtenaw County",4,63,3988,1924,2064
050,26,161,"Michigan","Washtenaw County",4,64,4039,1947,2092
050,26,161,"Michigan","Washtenaw County",4,65,3991,1941,2050
050,26,161,"Michigan","Washtenaw County",4,66,3781,1799,1982
050,26,161,"Michigan","Washtenaw County",4,67,3685,1708,1977
050,26,161,"Michigan","Washtenaw County",4,68,3635,1697,1938
050,26,161,"Michigan","Washtenaw County",4,69,3561,1648,1913
050,26,161,"Michigan","Washtenaw County",4,70,3467,1628,1839
050,26,161,"Michigan","Washtenaw County",4,71,3272,1481,1791
050,26,161,"Michigan","Washtenaw County",4,72,3149,1471,1678
050,26,161,"Michigan","Washtenaw County",4,73,3051,1458,1593
050,26,161,"Michigan","Washtenaw County",4,74,2979,1380,1599
050,26,161,"Michigan","Washtenaw County",4,75,3073,1447,1626
050,26,161,"Michigan","Washtenaw County",4,76,2111,1001,1110
050,26,161,"Michigan","Washtenaw County",4,77,1999,892,1107
050,26,161,"Michigan","Washtenaw County",4,78,1887,859,1028
050,26,161,"Michigan","Washtenaw County",4,79,1939,858,1081
050,26,161,"Michigan","Washtenaw County",4,80,1676,745,931
050,26,161,"Michigan","Washtenaw County",4,81,1425,639,786
050,26,161,"Michigan","Washtenaw County",4,82,1245,512,733
050,26,161,"Michigan","Washtenaw County",4,83,1141,489,652
050,26,161,"Michigan","Washtenaw County",4,84,987,399,588
050,26,161,"Michigan","Washtenaw County",4,85,6015,2223,3792
050,26,161,"Michigan","Washtenaw County",5,0,2936,1502,1434
050,26,161,"Michigan","Washtenaw County",5,1,3214,1653,1561
050,26,161,"Michigan","Washtenaw County",5,2,3169,1652,1517
050,26,161,"Michigan","Washtenaw County",5,3,3436,1724,1712
050,26,161,"Michigan","Washtenaw County",5,4,3411,1753,1658
050,26,161,"Michigan","Washtenaw County",5,5,3514,1765,1749
050,26,161,"Michigan","Washtenaw County",5,6,3615,1816,1799
050,26,161,"Michigan","Washtenaw County",5,7,3639,1877,1762
050,26,161,"Michigan","Washtenaw County",5,8,3707,1933,1774
050,26,161,"Michigan","Washtenaw County",5,9,3603,1894,1709
050,26,161,"Michigan","Washtenaw County",5,10,3590,1828,1762
050,26,161,"Michigan","Washtenaw County",5,11,3769,1909,1860
050,26,161,"Michigan","Washtenaw County",5,12,3835,1988,1847
050,26,161,"Michigan","Washtenaw County",5,13,3868,1976,1892
050,26,161,"Michigan","Washtenaw County",5,14,3855,1956,1899
050,26,161,"Michigan","Washtenaw County",5,15,4011,2065,1946
050,26,161,"Michigan","Washtenaw County",5,16,4135,2121,2014
050,26,161,"Michigan","Washtenaw County",5,17,4326,2246,2080
050,26,161,"Michigan","Washtenaw County",5,18,8135,3977,4158
050,26,161,"Michigan","Washtenaw County",5,19,10661,5387,5274
050,26,161,"Michigan","Washtenaw County",5,20,10374,5110,5264
050,26,161,"Michigan","Washtenaw County",5,21,10189,5009,5180
050,26,161,"Michigan","Washtenaw County",5,22,9590,4979,4611
050,26,161,"Michigan","Washtenaw County",5,23,7891,4169,3722
050,26,161,"Michigan","Washtenaw County",5,24,6796,3538,3258
050,26,161,"Michigan","Washtenaw County",5,25,5907,2990,2917
050,26,161,"Michigan","Washtenaw County",5,26,5309,2633,2676
050,26,161,"Michigan","Washtenaw County",5,27,5002,2561,2441
050,26,161,"Michigan","Washtenaw County",5,28,5022,2556,2466
050,26,161,"Michigan","Washtenaw County",5,29,5140,2694,2446
050,26,161,"Michigan","Washtenaw County",5,30,4972,2591,2381
050,26,161,"Michigan","Washtenaw County",5,31,5039,2668,2371
050,26,161,"Michigan","Washtenaw County",5,32,5038,2589,2449
050,26,161,"Michigan","Washtenaw County",5,33,4999,2604,2395
050,26,161,"Michigan","Washtenaw County",5,34,4676,2472,2204
050,26,161,"Michigan","Washtenaw County",5,35,4419,2279,2140
050,26,161,"Michigan","Washtenaw County",5,36,4428,2305,2123
050,26,161,"Michigan","Washtenaw County",5,37,4392,2260,2132
050,26,161,"Michigan","Washtenaw County",5,38,4453,2295,2158
050,26,161,"Michigan","Washtenaw County",5,39,4391,2287,2104
050,26,161,"Michigan","Washtenaw County",5,40,4405,2255,2150
050,26,161,"Michigan","Washtenaw County",5,41,4534,2276,2258
050,26,161,"Michigan","Washtenaw County",5,42,4409,2229,2180
050,26,161,"Michigan","Washtenaw County",5,43,4276,2147,2129
050,26,161,"Michigan","Washtenaw County",5,44,4153,2091,2062
050,26,161,"Michigan","Washtenaw County",5,45,3977,2005,1972
050,26,161,"Michigan","Washtenaw County",5,46,4032,2033,1999
050,26,161,"Michigan","Washtenaw County",5,47,3884,1956,1928
050,26,161,"Michigan","Washtenaw County",5,48,3914,1975,1939
050,26,161,"Michigan","Washtenaw County",5,49,3865,1952,1913
050,26,161,"Michigan","Washtenaw County",5,50,3934,1922,2012
050,26,161,"Michigan","Washtenaw County",5,51,4100,2023,2077
050,26,161,"Michigan","Washtenaw County",5,52,4319,2171,2148
050,26,161,"Michigan","Washtenaw County",5,53,4298,2207,2091
050,26,161,"Michigan","Washtenaw County",5,54,4247,2144,2103
050,26,161,"Michigan","Washtenaw County",5,55,4013,1972,2041
050,26,161,"Michigan","Washtenaw County",5,56,3997,1971,2026
050,26,161,"Michigan","Washtenaw County",5,57,3968,1985,1983
050,26,161,"Michigan","Washtenaw County",5,58,4097,2038,2059
050,26,161,"Michigan","Washtenaw County",5,59,4233,2080,2153
050,26,161,"Michigan","Washtenaw County",5,60,4168,2064,2104
050,26,161,"Michigan","Washtenaw County",5,61,4183,2057,2126
050,26,161,"Michigan","Washtenaw County",5,62,4103,2001,2102
050,26,161,"Michigan","Washtenaw County",5,63,3868,1903,1965
050,26,161,"Michigan","Washtenaw County",5,64,3914,1883,2031
050,26,161,"Michigan","Washtenaw County",5,65,3975,1909,2066
050,26,161,"Michigan","Washtenaw County",5,66,3940,1931,2009
050,26,161,"Michigan","Washtenaw County",5,67,3713,1754,1959
050,26,161,"Michigan","Washtenaw County",5,68,3605,1673,1932
050,26,161,"Michigan","Washtenaw County",5,69,3607,1663,1944
050,26,161,"Michigan","Washtenaw County",5,70,3492,1622,1870
050,26,161,"Michigan","Washtenaw County",5,71,3404,1583,1821
050,26,161,"Michigan","Washtenaw County",5,72,3221,1446,1775
050,26,161,"Michigan","Washtenaw County",5,73,3102,1443,1659
050,26,161,"Michigan","Washtenaw County",5,74,3031,1434,1597
050,26,161,"Michigan","Washtenaw County",5,75,2900,1336,1564
050,26,161,"Michigan","Washtenaw County",5,76,3017,1414,1603
050,26,161,"Michigan","Washtenaw County",5,77,2037,967,1070
050,26,161,"Michigan","Washtenaw County",5,78,1932,868,1064
050,26,161,"Michigan","Washtenaw County",5,79,1835,818,1017
050,26,161,"Michigan","Washtenaw County",5,80,1885,831,1054
050,26,161,"Michigan","Washtenaw County",5,81,1597,716,881
050,26,161,"Michigan","Washtenaw County",5,82,1373,610,763
050,26,161,"Michigan","Washtenaw County",5,83,1202,491,711
050,26,161,"Michigan","Washtenaw County",5,84,1076,447,629
050,26,161,"Michigan","Washtenaw County",5,85,6245,2335,3910
050,26,163,"Michigan","Wayne County",1,0,22807,11656,11151
050,26,163,"Michigan","Wayne County",1,1,23006,11803,11203
050,26,163,"Michigan","Wayne County",1,2,23701,12109,11592
050,26,163,"Michigan","Wayne County",1,3,23438,11980,11458
050,26,163,"Michigan","Wayne County",1,4,23778,12198,11580
050,26,163,"Michigan","Wayne County",1,5,23702,12130,11572
050,26,163,"Michigan","Wayne County",1,6,23593,12030,11563
050,26,163,"Michigan","Wayne County",1,7,23288,11947,11341
050,26,163,"Michigan","Wayne County",1,8,23265,12001,11264
050,26,163,"Michigan","Wayne County",1,9,23547,12120,11427
050,26,163,"Michigan","Wayne County",1,10,23835,12249,11586
050,26,163,"Michigan","Wayne County",1,11,24228,12349,11879
050,26,163,"Michigan","Wayne County",1,12,24755,12615,12140
050,26,163,"Michigan","Wayne County",1,13,24585,12530,12055
050,26,163,"Michigan","Wayne County",1,14,24264,12363,11901
050,26,163,"Michigan","Wayne County",1,15,24109,12339,11770
050,26,163,"Michigan","Wayne County",1,16,24379,12423,11956
050,26,163,"Michigan","Wayne County",1,17,24327,12404,11923
050,26,163,"Michigan","Wayne County",1,18,22205,11353,10852
050,26,163,"Michigan","Wayne County",1,19,19515,9884,9631
050,26,163,"Michigan","Wayne County",1,20,20138,10098,10040
050,26,163,"Michigan","Wayne County",1,21,20769,10347,10422
050,26,163,"Michigan","Wayne County",1,22,21639,10673,10966
050,26,163,"Michigan","Wayne County",1,23,22745,11158,11587
050,26,163,"Michigan","Wayne County",1,24,23717,11779,11938
050,26,163,"Michigan","Wayne County",1,25,25037,12331,12706
050,26,163,"Michigan","Wayne County",1,26,26327,12924,13403
050,26,163,"Michigan","Wayne County",1,27,26960,13355,13605
050,26,163,"Michigan","Wayne County",1,28,28079,13859,14220
050,26,163,"Michigan","Wayne County",1,29,29400,14449,14951
050,26,163,"Michigan","Wayne County",1,30,28200,13802,14398
050,26,163,"Michigan","Wayne County",1,31,25495,12404,13091
050,26,163,"Michigan","Wayne County",1,32,23945,11672,12273
050,26,163,"Michigan","Wayne County",1,33,22780,11153,11627
050,26,163,"Michigan","Wayne County",1,34,22505,10983,11522
050,26,163,"Michigan","Wayne County",1,35,21863,10578,11285
050,26,163,"Michigan","Wayne County",1,36,21240,10269,10971
050,26,163,"Michigan","Wayne County",1,37,21438,10398,11040
050,26,163,"Michigan","Wayne County",1,38,21385,10386,10999
050,26,163,"Michigan","Wayne County",1,39,21718,10418,11300
050,26,163,"Michigan","Wayne County",1,40,21553,10302,11251
050,26,163,"Michigan","Wayne County",1,41,21053,10033,11020
050,26,163,"Michigan","Wayne County",1,42,20945,9969,10976
050,26,163,"Michigan","Wayne County",1,43,20320,9635,10685
050,26,163,"Michigan","Wayne County",1,44,20266,9585,10681
050,26,163,"Michigan","Wayne County",1,45,20551,9685,10866
050,26,163,"Michigan","Wayne County",1,46,20787,9776,11011
050,26,163,"Michigan","Wayne County",1,47,22057,10518,11539
050,26,163,"Michigan","Wayne County",1,48,23575,11422,12153
050,26,163,"Michigan","Wayne County",1,49,24914,12242,12672
050,26,163,"Michigan","Wayne County",1,50,23603,11628,11975
050,26,163,"Michigan","Wayne County",1,51,22599,11132,11467
050,26,163,"Michigan","Wayne County",1,52,22475,11030,11445
050,26,163,"Michigan","Wayne County",1,53,22914,11245,11669
050,26,163,"Michigan","Wayne County",1,54,23127,11425,11702
050,26,163,"Michigan","Wayne County",1,55,23662,11642,12020
050,26,163,"Michigan","Wayne County",1,56,24037,11800,12237
050,26,163,"Michigan","Wayne County",1,57,23918,11727,12191
050,26,163,"Michigan","Wayne County",1,58,24255,11822,12433
050,26,163,"Michigan","Wayne County",1,59,23974,11624,12350
050,26,163,"Michigan","Wayne County",1,60,23924,11623,12301
050,26,163,"Michigan","Wayne County",1,61,23906,11532,12374
050,26,163,"Michigan","Wayne County",1,62,24098,11675,12423
050,26,163,"Michigan","Wayne County",1,63,23159,11045,12114
050,26,163,"Michigan","Wayne County",1,64,22174,10442,11732
050,26,163,"Michigan","Wayne County",1,65,21258,9947,11311
050,26,163,"Michigan","Wayne County",1,66,20174,9474,10700
050,26,163,"Michigan","Wayne County",1,67,19233,8880,10353
050,26,163,"Michigan","Wayne County",1,68,18567,8479,10088
050,26,163,"Michigan","Wayne County",1,69,17352,7813,9539
050,26,163,"Michigan","Wayne County",1,70,16702,7472,9230
050,26,163,"Michigan","Wayne County",1,71,15827,7149,8678
050,26,163,"Michigan","Wayne County",1,72,15659,6951,8708
050,26,163,"Michigan","Wayne County",1,73,15381,6875,8506
050,26,163,"Michigan","Wayne County",1,74,10871,4783,6088
050,26,163,"Michigan","Wayne County",1,75,10423,4555,5868
050,26,163,"Michigan","Wayne County",1,76,10334,4512,5822
050,26,163,"Michigan","Wayne County",1,77,10241,4392,5849
050,26,163,"Michigan","Wayne County",1,78,8709,3709,5000
050,26,163,"Michigan","Wayne County",1,79,7701,3261,4440
050,26,163,"Michigan","Wayne County",1,80,6933,2899,4034
050,26,163,"Michigan","Wayne County",1,81,6402,2610,3792
050,26,163,"Michigan","Wayne County",1,82,5999,2406,3593
050,26,163,"Michigan","Wayne County",1,83,5297,2002,3295
050,26,163,"Michigan","Wayne County",1,84,4990,1895,3095
050,26,163,"Michigan","Wayne County",1,85,32308,10875,21433
050,26,163,"Michigan","Wayne County",2,0,22585,11622,10963
050,26,163,"Michigan","Wayne County",2,1,22935,11751,11184
050,26,163,"Michigan","Wayne County",2,2,23556,12052,11504
050,26,163,"Michigan","Wayne County",2,3,23407,11975,11432
050,26,163,"Michigan","Wayne County",2,4,23663,12129,11534
050,26,163,"Michigan","Wayne County",2,5,23682,12130,11552
050,26,163,"Michigan","Wayne County",2,6,23616,12047,11569
050,26,163,"Michigan","Wayne County",2,7,23325,11953,11372
050,26,163,"Michigan","Wayne County",2,8,23211,11949,11262
050,26,163,"Michigan","Wayne County",2,9,23405,12055,11350
050,26,163,"Michigan","Wayne County",2,10,23702,12180,11522
050,26,163,"Michigan","Wayne County",2,11,24014,12264,11750
050,26,163,"Michigan","Wayne County",2,12,24703,12592,12111
050,26,163,"Michigan","Wayne County",2,13,24569,12537,12032
050,26,163,"Michigan","Wayne County",2,14,24271,12360,11911
050,26,163,"Michigan","Wayne County",2,15,24117,12326,11791
050,26,163,"Michigan","Wayne County",2,16,24331,12406,11925
050,26,163,"Michigan","Wayne County",2,17,24283,12379,11904
050,26,163,"Michigan","Wayne County",2,18,22057,11283,10774
050,26,163,"Michigan","Wayne County",2,19,19558,9906,9652
050,26,163,"Michigan","Wayne County",2,20,20326,10194,10132
050,26,163,"Michigan","Wayne County",2,21,20735,10312,10423
050,26,163,"Michigan","Wayne County",2,22,21673,10717,10956
050,26,163,"Michigan","Wayne County",2,23,22719,11147,11572
050,26,163,"Michigan","Wayne County",2,24,23475,11611,11864
050,26,163,"Michigan","Wayne County",2,25,24745,12211,12534
050,26,163,"Michigan","Wayne County",2,26,26068,12822,13246
050,26,163,"Michigan","Wayne County",2,27,26748,13240,13508
050,26,163,"Michigan","Wayne County",2,28,27805,13747,14058
050,26,163,"Michigan","Wayne County",2,29,29025,14268,14757
050,26,163,"Michigan","Wayne County",2,30,28586,13995,14591
050,26,163,"Michigan","Wayne County",2,31,26065,12694,13371
050,26,163,"Michigan","Wayne County",2,32,24189,11773,12416
050,26,163,"Michigan","Wayne County",2,33,22999,11248,11751
050,26,163,"Michigan","Wayne County",2,34,22511,10995,11516
050,26,163,"Michigan","Wayne County",2,35,22085,10723,11362
050,26,163,"Michigan","Wayne County",2,36,21248,10266,10982
050,26,163,"Michigan","Wayne County",2,37,21376,10355,11021
050,26,163,"Michigan","Wayne County",2,38,21466,10417,11049
050,26,163,"Michigan","Wayne County",2,39,21480,10336,11144
050,26,163,"Michigan","Wayne County",2,40,21699,10381,11318
050,26,163,"Michigan","Wayne County",2,41,21097,10056,11041
050,26,163,"Michigan","Wayne County",2,42,20799,9901,10898
050,26,163,"Michigan","Wayne County",2,43,20573,9752,10821
050,26,163,"Michigan","Wayne County",2,44,20034,9488,10546
050,26,163,"Michigan","Wayne County",2,45,20521,9683,10838
050,26,163,"Michigan","Wayne County",2,46,20604,9694,10910
050,26,163,"Michigan","Wayne County",2,47,21655,10279,11376
050,26,163,"Michigan","Wayne County",2,48,23179,11187,11992
050,26,163,"Michigan","Wayne County",2,49,24609,12058,12551
050,26,163,"Michigan","Wayne County",2,50,23895,11778,12117
050,26,163,"Michigan","Wayne County",2,51,22625,11133,11492
050,26,163,"Michigan","Wayne County",2,52,22418,11010,11408
050,26,163,"Michigan","Wayne County",2,53,22701,11144,11557
050,26,163,"Michigan","Wayne County",2,54,22955,11321,11634
050,26,163,"Michigan","Wayne County",2,55,23447,11537,11910
050,26,163,"Michigan","Wayne County",2,56,23896,11734,12162
050,26,163,"Michigan","Wayne County",2,57,23861,11708,12153
050,26,163,"Michigan","Wayne County",2,58,24040,11721,12319
050,26,163,"Michigan","Wayne County",2,59,23934,11606,12328
050,26,163,"Michigan","Wayne County",2,60,23749,11520,12229
050,26,163,"Michigan","Wayne County",2,61,23714,11454,12260
050,26,163,"Michigan","Wayne County",2,62,23803,11499,12304
050,26,163,"Michigan","Wayne County",2,63,23367,11160,12207
050,26,163,"Michigan","Wayne County",2,64,22103,10422,11681
050,26,163,"Michigan","Wayne County",2,65,21245,9947,11298
050,26,163,"Michigan","Wayne County",2,66,20317,9510,10807
050,26,163,"Michigan","Wayne County",2,67,19196,8865,10331
050,26,163,"Michigan","Wayne County",2,68,18403,8409,9994
050,26,163,"Michigan","Wayne County",2,69,17586,7919,9667
050,26,163,"Michigan","Wayne County",2,70,16647,7444,9203
050,26,163,"Michigan","Wayne County",2,71,15842,7120,8722
050,26,163,"Michigan","Wayne County",2,72,15326,6827,8499
050,26,163,"Michigan","Wayne County",2,73,15899,7075,8824
050,26,163,"Michigan","Wayne County",2,74,11178,4926,6252
050,26,163,"Michigan","Wayne County",2,75,10424,4537,5887
050,26,163,"Michigan","Wayne County",2,76,10103,4409,5694
050,26,163,"Michigan","Wayne County",2,77,10274,4405,5869
050,26,163,"Michigan","Wayne County",2,78,8786,3743,5043
050,26,163,"Michigan","Wayne County",2,79,7764,3281,4483
050,26,163,"Michigan","Wayne County",2,80,6967,2905,4062
050,26,163,"Michigan","Wayne County",2,81,6322,2594,3728
050,26,163,"Michigan","Wayne County",2,82,5965,2382,3583
050,26,163,"Michigan","Wayne County",2,83,5300,2027,3273
050,26,163,"Michigan","Wayne County",2,84,4893,1849,3044
050,26,163,"Michigan","Wayne County",2,85,31557,10661,20896
050,26,163,"Michigan","Wayne County",3,0,21097,10768,10329
050,26,163,"Michigan","Wayne County",3,1,22387,11537,10850
050,26,163,"Michigan","Wayne County",3,2,22653,11599,11054
050,26,163,"Michigan","Wayne County",3,3,23379,11956,11423
050,26,163,"Michigan","Wayne County",3,4,23209,11861,11348
050,26,163,"Michigan","Wayne County",3,5,23461,12035,11426
050,26,163,"Michigan","Wayne County",3,6,23479,12031,11448
050,26,163,"Michigan","Wayne County",3,7,23460,12011,11449
050,26,163,"Michigan","Wayne County",3,8,23174,11861,11313
050,26,163,"Michigan","Wayne County",3,9,23036,11903,11133
050,26,163,"Michigan","Wayne County",3,10,23330,12036,11294
050,26,163,"Michigan","Wayne County",3,11,23649,12163,11486
050,26,163,"Michigan","Wayne County",3,12,23923,12210,11713
050,26,163,"Michigan","Wayne County",3,13,24663,12617,12046
050,26,163,"Michigan","Wayne County",3,14,24494,12522,11972
050,26,163,"Michigan","Wayne County",3,15,24126,12272,11854
050,26,163,"Michigan","Wayne County",3,16,23969,12208,11761
050,26,163,"Michigan","Wayne County",3,17,24133,12357,11776
050,26,163,"Michigan","Wayne County",3,18,21403,11015,10388
050,26,163,"Michigan","Wayne County",3,19,18622,9571,9051
050,26,163,"Michigan","Wayne County",3,20,19806,10024,9782
050,26,163,"Michigan","Wayne County",3,21,20781,10370,10411
050,26,163,"Michigan","Wayne County",3,22,21400,10643,10757
050,26,163,"Michigan","Wayne County",3,23,22358,11089,11269
050,26,163,"Michigan","Wayne County",3,24,22838,11197,11641
050,26,163,"Michigan","Wayne County",3,25,23306,11519,11787
050,26,163,"Michigan","Wayne County",3,26,24555,12093,12462
050,26,163,"Michigan","Wayne County",3,27,25780,12658,13122
050,26,163,"Michigan","Wayne County",3,28,26424,12938,13486
050,26,163,"Michigan","Wayne County",3,29,27490,13560,13930
050,26,163,"Michigan","Wayne County",3,30,28667,14034,14633
050,26,163,"Michigan","Wayne County",3,31,28179,13774,14405
050,26,163,"Michigan","Wayne County",3,32,25777,12437,13340
050,26,163,"Michigan","Wayne County",3,33,23955,11638,12317
050,26,163,"Michigan","Wayne County",3,34,22764,11108,11656
050,26,163,"Michigan","Wayne County",3,35,22190,10768,11422
050,26,163,"Michigan","Wayne County",3,36,21864,10592,11272
050,26,163,"Michigan","Wayne County",3,37,20935,10072,10863
050,26,163,"Michigan","Wayne County",3,38,21174,10264,10910
050,26,163,"Michigan","Wayne County",3,39,21204,10281,10923
050,26,163,"Michigan","Wayne County",3,40,21284,10227,11057
050,26,163,"Michigan","Wayne County",3,41,21454,10260,11194
050,26,163,"Michigan","Wayne County",3,42,20905,9964,10941
050,26,163,"Michigan","Wayne County",3,43,20547,9737,10810
050,26,163,"Michigan","Wayne County",3,44,20388,9641,10747
050,26,163,"Michigan","Wayne County",3,45,19807,9375,10432
050,26,163,"Michigan","Wayne County",3,46,20245,9568,10677
050,26,163,"Michigan","Wayne County",3,47,20389,9588,10801
050,26,163,"Michigan","Wayne County",3,48,21326,10078,11248
050,26,163,"Michigan","Wayne County",3,49,22927,11064,11863
050,26,163,"Michigan","Wayne County",3,50,24323,11914,12409
050,26,163,"Michigan","Wayne County",3,51,23487,11522,11965
050,26,163,"Michigan","Wayne County",3,52,22306,10946,11360
050,26,163,"Michigan","Wayne County",3,53,22146,10868,11278
050,26,163,"Michigan","Wayne County",3,54,22346,11009,11337
050,26,163,"Michigan","Wayne County",3,55,22558,11063,11495
050,26,163,"Michigan","Wayne County",3,56,23020,11301,11719
050,26,163,"Michigan","Wayne County",3,57,23537,11522,12015
050,26,163,"Michigan","Wayne County",3,58,23437,11483,11954
050,26,163,"Michigan","Wayne County",3,59,23564,11436,12128
050,26,163,"Michigan","Wayne County",3,60,23392,11344,12048
050,26,163,"Michigan","Wayne County",3,61,23211,11196,12015
050,26,163,"Michigan","Wayne County",3,62,23085,11120,11965
050,26,163,"Michigan","Wayne County",3,63,23120,11124,11996
050,26,163,"Michigan","Wayne County",3,64,22619,10748,11871
050,26,163,"Michigan","Wayne County",3,65,21486,10048,11438
050,26,163,"Michigan","Wayne County",3,66,20603,9599,11004
050,26,163,"Michigan","Wayne County",3,67,19695,9136,10559
050,26,163,"Michigan","Wayne County",3,68,18620,8570,10050
050,26,163,"Michigan","Wayne County",3,69,17798,8079,9719
050,26,163,"Michigan","Wayne County",3,70,17039,7619,9420
050,26,163,"Michigan","Wayne County",3,71,16054,7111,8943
050,26,163,"Michigan","Wayne County",3,72,15288,6819,8469
050,26,163,"Michigan","Wayne County",3,73,14824,6555,8269
050,26,163,"Michigan","Wayne County",3,74,15285,6721,8564
050,26,163,"Michigan","Wayne County",3,75,10757,4669,6088
050,26,163,"Michigan","Wayne County",3,76,9945,4296,5649
050,26,163,"Michigan","Wayne County",3,77,9595,4157,5438
050,26,163,"Michigan","Wayne County",3,78,9770,4142,5628
050,26,163,"Michigan","Wayne County",3,79,8320,3501,4819
050,26,163,"Michigan","Wayne County",3,80,7324,3067,4257
050,26,163,"Michigan","Wayne County",3,81,6525,2705,3820
050,26,163,"Michigan","Wayne County",3,82,5949,2430,3519
050,26,163,"Michigan","Wayne County",3,83,5516,2155,3361
050,26,163,"Michigan","Wayne County",3,84,4832,1833,2999
050,26,163,"Michigan","Wayne County",3,85,31065,10574,20491
050,26,163,"Michigan","Wayne County",4,0,21052,10607,10445
050,26,163,"Michigan","Wayne County",4,1,20939,10674,10265
050,26,163,"Michigan","Wayne County",4,2,22210,11466,10744
050,26,163,"Michigan","Wayne County",4,3,22488,11522,10966
050,26,163,"Michigan","Wayne County",4,4,23158,11865,11293
050,26,163,"Michigan","Wayne County",4,5,23080,11828,11252
050,26,163,"Michigan","Wayne County",4,6,23351,11994,11357
050,26,163,"Michigan","Wayne County",4,7,23390,11967,11423
050,26,163,"Michigan","Wayne County",4,8,23362,11995,11367
050,26,163,"Michigan","Wayne County",4,9,23096,11863,11233
050,26,163,"Michigan","Wayne County",4,10,22864,11843,11021
050,26,163,"Michigan","Wayne County",4,11,23108,11902,11206
050,26,163,"Michigan","Wayne County",4,12,23512,12088,11424
050,26,163,"Michigan","Wayne County",4,13,23750,12131,11619
050,26,163,"Michigan","Wayne County",4,14,24502,12508,11994
050,26,163,"Michigan","Wayne County",4,15,24371,12464,11907
050,26,163,"Michigan","Wayne County",4,16,23961,12189,11772
050,26,163,"Michigan","Wayne County",4,17,23751,12077,11674
050,26,163,"Michigan","Wayne County",4,18,21296,11046,10250
050,26,163,"Michigan","Wayne County",4,19,18156,9342,8814
050,26,163,"Michigan","Wayne County",4,20,19167,9759,9408
050,26,163,"Michigan","Wayne County",4,21,20378,10195,10183
050,26,163,"Michigan","Wayne County",4,22,21451,10640,10811
050,26,163,"Michigan","Wayne County",4,23,22120,10964,11156
050,26,163,"Michigan","Wayne County",4,24,22514,11188,11326
050,26,163,"Michigan","Wayne County",4,25,22835,11285,11550
050,26,163,"Michigan","Wayne County",4,26,23254,11433,11821
050,26,163,"Michigan","Wayne County",4,27,24151,11893,12258
050,26,163,"Michigan","Wayne County",4,28,25380,12438,12942
050,26,163,"Michigan","Wayne County",4,29,26076,12821,13255
050,26,163,"Michigan","Wayne County",4,30,27045,13313,13732
050,26,163,"Michigan","Wayne County",4,31,28321,13779,14542
050,26,163,"Michigan","Wayne County",4,32,27827,13557,14270
050,26,163,"Michigan","Wayne County",4,33,25526,12325,13201
050,26,163,"Michigan","Wayne County",4,34,23585,11441,12144
050,26,163,"Michigan","Wayne County",4,35,22496,11000,11496
050,26,163,"Michigan","Wayne County",4,36,21994,10681,11313
050,26,163,"Michigan","Wayne County",4,37,21548,10404,11144
050,26,163,"Michigan","Wayne County",4,38,20758,10005,10753
050,26,163,"Michigan","Wayne County",4,39,21049,10210,10839
050,26,163,"Michigan","Wayne County",4,40,20953,10145,10808
050,26,163,"Michigan","Wayne County",4,41,21028,10089,10939
050,26,163,"Michigan","Wayne County",4,42,21169,10101,11068
050,26,163,"Michigan","Wayne County",4,43,20681,9785,10896
050,26,163,"Michigan","Wayne County",4,44,20303,9610,10693
050,26,163,"Michigan","Wayne County",4,45,20033,9452,10581
050,26,163,"Michigan","Wayne County",4,46,19566,9258,10308
050,26,163,"Michigan","Wayne County",4,47,19975,9423,10552
050,26,163,"Michigan","Wayne County",4,48,20190,9470,10720
050,26,163,"Michigan","Wayne County",4,49,21033,9938,11095
050,26,163,"Michigan","Wayne County",4,50,22646,10948,11698
050,26,163,"Michigan","Wayne County",4,51,23956,11696,12260
050,26,163,"Michigan","Wayne County",4,52,23133,11322,11811
050,26,163,"Michigan","Wayne County",4,53,22025,10794,11231
050,26,163,"Michigan","Wayne County",4,54,21762,10719,11043
050,26,163,"Michigan","Wayne County",4,55,21900,10739,11161
050,26,163,"Michigan","Wayne County",4,56,22079,10796,11283
050,26,163,"Michigan","Wayne County",4,57,22537,11104,11433
050,26,163,"Michigan","Wayne County",4,58,22968,11199,11769
050,26,163,"Michigan","Wayne County",4,59,22921,11161,11760
050,26,163,"Michigan","Wayne County",4,60,22960,11122,11838
050,26,163,"Michigan","Wayne County",4,61,22718,10970,11748
050,26,163,"Michigan","Wayne County",4,62,22565,10817,11748
050,26,163,"Michigan","Wayne County",4,63,22446,10717,11729
050,26,163,"Michigan","Wayne County",4,64,22399,10716,11683
050,26,163,"Michigan","Wayne County",4,65,21945,10354,11591
050,26,163,"Michigan","Wayne County",4,66,20775,9696,11079
050,26,163,"Michigan","Wayne County",4,67,19914,9192,10722
050,26,163,"Michigan","Wayne County",4,68,19118,8828,10290
050,26,163,"Michigan","Wayne County",4,69,17994,8211,9783
050,26,163,"Michigan","Wayne County",4,70,17213,7748,9465
050,26,163,"Michigan","Wayne County",4,71,16497,7319,9178
050,26,163,"Michigan","Wayne County",4,72,15488,6819,8669
050,26,163,"Michigan","Wayne County",4,73,14763,6566,8197
050,26,163,"Michigan","Wayne County",4,74,14221,6256,7965
050,26,163,"Michigan","Wayne County",4,75,14637,6375,8262
050,26,163,"Michigan","Wayne County",4,76,10263,4426,5837
050,26,163,"Michigan","Wayne County",4,77,9478,4050,5428
050,26,163,"Michigan","Wayne County",4,78,9075,3912,5163
050,26,163,"Michigan","Wayne County",4,79,9198,3849,5349
050,26,163,"Michigan","Wayne County",4,80,7797,3251,4546
050,26,163,"Michigan","Wayne County",4,81,6843,2849,3994
050,26,163,"Michigan","Wayne County",4,82,6142,2530,3612
050,26,163,"Michigan","Wayne County",4,83,5508,2210,3298
050,26,163,"Michigan","Wayne County",4,84,5063,1959,3104
050,26,163,"Michigan","Wayne County",4,85,30192,10286,19906
050,26,163,"Michigan","Wayne County",5,0,20509,10324,10185
050,26,163,"Michigan","Wayne County",5,1,21103,10706,10397
050,26,163,"Michigan","Wayne County",5,2,20909,10654,10255
050,26,163,"Michigan","Wayne County",5,3,22196,11440,10756
050,26,163,"Michigan","Wayne County",5,4,22380,11489,10891
050,26,163,"Michigan","Wayne County",5,5,23086,11832,11254
050,26,163,"Michigan","Wayne County",5,6,22960,11770,11190
050,26,163,"Michigan","Wayne County",5,7,23227,11944,11283
050,26,163,"Michigan","Wayne County",5,8,23268,11919,11349
050,26,163,"Michigan","Wayne County",5,9,23249,11952,11297
050,26,163,"Michigan","Wayne County",5,10,23063,11824,11239
050,26,163,"Michigan","Wayne County",5,11,22828,11823,11005
050,26,163,"Michigan","Wayne County",5,12,23094,11912,11182
050,26,163,"Michigan","Wayne County",5,13,23421,11997,11424
050,26,163,"Michigan","Wayne County",5,14,23644,12054,11590
050,26,163,"Michigan","Wayne County",5,15,24502,12548,11954
050,26,163,"Michigan","Wayne County",5,16,24232,12351,11881
050,26,163,"Michigan","Wayne County",5,17,23808,12085,11723
050,26,163,"Michigan","Wayne County",5,18,21143,10885,10258
050,26,163,"Michigan","Wayne County",5,19,18216,9409,8807
050,26,163,"Michigan","Wayne County",5,20,18937,9616,9321
050,26,163,"Michigan","Wayne County",5,21,19963,10037,9926
050,26,163,"Michigan","Wayne County",5,22,21431,10622,10809
050,26,163,"Michigan","Wayne County",5,23,22241,10929,11312
050,26,163,"Michigan","Wayne County",5,24,22478,11110,11368
050,26,163,"Michigan","Wayne County",5,25,22661,11231,11430
050,26,163,"Michigan","Wayne County",5,26,22815,11235,11580
050,26,163,"Michigan","Wayne County",5,27,23003,11292,11711
050,26,163,"Michigan","Wayne County",5,28,24055,11856,12199
050,26,163,"Michigan","Wayne County",5,29,25220,12291,12929
050,26,163,"Michigan","Wayne County",5,30,25883,12700,13183
050,26,163,"Michigan","Wayne County",5,31,26798,13174,13624
050,26,163,"Michigan","Wayne County",5,32,28057,13668,14389
050,26,163,"Michigan","Wayne County",5,33,27633,13503,14130
050,26,163,"Michigan","Wayne County",5,34,25242,12161,13081
050,26,163,"Michigan","Wayne County",5,35,23389,11366,12023
050,26,163,"Michigan","Wayne County",5,36,22244,10853,11391
050,26,163,"Michigan","Wayne County",5,37,21751,10516,11235
050,26,163,"Michigan","Wayne County",5,38,21361,10324,11037
050,26,163,"Michigan","Wayne County",5,39,20631,9908,10723
050,26,163,"Michigan","Wayne County",5,40,20838,10074,10764
050,26,163,"Michigan","Wayne County",5,41,20779,10076,10703
050,26,163,"Michigan","Wayne County",5,42,20807,9945,10862
050,26,163,"Michigan","Wayne County",5,43,21048,10031,11017
050,26,163,"Michigan","Wayne County",5,44,20489,9692,10797
050,26,163,"Michigan","Wayne County",5,45,20083,9473,10610
050,26,163,"Michigan","Wayne County",5,46,19764,9327,10437
050,26,163,"Michigan","Wayne County",5,47,19429,9218,10211
050,26,163,"Michigan","Wayne County",5,48,19825,9354,10471
050,26,163,"Michigan","Wayne County",5,49,20005,9362,10643
050,26,163,"Michigan","Wayne County",5,50,20875,9840,11035
050,26,163,"Michigan","Wayne County",5,51,22323,10792,11531
050,26,163,"Michigan","Wayne County",5,52,23655,11550,12105
050,26,163,"Michigan","Wayne County",5,53,22875,11174,11701
050,26,163,"Michigan","Wayne County",5,54,21762,10685,11077
050,26,163,"Michigan","Wayne County",5,55,21479,10542,10937
050,26,163,"Michigan","Wayne County",5,56,21632,10619,11013
050,26,163,"Michigan","Wayne County",5,57,21731,10644,11087
050,26,163,"Michigan","Wayne County",5,58,22170,10910,11260
050,26,163,"Michigan","Wayne County",5,59,22568,10982,11586
050,26,163,"Michigan","Wayne County",5,60,22396,10851,11545
050,26,163,"Michigan","Wayne County",5,61,22442,10852,11590
050,26,163,"Michigan","Wayne County",5,62,22192,10684,11508
050,26,163,"Michigan","Wayne County",5,63,21914,10466,11448
050,26,163,"Michigan","Wayne County",5,64,21811,10346,11465
050,26,163,"Michigan","Wayne County",5,65,21840,10406,11434
050,26,163,"Michigan","Wayne County",5,66,21368,10051,11317
050,26,163,"Michigan","Wayne County",5,67,20251,9355,10896
050,26,163,"Michigan","Wayne County",5,68,19391,8907,10484
050,26,163,"Michigan","Wayne County",5,69,18579,8533,10046
050,26,163,"Michigan","Wayne County",5,70,17463,7906,9557
050,26,163,"Michigan","Wayne County",5,71,16701,7481,9220
050,26,163,"Michigan","Wayne County",5,72,16032,7077,8955
050,26,163,"Michigan","Wayne County",5,73,15047,6597,8450
050,26,163,"Michigan","Wayne County",5,74,14295,6323,7972
050,26,163,"Michigan","Wayne County",5,75,13709,5978,7731
050,26,163,"Michigan","Wayne County",5,76,14082,6093,7989
050,26,163,"Michigan","Wayne County",5,77,9842,4206,5636
050,26,163,"Michigan","Wayne County",5,78,9016,3836,5180
050,26,163,"Michigan","Wayne County",5,79,8632,3670,4962
050,26,163,"Michigan","Wayne County",5,80,8673,3613,5060
050,26,163,"Michigan","Wayne County",5,81,7362,3054,4308
050,26,163,"Michigan","Wayne County",5,82,6486,2697,3789
050,26,163,"Michigan","Wayne County",5,83,5737,2319,3418
050,26,163,"Michigan","Wayne County",5,84,5101,2037,3064
050,26,163,"Michigan","Wayne County",5,85,30039,10356,19683
050,26,165,"Michigan","Wexford County",1,0,367,189,178
050,26,165,"Michigan","Wexford County",1,1,382,203,179
050,26,165,"Michigan","Wexford County",1,2,421,217,204
050,26,165,"Michigan","Wexford County",1,3,413,217,196
050,26,165,"Michigan","Wexford County",1,4,445,249,196
050,26,165,"Michigan","Wexford County",1,5,414,215,199
050,26,165,"Michigan","Wexford County",1,6,413,226,187
050,26,165,"Michigan","Wexford County",1,7,413,205,208
050,26,165,"Michigan","Wexford County",1,8,424,228,196
050,26,165,"Michigan","Wexford County",1,9,452,233,219
050,26,165,"Michigan","Wexford County",1,10,452,225,227
050,26,165,"Michigan","Wexford County",1,11,472,226,246
050,26,165,"Michigan","Wexford County",1,12,465,226,239
050,26,165,"Michigan","Wexford County",1,13,486,229,257
050,26,165,"Michigan","Wexford County",1,14,459,232,227
050,26,165,"Michigan","Wexford County",1,15,465,228,237
050,26,165,"Michigan","Wexford County",1,16,479,234,245
050,26,165,"Michigan","Wexford County",1,17,432,217,215
050,26,165,"Michigan","Wexford County",1,18,364,191,173
050,26,165,"Michigan","Wexford County",1,19,283,142,141
050,26,165,"Michigan","Wexford County",1,20,310,165,145
050,26,165,"Michigan","Wexford County",1,21,317,174,143
050,26,165,"Michigan","Wexford County",1,22,346,175,171
050,26,165,"Michigan","Wexford County",1,23,371,188,183
050,26,165,"Michigan","Wexford County",1,24,373,205,168
050,26,165,"Michigan","Wexford County",1,25,372,202,170
050,26,165,"Michigan","Wexford County",1,26,381,210,171
050,26,165,"Michigan","Wexford County",1,27,424,218,206
050,26,165,"Michigan","Wexford County",1,28,419,204,215
050,26,165,"Michigan","Wexford County",1,29,394,184,210
050,26,165,"Michigan","Wexford County",1,30,383,194,189
050,26,165,"Michigan","Wexford County",1,31,371,187,184
050,26,165,"Michigan","Wexford County",1,32,353,179,174
050,26,165,"Michigan","Wexford County",1,33,374,198,176
050,26,165,"Michigan","Wexford County",1,34,423,201,222
050,26,165,"Michigan","Wexford County",1,35,406,204,202
050,26,165,"Michigan","Wexford County",1,36,400,201,199
050,26,165,"Michigan","Wexford County",1,37,407,206,201
050,26,165,"Michigan","Wexford County",1,38,421,215,206
050,26,165,"Michigan","Wexford County",1,39,398,205,193
050,26,165,"Michigan","Wexford County",1,40,396,203,193
050,26,165,"Michigan","Wexford County",1,41,383,193,190
050,26,165,"Michigan","Wexford County",1,42,359,178,181
050,26,165,"Michigan","Wexford County",1,43,346,171,175
050,26,165,"Michigan","Wexford County",1,44,361,183,178
050,26,165,"Michigan","Wexford County",1,45,363,179,184
050,26,165,"Michigan","Wexford County",1,46,361,188,173
050,26,165,"Michigan","Wexford County",1,47,380,190,190
050,26,165,"Michigan","Wexford County",1,48,383,196,187
050,26,165,"Michigan","Wexford County",1,49,434,229,205
050,26,165,"Michigan","Wexford County",1,50,413,213,200
050,26,165,"Michigan","Wexford County",1,51,448,223,225
050,26,165,"Michigan","Wexford County",1,52,398,207,191
050,26,165,"Michigan","Wexford County",1,53,421,236,185
050,26,165,"Michigan","Wexford County",1,54,446,233,213
050,26,165,"Michigan","Wexford County",1,55,487,246,241
050,26,165,"Michigan","Wexford County",1,56,489,237,252
050,26,165,"Michigan","Wexford County",1,57,485,242,243
050,26,165,"Michigan","Wexford County",1,58,510,255,255
050,26,165,"Michigan","Wexford County",1,59,526,258,268
050,26,165,"Michigan","Wexford County",1,60,504,244,260
050,26,165,"Michigan","Wexford County",1,61,526,279,247
050,26,165,"Michigan","Wexford County",1,62,498,261,237
050,26,165,"Michigan","Wexford County",1,63,512,245,267
050,26,165,"Michigan","Wexford County",1,64,496,235,261
050,26,165,"Michigan","Wexford County",1,65,478,232,246
050,26,165,"Michigan","Wexford County",1,66,481,229,252
050,26,165,"Michigan","Wexford County",1,67,456,228,228
050,26,165,"Michigan","Wexford County",1,68,459,236,223
050,26,165,"Michigan","Wexford County",1,69,391,208,183
050,26,165,"Michigan","Wexford County",1,70,374,184,190
050,26,165,"Michigan","Wexford County",1,71,363,180,183
050,26,165,"Michigan","Wexford County",1,72,394,201,193
050,26,165,"Michigan","Wexford County",1,73,374,195,179
050,26,165,"Michigan","Wexford County",1,74,226,112,114
050,26,165,"Michigan","Wexford County",1,75,249,130,119
050,26,165,"Michigan","Wexford County",1,76,262,128,134
050,26,165,"Michigan","Wexford County",1,77,260,121,139
050,26,165,"Michigan","Wexford County",1,78,220,103,117
050,26,165,"Michigan","Wexford County",1,79,192,91,101
050,26,165,"Michigan","Wexford County",1,80,180,86,94
050,26,165,"Michigan","Wexford County",1,81,175,94,81
050,26,165,"Michigan","Wexford County",1,82,125,61,64
050,26,165,"Michigan","Wexford County",1,83,133,56,77
050,26,165,"Michigan","Wexford County",1,84,120,52,68
050,26,165,"Michigan","Wexford County",1,85,692,251,441
050,26,165,"Michigan","Wexford County",2,0,360,187,173
050,26,165,"Michigan","Wexford County",2,1,376,197,179
050,26,165,"Michigan","Wexford County",2,2,410,210,200
050,26,165,"Michigan","Wexford County",2,3,415,217,198
050,26,165,"Michigan","Wexford County",2,4,437,240,197
050,26,165,"Michigan","Wexford County",2,5,423,224,199
050,26,165,"Michigan","Wexford County",2,6,418,225,193
050,26,165,"Michigan","Wexford County",2,7,418,214,204
050,26,165,"Michigan","Wexford County",2,8,421,224,197
050,26,165,"Michigan","Wexford County",2,9,445,234,211
050,26,165,"Michigan","Wexford County",2,10,452,226,226
050,26,165,"Michigan","Wexford County",2,11,461,222,239
050,26,165,"Michigan","Wexford County",2,12,471,227,244
050,26,165,"Michigan","Wexford County",2,13,479,227,252
050,26,165,"Michigan","Wexford County",2,14,469,232,237
050,26,165,"Michigan","Wexford County",2,15,468,230,238
050,26,165,"Michigan","Wexford County",2,16,475,232,243
050,26,165,"Michigan","Wexford County",2,17,443,223,220
050,26,165,"Michigan","Wexford County",2,18,362,189,173
050,26,165,"Michigan","Wexford County",2,19,284,144,140
050,26,165,"Michigan","Wexford County",2,20,311,163,148
050,26,165,"Michigan","Wexford County",2,21,318,171,147
050,26,165,"Michigan","Wexford County",2,22,347,178,169
050,26,165,"Michigan","Wexford County",2,23,365,186,179
050,26,165,"Michigan","Wexford County",2,24,371,200,171
050,26,165,"Michigan","Wexford County",2,25,372,205,167
050,26,165,"Michigan","Wexford County",2,26,383,212,171
050,26,165,"Michigan","Wexford County",2,27,417,217,200
050,26,165,"Michigan","Wexford County",2,28,420,204,216
050,26,165,"Michigan","Wexford County",2,29,403,187,216
050,26,165,"Michigan","Wexford County",2,30,389,191,198
050,26,165,"Michigan","Wexford County",2,31,372,188,184
050,26,165,"Michigan","Wexford County",2,32,359,183,176
050,26,165,"Michigan","Wexford County",2,33,369,193,176
050,26,165,"Michigan","Wexford County",2,34,411,200,211
050,26,165,"Michigan","Wexford County",2,35,415,204,211
050,26,165,"Michigan","Wexford County",2,36,402,200,202
050,26,165,"Michigan","Wexford County",2,37,409,206,203
050,26,165,"Michigan","Wexford County",2,38,417,213,204
050,26,165,"Michigan","Wexford County",2,39,403,207,196
050,26,165,"Michigan","Wexford County",2,40,399,204,195
050,26,165,"Michigan","Wexford County",2,41,384,195,189
050,26,165,"Michigan","Wexford County",2,42,362,179,183
050,26,165,"Michigan","Wexford County",2,43,353,174,179
050,26,165,"Michigan","Wexford County",2,44,354,179,175
050,26,165,"Michigan","Wexford County",2,45,366,180,186
050,26,165,"Michigan","Wexford County",2,46,363,187,176
050,26,165,"Michigan","Wexford County",2,47,376,189,187
050,26,165,"Michigan","Wexford County",2,48,378,192,186
050,26,165,"Michigan","Wexford County",2,49,423,221,202
050,26,165,"Michigan","Wexford County",2,50,421,218,203
050,26,165,"Michigan","Wexford County",2,51,438,218,220
050,26,165,"Michigan","Wexford County",2,52,409,211,198
050,26,165,"Michigan","Wexford County",2,53,414,228,186
050,26,165,"Michigan","Wexford County",2,54,438,232,206
050,26,165,"Michigan","Wexford County",2,55,479,246,233
050,26,165,"Michigan","Wexford County",2,56,489,239,250
050,26,165,"Michigan","Wexford County",2,57,484,240,244
050,26,165,"Michigan","Wexford County",2,58,499,248,251
050,26,165,"Michigan","Wexford County",2,59,522,258,264
050,26,165,"Michigan","Wexford County",2,60,509,246,263
050,26,165,"Michigan","Wexford County",2,61,516,267,249
050,26,165,"Michigan","Wexford County",2,62,507,267,240
050,26,165,"Michigan","Wexford County",2,63,513,251,262
050,26,165,"Michigan","Wexford County",2,64,497,236,261
050,26,165,"Michigan","Wexford County",2,65,478,229,249
050,26,165,"Michigan","Wexford County",2,66,485,231,254
050,26,165,"Michigan","Wexford County",2,67,460,229,231
050,26,165,"Michigan","Wexford County",2,68,455,233,222
050,26,165,"Michigan","Wexford County",2,69,408,214,194
050,26,165,"Michigan","Wexford County",2,70,378,190,188
050,26,165,"Michigan","Wexford County",2,71,368,181,187
050,26,165,"Michigan","Wexford County",2,72,380,194,186
050,26,165,"Michigan","Wexford County",2,73,394,207,187
050,26,165,"Michigan","Wexford County",2,74,243,123,120
050,26,165,"Michigan","Wexford County",2,75,245,127,118
050,26,165,"Michigan","Wexford County",2,76,255,126,129
050,26,165,"Michigan","Wexford County",2,77,266,125,141
050,26,165,"Michigan","Wexford County",2,78,219,104,115
050,26,165,"Michigan","Wexford County",2,79,194,91,103
050,26,165,"Michigan","Wexford County",2,80,180,85,95
050,26,165,"Michigan","Wexford County",2,81,172,90,82
050,26,165,"Michigan","Wexford County",2,82,135,68,67
050,26,165,"Michigan","Wexford County",2,83,129,57,72
050,26,165,"Michigan","Wexford County",2,84,119,52,67
050,26,165,"Michigan","Wexford County",2,85,697,252,445
050,26,165,"Michigan","Wexford County",3,0,347,179,168
050,26,165,"Michigan","Wexford County",3,1,367,185,182
050,26,165,"Michigan","Wexford County",3,2,388,198,190
050,26,165,"Michigan","Wexford County",3,3,397,198,199
050,26,165,"Michigan","Wexford County",3,4,422,224,198
050,26,165,"Michigan","Wexford County",3,5,435,235,200
050,26,165,"Michigan","Wexford County",3,6,429,229,200
050,26,165,"Michigan","Wexford County",3,7,423,230,193
050,26,165,"Michigan","Wexford County",3,8,425,220,205
050,26,165,"Michigan","Wexford County",3,9,425,219,206
050,26,165,"Michigan","Wexford County",3,10,458,243,215
050,26,165,"Michigan","Wexford County",3,11,448,221,227
050,26,165,"Michigan","Wexford County",3,12,454,222,232
050,26,165,"Michigan","Wexford County",3,13,483,235,248
050,26,165,"Michigan","Wexford County",3,14,483,236,247
050,26,165,"Michigan","Wexford County",3,15,479,234,245
050,26,165,"Michigan","Wexford County",3,16,473,236,237
050,26,165,"Michigan","Wexford County",3,17,477,232,245
050,26,165,"Michigan","Wexford County",3,18,385,201,184
050,26,165,"Michigan","Wexford County",3,19,298,158,140
050,26,165,"Michigan","Wexford County",3,20,305,168,137
050,26,165,"Michigan","Wexford County",3,21,330,167,163
050,26,165,"Michigan","Wexford County",3,22,329,175,154
050,26,165,"Michigan","Wexford County",3,23,354,176,178
050,26,165,"Michigan","Wexford County",3,24,351,188,163
050,26,165,"Michigan","Wexford County",3,25,358,189,169
050,26,165,"Michigan","Wexford County",3,26,392,218,174
050,26,165,"Michigan","Wexford County",3,27,399,212,187
050,26,165,"Michigan","Wexford County",3,28,423,214,209
050,26,165,"Michigan","Wexford County",3,29,429,210,219
050,26,165,"Michigan","Wexford County",3,30,413,206,207
050,26,165,"Michigan","Wexford County",3,31,388,194,194
050,26,165,"Michigan","Wexford County",3,32,387,194,193
050,26,165,"Michigan","Wexford County",3,33,376,189,187
050,26,165,"Michigan","Wexford County",3,34,380,194,186
050,26,165,"Michigan","Wexford County",3,35,401,195,206
050,26,165,"Michigan","Wexford County",3,36,431,212,219
050,26,165,"Michigan","Wexford County",3,37,393,201,192
050,26,165,"Michigan","Wexford County",3,38,413,210,203
050,26,165,"Michigan","Wexford County",3,39,424,212,212
050,26,165,"Michigan","Wexford County",3,40,416,211,205
050,26,165,"Michigan","Wexford County",3,41,408,210,198
050,26,165,"Michigan","Wexford County",3,42,383,192,191
050,26,165,"Michigan","Wexford County",3,43,366,182,184
050,26,165,"Michigan","Wexford County",3,44,376,185,191
050,26,165,"Michigan","Wexford County",3,45,349,180,169
050,26,165,"Michigan","Wexford County",3,46,367,181,186
050,26,165,"Michigan","Wexford County",3,47,367,189,178
050,26,165,"Michigan","Wexford County",3,48,363,175,188
050,26,165,"Michigan","Wexford County",3,49,382,202,180
050,26,165,"Michigan","Wexford County",3,50,438,234,204
050,26,165,"Michigan","Wexford County",3,51,414,218,196
050,26,165,"Michigan","Wexford County",3,52,441,218,223
050,26,165,"Michigan","Wexford County",3,53,420,216,204
050,26,165,"Michigan","Wexford County",3,54,414,221,193
050,26,165,"Michigan","Wexford County",3,55,441,236,205
050,26,165,"Michigan","Wexford County",3,56,485,243,242
050,26,165,"Michigan","Wexford County",3,57,496,241,255
050,26,165,"Michigan","Wexford County",3,58,478,236,242
050,26,165,"Michigan","Wexford County",3,59,483,243,240
050,26,165,"Michigan","Wexford County",3,60,524,255,269
050,26,165,"Michigan","Wexford County",3,61,517,256,261
050,26,165,"Michigan","Wexford County",3,62,537,277,260
050,26,165,"Michigan","Wexford County",3,63,512,272,240
050,26,165,"Michigan","Wexford County",3,64,520,260,260
050,26,165,"Michigan","Wexford County",3,65,489,230,259
050,26,165,"Michigan","Wexford County",3,66,472,221,251
050,26,165,"Michigan","Wexford County",3,67,463,219,244
050,26,165,"Michigan","Wexford County",3,68,457,223,234
050,26,165,"Michigan","Wexford County",3,69,438,224,214
050,26,165,"Michigan","Wexford County",3,70,404,213,191
050,26,165,"Michigan","Wexford County",3,71,364,180,184
050,26,165,"Michigan","Wexford County",3,72,357,182,175
050,26,165,"Michigan","Wexford County",3,73,375,185,190
050,26,165,"Michigan","Wexford County",3,74,380,201,179
050,26,165,"Michigan","Wexford County",3,75,235,119,116
050,26,165,"Michigan","Wexford County",3,76,234,117,117
050,26,165,"Michigan","Wexford County",3,77,237,118,119
050,26,165,"Michigan","Wexford County",3,78,251,115,136
050,26,165,"Michigan","Wexford County",3,79,211,99,112
050,26,165,"Michigan","Wexford County",3,80,192,88,104
050,26,165,"Michigan","Wexford County",3,81,168,78,90
050,26,165,"Michigan","Wexford County",3,82,167,83,84
050,26,165,"Michigan","Wexford County",3,83,135,67,68
050,26,165,"Michigan","Wexford County",3,84,111,52,59
050,26,165,"Michigan","Wexford County",3,85,689,252,437
050,26,165,"Michigan","Wexford County",4,0,341,179,162
050,26,165,"Michigan","Wexford County",4,1,353,185,168
050,26,165,"Michigan","Wexford County",4,2,392,201,191
050,26,165,"Michigan","Wexford County",4,3,385,196,189
050,26,165,"Michigan","Wexford County",4,4,414,207,207
050,26,165,"Michigan","Wexford County",4,5,423,216,207
050,26,165,"Michigan","Wexford County",4,6,453,238,215
050,26,165,"Michigan","Wexford County",4,7,430,227,203
050,26,165,"Michigan","Wexford County",4,8,406,219,187
050,26,165,"Michigan","Wexford County",4,9,430,216,214
050,26,165,"Michigan","Wexford County",4,10,423,220,203
050,26,165,"Michigan","Wexford County",4,11,471,250,221
050,26,165,"Michigan","Wexford County",4,12,455,220,235
050,26,165,"Michigan","Wexford County",4,13,443,212,231
050,26,165,"Michigan","Wexford County",4,14,499,239,260
050,26,165,"Michigan","Wexford County",4,15,485,240,245
050,26,165,"Michigan","Wexford County",4,16,482,234,248
050,26,165,"Michigan","Wexford County",4,17,483,245,238
050,26,165,"Michigan","Wexford County",4,18,389,201,188
050,26,165,"Michigan","Wexford County",4,19,290,157,133
050,26,165,"Michigan","Wexford County",4,20,316,170,146
050,26,165,"Michigan","Wexford County",4,21,310,160,150
050,26,165,"Michigan","Wexford County",4,22,350,174,176
050,26,165,"Michigan","Wexford County",4,23,361,187,174
050,26,165,"Michigan","Wexford County",4,24,361,181,180
050,26,165,"Michigan","Wexford County",4,25,388,199,189
050,26,165,"Michigan","Wexford County",4,26,353,177,176
050,26,165,"Michigan","Wexford County",4,27,378,213,165
050,26,165,"Michigan","Wexford County",4,28,370,200,170
050,26,165,"Michigan","Wexford County",4,29,446,228,218
050,26,165,"Michigan","Wexford County",4,30,445,218,227
050,26,165,"Michigan","Wexford County",4,31,419,215,204
050,26,165,"Michigan","Wexford County",4,32,397,199,198
050,26,165,"Michigan","Wexford County",4,33,395,207,188
050,26,165,"Michigan","Wexford County",4,34,374,188,186
050,26,165,"Michigan","Wexford County",4,35,378,195,183
050,26,165,"Michigan","Wexford County",4,36,417,200,217
050,26,165,"Michigan","Wexford County",4,37,450,217,233
050,26,165,"Michigan","Wexford County",4,38,389,199,190
050,26,165,"Michigan","Wexford County",4,39,425,214,211
050,26,165,"Michigan","Wexford County",4,40,429,217,212
050,26,165,"Michigan","Wexford County",4,41,429,220,209
050,26,165,"Michigan","Wexford County",4,42,395,205,190
050,26,165,"Michigan","Wexford County",4,43,390,193,197
050,26,165,"Michigan","Wexford County",4,44,372,176,196
050,26,165,"Michigan","Wexford County",4,45,383,194,189
050,26,165,"Michigan","Wexford County",4,46,354,179,175
050,26,165,"Michigan","Wexford County",4,47,368,186,182
050,26,165,"Michigan","Wexford County",4,48,369,188,181
050,26,165,"Michigan","Wexford County",4,49,365,180,185
050,26,165,"Michigan","Wexford County",4,50,387,201,186
050,26,165,"Michigan","Wexford County",4,51,441,230,211
050,26,165,"Michigan","Wexford County",4,52,414,220,194
050,26,165,"Michigan","Wexford County",4,53,437,217,220
050,26,165,"Michigan","Wexford County",4,54,418,217,201
050,26,165,"Michigan","Wexford County",4,55,411,218,193
050,26,165,"Michigan","Wexford County",4,56,422,225,197
050,26,165,"Michigan","Wexford County",4,57,485,244,241
050,26,165,"Michigan","Wexford County",4,58,489,240,249
050,26,165,"Michigan","Wexford County",4,59,482,236,246
050,26,165,"Michigan","Wexford County",4,60,485,241,244
050,26,165,"Michigan","Wexford County",4,61,535,263,272
050,26,165,"Michigan","Wexford County",4,62,520,258,262
050,26,165,"Michigan","Wexford County",4,63,535,281,254
050,26,165,"Michigan","Wexford County",4,64,515,275,240
050,26,165,"Michigan","Wexford County",4,65,515,258,257
050,26,165,"Michigan","Wexford County",4,66,479,224,255
050,26,165,"Michigan","Wexford County",4,67,457,212,245
050,26,165,"Michigan","Wexford County",4,68,467,221,246
050,26,165,"Michigan","Wexford County",4,69,441,212,229
050,26,165,"Michigan","Wexford County",4,70,426,221,205
050,26,165,"Michigan","Wexford County",4,71,405,211,194
050,26,165,"Michigan","Wexford County",4,72,359,180,179
050,26,165,"Michigan","Wexford County",4,73,353,177,176
050,26,165,"Michigan","Wexford County",4,74,357,178,179
050,26,165,"Michigan","Wexford County",4,75,368,195,173
050,26,165,"Michigan","Wexford County",4,76,228,114,114
050,26,165,"Michigan","Wexford County",4,77,225,114,111
050,26,165,"Michigan","Wexford County",4,78,224,111,113
050,26,165,"Michigan","Wexford County",4,79,233,109,124
050,26,165,"Michigan","Wexford County",4,80,209,96,113
050,26,165,"Michigan","Wexford County",4,81,168,76,92
050,26,165,"Michigan","Wexford County",4,82,153,66,87
050,26,165,"Michigan","Wexford County",4,83,168,81,87
050,26,165,"Michigan","Wexford County",4,84,110,56,54
050,26,165,"Michigan","Wexford County",4,85,674,262,412
050,26,165,"Michigan","Wexford County",5,0,343,181,162
050,26,165,"Michigan","Wexford County",5,1,351,176,175
050,26,165,"Michigan","Wexford County",5,2,349,179,170
050,26,165,"Michigan","Wexford County",5,3,417,213,204
050,26,165,"Michigan","Wexford County",5,4,368,188,180
050,26,165,"Michigan","Wexford County",5,5,423,218,205
050,26,165,"Michigan","Wexford County",5,6,442,228,214
050,26,165,"Michigan","Wexford County",5,7,459,239,220
050,26,165,"Michigan","Wexford County",5,8,437,230,207
050,26,165,"Michigan","Wexford County",5,9,416,228,188
050,26,165,"Michigan","Wexford County",5,10,440,226,214
050,26,165,"Michigan","Wexford County",5,11,411,215,196
050,26,165,"Michigan","Wexford County",5,12,475,254,221
050,26,165,"Michigan","Wexford County",5,13,464,227,237
050,26,165,"Michigan","Wexford County",5,14,465,226,239
050,26,165,"Michigan","Wexford County",5,15,505,251,254
050,26,165,"Michigan","Wexford County",5,16,488,241,247
050,26,165,"Michigan","Wexford County",5,17,485,240,245
050,26,165,"Michigan","Wexford County",5,18,418,216,202
050,26,165,"Michigan","Wexford County",5,19,308,163,145
050,26,165,"Michigan","Wexford County",5,20,323,179,144
050,26,165,"Michigan","Wexford County",5,21,326,172,154
050,26,165,"Michigan","Wexford County",5,22,348,173,175
050,26,165,"Michigan","Wexford County",5,23,358,175,183
050,26,165,"Michigan","Wexford County",5,24,348,179,169
050,26,165,"Michigan","Wexford County",5,25,342,168,174
050,26,165,"Michigan","Wexford County",5,26,376,194,182
050,26,165,"Michigan","Wexford County",5,27,368,182,186
050,26,165,"Michigan","Wexford County",5,28,384,216,168
050,26,165,"Michigan","Wexford County",5,29,378,196,182
050,26,165,"Michigan","Wexford County",5,30,460,236,224
050,26,165,"Michigan","Wexford County",5,31,428,205,223
050,26,165,"Michigan","Wexford County",5,32,440,225,215
050,26,165,"Michigan","Wexford County",5,33,391,199,192
050,26,165,"Michigan","Wexford County",5,34,419,225,194
050,26,165,"Michigan","Wexford County",5,35,388,197,191
050,26,165,"Michigan","Wexford County",5,36,394,197,197
050,26,165,"Michigan","Wexford County",5,37,407,190,217
050,26,165,"Michigan","Wexford County",5,38,462,229,233
050,26,165,"Michigan","Wexford County",5,39,394,197,197
050,26,165,"Michigan","Wexford County",5,40,427,220,207
050,26,165,"Michigan","Wexford County",5,41,436,219,217
050,26,165,"Michigan","Wexford County",5,42,430,216,214
050,26,165,"Michigan","Wexford County",5,43,401,207,194
050,26,165,"Michigan","Wexford County",5,44,393,194,199
050,26,165,"Michigan","Wexford County",5,45,368,169,199
050,26,165,"Michigan","Wexford County",5,46,385,194,191
050,26,165,"Michigan","Wexford County",5,47,354,173,181
050,26,165,"Michigan","Wexford County",5,48,373,192,181
050,26,165,"Michigan","Wexford County",5,49,366,186,180
050,26,165,"Michigan","Wexford County",5,50,364,177,187
050,26,165,"Michigan","Wexford County",5,51,387,196,191
050,26,165,"Michigan","Wexford County",5,52,432,230,202
050,26,165,"Michigan","Wexford County",5,53,406,218,188
050,26,165,"Michigan","Wexford County",5,54,441,215,226
050,26,165,"Michigan","Wexford County",5,55,413,224,189
050,26,165,"Michigan","Wexford County",5,56,413,216,197
050,26,165,"Michigan","Wexford County",5,57,420,231,189
050,26,165,"Michigan","Wexford County",5,58,487,241,246
050,26,165,"Michigan","Wexford County",5,59,495,242,253
050,26,165,"Michigan","Wexford County",5,60,484,233,251
050,26,165,"Michigan","Wexford County",5,61,485,241,244
050,26,165,"Michigan","Wexford County",5,62,527,260,267
050,26,165,"Michigan","Wexford County",5,63,511,262,249
050,26,165,"Michigan","Wexford County",5,64,537,279,258
050,26,165,"Michigan","Wexford County",5,65,515,273,242
050,26,165,"Michigan","Wexford County",5,66,500,243,257
050,26,165,"Michigan","Wexford County",5,67,467,220,247
050,26,165,"Michigan","Wexford County",5,68,452,207,245
050,26,165,"Michigan","Wexford County",5,69,451,215,236
050,26,165,"Michigan","Wexford County",5,70,441,215,226
050,26,165,"Michigan","Wexford County",5,71,423,212,211
050,26,165,"Michigan","Wexford County",5,72,389,207,182
050,26,165,"Michigan","Wexford County",5,73,351,174,177
050,26,165,"Michigan","Wexford County",5,74,340,171,169
050,26,165,"Michigan","Wexford County",5,75,346,174,172
050,26,165,"Michigan","Wexford County",5,76,359,186,173
050,26,165,"Michigan","Wexford County",5,77,216,111,105
050,26,165,"Michigan","Wexford County",5,78,205,102,103
050,26,165,"Michigan","Wexford County",5,79,209,103,106
050,26,165,"Michigan","Wexford County",5,80,222,104,118
050,26,165,"Michigan","Wexford County",5,81,189,87,102
050,26,165,"Michigan","Wexford County",5,82,153,66,87
050,26,165,"Michigan","Wexford County",5,83,149,62,87
050,26,165,"Michigan","Wexford County",5,84,142,72,70
050,26,165,"Michigan","Wexford County",5,85,670,277,393

