"SUMLEV","STATE","COUNTY","STNAME","CTYNAME","YEAR","AGE","TOT_POP","TOT_MALE","TOT_FEMALE"
050,30,001,"Montana","Beaverhead County",1,0,81,42,39
050,30,001,"Montana","Beaverhead County",1,1,78,43,35
050,30,001,"Montana","Beaverhead County",1,2,83,47,36
050,30,001,"Montana","Beaverhead County",1,3,74,35,39
050,30,001,"Montana","Beaverhead County",1,4,85,41,44
050,30,001,"Montana","Beaverhead County",1,5,89,41,48
050,30,001,"Montana","Beaverhead County",1,6,95,39,56
050,30,001,"Montana","Beaverhead County",1,7,86,42,44
050,30,001,"Montana","Beaverhead County",1,8,104,49,55
050,30,001,"Montana","Beaverhead County",1,9,80,38,42
050,30,001,"Montana","Beaverhead County",1,10,84,36,48
050,30,001,"Montana","Beaverhead County",1,11,80,38,42
050,30,001,"Montana","Beaverhead County",1,12,89,50,39
050,30,001,"Montana","Beaverhead County",1,13,93,44,49
050,30,001,"Montana","Beaverhead County",1,14,98,50,48
050,30,001,"Montana","Beaverhead County",1,15,85,44,41
050,30,001,"Montana","Beaverhead County",1,16,152,97,55
050,30,001,"Montana","Beaverhead County",1,17,125,73,52
050,30,001,"Montana","Beaverhead County",1,18,138,80,58
050,30,001,"Montana","Beaverhead County",1,19,177,71,106
050,30,001,"Montana","Beaverhead County",1,20,180,86,94
050,30,001,"Montana","Beaverhead County",1,21,233,127,106
050,30,001,"Montana","Beaverhead County",1,22,190,98,92
050,30,001,"Montana","Beaverhead County",1,23,179,58,121
050,30,001,"Montana","Beaverhead County",1,24,145,88,57
050,30,001,"Montana","Beaverhead County",1,25,116,63,53
050,30,001,"Montana","Beaverhead County",1,26,97,52,45
050,30,001,"Montana","Beaverhead County",1,27,106,63,43
050,30,001,"Montana","Beaverhead County",1,28,102,56,46
050,30,001,"Montana","Beaverhead County",1,29,87,43,44
050,30,001,"Montana","Beaverhead County",1,30,112,56,56
050,30,001,"Montana","Beaverhead County",1,31,92,49,43
050,30,001,"Montana","Beaverhead County",1,32,89,45,44
050,30,001,"Montana","Beaverhead County",1,33,93,45,48
050,30,001,"Montana","Beaverhead County",1,34,86,40,46
050,30,001,"Montana","Beaverhead County",1,35,100,44,56
050,30,001,"Montana","Beaverhead County",1,36,110,53,57
050,30,001,"Montana","Beaverhead County",1,37,110,57,53
050,30,001,"Montana","Beaverhead County",1,38,97,52,45
050,30,001,"Montana","Beaverhead County",1,39,106,66,40
050,30,001,"Montana","Beaverhead County",1,40,103,47,56
050,30,001,"Montana","Beaverhead County",1,41,98,51,47
050,30,001,"Montana","Beaverhead County",1,42,125,74,51
050,30,001,"Montana","Beaverhead County",1,43,87,48,39
050,30,001,"Montana","Beaverhead County",1,44,90,48,42
050,30,001,"Montana","Beaverhead County",1,45,92,53,39
050,30,001,"Montana","Beaverhead County",1,46,87,52,35
050,30,001,"Montana","Beaverhead County",1,47,83,45,38
050,30,001,"Montana","Beaverhead County",1,48,95,50,45
050,30,001,"Montana","Beaverhead County",1,49,101,50,51
050,30,001,"Montana","Beaverhead County",1,50,92,45,47
050,30,001,"Montana","Beaverhead County",1,51,79,46,33
050,30,001,"Montana","Beaverhead County",1,52,90,49,41
050,30,001,"Montana","Beaverhead County",1,53,97,45,52
050,30,001,"Montana","Beaverhead County",1,54,99,51,48
050,30,001,"Montana","Beaverhead County",1,55,114,58,56
050,30,001,"Montana","Beaverhead County",1,56,130,62,68
050,30,001,"Montana","Beaverhead County",1,57,117,56,61
050,30,001,"Montana","Beaverhead County",1,58,139,73,66
050,30,001,"Montana","Beaverhead County",1,59,134,71,63
050,30,001,"Montana","Beaverhead County",1,60,138,71,67
050,30,001,"Montana","Beaverhead County",1,61,147,67,80
050,30,001,"Montana","Beaverhead County",1,62,146,82,64
050,30,001,"Montana","Beaverhead County",1,63,144,76,68
050,30,001,"Montana","Beaverhead County",1,64,155,83,72
050,30,001,"Montana","Beaverhead County",1,65,179,86,93
050,30,001,"Montana","Beaverhead County",1,66,152,67,85
050,30,001,"Montana","Beaverhead County",1,67,127,65,62
050,30,001,"Montana","Beaverhead County",1,68,130,67,63
050,30,001,"Montana","Beaverhead County",1,69,120,68,52
050,30,001,"Montana","Beaverhead County",1,70,114,61,53
050,30,001,"Montana","Beaverhead County",1,71,126,71,55
050,30,001,"Montana","Beaverhead County",1,72,133,69,64
050,30,001,"Montana","Beaverhead County",1,73,127,72,55
050,30,001,"Montana","Beaverhead County",1,74,79,43,36
050,30,001,"Montana","Beaverhead County",1,75,89,46,43
050,30,001,"Montana","Beaverhead County",1,76,78,40,38
050,30,001,"Montana","Beaverhead County",1,77,82,44,38
050,30,001,"Montana","Beaverhead County",1,78,80,39,41
050,30,001,"Montana","Beaverhead County",1,79,80,40,40
050,30,001,"Montana","Beaverhead County",1,80,69,36,33
050,30,001,"Montana","Beaverhead County",1,81,49,23,26
050,30,001,"Montana","Beaverhead County",1,82,55,28,27
050,30,001,"Montana","Beaverhead County",1,83,53,32,21
050,30,001,"Montana","Beaverhead County",1,84,37,21,16
050,30,001,"Montana","Beaverhead County",1,85,227,97,130
050,30,001,"Montana","Beaverhead County",2,0,77,43,34
050,30,001,"Montana","Beaverhead County",2,1,79,43,36
050,30,001,"Montana","Beaverhead County",2,2,82,45,37
050,30,001,"Montana","Beaverhead County",2,3,75,37,38
050,30,001,"Montana","Beaverhead County",2,4,83,41,42
050,30,001,"Montana","Beaverhead County",2,5,87,40,47
050,30,001,"Montana","Beaverhead County",2,6,93,39,54
050,30,001,"Montana","Beaverhead County",2,7,88,42,46
050,30,001,"Montana","Beaverhead County",2,8,97,46,51
050,30,001,"Montana","Beaverhead County",2,9,83,39,44
050,30,001,"Montana","Beaverhead County",2,10,83,36,47
050,30,001,"Montana","Beaverhead County",2,11,79,37,42
050,30,001,"Montana","Beaverhead County",2,12,87,47,40
050,30,001,"Montana","Beaverhead County",2,13,91,45,46
050,30,001,"Montana","Beaverhead County",2,14,98,50,48
050,30,001,"Montana","Beaverhead County",2,15,88,46,42
050,30,001,"Montana","Beaverhead County",2,16,153,97,56
050,30,001,"Montana","Beaverhead County",2,17,121,71,50
050,30,001,"Montana","Beaverhead County",2,18,140,81,59
050,30,001,"Montana","Beaverhead County",2,19,177,71,106
050,30,001,"Montana","Beaverhead County",2,20,181,88,93
050,30,001,"Montana","Beaverhead County",2,21,228,123,105
050,30,001,"Montana","Beaverhead County",2,22,193,101,92
050,30,001,"Montana","Beaverhead County",2,23,181,60,121
050,30,001,"Montana","Beaverhead County",2,24,143,84,59
050,30,001,"Montana","Beaverhead County",2,25,118,63,55
050,30,001,"Montana","Beaverhead County",2,26,99,54,45
050,30,001,"Montana","Beaverhead County",2,27,101,59,42
050,30,001,"Montana","Beaverhead County",2,28,103,57,46
050,30,001,"Montana","Beaverhead County",2,29,93,48,45
050,30,001,"Montana","Beaverhead County",2,30,106,53,53
050,30,001,"Montana","Beaverhead County",2,31,97,50,47
050,30,001,"Montana","Beaverhead County",2,32,90,45,45
050,30,001,"Montana","Beaverhead County",2,33,92,45,47
050,30,001,"Montana","Beaverhead County",2,34,88,41,47
050,30,001,"Montana","Beaverhead County",2,35,99,44,55
050,30,001,"Montana","Beaverhead County",2,36,109,52,57
050,30,001,"Montana","Beaverhead County",2,37,110,56,54
050,30,001,"Montana","Beaverhead County",2,38,101,55,46
050,30,001,"Montana","Beaverhead County",2,39,105,63,42
050,30,001,"Montana","Beaverhead County",2,40,102,51,51
050,30,001,"Montana","Beaverhead County",2,41,101,51,50
050,30,001,"Montana","Beaverhead County",2,42,117,68,49
050,30,001,"Montana","Beaverhead County",2,43,97,55,42
050,30,001,"Montana","Beaverhead County",2,44,89,48,41
050,30,001,"Montana","Beaverhead County",2,45,91,52,39
050,30,001,"Montana","Beaverhead County",2,46,87,52,35
050,30,001,"Montana","Beaverhead County",2,47,84,47,37
050,30,001,"Montana","Beaverhead County",2,48,94,50,44
050,30,001,"Montana","Beaverhead County",2,49,100,50,50
050,30,001,"Montana","Beaverhead County",2,50,93,46,47
050,30,001,"Montana","Beaverhead County",2,51,83,45,38
050,30,001,"Montana","Beaverhead County",2,52,88,49,39
050,30,001,"Montana","Beaverhead County",2,53,95,46,49
050,30,001,"Montana","Beaverhead County",2,54,98,49,49
050,30,001,"Montana","Beaverhead County",2,55,113,58,55
050,30,001,"Montana","Beaverhead County",2,56,126,61,65
050,30,001,"Montana","Beaverhead County",2,57,119,57,62
050,30,001,"Montana","Beaverhead County",2,58,134,69,65
050,30,001,"Montana","Beaverhead County",2,59,136,73,63
050,30,001,"Montana","Beaverhead County",2,60,137,70,67
050,30,001,"Montana","Beaverhead County",2,61,144,66,78
050,30,001,"Montana","Beaverhead County",2,62,148,79,69
050,30,001,"Montana","Beaverhead County",2,63,147,79,68
050,30,001,"Montana","Beaverhead County",2,64,152,81,71
050,30,001,"Montana","Beaverhead County",2,65,175,86,89
050,30,001,"Montana","Beaverhead County",2,66,156,70,86
050,30,001,"Montana","Beaverhead County",2,67,133,66,67
050,30,001,"Montana","Beaverhead County",2,68,129,67,62
050,30,001,"Montana","Beaverhead County",2,69,125,69,56
050,30,001,"Montana","Beaverhead County",2,70,115,63,52
050,30,001,"Montana","Beaverhead County",2,71,125,70,55
050,30,001,"Montana","Beaverhead County",2,72,127,68,59
050,30,001,"Montana","Beaverhead County",2,73,135,75,60
050,30,001,"Montana","Beaverhead County",2,74,84,45,39
050,30,001,"Montana","Beaverhead County",2,75,88,46,42
050,30,001,"Montana","Beaverhead County",2,76,79,41,38
050,30,001,"Montana","Beaverhead County",2,77,84,44,40
050,30,001,"Montana","Beaverhead County",2,78,78,39,39
050,30,001,"Montana","Beaverhead County",2,79,78,38,40
050,30,001,"Montana","Beaverhead County",2,80,69,35,34
050,30,001,"Montana","Beaverhead County",2,81,53,26,27
050,30,001,"Montana","Beaverhead County",2,82,54,27,27
050,30,001,"Montana","Beaverhead County",2,83,53,31,22
050,30,001,"Montana","Beaverhead County",2,84,40,24,16
050,30,001,"Montana","Beaverhead County",2,85,229,101,128
050,30,001,"Montana","Beaverhead County",3,0,91,46,45
050,30,001,"Montana","Beaverhead County",3,1,71,37,34
050,30,001,"Montana","Beaverhead County",3,2,91,53,38
050,30,001,"Montana","Beaverhead County",3,3,92,49,43
050,30,001,"Montana","Beaverhead County",3,4,85,44,41
050,30,001,"Montana","Beaverhead County",3,5,89,48,41
050,30,001,"Montana","Beaverhead County",3,6,82,37,45
050,30,001,"Montana","Beaverhead County",3,7,100,42,58
050,30,001,"Montana","Beaverhead County",3,8,92,46,46
050,30,001,"Montana","Beaverhead County",3,9,95,46,49
050,30,001,"Montana","Beaverhead County",3,10,88,44,44
050,30,001,"Montana","Beaverhead County",3,11,89,41,48
050,30,001,"Montana","Beaverhead County",3,12,79,36,43
050,30,001,"Montana","Beaverhead County",3,13,89,48,41
050,30,001,"Montana","Beaverhead County",3,14,87,45,42
050,30,001,"Montana","Beaverhead County",3,15,98,52,46
050,30,001,"Montana","Beaverhead County",3,16,152,98,54
050,30,001,"Montana","Beaverhead County",3,17,109,65,44
050,30,001,"Montana","Beaverhead County",3,18,145,78,67
050,30,001,"Montana","Beaverhead County",3,19,175,70,105
050,30,001,"Montana","Beaverhead County",3,20,163,85,78
050,30,001,"Montana","Beaverhead County",3,21,210,115,95
050,30,001,"Montana","Beaverhead County",3,22,198,106,92
050,30,001,"Montana","Beaverhead County",3,23,193,72,121
050,30,001,"Montana","Beaverhead County",3,24,124,62,62
050,30,001,"Montana","Beaverhead County",3,25,119,63,56
050,30,001,"Montana","Beaverhead County",3,26,112,63,49
050,30,001,"Montana","Beaverhead County",3,27,100,58,42
050,30,001,"Montana","Beaverhead County",3,28,107,62,45
050,30,001,"Montana","Beaverhead County",3,29,111,57,54
050,30,001,"Montana","Beaverhead County",3,30,94,44,50
050,30,001,"Montana","Beaverhead County",3,31,106,47,59
050,30,001,"Montana","Beaverhead County",3,32,103,56,47
050,30,001,"Montana","Beaverhead County",3,33,98,49,49
050,30,001,"Montana","Beaverhead County",3,34,94,45,49
050,30,001,"Montana","Beaverhead County",3,35,94,44,50
050,30,001,"Montana","Beaverhead County",3,36,117,53,64
050,30,001,"Montana","Beaverhead County",3,37,110,51,59
050,30,001,"Montana","Beaverhead County",3,38,124,66,58
050,30,001,"Montana","Beaverhead County",3,39,105,65,40
050,30,001,"Montana","Beaverhead County",3,40,97,58,39
050,30,001,"Montana","Beaverhead County",3,41,108,55,53
050,30,001,"Montana","Beaverhead County",3,42,104,51,53
050,30,001,"Montana","Beaverhead County",3,43,117,66,51
050,30,001,"Montana","Beaverhead County",3,44,93,51,42
050,30,001,"Montana","Beaverhead County",3,45,86,46,40
050,30,001,"Montana","Beaverhead County",3,46,95,51,44
050,30,001,"Montana","Beaverhead County",3,47,80,47,33
050,30,001,"Montana","Beaverhead County",3,48,93,51,42
050,30,001,"Montana","Beaverhead County",3,49,99,53,46
050,30,001,"Montana","Beaverhead County",3,50,108,52,56
050,30,001,"Montana","Beaverhead County",3,51,97,48,49
050,30,001,"Montana","Beaverhead County",3,52,89,48,41
050,30,001,"Montana","Beaverhead County",3,53,86,47,39
050,30,001,"Montana","Beaverhead County",3,54,103,51,52
050,30,001,"Montana","Beaverhead County",3,55,109,55,54
050,30,001,"Montana","Beaverhead County",3,56,98,47,51
050,30,001,"Montana","Beaverhead County",3,57,128,66,62
050,30,001,"Montana","Beaverhead County",3,58,130,68,62
050,30,001,"Montana","Beaverhead County",3,59,135,71,64
050,30,001,"Montana","Beaverhead County",3,60,134,71,63
050,30,001,"Montana","Beaverhead County",3,61,137,67,70
050,30,001,"Montana","Beaverhead County",3,62,153,74,79
050,30,001,"Montana","Beaverhead County",3,63,161,86,75
050,30,001,"Montana","Beaverhead County",3,64,152,84,68
050,30,001,"Montana","Beaverhead County",3,65,154,85,69
050,30,001,"Montana","Beaverhead County",3,66,176,83,93
050,30,001,"Montana","Beaverhead County",3,67,153,67,86
050,30,001,"Montana","Beaverhead County",3,68,135,68,67
050,30,001,"Montana","Beaverhead County",3,69,133,68,65
050,30,001,"Montana","Beaverhead County",3,70,123,69,54
050,30,001,"Montana","Beaverhead County",3,71,123,67,56
050,30,001,"Montana","Beaverhead County",3,72,116,68,48
050,30,001,"Montana","Beaverhead County",3,73,121,64,57
050,30,001,"Montana","Beaverhead County",3,74,135,72,63
050,30,001,"Montana","Beaverhead County",3,75,82,42,40
050,30,001,"Montana","Beaverhead County",3,76,84,43,41
050,30,001,"Montana","Beaverhead County",3,77,75,36,39
050,30,001,"Montana","Beaverhead County",3,78,76,40,36
050,30,001,"Montana","Beaverhead County",3,79,69,35,34
050,30,001,"Montana","Beaverhead County",3,80,75,34,41
050,30,001,"Montana","Beaverhead County",3,81,62,33,29
050,30,001,"Montana","Beaverhead County",3,82,49,25,24
050,30,001,"Montana","Beaverhead County",3,83,47,23,24
050,30,001,"Montana","Beaverhead County",3,84,50,30,20
050,30,001,"Montana","Beaverhead County",3,85,242,114,128
050,30,001,"Montana","Beaverhead County",4,0,86,43,43
050,30,001,"Montana","Beaverhead County",4,1,86,47,39
050,30,001,"Montana","Beaverhead County",4,2,73,39,34
050,30,001,"Montana","Beaverhead County",4,3,90,53,37
050,30,001,"Montana","Beaverhead County",4,4,89,49,40
050,30,001,"Montana","Beaverhead County",4,5,89,43,46
050,30,001,"Montana","Beaverhead County",4,6,92,47,45
050,30,001,"Montana","Beaverhead County",4,7,81,35,46
050,30,001,"Montana","Beaverhead County",4,8,103,41,62
050,30,001,"Montana","Beaverhead County",4,9,96,49,47
050,30,001,"Montana","Beaverhead County",4,10,94,43,51
050,30,001,"Montana","Beaverhead County",4,11,88,42,46
050,30,001,"Montana","Beaverhead County",4,12,92,43,49
050,30,001,"Montana","Beaverhead County",4,13,88,36,52
050,30,001,"Montana","Beaverhead County",4,14,92,49,43
050,30,001,"Montana","Beaverhead County",4,15,91,49,42
050,30,001,"Montana","Beaverhead County",4,16,173,110,63
050,30,001,"Montana","Beaverhead County",4,17,117,73,44
050,30,001,"Montana","Beaverhead County",4,18,139,75,64
050,30,001,"Montana","Beaverhead County",4,19,174,65,109
050,30,001,"Montana","Beaverhead County",4,20,173,88,85
050,30,001,"Montana","Beaverhead County",4,21,194,107,87
050,30,001,"Montana","Beaverhead County",4,22,186,103,83
050,30,001,"Montana","Beaverhead County",4,23,189,75,114
050,30,001,"Montana","Beaverhead County",4,24,156,92,64
050,30,001,"Montana","Beaverhead County",4,25,104,46,58
050,30,001,"Montana","Beaverhead County",4,26,100,51,49
050,30,001,"Montana","Beaverhead County",4,27,114,67,47
050,30,001,"Montana","Beaverhead County",4,28,115,68,47
050,30,001,"Montana","Beaverhead County",4,29,100,59,41
050,30,001,"Montana","Beaverhead County",4,30,118,59,59
050,30,001,"Montana","Beaverhead County",4,31,97,46,51
050,30,001,"Montana","Beaverhead County",4,32,118,50,68
050,30,001,"Montana","Beaverhead County",4,33,107,56,51
050,30,001,"Montana","Beaverhead County",4,34,101,53,48
050,30,001,"Montana","Beaverhead County",4,35,99,48,51
050,30,001,"Montana","Beaverhead County",4,36,93,44,49
050,30,001,"Montana","Beaverhead County",4,37,124,56,68
050,30,001,"Montana","Beaverhead County",4,38,117,58,59
050,30,001,"Montana","Beaverhead County",4,39,129,67,62
050,30,001,"Montana","Beaverhead County",4,40,105,65,40
050,30,001,"Montana","Beaverhead County",4,41,96,55,41
050,30,001,"Montana","Beaverhead County",4,42,109,58,51
050,30,001,"Montana","Beaverhead County",4,43,108,58,50
050,30,001,"Montana","Beaverhead County",4,44,128,73,55
050,30,001,"Montana","Beaverhead County",4,45,94,51,43
050,30,001,"Montana","Beaverhead County",4,46,88,48,40
050,30,001,"Montana","Beaverhead County",4,47,94,50,44
050,30,001,"Montana","Beaverhead County",4,48,77,47,30
050,30,001,"Montana","Beaverhead County",4,49,103,57,46
050,30,001,"Montana","Beaverhead County",4,50,99,53,46
050,30,001,"Montana","Beaverhead County",4,51,113,57,56
050,30,001,"Montana","Beaverhead County",4,52,100,48,52
050,30,001,"Montana","Beaverhead County",4,53,88,47,41
050,30,001,"Montana","Beaverhead County",4,54,92,48,44
050,30,001,"Montana","Beaverhead County",4,55,121,57,64
050,30,001,"Montana","Beaverhead County",4,56,107,48,59
050,30,001,"Montana","Beaverhead County",4,57,106,50,56
050,30,001,"Montana","Beaverhead County",4,58,138,69,69
050,30,001,"Montana","Beaverhead County",4,59,138,76,62
050,30,001,"Montana","Beaverhead County",4,60,145,78,67
050,30,001,"Montana","Beaverhead County",4,61,142,75,67
050,30,001,"Montana","Beaverhead County",4,62,136,67,69
050,30,001,"Montana","Beaverhead County",4,63,163,76,87
050,30,001,"Montana","Beaverhead County",4,64,165,86,79
050,30,001,"Montana","Beaverhead County",4,65,151,82,69
050,30,001,"Montana","Beaverhead County",4,66,151,80,71
050,30,001,"Montana","Beaverhead County",4,67,172,82,90
050,30,001,"Montana","Beaverhead County",4,68,154,68,86
050,30,001,"Montana","Beaverhead County",4,69,137,70,67
050,30,001,"Montana","Beaverhead County",4,70,132,68,64
050,30,001,"Montana","Beaverhead County",4,71,131,75,56
050,30,001,"Montana","Beaverhead County",4,72,117,65,52
050,30,001,"Montana","Beaverhead County",4,73,112,67,45
050,30,001,"Montana","Beaverhead County",4,74,113,61,52
050,30,001,"Montana","Beaverhead County",4,75,133,70,63
050,30,001,"Montana","Beaverhead County",4,76,76,40,36
050,30,001,"Montana","Beaverhead County",4,77,81,41,40
050,30,001,"Montana","Beaverhead County",4,78,71,33,38
050,30,001,"Montana","Beaverhead County",4,79,73,38,35
050,30,001,"Montana","Beaverhead County",4,80,64,32,32
050,30,001,"Montana","Beaverhead County",4,81,68,33,35
050,30,001,"Montana","Beaverhead County",4,82,61,32,29
050,30,001,"Montana","Beaverhead County",4,83,49,25,24
050,30,001,"Montana","Beaverhead County",4,84,40,20,20
050,30,001,"Montana","Beaverhead County",4,85,239,114,125
050,30,001,"Montana","Beaverhead County",5,0,87,44,43
050,30,001,"Montana","Beaverhead County",5,1,85,44,41
050,30,001,"Montana","Beaverhead County",5,2,85,42,43
050,30,001,"Montana","Beaverhead County",5,3,65,32,33
050,30,001,"Montana","Beaverhead County",5,4,87,52,35
050,30,001,"Montana","Beaverhead County",5,5,90,48,42
050,30,001,"Montana","Beaverhead County",5,6,90,39,51
050,30,001,"Montana","Beaverhead County",5,7,94,48,46
050,30,001,"Montana","Beaverhead County",5,8,84,38,46
050,30,001,"Montana","Beaverhead County",5,9,99,40,59
050,30,001,"Montana","Beaverhead County",5,10,99,52,47
050,30,001,"Montana","Beaverhead County",5,11,95,46,49
050,30,001,"Montana","Beaverhead County",5,12,89,42,47
050,30,001,"Montana","Beaverhead County",5,13,96,44,52
050,30,001,"Montana","Beaverhead County",5,14,94,40,54
050,30,001,"Montana","Beaverhead County",5,15,92,47,45
050,30,001,"Montana","Beaverhead County",5,16,162,105,57
050,30,001,"Montana","Beaverhead County",5,17,136,84,52
050,30,001,"Montana","Beaverhead County",5,18,145,80,65
050,30,001,"Montana","Beaverhead County",5,19,173,66,107
050,30,001,"Montana","Beaverhead County",5,20,166,80,86
050,30,001,"Montana","Beaverhead County",5,21,223,117,106
050,30,001,"Montana","Beaverhead County",5,22,178,96,82
050,30,001,"Montana","Beaverhead County",5,23,179,72,107
050,30,001,"Montana","Beaverhead County",5,24,133,79,54
050,30,001,"Montana","Beaverhead County",5,25,133,68,65
050,30,001,"Montana","Beaverhead County",5,26,97,42,55
050,30,001,"Montana","Beaverhead County",5,27,110,58,52
050,30,001,"Montana","Beaverhead County",5,28,117,65,52
050,30,001,"Montana","Beaverhead County",5,29,114,70,44
050,30,001,"Montana","Beaverhead County",5,30,102,59,43
050,30,001,"Montana","Beaverhead County",5,31,118,52,66
050,30,001,"Montana","Beaverhead County",5,32,96,48,48
050,30,001,"Montana","Beaverhead County",5,33,121,52,69
050,30,001,"Montana","Beaverhead County",5,34,120,59,61
050,30,001,"Montana","Beaverhead County",5,35,104,58,46
050,30,001,"Montana","Beaverhead County",5,36,104,51,53
050,30,001,"Montana","Beaverhead County",5,37,104,52,52
050,30,001,"Montana","Beaverhead County",5,38,132,58,74
050,30,001,"Montana","Beaverhead County",5,39,120,60,60
050,30,001,"Montana","Beaverhead County",5,40,127,64,63
050,30,001,"Montana","Beaverhead County",5,41,108,65,43
050,30,001,"Montana","Beaverhead County",5,42,98,57,41
050,30,001,"Montana","Beaverhead County",5,43,107,56,51
050,30,001,"Montana","Beaverhead County",5,44,106,55,51
050,30,001,"Montana","Beaverhead County",5,45,128,72,56
050,30,001,"Montana","Beaverhead County",5,46,102,52,50
050,30,001,"Montana","Beaverhead County",5,47,91,51,40
050,30,001,"Montana","Beaverhead County",5,48,99,56,43
050,30,001,"Montana","Beaverhead County",5,49,77,49,28
050,30,001,"Montana","Beaverhead County",5,50,109,61,48
050,30,001,"Montana","Beaverhead County",5,51,98,50,48
050,30,001,"Montana","Beaverhead County",5,52,126,65,61
050,30,001,"Montana","Beaverhead County",5,53,101,51,50
050,30,001,"Montana","Beaverhead County",5,54,90,46,44
050,30,001,"Montana","Beaverhead County",5,55,98,53,45
050,30,001,"Montana","Beaverhead County",5,56,117,52,65
050,30,001,"Montana","Beaverhead County",5,57,110,50,60
050,30,001,"Montana","Beaverhead County",5,58,110,52,58
050,30,001,"Montana","Beaverhead County",5,59,144,75,69
050,30,001,"Montana","Beaverhead County",5,60,139,74,65
050,30,001,"Montana","Beaverhead County",5,61,148,78,70
050,30,001,"Montana","Beaverhead County",5,62,144,77,67
050,30,001,"Montana","Beaverhead County",5,63,133,65,68
050,30,001,"Montana","Beaverhead County",5,64,164,75,89
050,30,001,"Montana","Beaverhead County",5,65,171,92,79
050,30,001,"Montana","Beaverhead County",5,66,147,79,68
050,30,001,"Montana","Beaverhead County",5,67,150,80,70
050,30,001,"Montana","Beaverhead County",5,68,167,79,88
050,30,001,"Montana","Beaverhead County",5,69,151,66,85
050,30,001,"Montana","Beaverhead County",5,70,132,67,65
050,30,001,"Montana","Beaverhead County",5,71,140,75,65
050,30,001,"Montana","Beaverhead County",5,72,120,69,51
050,30,001,"Montana","Beaverhead County",5,73,116,64,52
050,30,001,"Montana","Beaverhead County",5,74,106,63,43
050,30,001,"Montana","Beaverhead County",5,75,114,59,55
050,30,001,"Montana","Beaverhead County",5,76,130,69,61
050,30,001,"Montana","Beaverhead County",5,77,76,38,38
050,30,001,"Montana","Beaverhead County",5,78,76,37,39
050,30,001,"Montana","Beaverhead County",5,79,67,28,39
050,30,001,"Montana","Beaverhead County",5,80,67,35,32
050,30,001,"Montana","Beaverhead County",5,81,58,30,28
050,30,001,"Montana","Beaverhead County",5,82,67,31,36
050,30,001,"Montana","Beaverhead County",5,83,61,33,28
050,30,001,"Montana","Beaverhead County",5,84,43,22,21
050,30,001,"Montana","Beaverhead County",5,85,234,114,120
050,30,003,"Montana","Big Horn County",1,0,204,106,98
050,30,003,"Montana","Big Horn County",1,1,203,103,100
050,30,003,"Montana","Big Horn County",1,2,212,99,113
050,30,003,"Montana","Big Horn County",1,3,234,113,121
050,30,003,"Montana","Big Horn County",1,4,218,115,103
050,30,003,"Montana","Big Horn County",1,5,254,127,127
050,30,003,"Montana","Big Horn County",1,6,241,135,106
050,30,003,"Montana","Big Horn County",1,7,239,136,103
050,30,003,"Montana","Big Horn County",1,8,238,127,111
050,30,003,"Montana","Big Horn County",1,9,250,146,104
050,30,003,"Montana","Big Horn County",1,10,273,141,132
050,30,003,"Montana","Big Horn County",1,11,273,142,131
050,30,003,"Montana","Big Horn County",1,12,277,148,129
050,30,003,"Montana","Big Horn County",1,13,274,141,133
050,30,003,"Montana","Big Horn County",1,14,250,125,125
050,30,003,"Montana","Big Horn County",1,15,243,121,122
050,30,003,"Montana","Big Horn County",1,16,235,109,126
050,30,003,"Montana","Big Horn County",1,17,221,114,107
050,30,003,"Montana","Big Horn County",1,18,204,107,97
050,30,003,"Montana","Big Horn County",1,19,177,97,80
050,30,003,"Montana","Big Horn County",1,20,148,81,67
050,30,003,"Montana","Big Horn County",1,21,134,61,73
050,30,003,"Montana","Big Horn County",1,22,143,68,75
050,30,003,"Montana","Big Horn County",1,23,151,70,81
050,30,003,"Montana","Big Horn County",1,24,135,60,75
050,30,003,"Montana","Big Horn County",1,25,140,69,71
050,30,003,"Montana","Big Horn County",1,26,143,73,70
050,30,003,"Montana","Big Horn County",1,27,160,82,78
050,30,003,"Montana","Big Horn County",1,28,144,71,73
050,30,003,"Montana","Big Horn County",1,29,154,72,82
050,30,003,"Montana","Big Horn County",1,30,194,94,100
050,30,003,"Montana","Big Horn County",1,31,173,85,88
050,30,003,"Montana","Big Horn County",1,32,159,78,81
050,30,003,"Montana","Big Horn County",1,33,151,83,68
050,30,003,"Montana","Big Horn County",1,34,133,58,75
050,30,003,"Montana","Big Horn County",1,35,145,70,75
050,30,003,"Montana","Big Horn County",1,36,159,78,81
050,30,003,"Montana","Big Horn County",1,37,147,71,76
050,30,003,"Montana","Big Horn County",1,38,159,83,76
050,30,003,"Montana","Big Horn County",1,39,157,81,76
050,30,003,"Montana","Big Horn County",1,40,142,74,68
050,30,003,"Montana","Big Horn County",1,41,127,61,66
050,30,003,"Montana","Big Horn County",1,42,161,76,85
050,30,003,"Montana","Big Horn County",1,43,140,63,77
050,30,003,"Montana","Big Horn County",1,44,113,52,61
050,30,003,"Montana","Big Horn County",1,45,116,58,58
050,30,003,"Montana","Big Horn County",1,46,118,53,65
050,30,003,"Montana","Big Horn County",1,47,124,59,65
050,30,003,"Montana","Big Horn County",1,48,131,65,66
050,30,003,"Montana","Big Horn County",1,49,128,57,71
050,30,003,"Montana","Big Horn County",1,50,128,54,74
050,30,003,"Montana","Big Horn County",1,51,136,57,79
050,30,003,"Montana","Big Horn County",1,52,159,82,77
050,30,003,"Montana","Big Horn County",1,53,144,68,76
050,30,003,"Montana","Big Horn County",1,54,157,84,73
050,30,003,"Montana","Big Horn County",1,55,160,76,84
050,30,003,"Montana","Big Horn County",1,56,150,65,85
050,30,003,"Montana","Big Horn County",1,57,172,85,87
050,30,003,"Montana","Big Horn County",1,58,161,75,86
050,30,003,"Montana","Big Horn County",1,59,153,84,69
050,30,003,"Montana","Big Horn County",1,60,148,70,78
050,30,003,"Montana","Big Horn County",1,61,157,76,81
050,30,003,"Montana","Big Horn County",1,62,162,80,82
050,30,003,"Montana","Big Horn County",1,63,142,68,74
050,30,003,"Montana","Big Horn County",1,64,148,67,81
050,30,003,"Montana","Big Horn County",1,65,138,74,64
050,30,003,"Montana","Big Horn County",1,66,125,55,70
050,30,003,"Montana","Big Horn County",1,67,132,65,67
050,30,003,"Montana","Big Horn County",1,68,132,73,59
050,30,003,"Montana","Big Horn County",1,69,128,73,55
050,30,003,"Montana","Big Horn County",1,70,113,59,54
050,30,003,"Montana","Big Horn County",1,71,104,42,62
050,30,003,"Montana","Big Horn County",1,72,104,48,56
050,30,003,"Montana","Big Horn County",1,73,103,48,55
050,30,003,"Montana","Big Horn County",1,74,77,36,41
050,30,003,"Montana","Big Horn County",1,75,74,33,41
050,30,003,"Montana","Big Horn County",1,76,58,27,31
050,30,003,"Montana","Big Horn County",1,77,53,29,24
050,30,003,"Montana","Big Horn County",1,78,57,26,31
050,30,003,"Montana","Big Horn County",1,79,53,22,31
050,30,003,"Montana","Big Horn County",1,80,38,17,21
050,30,003,"Montana","Big Horn County",1,81,45,21,24
050,30,003,"Montana","Big Horn County",1,82,39,19,20
050,30,003,"Montana","Big Horn County",1,83,39,22,17
050,30,003,"Montana","Big Horn County",1,84,39,16,23
050,30,003,"Montana","Big Horn County",1,85,148,73,75
050,30,003,"Montana","Big Horn County",2,0,207,112,95
050,30,003,"Montana","Big Horn County",2,1,202,104,98
050,30,003,"Montana","Big Horn County",2,2,208,98,110
050,30,003,"Montana","Big Horn County",2,3,227,110,117
050,30,003,"Montana","Big Horn County",2,4,219,114,105
050,30,003,"Montana","Big Horn County",2,5,241,122,119
050,30,003,"Montana","Big Horn County",2,6,243,133,110
050,30,003,"Montana","Big Horn County",2,7,238,135,103
050,30,003,"Montana","Big Horn County",2,8,239,130,109
050,30,003,"Montana","Big Horn County",2,9,249,142,107
050,30,003,"Montana","Big Horn County",2,10,267,140,127
050,30,003,"Montana","Big Horn County",2,11,270,140,130
050,30,003,"Montana","Big Horn County",2,12,281,149,132
050,30,003,"Montana","Big Horn County",2,13,276,142,134
050,30,003,"Montana","Big Horn County",2,14,254,129,125
050,30,003,"Montana","Big Horn County",2,15,244,121,123
050,30,003,"Montana","Big Horn County",2,16,235,111,124
050,30,003,"Montana","Big Horn County",2,17,223,113,110
050,30,003,"Montana","Big Horn County",2,18,201,106,95
050,30,003,"Montana","Big Horn County",2,19,177,96,81
050,30,003,"Montana","Big Horn County",2,20,152,82,70
050,30,003,"Montana","Big Horn County",2,21,134,63,71
050,30,003,"Montana","Big Horn County",2,22,143,67,76
050,30,003,"Montana","Big Horn County",2,23,149,70,79
050,30,003,"Montana","Big Horn County",2,24,133,59,74
050,30,003,"Montana","Big Horn County",2,25,137,67,70
050,30,003,"Montana","Big Horn County",2,26,139,71,68
050,30,003,"Montana","Big Horn County",2,27,158,80,78
050,30,003,"Montana","Big Horn County",2,28,148,73,75
050,30,003,"Montana","Big Horn County",2,29,152,71,81
050,30,003,"Montana","Big Horn County",2,30,189,92,97
050,30,003,"Montana","Big Horn County",2,31,172,82,90
050,30,003,"Montana","Big Horn County",2,32,158,79,79
050,30,003,"Montana","Big Horn County",2,33,153,82,71
050,30,003,"Montana","Big Horn County",2,34,135,63,72
050,30,003,"Montana","Big Horn County",2,35,140,67,73
050,30,003,"Montana","Big Horn County",2,36,154,74,80
050,30,003,"Montana","Big Horn County",2,37,149,72,77
050,30,003,"Montana","Big Horn County",2,38,161,85,76
050,30,003,"Montana","Big Horn County",2,39,158,81,77
050,30,003,"Montana","Big Horn County",2,40,145,75,70
050,30,003,"Montana","Big Horn County",2,41,127,62,65
050,30,003,"Montana","Big Horn County",2,42,151,72,79
050,30,003,"Montana","Big Horn County",2,43,147,66,81
050,30,003,"Montana","Big Horn County",2,44,117,54,63
050,30,003,"Montana","Big Horn County",2,45,114,55,59
050,30,003,"Montana","Big Horn County",2,46,117,55,62
050,30,003,"Montana","Big Horn County",2,47,121,56,65
050,30,003,"Montana","Big Horn County",2,48,132,65,67
050,30,003,"Montana","Big Horn County",2,49,124,55,69
050,30,003,"Montana","Big Horn County",2,50,128,54,74
050,30,003,"Montana","Big Horn County",2,51,133,55,78
050,30,003,"Montana","Big Horn County",2,52,157,79,78
050,30,003,"Montana","Big Horn County",2,53,145,69,76
050,30,003,"Montana","Big Horn County",2,54,152,80,72
050,30,003,"Montana","Big Horn County",2,55,158,78,80
050,30,003,"Montana","Big Horn County",2,56,151,67,84
050,30,003,"Montana","Big Horn County",2,57,165,80,85
050,30,003,"Montana","Big Horn County",2,58,164,78,86
050,30,003,"Montana","Big Horn County",2,59,155,81,74
050,30,003,"Montana","Big Horn County",2,60,149,73,76
050,30,003,"Montana","Big Horn County",2,61,155,74,81
050,30,003,"Montana","Big Horn County",2,62,160,77,83
050,30,003,"Montana","Big Horn County",2,63,148,72,76
050,30,003,"Montana","Big Horn County",2,64,147,68,79
050,30,003,"Montana","Big Horn County",2,65,139,72,67
050,30,003,"Montana","Big Horn County",2,66,126,60,66
050,30,003,"Montana","Big Horn County",2,67,130,62,68
050,30,003,"Montana","Big Horn County",2,68,129,69,60
050,30,003,"Montana","Big Horn County",2,69,129,73,56
050,30,003,"Montana","Big Horn County",2,70,117,63,54
050,30,003,"Montana","Big Horn County",2,71,105,45,60
050,30,003,"Montana","Big Horn County",2,72,101,47,54
050,30,003,"Montana","Big Horn County",2,73,103,47,56
050,30,003,"Montana","Big Horn County",2,74,77,35,42
050,30,003,"Montana","Big Horn County",2,75,76,34,42
050,30,003,"Montana","Big Horn County",2,76,61,28,33
050,30,003,"Montana","Big Horn County",2,77,54,28,26
050,30,003,"Montana","Big Horn County",2,78,56,26,30
050,30,003,"Montana","Big Horn County",2,79,54,23,31
050,30,003,"Montana","Big Horn County",2,80,42,19,23
050,30,003,"Montana","Big Horn County",2,81,40,19,21
050,30,003,"Montana","Big Horn County",2,82,39,18,21
050,30,003,"Montana","Big Horn County",2,83,38,20,18
050,30,003,"Montana","Big Horn County",2,84,39,17,22
050,30,003,"Montana","Big Horn County",2,85,148,73,75
050,30,003,"Montana","Big Horn County",3,0,169,82,87
050,30,003,"Montana","Big Horn County",3,1,194,101,93
050,30,003,"Montana","Big Horn County",3,2,197,97,100
050,30,003,"Montana","Big Horn County",3,3,195,95,100
050,30,003,"Montana","Big Horn County",3,4,227,114,113
050,30,003,"Montana","Big Horn County",3,5,209,113,96
050,30,003,"Montana","Big Horn County",3,6,246,123,123
050,30,003,"Montana","Big Horn County",3,7,235,127,108
050,30,003,"Montana","Big Horn County",3,8,235,132,103
050,30,003,"Montana","Big Horn County",3,9,238,133,105
050,30,003,"Montana","Big Horn County",3,10,254,142,112
050,30,003,"Montana","Big Horn County",3,11,273,146,127
050,30,003,"Montana","Big Horn County",3,12,261,136,125
050,30,003,"Montana","Big Horn County",3,13,272,145,127
050,30,003,"Montana","Big Horn County",3,14,263,138,125
050,30,003,"Montana","Big Horn County",3,15,255,130,125
050,30,003,"Montana","Big Horn County",3,16,237,124,113
050,30,003,"Montana","Big Horn County",3,17,235,108,127
050,30,003,"Montana","Big Horn County",3,18,199,100,99
050,30,003,"Montana","Big Horn County",3,19,172,96,76
050,30,003,"Montana","Big Horn County",3,20,181,100,81
050,30,003,"Montana","Big Horn County",3,21,146,77,69
050,30,003,"Montana","Big Horn County",3,22,134,67,67
050,30,003,"Montana","Big Horn County",3,23,147,69,78
050,30,003,"Montana","Big Horn County",3,24,140,65,75
050,30,003,"Montana","Big Horn County",3,25,137,64,73
050,30,003,"Montana","Big Horn County",3,26,137,66,71
050,30,003,"Montana","Big Horn County",3,27,153,77,76
050,30,003,"Montana","Big Horn County",3,28,146,79,67
050,30,003,"Montana","Big Horn County",3,29,151,78,73
050,30,003,"Montana","Big Horn County",3,30,173,86,87
050,30,003,"Montana","Big Horn County",3,31,176,78,98
050,30,003,"Montana","Big Horn County",3,32,173,75,98
050,30,003,"Montana","Big Horn County",3,33,156,79,77
050,30,003,"Montana","Big Horn County",3,34,153,73,80
050,30,003,"Montana","Big Horn County",3,35,137,68,69
050,30,003,"Montana","Big Horn County",3,36,137,58,79
050,30,003,"Montana","Big Horn County",3,37,149,71,78
050,30,003,"Montana","Big Horn County",3,38,153,77,76
050,30,003,"Montana","Big Horn County",3,39,163,89,74
050,30,003,"Montana","Big Horn County",3,40,149,76,73
050,30,003,"Montana","Big Horn County",3,41,143,70,73
050,30,003,"Montana","Big Horn County",3,42,132,70,62
050,30,003,"Montana","Big Horn County",3,43,143,62,81
050,30,003,"Montana","Big Horn County",3,44,146,65,81
050,30,003,"Montana","Big Horn County",3,45,119,52,67
050,30,003,"Montana","Big Horn County",3,46,121,63,58
050,30,003,"Montana","Big Horn County",3,47,117,56,61
050,30,003,"Montana","Big Horn County",3,48,115,54,61
050,30,003,"Montana","Big Horn County",3,49,115,53,62
050,30,003,"Montana","Big Horn County",3,50,126,56,70
050,30,003,"Montana","Big Horn County",3,51,120,47,73
050,30,003,"Montana","Big Horn County",3,52,147,68,79
050,30,003,"Montana","Big Horn County",3,53,151,67,84
050,30,003,"Montana","Big Horn County",3,54,146,74,72
050,30,003,"Montana","Big Horn County",3,55,144,78,66
050,30,003,"Montana","Big Horn County",3,56,159,80,79
050,30,003,"Montana","Big Horn County",3,57,142,66,76
050,30,003,"Montana","Big Horn County",3,58,160,75,85
050,30,003,"Montana","Big Horn County",3,59,166,79,87
050,30,003,"Montana","Big Horn County",3,60,144,72,72
050,30,003,"Montana","Big Horn County",3,61,148,74,74
050,30,003,"Montana","Big Horn County",3,62,147,65,82
050,30,003,"Montana","Big Horn County",3,63,156,75,81
050,30,003,"Montana","Big Horn County",3,64,148,72,76
050,30,003,"Montana","Big Horn County",3,65,142,67,75
050,30,003,"Montana","Big Horn County",3,66,127,67,60
050,30,003,"Montana","Big Horn County",3,67,115,51,64
050,30,003,"Montana","Big Horn County",3,68,130,65,65
050,30,003,"Montana","Big Horn County",3,69,114,58,56
050,30,003,"Montana","Big Horn County",3,70,125,70,55
050,30,003,"Montana","Big Horn County",3,71,110,55,55
050,30,003,"Montana","Big Horn County",3,72,104,46,58
050,30,003,"Montana","Big Horn County",3,73,92,38,54
050,30,003,"Montana","Big Horn County",3,74,96,41,55
050,30,003,"Montana","Big Horn County",3,75,69,34,35
050,30,003,"Montana","Big Horn County",3,76,76,34,42
050,30,003,"Montana","Big Horn County",3,77,56,26,30
050,30,003,"Montana","Big Horn County",3,78,50,26,24
050,30,003,"Montana","Big Horn County",3,79,53,23,30
050,30,003,"Montana","Big Horn County",3,80,45,18,27
050,30,003,"Montana","Big Horn County",3,81,33,14,19
050,30,003,"Montana","Big Horn County",3,82,39,17,22
050,30,003,"Montana","Big Horn County",3,83,36,17,19
050,30,003,"Montana","Big Horn County",3,84,36,15,21
050,30,003,"Montana","Big Horn County",3,85,133,68,65
050,30,003,"Montana","Big Horn County",4,0,154,80,74
050,30,003,"Montana","Big Horn County",4,1,154,73,81
050,30,003,"Montana","Big Horn County",4,2,197,100,97
050,30,003,"Montana","Big Horn County",4,3,191,97,94
050,30,003,"Montana","Big Horn County",4,4,199,100,99
050,30,003,"Montana","Big Horn County",4,5,216,110,106
050,30,003,"Montana","Big Horn County",4,6,213,116,97
050,30,003,"Montana","Big Horn County",4,7,247,124,123
050,30,003,"Montana","Big Horn County",4,8,237,124,113
050,30,003,"Montana","Big Horn County",4,9,227,132,95
050,30,003,"Montana","Big Horn County",4,10,243,130,113
050,30,003,"Montana","Big Horn County",4,11,236,135,101
050,30,003,"Montana","Big Horn County",4,12,271,145,126
050,30,003,"Montana","Big Horn County",4,13,269,141,128
050,30,003,"Montana","Big Horn County",4,14,276,146,130
050,30,003,"Montana","Big Horn County",4,15,258,140,118
050,30,003,"Montana","Big Horn County",4,16,258,129,129
050,30,003,"Montana","Big Horn County",4,17,241,123,118
050,30,003,"Montana","Big Horn County",4,18,215,105,110
050,30,003,"Montana","Big Horn County",4,19,187,97,90
050,30,003,"Montana","Big Horn County",4,20,173,96,77
050,30,003,"Montana","Big Horn County",4,21,174,92,82
050,30,003,"Montana","Big Horn County",4,22,137,68,69
050,30,003,"Montana","Big Horn County",4,23,137,71,66
050,30,003,"Montana","Big Horn County",4,24,139,58,81
050,30,003,"Montana","Big Horn County",4,25,146,71,75
050,30,003,"Montana","Big Horn County",4,26,131,54,77
050,30,003,"Montana","Big Horn County",4,27,152,78,74
050,30,003,"Montana","Big Horn County",4,28,146,78,68
050,30,003,"Montana","Big Horn County",4,29,135,64,71
050,30,003,"Montana","Big Horn County",4,30,174,92,82
050,30,003,"Montana","Big Horn County",4,31,146,66,80
050,30,003,"Montana","Big Horn County",4,32,175,79,96
050,30,003,"Montana","Big Horn County",4,33,173,73,100
050,30,003,"Montana","Big Horn County",4,34,165,83,82
050,30,003,"Montana","Big Horn County",4,35,153,76,77
050,30,003,"Montana","Big Horn County",4,36,131,62,69
050,30,003,"Montana","Big Horn County",4,37,133,63,70
050,30,003,"Montana","Big Horn County",4,38,153,76,77
050,30,003,"Montana","Big Horn County",4,39,157,75,82
050,30,003,"Montana","Big Horn County",4,40,157,83,74
050,30,003,"Montana","Big Horn County",4,41,142,68,74
050,30,003,"Montana","Big Horn County",4,42,146,75,71
050,30,003,"Montana","Big Horn County",4,43,127,65,62
050,30,003,"Montana","Big Horn County",4,44,144,61,83
050,30,003,"Montana","Big Horn County",4,45,157,69,88
050,30,003,"Montana","Big Horn County",4,46,119,54,65
050,30,003,"Montana","Big Horn County",4,47,122,64,58
050,30,003,"Montana","Big Horn County",4,48,119,58,61
050,30,003,"Montana","Big Horn County",4,49,110,49,61
050,30,003,"Montana","Big Horn County",4,50,122,57,65
050,30,003,"Montana","Big Horn County",4,51,124,50,74
050,30,003,"Montana","Big Horn County",4,52,138,64,74
050,30,003,"Montana","Big Horn County",4,53,138,57,81
050,30,003,"Montana","Big Horn County",4,54,145,69,76
050,30,003,"Montana","Big Horn County",4,55,144,70,74
050,30,003,"Montana","Big Horn County",4,56,143,75,68
050,30,003,"Montana","Big Horn County",4,57,152,81,71
050,30,003,"Montana","Big Horn County",4,58,139,65,74
050,30,003,"Montana","Big Horn County",4,59,161,77,84
050,30,003,"Montana","Big Horn County",4,60,171,84,87
050,30,003,"Montana","Big Horn County",4,61,146,76,70
050,30,003,"Montana","Big Horn County",4,62,147,70,77
050,30,003,"Montana","Big Horn County",4,63,139,63,76
050,30,003,"Montana","Big Horn County",4,64,153,74,79
050,30,003,"Montana","Big Horn County",4,65,145,71,74
050,30,003,"Montana","Big Horn County",4,66,136,61,75
050,30,003,"Montana","Big Horn County",4,67,126,65,61
050,30,003,"Montana","Big Horn County",4,68,116,54,62
050,30,003,"Montana","Big Horn County",4,69,117,57,60
050,30,003,"Montana","Big Horn County",4,70,113,56,57
050,30,003,"Montana","Big Horn County",4,71,119,63,56
050,30,003,"Montana","Big Horn County",4,72,97,49,48
050,30,003,"Montana","Big Horn County",4,73,92,40,52
050,30,003,"Montana","Big Horn County",4,74,87,36,51
050,30,003,"Montana","Big Horn County",4,75,89,36,53
050,30,003,"Montana","Big Horn County",4,76,65,31,34
050,30,003,"Montana","Big Horn County",4,77,70,29,41
050,30,003,"Montana","Big Horn County",4,78,53,24,29
050,30,003,"Montana","Big Horn County",4,79,47,25,22
050,30,003,"Montana","Big Horn County",4,80,48,22,26
050,30,003,"Montana","Big Horn County",4,81,40,18,22
050,30,003,"Montana","Big Horn County",4,82,32,12,20
050,30,003,"Montana","Big Horn County",4,83,36,18,18
050,30,003,"Montana","Big Horn County",4,84,35,13,22
050,30,003,"Montana","Big Horn County",4,85,139,75,64
050,30,003,"Montana","Big Horn County",5,0,154,80,74
050,30,003,"Montana","Big Horn County",5,1,159,84,75
050,30,003,"Montana","Big Horn County",5,2,161,74,87
050,30,003,"Montana","Big Horn County",5,3,201,101,100
050,30,003,"Montana","Big Horn County",5,4,182,93,89
050,30,003,"Montana","Big Horn County",5,5,209,106,103
050,30,003,"Montana","Big Horn County",5,6,206,106,100
050,30,003,"Montana","Big Horn County",5,7,203,115,88
050,30,003,"Montana","Big Horn County",5,8,236,114,122
050,30,003,"Montana","Big Horn County",5,9,233,122,111
050,30,003,"Montana","Big Horn County",5,10,225,128,97
050,30,003,"Montana","Big Horn County",5,11,234,129,105
050,30,003,"Montana","Big Horn County",5,12,234,132,102
050,30,003,"Montana","Big Horn County",5,13,278,149,129
050,30,003,"Montana","Big Horn County",5,14,261,138,123
050,30,003,"Montana","Big Horn County",5,15,280,151,129
050,30,003,"Montana","Big Horn County",5,16,258,140,118
050,30,003,"Montana","Big Horn County",5,17,253,127,126
050,30,003,"Montana","Big Horn County",5,18,214,111,103
050,30,003,"Montana","Big Horn County",5,19,198,104,94
050,30,003,"Montana","Big Horn County",5,20,189,100,89
050,30,003,"Montana","Big Horn County",5,21,160,86,74
050,30,003,"Montana","Big Horn County",5,22,167,81,86
050,30,003,"Montana","Big Horn County",5,23,155,78,77
050,30,003,"Montana","Big Horn County",5,24,138,73,65
050,30,003,"Montana","Big Horn County",5,25,159,70,89
050,30,003,"Montana","Big Horn County",5,26,142,65,77
050,30,003,"Montana","Big Horn County",5,27,145,67,78
050,30,003,"Montana","Big Horn County",5,28,148,76,72
050,30,003,"Montana","Big Horn County",5,29,140,80,60
050,30,003,"Montana","Big Horn County",5,30,157,74,83
050,30,003,"Montana","Big Horn County",5,31,146,75,71
050,30,003,"Montana","Big Horn County",5,32,151,65,86
050,30,003,"Montana","Big Horn County",5,33,171,81,90
050,30,003,"Montana","Big Horn County",5,34,171,71,100
050,30,003,"Montana","Big Horn County",5,35,164,86,78
050,30,003,"Montana","Big Horn County",5,36,160,73,87
050,30,003,"Montana","Big Horn County",5,37,128,61,67
050,30,003,"Montana","Big Horn County",5,38,136,69,67
050,30,003,"Montana","Big Horn County",5,39,156,71,85
050,30,003,"Montana","Big Horn County",5,40,146,77,69
050,30,003,"Montana","Big Horn County",5,41,152,74,78
050,30,003,"Montana","Big Horn County",5,42,146,73,73
050,30,003,"Montana","Big Horn County",5,43,132,62,70
050,30,003,"Montana","Big Horn County",5,44,129,63,66
050,30,003,"Montana","Big Horn County",5,45,145,58,87
050,30,003,"Montana","Big Horn County",5,46,154,70,84
050,30,003,"Montana","Big Horn County",5,47,119,54,65
050,30,003,"Montana","Big Horn County",5,48,120,61,59
050,30,003,"Montana","Big Horn County",5,49,108,50,58
050,30,003,"Montana","Big Horn County",5,50,117,54,63
050,30,003,"Montana","Big Horn County",5,51,123,56,67
050,30,003,"Montana","Big Horn County",5,52,140,64,76
050,30,003,"Montana","Big Horn County",5,53,124,49,75
050,30,003,"Montana","Big Horn County",5,54,132,55,77
050,30,003,"Montana","Big Horn County",5,55,147,66,81
050,30,003,"Montana","Big Horn County",5,56,148,76,72
050,30,003,"Montana","Big Horn County",5,57,123,70,53
050,30,003,"Montana","Big Horn County",5,58,154,77,77
050,30,003,"Montana","Big Horn County",5,59,136,61,75
050,30,003,"Montana","Big Horn County",5,60,154,75,79
050,30,003,"Montana","Big Horn County",5,61,165,86,79
050,30,003,"Montana","Big Horn County",5,62,141,68,73
050,30,003,"Montana","Big Horn County",5,63,145,68,77
050,30,003,"Montana","Big Horn County",5,64,140,65,75
050,30,003,"Montana","Big Horn County",5,65,159,74,85
050,30,003,"Montana","Big Horn County",5,66,138,67,71
050,30,003,"Montana","Big Horn County",5,67,134,58,76
050,30,003,"Montana","Big Horn County",5,68,126,68,58
050,30,003,"Montana","Big Horn County",5,69,107,48,59
050,30,003,"Montana","Big Horn County",5,70,117,56,61
050,30,003,"Montana","Big Horn County",5,71,109,48,61
050,30,003,"Montana","Big Horn County",5,72,105,56,49
050,30,003,"Montana","Big Horn County",5,73,90,45,45
050,30,003,"Montana","Big Horn County",5,74,90,38,52
050,30,003,"Montana","Big Horn County",5,75,82,32,50
050,30,003,"Montana","Big Horn County",5,76,81,32,49
050,30,003,"Montana","Big Horn County",5,77,60,27,33
050,30,003,"Montana","Big Horn County",5,78,68,28,40
050,30,003,"Montana","Big Horn County",5,79,49,21,28
050,30,003,"Montana","Big Horn County",5,80,43,25,18
050,30,003,"Montana","Big Horn County",5,81,43,20,23
050,30,003,"Montana","Big Horn County",5,82,41,19,22
050,30,003,"Montana","Big Horn County",5,83,30,11,19
050,30,003,"Montana","Big Horn County",5,84,38,17,21
050,30,003,"Montana","Big Horn County",5,85,139,75,64
050,30,005,"Montana","Blaine County",1,0,112,56,56
050,30,005,"Montana","Blaine County",1,1,106,51,55
050,30,005,"Montana","Blaine County",1,2,102,48,54
050,30,005,"Montana","Blaine County",1,3,123,60,63
050,30,005,"Montana","Blaine County",1,4,120,63,57
050,30,005,"Montana","Blaine County",1,5,119,70,49
050,30,005,"Montana","Blaine County",1,6,117,63,54
050,30,005,"Montana","Blaine County",1,7,118,55,63
050,30,005,"Montana","Blaine County",1,8,127,56,71
050,30,005,"Montana","Blaine County",1,9,119,59,60
050,30,005,"Montana","Blaine County",1,10,113,69,44
050,30,005,"Montana","Blaine County",1,11,130,72,58
050,30,005,"Montana","Blaine County",1,12,117,65,52
050,30,005,"Montana","Blaine County",1,13,136,62,74
050,30,005,"Montana","Blaine County",1,14,118,58,60
050,30,005,"Montana","Blaine County",1,15,122,59,63
050,30,005,"Montana","Blaine County",1,16,114,56,58
050,30,005,"Montana","Blaine County",1,17,112,58,54
050,30,005,"Montana","Blaine County",1,18,96,46,50
050,30,005,"Montana","Blaine County",1,19,84,50,34
050,30,005,"Montana","Blaine County",1,20,83,48,35
050,30,005,"Montana","Blaine County",1,21,79,40,39
050,30,005,"Montana","Blaine County",1,22,80,38,42
050,30,005,"Montana","Blaine County",1,23,95,47,48
050,30,005,"Montana","Blaine County",1,24,77,42,35
050,30,005,"Montana","Blaine County",1,25,72,41,31
050,30,005,"Montana","Blaine County",1,26,87,38,49
050,30,005,"Montana","Blaine County",1,27,80,43,37
050,30,005,"Montana","Blaine County",1,28,102,57,45
050,30,005,"Montana","Blaine County",1,29,89,44,45
050,30,005,"Montana","Blaine County",1,30,87,42,45
050,30,005,"Montana","Blaine County",1,31,81,41,40
050,30,005,"Montana","Blaine County",1,32,85,49,36
050,30,005,"Montana","Blaine County",1,33,85,47,38
050,30,005,"Montana","Blaine County",1,34,79,39,40
050,30,005,"Montana","Blaine County",1,35,84,34,50
050,30,005,"Montana","Blaine County",1,36,87,44,43
050,30,005,"Montana","Blaine County",1,37,91,42,49
050,30,005,"Montana","Blaine County",1,38,78,39,39
050,30,005,"Montana","Blaine County",1,39,94,46,48
050,30,005,"Montana","Blaine County",1,40,81,46,35
050,30,005,"Montana","Blaine County",1,41,81,43,38
050,30,005,"Montana","Blaine County",1,42,83,46,37
050,30,005,"Montana","Blaine County",1,43,69,40,29
050,30,005,"Montana","Blaine County",1,44,69,40,29
050,30,005,"Montana","Blaine County",1,45,67,33,34
050,30,005,"Montana","Blaine County",1,46,63,34,29
050,30,005,"Montana","Blaine County",1,47,63,34,29
050,30,005,"Montana","Blaine County",1,48,73,38,35
050,30,005,"Montana","Blaine County",1,49,72,32,40
050,30,005,"Montana","Blaine County",1,50,55,26,29
050,30,005,"Montana","Blaine County",1,51,55,28,27
050,30,005,"Montana","Blaine County",1,52,70,34,36
050,30,005,"Montana","Blaine County",1,53,69,30,39
050,30,005,"Montana","Blaine County",1,54,82,43,39
050,30,005,"Montana","Blaine County",1,55,88,38,50
050,30,005,"Montana","Blaine County",1,56,85,50,35
050,30,005,"Montana","Blaine County",1,57,83,49,34
050,30,005,"Montana","Blaine County",1,58,86,35,51
050,30,005,"Montana","Blaine County",1,59,98,40,58
050,30,005,"Montana","Blaine County",1,60,108,57,51
050,30,005,"Montana","Blaine County",1,61,99,55,44
050,30,005,"Montana","Blaine County",1,62,85,47,38
050,30,005,"Montana","Blaine County",1,63,72,38,34
050,30,005,"Montana","Blaine County",1,64,86,50,36
050,30,005,"Montana","Blaine County",1,65,68,36,32
050,30,005,"Montana","Blaine County",1,66,70,27,43
050,30,005,"Montana","Blaine County",1,67,73,38,35
050,30,005,"Montana","Blaine County",1,68,74,35,39
050,30,005,"Montana","Blaine County",1,69,66,29,37
050,30,005,"Montana","Blaine County",1,70,63,31,32
050,30,005,"Montana","Blaine County",1,71,65,32,33
050,30,005,"Montana","Blaine County",1,72,62,29,33
050,30,005,"Montana","Blaine County",1,73,65,28,37
050,30,005,"Montana","Blaine County",1,74,54,22,32
050,30,005,"Montana","Blaine County",1,75,40,18,22
050,30,005,"Montana","Blaine County",1,76,35,17,18
050,30,005,"Montana","Blaine County",1,77,48,21,27
050,30,005,"Montana","Blaine County",1,78,32,15,17
050,30,005,"Montana","Blaine County",1,79,30,15,15
050,30,005,"Montana","Blaine County",1,80,29,12,17
050,30,005,"Montana","Blaine County",1,81,28,10,18
050,30,005,"Montana","Blaine County",1,82,30,15,15
050,30,005,"Montana","Blaine County",1,83,25,12,13
050,30,005,"Montana","Blaine County",1,84,22,11,11
050,30,005,"Montana","Blaine County",1,85,123,44,79
050,30,005,"Montana","Blaine County",2,0,108,52,56
050,30,005,"Montana","Blaine County",2,1,106,51,55
050,30,005,"Montana","Blaine County",2,2,102,48,54
050,30,005,"Montana","Blaine County",2,3,120,57,63
050,30,005,"Montana","Blaine County",2,4,118,62,56
050,30,005,"Montana","Blaine County",2,5,118,68,50
050,30,005,"Montana","Blaine County",2,6,119,66,53
050,30,005,"Montana","Blaine County",2,7,118,56,62
050,30,005,"Montana","Blaine County",2,8,122,55,67
050,30,005,"Montana","Blaine County",2,9,118,57,61
050,30,005,"Montana","Blaine County",2,10,116,67,49
050,30,005,"Montana","Blaine County",2,11,125,71,54
050,30,005,"Montana","Blaine County",2,12,120,66,54
050,30,005,"Montana","Blaine County",2,13,132,63,69
050,30,005,"Montana","Blaine County",2,14,122,58,64
050,30,005,"Montana","Blaine County",2,15,118,57,61
050,30,005,"Montana","Blaine County",2,16,116,56,60
050,30,005,"Montana","Blaine County",2,17,111,56,55
050,30,005,"Montana","Blaine County",2,18,96,48,48
050,30,005,"Montana","Blaine County",2,19,83,48,35
050,30,005,"Montana","Blaine County",2,20,83,48,35
050,30,005,"Montana","Blaine County",2,21,77,41,36
050,30,005,"Montana","Blaine County",2,22,80,39,41
050,30,005,"Montana","Blaine County",2,23,90,44,46
050,30,005,"Montana","Blaine County",2,24,79,43,36
050,30,005,"Montana","Blaine County",2,25,71,40,31
050,30,005,"Montana","Blaine County",2,26,83,38,45
050,30,005,"Montana","Blaine County",2,27,82,44,38
050,30,005,"Montana","Blaine County",2,28,98,54,44
050,30,005,"Montana","Blaine County",2,29,91,45,46
050,30,005,"Montana","Blaine County",2,30,87,42,45
050,30,005,"Montana","Blaine County",2,31,81,40,41
050,30,005,"Montana","Blaine County",2,32,84,47,37
050,30,005,"Montana","Blaine County",2,33,86,48,38
050,30,005,"Montana","Blaine County",2,34,80,41,39
050,30,005,"Montana","Blaine County",2,35,82,34,48
050,30,005,"Montana","Blaine County",2,36,86,41,45
050,30,005,"Montana","Blaine County",2,37,91,43,48
050,30,005,"Montana","Blaine County",2,38,81,40,41
050,30,005,"Montana","Blaine County",2,39,91,45,46
050,30,005,"Montana","Blaine County",2,40,84,47,37
050,30,005,"Montana","Blaine County",2,41,81,44,37
050,30,005,"Montana","Blaine County",2,42,80,43,37
050,30,005,"Montana","Blaine County",2,43,73,43,30
050,30,005,"Montana","Blaine County",2,44,67,39,28
050,30,005,"Montana","Blaine County",2,45,67,34,33
050,30,005,"Montana","Blaine County",2,46,63,34,29
050,30,005,"Montana","Blaine County",2,47,63,34,29
050,30,005,"Montana","Blaine County",2,48,70,37,33
050,30,005,"Montana","Blaine County",2,49,72,34,38
050,30,005,"Montana","Blaine County",2,50,57,27,30
050,30,005,"Montana","Blaine County",2,51,54,27,27
050,30,005,"Montana","Blaine County",2,52,68,33,35
050,30,005,"Montana","Blaine County",2,53,68,30,38
050,30,005,"Montana","Blaine County",2,54,77,40,37
050,30,005,"Montana","Blaine County",2,55,87,39,48
050,30,005,"Montana","Blaine County",2,56,86,48,38
050,30,005,"Montana","Blaine County",2,57,80,47,33
050,30,005,"Montana","Blaine County",2,58,86,39,47
050,30,005,"Montana","Blaine County",2,59,96,39,57
050,30,005,"Montana","Blaine County",2,60,106,54,52
050,30,005,"Montana","Blaine County",2,61,100,55,45
050,30,005,"Montana","Blaine County",2,62,89,50,39
050,30,005,"Montana","Blaine County",2,63,75,39,36
050,30,005,"Montana","Blaine County",2,64,82,48,34
050,30,005,"Montana","Blaine County",2,65,73,40,33
050,30,005,"Montana","Blaine County",2,66,69,29,40
050,30,005,"Montana","Blaine County",2,67,69,34,35
050,30,005,"Montana","Blaine County",2,68,74,36,38
050,30,005,"Montana","Blaine County",2,69,69,31,38
050,30,005,"Montana","Blaine County",2,70,62,29,33
050,30,005,"Montana","Blaine County",2,71,65,32,33
050,30,005,"Montana","Blaine County",2,72,62,30,32
050,30,005,"Montana","Blaine County",2,73,67,30,37
050,30,005,"Montana","Blaine County",2,74,51,20,31
050,30,005,"Montana","Blaine County",2,75,42,20,22
050,30,005,"Montana","Blaine County",2,76,33,17,16
050,30,005,"Montana","Blaine County",2,77,46,21,25
050,30,005,"Montana","Blaine County",2,78,35,16,19
050,30,005,"Montana","Blaine County",2,79,30,15,15
050,30,005,"Montana","Blaine County",2,80,28,13,15
050,30,005,"Montana","Blaine County",2,81,27,10,17
050,30,005,"Montana","Blaine County",2,82,31,14,17
050,30,005,"Montana","Blaine County",2,83,26,13,13
050,30,005,"Montana","Blaine County",2,84,21,11,10
050,30,005,"Montana","Blaine County",2,85,125,44,81
050,30,005,"Montana","Blaine County",3,0,99,48,51
050,30,005,"Montana","Blaine County",3,1,106,54,52
050,30,005,"Montana","Blaine County",3,2,96,50,46
050,30,005,"Montana","Blaine County",3,3,100,44,56
050,30,005,"Montana","Blaine County",3,4,116,53,63
050,30,005,"Montana","Blaine County",3,5,123,66,57
050,30,005,"Montana","Blaine County",3,6,114,67,47
050,30,005,"Montana","Blaine County",3,7,125,66,59
050,30,005,"Montana","Blaine County",3,8,108,56,52
050,30,005,"Montana","Blaine County",3,9,126,59,67
050,30,005,"Montana","Blaine County",3,10,122,60,62
050,30,005,"Montana","Blaine County",3,11,115,68,47
050,30,005,"Montana","Blaine County",3,12,127,71,56
050,30,005,"Montana","Blaine County",3,13,129,71,58
050,30,005,"Montana","Blaine County",3,14,131,65,66
050,30,005,"Montana","Blaine County",3,15,122,58,64
050,30,005,"Montana","Blaine County",3,16,129,63,66
050,30,005,"Montana","Blaine County",3,17,116,51,65
050,30,005,"Montana","Blaine County",3,18,109,55,54
050,30,005,"Montana","Blaine County",3,19,80,40,40
050,30,005,"Montana","Blaine County",3,20,78,42,36
050,30,005,"Montana","Blaine County",3,21,72,42,30
050,30,005,"Montana","Blaine County",3,22,80,44,36
050,30,005,"Montana","Blaine County",3,23,84,41,43
050,30,005,"Montana","Blaine County",3,24,80,39,41
050,30,005,"Montana","Blaine County",3,25,74,43,31
050,30,005,"Montana","Blaine County",3,26,74,42,32
050,30,005,"Montana","Blaine County",3,27,80,36,44
050,30,005,"Montana","Blaine County",3,28,91,47,44
050,30,005,"Montana","Blaine County",3,29,99,53,46
050,30,005,"Montana","Blaine County",3,30,85,44,41
050,30,005,"Montana","Blaine County",3,31,91,44,47
050,30,005,"Montana","Blaine County",3,32,83,43,40
050,30,005,"Montana","Blaine County",3,33,85,45,40
050,30,005,"Montana","Blaine County",3,34,95,57,38
050,30,005,"Montana","Blaine County",3,35,79,41,38
050,30,005,"Montana","Blaine County",3,36,76,29,47
050,30,005,"Montana","Blaine County",3,37,83,41,42
050,30,005,"Montana","Blaine County",3,38,87,42,45
050,30,005,"Montana","Blaine County",3,39,79,38,41
050,30,005,"Montana","Blaine County",3,40,92,49,43
050,30,005,"Montana","Blaine County",3,41,79,46,33
050,30,005,"Montana","Blaine County",3,42,81,41,40
050,30,005,"Montana","Blaine County",3,43,84,47,37
050,30,005,"Montana","Blaine County",3,44,75,42,33
050,30,005,"Montana","Blaine County",3,45,70,39,31
050,30,005,"Montana","Blaine County",3,46,63,33,30
050,30,005,"Montana","Blaine County",3,47,64,35,29
050,30,005,"Montana","Blaine County",3,48,61,32,29
050,30,005,"Montana","Blaine County",3,49,72,40,32
050,30,005,"Montana","Blaine County",3,50,72,34,38
050,30,005,"Montana","Blaine County",3,51,54,25,29
050,30,005,"Montana","Blaine County",3,52,52,25,27
050,30,005,"Montana","Blaine County",3,53,72,33,39
050,30,005,"Montana","Blaine County",3,54,64,25,39
050,30,005,"Montana","Blaine County",3,55,85,41,44
050,30,005,"Montana","Blaine County",3,56,87,40,47
050,30,005,"Montana","Blaine County",3,57,80,44,36
050,30,005,"Montana","Blaine County",3,58,83,48,35
050,30,005,"Montana","Blaine County",3,59,85,39,46
050,30,005,"Montana","Blaine County",3,60,98,41,57
050,30,005,"Montana","Blaine County",3,61,108,55,53
050,30,005,"Montana","Blaine County",3,62,97,53,44
050,30,005,"Montana","Blaine County",3,63,84,47,37
050,30,005,"Montana","Blaine County",3,64,76,40,36
050,30,005,"Montana","Blaine County",3,65,81,46,35
050,30,005,"Montana","Blaine County",3,66,68,39,29
050,30,005,"Montana","Blaine County",3,67,68,29,39
050,30,005,"Montana","Blaine County",3,68,70,35,35
050,30,005,"Montana","Blaine County",3,69,68,33,35
050,30,005,"Montana","Blaine County",3,70,67,31,36
050,30,005,"Montana","Blaine County",3,71,59,28,31
050,30,005,"Montana","Blaine County",3,72,64,32,32
050,30,005,"Montana","Blaine County",3,73,61,29,32
050,30,005,"Montana","Blaine County",3,74,63,29,34
050,30,005,"Montana","Blaine County",3,75,50,21,29
050,30,005,"Montana","Blaine County",3,76,44,20,24
050,30,005,"Montana","Blaine County",3,77,31,15,16
050,30,005,"Montana","Blaine County",3,78,44,22,22
050,30,005,"Montana","Blaine County",3,79,29,13,16
050,30,005,"Montana","Blaine County",3,80,29,14,15
050,30,005,"Montana","Blaine County",3,81,26,12,14
050,30,005,"Montana","Blaine County",3,82,29,11,18
050,30,005,"Montana","Blaine County",3,83,29,15,14
050,30,005,"Montana","Blaine County",3,84,20,11,9
050,30,005,"Montana","Blaine County",3,85,117,37,80
050,30,005,"Montana","Blaine County",4,0,87,41,46
050,30,005,"Montana","Blaine County",4,1,99,50,49
050,30,005,"Montana","Blaine County",4,2,99,45,54
050,30,005,"Montana","Blaine County",4,3,96,51,45
050,30,005,"Montana","Blaine County",4,4,108,49,59
050,30,005,"Montana","Blaine County",4,5,111,51,60
050,30,005,"Montana","Blaine County",4,6,118,64,54
050,30,005,"Montana","Blaine County",4,7,115,63,52
050,30,005,"Montana","Blaine County",4,8,119,62,57
050,30,005,"Montana","Blaine County",4,9,100,52,48
050,30,005,"Montana","Blaine County",4,10,122,57,65
050,30,005,"Montana","Blaine County",4,11,122,60,62
050,30,005,"Montana","Blaine County",4,12,112,64,48
050,30,005,"Montana","Blaine County",4,13,135,75,60
050,30,005,"Montana","Blaine County",4,14,125,69,56
050,30,005,"Montana","Blaine County",4,15,121,59,62
050,30,005,"Montana","Blaine County",4,16,125,61,64
050,30,005,"Montana","Blaine County",4,17,125,58,67
050,30,005,"Montana","Blaine County",4,18,105,52,53
050,30,005,"Montana","Blaine County",4,19,86,49,37
050,30,005,"Montana","Blaine County",4,20,76,40,36
050,30,005,"Montana","Blaine County",4,21,77,45,32
050,30,005,"Montana","Blaine County",4,22,81,44,37
050,30,005,"Montana","Blaine County",4,23,91,48,43
050,30,005,"Montana","Blaine County",4,24,74,36,38
050,30,005,"Montana","Blaine County",4,25,79,42,37
050,30,005,"Montana","Blaine County",4,26,73,42,31
050,30,005,"Montana","Blaine County",4,27,82,46,36
050,30,005,"Montana","Blaine County",4,28,80,38,42
050,30,005,"Montana","Blaine County",4,29,86,43,43
050,30,005,"Montana","Blaine County",4,30,97,54,43
050,30,005,"Montana","Blaine County",4,31,86,46,40
050,30,005,"Montana","Blaine County",4,32,91,45,46
050,30,005,"Montana","Blaine County",4,33,84,47,37
050,30,005,"Montana","Blaine County",4,34,78,43,35
050,30,005,"Montana","Blaine County",4,35,89,55,34
050,30,005,"Montana","Blaine County",4,36,78,41,37
050,30,005,"Montana","Blaine County",4,37,73,27,46
050,30,005,"Montana","Blaine County",4,38,86,41,45
050,30,005,"Montana","Blaine County",4,39,86,44,42
050,30,005,"Montana","Blaine County",4,40,84,40,44
050,30,005,"Montana","Blaine County",4,41,88,48,40
050,30,005,"Montana","Blaine County",4,42,81,45,36
050,30,005,"Montana","Blaine County",4,43,85,45,40
050,30,005,"Montana","Blaine County",4,44,81,44,37
050,30,005,"Montana","Blaine County",4,45,76,42,34
050,30,005,"Montana","Blaine County",4,46,69,41,28
050,30,005,"Montana","Blaine County",4,47,66,33,33
050,30,005,"Montana","Blaine County",4,48,57,28,29
050,30,005,"Montana","Blaine County",4,49,60,31,29
050,30,005,"Montana","Blaine County",4,50,76,44,32
050,30,005,"Montana","Blaine County",4,51,72,37,35
050,30,005,"Montana","Blaine County",4,52,60,30,30
050,30,005,"Montana","Blaine County",4,53,47,21,26
050,30,005,"Montana","Blaine County",4,54,72,34,38
050,30,005,"Montana","Blaine County",4,55,66,26,40
050,30,005,"Montana","Blaine County",4,56,81,42,39
050,30,005,"Montana","Blaine County",4,57,82,39,43
050,30,005,"Montana","Blaine County",4,58,82,43,39
050,30,005,"Montana","Blaine County",4,59,80,48,32
050,30,005,"Montana","Blaine County",4,60,87,41,46
050,30,005,"Montana","Blaine County",4,61,100,40,60
050,30,005,"Montana","Blaine County",4,62,108,55,53
050,30,005,"Montana","Blaine County",4,63,93,51,42
050,30,005,"Montana","Blaine County",4,64,92,55,37
050,30,005,"Montana","Blaine County",4,65,80,41,39
050,30,005,"Montana","Blaine County",4,66,79,46,33
050,30,005,"Montana","Blaine County",4,67,65,38,27
050,30,005,"Montana","Blaine County",4,68,69,30,39
050,30,005,"Montana","Blaine County",4,69,61,32,29
050,30,005,"Montana","Blaine County",4,70,68,35,33
050,30,005,"Montana","Blaine County",4,71,67,30,37
050,30,005,"Montana","Blaine County",4,72,56,28,28
050,30,005,"Montana","Blaine County",4,73,63,30,33
050,30,005,"Montana","Blaine County",4,74,60,28,32
050,30,005,"Montana","Blaine County",4,75,62,30,32
050,30,005,"Montana","Blaine County",4,76,48,18,30
050,30,005,"Montana","Blaine County",4,77,42,17,25
050,30,005,"Montana","Blaine County",4,78,32,16,16
050,30,005,"Montana","Blaine County",4,79,41,20,21
050,30,005,"Montana","Blaine County",4,80,29,13,16
050,30,005,"Montana","Blaine County",4,81,31,14,17
050,30,005,"Montana","Blaine County",4,82,26,12,14
050,30,005,"Montana","Blaine County",4,83,29,13,16
050,30,005,"Montana","Blaine County",4,84,26,14,12
050,30,005,"Montana","Blaine County",4,85,116,42,74
050,30,005,"Montana","Blaine County",5,0,87,41,46
050,30,005,"Montana","Blaine County",5,1,88,42,46
050,30,005,"Montana","Blaine County",5,2,96,47,49
050,30,005,"Montana","Blaine County",5,3,95,42,53
050,30,005,"Montana","Blaine County",5,4,94,50,44
050,30,005,"Montana","Blaine County",5,5,112,47,65
050,30,005,"Montana","Blaine County",5,6,105,48,57
050,30,005,"Montana","Blaine County",5,7,113,59,54
050,30,005,"Montana","Blaine County",5,8,114,64,50
050,30,005,"Montana","Blaine County",5,9,118,57,61
050,30,005,"Montana","Blaine County",5,10,103,53,50
050,30,005,"Montana","Blaine County",5,11,116,52,64
050,30,005,"Montana","Blaine County",5,12,116,55,61
050,30,005,"Montana","Blaine County",5,13,108,61,47
050,30,005,"Montana","Blaine County",5,14,132,70,62
050,30,005,"Montana","Blaine County",5,15,120,67,53
050,30,005,"Montana","Blaine County",5,16,119,62,57
050,30,005,"Montana","Blaine County",5,17,115,53,62
050,30,005,"Montana","Blaine County",5,18,116,56,60
050,30,005,"Montana","Blaine County",5,19,84,45,39
050,30,005,"Montana","Blaine County",5,20,83,44,39
050,30,005,"Montana","Blaine County",5,21,68,41,27
050,30,005,"Montana","Blaine County",5,22,70,39,31
050,30,005,"Montana","Blaine County",5,23,81,47,34
050,30,005,"Montana","Blaine County",5,24,95,50,45
050,30,005,"Montana","Blaine County",5,25,71,37,34
050,30,005,"Montana","Blaine County",5,26,81,43,38
050,30,005,"Montana","Blaine County",5,27,72,42,30
050,30,005,"Montana","Blaine County",5,28,76,43,33
050,30,005,"Montana","Blaine County",5,29,80,42,38
050,30,005,"Montana","Blaine County",5,30,83,45,38
050,30,005,"Montana","Blaine County",5,31,93,53,40
050,30,005,"Montana","Blaine County",5,32,90,49,41
050,30,005,"Montana","Blaine County",5,33,86,40,46
050,30,005,"Montana","Blaine County",5,34,82,46,36
050,30,005,"Montana","Blaine County",5,35,78,43,35
050,30,005,"Montana","Blaine County",5,36,91,56,35
050,30,005,"Montana","Blaine County",5,37,79,42,37
050,30,005,"Montana","Blaine County",5,38,79,31,48
050,30,005,"Montana","Blaine County",5,39,83,39,44
050,30,005,"Montana","Blaine County",5,40,90,46,44
050,30,005,"Montana","Blaine County",5,41,83,39,44
050,30,005,"Montana","Blaine County",5,42,92,48,44
050,30,005,"Montana","Blaine County",5,43,76,47,29
050,30,005,"Montana","Blaine County",5,44,81,42,39
050,30,005,"Montana","Blaine County",5,45,81,44,37
050,30,005,"Montana","Blaine County",5,46,71,40,31
050,30,005,"Montana","Blaine County",5,47,69,42,27
050,30,005,"Montana","Blaine County",5,48,61,30,31
050,30,005,"Montana","Blaine County",5,49,59,28,31
050,30,005,"Montana","Blaine County",5,50,65,34,31
050,30,005,"Montana","Blaine County",5,51,77,42,35
050,30,005,"Montana","Blaine County",5,52,78,43,35
050,30,005,"Montana","Blaine County",5,53,56,24,32
050,30,005,"Montana","Blaine County",5,54,49,23,26
050,30,005,"Montana","Blaine County",5,55,73,31,42
050,30,005,"Montana","Blaine County",5,56,62,27,35
050,30,005,"Montana","Blaine County",5,57,76,41,35
050,30,005,"Montana","Blaine County",5,58,82,38,44
050,30,005,"Montana","Blaine County",5,59,79,43,36
050,30,005,"Montana","Blaine County",5,60,82,50,32
050,30,005,"Montana","Blaine County",5,61,81,36,45
050,30,005,"Montana","Blaine County",5,62,98,39,59
050,30,005,"Montana","Blaine County",5,63,108,57,51
050,30,005,"Montana","Blaine County",5,64,94,52,42
050,30,005,"Montana","Blaine County",5,65,88,48,40
050,30,005,"Montana","Blaine County",5,66,81,42,39
050,30,005,"Montana","Blaine County",5,67,76,45,31
050,30,005,"Montana","Blaine County",5,68,65,38,27
050,30,005,"Montana","Blaine County",5,69,67,29,38
050,30,005,"Montana","Blaine County",5,70,61,32,29
050,30,005,"Montana","Blaine County",5,71,68,34,34
050,30,005,"Montana","Blaine County",5,72,65,30,35
050,30,005,"Montana","Blaine County",5,73,58,27,31
050,30,005,"Montana","Blaine County",5,74,60,29,31
050,30,005,"Montana","Blaine County",5,75,58,29,29
050,30,005,"Montana","Blaine County",5,76,58,25,33
050,30,005,"Montana","Blaine County",5,77,47,17,30
050,30,005,"Montana","Blaine County",5,78,41,17,24
050,30,005,"Montana","Blaine County",5,79,28,14,14
050,30,005,"Montana","Blaine County",5,80,41,20,21
050,30,005,"Montana","Blaine County",5,81,31,13,18
050,30,005,"Montana","Blaine County",5,82,33,13,20
050,30,005,"Montana","Blaine County",5,83,26,14,12
050,30,005,"Montana","Blaine County",5,84,24,11,13
050,30,005,"Montana","Blaine County",5,85,128,51,77
050,30,007,"Montana","Broadwater County",1,0,63,31,32
050,30,007,"Montana","Broadwater County",1,1,76,37,39
050,30,007,"Montana","Broadwater County",1,2,67,38,29
050,30,007,"Montana","Broadwater County",1,3,83,54,29
050,30,007,"Montana","Broadwater County",1,4,73,32,41
050,30,007,"Montana","Broadwater County",1,5,61,33,28
050,30,007,"Montana","Broadwater County",1,6,77,37,40
050,30,007,"Montana","Broadwater County",1,7,75,41,34
050,30,007,"Montana","Broadwater County",1,8,73,36,37
050,30,007,"Montana","Broadwater County",1,9,75,37,38
050,30,007,"Montana","Broadwater County",1,10,70,37,33
050,30,007,"Montana","Broadwater County",1,11,69,29,40
050,30,007,"Montana","Broadwater County",1,12,77,35,42
050,30,007,"Montana","Broadwater County",1,13,73,42,31
050,30,007,"Montana","Broadwater County",1,14,79,41,38
050,30,007,"Montana","Broadwater County",1,15,76,40,36
050,30,007,"Montana","Broadwater County",1,16,83,40,43
050,30,007,"Montana","Broadwater County",1,17,80,36,44
050,30,007,"Montana","Broadwater County",1,18,66,32,34
050,30,007,"Montana","Broadwater County",1,19,54,24,30
050,30,007,"Montana","Broadwater County",1,20,52,30,22
050,30,007,"Montana","Broadwater County",1,21,56,33,23
050,30,007,"Montana","Broadwater County",1,22,56,31,25
050,30,007,"Montana","Broadwater County",1,23,70,39,31
050,30,007,"Montana","Broadwater County",1,24,63,33,30
050,30,007,"Montana","Broadwater County",1,25,66,33,33
050,30,007,"Montana","Broadwater County",1,26,59,30,29
050,30,007,"Montana","Broadwater County",1,27,81,43,38
050,30,007,"Montana","Broadwater County",1,28,74,39,35
050,30,007,"Montana","Broadwater County",1,29,66,37,29
050,30,007,"Montana","Broadwater County",1,30,70,34,36
050,30,007,"Montana","Broadwater County",1,31,70,36,34
050,30,007,"Montana","Broadwater County",1,32,70,33,37
050,30,007,"Montana","Broadwater County",1,33,61,31,30
050,30,007,"Montana","Broadwater County",1,34,70,39,31
050,30,007,"Montana","Broadwater County",1,35,80,40,40
050,30,007,"Montana","Broadwater County",1,36,72,41,31
050,30,007,"Montana","Broadwater County",1,37,77,38,39
050,30,007,"Montana","Broadwater County",1,38,78,39,39
050,30,007,"Montana","Broadwater County",1,39,72,38,34
050,30,007,"Montana","Broadwater County",1,40,80,41,39
050,30,007,"Montana","Broadwater County",1,41,73,34,39
050,30,007,"Montana","Broadwater County",1,42,74,39,35
050,30,007,"Montana","Broadwater County",1,43,83,42,41
050,30,007,"Montana","Broadwater County",1,44,76,45,31
050,30,007,"Montana","Broadwater County",1,45,65,32,33
050,30,007,"Montana","Broadwater County",1,46,68,38,30
050,30,007,"Montana","Broadwater County",1,47,81,46,35
050,30,007,"Montana","Broadwater County",1,48,81,41,40
050,30,007,"Montana","Broadwater County",1,49,105,54,51
050,30,007,"Montana","Broadwater County",1,50,87,41,46
050,30,007,"Montana","Broadwater County",1,51,82,38,44
050,30,007,"Montana","Broadwater County",1,52,94,47,47
050,30,007,"Montana","Broadwater County",1,53,84,41,43
050,30,007,"Montana","Broadwater County",1,54,93,49,44
050,30,007,"Montana","Broadwater County",1,55,107,60,47
050,30,007,"Montana","Broadwater County",1,56,98,47,51
050,30,007,"Montana","Broadwater County",1,57,110,42,68
050,30,007,"Montana","Broadwater County",1,58,108,52,56
050,30,007,"Montana","Broadwater County",1,59,122,63,59
050,30,007,"Montana","Broadwater County",1,60,114,58,56
050,30,007,"Montana","Broadwater County",1,61,139,76,63
050,30,007,"Montana","Broadwater County",1,62,125,73,52
050,30,007,"Montana","Broadwater County",1,63,115,66,49
050,30,007,"Montana","Broadwater County",1,64,113,58,55
050,30,007,"Montana","Broadwater County",1,65,111,63,48
050,30,007,"Montana","Broadwater County",1,66,113,68,45
050,30,007,"Montana","Broadwater County",1,67,107,59,48
050,30,007,"Montana","Broadwater County",1,68,99,61,38
050,30,007,"Montana","Broadwater County",1,69,102,56,46
050,30,007,"Montana","Broadwater County",1,70,113,53,60
050,30,007,"Montana","Broadwater County",1,71,93,47,46
050,30,007,"Montana","Broadwater County",1,72,99,57,42
050,30,007,"Montana","Broadwater County",1,73,105,59,46
050,30,007,"Montana","Broadwater County",1,74,65,34,31
050,30,007,"Montana","Broadwater County",1,75,73,31,42
050,30,007,"Montana","Broadwater County",1,76,66,35,31
050,30,007,"Montana","Broadwater County",1,77,61,33,28
050,30,007,"Montana","Broadwater County",1,78,50,31,19
050,30,007,"Montana","Broadwater County",1,79,48,31,17
050,30,007,"Montana","Broadwater County",1,80,40,20,20
050,30,007,"Montana","Broadwater County",1,81,38,18,20
050,30,007,"Montana","Broadwater County",1,82,34,17,17
050,30,007,"Montana","Broadwater County",1,83,28,11,17
050,30,007,"Montana","Broadwater County",1,84,24,12,12
050,30,007,"Montana","Broadwater County",1,85,116,52,64
050,30,007,"Montana","Broadwater County",2,0,76,37,39
050,30,007,"Montana","Broadwater County",2,1,74,35,39
050,30,007,"Montana","Broadwater County",2,2,72,40,32
050,30,007,"Montana","Broadwater County",2,3,80,50,30
050,30,007,"Montana","Broadwater County",2,4,76,38,38
050,30,007,"Montana","Broadwater County",2,5,64,32,32
050,30,007,"Montana","Broadwater County",2,6,73,36,37
050,30,007,"Montana","Broadwater County",2,7,74,40,34
050,30,007,"Montana","Broadwater County",2,8,74,37,37
050,30,007,"Montana","Broadwater County",2,9,75,37,38
050,30,007,"Montana","Broadwater County",2,10,72,37,35
050,30,007,"Montana","Broadwater County",2,11,69,31,38
050,30,007,"Montana","Broadwater County",2,12,75,34,41
050,30,007,"Montana","Broadwater County",2,13,74,40,34
050,30,007,"Montana","Broadwater County",2,14,78,41,37
050,30,007,"Montana","Broadwater County",2,15,76,39,37
050,30,007,"Montana","Broadwater County",2,16,82,40,42
050,30,007,"Montana","Broadwater County",2,17,80,37,43
050,30,007,"Montana","Broadwater County",2,18,65,31,34
050,30,007,"Montana","Broadwater County",2,19,52,23,29
050,30,007,"Montana","Broadwater County",2,20,54,29,25
050,30,007,"Montana","Broadwater County",2,21,56,33,23
050,30,007,"Montana","Broadwater County",2,22,56,31,25
050,30,007,"Montana","Broadwater County",2,23,70,39,31
050,30,007,"Montana","Broadwater County",2,24,67,35,32
050,30,007,"Montana","Broadwater County",2,25,68,33,35
050,30,007,"Montana","Broadwater County",2,26,63,32,31
050,30,007,"Montana","Broadwater County",2,27,77,41,36
050,30,007,"Montana","Broadwater County",2,28,78,41,37
050,30,007,"Montana","Broadwater County",2,29,71,39,32
050,30,007,"Montana","Broadwater County",2,30,73,36,37
050,30,007,"Montana","Broadwater County",2,31,71,36,35
050,30,007,"Montana","Broadwater County",2,32,72,35,37
050,30,007,"Montana","Broadwater County",2,33,65,34,31
050,30,007,"Montana","Broadwater County",2,34,69,38,31
050,30,007,"Montana","Broadwater County",2,35,79,41,38
050,30,007,"Montana","Broadwater County",2,36,74,40,34
050,30,007,"Montana","Broadwater County",2,37,78,41,37
050,30,007,"Montana","Broadwater County",2,38,76,38,38
050,30,007,"Montana","Broadwater County",2,39,74,39,35
050,30,007,"Montana","Broadwater County",2,40,80,41,39
050,30,007,"Montana","Broadwater County",2,41,75,36,39
050,30,007,"Montana","Broadwater County",2,42,74,38,36
050,30,007,"Montana","Broadwater County",2,43,81,42,39
050,30,007,"Montana","Broadwater County",2,44,78,44,34
050,30,007,"Montana","Broadwater County",2,45,68,36,32
050,30,007,"Montana","Broadwater County",2,46,68,37,31
050,30,007,"Montana","Broadwater County",2,47,79,44,35
050,30,007,"Montana","Broadwater County",2,48,83,43,40
050,30,007,"Montana","Broadwater County",2,49,101,52,49
050,30,007,"Montana","Broadwater County",2,50,92,45,47
050,30,007,"Montana","Broadwater County",2,51,82,39,43
050,30,007,"Montana","Broadwater County",2,52,92,46,46
050,30,007,"Montana","Broadwater County",2,53,87,42,45
050,30,007,"Montana","Broadwater County",2,54,93,49,44
050,30,007,"Montana","Broadwater County",2,55,105,58,47
050,30,007,"Montana","Broadwater County",2,56,102,51,51
050,30,007,"Montana","Broadwater County",2,57,109,44,65
050,30,007,"Montana","Broadwater County",2,58,111,51,60
050,30,007,"Montana","Broadwater County",2,59,121,63,58
050,30,007,"Montana","Broadwater County",2,60,119,61,58
050,30,007,"Montana","Broadwater County",2,61,134,72,62
050,30,007,"Montana","Broadwater County",2,62,130,74,56
050,30,007,"Montana","Broadwater County",2,63,119,69,50
050,30,007,"Montana","Broadwater County",2,64,111,57,54
050,30,007,"Montana","Broadwater County",2,65,113,63,50
050,30,007,"Montana","Broadwater County",2,66,113,67,46
050,30,007,"Montana","Broadwater County",2,67,110,62,48
050,30,007,"Montana","Broadwater County",2,68,100,61,39
050,30,007,"Montana","Broadwater County",2,69,103,58,45
050,30,007,"Montana","Broadwater County",2,70,110,53,57
050,30,007,"Montana","Broadwater County",2,71,99,49,50
050,30,007,"Montana","Broadwater County",2,72,97,55,42
050,30,007,"Montana","Broadwater County",2,73,110,62,48
050,30,007,"Montana","Broadwater County",2,74,70,38,32
050,30,007,"Montana","Broadwater County",2,75,72,32,40
050,30,007,"Montana","Broadwater County",2,76,68,35,33
050,30,007,"Montana","Broadwater County",2,77,62,32,30
050,30,007,"Montana","Broadwater County",2,78,52,30,22
050,30,007,"Montana","Broadwater County",2,79,48,31,17
050,30,007,"Montana","Broadwater County",2,80,42,23,19
050,30,007,"Montana","Broadwater County",2,81,39,19,20
050,30,007,"Montana","Broadwater County",2,82,35,17,18
050,30,007,"Montana","Broadwater County",2,83,28,11,17
050,30,007,"Montana","Broadwater County",2,84,25,12,13
050,30,007,"Montana","Broadwater County",2,85,118,52,66
050,30,007,"Montana","Broadwater County",3,0,69,43,26
050,30,007,"Montana","Broadwater County",3,1,82,36,46
050,30,007,"Montana","Broadwater County",3,2,82,39,43
050,30,007,"Montana","Broadwater County",3,3,86,48,38
050,30,007,"Montana","Broadwater County",3,4,82,52,30
050,30,007,"Montana","Broadwater County",3,5,87,45,42
050,30,007,"Montana","Broadwater County",3,6,70,34,36
050,30,007,"Montana","Broadwater County",3,7,83,43,40
050,30,007,"Montana","Broadwater County",3,8,86,47,39
050,30,007,"Montana","Broadwater County",3,9,82,38,44
050,30,007,"Montana","Broadwater County",3,10,78,37,41
050,30,007,"Montana","Broadwater County",3,11,85,42,43
050,30,007,"Montana","Broadwater County",3,12,69,32,37
050,30,007,"Montana","Broadwater County",3,13,80,39,41
050,30,007,"Montana","Broadwater County",3,14,80,43,37
050,30,007,"Montana","Broadwater County",3,15,82,40,42
050,30,007,"Montana","Broadwater County",3,16,76,37,39
050,30,007,"Montana","Broadwater County",3,17,86,42,44
050,30,007,"Montana","Broadwater County",3,18,74,35,39
050,30,007,"Montana","Broadwater County",3,19,49,23,26
050,30,007,"Montana","Broadwater County",3,20,56,28,28
050,30,007,"Montana","Broadwater County",3,21,51,30,21
050,30,007,"Montana","Broadwater County",3,22,66,37,29
050,30,007,"Montana","Broadwater County",3,23,67,35,32
050,30,007,"Montana","Broadwater County",3,24,75,37,38
050,30,007,"Montana","Broadwater County",3,25,76,40,36
050,30,007,"Montana","Broadwater County",3,26,73,36,37
050,30,007,"Montana","Broadwater County",3,27,73,38,35
050,30,007,"Montana","Broadwater County",3,28,82,41,41
050,30,007,"Montana","Broadwater County",3,29,90,51,39
050,30,007,"Montana","Broadwater County",3,30,85,49,36
050,30,007,"Montana","Broadwater County",3,31,89,49,40
050,30,007,"Montana","Broadwater County",3,32,72,31,41
050,30,007,"Montana","Broadwater County",3,33,80,36,44
050,30,007,"Montana","Broadwater County",3,34,72,40,32
050,30,007,"Montana","Broadwater County",3,35,86,47,39
050,30,007,"Montana","Broadwater County",3,36,82,46,36
050,30,007,"Montana","Broadwater County",3,37,80,42,38
050,30,007,"Montana","Broadwater County",3,38,90,47,43
050,30,007,"Montana","Broadwater County",3,39,84,43,41
050,30,007,"Montana","Broadwater County",3,40,81,43,38
050,30,007,"Montana","Broadwater County",3,41,89,44,45
050,30,007,"Montana","Broadwater County",3,42,81,41,40
050,30,007,"Montana","Broadwater County",3,43,77,42,35
050,30,007,"Montana","Broadwater County",3,44,89,48,41
050,30,007,"Montana","Broadwater County",3,45,84,45,39
050,30,007,"Montana","Broadwater County",3,46,74,39,35
050,30,007,"Montana","Broadwater County",3,47,72,37,35
050,30,007,"Montana","Broadwater County",3,48,87,49,38
050,30,007,"Montana","Broadwater County",3,49,92,47,45
050,30,007,"Montana","Broadwater County",3,50,106,55,51
050,30,007,"Montana","Broadwater County",3,51,91,46,45
050,30,007,"Montana","Broadwater County",3,52,85,42,43
050,30,007,"Montana","Broadwater County",3,53,104,51,53
050,30,007,"Montana","Broadwater County",3,54,93,49,44
050,30,007,"Montana","Broadwater County",3,55,104,56,48
050,30,007,"Montana","Broadwater County",3,56,114,58,56
050,30,007,"Montana","Broadwater County",3,57,107,52,55
050,30,007,"Montana","Broadwater County",3,58,117,43,74
050,30,007,"Montana","Broadwater County",3,59,121,59,62
050,30,007,"Montana","Broadwater County",3,60,126,64,62
050,30,007,"Montana","Broadwater County",3,61,117,56,61
050,30,007,"Montana","Broadwater County",3,62,135,72,63
050,30,007,"Montana","Broadwater County",3,63,142,83,59
050,30,007,"Montana","Broadwater County",3,64,125,71,54
050,30,007,"Montana","Broadwater County",3,65,116,55,61
050,30,007,"Montana","Broadwater County",3,66,115,62,53
050,30,007,"Montana","Broadwater County",3,67,116,70,46
050,30,007,"Montana","Broadwater County",3,68,107,62,45
050,30,007,"Montana","Broadwater County",3,69,105,60,45
050,30,007,"Montana","Broadwater County",3,70,105,59,46
050,30,007,"Montana","Broadwater County",3,71,113,57,56
050,30,007,"Montana","Broadwater County",3,72,103,49,54
050,30,007,"Montana","Broadwater County",3,73,96,54,42
050,30,007,"Montana","Broadwater County",3,74,112,61,51
050,30,007,"Montana","Broadwater County",3,75,69,37,32
050,30,007,"Montana","Broadwater County",3,76,71,34,37
050,30,007,"Montana","Broadwater County",3,77,68,35,33
050,30,007,"Montana","Broadwater County",3,78,61,32,29
050,30,007,"Montana","Broadwater County",3,79,49,27,22
050,30,007,"Montana","Broadwater County",3,80,48,32,16
050,30,007,"Montana","Broadwater County",3,81,41,23,18
050,30,007,"Montana","Broadwater County",3,82,34,17,17
050,30,007,"Montana","Broadwater County",3,83,31,16,15
050,30,007,"Montana","Broadwater County",3,84,23,10,13
050,30,007,"Montana","Broadwater County",3,85,130,60,70
050,30,007,"Montana","Broadwater County",4,0,84,51,33
050,30,007,"Montana","Broadwater County",4,1,83,45,38
050,30,007,"Montana","Broadwater County",4,2,89,36,53
050,30,007,"Montana","Broadwater County",4,3,83,42,41
050,30,007,"Montana","Broadwater County",4,4,93,51,42
050,30,007,"Montana","Broadwater County",4,5,88,52,36
050,30,007,"Montana","Broadwater County",4,6,92,47,45
050,30,007,"Montana","Broadwater County",4,7,85,42,43
050,30,007,"Montana","Broadwater County",4,8,82,40,42
050,30,007,"Montana","Broadwater County",4,9,97,52,45
050,30,007,"Montana","Broadwater County",4,10,94,45,49
050,30,007,"Montana","Broadwater County",4,11,83,43,40
050,30,007,"Montana","Broadwater County",4,12,86,44,42
050,30,007,"Montana","Broadwater County",4,13,82,39,43
050,30,007,"Montana","Broadwater County",4,14,89,46,43
050,30,007,"Montana","Broadwater County",4,15,86,42,44
050,30,007,"Montana","Broadwater County",4,16,90,46,44
050,30,007,"Montana","Broadwater County",4,17,84,45,39
050,30,007,"Montana","Broadwater County",4,18,68,33,35
050,30,007,"Montana","Broadwater County",4,19,54,25,29
050,30,007,"Montana","Broadwater County",4,20,56,27,29
050,30,007,"Montana","Broadwater County",4,21,61,31,30
050,30,007,"Montana","Broadwater County",4,22,58,34,24
050,30,007,"Montana","Broadwater County",4,23,68,39,29
050,30,007,"Montana","Broadwater County",4,24,82,42,40
050,30,007,"Montana","Broadwater County",4,25,79,38,41
050,30,007,"Montana","Broadwater County",4,26,83,46,37
050,30,007,"Montana","Broadwater County",4,27,83,44,39
050,30,007,"Montana","Broadwater County",4,28,84,48,36
050,30,007,"Montana","Broadwater County",4,29,96,49,47
050,30,007,"Montana","Broadwater County",4,30,100,59,41
050,30,007,"Montana","Broadwater County",4,31,95,59,36
050,30,007,"Montana","Broadwater County",4,32,104,54,50
050,30,007,"Montana","Broadwater County",4,33,73,28,45
050,30,007,"Montana","Broadwater County",4,34,99,46,53
050,30,007,"Montana","Broadwater County",4,35,82,42,40
050,30,007,"Montana","Broadwater County",4,36,92,49,43
050,30,007,"Montana","Broadwater County",4,37,94,54,40
050,30,007,"Montana","Broadwater County",4,38,89,47,42
050,30,007,"Montana","Broadwater County",4,39,100,55,45
050,30,007,"Montana","Broadwater County",4,40,93,48,45
050,30,007,"Montana","Broadwater County",4,41,91,50,41
050,30,007,"Montana","Broadwater County",4,42,108,51,57
050,30,007,"Montana","Broadwater County",4,43,94,48,46
050,30,007,"Montana","Broadwater County",4,44,88,49,39
050,30,007,"Montana","Broadwater County",4,45,89,46,43
050,30,007,"Montana","Broadwater County",4,46,86,49,37
050,30,007,"Montana","Broadwater County",4,47,74,39,35
050,30,007,"Montana","Broadwater County",4,48,74,37,37
050,30,007,"Montana","Broadwater County",4,49,92,54,38
050,30,007,"Montana","Broadwater County",4,50,103,59,44
050,30,007,"Montana","Broadwater County",4,51,105,51,54
050,30,007,"Montana","Broadwater County",4,52,101,49,52
050,30,007,"Montana","Broadwater County",4,53,87,44,43
050,30,007,"Montana","Broadwater County",4,54,106,54,52
050,30,007,"Montana","Broadwater County",4,55,97,48,49
050,30,007,"Montana","Broadwater County",4,56,107,57,50
050,30,007,"Montana","Broadwater County",4,57,115,58,57
050,30,007,"Montana","Broadwater County",4,58,111,56,55
050,30,007,"Montana","Broadwater County",4,59,113,40,73
050,30,007,"Montana","Broadwater County",4,60,123,56,67
050,30,007,"Montana","Broadwater County",4,61,124,64,60
050,30,007,"Montana","Broadwater County",4,62,117,58,59
050,30,007,"Montana","Broadwater County",4,63,137,74,63
050,30,007,"Montana","Broadwater County",4,64,151,90,61
050,30,007,"Montana","Broadwater County",4,65,131,73,58
050,30,007,"Montana","Broadwater County",4,66,113,53,60
050,30,007,"Montana","Broadwater County",4,67,116,64,52
050,30,007,"Montana","Broadwater County",4,68,115,68,47
050,30,007,"Montana","Broadwater County",4,69,115,68,47
050,30,007,"Montana","Broadwater County",4,70,106,63,43
050,30,007,"Montana","Broadwater County",4,71,102,58,44
050,30,007,"Montana","Broadwater County",4,72,119,61,58
050,30,007,"Montana","Broadwater County",4,73,105,49,56
050,30,007,"Montana","Broadwater County",4,74,99,53,46
050,30,007,"Montana","Broadwater County",4,75,108,57,51
050,30,007,"Montana","Broadwater County",4,76,68,37,31
050,30,007,"Montana","Broadwater County",4,77,72,33,39
050,30,007,"Montana","Broadwater County",4,78,71,35,36
050,30,007,"Montana","Broadwater County",4,79,62,35,27
050,30,007,"Montana","Broadwater County",4,80,44,22,22
050,30,007,"Montana","Broadwater County",4,81,46,31,15
050,30,007,"Montana","Broadwater County",4,82,35,20,15
050,30,007,"Montana","Broadwater County",4,83,36,17,19
050,30,007,"Montana","Broadwater County",4,84,29,14,15
050,30,007,"Montana","Broadwater County",4,85,123,58,65
050,30,007,"Montana","Broadwater County",5,0,84,51,33
050,30,007,"Montana","Broadwater County",5,1,88,57,31
050,30,007,"Montana","Broadwater County",5,2,87,50,37
050,30,007,"Montana","Broadwater County",5,3,100,45,55
050,30,007,"Montana","Broadwater County",5,4,86,40,46
050,30,007,"Montana","Broadwater County",5,5,100,55,45
050,30,007,"Montana","Broadwater County",5,6,94,56,38
050,30,007,"Montana","Broadwater County",5,7,98,47,51
050,30,007,"Montana","Broadwater County",5,8,81,36,45
050,30,007,"Montana","Broadwater County",5,9,85,42,43
050,30,007,"Montana","Broadwater County",5,10,95,51,44
050,30,007,"Montana","Broadwater County",5,11,94,47,47
050,30,007,"Montana","Broadwater County",5,12,82,40,42
050,30,007,"Montana","Broadwater County",5,13,92,45,47
050,30,007,"Montana","Broadwater County",5,14,87,40,47
050,30,007,"Montana","Broadwater County",5,15,92,46,46
050,30,007,"Montana","Broadwater County",5,16,89,43,46
050,30,007,"Montana","Broadwater County",5,17,88,43,45
050,30,007,"Montana","Broadwater County",5,18,80,43,37
050,30,007,"Montana","Broadwater County",5,19,62,34,28
050,30,007,"Montana","Broadwater County",5,20,62,27,35
050,30,007,"Montana","Broadwater County",5,21,57,26,31
050,30,007,"Montana","Broadwater County",5,22,68,35,33
050,30,007,"Montana","Broadwater County",5,23,64,40,24
050,30,007,"Montana","Broadwater County",5,24,72,35,37
050,30,007,"Montana","Broadwater County",5,25,90,48,42
050,30,007,"Montana","Broadwater County",5,26,93,48,45
050,30,007,"Montana","Broadwater County",5,27,93,49,44
050,30,007,"Montana","Broadwater County",5,28,80,36,44
050,30,007,"Montana","Broadwater County",5,29,96,58,38
050,30,007,"Montana","Broadwater County",5,30,109,59,50
050,30,007,"Montana","Broadwater County",5,31,105,59,46
050,30,007,"Montana","Broadwater County",5,32,102,63,39
050,30,007,"Montana","Broadwater County",5,33,103,53,50
050,30,007,"Montana","Broadwater County",5,34,76,32,44
050,30,007,"Montana","Broadwater County",5,35,107,53,54
050,30,007,"Montana","Broadwater County",5,36,85,43,42
050,30,007,"Montana","Broadwater County",5,37,96,52,44
050,30,007,"Montana","Broadwater County",5,38,104,59,45
050,30,007,"Montana","Broadwater County",5,39,94,47,47
050,30,007,"Montana","Broadwater County",5,40,103,55,48
050,30,007,"Montana","Broadwater County",5,41,99,52,47
050,30,007,"Montana","Broadwater County",5,42,102,56,46
050,30,007,"Montana","Broadwater County",5,43,113,55,58
050,30,007,"Montana","Broadwater County",5,44,91,43,48
050,30,007,"Montana","Broadwater County",5,45,88,49,39
050,30,007,"Montana","Broadwater County",5,46,92,51,41
050,30,007,"Montana","Broadwater County",5,47,91,49,42
050,30,007,"Montana","Broadwater County",5,48,80,42,38
050,30,007,"Montana","Broadwater County",5,49,78,38,40
050,30,007,"Montana","Broadwater County",5,50,95,54,41
050,30,007,"Montana","Broadwater County",5,51,105,59,46
050,30,007,"Montana","Broadwater County",5,52,112,53,59
050,30,007,"Montana","Broadwater County",5,53,105,51,54
050,30,007,"Montana","Broadwater County",5,54,96,47,49
050,30,007,"Montana","Broadwater County",5,55,104,52,52
050,30,007,"Montana","Broadwater County",5,56,96,47,49
050,30,007,"Montana","Broadwater County",5,57,107,57,50
050,30,007,"Montana","Broadwater County",5,58,118,61,57
050,30,007,"Montana","Broadwater County",5,59,113,59,54
050,30,007,"Montana","Broadwater County",5,60,113,40,73
050,30,007,"Montana","Broadwater County",5,61,140,66,74
050,30,007,"Montana","Broadwater County",5,62,120,60,60
050,30,007,"Montana","Broadwater County",5,63,120,58,62
050,30,007,"Montana","Broadwater County",5,64,143,78,65
050,30,007,"Montana","Broadwater County",5,65,157,94,63
050,30,007,"Montana","Broadwater County",5,66,129,74,55
050,30,007,"Montana","Broadwater County",5,67,110,55,55
050,30,007,"Montana","Broadwater County",5,68,111,62,49
050,30,007,"Montana","Broadwater County",5,69,119,68,51
050,30,007,"Montana","Broadwater County",5,70,115,63,52
050,30,007,"Montana","Broadwater County",5,71,94,54,40
050,30,007,"Montana","Broadwater County",5,72,100,57,43
050,30,007,"Montana","Broadwater County",5,73,119,57,62
050,30,007,"Montana","Broadwater County",5,74,108,49,59
050,30,007,"Montana","Broadwater County",5,75,97,51,46
050,30,007,"Montana","Broadwater County",5,76,106,55,51
050,30,007,"Montana","Broadwater County",5,77,67,35,32
050,30,007,"Montana","Broadwater County",5,78,65,30,35
050,30,007,"Montana","Broadwater County",5,79,67,35,32
050,30,007,"Montana","Broadwater County",5,80,56,34,22
050,30,007,"Montana","Broadwater County",5,81,46,23,23
050,30,007,"Montana","Broadwater County",5,82,40,28,12
050,30,007,"Montana","Broadwater County",5,83,32,18,14
050,30,007,"Montana","Broadwater County",5,84,28,14,14
050,30,007,"Montana","Broadwater County",5,85,122,55,67
050,30,009,"Montana","Carbon County",1,0,81,42,39
050,30,009,"Montana","Carbon County",1,1,88,44,44
050,30,009,"Montana","Carbon County",1,2,90,44,46
050,30,009,"Montana","Carbon County",1,3,79,40,39
050,30,009,"Montana","Carbon County",1,4,79,37,42
050,30,009,"Montana","Carbon County",1,5,79,31,48
050,30,009,"Montana","Carbon County",1,6,86,45,41
050,30,009,"Montana","Carbon County",1,7,94,52,42
050,30,009,"Montana","Carbon County",1,8,116,66,50
050,30,009,"Montana","Carbon County",1,9,122,75,47
050,30,009,"Montana","Carbon County",1,10,117,62,55
050,30,009,"Montana","Carbon County",1,11,106,47,59
050,30,009,"Montana","Carbon County",1,12,119,64,55
050,30,009,"Montana","Carbon County",1,13,126,68,58
050,30,009,"Montana","Carbon County",1,14,114,61,53
050,30,009,"Montana","Carbon County",1,15,111,52,59
050,30,009,"Montana","Carbon County",1,16,127,61,66
050,30,009,"Montana","Carbon County",1,17,120,58,62
050,30,009,"Montana","Carbon County",1,18,99,56,43
050,30,009,"Montana","Carbon County",1,19,83,46,37
050,30,009,"Montana","Carbon County",1,20,76,48,28
050,30,009,"Montana","Carbon County",1,21,70,37,33
050,30,009,"Montana","Carbon County",1,22,71,35,36
050,30,009,"Montana","Carbon County",1,23,79,44,35
050,30,009,"Montana","Carbon County",1,24,85,38,47
050,30,009,"Montana","Carbon County",1,25,82,38,44
050,30,009,"Montana","Carbon County",1,26,92,45,47
050,30,009,"Montana","Carbon County",1,27,75,43,32
050,30,009,"Montana","Carbon County",1,28,84,45,39
050,30,009,"Montana","Carbon County",1,29,69,36,33
050,30,009,"Montana","Carbon County",1,30,68,40,28
050,30,009,"Montana","Carbon County",1,31,91,42,49
050,30,009,"Montana","Carbon County",1,32,99,48,51
050,30,009,"Montana","Carbon County",1,33,100,49,51
050,30,009,"Montana","Carbon County",1,34,95,49,46
050,30,009,"Montana","Carbon County",1,35,115,59,56
050,30,009,"Montana","Carbon County",1,36,112,56,56
050,30,009,"Montana","Carbon County",1,37,119,60,59
050,30,009,"Montana","Carbon County",1,38,133,68,65
050,30,009,"Montana","Carbon County",1,39,129,62,67
050,30,009,"Montana","Carbon County",1,40,119,57,62
050,30,009,"Montana","Carbon County",1,41,139,71,68
050,30,009,"Montana","Carbon County",1,42,139,70,69
050,30,009,"Montana","Carbon County",1,43,143,74,69
050,30,009,"Montana","Carbon County",1,44,108,56,52
050,30,009,"Montana","Carbon County",1,45,119,59,60
050,30,009,"Montana","Carbon County",1,46,121,66,55
050,30,009,"Montana","Carbon County",1,47,115,63,52
050,30,009,"Montana","Carbon County",1,48,128,57,71
050,30,009,"Montana","Carbon County",1,49,140,75,65
050,30,009,"Montana","Carbon County",1,50,128,77,51
050,30,009,"Montana","Carbon County",1,51,133,71,62
050,30,009,"Montana","Carbon County",1,52,137,72,65
050,30,009,"Montana","Carbon County",1,53,134,72,62
050,30,009,"Montana","Carbon County",1,54,119,63,56
050,30,009,"Montana","Carbon County",1,55,157,83,74
050,30,009,"Montana","Carbon County",1,56,176,94,82
050,30,009,"Montana","Carbon County",1,57,189,102,87
050,30,009,"Montana","Carbon County",1,58,167,78,89
050,30,009,"Montana","Carbon County",1,59,177,89,88
050,30,009,"Montana","Carbon County",1,60,210,110,100
050,30,009,"Montana","Carbon County",1,61,208,116,92
050,30,009,"Montana","Carbon County",1,62,231,121,110
050,30,009,"Montana","Carbon County",1,63,221,108,113
050,30,009,"Montana","Carbon County",1,64,213,104,109
050,30,009,"Montana","Carbon County",1,65,188,93,95
050,30,009,"Montana","Carbon County",1,66,188,96,92
050,30,009,"Montana","Carbon County",1,67,177,93,84
050,30,009,"Montana","Carbon County",1,68,181,94,87
050,30,009,"Montana","Carbon County",1,69,191,90,101
050,30,009,"Montana","Carbon County",1,70,177,84,93
050,30,009,"Montana","Carbon County",1,71,164,90,74
050,30,009,"Montana","Carbon County",1,72,172,97,75
050,30,009,"Montana","Carbon County",1,73,167,87,80
050,30,009,"Montana","Carbon County",1,74,120,68,52
050,30,009,"Montana","Carbon County",1,75,104,52,52
050,30,009,"Montana","Carbon County",1,76,94,47,47
050,30,009,"Montana","Carbon County",1,77,92,54,38
050,30,009,"Montana","Carbon County",1,78,85,48,37
050,30,009,"Montana","Carbon County",1,79,65,34,31
050,30,009,"Montana","Carbon County",1,80,73,38,35
050,30,009,"Montana","Carbon County",1,81,76,41,35
050,30,009,"Montana","Carbon County",1,82,65,33,32
050,30,009,"Montana","Carbon County",1,83,44,19,25
050,30,009,"Montana","Carbon County",1,84,43,22,21
050,30,009,"Montana","Carbon County",1,85,254,115,139
050,30,009,"Montana","Carbon County",2,0,76,39,37
050,30,009,"Montana","Carbon County",2,1,86,44,42
050,30,009,"Montana","Carbon County",2,2,91,45,46
050,30,009,"Montana","Carbon County",2,3,82,42,40
050,30,009,"Montana","Carbon County",2,4,80,38,42
050,30,009,"Montana","Carbon County",2,5,83,35,48
050,30,009,"Montana","Carbon County",2,6,86,42,44
050,30,009,"Montana","Carbon County",2,7,92,51,41
050,30,009,"Montana","Carbon County",2,8,111,63,48
050,30,009,"Montana","Carbon County",2,9,121,73,48
050,30,009,"Montana","Carbon County",2,10,118,64,54
050,30,009,"Montana","Carbon County",2,11,110,52,58
050,30,009,"Montana","Carbon County",2,12,118,61,57
050,30,009,"Montana","Carbon County",2,13,127,68,59
050,30,009,"Montana","Carbon County",2,14,117,62,55
050,30,009,"Montana","Carbon County",2,15,112,54,58
050,30,009,"Montana","Carbon County",2,16,124,59,65
050,30,009,"Montana","Carbon County",2,17,122,59,63
050,30,009,"Montana","Carbon County",2,18,98,54,44
050,30,009,"Montana","Carbon County",2,19,79,45,34
050,30,009,"Montana","Carbon County",2,20,78,47,31
050,30,009,"Montana","Carbon County",2,21,72,40,32
050,30,009,"Montana","Carbon County",2,22,73,35,38
050,30,009,"Montana","Carbon County",2,23,80,44,36
050,30,009,"Montana","Carbon County",2,24,83,39,44
050,30,009,"Montana","Carbon County",2,25,84,38,46
050,30,009,"Montana","Carbon County",2,26,89,44,45
050,30,009,"Montana","Carbon County",2,27,79,44,35
050,30,009,"Montana","Carbon County",2,28,83,45,38
050,30,009,"Montana","Carbon County",2,29,72,39,33
050,30,009,"Montana","Carbon County",2,30,70,40,30
050,30,009,"Montana","Carbon County",2,31,85,42,43
050,30,009,"Montana","Carbon County",2,32,98,48,50
050,30,009,"Montana","Carbon County",2,33,101,49,52
050,30,009,"Montana","Carbon County",2,34,98,50,48
050,30,009,"Montana","Carbon County",2,35,112,58,54
050,30,009,"Montana","Carbon County",2,36,114,58,56
050,30,009,"Montana","Carbon County",2,37,119,60,59
050,30,009,"Montana","Carbon County",2,38,133,68,65
050,30,009,"Montana","Carbon County",2,39,131,65,66
050,30,009,"Montana","Carbon County",2,40,124,61,63
050,30,009,"Montana","Carbon County",2,41,136,68,68
050,30,009,"Montana","Carbon County",2,42,141,72,69
050,30,009,"Montana","Carbon County",2,43,143,74,69
050,30,009,"Montana","Carbon County",2,44,118,62,56
050,30,009,"Montana","Carbon County",2,45,118,60,58
050,30,009,"Montana","Carbon County",2,46,122,64,58
050,30,009,"Montana","Carbon County",2,47,117,65,52
050,30,009,"Montana","Carbon County",2,48,126,59,67
050,30,009,"Montana","Carbon County",2,49,139,73,66
050,30,009,"Montana","Carbon County",2,50,133,77,56
050,30,009,"Montana","Carbon County",2,51,132,72,60
050,30,009,"Montana","Carbon County",2,52,137,72,65
050,30,009,"Montana","Carbon County",2,53,135,72,63
050,30,009,"Montana","Carbon County",2,54,125,66,59
050,30,009,"Montana","Carbon County",2,55,151,80,71
050,30,009,"Montana","Carbon County",2,56,171,92,79
050,30,009,"Montana","Carbon County",2,57,187,101,86
050,30,009,"Montana","Carbon County",2,58,174,84,90
050,30,009,"Montana","Carbon County",2,59,176,86,90
050,30,009,"Montana","Carbon County",2,60,203,104,99
050,30,009,"Montana","Carbon County",2,61,210,115,95
050,30,009,"Montana","Carbon County",2,62,227,122,105
050,30,009,"Montana","Carbon County",2,63,226,112,114
050,30,009,"Montana","Carbon County",2,64,214,105,109
050,30,009,"Montana","Carbon County",2,65,196,97,99
050,30,009,"Montana","Carbon County",2,66,188,95,93
050,30,009,"Montana","Carbon County",2,67,178,93,85
050,30,009,"Montana","Carbon County",2,68,179,93,86
050,30,009,"Montana","Carbon County",2,69,187,90,97
050,30,009,"Montana","Carbon County",2,70,178,84,94
050,30,009,"Montana","Carbon County",2,71,168,89,79
050,30,009,"Montana","Carbon County",2,72,165,92,73
050,30,009,"Montana","Carbon County",2,73,177,94,83
050,30,009,"Montana","Carbon County",2,74,123,69,54
050,30,009,"Montana","Carbon County",2,75,107,55,52
050,30,009,"Montana","Carbon County",2,76,94,48,46
050,30,009,"Montana","Carbon County",2,77,92,52,40
050,30,009,"Montana","Carbon County",2,78,84,48,36
050,30,009,"Montana","Carbon County",2,79,68,36,32
050,30,009,"Montana","Carbon County",2,80,72,37,35
050,30,009,"Montana","Carbon County",2,81,74,40,34
050,30,009,"Montana","Carbon County",2,82,65,34,31
050,30,009,"Montana","Carbon County",2,83,47,21,26
050,30,009,"Montana","Carbon County",2,84,41,20,21
050,30,009,"Montana","Carbon County",2,85,250,115,135
050,30,009,"Montana","Carbon County",3,0,82,49,33
050,30,009,"Montana","Carbon County",3,1,85,50,35
050,30,009,"Montana","Carbon County",3,2,93,47,46
050,30,009,"Montana","Carbon County",3,3,91,46,45
050,30,009,"Montana","Carbon County",3,4,87,39,48
050,30,009,"Montana","Carbon County",3,5,76,38,38
050,30,009,"Montana","Carbon County",3,6,85,37,48
050,30,009,"Montana","Carbon County",3,7,93,49,44
050,30,009,"Montana","Carbon County",3,8,94,51,43
050,30,009,"Montana","Carbon County",3,9,127,69,58
050,30,009,"Montana","Carbon County",3,10,125,77,48
050,30,009,"Montana","Carbon County",3,11,122,63,59
050,30,009,"Montana","Carbon County",3,12,113,51,62
050,30,009,"Montana","Carbon County",3,13,134,71,63
050,30,009,"Montana","Carbon County",3,14,130,74,56
050,30,009,"Montana","Carbon County",3,15,118,65,53
050,30,009,"Montana","Carbon County",3,16,108,49,59
050,30,009,"Montana","Carbon County",3,17,132,66,66
050,30,009,"Montana","Carbon County",3,18,101,53,48
050,30,009,"Montana","Carbon County",3,19,85,43,42
050,30,009,"Montana","Carbon County",3,20,83,48,35
050,30,009,"Montana","Carbon County",3,21,83,48,35
050,30,009,"Montana","Carbon County",3,22,80,44,36
050,30,009,"Montana","Carbon County",3,23,81,42,39
050,30,009,"Montana","Carbon County",3,24,85,43,42
050,30,009,"Montana","Carbon County",3,25,89,38,51
050,30,009,"Montana","Carbon County",3,26,91,47,44
050,30,009,"Montana","Carbon County",3,27,103,53,50
050,30,009,"Montana","Carbon County",3,28,92,46,46
050,30,009,"Montana","Carbon County",3,29,89,48,41
050,30,009,"Montana","Carbon County",3,30,90,48,42
050,30,009,"Montana","Carbon County",3,31,87,47,40
050,30,009,"Montana","Carbon County",3,32,95,45,50
050,30,009,"Montana","Carbon County",3,33,113,57,56
050,30,009,"Montana","Carbon County",3,34,115,53,62
050,30,009,"Montana","Carbon County",3,35,97,53,44
050,30,009,"Montana","Carbon County",3,36,111,56,55
050,30,009,"Montana","Carbon County",3,37,128,63,65
050,30,009,"Montana","Carbon County",3,38,137,70,67
050,30,009,"Montana","Carbon County",3,39,136,71,65
050,30,009,"Montana","Carbon County",3,40,133,67,66
050,30,009,"Montana","Carbon County",3,41,130,65,65
050,30,009,"Montana","Carbon County",3,42,139,67,72
050,30,009,"Montana","Carbon County",3,43,155,76,79
050,30,009,"Montana","Carbon County",3,44,147,78,69
050,30,009,"Montana","Carbon County",3,45,118,62,56
050,30,009,"Montana","Carbon County",3,46,127,64,63
050,30,009,"Montana","Carbon County",3,47,123,68,55
050,30,009,"Montana","Carbon County",3,48,121,66,55
050,30,009,"Montana","Carbon County",3,49,128,59,69
050,30,009,"Montana","Carbon County",3,50,145,75,70
050,30,009,"Montana","Carbon County",3,51,146,88,58
050,30,009,"Montana","Carbon County",3,52,140,77,63
050,30,009,"Montana","Carbon County",3,53,131,70,61
050,30,009,"Montana","Carbon County",3,54,136,72,64
050,30,009,"Montana","Carbon County",3,55,128,69,59
050,30,009,"Montana","Carbon County",3,56,145,74,71
050,30,009,"Montana","Carbon County",3,57,179,95,84
050,30,009,"Montana","Carbon County",3,58,184,100,84
050,30,009,"Montana","Carbon County",3,59,182,83,99
050,30,009,"Montana","Carbon County",3,60,171,82,89
050,30,009,"Montana","Carbon County",3,61,211,108,103
050,30,009,"Montana","Carbon County",3,62,219,119,100
050,30,009,"Montana","Carbon County",3,63,236,124,112
050,30,009,"Montana","Carbon County",3,64,241,128,113
050,30,009,"Montana","Carbon County",3,65,214,105,109
050,30,009,"Montana","Carbon County",3,66,206,105,101
050,30,009,"Montana","Carbon County",3,67,196,101,95
050,30,009,"Montana","Carbon County",3,68,182,95,87
050,30,009,"Montana","Carbon County",3,69,183,93,90
050,30,009,"Montana","Carbon County",3,70,187,91,96
050,30,009,"Montana","Carbon County",3,71,170,81,89
050,30,009,"Montana","Carbon County",3,72,169,89,80
050,30,009,"Montana","Carbon County",3,73,158,84,74
050,30,009,"Montana","Carbon County",3,74,176,95,81
050,30,009,"Montana","Carbon County",3,75,121,68,53
050,30,009,"Montana","Carbon County",3,76,111,55,56
050,30,009,"Montana","Carbon County",3,77,94,50,44
050,30,009,"Montana","Carbon County",3,78,88,49,39
050,30,009,"Montana","Carbon County",3,79,85,46,39
050,30,009,"Montana","Carbon County",3,80,69,35,34
050,30,009,"Montana","Carbon County",3,81,65,35,30
050,30,009,"Montana","Carbon County",3,82,65,34,31
050,30,009,"Montana","Carbon County",3,83,65,34,31
050,30,009,"Montana","Carbon County",3,84,52,24,28
050,30,009,"Montana","Carbon County",3,85,252,116,136
050,30,009,"Montana","Carbon County",4,0,77,46,31
050,30,009,"Montana","Carbon County",4,1,97,62,35
050,30,009,"Montana","Carbon County",4,2,92,53,39
050,30,009,"Montana","Carbon County",4,3,104,52,52
050,30,009,"Montana","Carbon County",4,4,100,52,48
050,30,009,"Montana","Carbon County",4,5,95,46,49
050,30,009,"Montana","Carbon County",4,6,86,42,44
050,30,009,"Montana","Carbon County",4,7,99,44,55
050,30,009,"Montana","Carbon County",4,8,100,48,52
050,30,009,"Montana","Carbon County",4,9,106,58,48
050,30,009,"Montana","Carbon County",4,10,125,64,61
050,30,009,"Montana","Carbon County",4,11,132,78,54
050,30,009,"Montana","Carbon County",4,12,130,65,65
050,30,009,"Montana","Carbon County",4,13,120,53,67
050,30,009,"Montana","Carbon County",4,14,134,73,61
050,30,009,"Montana","Carbon County",4,15,134,76,58
050,30,009,"Montana","Carbon County",4,16,120,64,56
050,30,009,"Montana","Carbon County",4,17,117,58,59
050,30,009,"Montana","Carbon County",4,18,114,58,56
050,30,009,"Montana","Carbon County",4,19,77,40,37
050,30,009,"Montana","Carbon County",4,20,86,46,40
050,30,009,"Montana","Carbon County",4,21,86,50,36
050,30,009,"Montana","Carbon County",4,22,96,57,39
050,30,009,"Montana","Carbon County",4,23,80,45,35
050,30,009,"Montana","Carbon County",4,24,82,38,44
050,30,009,"Montana","Carbon County",4,25,91,45,46
050,30,009,"Montana","Carbon County",4,26,93,44,49
050,30,009,"Montana","Carbon County",4,27,103,55,48
050,30,009,"Montana","Carbon County",4,28,122,50,72
050,30,009,"Montana","Carbon County",4,29,107,42,65
050,30,009,"Montana","Carbon County",4,30,97,56,41
050,30,009,"Montana","Carbon County",4,31,96,54,42
050,30,009,"Montana","Carbon County",4,32,102,52,50
050,30,009,"Montana","Carbon County",4,33,103,47,56
050,30,009,"Montana","Carbon County",4,34,110,55,55
050,30,009,"Montana","Carbon County",4,35,123,55,68
050,30,009,"Montana","Carbon County",4,36,118,61,57
050,30,009,"Montana","Carbon County",4,37,112,55,57
050,30,009,"Montana","Carbon County",4,38,133,66,67
050,30,009,"Montana","Carbon County",4,39,144,72,72
050,30,009,"Montana","Carbon County",4,40,137,71,66
050,30,009,"Montana","Carbon County",4,41,133,66,67
050,30,009,"Montana","Carbon County",4,42,145,74,71
050,30,009,"Montana","Carbon County",4,43,154,71,83
050,30,009,"Montana","Carbon County",4,44,162,84,78
050,30,009,"Montana","Carbon County",4,45,151,82,69
050,30,009,"Montana","Carbon County",4,46,120,57,63
050,30,009,"Montana","Carbon County",4,47,126,66,60
050,30,009,"Montana","Carbon County",4,48,133,77,56
050,30,009,"Montana","Carbon County",4,49,128,73,55
050,30,009,"Montana","Carbon County",4,50,131,58,73
050,30,009,"Montana","Carbon County",4,51,146,80,66
050,30,009,"Montana","Carbon County",4,52,156,93,63
050,30,009,"Montana","Carbon County",4,53,139,76,63
050,30,009,"Montana","Carbon County",4,54,146,75,71
050,30,009,"Montana","Carbon County",4,55,138,76,62
050,30,009,"Montana","Carbon County",4,56,133,70,63
050,30,009,"Montana","Carbon County",4,57,152,85,67
050,30,009,"Montana","Carbon County",4,58,178,95,83
050,30,009,"Montana","Carbon County",4,59,189,102,87
050,30,009,"Montana","Carbon County",4,60,190,89,101
050,30,009,"Montana","Carbon County",4,61,164,76,88
050,30,009,"Montana","Carbon County",4,62,217,107,110
050,30,009,"Montana","Carbon County",4,63,221,112,109
050,30,009,"Montana","Carbon County",4,64,244,125,119
050,30,009,"Montana","Carbon County",4,65,246,129,117
050,30,009,"Montana","Carbon County",4,66,218,109,109
050,30,009,"Montana","Carbon County",4,67,205,104,101
050,30,009,"Montana","Carbon County",4,68,195,100,95
050,30,009,"Montana","Carbon County",4,69,186,95,91
050,30,009,"Montana","Carbon County",4,70,181,91,90
050,30,009,"Montana","Carbon County",4,71,183,91,92
050,30,009,"Montana","Carbon County",4,72,176,84,92
050,30,009,"Montana","Carbon County",4,73,161,82,79
050,30,009,"Montana","Carbon County",4,74,152,79,73
050,30,009,"Montana","Carbon County",4,75,169,91,78
050,30,009,"Montana","Carbon County",4,76,115,63,52
050,30,009,"Montana","Carbon County",4,77,104,53,51
050,30,009,"Montana","Carbon County",4,78,88,47,41
050,30,009,"Montana","Carbon County",4,79,84,44,40
050,30,009,"Montana","Carbon County",4,80,88,46,42
050,30,009,"Montana","Carbon County",4,81,62,35,27
050,30,009,"Montana","Carbon County",4,82,54,27,27
050,30,009,"Montana","Carbon County",4,83,61,33,28
050,30,009,"Montana","Carbon County",4,84,66,35,31
050,30,009,"Montana","Carbon County",4,85,266,121,145
050,30,009,"Montana","Carbon County",5,0,76,45,31
050,30,009,"Montana","Carbon County",5,1,87,50,37
050,30,009,"Montana","Carbon County",5,2,98,62,36
050,30,009,"Montana","Carbon County",5,3,81,46,35
050,30,009,"Montana","Carbon County",5,4,105,54,51
050,30,009,"Montana","Carbon County",5,5,100,52,48
050,30,009,"Montana","Carbon County",5,6,100,49,51
050,30,009,"Montana","Carbon County",5,7,88,42,46
050,30,009,"Montana","Carbon County",5,8,103,47,56
050,30,009,"Montana","Carbon County",5,9,107,56,51
050,30,009,"Montana","Carbon County",5,10,106,58,48
050,30,009,"Montana","Carbon County",5,11,124,64,60
050,30,009,"Montana","Carbon County",5,12,133,79,54
050,30,009,"Montana","Carbon County",5,13,132,68,64
050,30,009,"Montana","Carbon County",5,14,121,53,68
050,30,009,"Montana","Carbon County",5,15,137,75,62
050,30,009,"Montana","Carbon County",5,16,129,74,55
050,30,009,"Montana","Carbon County",5,17,118,63,55
050,30,009,"Montana","Carbon County",5,18,99,53,46
050,30,009,"Montana","Carbon County",5,19,85,41,44
050,30,009,"Montana","Carbon County",5,20,84,46,38
050,30,009,"Montana","Carbon County",5,21,91,49,42
050,30,009,"Montana","Carbon County",5,22,86,48,38
050,30,009,"Montana","Carbon County",5,23,102,56,46
050,30,009,"Montana","Carbon County",5,24,85,47,38
050,30,009,"Montana","Carbon County",5,25,86,36,50
050,30,009,"Montana","Carbon County",5,26,91,43,48
050,30,009,"Montana","Carbon County",5,27,97,50,47
050,30,009,"Montana","Carbon County",5,28,125,61,64
050,30,009,"Montana","Carbon County",5,29,126,50,76
050,30,009,"Montana","Carbon County",5,30,102,41,61
050,30,009,"Montana","Carbon County",5,31,96,53,43
050,30,009,"Montana","Carbon County",5,32,98,51,47
050,30,009,"Montana","Carbon County",5,33,104,59,45
050,30,009,"Montana","Carbon County",5,34,104,50,54
050,30,009,"Montana","Carbon County",5,35,112,53,59
050,30,009,"Montana","Carbon County",5,36,137,63,74
050,30,009,"Montana","Carbon County",5,37,124,68,56
050,30,009,"Montana","Carbon County",5,38,123,59,64
050,30,009,"Montana","Carbon County",5,39,142,72,70
050,30,009,"Montana","Carbon County",5,40,149,77,72
050,30,009,"Montana","Carbon County",5,41,144,72,72
050,30,009,"Montana","Carbon County",5,42,131,70,61
050,30,009,"Montana","Carbon County",5,43,147,71,76
050,30,009,"Montana","Carbon County",5,44,153,70,83
050,30,009,"Montana","Carbon County",5,45,167,89,78
050,30,009,"Montana","Carbon County",5,46,156,79,77
050,30,009,"Montana","Carbon County",5,47,122,59,63
050,30,009,"Montana","Carbon County",5,48,127,67,60
050,30,009,"Montana","Carbon County",5,49,131,76,55
050,30,009,"Montana","Carbon County",5,50,135,73,62
050,30,009,"Montana","Carbon County",5,51,134,62,72
050,30,009,"Montana","Carbon County",5,52,149,80,69
050,30,009,"Montana","Carbon County",5,53,163,92,71
050,30,009,"Montana","Carbon County",5,54,126,69,57
050,30,009,"Montana","Carbon County",5,55,146,78,68
050,30,009,"Montana","Carbon County",5,56,142,78,64
050,30,009,"Montana","Carbon County",5,57,139,78,61
050,30,009,"Montana","Carbon County",5,58,154,87,67
050,30,009,"Montana","Carbon County",5,59,181,95,86
050,30,009,"Montana","Carbon County",5,60,186,94,92
050,30,009,"Montana","Carbon County",5,61,183,82,101
050,30,009,"Montana","Carbon County",5,62,177,86,91
050,30,009,"Montana","Carbon County",5,63,231,112,119
050,30,009,"Montana","Carbon County",5,64,230,118,112
050,30,009,"Montana","Carbon County",5,65,255,128,127
050,30,009,"Montana","Carbon County",5,66,259,137,122
050,30,009,"Montana","Carbon County",5,67,225,112,113
050,30,009,"Montana","Carbon County",5,68,205,102,103
050,30,009,"Montana","Carbon County",5,69,206,102,104
050,30,009,"Montana","Carbon County",5,70,190,96,94
050,30,009,"Montana","Carbon County",5,71,184,94,90
050,30,009,"Montana","Carbon County",5,72,184,94,90
050,30,009,"Montana","Carbon County",5,73,169,82,87
050,30,009,"Montana","Carbon County",5,74,155,81,74
050,30,009,"Montana","Carbon County",5,75,146,75,71
050,30,009,"Montana","Carbon County",5,76,170,92,78
050,30,009,"Montana","Carbon County",5,77,112,62,50
050,30,009,"Montana","Carbon County",5,78,101,50,51
050,30,009,"Montana","Carbon County",5,79,87,46,41
050,30,009,"Montana","Carbon County",5,80,87,42,45
050,30,009,"Montana","Carbon County",5,81,81,45,36
050,30,009,"Montana","Carbon County",5,82,49,24,25
050,30,009,"Montana","Carbon County",5,83,57,30,27
050,30,009,"Montana","Carbon County",5,84,63,34,29
050,30,009,"Montana","Carbon County",5,85,287,130,157
050,30,011,"Montana","Carter County",1,0,22,11,11
050,30,011,"Montana","Carter County",1,1,21,9,12
050,30,011,"Montana","Carter County",1,2,20,10,10
050,30,011,"Montana","Carter County",1,3,25,17,8
050,30,011,"Montana","Carter County",1,4,19,11,8
050,30,011,"Montana","Carter County",1,5,18,9,9
050,30,011,"Montana","Carter County",1,6,22,12,10
050,30,011,"Montana","Carter County",1,7,15,8,7
050,30,011,"Montana","Carter County",1,8,19,12,7
050,30,011,"Montana","Carter County",1,9,17,8,9
050,30,011,"Montana","Carter County",1,10,16,7,9
050,30,011,"Montana","Carter County",1,11,14,7,7
050,30,011,"Montana","Carter County",1,12,12,6,6
050,30,011,"Montana","Carter County",1,13,10,4,6
050,30,011,"Montana","Carter County",1,14,13,8,5
050,30,011,"Montana","Carter County",1,15,14,10,4
050,30,011,"Montana","Carter County",1,16,16,10,6
050,30,011,"Montana","Carter County",1,17,13,9,4
050,30,011,"Montana","Carter County",1,18,7,3,4
050,30,011,"Montana","Carter County",1,19,11,5,6
050,30,011,"Montana","Carter County",1,20,7,1,6
050,30,011,"Montana","Carter County",1,21,8,3,5
050,30,011,"Montana","Carter County",1,22,10,6,4
050,30,011,"Montana","Carter County",1,23,14,7,7
050,30,011,"Montana","Carter County",1,24,14,7,7
050,30,011,"Montana","Carter County",1,25,13,7,6
050,30,011,"Montana","Carter County",1,26,12,7,5
050,30,011,"Montana","Carter County",1,27,12,6,6
050,30,011,"Montana","Carter County",1,28,15,8,7
050,30,011,"Montana","Carter County",1,29,16,8,8
050,30,011,"Montana","Carter County",1,30,13,6,7
050,30,011,"Montana","Carter County",1,31,20,12,8
050,30,011,"Montana","Carter County",1,32,11,4,7
050,30,011,"Montana","Carter County",1,33,22,9,13
050,30,011,"Montana","Carter County",1,34,20,13,7
050,30,011,"Montana","Carter County",1,35,16,7,9
050,30,011,"Montana","Carter County",1,36,18,8,10
050,30,011,"Montana","Carter County",1,37,13,8,5
050,30,011,"Montana","Carter County",1,38,20,11,9
050,30,011,"Montana","Carter County",1,39,19,12,7
050,30,011,"Montana","Carter County",1,40,15,8,7
050,30,011,"Montana","Carter County",1,41,11,6,5
050,30,011,"Montana","Carter County",1,42,18,10,8
050,30,011,"Montana","Carter County",1,43,12,5,7
050,30,011,"Montana","Carter County",1,44,4,3,1
050,30,011,"Montana","Carter County",1,45,9,5,4
050,30,011,"Montana","Carter County",1,46,10,2,8
050,30,011,"Montana","Carter County",1,47,11,6,5
050,30,011,"Montana","Carter County",1,48,7,2,5
050,30,011,"Montana","Carter County",1,49,12,6,6
050,30,011,"Montana","Carter County",1,50,12,9,3
050,30,011,"Montana","Carter County",1,51,11,5,6
050,30,011,"Montana","Carter County",1,52,13,2,11
050,30,011,"Montana","Carter County",1,53,13,4,9
050,30,011,"Montana","Carter County",1,54,14,6,8
050,30,011,"Montana","Carter County",1,55,23,9,14
050,30,011,"Montana","Carter County",1,56,21,8,13
050,30,011,"Montana","Carter County",1,57,26,12,14
050,30,011,"Montana","Carter County",1,58,25,15,10
050,30,011,"Montana","Carter County",1,59,26,16,10
050,30,011,"Montana","Carter County",1,60,21,9,12
050,30,011,"Montana","Carter County",1,61,30,16,14
050,30,011,"Montana","Carter County",1,62,27,17,10
050,30,011,"Montana","Carter County",1,63,23,13,10
050,30,011,"Montana","Carter County",1,64,28,16,12
050,30,011,"Montana","Carter County",1,65,33,17,16
050,30,011,"Montana","Carter County",1,66,30,14,16
050,30,011,"Montana","Carter County",1,67,28,14,14
050,30,011,"Montana","Carter County",1,68,33,23,10
050,30,011,"Montana","Carter County",1,69,21,13,8
050,30,011,"Montana","Carter County",1,70,18,5,13
050,30,011,"Montana","Carter County",1,71,13,7,6
050,30,011,"Montana","Carter County",1,72,10,6,4
050,30,011,"Montana","Carter County",1,73,11,6,5
050,30,011,"Montana","Carter County",1,74,13,5,8
050,30,011,"Montana","Carter County",1,75,15,8,7
050,30,011,"Montana","Carter County",1,76,10,6,4
050,30,011,"Montana","Carter County",1,77,17,9,8
050,30,011,"Montana","Carter County",1,78,15,8,7
050,30,011,"Montana","Carter County",1,79,8,4,4
050,30,011,"Montana","Carter County",1,80,10,4,6
050,30,011,"Montana","Carter County",1,81,12,8,4
050,30,011,"Montana","Carter County",1,82,8,3,5
050,30,011,"Montana","Carter County",1,83,12,3,9
050,30,011,"Montana","Carter County",1,84,5,4,1
050,30,011,"Montana","Carter County",1,85,50,19,31
050,30,011,"Montana","Carter County",2,0,19,10,9
050,30,011,"Montana","Carter County",2,1,20,9,11
050,30,011,"Montana","Carter County",2,2,20,10,10
050,30,011,"Montana","Carter County",2,3,23,15,8
050,30,011,"Montana","Carter County",2,4,20,12,8
050,30,011,"Montana","Carter County",2,5,18,9,9
050,30,011,"Montana","Carter County",2,6,21,11,10
050,30,011,"Montana","Carter County",2,7,17,9,8
050,30,011,"Montana","Carter County",2,8,17,10,7
050,30,011,"Montana","Carter County",2,9,18,10,8
050,30,011,"Montana","Carter County",2,10,16,7,9
050,30,011,"Montana","Carter County",2,11,14,7,7
050,30,011,"Montana","Carter County",2,12,12,6,6
050,30,011,"Montana","Carter County",2,13,10,4,6
050,30,011,"Montana","Carter County",2,14,12,7,5
050,30,011,"Montana","Carter County",2,15,15,10,5
050,30,011,"Montana","Carter County",2,16,15,10,5
050,30,011,"Montana","Carter County",2,17,13,9,4
050,30,011,"Montana","Carter County",2,18,8,4,4
050,30,011,"Montana","Carter County",2,19,9,4,5
050,30,011,"Montana","Carter County",2,20,8,2,6
050,30,011,"Montana","Carter County",2,21,9,3,6
050,30,011,"Montana","Carter County",2,22,10,5,5
050,30,011,"Montana","Carter County",2,23,13,7,6
050,30,011,"Montana","Carter County",2,24,14,7,7
050,30,011,"Montana","Carter County",2,25,14,8,6
050,30,011,"Montana","Carter County",2,26,12,7,5
050,30,011,"Montana","Carter County",2,27,12,6,6
050,30,011,"Montana","Carter County",2,28,13,7,6
050,30,011,"Montana","Carter County",2,29,16,8,8
050,30,011,"Montana","Carter County",2,30,15,7,8
050,30,011,"Montana","Carter County",2,31,19,11,8
050,30,011,"Montana","Carter County",2,32,14,7,7
050,30,011,"Montana","Carter County",2,33,19,8,11
050,30,011,"Montana","Carter County",2,34,20,12,8
050,30,011,"Montana","Carter County",2,35,18,9,9
050,30,011,"Montana","Carter County",2,36,18,8,10
050,30,011,"Montana","Carter County",2,37,14,8,6
050,30,011,"Montana","Carter County",2,38,18,10,8
050,30,011,"Montana","Carter County",2,39,19,12,7
050,30,011,"Montana","Carter County",2,40,16,9,7
050,30,011,"Montana","Carter County",2,41,12,6,6
050,30,011,"Montana","Carter County",2,42,16,9,7
050,30,011,"Montana","Carter County",2,43,13,6,7
050,30,011,"Montana","Carter County",2,44,5,3,2
050,30,011,"Montana","Carter County",2,45,7,4,3
050,30,011,"Montana","Carter County",2,46,9,2,7
050,30,011,"Montana","Carter County",2,47,11,5,6
050,30,011,"Montana","Carter County",2,48,8,3,5
050,30,011,"Montana","Carter County",2,49,11,5,6
050,30,011,"Montana","Carter County",2,50,12,8,4
050,30,011,"Montana","Carter County",2,51,11,6,5
050,30,011,"Montana","Carter County",2,52,12,3,9
050,30,011,"Montana","Carter County",2,53,13,4,9
050,30,011,"Montana","Carter County",2,54,14,6,8
050,30,011,"Montana","Carter County",2,55,21,8,13
050,30,011,"Montana","Carter County",2,56,21,8,13
050,30,011,"Montana","Carter County",2,57,25,11,14
050,30,011,"Montana","Carter County",2,58,25,14,11
050,30,011,"Montana","Carter County",2,59,26,16,10
050,30,011,"Montana","Carter County",2,60,22,10,12
050,30,011,"Montana","Carter County",2,61,28,14,14
050,30,011,"Montana","Carter County",2,62,28,17,11
050,30,011,"Montana","Carter County",2,63,25,15,10
050,30,011,"Montana","Carter County",2,64,27,15,12
050,30,011,"Montana","Carter County",2,65,32,17,15
050,30,011,"Montana","Carter County",2,66,31,15,16
050,30,011,"Montana","Carter County",2,67,29,14,15
050,30,011,"Montana","Carter County",2,68,32,21,11
050,30,011,"Montana","Carter County",2,69,23,15,8
050,30,011,"Montana","Carter County",2,70,19,7,12
050,30,011,"Montana","Carter County",2,71,13,6,7
050,30,011,"Montana","Carter County",2,72,10,6,4
050,30,011,"Montana","Carter County",2,73,11,6,5
050,30,011,"Montana","Carter County",2,74,12,5,7
050,30,011,"Montana","Carter County",2,75,15,7,8
050,30,011,"Montana","Carter County",2,76,11,7,4
050,30,011,"Montana","Carter County",2,77,15,8,7
050,30,011,"Montana","Carter County",2,78,15,8,7
050,30,011,"Montana","Carter County",2,79,10,5,5
050,30,011,"Montana","Carter County",2,80,10,4,6
050,30,011,"Montana","Carter County",2,81,10,6,4
050,30,011,"Montana","Carter County",2,82,10,5,5
050,30,011,"Montana","Carter County",2,83,10,3,7
050,30,011,"Montana","Carter County",2,84,6,4,2
050,30,011,"Montana","Carter County",2,85,50,19,31
050,30,011,"Montana","Carter County",3,0,9,3,6
050,30,011,"Montana","Carter County",3,1,21,12,9
050,30,011,"Montana","Carter County",3,2,22,9,13
050,30,011,"Montana","Carter County",3,3,23,11,12
050,30,011,"Montana","Carter County",3,4,19,13,6
050,30,011,"Montana","Carter County",3,5,19,12,7
050,30,011,"Montana","Carter County",3,6,18,9,9
050,30,011,"Montana","Carter County",3,7,19,11,8
050,30,011,"Montana","Carter County",3,8,16,5,11
050,30,011,"Montana","Carter County",3,9,18,10,8
050,30,011,"Montana","Carter County",3,10,19,9,10
050,30,011,"Montana","Carter County",3,11,15,8,7
050,30,011,"Montana","Carter County",3,12,12,5,7
050,30,011,"Montana","Carter County",3,13,16,8,8
050,30,011,"Montana","Carter County",3,14,11,4,7
050,30,011,"Montana","Carter County",3,15,10,5,5
050,30,011,"Montana","Carter County",3,16,17,12,5
050,30,011,"Montana","Carter County",3,17,15,10,5
050,30,011,"Montana","Carter County",3,18,13,9,4
050,30,011,"Montana","Carter County",3,19,7,3,4
050,30,011,"Montana","Carter County",3,20,8,5,3
050,30,011,"Montana","Carter County",3,21,9,3,6
050,30,011,"Montana","Carter County",3,22,11,3,8
050,30,011,"Montana","Carter County",3,23,10,4,6
050,30,011,"Montana","Carter County",3,24,10,6,4
050,30,011,"Montana","Carter County",3,25,14,7,7
050,30,011,"Montana","Carter County",3,26,14,8,6
050,30,011,"Montana","Carter County",3,27,10,5,5
050,30,011,"Montana","Carter County",3,28,18,10,8
050,30,011,"Montana","Carter County",3,29,14,7,7
050,30,011,"Montana","Carter County",3,30,23,12,11
050,30,011,"Montana","Carter County",3,31,15,7,8
050,30,011,"Montana","Carter County",3,32,19,11,8
050,30,011,"Montana","Carter County",3,33,16,8,8
050,30,011,"Montana","Carter County",3,34,13,5,8
050,30,011,"Montana","Carter County",3,35,19,10,9
050,30,011,"Montana","Carter County",3,36,18,9,9
050,30,011,"Montana","Carter County",3,37,18,10,8
050,30,011,"Montana","Carter County",3,38,13,9,4
050,30,011,"Montana","Carter County",3,39,18,10,8
050,30,011,"Montana","Carter County",3,40,22,12,10
050,30,011,"Montana","Carter County",3,41,15,7,8
050,30,011,"Montana","Carter County",3,42,11,6,5
050,30,011,"Montana","Carter County",3,43,15,8,7
050,30,011,"Montana","Carter County",3,44,12,6,6
050,30,011,"Montana","Carter County",3,45,5,3,2
050,30,011,"Montana","Carter County",3,46,7,4,3
050,30,011,"Montana","Carter County",3,47,9,2,7
050,30,011,"Montana","Carter County",3,48,10,5,5
050,30,011,"Montana","Carter County",3,49,11,5,6
050,30,011,"Montana","Carter County",3,50,11,5,6
050,30,011,"Montana","Carter County",3,51,14,10,4
050,30,011,"Montana","Carter County",3,52,12,6,6
050,30,011,"Montana","Carter County",3,53,12,3,9
050,30,011,"Montana","Carter County",3,54,13,4,9
050,30,011,"Montana","Carter County",3,55,16,8,8
050,30,011,"Montana","Carter County",3,56,19,7,12
050,30,011,"Montana","Carter County",3,57,21,8,13
050,30,011,"Montana","Carter County",3,58,25,11,14
050,30,011,"Montana","Carter County",3,59,25,14,11
050,30,011,"Montana","Carter County",3,60,28,18,10
050,30,011,"Montana","Carter County",3,61,21,10,11
050,30,011,"Montana","Carter County",3,62,26,14,12
050,30,011,"Montana","Carter County",3,63,26,15,11
050,30,011,"Montana","Carter County",3,64,25,15,10
050,30,011,"Montana","Carter County",3,65,25,13,12
050,30,011,"Montana","Carter County",3,66,32,17,15
050,30,011,"Montana","Carter County",3,67,31,15,16
050,30,011,"Montana","Carter County",3,68,29,14,15
050,30,011,"Montana","Carter County",3,69,30,20,10
050,30,011,"Montana","Carter County",3,70,22,14,8
050,30,011,"Montana","Carter County",3,71,21,8,13
050,30,011,"Montana","Carter County",3,72,12,6,6
050,30,011,"Montana","Carter County",3,73,9,5,4
050,30,011,"Montana","Carter County",3,74,11,6,5
050,30,011,"Montana","Carter County",3,75,14,6,8
050,30,011,"Montana","Carter County",3,76,15,7,8
050,30,011,"Montana","Carter County",3,77,13,7,6
050,30,011,"Montana","Carter County",3,78,15,8,7
050,30,011,"Montana","Carter County",3,79,15,8,7
050,30,011,"Montana","Carter County",3,80,9,4,5
050,30,011,"Montana","Carter County",3,81,11,5,6
050,30,011,"Montana","Carter County",3,82,9,5,4
050,30,011,"Montana","Carter County",3,83,10,5,5
050,30,011,"Montana","Carter County",3,84,9,2,7
050,30,011,"Montana","Carter County",3,85,51,19,32
050,30,011,"Montana","Carter County",4,0,16,9,7
050,30,011,"Montana","Carter County",4,1,9,3,6
050,30,011,"Montana","Carter County",4,2,21,12,9
050,30,011,"Montana","Carter County",4,3,21,9,12
050,30,011,"Montana","Carter County",4,4,23,11,12
050,30,011,"Montana","Carter County",4,5,21,15,6
050,30,011,"Montana","Carter County",4,6,18,12,6
050,30,011,"Montana","Carter County",4,7,16,7,9
050,30,011,"Montana","Carter County",4,8,17,11,6
050,30,011,"Montana","Carter County",4,9,15,5,10
050,30,011,"Montana","Carter County",4,10,16,9,7
050,30,011,"Montana","Carter County",4,11,16,9,7
050,30,011,"Montana","Carter County",4,12,15,8,7
050,30,011,"Montana","Carter County",4,13,12,5,7
050,30,011,"Montana","Carter County",4,14,16,8,8
050,30,011,"Montana","Carter County",4,15,12,4,8
050,30,011,"Montana","Carter County",4,16,13,8,5
050,30,011,"Montana","Carter County",4,17,17,12,5
050,30,011,"Montana","Carter County",4,18,11,8,3
050,30,011,"Montana","Carter County",4,19,10,7,3
050,30,011,"Montana","Carter County",4,20,9,4,5
050,30,011,"Montana","Carter County",4,21,7,5,2
050,30,011,"Montana","Carter County",4,22,8,2,6
050,30,011,"Montana","Carter County",4,23,12,5,7
050,30,011,"Montana","Carter County",4,24,8,3,5
050,30,011,"Montana","Carter County",4,25,11,6,5
050,30,011,"Montana","Carter County",4,26,11,6,5
050,30,011,"Montana","Carter County",4,27,14,8,6
050,30,011,"Montana","Carter County",4,28,10,6,4
050,30,011,"Montana","Carter County",4,29,18,8,10
050,30,011,"Montana","Carter County",4,30,14,7,7
050,30,011,"Montana","Carter County",4,31,24,12,12
050,30,011,"Montana","Carter County",4,32,13,5,8
050,30,011,"Montana","Carter County",4,33,19,12,7
050,30,011,"Montana","Carter County",4,34,16,8,8
050,30,011,"Montana","Carter County",4,35,14,5,9
050,30,011,"Montana","Carter County",4,36,23,13,10
050,30,011,"Montana","Carter County",4,37,18,9,9
050,30,011,"Montana","Carter County",4,38,15,7,8
050,30,011,"Montana","Carter County",4,39,14,9,5
050,30,011,"Montana","Carter County",4,40,18,10,8
050,30,011,"Montana","Carter County",4,41,22,12,10
050,30,011,"Montana","Carter County",4,42,18,10,8
050,30,011,"Montana","Carter County",4,43,9,6,3
050,30,011,"Montana","Carter County",4,44,12,8,4
050,30,011,"Montana","Carter County",4,45,10,6,4
050,30,011,"Montana","Carter County",4,46,5,3,2
050,30,011,"Montana","Carter County",4,47,7,4,3
050,30,011,"Montana","Carter County",4,48,13,4,9
050,30,011,"Montana","Carter County",4,49,10,5,5
050,30,011,"Montana","Carter County",4,50,11,5,6
050,30,011,"Montana","Carter County",4,51,11,5,6
050,30,011,"Montana","Carter County",4,52,16,10,6
050,30,011,"Montana","Carter County",4,53,14,6,8
050,30,011,"Montana","Carter County",4,54,12,3,9
050,30,011,"Montana","Carter County",4,55,10,2,8
050,30,011,"Montana","Carter County",4,56,15,7,8
050,30,011,"Montana","Carter County",4,57,19,7,12
050,30,011,"Montana","Carter County",4,58,21,8,13
050,30,011,"Montana","Carter County",4,59,23,9,14
050,30,011,"Montana","Carter County",4,60,24,11,13
050,30,011,"Montana","Carter County",4,61,31,18,13
050,30,011,"Montana","Carter County",4,62,21,10,11
050,30,011,"Montana","Carter County",4,63,26,14,12
050,30,011,"Montana","Carter County",4,64,27,16,11
050,30,011,"Montana","Carter County",4,65,25,15,10
050,30,011,"Montana","Carter County",4,66,24,13,11
050,30,011,"Montana","Carter County",4,67,30,17,13
050,30,011,"Montana","Carter County",4,68,30,15,15
050,30,011,"Montana","Carter County",4,69,27,12,15
050,30,011,"Montana","Carter County",4,70,30,20,10
050,30,011,"Montana","Carter County",4,71,23,15,8
050,30,011,"Montana","Carter County",4,72,20,8,12
050,30,011,"Montana","Carter County",4,73,12,7,5
050,30,011,"Montana","Carter County",4,74,9,5,4
050,30,011,"Montana","Carter County",4,75,12,6,6
050,30,011,"Montana","Carter County",4,76,13,6,7
050,30,011,"Montana","Carter County",4,77,16,7,9
050,30,011,"Montana","Carter County",4,78,13,7,6
050,30,011,"Montana","Carter County",4,79,15,8,7
050,30,011,"Montana","Carter County",4,80,14,7,7
050,30,011,"Montana","Carter County",4,81,10,5,5
050,30,011,"Montana","Carter County",4,82,10,5,5
050,30,011,"Montana","Carter County",4,83,8,5,3
050,30,011,"Montana","Carter County",4,84,7,4,3
050,30,011,"Montana","Carter County",4,85,57,21,36
050,30,011,"Montana","Carter County",5,0,14,8,6
050,30,011,"Montana","Carter County",5,1,16,9,7
050,30,011,"Montana","Carter County",5,2,6,3,3
050,30,011,"Montana","Carter County",5,3,21,12,9
050,30,011,"Montana","Carter County",5,4,23,10,13
050,30,011,"Montana","Carter County",5,5,24,14,10
050,30,011,"Montana","Carter County",5,6,21,15,6
050,30,011,"Montana","Carter County",5,7,19,12,7
050,30,011,"Montana","Carter County",5,8,16,7,9
050,30,011,"Montana","Carter County",5,9,16,11,5
050,30,011,"Montana","Carter County",5,10,14,6,8
050,30,011,"Montana","Carter County",5,11,16,9,7
050,30,011,"Montana","Carter County",5,12,15,7,8
050,30,011,"Montana","Carter County",5,13,15,8,7
050,30,011,"Montana","Carter County",5,14,16,7,9
050,30,011,"Montana","Carter County",5,15,17,7,10
050,30,011,"Montana","Carter County",5,16,14,4,10
050,30,011,"Montana","Carter County",5,17,14,8,6
050,30,011,"Montana","Carter County",5,18,14,10,4
050,30,011,"Montana","Carter County",5,19,9,7,2
050,30,011,"Montana","Carter County",5,20,10,8,2
050,30,011,"Montana","Carter County",5,21,12,6,6
050,30,011,"Montana","Carter County",5,22,11,7,4
050,30,011,"Montana","Carter County",5,23,5,2,3
050,30,011,"Montana","Carter County",5,24,10,3,7
050,30,011,"Montana","Carter County",5,25,3,0,3
050,30,011,"Montana","Carter County",5,26,12,5,7
050,30,011,"Montana","Carter County",5,27,9,3,6
050,30,011,"Montana","Carter County",5,28,15,9,6
050,30,011,"Montana","Carter County",5,29,11,6,5
050,30,011,"Montana","Carter County",5,30,17,6,11
050,30,011,"Montana","Carter County",5,31,15,6,9
050,30,011,"Montana","Carter County",5,32,20,10,10
050,30,011,"Montana","Carter County",5,33,12,5,7
050,30,011,"Montana","Carter County",5,34,20,13,7
050,30,011,"Montana","Carter County",5,35,14,8,6
050,30,011,"Montana","Carter County",5,36,14,5,9
050,30,011,"Montana","Carter County",5,37,24,14,10
050,30,011,"Montana","Carter County",5,38,24,12,12
050,30,011,"Montana","Carter County",5,39,20,9,11
050,30,011,"Montana","Carter County",5,40,13,10,3
050,30,011,"Montana","Carter County",5,41,17,9,8
050,30,011,"Montana","Carter County",5,42,20,12,8
050,30,011,"Montana","Carter County",5,43,18,10,8
050,30,011,"Montana","Carter County",5,44,9,6,3
050,30,011,"Montana","Carter County",5,45,14,9,5
050,30,011,"Montana","Carter County",5,46,11,6,5
050,30,011,"Montana","Carter County",5,47,5,3,2
050,30,011,"Montana","Carter County",5,48,6,3,3
050,30,011,"Montana","Carter County",5,49,14,5,9
050,30,011,"Montana","Carter County",5,50,10,5,5
050,30,011,"Montana","Carter County",5,51,11,5,6
050,30,011,"Montana","Carter County",5,52,14,7,7
050,30,011,"Montana","Carter County",5,53,18,12,6
050,30,011,"Montana","Carter County",5,54,12,6,6
050,30,011,"Montana","Carter County",5,55,12,2,10
050,30,011,"Montana","Carter County",5,56,11,3,8
050,30,011,"Montana","Carter County",5,57,15,7,8
050,30,011,"Montana","Carter County",5,58,19,7,12
050,30,011,"Montana","Carter County",5,59,22,8,14
050,30,011,"Montana","Carter County",5,60,26,11,15
050,30,011,"Montana","Carter County",5,61,24,11,13
050,30,011,"Montana","Carter County",5,62,28,15,13
050,30,011,"Montana","Carter County",5,63,24,12,12
050,30,011,"Montana","Carter County",5,64,25,13,12
050,30,011,"Montana","Carter County",5,65,26,16,10
050,30,011,"Montana","Carter County",5,66,23,13,10
050,30,011,"Montana","Carter County",5,67,22,12,10
050,30,011,"Montana","Carter County",5,68,29,17,12
050,30,011,"Montana","Carter County",5,69,29,14,15
050,30,011,"Montana","Carter County",5,70,27,12,15
050,30,011,"Montana","Carter County",5,71,32,21,11
050,30,011,"Montana","Carter County",5,72,25,17,8
050,30,011,"Montana","Carter County",5,73,20,8,12
050,30,011,"Montana","Carter County",5,74,13,7,6
050,30,011,"Montana","Carter County",5,75,9,4,5
050,30,011,"Montana","Carter County",5,76,9,4,5
050,30,011,"Montana","Carter County",5,77,13,6,7
050,30,011,"Montana","Carter County",5,78,16,7,9
050,30,011,"Montana","Carter County",5,79,13,7,6
050,30,011,"Montana","Carter County",5,80,14,7,7
050,30,011,"Montana","Carter County",5,81,15,8,7
050,30,011,"Montana","Carter County",5,82,9,5,4
050,30,011,"Montana","Carter County",5,83,10,5,5
050,30,011,"Montana","Carter County",5,84,7,4,3
050,30,011,"Montana","Carter County",5,85,61,24,37
050,30,013,"Montana","Cascade County",1,0,1070,552,518
050,30,013,"Montana","Cascade County",1,1,1055,558,497
050,30,013,"Montana","Cascade County",1,2,1043,553,490
050,30,013,"Montana","Cascade County",1,3,1104,565,539
050,30,013,"Montana","Cascade County",1,4,1118,566,552
050,30,013,"Montana","Cascade County",1,5,1131,579,552
050,30,013,"Montana","Cascade County",1,6,1044,539,505
050,30,013,"Montana","Cascade County",1,7,1045,571,474
050,30,013,"Montana","Cascade County",1,8,1065,574,491
050,30,013,"Montana","Cascade County",1,9,1077,559,518
050,30,013,"Montana","Cascade County",1,10,1038,533,505
050,30,013,"Montana","Cascade County",1,11,1083,584,499
050,30,013,"Montana","Cascade County",1,12,1130,595,535
050,30,013,"Montana","Cascade County",1,13,1118,598,520
050,30,013,"Montana","Cascade County",1,14,1044,554,490
050,30,013,"Montana","Cascade County",1,15,1035,525,510
050,30,013,"Montana","Cascade County",1,16,1041,555,486
050,30,013,"Montana","Cascade County",1,17,961,517,444
050,30,013,"Montana","Cascade County",1,18,889,459,430
050,30,013,"Montana","Cascade County",1,19,895,512,383
050,30,013,"Montana","Cascade County",1,20,1125,661,464
050,30,013,"Montana","Cascade County",1,21,1194,688,506
050,30,013,"Montana","Cascade County",1,22,1135,633,502
050,30,013,"Montana","Cascade County",1,23,1183,658,525
050,30,013,"Montana","Cascade County",1,24,1183,633,550
050,30,013,"Montana","Cascade County",1,25,1184,623,561
050,30,013,"Montana","Cascade County",1,26,1174,610,564
050,30,013,"Montana","Cascade County",1,27,1262,697,565
050,30,013,"Montana","Cascade County",1,28,1305,691,614
050,30,013,"Montana","Cascade County",1,29,1214,631,583
050,30,013,"Montana","Cascade County",1,30,1207,612,595
050,30,013,"Montana","Cascade County",1,31,1160,608,552
050,30,013,"Montana","Cascade County",1,32,1129,565,564
050,30,013,"Montana","Cascade County",1,33,1101,555,546
050,30,013,"Montana","Cascade County",1,34,1095,601,494
050,30,013,"Montana","Cascade County",1,35,1104,557,547
050,30,013,"Montana","Cascade County",1,36,1103,560,543
050,30,013,"Montana","Cascade County",1,37,1076,585,491
050,30,013,"Montana","Cascade County",1,38,1100,566,534
050,30,013,"Montana","Cascade County",1,39,1086,583,503
050,30,013,"Montana","Cascade County",1,40,980,529,451
050,30,013,"Montana","Cascade County",1,41,920,457,463
050,30,013,"Montana","Cascade County",1,42,919,464,455
050,30,013,"Montana","Cascade County",1,43,875,452,423
050,30,013,"Montana","Cascade County",1,44,845,439,406
050,30,013,"Montana","Cascade County",1,45,789,417,372
050,30,013,"Montana","Cascade County",1,46,787,413,374
050,30,013,"Montana","Cascade County",1,47,817,424,393
050,30,013,"Montana","Cascade County",1,48,866,437,429
050,30,013,"Montana","Cascade County",1,49,922,471,451
050,30,013,"Montana","Cascade County",1,50,884,452,432
050,30,013,"Montana","Cascade County",1,51,854,446,408
050,30,013,"Montana","Cascade County",1,52,870,450,420
050,30,013,"Montana","Cascade County",1,53,921,449,472
050,30,013,"Montana","Cascade County",1,54,933,440,493
050,30,013,"Montana","Cascade County",1,55,1034,515,519
050,30,013,"Montana","Cascade County",1,56,1089,556,533
050,30,013,"Montana","Cascade County",1,57,1093,556,537
050,30,013,"Montana","Cascade County",1,58,1191,587,604
050,30,013,"Montana","Cascade County",1,59,1184,576,608
050,30,013,"Montana","Cascade County",1,60,1184,590,594
050,30,013,"Montana","Cascade County",1,61,1106,560,546
050,30,013,"Montana","Cascade County",1,62,1146,541,605
050,30,013,"Montana","Cascade County",1,63,1136,542,594
050,30,013,"Montana","Cascade County",1,64,1048,499,549
050,30,013,"Montana","Cascade County",1,65,1044,491,553
050,30,013,"Montana","Cascade County",1,66,1056,520,536
050,30,013,"Montana","Cascade County",1,67,1030,495,535
050,30,013,"Montana","Cascade County",1,68,984,482,502
050,30,013,"Montana","Cascade County",1,69,900,422,478
050,30,013,"Montana","Cascade County",1,70,919,415,504
050,30,013,"Montana","Cascade County",1,71,877,423,454
050,30,013,"Montana","Cascade County",1,72,844,422,422
050,30,013,"Montana","Cascade County",1,73,866,413,453
050,30,013,"Montana","Cascade County",1,74,628,308,320
050,30,013,"Montana","Cascade County",1,75,622,311,311
050,30,013,"Montana","Cascade County",1,76,595,283,312
050,30,013,"Montana","Cascade County",1,77,612,285,327
050,30,013,"Montana","Cascade County",1,78,509,226,283
050,30,013,"Montana","Cascade County",1,79,483,217,266
050,30,013,"Montana","Cascade County",1,80,462,190,272
050,30,013,"Montana","Cascade County",1,81,436,187,249
050,30,013,"Montana","Cascade County",1,82,400,191,209
050,30,013,"Montana","Cascade County",1,83,373,165,208
050,30,013,"Montana","Cascade County",1,84,333,146,187
050,30,013,"Montana","Cascade County",1,85,1937,778,1159
050,30,013,"Montana","Cascade County",2,0,1041,510,531
050,30,013,"Montana","Cascade County",2,1,1055,555,500
050,30,013,"Montana","Cascade County",2,2,1043,554,489
050,30,013,"Montana","Cascade County",2,3,1083,561,522
050,30,013,"Montana","Cascade County",2,4,1118,567,551
050,30,013,"Montana","Cascade County",2,5,1128,575,553
050,30,013,"Montana","Cascade County",2,6,1065,552,513
050,30,013,"Montana","Cascade County",2,7,1043,562,481
050,30,013,"Montana","Cascade County",2,8,1063,575,488
050,30,013,"Montana","Cascade County",2,9,1063,556,507
050,30,013,"Montana","Cascade County",2,10,1044,538,506
050,30,013,"Montana","Cascade County",2,11,1069,574,495
050,30,013,"Montana","Cascade County",2,12,1121,596,525
050,30,013,"Montana","Cascade County",2,13,1115,594,521
050,30,013,"Montana","Cascade County",2,14,1058,564,494
050,30,013,"Montana","Cascade County",2,15,1042,533,509
050,30,013,"Montana","Cascade County",2,16,1041,548,493
050,30,013,"Montana","Cascade County",2,17,982,529,453
050,30,013,"Montana","Cascade County",2,18,888,467,421
050,30,013,"Montana","Cascade County",2,19,921,524,397
050,30,013,"Montana","Cascade County",2,20,1117,654,463
050,30,013,"Montana","Cascade County",2,21,1182,682,500
050,30,013,"Montana","Cascade County",2,22,1152,643,509
050,30,013,"Montana","Cascade County",2,23,1168,645,523
050,30,013,"Montana","Cascade County",2,24,1164,627,537
050,30,013,"Montana","Cascade County",2,25,1169,613,556
050,30,013,"Montana","Cascade County",2,26,1170,606,564
050,30,013,"Montana","Cascade County",2,27,1228,668,560
050,30,013,"Montana","Cascade County",2,28,1280,684,596
050,30,013,"Montana","Cascade County",2,29,1238,646,592
050,30,013,"Montana","Cascade County",2,30,1220,621,599
050,30,013,"Montana","Cascade County",2,31,1173,613,560
050,30,013,"Montana","Cascade County",2,32,1127,569,558
050,30,013,"Montana","Cascade County",2,33,1100,560,540
050,30,013,"Montana","Cascade County",2,34,1097,589,508
050,30,013,"Montana","Cascade County",2,35,1116,574,542
050,30,013,"Montana","Cascade County",2,36,1099,558,541
050,30,013,"Montana","Cascade County",2,37,1082,578,504
050,30,013,"Montana","Cascade County",2,38,1099,574,525
050,30,013,"Montana","Cascade County",2,39,1084,574,510
050,30,013,"Montana","Cascade County",2,40,1009,542,467
050,30,013,"Montana","Cascade County",2,41,935,475,460
050,30,013,"Montana","Cascade County",2,42,908,454,454
050,30,013,"Montana","Cascade County",2,43,894,459,435
050,30,013,"Montana","Cascade County",2,44,844,438,406
050,30,013,"Montana","Cascade County",2,45,809,426,383
050,30,013,"Montana","Cascade County",2,46,789,418,371
050,30,013,"Montana","Cascade County",2,47,803,418,385
050,30,013,"Montana","Cascade County",2,48,851,431,420
050,30,013,"Montana","Cascade County",2,49,915,465,450
050,30,013,"Montana","Cascade County",2,50,890,454,436
050,30,013,"Montana","Cascade County",2,51,861,448,413
050,30,013,"Montana","Cascade County",2,52,858,447,411
050,30,013,"Montana","Cascade County",2,53,913,450,463
050,30,013,"Montana","Cascade County",2,54,925,440,485
050,30,013,"Montana","Cascade County",2,55,1009,501,508
050,30,013,"Montana","Cascade County",2,56,1072,544,528
050,30,013,"Montana","Cascade County",2,57,1095,555,540
050,30,013,"Montana","Cascade County",2,58,1158,573,585
050,30,013,"Montana","Cascade County",2,59,1191,582,609
050,30,013,"Montana","Cascade County",2,60,1176,582,594
050,30,013,"Montana","Cascade County",2,61,1123,565,558
050,30,013,"Montana","Cascade County",2,62,1130,540,590
050,30,013,"Montana","Cascade County",2,63,1140,545,595
050,30,013,"Montana","Cascade County",2,64,1058,503,555
050,30,013,"Montana","Cascade County",2,65,1045,491,554
050,30,013,"Montana","Cascade County",2,66,1052,514,538
050,30,013,"Montana","Cascade County",2,67,1028,495,533
050,30,013,"Montana","Cascade County",2,68,982,479,503
050,30,013,"Montana","Cascade County",2,69,920,436,484
050,30,013,"Montana","Cascade County",2,70,910,414,496
050,30,013,"Montana","Cascade County",2,71,889,423,466
050,30,013,"Montana","Cascade County",2,72,836,412,424
050,30,013,"Montana","Cascade County",2,73,899,434,465
050,30,013,"Montana","Cascade County",2,74,643,311,332
050,30,013,"Montana","Cascade County",2,75,620,307,313
050,30,013,"Montana","Cascade County",2,76,594,286,308
050,30,013,"Montana","Cascade County",2,77,616,286,330
050,30,013,"Montana","Cascade County",2,78,521,232,289
050,30,013,"Montana","Cascade County",2,79,485,216,269
050,30,013,"Montana","Cascade County",2,80,464,194,270
050,30,013,"Montana","Cascade County",2,81,427,183,244
050,30,013,"Montana","Cascade County",2,82,407,190,217
050,30,013,"Montana","Cascade County",2,83,376,170,206
050,30,013,"Montana","Cascade County",2,84,337,146,191
050,30,013,"Montana","Cascade County",2,85,1952,786,1166
050,30,013,"Montana","Cascade County",3,0,949,482,467
050,30,013,"Montana","Cascade County",3,1,1005,480,525
050,30,013,"Montana","Cascade County",3,2,1036,543,493
050,30,013,"Montana","Cascade County",3,3,1008,515,493
050,30,013,"Montana","Cascade County",3,4,1068,547,521
050,30,013,"Montana","Cascade County",3,5,1123,567,556
050,30,013,"Montana","Cascade County",3,6,1092,560,532
050,30,013,"Montana","Cascade County",3,7,1082,578,504
050,30,013,"Montana","Cascade County",3,8,1075,587,488
050,30,013,"Montana","Cascade County",3,9,1048,565,483
050,30,013,"Montana","Cascade County",3,10,1079,573,506
050,30,013,"Montana","Cascade County",3,11,1048,533,515
050,30,013,"Montana","Cascade County",3,12,1061,573,488
050,30,013,"Montana","Cascade County",3,13,1118,597,521
050,30,013,"Montana","Cascade County",3,14,1104,578,526
050,30,013,"Montana","Cascade County",3,15,1075,569,506
050,30,013,"Montana","Cascade County",3,16,1039,536,503
050,30,013,"Montana","Cascade County",3,17,1040,544,496
050,30,013,"Montana","Cascade County",3,18,914,495,419
050,30,013,"Montana","Cascade County",3,19,926,526,400
050,30,013,"Montana","Cascade County",3,20,1140,684,456
050,30,013,"Montana","Cascade County",3,21,1195,686,509
050,30,013,"Montana","Cascade County",3,22,1189,684,505
050,30,013,"Montana","Cascade County",3,23,1193,651,542
050,30,013,"Montana","Cascade County",3,24,1134,620,514
050,30,013,"Montana","Cascade County",3,25,1140,623,517
050,30,013,"Montana","Cascade County",3,26,1189,600,589
050,30,013,"Montana","Cascade County",3,27,1158,600,558
050,30,013,"Montana","Cascade County",3,28,1214,672,542
050,30,013,"Montana","Cascade County",3,29,1292,691,601
050,30,013,"Montana","Cascade County",3,30,1246,647,599
050,30,013,"Montana","Cascade County",3,31,1212,619,593
050,30,013,"Montana","Cascade County",3,32,1156,601,555
050,30,013,"Montana","Cascade County",3,33,1145,596,549
050,30,013,"Montana","Cascade County",3,34,1099,557,542
050,30,013,"Montana","Cascade County",3,35,1110,595,515
050,30,013,"Montana","Cascade County",3,36,1104,562,542
050,30,013,"Montana","Cascade County",3,37,1088,561,527
050,30,013,"Montana","Cascade County",3,38,1066,561,505
050,30,013,"Montana","Cascade County",3,39,1088,567,521
050,30,013,"Montana","Cascade County",3,40,1070,564,506
050,30,013,"Montana","Cascade County",3,41,1010,541,469
050,30,013,"Montana","Cascade County",3,42,949,477,472
050,30,013,"Montana","Cascade County",3,43,905,451,454
050,30,013,"Montana","Cascade County",3,44,876,453,423
050,30,013,"Montana","Cascade County",3,45,850,436,414
050,30,013,"Montana","Cascade County",3,46,833,443,390
050,30,013,"Montana","Cascade County",3,47,760,395,365
050,30,013,"Montana","Cascade County",3,48,783,405,378
050,30,013,"Montana","Cascade County",3,49,854,427,427
050,30,013,"Montana","Cascade County",3,50,906,457,449
050,30,013,"Montana","Cascade County",3,51,895,457,438
050,30,013,"Montana","Cascade County",3,52,857,447,410
050,30,013,"Montana","Cascade County",3,53,876,455,421
050,30,013,"Montana","Cascade County",3,54,885,434,451
050,30,013,"Montana","Cascade County",3,55,923,445,478
050,30,013,"Montana","Cascade County",3,56,994,487,507
050,30,013,"Montana","Cascade County",3,57,1073,548,525
050,30,013,"Montana","Cascade County",3,58,1050,531,519
050,30,013,"Montana","Cascade County",3,59,1153,577,576
050,30,013,"Montana","Cascade County",3,60,1178,576,602
050,30,013,"Montana","Cascade County",3,61,1163,572,591
050,30,013,"Montana","Cascade County",3,62,1106,539,567
050,30,013,"Montana","Cascade County",3,63,1112,541,571
050,30,013,"Montana","Cascade County",3,64,1118,534,584
050,30,013,"Montana","Cascade County",3,65,1044,492,552
050,30,013,"Montana","Cascade County",3,66,1044,492,552
050,30,013,"Montana","Cascade County",3,67,1057,506,551
050,30,013,"Montana","Cascade County",3,68,1011,480,531
050,30,013,"Montana","Cascade County",3,69,984,474,510
050,30,013,"Montana","Cascade County",3,70,904,427,477
050,30,013,"Montana","Cascade County",3,71,888,401,487
050,30,013,"Montana","Cascade County",3,72,866,407,459
050,30,013,"Montana","Cascade County",3,73,820,405,415
050,30,013,"Montana","Cascade County",3,74,866,419,447
050,30,013,"Montana","Cascade County",3,75,608,292,316
050,30,013,"Montana","Cascade County",3,76,607,306,301
050,30,013,"Montana","Cascade County",3,77,573,282,291
050,30,013,"Montana","Cascade County",3,78,584,264,320
050,30,013,"Montana","Cascade County",3,79,504,217,287
050,30,013,"Montana","Cascade County",3,80,456,203,253
050,30,013,"Montana","Cascade County",3,81,420,177,243
050,30,013,"Montana","Cascade County",3,82,405,173,232
050,30,013,"Montana","Cascade County",3,83,372,171,201
050,30,013,"Montana","Cascade County",3,84,353,155,198
050,30,013,"Montana","Cascade County",3,85,1958,773,1185
050,30,013,"Montana","Cascade County",4,0,965,504,461
050,30,013,"Montana","Cascade County",4,1,908,439,469
050,30,013,"Montana","Cascade County",4,2,995,478,517
050,30,013,"Montana","Cascade County",4,3,1030,551,479
050,30,013,"Montana","Cascade County",4,4,1029,535,494
050,30,013,"Montana","Cascade County",4,5,1067,553,514
050,30,013,"Montana","Cascade County",4,6,1129,582,547
050,30,013,"Montana","Cascade County",4,7,1102,563,539
050,30,013,"Montana","Cascade County",4,8,1115,599,516
050,30,013,"Montana","Cascade County",4,9,1064,586,478
050,30,013,"Montana","Cascade County",4,10,1064,569,495
050,30,013,"Montana","Cascade County",4,11,1077,572,505
050,30,013,"Montana","Cascade County",4,12,1046,534,512
050,30,013,"Montana","Cascade County",4,13,1054,569,485
050,30,013,"Montana","Cascade County",4,14,1095,573,522
050,30,013,"Montana","Cascade County",4,15,1110,575,535
050,30,013,"Montana","Cascade County",4,16,1078,574,504
050,30,013,"Montana","Cascade County",4,17,1038,535,503
050,30,013,"Montana","Cascade County",4,18,929,495,434
050,30,013,"Montana","Cascade County",4,19,917,533,384
050,30,013,"Montana","Cascade County",4,20,1061,629,432
050,30,013,"Montana","Cascade County",4,21,1185,690,495
050,30,013,"Montana","Cascade County",4,22,1166,654,512
050,30,013,"Montana","Cascade County",4,23,1180,660,520
050,30,013,"Montana","Cascade County",4,24,1219,638,581
050,30,013,"Montana","Cascade County",4,25,1102,575,527
050,30,013,"Montana","Cascade County",4,26,1144,627,517
050,30,013,"Montana","Cascade County",4,27,1211,607,604
050,30,013,"Montana","Cascade County",4,28,1147,601,546
050,30,013,"Montana","Cascade County",4,29,1223,677,546
050,30,013,"Montana","Cascade County",4,30,1277,689,588
050,30,013,"Montana","Cascade County",4,31,1269,652,617
050,30,013,"Montana","Cascade County",4,32,1214,600,614
050,30,013,"Montana","Cascade County",4,33,1194,614,580
050,30,013,"Montana","Cascade County",4,34,1188,631,557
050,30,013,"Montana","Cascade County",4,35,1108,564,544
050,30,013,"Montana","Cascade County",4,36,1129,595,534
050,30,013,"Montana","Cascade County",4,37,1096,562,534
050,30,013,"Montana","Cascade County",4,38,1107,567,540
050,30,013,"Montana","Cascade County",4,39,1077,573,504
050,30,013,"Montana","Cascade County",4,40,1094,583,511
050,30,013,"Montana","Cascade County",4,41,1097,578,519
050,30,013,"Montana","Cascade County",4,42,989,532,457
050,30,013,"Montana","Cascade County",4,43,966,488,478
050,30,013,"Montana","Cascade County",4,44,902,447,455
050,30,013,"Montana","Cascade County",4,45,877,444,433
050,30,013,"Montana","Cascade County",4,46,871,458,413
050,30,013,"Montana","Cascade County",4,47,831,439,392
050,30,013,"Montana","Cascade County",4,48,748,387,361
050,30,013,"Montana","Cascade County",4,49,773,402,371
050,30,013,"Montana","Cascade County",4,50,846,415,431
050,30,013,"Montana","Cascade County",4,51,907,460,447
050,30,013,"Montana","Cascade County",4,52,911,460,451
050,30,013,"Montana","Cascade County",4,53,875,448,427
050,30,013,"Montana","Cascade County",4,54,851,440,411
050,30,013,"Montana","Cascade County",4,55,909,453,456
050,30,013,"Montana","Cascade County",4,56,935,450,485
050,30,013,"Montana","Cascade County",4,57,1004,486,518
050,30,013,"Montana","Cascade County",4,58,1037,523,514
050,30,013,"Montana","Cascade County",4,59,1059,540,519
050,30,013,"Montana","Cascade County",4,60,1146,567,579
050,30,013,"Montana","Cascade County",4,61,1166,567,599
050,30,013,"Montana","Cascade County",4,62,1159,560,599
050,30,013,"Montana","Cascade County",4,63,1078,536,542
050,30,013,"Montana","Cascade County",4,64,1099,535,564
050,30,013,"Montana","Cascade County",4,65,1099,515,584
050,30,013,"Montana","Cascade County",4,66,1035,489,546
050,30,013,"Montana","Cascade County",4,67,1039,486,553
050,30,013,"Montana","Cascade County",4,68,1045,504,541
050,30,013,"Montana","Cascade County",4,69,1015,483,532
050,30,013,"Montana","Cascade County",4,70,966,461,505
050,30,013,"Montana","Cascade County",4,71,895,427,468
050,30,013,"Montana","Cascade County",4,72,868,388,480
050,30,013,"Montana","Cascade County",4,73,845,400,445
050,30,013,"Montana","Cascade County",4,74,810,398,412
050,30,013,"Montana","Cascade County",4,75,836,405,431
050,30,013,"Montana","Cascade County",4,76,604,289,315
050,30,013,"Montana","Cascade County",4,77,577,294,283
050,30,013,"Montana","Cascade County",4,78,548,268,280
050,30,013,"Montana","Cascade County",4,79,565,250,315
050,30,013,"Montana","Cascade County",4,80,482,206,276
050,30,013,"Montana","Cascade County",4,81,427,193,234
050,30,013,"Montana","Cascade County",4,82,389,166,223
050,30,013,"Montana","Cascade County",4,83,378,157,221
050,30,013,"Montana","Cascade County",4,84,346,155,191
050,30,013,"Montana","Cascade County",4,85,1993,764,1229
050,30,013,"Montana","Cascade County",5,0,970,504,466
050,30,013,"Montana","Cascade County",5,1,964,480,484
050,30,013,"Montana","Cascade County",5,2,898,463,435
050,30,013,"Montana","Cascade County",5,3,1007,493,514
050,30,013,"Montana","Cascade County",5,4,1008,533,475
050,30,013,"Montana","Cascade County",5,5,1029,525,504
050,30,013,"Montana","Cascade County",5,6,1035,546,489
050,30,013,"Montana","Cascade County",5,7,1119,565,554
050,30,013,"Montana","Cascade County",5,8,1087,548,539
050,30,013,"Montana","Cascade County",5,9,1082,575,507
050,30,013,"Montana","Cascade County",5,10,1037,566,471
050,30,013,"Montana","Cascade County",5,11,1075,574,501
050,30,013,"Montana","Cascade County",5,12,1063,560,503
050,30,013,"Montana","Cascade County",5,13,1061,537,524
050,30,013,"Montana","Cascade County",5,14,1030,551,479
050,30,013,"Montana","Cascade County",5,15,1094,583,511
050,30,013,"Montana","Cascade County",5,16,1113,576,537
050,30,013,"Montana","Cascade County",5,17,1089,575,514
050,30,013,"Montana","Cascade County",5,18,926,478,448
050,30,013,"Montana","Cascade County",5,19,925,524,401
050,30,013,"Montana","Cascade County",5,20,1099,661,438
050,30,013,"Montana","Cascade County",5,21,1118,646,472
050,30,013,"Montana","Cascade County",5,22,1163,661,502
050,30,013,"Montana","Cascade County",5,23,1214,684,530
050,30,013,"Montana","Cascade County",5,24,1170,675,495
050,30,013,"Montana","Cascade County",5,25,1197,631,566
050,30,013,"Montana","Cascade County",5,26,1110,580,530
050,30,013,"Montana","Cascade County",5,27,1131,616,515
050,30,013,"Montana","Cascade County",5,28,1194,587,607
050,30,013,"Montana","Cascade County",5,29,1148,604,544
050,30,013,"Montana","Cascade County",5,30,1222,671,551
050,30,013,"Montana","Cascade County",5,31,1236,668,568
050,30,013,"Montana","Cascade County",5,32,1248,625,623
050,30,013,"Montana","Cascade County",5,33,1225,620,605
050,30,013,"Montana","Cascade County",5,34,1197,612,585
050,30,013,"Montana","Cascade County",5,35,1181,631,550
050,30,013,"Montana","Cascade County",5,36,1127,564,563
050,30,013,"Montana","Cascade County",5,37,1113,582,531
050,30,013,"Montana","Cascade County",5,38,1060,536,524
050,30,013,"Montana","Cascade County",5,39,1095,567,528
050,30,013,"Montana","Cascade County",5,40,1056,567,489
050,30,013,"Montana","Cascade County",5,41,1092,588,504
050,30,013,"Montana","Cascade County",5,42,1092,570,522
050,30,013,"Montana","Cascade County",5,43,973,522,451
050,30,013,"Montana","Cascade County",5,44,941,480,461
050,30,013,"Montana","Cascade County",5,45,918,446,472
050,30,013,"Montana","Cascade County",5,46,879,452,427
050,30,013,"Montana","Cascade County",5,47,852,440,412
050,30,013,"Montana","Cascade County",5,48,841,435,406
050,30,013,"Montana","Cascade County",5,49,767,397,370
050,30,013,"Montana","Cascade County",5,50,758,395,363
050,30,013,"Montana","Cascade County",5,51,832,407,425
050,30,013,"Montana","Cascade County",5,52,901,461,440
050,30,013,"Montana","Cascade County",5,53,923,464,459
050,30,013,"Montana","Cascade County",5,54,872,438,434
050,30,013,"Montana","Cascade County",5,55,847,434,413
050,30,013,"Montana","Cascade County",5,56,902,449,453
050,30,013,"Montana","Cascade County",5,57,942,458,484
050,30,013,"Montana","Cascade County",5,58,994,480,514
050,30,013,"Montana","Cascade County",5,59,1034,526,508
050,30,013,"Montana","Cascade County",5,60,1051,537,514
050,30,013,"Montana","Cascade County",5,61,1124,559,565
050,30,013,"Montana","Cascade County",5,62,1152,546,606
050,30,013,"Montana","Cascade County",5,63,1130,555,575
050,30,013,"Montana","Cascade County",5,64,1069,530,539
050,30,013,"Montana","Cascade County",5,65,1080,521,559
050,30,013,"Montana","Cascade County",5,66,1084,506,578
050,30,013,"Montana","Cascade County",5,67,1012,476,536
050,30,013,"Montana","Cascade County",5,68,1022,477,545
050,30,013,"Montana","Cascade County",5,69,1028,498,530
050,30,013,"Montana","Cascade County",5,70,1002,476,526
050,30,013,"Montana","Cascade County",5,71,956,453,503
050,30,013,"Montana","Cascade County",5,72,874,410,464
050,30,013,"Montana","Cascade County",5,73,845,387,458
050,30,013,"Montana","Cascade County",5,74,832,391,441
050,30,013,"Montana","Cascade County",5,75,776,384,392
050,30,013,"Montana","Cascade County",5,76,820,393,427
050,30,013,"Montana","Cascade County",5,77,577,279,298
050,30,013,"Montana","Cascade County",5,78,548,278,270
050,30,013,"Montana","Cascade County",5,79,534,255,279
050,30,013,"Montana","Cascade County",5,80,535,238,297
050,30,013,"Montana","Cascade County",5,81,444,189,255
050,30,013,"Montana","Cascade County",5,82,394,178,216
050,30,013,"Montana","Cascade County",5,83,360,152,208
050,30,013,"Montana","Cascade County",5,84,349,140,209
050,30,013,"Montana","Cascade County",5,85,2026,771,1255
050,30,015,"Montana","Chouteau County",1,0,52,27,25
050,30,015,"Montana","Chouteau County",1,1,50,27,23
050,30,015,"Montana","Chouteau County",1,2,66,38,28
050,30,015,"Montana","Chouteau County",1,3,54,35,19
050,30,015,"Montana","Chouteau County",1,4,60,33,27
050,30,015,"Montana","Chouteau County",1,5,71,34,37
050,30,015,"Montana","Chouteau County",1,6,59,28,31
050,30,015,"Montana","Chouteau County",1,7,56,35,21
050,30,015,"Montana","Chouteau County",1,8,46,24,22
050,30,015,"Montana","Chouteau County",1,9,80,36,44
050,30,015,"Montana","Chouteau County",1,10,85,32,53
050,30,015,"Montana","Chouteau County",1,11,84,49,35
050,30,015,"Montana","Chouteau County",1,12,99,54,45
050,30,015,"Montana","Chouteau County",1,13,95,38,57
050,30,015,"Montana","Chouteau County",1,14,87,35,52
050,30,015,"Montana","Chouteau County",1,15,94,47,47
050,30,015,"Montana","Chouteau County",1,16,95,46,49
050,30,015,"Montana","Chouteau County",1,17,88,49,39
050,30,015,"Montana","Chouteau County",1,18,84,42,42
050,30,015,"Montana","Chouteau County",1,19,59,33,26
050,30,015,"Montana","Chouteau County",1,20,62,34,28
050,30,015,"Montana","Chouteau County",1,21,65,34,31
050,30,015,"Montana","Chouteau County",1,22,59,27,32
050,30,015,"Montana","Chouteau County",1,23,67,39,28
050,30,015,"Montana","Chouteau County",1,24,62,38,24
050,30,015,"Montana","Chouteau County",1,25,58,32,26
050,30,015,"Montana","Chouteau County",1,26,61,34,27
050,30,015,"Montana","Chouteau County",1,27,62,33,29
050,30,015,"Montana","Chouteau County",1,28,55,26,29
050,30,015,"Montana","Chouteau County",1,29,72,36,36
050,30,015,"Montana","Chouteau County",1,30,78,39,39
050,30,015,"Montana","Chouteau County",1,31,74,39,35
050,30,015,"Montana","Chouteau County",1,32,82,39,43
050,30,015,"Montana","Chouteau County",1,33,61,37,24
050,30,015,"Montana","Chouteau County",1,34,79,44,35
050,30,015,"Montana","Chouteau County",1,35,74,35,39
050,30,015,"Montana","Chouteau County",1,36,72,32,40
050,30,015,"Montana","Chouteau County",1,37,65,38,27
050,30,015,"Montana","Chouteau County",1,38,50,24,26
050,30,015,"Montana","Chouteau County",1,39,71,35,36
050,30,015,"Montana","Chouteau County",1,40,73,37,36
050,30,015,"Montana","Chouteau County",1,41,64,32,32
050,30,015,"Montana","Chouteau County",1,42,59,30,29
050,30,015,"Montana","Chouteau County",1,43,67,31,36
050,30,015,"Montana","Chouteau County",1,44,71,38,33
050,30,015,"Montana","Chouteau County",1,45,68,37,31
050,30,015,"Montana","Chouteau County",1,46,66,29,37
050,30,015,"Montana","Chouteau County",1,47,59,33,26
050,30,015,"Montana","Chouteau County",1,48,58,34,24
050,30,015,"Montana","Chouteau County",1,49,59,31,28
050,30,015,"Montana","Chouteau County",1,50,66,32,34
050,30,015,"Montana","Chouteau County",1,51,75,37,38
050,30,015,"Montana","Chouteau County",1,52,64,35,29
050,30,015,"Montana","Chouteau County",1,53,59,35,24
050,30,015,"Montana","Chouteau County",1,54,46,23,23
050,30,015,"Montana","Chouteau County",1,55,55,31,24
050,30,015,"Montana","Chouteau County",1,56,82,35,47
050,30,015,"Montana","Chouteau County",1,57,90,41,49
050,30,015,"Montana","Chouteau County",1,58,96,46,50
050,30,015,"Montana","Chouteau County",1,59,107,49,58
050,30,015,"Montana","Chouteau County",1,60,93,45,48
050,30,015,"Montana","Chouteau County",1,61,88,47,41
050,30,015,"Montana","Chouteau County",1,62,98,52,46
050,30,015,"Montana","Chouteau County",1,63,104,56,48
050,30,015,"Montana","Chouteau County",1,64,90,49,41
050,30,015,"Montana","Chouteau County",1,65,85,43,42
050,30,015,"Montana","Chouteau County",1,66,97,47,50
050,30,015,"Montana","Chouteau County",1,67,97,45,52
050,30,015,"Montana","Chouteau County",1,68,89,47,42
050,30,015,"Montana","Chouteau County",1,69,79,42,37
050,30,015,"Montana","Chouteau County",1,70,72,44,28
050,30,015,"Montana","Chouteau County",1,71,69,31,38
050,30,015,"Montana","Chouteau County",1,72,66,33,33
050,30,015,"Montana","Chouteau County",1,73,66,38,28
050,30,015,"Montana","Chouteau County",1,74,43,21,22
050,30,015,"Montana","Chouteau County",1,75,46,19,27
050,30,015,"Montana","Chouteau County",1,76,43,21,22
050,30,015,"Montana","Chouteau County",1,77,41,20,21
050,30,015,"Montana","Chouteau County",1,78,39,19,20
050,30,015,"Montana","Chouteau County",1,79,39,19,20
050,30,015,"Montana","Chouteau County",1,80,33,14,19
050,30,015,"Montana","Chouteau County",1,81,26,10,16
050,30,015,"Montana","Chouteau County",1,82,29,17,12
050,30,015,"Montana","Chouteau County",1,83,29,13,16
050,30,015,"Montana","Chouteau County",1,84,22,11,11
050,30,015,"Montana","Chouteau County",1,85,138,60,78
050,30,015,"Montana","Chouteau County",2,0,51,26,25
050,30,015,"Montana","Chouteau County",2,1,52,28,24
050,30,015,"Montana","Chouteau County",2,2,63,36,27
050,30,015,"Montana","Chouteau County",2,3,56,35,21
050,30,015,"Montana","Chouteau County",2,4,61,34,27
050,30,015,"Montana","Chouteau County",2,5,67,32,35
050,30,015,"Montana","Chouteau County",2,6,61,29,32
050,30,015,"Montana","Chouteau County",2,7,55,32,23
050,30,015,"Montana","Chouteau County",2,8,49,27,22
050,30,015,"Montana","Chouteau County",2,9,72,33,39
050,30,015,"Montana","Chouteau County",2,10,84,34,50
050,30,015,"Montana","Chouteau County",2,11,86,46,40
050,30,015,"Montana","Chouteau County",2,12,95,53,42
050,30,015,"Montana","Chouteau County",2,13,97,42,55
050,30,015,"Montana","Chouteau County",2,14,87,36,51
050,30,015,"Montana","Chouteau County",2,15,93,44,49
050,30,015,"Montana","Chouteau County",2,16,96,48,48
050,30,015,"Montana","Chouteau County",2,17,87,47,40
050,30,015,"Montana","Chouteau County",2,18,80,42,38
050,30,015,"Montana","Chouteau County",2,19,61,34,27
050,30,015,"Montana","Chouteau County",2,20,63,35,28
050,30,015,"Montana","Chouteau County",2,21,64,34,30
050,30,015,"Montana","Chouteau County",2,22,60,28,32
050,30,015,"Montana","Chouteau County",2,23,67,38,29
050,30,015,"Montana","Chouteau County",2,24,64,39,25
050,30,015,"Montana","Chouteau County",2,25,62,35,27
050,30,015,"Montana","Chouteau County",2,26,61,34,27
050,30,015,"Montana","Chouteau County",2,27,61,32,29
050,30,015,"Montana","Chouteau County",2,28,57,28,29
050,30,015,"Montana","Chouteau County",2,29,66,33,33
050,30,015,"Montana","Chouteau County",2,30,76,39,37
050,30,015,"Montana","Chouteau County",2,31,74,38,36
050,30,015,"Montana","Chouteau County",2,32,80,38,42
050,30,015,"Montana","Chouteau County",2,33,65,37,28
050,30,015,"Montana","Chouteau County",2,34,76,43,33
050,30,015,"Montana","Chouteau County",2,35,77,38,39
050,30,015,"Montana","Chouteau County",2,36,73,33,40
050,30,015,"Montana","Chouteau County",2,37,67,36,31
050,30,015,"Montana","Chouteau County",2,38,54,27,27
050,30,015,"Montana","Chouteau County",2,39,66,32,34
050,30,015,"Montana","Chouteau County",2,40,73,37,36
050,30,015,"Montana","Chouteau County",2,41,65,33,32
050,30,015,"Montana","Chouteau County",2,42,61,31,30
050,30,015,"Montana","Chouteau County",2,43,67,32,35
050,30,015,"Montana","Chouteau County",2,44,70,37,33
050,30,015,"Montana","Chouteau County",2,45,70,37,33
050,30,015,"Montana","Chouteau County",2,46,64,30,34
050,30,015,"Montana","Chouteau County",2,47,62,32,30
050,30,015,"Montana","Chouteau County",2,48,59,34,25
050,30,015,"Montana","Chouteau County",2,49,60,33,27
050,30,015,"Montana","Chouteau County",2,50,64,32,32
050,30,015,"Montana","Chouteau County",2,51,72,36,36
050,30,015,"Montana","Chouteau County",2,52,66,35,31
050,30,015,"Montana","Chouteau County",2,53,59,35,24
050,30,015,"Montana","Chouteau County",2,54,49,26,23
050,30,015,"Montana","Chouteau County",2,55,53,30,23
050,30,015,"Montana","Chouteau County",2,56,77,35,42
050,30,015,"Montana","Chouteau County",2,57,88,40,48
050,30,015,"Montana","Chouteau County",2,58,93,44,49
050,30,015,"Montana","Chouteau County",2,59,104,49,55
050,30,015,"Montana","Chouteau County",2,60,97,46,51
050,30,015,"Montana","Chouteau County",2,61,91,48,43
050,30,015,"Montana","Chouteau County",2,62,95,51,44
050,30,015,"Montana","Chouteau County",2,63,105,56,49
050,30,015,"Montana","Chouteau County",2,64,93,50,43
050,30,015,"Montana","Chouteau County",2,65,84,44,40
050,30,015,"Montana","Chouteau County",2,66,96,47,49
050,30,015,"Montana","Chouteau County",2,67,97,45,52
050,30,015,"Montana","Chouteau County",2,68,88,45,43
050,30,015,"Montana","Chouteau County",2,69,83,44,39
050,30,015,"Montana","Chouteau County",2,70,72,42,30
050,30,015,"Montana","Chouteau County",2,71,70,34,36
050,30,015,"Montana","Chouteau County",2,72,65,32,33
050,30,015,"Montana","Chouteau County",2,73,67,36,31
050,30,015,"Montana","Chouteau County",2,74,44,22,22
050,30,015,"Montana","Chouteau County",2,75,44,18,26
050,30,015,"Montana","Chouteau County",2,76,44,21,23
050,30,015,"Montana","Chouteau County",2,77,43,21,22
050,30,015,"Montana","Chouteau County",2,78,39,19,20
050,30,015,"Montana","Chouteau County",2,79,39,19,20
050,30,015,"Montana","Chouteau County",2,80,35,15,20
050,30,015,"Montana","Chouteau County",2,81,27,11,16
050,30,015,"Montana","Chouteau County",2,82,29,16,13
050,30,015,"Montana","Chouteau County",2,83,28,13,15
050,30,015,"Montana","Chouteau County",2,84,23,11,12
050,30,015,"Montana","Chouteau County",2,85,139,59,80
050,30,015,"Montana","Chouteau County",3,0,38,18,20
050,30,015,"Montana","Chouteau County",3,1,53,28,25
050,30,015,"Montana","Chouteau County",3,2,54,29,25
050,30,015,"Montana","Chouteau County",3,3,62,31,31
050,30,015,"Montana","Chouteau County",3,4,59,36,23
050,30,015,"Montana","Chouteau County",3,5,63,38,25
050,30,015,"Montana","Chouteau County",3,6,64,32,32
050,30,015,"Montana","Chouteau County",3,7,62,30,32
050,30,015,"Montana","Chouteau County",3,8,59,30,29
050,30,015,"Montana","Chouteau County",3,9,52,28,24
050,30,015,"Montana","Chouteau County",3,10,67,33,34
050,30,015,"Montana","Chouteau County",3,11,89,36,53
050,30,015,"Montana","Chouteau County",3,12,92,51,41
050,30,015,"Montana","Chouteau County",3,13,95,50,45
050,30,015,"Montana","Chouteau County",3,14,91,43,48
050,30,015,"Montana","Chouteau County",3,15,91,39,52
050,30,015,"Montana","Chouteau County",3,16,95,47,48
050,30,015,"Montana","Chouteau County",3,17,96,48,48
050,30,015,"Montana","Chouteau County",3,18,77,44,33
050,30,015,"Montana","Chouteau County",3,19,70,37,33
050,30,015,"Montana","Chouteau County",3,20,63,34,29
050,30,015,"Montana","Chouteau County",3,21,60,34,26
050,30,015,"Montana","Chouteau County",3,22,64,34,30
050,30,015,"Montana","Chouteau County",3,23,59,34,25
050,30,015,"Montana","Chouteau County",3,24,62,38,24
050,30,015,"Montana","Chouteau County",3,25,69,43,26
050,30,015,"Montana","Chouteau County",3,26,70,35,35
050,30,015,"Montana","Chouteau County",3,27,58,34,24
050,30,015,"Montana","Chouteau County",3,28,59,33,26
050,30,015,"Montana","Chouteau County",3,29,45,19,26
050,30,015,"Montana","Chouteau County",3,30,65,30,35
050,30,015,"Montana","Chouteau County",3,31,73,37,36
050,30,015,"Montana","Chouteau County",3,32,81,42,39
050,30,015,"Montana","Chouteau County",3,33,82,38,44
050,30,015,"Montana","Chouteau County",3,34,51,21,30
050,30,015,"Montana","Chouteau County",3,35,83,47,36
050,30,015,"Montana","Chouteau County",3,36,78,39,39
050,30,015,"Montana","Chouteau County",3,37,78,37,41
050,30,015,"Montana","Chouteau County",3,38,66,35,31
050,30,015,"Montana","Chouteau County",3,39,50,24,26
050,30,015,"Montana","Chouteau County",3,40,66,31,35
050,30,015,"Montana","Chouteau County",3,41,70,35,35
050,30,015,"Montana","Chouteau County",3,42,64,33,31
050,30,015,"Montana","Chouteau County",3,43,67,34,33
050,30,015,"Montana","Chouteau County",3,44,67,32,35
050,30,015,"Montana","Chouteau County",3,45,74,38,36
050,30,015,"Montana","Chouteau County",3,46,72,39,33
050,30,015,"Montana","Chouteau County",3,47,67,32,35
050,30,015,"Montana","Chouteau County",3,48,63,30,33
050,30,015,"Montana","Chouteau County",3,49,59,38,21
050,30,015,"Montana","Chouteau County",3,50,61,36,25
050,30,015,"Montana","Chouteau County",3,51,65,32,33
050,30,015,"Montana","Chouteau County",3,52,77,38,39
050,30,015,"Montana","Chouteau County",3,53,70,39,31
050,30,015,"Montana","Chouteau County",3,54,62,36,26
050,30,015,"Montana","Chouteau County",3,55,49,26,23
050,30,015,"Montana","Chouteau County",3,56,58,32,26
050,30,015,"Montana","Chouteau County",3,57,70,29,41
050,30,015,"Montana","Chouteau County",3,58,94,44,50
050,30,015,"Montana","Chouteau County",3,59,96,46,50
050,30,015,"Montana","Chouteau County",3,60,108,52,56
050,30,015,"Montana","Chouteau County",3,61,95,44,51
050,30,015,"Montana","Chouteau County",3,62,89,47,42
050,30,015,"Montana","Chouteau County",3,63,94,51,43
050,30,015,"Montana","Chouteau County",3,64,111,57,54
050,30,015,"Montana","Chouteau County",3,65,85,46,39
050,30,015,"Montana","Chouteau County",3,66,86,44,42
050,30,015,"Montana","Chouteau County",3,67,96,45,51
050,30,015,"Montana","Chouteau County",3,68,95,43,52
050,30,015,"Montana","Chouteau County",3,69,88,48,40
050,30,015,"Montana","Chouteau County",3,70,83,44,39
050,30,015,"Montana","Chouteau County",3,71,72,43,29
050,30,015,"Montana","Chouteau County",3,72,72,35,37
050,30,015,"Montana","Chouteau County",3,73,64,31,33
050,30,015,"Montana","Chouteau County",3,74,67,35,32
050,30,015,"Montana","Chouteau County",3,75,44,22,22
050,30,015,"Montana","Chouteau County",3,76,46,19,27
050,30,015,"Montana","Chouteau County",3,77,43,20,23
050,30,015,"Montana","Chouteau County",3,78,41,21,20
050,30,015,"Montana","Chouteau County",3,79,38,18,20
050,30,015,"Montana","Chouteau County",3,80,38,18,20
050,30,015,"Montana","Chouteau County",3,81,32,14,18
050,30,015,"Montana","Chouteau County",3,82,26,11,15
050,30,015,"Montana","Chouteau County",3,83,27,17,10
050,30,015,"Montana","Chouteau County",3,84,26,12,14
050,30,015,"Montana","Chouteau County",3,85,139,60,79
050,30,015,"Montana","Chouteau County",4,0,34,10,24
050,30,015,"Montana","Chouteau County",4,1,47,27,20
050,30,015,"Montana","Chouteau County",4,2,57,30,27
050,30,015,"Montana","Chouteau County",4,3,56,28,28
050,30,015,"Montana","Chouteau County",4,4,60,31,29
050,30,015,"Montana","Chouteau County",4,5,61,37,24
050,30,015,"Montana","Chouteau County",4,6,63,36,27
050,30,015,"Montana","Chouteau County",4,7,67,33,34
050,30,015,"Montana","Chouteau County",4,8,65,29,36
050,30,015,"Montana","Chouteau County",4,9,61,30,31
050,30,015,"Montana","Chouteau County",4,10,56,32,24
050,30,015,"Montana","Chouteau County",4,11,71,36,35
050,30,015,"Montana","Chouteau County",4,12,89,32,57
050,30,015,"Montana","Chouteau County",4,13,87,48,39
050,30,015,"Montana","Chouteau County",4,14,94,49,45
050,30,015,"Montana","Chouteau County",4,15,93,45,48
050,30,015,"Montana","Chouteau County",4,16,93,36,57
050,30,015,"Montana","Chouteau County",4,17,90,45,45
050,30,015,"Montana","Chouteau County",4,18,84,39,45
050,30,015,"Montana","Chouteau County",4,19,44,23,21
050,30,015,"Montana","Chouteau County",4,20,69,38,31
050,30,015,"Montana","Chouteau County",4,21,68,36,32
050,30,015,"Montana","Chouteau County",4,22,60,37,23
050,30,015,"Montana","Chouteau County",4,23,64,31,33
050,30,015,"Montana","Chouteau County",4,24,49,25,24
050,30,015,"Montana","Chouteau County",4,25,68,39,29
050,30,015,"Montana","Chouteau County",4,26,70,40,30
050,30,015,"Montana","Chouteau County",4,27,68,33,35
050,30,015,"Montana","Chouteau County",4,28,63,34,29
050,30,015,"Montana","Chouteau County",4,29,56,30,26
050,30,015,"Montana","Chouteau County",4,30,49,24,25
050,30,015,"Montana","Chouteau County",4,31,67,33,34
050,30,015,"Montana","Chouteau County",4,32,78,41,37
050,30,015,"Montana","Chouteau County",4,33,83,43,40
050,30,015,"Montana","Chouteau County",4,34,85,40,45
050,30,015,"Montana","Chouteau County",4,35,54,26,28
050,30,015,"Montana","Chouteau County",4,36,79,43,36
050,30,015,"Montana","Chouteau County",4,37,81,42,39
050,30,015,"Montana","Chouteau County",4,38,77,37,40
050,30,015,"Montana","Chouteau County",4,39,60,34,26
050,30,015,"Montana","Chouteau County",4,40,45,19,26
050,30,015,"Montana","Chouteau County",4,41,74,35,39
050,30,015,"Montana","Chouteau County",4,42,65,32,33
050,30,015,"Montana","Chouteau County",4,43,67,34,33
050,30,015,"Montana","Chouteau County",4,44,62,32,30
050,30,015,"Montana","Chouteau County",4,45,63,31,32
050,30,015,"Montana","Chouteau County",4,46,78,40,38
050,30,015,"Montana","Chouteau County",4,47,67,37,30
050,30,015,"Montana","Chouteau County",4,48,67,31,36
050,30,015,"Montana","Chouteau County",4,49,70,34,36
050,30,015,"Montana","Chouteau County",4,50,61,40,21
050,30,015,"Montana","Chouteau County",4,51,59,33,26
050,30,015,"Montana","Chouteau County",4,52,66,31,35
050,30,015,"Montana","Chouteau County",4,53,72,38,34
050,30,015,"Montana","Chouteau County",4,54,76,41,35
050,30,015,"Montana","Chouteau County",4,55,62,38,24
050,30,015,"Montana","Chouteau County",4,56,49,26,23
050,30,015,"Montana","Chouteau County",4,57,57,31,26
050,30,015,"Montana","Chouteau County",4,58,75,31,44
050,30,015,"Montana","Chouteau County",4,59,100,46,54
050,30,015,"Montana","Chouteau County",4,60,100,47,53
050,30,015,"Montana","Chouteau County",4,61,107,51,56
050,30,015,"Montana","Chouteau County",4,62,98,46,52
050,30,015,"Montana","Chouteau County",4,63,87,45,42
050,30,015,"Montana","Chouteau County",4,64,97,53,44
050,30,015,"Montana","Chouteau County",4,65,105,53,52
050,30,015,"Montana","Chouteau County",4,66,85,46,39
050,30,015,"Montana","Chouteau County",4,67,85,42,43
050,30,015,"Montana","Chouteau County",4,68,95,43,52
050,30,015,"Montana","Chouteau County",4,69,95,43,52
050,30,015,"Montana","Chouteau County",4,70,89,50,39
050,30,015,"Montana","Chouteau County",4,71,81,42,39
050,30,015,"Montana","Chouteau County",4,72,79,46,33
050,30,015,"Montana","Chouteau County",4,73,71,35,36
050,30,015,"Montana","Chouteau County",4,74,59,27,32
050,30,015,"Montana","Chouteau County",4,75,67,35,32
050,30,015,"Montana","Chouteau County",4,76,43,22,21
050,30,015,"Montana","Chouteau County",4,77,43,18,25
050,30,015,"Montana","Chouteau County",4,78,39,18,21
050,30,015,"Montana","Chouteau County",4,79,39,20,19
050,30,015,"Montana","Chouteau County",4,80,38,18,20
050,30,015,"Montana","Chouteau County",4,81,36,17,19
050,30,015,"Montana","Chouteau County",4,82,30,13,17
050,30,015,"Montana","Chouteau County",4,83,18,7,11
050,30,015,"Montana","Chouteau County",4,84,25,17,8
050,30,015,"Montana","Chouteau County",4,85,142,64,78
050,30,015,"Montana","Chouteau County",5,0,34,10,24
050,30,015,"Montana","Chouteau County",5,1,39,15,24
050,30,015,"Montana","Chouteau County",5,2,47,24,23
050,30,015,"Montana","Chouteau County",5,3,60,31,29
050,30,015,"Montana","Chouteau County",5,4,54,25,29
050,30,015,"Montana","Chouteau County",5,5,62,36,26
050,30,015,"Montana","Chouteau County",5,6,67,39,28
050,30,015,"Montana","Chouteau County",5,7,56,32,24
050,30,015,"Montana","Chouteau County",5,8,68,33,35
050,30,015,"Montana","Chouteau County",5,9,59,29,30
050,30,015,"Montana","Chouteau County",5,10,71,39,32
050,30,015,"Montana","Chouteau County",5,11,63,33,30
050,30,015,"Montana","Chouteau County",5,12,67,34,33
050,30,015,"Montana","Chouteau County",5,13,84,31,53
050,30,015,"Montana","Chouteau County",5,14,83,48,35
050,30,015,"Montana","Chouteau County",5,15,85,46,39
050,30,015,"Montana","Chouteau County",5,16,97,47,50
050,30,015,"Montana","Chouteau County",5,17,94,36,58
050,30,015,"Montana","Chouteau County",5,18,72,37,35
050,30,015,"Montana","Chouteau County",5,19,59,27,32
050,30,015,"Montana","Chouteau County",5,20,43,23,20
050,30,015,"Montana","Chouteau County",5,21,74,37,37
050,30,015,"Montana","Chouteau County",5,22,68,35,33
050,30,015,"Montana","Chouteau County",5,23,56,36,20
050,30,015,"Montana","Chouteau County",5,24,63,27,36
050,30,015,"Montana","Chouteau County",5,25,45,21,24
050,30,015,"Montana","Chouteau County",5,26,72,40,32
050,30,015,"Montana","Chouteau County",5,27,67,36,31
050,30,015,"Montana","Chouteau County",5,28,64,31,33
050,30,015,"Montana","Chouteau County",5,29,66,38,28
050,30,015,"Montana","Chouteau County",5,30,57,29,28
050,30,015,"Montana","Chouteau County",5,31,51,26,25
050,30,015,"Montana","Chouteau County",5,32,75,39,36
050,30,015,"Montana","Chouteau County",5,33,75,40,35
050,30,015,"Montana","Chouteau County",5,34,82,42,40
050,30,015,"Montana","Chouteau County",5,35,83,35,48
050,30,015,"Montana","Chouteau County",5,36,53,26,27
050,30,015,"Montana","Chouteau County",5,37,82,44,38
050,30,015,"Montana","Chouteau County",5,38,77,39,38
050,30,015,"Montana","Chouteau County",5,39,72,34,38
050,30,015,"Montana","Chouteau County",5,40,62,34,28
050,30,015,"Montana","Chouteau County",5,41,48,23,25
050,30,015,"Montana","Chouteau County",5,42,75,36,39
050,30,015,"Montana","Chouteau County",5,43,64,30,34
050,30,015,"Montana","Chouteau County",5,44,68,34,34
050,30,015,"Montana","Chouteau County",5,45,64,31,33
050,30,015,"Montana","Chouteau County",5,46,57,31,26
050,30,015,"Montana","Chouteau County",5,47,82,44,38
050,30,015,"Montana","Chouteau County",5,48,67,36,31
050,30,015,"Montana","Chouteau County",5,49,68,33,35
050,30,015,"Montana","Chouteau County",5,50,72,34,38
050,30,015,"Montana","Chouteau County",5,51,60,37,23
050,30,015,"Montana","Chouteau County",5,52,55,29,26
050,30,015,"Montana","Chouteau County",5,53,65,33,32
050,30,015,"Montana","Chouteau County",5,54,78,41,37
050,30,015,"Montana","Chouteau County",5,55,78,43,35
050,30,015,"Montana","Chouteau County",5,56,59,37,22
050,30,015,"Montana","Chouteau County",5,57,53,26,27
050,30,015,"Montana","Chouteau County",5,58,57,31,26
050,30,015,"Montana","Chouteau County",5,59,75,31,44
050,30,015,"Montana","Chouteau County",5,60,95,42,53
050,30,015,"Montana","Chouteau County",5,61,99,48,51
050,30,015,"Montana","Chouteau County",5,62,107,50,57
050,30,015,"Montana","Chouteau County",5,63,97,48,49
050,30,015,"Montana","Chouteau County",5,64,88,44,44
050,30,015,"Montana","Chouteau County",5,65,93,51,42
050,30,015,"Montana","Chouteau County",5,66,103,54,49
050,30,015,"Montana","Chouteau County",5,67,81,40,41
050,30,015,"Montana","Chouteau County",5,68,87,45,42
050,30,015,"Montana","Chouteau County",5,69,94,43,51
050,30,015,"Montana","Chouteau County",5,70,94,42,52
050,30,015,"Montana","Chouteau County",5,71,86,47,39
050,30,015,"Montana","Chouteau County",5,72,80,42,38
050,30,015,"Montana","Chouteau County",5,73,79,45,34
050,30,015,"Montana","Chouteau County",5,74,71,34,37
050,30,015,"Montana","Chouteau County",5,75,58,28,30
050,30,015,"Montana","Chouteau County",5,76,68,36,32
050,30,015,"Montana","Chouteau County",5,77,42,22,20
050,30,015,"Montana","Chouteau County",5,78,36,15,21
050,30,015,"Montana","Chouteau County",5,79,38,18,20
050,30,015,"Montana","Chouteau County",5,80,36,19,17
050,30,015,"Montana","Chouteau County",5,81,32,14,18
050,30,015,"Montana","Chouteau County",5,82,36,16,20
050,30,015,"Montana","Chouteau County",5,83,23,9,14
050,30,015,"Montana","Chouteau County",5,84,19,6,13
050,30,015,"Montana","Chouteau County",5,85,152,73,79
050,30,017,"Montana","Custer County",1,0,115,58,57
050,30,017,"Montana","Custer County",1,1,110,56,54
050,30,017,"Montana","Custer County",1,2,129,63,66
050,30,017,"Montana","Custer County",1,3,146,66,80
050,30,017,"Montana","Custer County",1,4,133,66,67
050,30,017,"Montana","Custer County",1,5,133,77,56
050,30,017,"Montana","Custer County",1,6,127,70,57
050,30,017,"Montana","Custer County",1,7,130,71,59
050,30,017,"Montana","Custer County",1,8,143,74,69
050,30,017,"Montana","Custer County",1,9,138,66,72
050,30,017,"Montana","Custer County",1,10,141,69,72
050,30,017,"Montana","Custer County",1,11,129,71,58
050,30,017,"Montana","Custer County",1,12,122,64,58
050,30,017,"Montana","Custer County",1,13,136,66,70
050,30,017,"Montana","Custer County",1,14,129,68,61
050,30,017,"Montana","Custer County",1,15,138,77,61
050,30,017,"Montana","Custer County",1,16,123,59,64
050,30,017,"Montana","Custer County",1,17,141,78,63
050,30,017,"Montana","Custer County",1,18,152,79,73
050,30,017,"Montana","Custer County",1,19,160,89,71
050,30,017,"Montana","Custer County",1,20,155,88,67
050,30,017,"Montana","Custer County",1,21,126,77,49
050,30,017,"Montana","Custer County",1,22,119,61,58
050,30,017,"Montana","Custer County",1,23,124,61,63
050,30,017,"Montana","Custer County",1,24,138,76,62
050,30,017,"Montana","Custer County",1,25,140,74,66
050,30,017,"Montana","Custer County",1,26,152,71,81
050,30,017,"Montana","Custer County",1,27,160,75,85
050,30,017,"Montana","Custer County",1,28,126,58,68
050,30,017,"Montana","Custer County",1,29,150,71,79
050,30,017,"Montana","Custer County",1,30,142,75,67
050,30,017,"Montana","Custer County",1,31,130,66,64
050,30,017,"Montana","Custer County",1,32,139,70,69
050,30,017,"Montana","Custer County",1,33,135,68,67
050,30,017,"Montana","Custer County",1,34,148,78,70
050,30,017,"Montana","Custer County",1,35,172,89,83
050,30,017,"Montana","Custer County",1,36,166,85,81
050,30,017,"Montana","Custer County",1,37,166,83,83
050,30,017,"Montana","Custer County",1,38,161,77,84
050,30,017,"Montana","Custer County",1,39,165,96,69
050,30,017,"Montana","Custer County",1,40,166,94,72
050,30,017,"Montana","Custer County",1,41,149,79,70
050,30,017,"Montana","Custer County",1,42,132,76,56
050,30,017,"Montana","Custer County",1,43,135,64,71
050,30,017,"Montana","Custer County",1,44,124,66,58
050,30,017,"Montana","Custer County",1,45,127,67,60
050,30,017,"Montana","Custer County",1,46,122,57,65
050,30,017,"Montana","Custer County",1,47,128,57,71
050,30,017,"Montana","Custer County",1,48,163,71,92
050,30,017,"Montana","Custer County",1,49,161,80,81
050,30,017,"Montana","Custer County",1,50,142,69,73
050,30,017,"Montana","Custer County",1,51,130,65,65
050,30,017,"Montana","Custer County",1,52,123,66,57
050,30,017,"Montana","Custer County",1,53,146,83,63
050,30,017,"Montana","Custer County",1,54,146,69,77
050,30,017,"Montana","Custer County",1,55,165,84,81
050,30,017,"Montana","Custer County",1,56,176,97,79
050,30,017,"Montana","Custer County",1,57,183,102,81
050,30,017,"Montana","Custer County",1,58,207,101,106
050,30,017,"Montana","Custer County",1,59,208,107,101
050,30,017,"Montana","Custer County",1,60,169,77,92
050,30,017,"Montana","Custer County",1,61,192,105,87
050,30,017,"Montana","Custer County",1,62,192,108,84
050,30,017,"Montana","Custer County",1,63,170,80,90
050,30,017,"Montana","Custer County",1,64,171,82,89
050,30,017,"Montana","Custer County",1,65,156,77,79
050,30,017,"Montana","Custer County",1,66,178,102,76
050,30,017,"Montana","Custer County",1,67,161,80,81
050,30,017,"Montana","Custer County",1,68,158,76,82
050,30,017,"Montana","Custer County",1,69,140,64,76
050,30,017,"Montana","Custer County",1,70,124,55,69
050,30,017,"Montana","Custer County",1,71,140,59,81
050,30,017,"Montana","Custer County",1,72,126,55,71
050,30,017,"Montana","Custer County",1,73,121,57,64
050,30,017,"Montana","Custer County",1,74,83,42,41
050,30,017,"Montana","Custer County",1,75,85,46,39
050,30,017,"Montana","Custer County",1,76,79,40,39
050,30,017,"Montana","Custer County",1,77,80,36,44
050,30,017,"Montana","Custer County",1,78,61,26,35
050,30,017,"Montana","Custer County",1,79,67,31,36
050,30,017,"Montana","Custer County",1,80,72,34,38
050,30,017,"Montana","Custer County",1,81,62,26,36
050,30,017,"Montana","Custer County",1,82,51,20,31
050,30,017,"Montana","Custer County",1,83,58,22,36
050,30,017,"Montana","Custer County",1,84,50,18,32
050,30,017,"Montana","Custer County",1,85,301,118,183
050,30,017,"Montana","Custer County",2,0,116,56,60
050,30,017,"Montana","Custer County",2,1,110,56,54
050,30,017,"Montana","Custer County",2,2,125,61,64
050,30,017,"Montana","Custer County",2,3,139,64,75
050,30,017,"Montana","Custer County",2,4,135,66,69
050,30,017,"Montana","Custer County",2,5,131,74,57
050,30,017,"Montana","Custer County",2,6,130,73,57
050,30,017,"Montana","Custer County",2,7,129,71,58
050,30,017,"Montana","Custer County",2,8,141,74,67
050,30,017,"Montana","Custer County",2,9,141,69,72
050,30,017,"Montana","Custer County",2,10,141,69,72
050,30,017,"Montana","Custer County",2,11,130,70,60
050,30,017,"Montana","Custer County",2,12,125,66,59
050,30,017,"Montana","Custer County",2,13,131,64,67
050,30,017,"Montana","Custer County",2,14,132,69,63
050,30,017,"Montana","Custer County",2,15,138,77,61
050,30,017,"Montana","Custer County",2,16,128,65,63
050,30,017,"Montana","Custer County",2,17,141,76,65
050,30,017,"Montana","Custer County",2,18,148,76,72
050,30,017,"Montana","Custer County",2,19,163,92,71
050,30,017,"Montana","Custer County",2,20,154,88,66
050,30,017,"Montana","Custer County",2,21,128,76,52
050,30,017,"Montana","Custer County",2,22,120,65,55
050,30,017,"Montana","Custer County",2,23,125,63,62
050,30,017,"Montana","Custer County",2,24,137,73,64
050,30,017,"Montana","Custer County",2,25,140,74,66
050,30,017,"Montana","Custer County",2,26,152,72,80
050,30,017,"Montana","Custer County",2,27,155,73,82
050,30,017,"Montana","Custer County",2,28,133,62,71
050,30,017,"Montana","Custer County",2,29,146,69,77
050,30,017,"Montana","Custer County",2,30,143,74,69
050,30,017,"Montana","Custer County",2,31,132,70,62
050,30,017,"Montana","Custer County",2,32,137,70,67
050,30,017,"Montana","Custer County",2,33,135,67,68
050,30,017,"Montana","Custer County",2,34,146,76,70
050,30,017,"Montana","Custer County",2,35,168,87,81
050,30,017,"Montana","Custer County",2,36,165,85,80
050,30,017,"Montana","Custer County",2,37,165,83,82
050,30,017,"Montana","Custer County",2,38,164,79,85
050,30,017,"Montana","Custer County",2,39,163,90,73
050,30,017,"Montana","Custer County",2,40,169,95,74
050,30,017,"Montana","Custer County",2,41,152,81,71
050,30,017,"Montana","Custer County",2,42,134,76,58
050,30,017,"Montana","Custer County",2,43,135,67,68
050,30,017,"Montana","Custer County",2,44,125,65,60
050,30,017,"Montana","Custer County",2,45,126,66,60
050,30,017,"Montana","Custer County",2,46,123,58,65
050,30,017,"Montana","Custer County",2,47,128,57,71
050,30,017,"Montana","Custer County",2,48,154,68,86
050,30,017,"Montana","Custer County",2,49,162,78,84
050,30,017,"Montana","Custer County",2,50,144,69,75
050,30,017,"Montana","Custer County",2,51,132,65,67
050,30,017,"Montana","Custer County",2,52,121,64,57
050,30,017,"Montana","Custer County",2,53,142,80,62
050,30,017,"Montana","Custer County",2,54,145,72,73
050,30,017,"Montana","Custer County",2,55,161,81,80
050,30,017,"Montana","Custer County",2,56,174,94,80
050,30,017,"Montana","Custer County",2,57,180,100,80
050,30,017,"Montana","Custer County",2,58,201,102,99
050,30,017,"Montana","Custer County",2,59,209,106,103
050,30,017,"Montana","Custer County",2,60,178,84,94
050,30,017,"Montana","Custer County",2,61,184,98,86
050,30,017,"Montana","Custer County",2,62,190,105,85
050,30,017,"Montana","Custer County",2,63,178,88,90
050,30,017,"Montana","Custer County",2,64,170,81,89
050,30,017,"Montana","Custer County",2,65,160,78,82
050,30,017,"Montana","Custer County",2,66,175,98,77
050,30,017,"Montana","Custer County",2,67,162,82,80
050,30,017,"Montana","Custer County",2,68,157,76,81
050,30,017,"Montana","Custer County",2,69,145,68,77
050,30,017,"Montana","Custer County",2,70,127,57,70
050,30,017,"Montana","Custer County",2,71,136,57,79
050,30,017,"Montana","Custer County",2,72,123,52,71
050,30,017,"Montana","Custer County",2,73,127,60,67
050,30,017,"Montana","Custer County",2,74,88,43,45
050,30,017,"Montana","Custer County",2,75,84,44,40
050,30,017,"Montana","Custer County",2,76,77,40,37
050,30,017,"Montana","Custer County",2,77,81,37,44
050,30,017,"Montana","Custer County",2,78,65,28,37
050,30,017,"Montana","Custer County",2,79,63,29,34
050,30,017,"Montana","Custer County",2,80,70,31,39
050,30,017,"Montana","Custer County",2,81,63,27,36
050,30,017,"Montana","Custer County",2,82,53,22,31
050,30,017,"Montana","Custer County",2,83,56,22,34
050,30,017,"Montana","Custer County",2,84,52,19,33
050,30,017,"Montana","Custer County",2,85,303,118,185
050,30,017,"Montana","Custer County",3,0,106,45,61
050,30,017,"Montana","Custer County",3,1,121,58,63
050,30,017,"Montana","Custer County",3,2,114,58,56
050,30,017,"Montana","Custer County",3,3,121,62,59
050,30,017,"Montana","Custer County",3,4,146,64,82
050,30,017,"Montana","Custer County",3,5,138,68,70
050,30,017,"Montana","Custer County",3,6,143,82,61
050,30,017,"Montana","Custer County",3,7,128,74,54
050,30,017,"Montana","Custer County",3,8,136,74,62
050,30,017,"Montana","Custer County",3,9,136,70,66
050,30,017,"Montana","Custer County",3,10,134,67,67
050,30,017,"Montana","Custer County",3,11,146,69,77
050,30,017,"Montana","Custer County",3,12,132,71,61
050,30,017,"Montana","Custer County",3,13,132,70,62
050,30,017,"Montana","Custer County",3,14,138,69,69
050,30,017,"Montana","Custer County",3,15,136,75,61
050,30,017,"Montana","Custer County",3,16,142,79,63
050,30,017,"Montana","Custer County",3,17,137,73,64
050,30,017,"Montana","Custer County",3,18,138,70,68
050,30,017,"Montana","Custer County",3,19,163,90,73
050,30,017,"Montana","Custer County",3,20,155,82,73
050,30,017,"Montana","Custer County",3,21,135,76,59
050,30,017,"Montana","Custer County",3,22,118,72,46
050,30,017,"Montana","Custer County",3,23,125,72,53
050,30,017,"Montana","Custer County",3,24,139,71,68
050,30,017,"Montana","Custer County",3,25,139,72,67
050,30,017,"Montana","Custer County",3,26,142,69,73
050,30,017,"Montana","Custer County",3,27,158,74,84
050,30,017,"Montana","Custer County",3,28,160,78,82
050,30,017,"Montana","Custer County",3,29,154,73,81
050,30,017,"Montana","Custer County",3,30,150,69,81
050,30,017,"Montana","Custer County",3,31,150,84,66
050,30,017,"Montana","Custer County",3,32,142,73,69
050,30,017,"Montana","Custer County",3,33,130,65,65
050,30,017,"Montana","Custer County",3,34,132,65,67
050,30,017,"Montana","Custer County",3,35,149,82,67
050,30,017,"Montana","Custer County",3,36,176,95,81
050,30,017,"Montana","Custer County",3,37,164,86,78
050,30,017,"Montana","Custer County",3,38,171,87,84
050,30,017,"Montana","Custer County",3,39,168,81,87
050,30,017,"Montana","Custer County",3,40,171,94,77
050,30,017,"Montana","Custer County",3,41,172,94,78
050,30,017,"Montana","Custer County",3,42,151,80,71
050,30,017,"Montana","Custer County",3,43,134,78,56
050,30,017,"Montana","Custer County",3,44,139,73,66
050,30,017,"Montana","Custer County",3,45,124,64,60
050,30,017,"Montana","Custer County",3,46,122,67,55
050,30,017,"Montana","Custer County",3,47,130,57,73
050,30,017,"Montana","Custer County",3,48,132,58,74
050,30,017,"Montana","Custer County",3,49,153,68,85
050,30,017,"Montana","Custer County",3,50,162,77,85
050,30,017,"Montana","Custer County",3,51,145,67,78
050,30,017,"Montana","Custer County",3,52,135,66,69
050,30,017,"Montana","Custer County",3,53,125,69,56
050,30,017,"Montana","Custer County",3,54,139,75,64
050,30,017,"Montana","Custer County",3,55,139,69,70
050,30,017,"Montana","Custer County",3,56,163,83,80
050,30,017,"Montana","Custer County",3,57,165,94,71
050,30,017,"Montana","Custer County",3,58,173,96,77
050,30,017,"Montana","Custer County",3,59,203,103,100
050,30,017,"Montana","Custer County",3,60,202,99,103
050,30,017,"Montana","Custer County",3,61,179,85,94
050,30,017,"Montana","Custer County",3,62,183,94,89
050,30,017,"Montana","Custer County",3,63,192,111,81
050,30,017,"Montana","Custer County",3,64,170,81,89
050,30,017,"Montana","Custer County",3,65,168,80,88
050,30,017,"Montana","Custer County",3,66,156,79,77
050,30,017,"Montana","Custer County",3,67,167,91,76
050,30,017,"Montana","Custer County",3,68,156,82,74
050,30,017,"Montana","Custer County",3,69,154,75,79
050,30,017,"Montana","Custer County",3,70,141,65,76
050,30,017,"Montana","Custer County",3,71,128,56,72
050,30,017,"Montana","Custer County",3,72,134,59,75
050,30,017,"Montana","Custer County",3,73,122,51,71
050,30,017,"Montana","Custer County",3,74,131,65,66
050,30,017,"Montana","Custer County",3,75,88,43,45
050,30,017,"Montana","Custer County",3,76,79,41,38
050,30,017,"Montana","Custer County",3,77,75,38,37
050,30,017,"Montana","Custer County",3,78,81,37,44
050,30,017,"Montana","Custer County",3,79,57,26,31
050,30,017,"Montana","Custer County",3,80,65,28,37
050,30,017,"Montana","Custer County",3,81,59,28,31
050,30,017,"Montana","Custer County",3,82,59,26,33
050,30,017,"Montana","Custer County",3,83,52,23,29
050,30,017,"Montana","Custer County",3,84,57,21,36
050,30,017,"Montana","Custer County",3,85,285,97,188
050,30,017,"Montana","Custer County",4,0,102,50,52
050,30,017,"Montana","Custer County",4,1,119,43,76
050,30,017,"Montana","Custer County",4,2,119,58,61
050,30,017,"Montana","Custer County",4,3,116,59,57
050,30,017,"Montana","Custer County",4,4,120,59,61
050,30,017,"Montana","Custer County",4,5,141,64,77
050,30,017,"Montana","Custer County",4,6,142,67,75
050,30,017,"Montana","Custer County",4,7,140,82,58
050,30,017,"Montana","Custer County",4,8,135,74,61
050,30,017,"Montana","Custer County",4,9,138,77,61
050,30,017,"Montana","Custer County",4,10,133,68,65
050,30,017,"Montana","Custer County",4,11,139,67,72
050,30,017,"Montana","Custer County",4,12,144,69,75
050,30,017,"Montana","Custer County",4,13,143,77,66
050,30,017,"Montana","Custer County",4,14,137,74,63
050,30,017,"Montana","Custer County",4,15,138,71,67
050,30,017,"Montana","Custer County",4,16,141,80,61
050,30,017,"Montana","Custer County",4,17,149,85,64
050,30,017,"Montana","Custer County",4,18,128,63,65
050,30,017,"Montana","Custer County",4,19,158,86,72
050,30,017,"Montana","Custer County",4,20,134,70,64
050,30,017,"Montana","Custer County",4,21,128,65,63
050,30,017,"Montana","Custer County",4,22,141,75,66
050,30,017,"Montana","Custer County",4,23,135,83,52
050,30,017,"Montana","Custer County",4,24,141,79,62
050,30,017,"Montana","Custer County",4,25,138,66,72
050,30,017,"Montana","Custer County",4,26,151,81,70
050,30,017,"Montana","Custer County",4,27,137,73,64
050,30,017,"Montana","Custer County",4,28,157,76,81
050,30,017,"Montana","Custer County",4,29,159,79,80
050,30,017,"Montana","Custer County",4,30,154,76,78
050,30,017,"Montana","Custer County",4,31,160,72,88
050,30,017,"Montana","Custer County",4,32,164,90,74
050,30,017,"Montana","Custer County",4,33,148,73,75
050,30,017,"Montana","Custer County",4,34,134,65,69
050,30,017,"Montana","Custer County",4,35,132,67,65
050,30,017,"Montana","Custer County",4,36,146,74,72
050,30,017,"Montana","Custer County",4,37,181,104,77
050,30,017,"Montana","Custer County",4,38,175,93,82
050,30,017,"Montana","Custer County",4,39,171,84,87
050,30,017,"Montana","Custer County",4,40,168,81,87
050,30,017,"Montana","Custer County",4,41,162,89,73
050,30,017,"Montana","Custer County",4,42,180,95,85
050,30,017,"Montana","Custer County",4,43,147,78,69
050,30,017,"Montana","Custer County",4,44,131,81,50
050,30,017,"Montana","Custer County",4,45,144,81,63
050,30,017,"Montana","Custer County",4,46,120,61,59
050,30,017,"Montana","Custer County",4,47,138,77,61
050,30,017,"Montana","Custer County",4,48,125,54,71
050,30,017,"Montana","Custer County",4,49,129,57,72
050,30,017,"Montana","Custer County",4,50,143,63,80
050,30,017,"Montana","Custer County",4,51,163,81,82
050,30,017,"Montana","Custer County",4,52,145,68,77
050,30,017,"Montana","Custer County",4,53,137,69,68
050,30,017,"Montana","Custer County",4,54,121,64,57
050,30,017,"Montana","Custer County",4,55,138,76,62
050,30,017,"Montana","Custer County",4,56,140,68,72
050,30,017,"Montana","Custer County",4,57,159,78,81
050,30,017,"Montana","Custer County",4,58,162,90,72
050,30,017,"Montana","Custer County",4,59,177,96,81
050,30,017,"Montana","Custer County",4,60,193,95,98
050,30,017,"Montana","Custer County",4,61,203,102,101
050,30,017,"Montana","Custer County",4,62,179,82,97
050,30,017,"Montana","Custer County",4,63,181,94,87
050,30,017,"Montana","Custer County",4,64,190,110,80
050,30,017,"Montana","Custer County",4,65,165,75,90
050,30,017,"Montana","Custer County",4,66,165,77,88
050,30,017,"Montana","Custer County",4,67,148,76,72
050,30,017,"Montana","Custer County",4,68,167,92,75
050,30,017,"Montana","Custer County",4,69,154,80,74
050,30,017,"Montana","Custer County",4,70,147,67,80
050,30,017,"Montana","Custer County",4,71,140,62,78
050,30,017,"Montana","Custer County",4,72,118,48,70
050,30,017,"Montana","Custer County",4,73,133,58,75
050,30,017,"Montana","Custer County",4,74,119,53,66
050,30,017,"Montana","Custer County",4,75,127,62,65
050,30,017,"Montana","Custer County",4,76,88,43,45
050,30,017,"Montana","Custer County",4,77,75,37,38
050,30,017,"Montana","Custer County",4,78,77,39,38
050,30,017,"Montana","Custer County",4,79,76,33,43
050,30,017,"Montana","Custer County",4,80,58,24,34
050,30,017,"Montana","Custer County",4,81,56,25,31
050,30,017,"Montana","Custer County",4,82,57,26,31
050,30,017,"Montana","Custer County",4,83,60,29,31
050,30,017,"Montana","Custer County",4,84,48,22,26
050,30,017,"Montana","Custer County",4,85,279,95,184
050,30,017,"Montana","Custer County",5,0,103,51,52
050,30,017,"Montana","Custer County",5,1,94,44,50
050,30,017,"Montana","Custer County",5,2,118,44,74
050,30,017,"Montana","Custer County",5,3,121,61,60
050,30,017,"Montana","Custer County",5,4,119,61,58
050,30,017,"Montana","Custer County",5,5,118,59,59
050,30,017,"Montana","Custer County",5,6,138,64,74
050,30,017,"Montana","Custer County",5,7,143,70,73
050,30,017,"Montana","Custer County",5,8,140,82,58
050,30,017,"Montana","Custer County",5,9,134,73,61
050,30,017,"Montana","Custer County",5,10,127,70,57
050,30,017,"Montana","Custer County",5,11,144,69,75
050,30,017,"Montana","Custer County",5,12,132,66,66
050,30,017,"Montana","Custer County",5,13,146,74,72
050,30,017,"Montana","Custer County",5,14,145,81,64
050,30,017,"Montana","Custer County",5,15,139,75,64
050,30,017,"Montana","Custer County",5,16,142,79,63
050,30,017,"Montana","Custer County",5,17,145,86,59
050,30,017,"Montana","Custer County",5,18,139,76,63
050,30,017,"Montana","Custer County",5,19,151,81,70
050,30,017,"Montana","Custer County",5,20,145,79,66
050,30,017,"Montana","Custer County",5,21,120,60,60
050,30,017,"Montana","Custer County",5,22,121,65,56
050,30,017,"Montana","Custer County",5,23,155,84,71
050,30,017,"Montana","Custer County",5,24,141,82,59
050,30,017,"Montana","Custer County",5,25,137,76,61
050,30,017,"Montana","Custer County",5,26,143,67,76
050,30,017,"Montana","Custer County",5,27,146,79,67
050,30,017,"Montana","Custer County",5,28,137,67,70
050,30,017,"Montana","Custer County",5,29,154,78,76
050,30,017,"Montana","Custer County",5,30,153,72,81
050,30,017,"Montana","Custer County",5,31,152,70,82
050,30,017,"Montana","Custer County",5,32,162,75,87
050,30,017,"Montana","Custer County",5,33,149,80,69
050,30,017,"Montana","Custer County",5,34,152,76,76
050,30,017,"Montana","Custer County",5,35,141,73,68
050,30,017,"Montana","Custer County",5,36,134,70,64
050,30,017,"Montana","Custer County",5,37,151,76,75
050,30,017,"Montana","Custer County",5,38,185,104,81
050,30,017,"Montana","Custer County",5,39,174,91,83
050,30,017,"Montana","Custer County",5,40,181,91,90
050,30,017,"Montana","Custer County",5,41,169,78,91
050,30,017,"Montana","Custer County",5,42,169,90,79
050,30,017,"Montana","Custer County",5,43,181,95,86
050,30,017,"Montana","Custer County",5,44,153,82,71
050,30,017,"Montana","Custer County",5,45,133,84,49
050,30,017,"Montana","Custer County",5,46,145,82,63
050,30,017,"Montana","Custer County",5,47,127,66,61
050,30,017,"Montana","Custer County",5,48,136,73,63
050,30,017,"Montana","Custer County",5,49,127,54,73
050,30,017,"Montana","Custer County",5,50,122,56,66
050,30,017,"Montana","Custer County",5,51,152,66,86
050,30,017,"Montana","Custer County",5,52,162,80,82
050,30,017,"Montana","Custer County",5,53,152,74,78
050,30,017,"Montana","Custer County",5,54,132,65,67
050,30,017,"Montana","Custer County",5,55,120,65,55
050,30,017,"Montana","Custer County",5,56,140,82,58
050,30,017,"Montana","Custer County",5,57,134,65,69
050,30,017,"Montana","Custer County",5,58,164,79,85
050,30,017,"Montana","Custer County",5,59,158,90,68
050,30,017,"Montana","Custer County",5,60,166,90,76
050,30,017,"Montana","Custer County",5,61,197,96,101
050,30,017,"Montana","Custer County",5,62,195,95,100
050,30,017,"Montana","Custer County",5,63,179,84,95
050,30,017,"Montana","Custer County",5,64,181,93,88
050,30,017,"Montana","Custer County",5,65,189,106,83
050,30,017,"Montana","Custer County",5,66,160,72,88
050,30,017,"Montana","Custer County",5,67,160,73,87
050,30,017,"Montana","Custer County",5,68,152,79,73
050,30,017,"Montana","Custer County",5,69,158,87,71
050,30,017,"Montana","Custer County",5,70,154,79,75
050,30,017,"Montana","Custer County",5,71,145,64,81
050,30,017,"Montana","Custer County",5,72,131,60,71
050,30,017,"Montana","Custer County",5,73,113,48,65
050,30,017,"Montana","Custer County",5,74,130,58,72
050,30,017,"Montana","Custer County",5,75,110,48,62
050,30,017,"Montana","Custer County",5,76,125,63,62
050,30,017,"Montana","Custer County",5,77,80,38,42
050,30,017,"Montana","Custer County",5,78,78,39,39
050,30,017,"Montana","Custer County",5,79,72,37,35
050,30,017,"Montana","Custer County",5,80,77,31,46
050,30,017,"Montana","Custer County",5,81,47,17,30
050,30,017,"Montana","Custer County",5,82,55,23,32
050,30,017,"Montana","Custer County",5,83,59,28,31
050,30,017,"Montana","Custer County",5,84,59,28,31
050,30,017,"Montana","Custer County",5,85,266,93,173
050,30,019,"Montana","Daniels County",1,0,15,8,7
050,30,019,"Montana","Daniels County",1,1,17,10,7
050,30,019,"Montana","Daniels County",1,2,16,11,5
050,30,019,"Montana","Daniels County",1,3,15,10,5
050,30,019,"Montana","Daniels County",1,4,16,9,7
050,30,019,"Montana","Daniels County",1,5,20,10,10
050,30,019,"Montana","Daniels County",1,6,22,10,12
050,30,019,"Montana","Daniels County",1,7,22,9,13
050,30,019,"Montana","Daniels County",1,8,20,11,9
050,30,019,"Montana","Daniels County",1,9,26,15,11
050,30,019,"Montana","Daniels County",1,10,25,13,12
050,30,019,"Montana","Daniels County",1,11,25,15,10
050,30,019,"Montana","Daniels County",1,12,23,14,9
050,30,019,"Montana","Daniels County",1,13,20,11,9
050,30,019,"Montana","Daniels County",1,14,16,6,10
050,30,019,"Montana","Daniels County",1,15,23,11,12
050,30,019,"Montana","Daniels County",1,16,20,12,8
050,30,019,"Montana","Daniels County",1,17,22,12,10
050,30,019,"Montana","Daniels County",1,18,21,14,7
050,30,019,"Montana","Daniels County",1,19,14,8,6
050,30,019,"Montana","Daniels County",1,20,10,4,6
050,30,019,"Montana","Daniels County",1,21,13,5,8
050,30,019,"Montana","Daniels County",1,22,13,5,8
050,30,019,"Montana","Daniels County",1,23,17,10,7
050,30,019,"Montana","Daniels County",1,24,13,6,7
050,30,019,"Montana","Daniels County",1,25,10,6,4
050,30,019,"Montana","Daniels County",1,26,14,7,7
050,30,019,"Montana","Daniels County",1,27,18,11,7
050,30,019,"Montana","Daniels County",1,28,16,9,7
050,30,019,"Montana","Daniels County",1,29,21,13,8
050,30,019,"Montana","Daniels County",1,30,19,11,8
050,30,019,"Montana","Daniels County",1,31,17,9,8
050,30,019,"Montana","Daniels County",1,32,11,7,4
050,30,019,"Montana","Daniels County",1,33,19,8,11
050,30,019,"Montana","Daniels County",1,34,17,10,7
050,30,019,"Montana","Daniels County",1,35,18,7,11
050,30,019,"Montana","Daniels County",1,36,24,13,11
050,30,019,"Montana","Daniels County",1,37,16,6,10
050,30,019,"Montana","Daniels County",1,38,18,10,8
050,30,019,"Montana","Daniels County",1,39,19,12,7
050,30,019,"Montana","Daniels County",1,40,18,9,9
050,30,019,"Montana","Daniels County",1,41,19,14,5
050,30,019,"Montana","Daniels County",1,42,22,16,6
050,30,019,"Montana","Daniels County",1,43,23,13,10
050,30,019,"Montana","Daniels County",1,44,14,5,9
050,30,019,"Montana","Daniels County",1,45,14,7,7
050,30,019,"Montana","Daniels County",1,46,10,5,5
050,30,019,"Montana","Daniels County",1,47,14,11,3
050,30,019,"Montana","Daniels County",1,48,16,7,9
050,30,019,"Montana","Daniels County",1,49,15,5,10
050,30,019,"Montana","Daniels County",1,50,12,5,7
050,30,019,"Montana","Daniels County",1,51,17,10,7
050,30,019,"Montana","Daniels County",1,52,12,6,6
050,30,019,"Montana","Daniels County",1,53,16,8,8
050,30,019,"Montana","Daniels County",1,54,15,10,5
050,30,019,"Montana","Daniels County",1,55,21,13,8
050,30,019,"Montana","Daniels County",1,56,25,14,11
050,30,019,"Montana","Daniels County",1,57,26,15,11
050,30,019,"Montana","Daniels County",1,58,22,12,10
050,30,019,"Montana","Daniels County",1,59,24,13,11
050,30,019,"Montana","Daniels County",1,60,23,11,12
050,30,019,"Montana","Daniels County",1,61,34,16,18
050,30,019,"Montana","Daniels County",1,62,40,20,20
050,30,019,"Montana","Daniels County",1,63,35,17,18
050,30,019,"Montana","Daniels County",1,64,31,19,12
050,30,019,"Montana","Daniels County",1,65,26,14,12
050,30,019,"Montana","Daniels County",1,66,27,14,13
050,30,019,"Montana","Daniels County",1,67,25,18,7
050,30,019,"Montana","Daniels County",1,68,24,15,9
050,30,019,"Montana","Daniels County",1,69,21,9,12
050,30,019,"Montana","Daniels County",1,70,21,10,11
050,30,019,"Montana","Daniels County",1,71,23,13,10
050,30,019,"Montana","Daniels County",1,72,16,8,8
050,30,019,"Montana","Daniels County",1,73,20,11,9
050,30,019,"Montana","Daniels County",1,74,17,8,9
050,30,019,"Montana","Daniels County",1,75,17,10,7
050,30,019,"Montana","Daniels County",1,76,14,7,7
050,30,019,"Montana","Daniels County",1,77,10,5,5
050,30,019,"Montana","Daniels County",1,78,18,11,7
050,30,019,"Montana","Daniels County",1,79,12,7,5
050,30,019,"Montana","Daniels County",1,80,10,3,7
050,30,019,"Montana","Daniels County",1,81,9,3,6
050,30,019,"Montana","Daniels County",1,82,13,8,5
050,30,019,"Montana","Daniels County",1,83,13,3,10
050,30,019,"Montana","Daniels County",1,84,4,2,2
050,30,019,"Montana","Daniels County",1,85,78,25,53
050,30,019,"Montana","Daniels County",2,0,14,9,5
050,30,019,"Montana","Daniels County",2,1,17,10,7
050,30,019,"Montana","Daniels County",2,2,17,12,5
050,30,019,"Montana","Daniels County",2,3,15,10,5
050,30,019,"Montana","Daniels County",2,4,16,10,6
050,30,019,"Montana","Daniels County",2,5,20,10,10
050,30,019,"Montana","Daniels County",2,6,21,9,12
050,30,019,"Montana","Daniels County",2,7,22,9,13
050,30,019,"Montana","Daniels County",2,8,21,11,10
050,30,019,"Montana","Daniels County",2,9,24,14,10
050,30,019,"Montana","Daniels County",2,10,25,13,12
050,30,019,"Montana","Daniels County",2,11,25,14,11
050,30,019,"Montana","Daniels County",2,12,24,15,9
050,30,019,"Montana","Daniels County",2,13,19,11,8
050,30,019,"Montana","Daniels County",2,14,17,7,10
050,30,019,"Montana","Daniels County",2,15,22,10,12
050,30,019,"Montana","Daniels County",2,16,20,12,8
050,30,019,"Montana","Daniels County",2,17,21,12,9
050,30,019,"Montana","Daniels County",2,18,21,13,8
050,30,019,"Montana","Daniels County",2,19,15,9,6
050,30,019,"Montana","Daniels County",2,20,12,5,7
050,30,019,"Montana","Daniels County",2,21,12,4,8
050,30,019,"Montana","Daniels County",2,22,14,6,8
050,30,019,"Montana","Daniels County",2,23,16,9,7
050,30,019,"Montana","Daniels County",2,24,13,7,6
050,30,019,"Montana","Daniels County",2,25,11,6,5
050,30,019,"Montana","Daniels County",2,26,13,7,6
050,30,019,"Montana","Daniels County",2,27,19,11,8
050,30,019,"Montana","Daniels County",2,28,17,10,7
050,30,019,"Montana","Daniels County",2,29,22,13,9
050,30,019,"Montana","Daniels County",2,30,19,11,8
050,30,019,"Montana","Daniels County",2,31,17,9,8
050,30,019,"Montana","Daniels County",2,32,11,7,4
050,30,019,"Montana","Daniels County",2,33,17,8,9
050,30,019,"Montana","Daniels County",2,34,17,9,8
050,30,019,"Montana","Daniels County",2,35,18,8,10
050,30,019,"Montana","Daniels County",2,36,22,11,11
050,30,019,"Montana","Daniels County",2,37,19,8,11
050,30,019,"Montana","Daniels County",2,38,18,9,9
050,30,019,"Montana","Daniels County",2,39,19,11,8
050,30,019,"Montana","Daniels County",2,40,18,10,8
050,30,019,"Montana","Daniels County",2,41,18,12,6
050,30,019,"Montana","Daniels County",2,42,21,15,6
050,30,019,"Montana","Daniels County",2,43,24,15,9
050,30,019,"Montana","Daniels County",2,44,16,7,9
050,30,019,"Montana","Daniels County",2,45,14,7,7
050,30,019,"Montana","Daniels County",2,46,12,6,6
050,30,019,"Montana","Daniels County",2,47,14,10,4
050,30,019,"Montana","Daniels County",2,48,16,8,8
050,30,019,"Montana","Daniels County",2,49,14,5,9
050,30,019,"Montana","Daniels County",2,50,13,5,8
050,30,019,"Montana","Daniels County",2,51,16,9,7
050,30,019,"Montana","Daniels County",2,52,13,7,6
050,30,019,"Montana","Daniels County",2,53,16,8,8
050,30,019,"Montana","Daniels County",2,54,15,9,6
050,30,019,"Montana","Daniels County",2,55,19,12,7
050,30,019,"Montana","Daniels County",2,56,24,14,10
050,30,019,"Montana","Daniels County",2,57,25,14,11
050,30,019,"Montana","Daniels County",2,58,22,12,10
050,30,019,"Montana","Daniels County",2,59,24,13,11
050,30,019,"Montana","Daniels County",2,60,22,11,11
050,30,019,"Montana","Daniels County",2,61,31,15,16
050,30,019,"Montana","Daniels County",2,62,38,18,20
050,30,019,"Montana","Daniels County",2,63,36,18,18
050,30,019,"Montana","Daniels County",2,64,31,18,13
050,30,019,"Montana","Daniels County",2,65,27,15,12
050,30,019,"Montana","Daniels County",2,66,27,14,13
050,30,019,"Montana","Daniels County",2,67,24,16,8
050,30,019,"Montana","Daniels County",2,68,24,16,8
050,30,019,"Montana","Daniels County",2,69,22,11,11
050,30,019,"Montana","Daniels County",2,70,20,9,11
050,30,019,"Montana","Daniels County",2,71,22,12,10
050,30,019,"Montana","Daniels County",2,72,18,9,9
050,30,019,"Montana","Daniels County",2,73,20,11,9
050,30,019,"Montana","Daniels County",2,74,16,8,8
050,30,019,"Montana","Daniels County",2,75,17,10,7
050,30,019,"Montana","Daniels County",2,76,15,8,7
050,30,019,"Montana","Daniels County",2,77,12,6,6
050,30,019,"Montana","Daniels County",2,78,17,10,7
050,30,019,"Montana","Daniels County",2,79,13,8,5
050,30,019,"Montana","Daniels County",2,80,10,4,6
050,30,019,"Montana","Daniels County",2,81,9,3,6
050,30,019,"Montana","Daniels County",2,82,12,7,5
050,30,019,"Montana","Daniels County",2,83,12,4,8
050,30,019,"Montana","Daniels County",2,84,6,2,4
050,30,019,"Montana","Daniels County",2,85,77,24,53
050,30,019,"Montana","Daniels County",3,0,11,5,6
050,30,019,"Montana","Daniels County",3,1,16,9,7
050,30,019,"Montana","Daniels County",3,2,18,10,8
050,30,019,"Montana","Daniels County",3,3,17,11,6
050,30,019,"Montana","Daniels County",3,4,17,9,8
050,30,019,"Montana","Daniels County",3,5,15,9,6
050,30,019,"Montana","Daniels County",3,6,19,10,9
050,30,019,"Montana","Daniels County",3,7,20,8,12
050,30,019,"Montana","Daniels County",3,8,23,9,14
050,30,019,"Montana","Daniels County",3,9,22,12,10
050,30,019,"Montana","Daniels County",3,10,23,13,10
050,30,019,"Montana","Daniels County",3,11,24,14,10
050,30,019,"Montana","Daniels County",3,12,27,14,13
050,30,019,"Montana","Daniels County",3,13,26,16,10
050,30,019,"Montana","Daniels County",3,14,20,12,8
050,30,019,"Montana","Daniels County",3,15,18,7,11
050,30,019,"Montana","Daniels County",3,16,23,11,12
050,30,019,"Montana","Daniels County",3,17,21,13,8
050,30,019,"Montana","Daniels County",3,18,17,10,7
050,30,019,"Montana","Daniels County",3,19,18,11,7
050,30,019,"Montana","Daniels County",3,20,17,11,6
050,30,019,"Montana","Daniels County",3,21,10,4,6
050,30,019,"Montana","Daniels County",3,22,12,5,7
050,30,019,"Montana","Daniels County",3,23,16,7,9
050,30,019,"Montana","Daniels County",3,24,24,13,11
050,30,019,"Montana","Daniels County",3,25,14,7,7
050,30,019,"Montana","Daniels County",3,26,12,6,6
050,30,019,"Montana","Daniels County",3,27,14,7,7
050,30,019,"Montana","Daniels County",3,28,20,11,9
050,30,019,"Montana","Daniels County",3,29,21,11,10
050,30,019,"Montana","Daniels County",3,30,22,12,10
050,30,019,"Montana","Daniels County",3,31,19,11,8
050,30,019,"Montana","Daniels County",3,32,17,8,9
050,30,019,"Montana","Daniels County",3,33,10,8,2
050,30,019,"Montana","Daniels County",3,34,16,8,8
050,30,019,"Montana","Daniels County",3,35,19,11,8
050,30,019,"Montana","Daniels County",3,36,18,8,10
050,30,019,"Montana","Daniels County",3,37,22,11,11
050,30,019,"Montana","Daniels County",3,38,21,11,10
050,30,019,"Montana","Daniels County",3,39,16,6,10
050,30,019,"Montana","Daniels County",3,40,19,11,8
050,30,019,"Montana","Daniels County",3,41,19,10,9
050,30,019,"Montana","Daniels County",3,42,18,12,6
050,30,019,"Montana","Daniels County",3,43,20,14,6
050,30,019,"Montana","Daniels County",3,44,26,16,10
050,30,019,"Montana","Daniels County",3,45,17,7,10
050,30,019,"Montana","Daniels County",3,46,15,7,8
050,30,019,"Montana","Daniels County",3,47,12,6,6
050,30,019,"Montana","Daniels County",3,48,14,10,4
050,30,019,"Montana","Daniels County",3,49,16,8,8
050,30,019,"Montana","Daniels County",3,50,15,6,9
050,30,019,"Montana","Daniels County",3,51,12,5,7
050,30,019,"Montana","Daniels County",3,52,16,9,7
050,30,019,"Montana","Daniels County",3,53,13,7,6
050,30,019,"Montana","Daniels County",3,54,19,10,9
050,30,019,"Montana","Daniels County",3,55,15,9,6
050,30,019,"Montana","Daniels County",3,56,19,12,7
050,30,019,"Montana","Daniels County",3,57,24,14,10
050,30,019,"Montana","Daniels County",3,58,24,13,11
050,30,019,"Montana","Daniels County",3,59,21,11,10
050,30,019,"Montana","Daniels County",3,60,23,11,12
050,30,019,"Montana","Daniels County",3,61,22,11,11
050,30,019,"Montana","Daniels County",3,62,30,14,16
050,30,019,"Montana","Daniels County",3,63,39,20,19
050,30,019,"Montana","Daniels County",3,64,37,18,19
050,30,019,"Montana","Daniels County",3,65,32,18,14
050,30,019,"Montana","Daniels County",3,66,28,16,12
050,30,019,"Montana","Daniels County",3,67,26,13,13
050,30,019,"Montana","Daniels County",3,68,22,14,8
050,30,019,"Montana","Daniels County",3,69,24,16,8
050,30,019,"Montana","Daniels County",3,70,22,11,11
050,30,019,"Montana","Daniels County",3,71,20,9,11
050,30,019,"Montana","Daniels County",3,72,23,12,11
050,30,019,"Montana","Daniels County",3,73,18,9,9
050,30,019,"Montana","Daniels County",3,74,20,11,9
050,30,019,"Montana","Daniels County",3,75,16,8,8
050,30,019,"Montana","Daniels County",3,76,16,10,6
050,30,019,"Montana","Daniels County",3,77,14,7,7
050,30,019,"Montana","Daniels County",3,78,14,7,7
050,30,019,"Montana","Daniels County",3,79,13,8,5
050,30,019,"Montana","Daniels County",3,80,13,8,5
050,30,019,"Montana","Daniels County",3,81,11,5,6
050,30,019,"Montana","Daniels County",3,82,8,2,6
050,30,019,"Montana","Daniels County",3,83,11,6,5
050,30,019,"Montana","Daniels County",3,84,11,4,7
050,30,019,"Montana","Daniels County",3,85,69,17,52
050,30,019,"Montana","Daniels County",4,0,15,7,8
050,30,019,"Montana","Daniels County",4,1,10,4,6
050,30,019,"Montana","Daniels County",4,2,16,9,7
050,30,019,"Montana","Daniels County",4,3,20,11,9
050,30,019,"Montana","Daniels County",4,4,17,12,5
050,30,019,"Montana","Daniels County",4,5,17,9,8
050,30,019,"Montana","Daniels County",4,6,15,9,6
050,30,019,"Montana","Daniels County",4,7,17,8,9
050,30,019,"Montana","Daniels County",4,8,20,8,12
050,30,019,"Montana","Daniels County",4,9,24,9,15
050,30,019,"Montana","Daniels County",4,10,21,11,10
050,30,019,"Montana","Daniels County",4,11,23,15,8
050,30,019,"Montana","Daniels County",4,12,28,14,14
050,30,019,"Montana","Daniels County",4,13,26,14,12
050,30,019,"Montana","Daniels County",4,14,24,15,9
050,30,019,"Montana","Daniels County",4,15,21,12,9
050,30,019,"Montana","Daniels County",4,16,17,7,10
050,30,019,"Montana","Daniels County",4,17,23,11,12
050,30,019,"Montana","Daniels County",4,18,19,11,8
050,30,019,"Montana","Daniels County",4,19,15,10,5
050,30,019,"Montana","Daniels County",4,20,15,8,7
050,30,019,"Montana","Daniels County",4,21,18,11,7
050,30,019,"Montana","Daniels County",4,22,10,4,6
050,30,019,"Montana","Daniels County",4,23,10,3,7
050,30,019,"Montana","Daniels County",4,24,18,7,11
050,30,019,"Montana","Daniels County",4,25,21,10,11
050,30,019,"Montana","Daniels County",4,26,12,6,6
050,30,019,"Montana","Daniels County",4,27,12,6,6
050,30,019,"Montana","Daniels County",4,28,14,9,5
050,30,019,"Montana","Daniels County",4,29,19,10,9
050,30,019,"Montana","Daniels County",4,30,25,11,14
050,30,019,"Montana","Daniels County",4,31,21,11,10
050,30,019,"Montana","Daniels County",4,32,20,12,8
050,30,019,"Montana","Daniels County",4,33,18,9,9
050,30,019,"Montana","Daniels County",4,34,10,8,2
050,30,019,"Montana","Daniels County",4,35,15,7,8
050,30,019,"Montana","Daniels County",4,36,18,10,8
050,30,019,"Montana","Daniels County",4,37,20,8,12
050,30,019,"Montana","Daniels County",4,38,22,12,10
050,30,019,"Montana","Daniels County",4,39,18,9,9
050,30,019,"Montana","Daniels County",4,40,13,6,7
050,30,019,"Montana","Daniels County",4,41,17,10,7
050,30,019,"Montana","Daniels County",4,42,18,10,8
050,30,019,"Montana","Daniels County",4,43,17,12,5
050,30,019,"Montana","Daniels County",4,44,19,13,6
050,30,019,"Montana","Daniels County",4,45,24,15,9
050,30,019,"Montana","Daniels County",4,46,17,7,10
050,30,019,"Montana","Daniels County",4,47,15,7,8
050,30,019,"Montana","Daniels County",4,48,13,6,7
050,30,019,"Montana","Daniels County",4,49,17,13,4
050,30,019,"Montana","Daniels County",4,50,17,8,9
050,30,019,"Montana","Daniels County",4,51,14,5,9
050,30,019,"Montana","Daniels County",4,52,13,5,8
050,30,019,"Montana","Daniels County",4,53,16,9,7
050,30,019,"Montana","Daniels County",4,54,16,8,8
050,30,019,"Montana","Daniels County",4,55,17,11,6
050,30,019,"Montana","Daniels County",4,56,16,9,7
050,30,019,"Montana","Daniels County",4,57,18,11,7
050,30,019,"Montana","Daniels County",4,58,25,14,11
050,30,019,"Montana","Daniels County",4,59,25,12,13
050,30,019,"Montana","Daniels County",4,60,21,11,10
050,30,019,"Montana","Daniels County",4,61,20,11,9
050,30,019,"Montana","Daniels County",4,62,22,11,11
050,30,019,"Montana","Daniels County",4,63,31,15,16
050,30,019,"Montana","Daniels County",4,64,39,20,19
050,30,019,"Montana","Daniels County",4,65,37,18,19
050,30,019,"Montana","Daniels County",4,66,31,18,13
050,30,019,"Montana","Daniels County",4,67,25,15,10
050,30,019,"Montana","Daniels County",4,68,24,12,12
050,30,019,"Montana","Daniels County",4,69,24,14,10
050,30,019,"Montana","Daniels County",4,70,22,14,8
050,30,019,"Montana","Daniels County",4,71,22,12,10
050,30,019,"Montana","Daniels County",4,72,21,9,12
050,30,019,"Montana","Daniels County",4,73,22,12,10
050,30,019,"Montana","Daniels County",4,74,16,9,7
050,30,019,"Montana","Daniels County",4,75,19,10,9
050,30,019,"Montana","Daniels County",4,76,14,8,6
050,30,019,"Montana","Daniels County",4,77,17,10,7
050,30,019,"Montana","Daniels County",4,78,15,7,8
050,30,019,"Montana","Daniels County",4,79,11,6,5
050,30,019,"Montana","Daniels County",4,80,13,8,5
050,30,019,"Montana","Daniels County",4,81,14,9,5
050,30,019,"Montana","Daniels County",4,82,10,4,6
050,30,019,"Montana","Daniels County",4,83,6,1,5
050,30,019,"Montana","Daniels County",4,84,11,6,5
050,30,019,"Montana","Daniels County",4,85,67,17,50
050,30,019,"Montana","Daniels County",5,0,15,7,8
050,30,019,"Montana","Daniels County",5,1,15,7,8
050,30,019,"Montana","Daniels County",5,2,10,3,7
050,30,019,"Montana","Daniels County",5,3,12,7,5
050,30,019,"Montana","Daniels County",5,4,26,13,13
050,30,019,"Montana","Daniels County",5,5,18,12,6
050,30,019,"Montana","Daniels County",5,6,18,9,9
050,30,019,"Montana","Daniels County",5,7,14,9,5
050,30,019,"Montana","Daniels County",5,8,14,6,8
050,30,019,"Montana","Daniels County",5,9,20,8,12
050,30,019,"Montana","Daniels County",5,10,24,10,14
050,30,019,"Montana","Daniels County",5,11,19,9,10
050,30,019,"Montana","Daniels County",5,12,22,14,8
050,30,019,"Montana","Daniels County",5,13,27,14,13
050,30,019,"Montana","Daniels County",5,14,26,14,12
050,30,019,"Montana","Daniels County",5,15,25,15,10
050,30,019,"Montana","Daniels County",5,16,21,12,9
050,30,019,"Montana","Daniels County",5,17,18,8,10
050,30,019,"Montana","Daniels County",5,18,17,9,8
050,30,019,"Montana","Daniels County",5,19,16,9,7
050,30,019,"Montana","Daniels County",5,20,14,10,4
050,30,019,"Montana","Daniels County",5,21,15,7,8
050,30,019,"Montana","Daniels County",5,22,21,13,8
050,30,019,"Montana","Daniels County",5,23,10,4,6
050,30,019,"Montana","Daniels County",5,24,8,5,3
050,30,019,"Montana","Daniels County",5,25,19,6,13
050,30,019,"Montana","Daniels County",5,26,22,10,12
050,30,019,"Montana","Daniels County",5,27,16,10,6
050,30,019,"Montana","Daniels County",5,28,15,7,8
050,30,019,"Montana","Daniels County",5,29,14,8,6
050,30,019,"Montana","Daniels County",5,30,19,10,9
050,30,019,"Montana","Daniels County",5,31,26,11,15
050,30,019,"Montana","Daniels County",5,32,22,12,10
050,30,019,"Montana","Daniels County",5,33,19,11,8
050,30,019,"Montana","Daniels County",5,34,18,8,10
050,30,019,"Montana","Daniels County",5,35,10,8,2
050,30,019,"Montana","Daniels County",5,36,17,8,9
050,30,019,"Montana","Daniels County",5,37,14,6,8
050,30,019,"Montana","Daniels County",5,38,20,8,12
050,30,019,"Montana","Daniels County",5,39,24,13,11
050,30,019,"Montana","Daniels County",5,40,18,9,9
050,30,019,"Montana","Daniels County",5,41,13,7,6
050,30,019,"Montana","Daniels County",5,42,17,10,7
050,30,019,"Montana","Daniels County",5,43,18,10,8
050,30,019,"Montana","Daniels County",5,44,19,14,5
050,30,019,"Montana","Daniels County",5,45,18,13,5
050,30,019,"Montana","Daniels County",5,46,24,15,9
050,30,019,"Montana","Daniels County",5,47,18,8,10
050,30,019,"Montana","Daniels County",5,48,15,7,8
050,30,019,"Montana","Daniels County",5,49,12,6,6
050,30,019,"Montana","Daniels County",5,50,18,14,4
050,30,019,"Montana","Daniels County",5,51,19,10,9
050,30,019,"Montana","Daniels County",5,52,14,5,9
050,30,019,"Montana","Daniels County",5,53,13,5,8
050,30,019,"Montana","Daniels County",5,54,15,9,6
050,30,019,"Montana","Daniels County",5,55,18,11,7
050,30,019,"Montana","Daniels County",5,56,17,11,6
050,30,019,"Montana","Daniels County",5,57,16,9,7
050,30,019,"Montana","Daniels County",5,58,17,10,7
050,30,019,"Montana","Daniels County",5,59,24,13,11
050,30,019,"Montana","Daniels County",5,60,24,11,13
050,30,019,"Montana","Daniels County",5,61,23,13,10
050,30,019,"Montana","Daniels County",5,62,18,11,7
050,30,019,"Montana","Daniels County",5,63,25,14,11
050,30,019,"Montana","Daniels County",5,64,31,15,16
050,30,019,"Montana","Daniels County",5,65,39,20,19
050,30,019,"Montana","Daniels County",5,66,37,19,18
050,30,019,"Montana","Daniels County",5,67,28,17,11
050,30,019,"Montana","Daniels County",5,68,23,14,9
050,30,019,"Montana","Daniels County",5,69,23,11,12
050,30,019,"Montana","Daniels County",5,70,22,14,8
050,30,019,"Montana","Daniels County",5,71,21,13,8
050,30,019,"Montana","Daniels County",5,72,21,10,11
050,30,019,"Montana","Daniels County",5,73,20,9,11
050,30,019,"Montana","Daniels County",5,74,20,12,8
050,30,019,"Montana","Daniels County",5,75,15,8,7
050,30,019,"Montana","Daniels County",5,76,17,10,7
050,30,019,"Montana","Daniels County",5,77,14,8,6
050,30,019,"Montana","Daniels County",5,78,19,11,8
050,30,019,"Montana","Daniels County",5,79,13,6,7
050,30,019,"Montana","Daniels County",5,80,10,6,4
050,30,019,"Montana","Daniels County",5,81,13,8,5
050,30,019,"Montana","Daniels County",5,82,13,8,5
050,30,019,"Montana","Daniels County",5,83,8,3,5
050,30,019,"Montana","Daniels County",5,84,6,1,5
050,30,019,"Montana","Daniels County",5,85,67,19,48
050,30,021,"Montana","Dawson County",1,0,95,49,46
050,30,021,"Montana","Dawson County",1,1,104,52,52
050,30,021,"Montana","Dawson County",1,2,91,42,49
050,30,021,"Montana","Dawson County",1,3,106,50,56
050,30,021,"Montana","Dawson County",1,4,118,60,58
050,30,021,"Montana","Dawson County",1,5,118,62,56
050,30,021,"Montana","Dawson County",1,6,104,51,53
050,30,021,"Montana","Dawson County",1,7,101,54,47
050,30,021,"Montana","Dawson County",1,8,103,62,41
050,30,021,"Montana","Dawson County",1,9,115,61,54
050,30,021,"Montana","Dawson County",1,10,110,57,53
050,30,021,"Montana","Dawson County",1,11,115,58,57
050,30,021,"Montana","Dawson County",1,12,119,57,62
050,30,021,"Montana","Dawson County",1,13,109,63,46
050,30,021,"Montana","Dawson County",1,14,106,60,46
050,30,021,"Montana","Dawson County",1,15,107,56,51
050,30,021,"Montana","Dawson County",1,16,115,62,53
050,30,021,"Montana","Dawson County",1,17,110,60,50
050,30,021,"Montana","Dawson County",1,18,119,59,60
050,30,021,"Montana","Dawson County",1,19,144,79,65
050,30,021,"Montana","Dawson County",1,20,115,60,55
050,30,021,"Montana","Dawson County",1,21,95,51,44
050,30,021,"Montana","Dawson County",1,22,78,44,34
050,30,021,"Montana","Dawson County",1,23,90,50,40
050,30,021,"Montana","Dawson County",1,24,110,62,48
050,30,021,"Montana","Dawson County",1,25,109,59,50
050,30,021,"Montana","Dawson County",1,26,104,58,46
050,30,021,"Montana","Dawson County",1,27,119,63,56
050,30,021,"Montana","Dawson County",1,28,121,63,58
050,30,021,"Montana","Dawson County",1,29,110,53,57
050,30,021,"Montana","Dawson County",1,30,107,49,58
050,30,021,"Montana","Dawson County",1,31,103,51,52
050,30,021,"Montana","Dawson County",1,32,101,54,47
050,30,021,"Montana","Dawson County",1,33,107,60,47
050,30,021,"Montana","Dawson County",1,34,126,77,49
050,30,021,"Montana","Dawson County",1,35,113,60,53
050,30,021,"Montana","Dawson County",1,36,125,71,54
050,30,021,"Montana","Dawson County",1,37,92,47,45
050,30,021,"Montana","Dawson County",1,38,102,55,47
050,30,021,"Montana","Dawson County",1,39,89,51,38
050,30,021,"Montana","Dawson County",1,40,117,66,51
050,30,021,"Montana","Dawson County",1,41,108,63,45
050,30,021,"Montana","Dawson County",1,42,94,58,36
050,30,021,"Montana","Dawson County",1,43,99,47,52
050,30,021,"Montana","Dawson County",1,44,98,52,46
050,30,021,"Montana","Dawson County",1,45,103,55,48
050,30,021,"Montana","Dawson County",1,46,99,49,50
050,30,021,"Montana","Dawson County",1,47,87,54,33
050,30,021,"Montana","Dawson County",1,48,102,59,43
050,30,021,"Montana","Dawson County",1,49,120,65,55
050,30,021,"Montana","Dawson County",1,50,103,58,45
050,30,021,"Montana","Dawson County",1,51,95,46,49
050,30,021,"Montana","Dawson County",1,52,93,55,38
050,30,021,"Montana","Dawson County",1,53,101,57,44
050,30,021,"Montana","Dawson County",1,54,90,46,44
050,30,021,"Montana","Dawson County",1,55,101,50,51
050,30,021,"Montana","Dawson County",1,56,125,52,73
050,30,021,"Montana","Dawson County",1,57,127,66,61
050,30,021,"Montana","Dawson County",1,58,126,75,51
050,30,021,"Montana","Dawson County",1,59,146,74,72
050,30,021,"Montana","Dawson County",1,60,132,67,65
050,30,021,"Montana","Dawson County",1,61,149,75,74
050,30,021,"Montana","Dawson County",1,62,137,70,67
050,30,021,"Montana","Dawson County",1,63,140,74,66
050,30,021,"Montana","Dawson County",1,64,119,60,59
050,30,021,"Montana","Dawson County",1,65,135,68,67
050,30,021,"Montana","Dawson County",1,66,142,69,73
050,30,021,"Montana","Dawson County",1,67,124,68,56
050,30,021,"Montana","Dawson County",1,68,132,80,52
050,30,021,"Montana","Dawson County",1,69,105,57,48
050,30,021,"Montana","Dawson County",1,70,100,52,48
050,30,021,"Montana","Dawson County",1,71,91,47,44
050,30,021,"Montana","Dawson County",1,72,82,42,40
050,30,021,"Montana","Dawson County",1,73,77,38,39
050,30,021,"Montana","Dawson County",1,74,61,30,31
050,30,021,"Montana","Dawson County",1,75,62,28,34
050,30,021,"Montana","Dawson County",1,76,54,24,30
050,30,021,"Montana","Dawson County",1,77,67,33,34
050,30,021,"Montana","Dawson County",1,78,53,30,23
050,30,021,"Montana","Dawson County",1,79,58,31,27
050,30,021,"Montana","Dawson County",1,80,39,20,19
050,30,021,"Montana","Dawson County",1,81,41,19,22
050,30,021,"Montana","Dawson County",1,82,33,14,19
050,30,021,"Montana","Dawson County",1,83,52,21,31
050,30,021,"Montana","Dawson County",1,84,39,16,23
050,30,021,"Montana","Dawson County",1,85,261,91,170
050,30,021,"Montana","Dawson County",2,0,95,48,47
050,30,021,"Montana","Dawson County",2,1,102,51,51
050,30,021,"Montana","Dawson County",2,2,95,45,50
050,30,021,"Montana","Dawson County",2,3,101,48,53
050,30,021,"Montana","Dawson County",2,4,115,57,58
050,30,021,"Montana","Dawson County",2,5,118,62,56
050,30,021,"Montana","Dawson County",2,6,107,54,53
050,30,021,"Montana","Dawson County",2,7,102,54,48
050,30,021,"Montana","Dawson County",2,8,102,59,43
050,30,021,"Montana","Dawson County",2,9,113,61,52
050,30,021,"Montana","Dawson County",2,10,111,59,52
050,30,021,"Montana","Dawson County",2,11,112,57,55
050,30,021,"Montana","Dawson County",2,12,117,57,60
050,30,021,"Montana","Dawson County",2,13,111,61,50
050,30,021,"Montana","Dawson County",2,14,106,60,46
050,30,021,"Montana","Dawson County",2,15,106,56,50
050,30,021,"Montana","Dawson County",2,16,113,60,53
050,30,021,"Montana","Dawson County",2,17,110,59,51
050,30,021,"Montana","Dawson County",2,18,112,58,54
050,30,021,"Montana","Dawson County",2,19,141,76,65
050,30,021,"Montana","Dawson County",2,20,116,61,55
050,30,021,"Montana","Dawson County",2,21,98,52,46
050,30,021,"Montana","Dawson County",2,22,81,45,36
050,30,021,"Montana","Dawson County",2,23,89,50,39
050,30,021,"Montana","Dawson County",2,24,107,61,46
050,30,021,"Montana","Dawson County",2,25,109,59,50
050,30,021,"Montana","Dawson County",2,26,109,61,48
050,30,021,"Montana","Dawson County",2,27,117,63,54
050,30,021,"Montana","Dawson County",2,28,121,64,57
050,30,021,"Montana","Dawson County",2,29,108,52,56
050,30,021,"Montana","Dawson County",2,30,107,49,58
050,30,021,"Montana","Dawson County",2,31,104,50,54
050,30,021,"Montana","Dawson County",2,32,102,54,48
050,30,021,"Montana","Dawson County",2,33,107,60,47
050,30,021,"Montana","Dawson County",2,34,121,72,49
050,30,021,"Montana","Dawson County",2,35,118,65,53
050,30,021,"Montana","Dawson County",2,36,122,68,54
050,30,021,"Montana","Dawson County",2,37,99,52,47
050,30,021,"Montana","Dawson County",2,38,100,54,46
050,30,021,"Montana","Dawson County",2,39,94,54,40
050,30,021,"Montana","Dawson County",2,40,111,63,48
050,30,021,"Montana","Dawson County",2,41,108,61,47
050,30,021,"Montana","Dawson County",2,42,98,60,38
050,30,021,"Montana","Dawson County",2,43,99,50,49
050,30,021,"Montana","Dawson County",2,44,96,51,45
050,30,021,"Montana","Dawson County",2,45,102,55,47
050,30,021,"Montana","Dawson County",2,46,99,49,50
050,30,021,"Montana","Dawson County",2,47,91,54,37
050,30,021,"Montana","Dawson County",2,48,98,57,41
050,30,021,"Montana","Dawson County",2,49,118,65,53
050,30,021,"Montana","Dawson County",2,50,106,58,48
050,30,021,"Montana","Dawson County",2,51,95,48,47
050,30,021,"Montana","Dawson County",2,52,94,53,41
050,30,021,"Montana","Dawson County",2,53,97,56,41
050,30,021,"Montana","Dawson County",2,54,92,48,44
050,30,021,"Montana","Dawson County",2,55,99,49,50
050,30,021,"Montana","Dawson County",2,56,120,52,68
050,30,021,"Montana","Dawson County",2,57,125,62,63
050,30,021,"Montana","Dawson County",2,58,125,72,53
050,30,021,"Montana","Dawson County",2,59,142,74,68
050,30,021,"Montana","Dawson County",2,60,136,68,68
050,30,021,"Montana","Dawson County",2,61,143,72,71
050,30,021,"Montana","Dawson County",2,62,139,71,68
050,30,021,"Montana","Dawson County",2,63,138,72,66
050,30,021,"Montana","Dawson County",2,64,123,63,60
050,30,021,"Montana","Dawson County",2,65,132,67,65
050,30,021,"Montana","Dawson County",2,66,139,68,71
050,30,021,"Montana","Dawson County",2,67,126,67,59
050,30,021,"Montana","Dawson County",2,68,129,76,53
050,30,021,"Montana","Dawson County",2,69,110,61,49
050,30,021,"Montana","Dawson County",2,70,99,51,48
050,30,021,"Montana","Dawson County",2,71,93,47,46
050,30,021,"Montana","Dawson County",2,72,83,43,40
050,30,021,"Montana","Dawson County",2,73,84,42,42
050,30,021,"Montana","Dawson County",2,74,59,29,30
050,30,021,"Montana","Dawson County",2,75,62,28,34
050,30,021,"Montana","Dawson County",2,76,55,25,30
050,30,021,"Montana","Dawson County",2,77,64,31,33
050,30,021,"Montana","Dawson County",2,78,55,30,25
050,30,021,"Montana","Dawson County",2,79,56,30,26
050,30,021,"Montana","Dawson County",2,80,43,22,21
050,30,021,"Montana","Dawson County",2,81,38,19,19
050,30,021,"Montana","Dawson County",2,82,35,15,20
050,30,021,"Montana","Dawson County",2,83,48,19,29
050,30,021,"Montana","Dawson County",2,84,40,16,24
050,30,021,"Montana","Dawson County",2,85,262,90,172
050,30,021,"Montana","Dawson County",3,0,87,42,45
050,30,021,"Montana","Dawson County",3,1,92,45,47
050,30,021,"Montana","Dawson County",3,2,100,53,47
050,30,021,"Montana","Dawson County",3,3,93,43,50
050,30,021,"Montana","Dawson County",3,4,99,47,52
050,30,021,"Montana","Dawson County",3,5,114,54,60
050,30,021,"Montana","Dawson County",3,6,115,60,55
050,30,021,"Montana","Dawson County",3,7,113,60,53
050,30,021,"Montana","Dawson County",3,8,94,50,44
050,30,021,"Montana","Dawson County",3,9,107,58,49
050,30,021,"Montana","Dawson County",3,10,112,58,54
050,30,021,"Montana","Dawson County",3,11,113,61,52
050,30,021,"Montana","Dawson County",3,12,115,62,53
050,30,021,"Montana","Dawson County",3,13,125,66,59
050,30,021,"Montana","Dawson County",3,14,107,58,49
050,30,021,"Montana","Dawson County",3,15,110,64,46
050,30,021,"Montana","Dawson County",3,16,107,57,50
050,30,021,"Montana","Dawson County",3,17,115,59,56
050,30,021,"Montana","Dawson County",3,18,107,61,46
050,30,021,"Montana","Dawson County",3,19,135,71,64
050,30,021,"Montana","Dawson County",3,20,123,62,61
050,30,021,"Montana","Dawson County",3,21,107,59,48
050,30,021,"Montana","Dawson County",3,22,93,52,41
050,30,021,"Montana","Dawson County",3,23,87,42,45
050,30,021,"Montana","Dawson County",3,24,98,60,38
050,30,021,"Montana","Dawson County",3,25,96,47,49
050,30,021,"Montana","Dawson County",3,26,107,58,49
050,30,021,"Montana","Dawson County",3,27,106,63,43
050,30,021,"Montana","Dawson County",3,28,120,69,51
050,30,021,"Montana","Dawson County",3,29,111,54,57
050,30,021,"Montana","Dawson County",3,30,113,55,58
050,30,021,"Montana","Dawson County",3,31,111,49,62
050,30,021,"Montana","Dawson County",3,32,100,49,51
050,30,021,"Montana","Dawson County",3,33,108,58,50
050,30,021,"Montana","Dawson County",3,34,103,54,49
050,30,021,"Montana","Dawson County",3,35,119,70,49
050,30,021,"Montana","Dawson County",3,36,116,62,54
050,30,021,"Montana","Dawson County",3,37,108,62,46
050,30,021,"Montana","Dawson County",3,38,98,53,45
050,30,021,"Montana","Dawson County",3,39,97,53,44
050,30,021,"Montana","Dawson County",3,40,101,60,41
050,30,021,"Montana","Dawson County",3,41,111,61,50
050,30,021,"Montana","Dawson County",3,42,110,62,48
050,30,021,"Montana","Dawson County",3,43,105,61,44
050,30,021,"Montana","Dawson County",3,44,92,47,45
050,30,021,"Montana","Dawson County",3,45,96,51,45
050,30,021,"Montana","Dawson County",3,46,105,53,52
050,30,021,"Montana","Dawson County",3,47,100,53,47
050,30,021,"Montana","Dawson County",3,48,87,51,36
050,30,021,"Montana","Dawson County",3,49,99,59,40
050,30,021,"Montana","Dawson County",3,50,112,60,52
050,30,021,"Montana","Dawson County",3,51,101,52,49
050,30,021,"Montana","Dawson County",3,52,98,52,46
050,30,021,"Montana","Dawson County",3,53,91,50,41
050,30,021,"Montana","Dawson County",3,54,94,58,36
050,30,021,"Montana","Dawson County",3,55,88,44,44
050,30,021,"Montana","Dawson County",3,56,101,51,50
050,30,021,"Montana","Dawson County",3,57,118,53,65
050,30,021,"Montana","Dawson County",3,58,129,65,64
050,30,021,"Montana","Dawson County",3,59,122,70,52
050,30,021,"Montana","Dawson County",3,60,140,73,67
050,30,021,"Montana","Dawson County",3,61,141,70,71
050,30,021,"Montana","Dawson County",3,62,141,73,68
050,30,021,"Montana","Dawson County",3,63,138,69,69
050,30,021,"Montana","Dawson County",3,64,131,71,60
050,30,021,"Montana","Dawson County",3,65,117,63,54
050,30,021,"Montana","Dawson County",3,66,124,61,63
050,30,021,"Montana","Dawson County",3,67,127,61,66
050,30,021,"Montana","Dawson County",3,68,129,70,59
050,30,021,"Montana","Dawson County",3,69,126,71,55
050,30,021,"Montana","Dawson County",3,70,107,58,49
050,30,021,"Montana","Dawson County",3,71,97,47,50
050,30,021,"Montana","Dawson County",3,72,86,46,40
050,30,021,"Montana","Dawson County",3,73,83,44,39
050,30,021,"Montana","Dawson County",3,74,79,38,41
050,30,021,"Montana","Dawson County",3,75,59,29,30
050,30,021,"Montana","Dawson County",3,76,60,27,33
050,30,021,"Montana","Dawson County",3,77,57,27,30
050,30,021,"Montana","Dawson County",3,78,61,29,32
050,30,021,"Montana","Dawson County",3,79,56,30,26
050,30,021,"Montana","Dawson County",3,80,54,27,27
050,30,021,"Montana","Dawson County",3,81,42,22,20
050,30,021,"Montana","Dawson County",3,82,35,15,20
050,30,021,"Montana","Dawson County",3,83,38,16,22
050,30,021,"Montana","Dawson County",3,84,39,15,24
050,30,021,"Montana","Dawson County",3,85,250,78,172
050,30,021,"Montana","Dawson County",4,0,85,42,43
050,30,021,"Montana","Dawson County",4,1,96,51,45
050,30,021,"Montana","Dawson County",4,2,87,41,46
050,30,021,"Montana","Dawson County",4,3,94,48,46
050,30,021,"Montana","Dawson County",4,4,92,46,46
050,30,021,"Montana","Dawson County",4,5,102,46,56
050,30,021,"Montana","Dawson County",4,6,115,59,56
050,30,021,"Montana","Dawson County",4,7,115,58,57
050,30,021,"Montana","Dawson County",4,8,114,62,52
050,30,021,"Montana","Dawson County",4,9,93,50,43
050,30,021,"Montana","Dawson County",4,10,98,53,45
050,30,021,"Montana","Dawson County",4,11,117,62,55
050,30,021,"Montana","Dawson County",4,12,117,63,54
050,30,021,"Montana","Dawson County",4,13,111,60,51
050,30,021,"Montana","Dawson County",4,14,123,64,59
050,30,021,"Montana","Dawson County",4,15,109,61,48
050,30,021,"Montana","Dawson County",4,16,119,68,51
050,30,021,"Montana","Dawson County",4,17,116,60,56
050,30,021,"Montana","Dawson County",4,18,108,58,50
050,30,021,"Montana","Dawson County",4,19,125,71,54
050,30,021,"Montana","Dawson County",4,20,119,63,56
050,30,021,"Montana","Dawson County",4,21,106,53,53
050,30,021,"Montana","Dawson County",4,22,105,60,45
050,30,021,"Montana","Dawson County",4,23,95,48,47
050,30,021,"Montana","Dawson County",4,24,82,44,38
050,30,021,"Montana","Dawson County",4,25,89,52,37
050,30,021,"Montana","Dawson County",4,26,99,53,46
050,30,021,"Montana","Dawson County",4,27,104,60,44
050,30,021,"Montana","Dawson County",4,28,105,65,40
050,30,021,"Montana","Dawson County",4,29,107,60,47
050,30,021,"Montana","Dawson County",4,30,106,52,54
050,30,021,"Montana","Dawson County",4,31,113,53,60
050,30,021,"Montana","Dawson County",4,32,108,47,61
050,30,021,"Montana","Dawson County",4,33,104,53,51
050,30,021,"Montana","Dawson County",4,34,107,53,54
050,30,021,"Montana","Dawson County",4,35,103,53,50
050,30,021,"Montana","Dawson County",4,36,121,70,51
050,30,021,"Montana","Dawson County",4,37,115,61,54
050,30,021,"Montana","Dawson County",4,38,107,62,45
050,30,021,"Montana","Dawson County",4,39,100,53,47
050,30,021,"Montana","Dawson County",4,40,105,62,43
050,30,021,"Montana","Dawson County",4,41,96,55,41
050,30,021,"Montana","Dawson County",4,42,119,65,54
050,30,021,"Montana","Dawson County",4,43,119,63,56
050,30,021,"Montana","Dawson County",4,44,102,60,42
050,30,021,"Montana","Dawson County",4,45,89,48,41
050,30,021,"Montana","Dawson County",4,46,101,54,47
050,30,021,"Montana","Dawson County",4,47,107,54,53
050,30,021,"Montana","Dawson County",4,48,97,50,47
050,30,021,"Montana","Dawson County",4,49,93,55,38
050,30,021,"Montana","Dawson County",4,50,95,56,39
050,30,021,"Montana","Dawson County",4,51,105,55,50
050,30,021,"Montana","Dawson County",4,52,101,51,50
050,30,021,"Montana","Dawson County",4,53,99,55,44
050,30,021,"Montana","Dawson County",4,54,87,51,36
050,30,021,"Montana","Dawson County",4,55,93,55,38
050,30,021,"Montana","Dawson County",4,56,90,44,46
050,30,021,"Montana","Dawson County",4,57,102,54,48
050,30,021,"Montana","Dawson County",4,58,115,47,68
050,30,021,"Montana","Dawson County",4,59,129,63,66
050,30,021,"Montana","Dawson County",4,60,119,65,54
050,30,021,"Montana","Dawson County",4,61,133,71,62
050,30,021,"Montana","Dawson County",4,62,141,71,70
050,30,021,"Montana","Dawson County",4,63,145,74,71
050,30,021,"Montana","Dawson County",4,64,139,70,69
050,30,021,"Montana","Dawson County",4,65,132,72,60
050,30,021,"Montana","Dawson County",4,66,109,53,56
050,30,021,"Montana","Dawson County",4,67,113,60,53
050,30,021,"Montana","Dawson County",4,68,131,68,63
050,30,021,"Montana","Dawson County",4,69,118,61,57
050,30,021,"Montana","Dawson County",4,70,120,68,52
050,30,021,"Montana","Dawson County",4,71,104,51,53
050,30,021,"Montana","Dawson County",4,72,92,43,49
050,30,021,"Montana","Dawson County",4,73,90,46,44
050,30,021,"Montana","Dawson County",4,74,80,40,40
050,30,021,"Montana","Dawson County",4,75,83,40,43
050,30,021,"Montana","Dawson County",4,76,57,27,30
050,30,021,"Montana","Dawson County",4,77,60,28,32
050,30,021,"Montana","Dawson County",4,78,55,24,31
050,30,021,"Montana","Dawson County",4,79,59,27,32
050,30,021,"Montana","Dawson County",4,80,50,25,25
050,30,021,"Montana","Dawson County",4,81,53,27,26
050,30,021,"Montana","Dawson County",4,82,37,18,19
050,30,021,"Montana","Dawson County",4,83,42,19,23
050,30,021,"Montana","Dawson County",4,84,27,9,18
050,30,021,"Montana","Dawson County",4,85,243,75,168
050,30,021,"Montana","Dawson County",5,0,83,41,42
050,30,021,"Montana","Dawson County",5,1,94,53,41
050,30,021,"Montana","Dawson County",5,2,92,47,45
050,30,021,"Montana","Dawson County",5,3,91,45,46
050,30,021,"Montana","Dawson County",5,4,91,49,42
050,30,021,"Montana","Dawson County",5,5,92,47,45
050,30,021,"Montana","Dawson County",5,6,106,49,57
050,30,021,"Montana","Dawson County",5,7,118,60,58
050,30,021,"Montana","Dawson County",5,8,117,61,56
050,30,021,"Montana","Dawson County",5,9,108,57,51
050,30,021,"Montana","Dawson County",5,10,94,51,43
050,30,021,"Montana","Dawson County",5,11,97,52,45
050,30,021,"Montana","Dawson County",5,12,123,69,54
050,30,021,"Montana","Dawson County",5,13,113,67,46
050,30,021,"Montana","Dawson County",5,14,120,66,54
050,30,021,"Montana","Dawson County",5,15,127,69,58
050,30,021,"Montana","Dawson County",5,16,103,55,48
050,30,021,"Montana","Dawson County",5,17,123,70,53
050,30,021,"Montana","Dawson County",5,18,104,60,44
050,30,021,"Montana","Dawson County",5,19,134,75,59
050,30,021,"Montana","Dawson County",5,20,103,57,46
050,30,021,"Montana","Dawson County",5,21,107,58,49
050,30,021,"Montana","Dawson County",5,22,91,48,43
050,30,021,"Montana","Dawson County",5,23,108,60,48
050,30,021,"Montana","Dawson County",5,24,93,53,40
050,30,021,"Montana","Dawson County",5,25,73,38,35
050,30,021,"Montana","Dawson County",5,26,91,54,37
050,30,021,"Montana","Dawson County",5,27,105,52,53
050,30,021,"Montana","Dawson County",5,28,107,62,45
050,30,021,"Montana","Dawson County",5,29,98,58,40
050,30,021,"Montana","Dawson County",5,30,118,68,50
050,30,021,"Montana","Dawson County",5,31,112,55,57
050,30,021,"Montana","Dawson County",5,32,127,66,61
050,30,021,"Montana","Dawson County",5,33,112,56,56
050,30,021,"Montana","Dawson County",5,34,97,46,51
050,30,021,"Montana","Dawson County",5,35,112,56,56
050,30,021,"Montana","Dawson County",5,36,108,55,53
050,30,021,"Montana","Dawson County",5,37,122,70,52
050,30,021,"Montana","Dawson County",5,38,114,62,52
050,30,021,"Montana","Dawson County",5,39,110,62,48
050,30,021,"Montana","Dawson County",5,40,109,61,48
050,30,021,"Montana","Dawson County",5,41,107,62,45
050,30,021,"Montana","Dawson County",5,42,98,56,42
050,30,021,"Montana","Dawson County",5,43,118,58,60
050,30,021,"Montana","Dawson County",5,44,121,64,57
050,30,021,"Montana","Dawson County",5,45,97,59,38
050,30,021,"Montana","Dawson County",5,46,90,48,42
050,30,021,"Montana","Dawson County",5,47,103,59,44
050,30,021,"Montana","Dawson County",5,48,104,52,52
050,30,021,"Montana","Dawson County",5,49,106,55,51
050,30,021,"Montana","Dawson County",5,50,92,54,38
050,30,021,"Montana","Dawson County",5,51,86,47,39
050,30,021,"Montana","Dawson County",5,52,111,57,54
050,30,021,"Montana","Dawson County",5,53,100,50,50
050,30,021,"Montana","Dawson County",5,54,98,55,43
050,30,021,"Montana","Dawson County",5,55,83,45,38
050,30,021,"Montana","Dawson County",5,56,97,58,39
050,30,021,"Montana","Dawson County",5,57,87,46,41
050,30,021,"Montana","Dawson County",5,58,103,53,50
050,30,021,"Montana","Dawson County",5,59,111,44,67
050,30,021,"Montana","Dawson County",5,60,126,63,63
050,30,021,"Montana","Dawson County",5,61,119,67,52
050,30,021,"Montana","Dawson County",5,62,132,72,60
050,30,021,"Montana","Dawson County",5,63,141,67,74
050,30,021,"Montana","Dawson County",5,64,143,72,71
050,30,021,"Montana","Dawson County",5,65,136,70,66
050,30,021,"Montana","Dawson County",5,66,126,68,58
050,30,021,"Montana","Dawson County",5,67,103,49,54
050,30,021,"Montana","Dawson County",5,68,115,66,49
050,30,021,"Montana","Dawson County",5,69,129,64,65
050,30,021,"Montana","Dawson County",5,70,113,56,57
050,30,021,"Montana","Dawson County",5,71,116,62,54
050,30,021,"Montana","Dawson County",5,72,97,46,51
050,30,021,"Montana","Dawson County",5,73,92,45,47
050,30,021,"Montana","Dawson County",5,74,89,45,44
050,30,021,"Montana","Dawson County",5,75,84,40,44
050,30,021,"Montana","Dawson County",5,76,78,39,39
050,30,021,"Montana","Dawson County",5,77,56,27,29
050,30,021,"Montana","Dawson County",5,78,54,25,29
050,30,021,"Montana","Dawson County",5,79,56,24,32
050,30,021,"Montana","Dawson County",5,80,53,22,31
050,30,021,"Montana","Dawson County",5,81,47,23,24
050,30,021,"Montana","Dawson County",5,82,47,23,24
050,30,021,"Montana","Dawson County",5,83,40,20,20
050,30,021,"Montana","Dawson County",5,84,31,11,20
050,30,021,"Montana","Dawson County",5,85,228,64,164
050,30,023,"Montana","Deer Lodge County",1,0,72,38,34
050,30,023,"Montana","Deer Lodge County",1,1,60,32,28
050,30,023,"Montana","Deer Lodge County",1,2,61,32,29
050,30,023,"Montana","Deer Lodge County",1,3,80,43,37
050,30,023,"Montana","Deer Lodge County",1,4,59,29,30
050,30,023,"Montana","Deer Lodge County",1,5,61,28,33
050,30,023,"Montana","Deer Lodge County",1,6,63,31,32
050,30,023,"Montana","Deer Lodge County",1,7,49,26,23
050,30,023,"Montana","Deer Lodge County",1,8,59,26,33
050,30,023,"Montana","Deer Lodge County",1,9,71,36,35
050,30,023,"Montana","Deer Lodge County",1,10,78,38,40
050,30,023,"Montana","Deer Lodge County",1,11,73,39,34
050,30,023,"Montana","Deer Lodge County",1,12,71,34,37
050,30,023,"Montana","Deer Lodge County",1,13,60,27,33
050,30,023,"Montana","Deer Lodge County",1,14,61,30,31
050,30,023,"Montana","Deer Lodge County",1,15,73,34,39
050,30,023,"Montana","Deer Lodge County",1,16,97,47,50
050,30,023,"Montana","Deer Lodge County",1,17,118,72,46
050,30,023,"Montana","Deer Lodge County",1,18,122,84,38
050,30,023,"Montana","Deer Lodge County",1,19,111,76,35
050,30,023,"Montana","Deer Lodge County",1,20,101,75,26
050,30,023,"Montana","Deer Lodge County",1,21,101,63,38
050,30,023,"Montana","Deer Lodge County",1,22,113,66,47
050,30,023,"Montana","Deer Lodge County",1,23,93,52,41
050,30,023,"Montana","Deer Lodge County",1,24,95,51,44
050,30,023,"Montana","Deer Lodge County",1,25,97,48,49
050,30,023,"Montana","Deer Lodge County",1,26,90,53,37
050,30,023,"Montana","Deer Lodge County",1,27,96,47,49
050,30,023,"Montana","Deer Lodge County",1,28,118,53,65
050,30,023,"Montana","Deer Lodge County",1,29,103,54,49
050,30,023,"Montana","Deer Lodge County",1,30,129,76,53
050,30,023,"Montana","Deer Lodge County",1,31,118,68,50
050,30,023,"Montana","Deer Lodge County",1,32,129,79,50
050,30,023,"Montana","Deer Lodge County",1,33,105,57,48
050,30,023,"Montana","Deer Lodge County",1,34,95,51,44
050,30,023,"Montana","Deer Lodge County",1,35,94,55,39
050,30,023,"Montana","Deer Lodge County",1,36,105,57,48
050,30,023,"Montana","Deer Lodge County",1,37,111,68,43
050,30,023,"Montana","Deer Lodge County",1,38,103,55,48
050,30,023,"Montana","Deer Lodge County",1,39,107,59,48
050,30,023,"Montana","Deer Lodge County",1,40,98,49,49
050,30,023,"Montana","Deer Lodge County",1,41,112,59,53
050,30,023,"Montana","Deer Lodge County",1,42,120,71,49
050,30,023,"Montana","Deer Lodge County",1,43,112,68,44
050,30,023,"Montana","Deer Lodge County",1,44,108,56,52
050,30,023,"Montana","Deer Lodge County",1,45,101,56,45
050,30,023,"Montana","Deer Lodge County",1,46,115,65,50
050,30,023,"Montana","Deer Lodge County",1,47,115,56,59
050,30,023,"Montana","Deer Lodge County",1,48,137,73,64
050,30,023,"Montana","Deer Lodge County",1,49,137,76,61
050,30,023,"Montana","Deer Lodge County",1,50,123,67,56
050,30,023,"Montana","Deer Lodge County",1,51,122,66,56
050,30,023,"Montana","Deer Lodge County",1,52,130,79,51
050,30,023,"Montana","Deer Lodge County",1,53,128,71,57
050,30,023,"Montana","Deer Lodge County",1,54,128,65,63
050,30,023,"Montana","Deer Lodge County",1,55,131,74,57
050,30,023,"Montana","Deer Lodge County",1,56,148,80,68
050,30,023,"Montana","Deer Lodge County",1,57,165,77,88
050,30,023,"Montana","Deer Lodge County",1,58,175,85,90
050,30,023,"Montana","Deer Lodge County",1,59,187,90,97
050,30,023,"Montana","Deer Lodge County",1,60,168,89,79
050,30,023,"Montana","Deer Lodge County",1,61,175,95,80
050,30,023,"Montana","Deer Lodge County",1,62,160,77,83
050,30,023,"Montana","Deer Lodge County",1,63,166,82,84
050,30,023,"Montana","Deer Lodge County",1,64,178,82,96
050,30,023,"Montana","Deer Lodge County",1,65,165,84,81
050,30,023,"Montana","Deer Lodge County",1,66,173,91,82
050,30,023,"Montana","Deer Lodge County",1,67,193,97,96
050,30,023,"Montana","Deer Lodge County",1,68,171,95,76
050,30,023,"Montana","Deer Lodge County",1,69,161,85,76
050,30,023,"Montana","Deer Lodge County",1,70,144,73,71
050,30,023,"Montana","Deer Lodge County",1,71,152,79,73
050,30,023,"Montana","Deer Lodge County",1,72,138,75,63
050,30,023,"Montana","Deer Lodge County",1,73,122,67,55
050,30,023,"Montana","Deer Lodge County",1,74,78,35,43
050,30,023,"Montana","Deer Lodge County",1,75,95,53,42
050,30,023,"Montana","Deer Lodge County",1,76,92,44,48
050,30,023,"Montana","Deer Lodge County",1,77,100,53,47
050,30,023,"Montana","Deer Lodge County",1,78,69,32,37
050,30,023,"Montana","Deer Lodge County",1,79,66,33,33
050,30,023,"Montana","Deer Lodge County",1,80,53,28,25
050,30,023,"Montana","Deer Lodge County",1,81,57,25,32
050,30,023,"Montana","Deer Lodge County",1,82,60,29,31
050,30,023,"Montana","Deer Lodge County",1,83,56,31,25
050,30,023,"Montana","Deer Lodge County",1,84,45,18,27
050,30,023,"Montana","Deer Lodge County",1,85,193,73,120
050,30,023,"Montana","Deer Lodge County",2,0,67,33,34
050,30,023,"Montana","Deer Lodge County",2,1,62,33,29
050,30,023,"Montana","Deer Lodge County",2,2,61,32,29
050,30,023,"Montana","Deer Lodge County",2,3,73,39,34
050,30,023,"Montana","Deer Lodge County",2,4,66,33,33
050,30,023,"Montana","Deer Lodge County",2,5,62,29,33
050,30,023,"Montana","Deer Lodge County",2,6,65,32,33
050,30,023,"Montana","Deer Lodge County",2,7,52,27,25
050,30,023,"Montana","Deer Lodge County",2,8,56,26,30
050,30,023,"Montana","Deer Lodge County",2,9,67,33,34
050,30,023,"Montana","Deer Lodge County",2,10,76,37,39
050,30,023,"Montana","Deer Lodge County",2,11,73,38,35
050,30,023,"Montana","Deer Lodge County",2,12,72,35,37
050,30,023,"Montana","Deer Lodge County",2,13,63,28,35
050,30,023,"Montana","Deer Lodge County",2,14,60,29,31
050,30,023,"Montana","Deer Lodge County",2,15,68,31,37
050,30,023,"Montana","Deer Lodge County",2,16,94,47,47
050,30,023,"Montana","Deer Lodge County",2,17,120,70,50
050,30,023,"Montana","Deer Lodge County",2,18,114,79,35
050,30,023,"Montana","Deer Lodge County",2,19,111,76,35
050,30,023,"Montana","Deer Lodge County",2,20,103,75,28
050,30,023,"Montana","Deer Lodge County",2,21,99,63,36
050,30,023,"Montana","Deer Lodge County",2,22,109,66,43
050,30,023,"Montana","Deer Lodge County",2,23,95,52,43
050,30,023,"Montana","Deer Lodge County",2,24,93,50,43
050,30,023,"Montana","Deer Lodge County",2,25,96,47,49
050,30,023,"Montana","Deer Lodge County",2,26,90,51,39
050,30,023,"Montana","Deer Lodge County",2,27,95,48,47
050,30,023,"Montana","Deer Lodge County",2,28,113,51,62
050,30,023,"Montana","Deer Lodge County",2,29,110,55,55
050,30,023,"Montana","Deer Lodge County",2,30,124,71,53
050,30,023,"Montana","Deer Lodge County",2,31,120,70,50
050,30,023,"Montana","Deer Lodge County",2,32,128,79,49
050,30,023,"Montana","Deer Lodge County",2,33,111,62,49
050,30,023,"Montana","Deer Lodge County",2,34,98,52,46
050,30,023,"Montana","Deer Lodge County",2,35,96,56,40
050,30,023,"Montana","Deer Lodge County",2,36,102,56,46
050,30,023,"Montana","Deer Lodge County",2,37,110,66,44
050,30,023,"Montana","Deer Lodge County",2,38,105,58,47
050,30,023,"Montana","Deer Lodge County",2,39,105,58,47
050,30,023,"Montana","Deer Lodge County",2,40,101,51,50
050,30,023,"Montana","Deer Lodge County",2,41,111,59,52
050,30,023,"Montana","Deer Lodge County",2,42,120,69,51
050,30,023,"Montana","Deer Lodge County",2,43,119,72,47
050,30,023,"Montana","Deer Lodge County",2,44,107,58,49
050,30,023,"Montana","Deer Lodge County",2,45,103,56,47
050,30,023,"Montana","Deer Lodge County",2,46,113,64,49
050,30,023,"Montana","Deer Lodge County",2,47,115,58,57
050,30,023,"Montana","Deer Lodge County",2,48,130,67,63
050,30,023,"Montana","Deer Lodge County",2,49,139,76,63
050,30,023,"Montana","Deer Lodge County",2,50,124,67,57
050,30,023,"Montana","Deer Lodge County",2,51,121,65,56
050,30,023,"Montana","Deer Lodge County",2,52,127,75,52
050,30,023,"Montana","Deer Lodge County",2,53,128,71,57
050,30,023,"Montana","Deer Lodge County",2,54,126,65,61
050,30,023,"Montana","Deer Lodge County",2,55,128,71,57
050,30,023,"Montana","Deer Lodge County",2,56,148,80,68
050,30,023,"Montana","Deer Lodge County",2,57,165,81,84
050,30,023,"Montana","Deer Lodge County",2,58,172,82,90
050,30,023,"Montana","Deer Lodge County",2,59,186,90,96
050,30,023,"Montana","Deer Lodge County",2,60,173,90,83
050,30,023,"Montana","Deer Lodge County",2,61,175,94,81
050,30,023,"Montana","Deer Lodge County",2,62,163,82,81
050,30,023,"Montana","Deer Lodge County",2,63,164,79,85
050,30,023,"Montana","Deer Lodge County",2,64,174,81,93
050,30,023,"Montana","Deer Lodge County",2,65,170,84,86
050,30,023,"Montana","Deer Lodge County",2,66,173,91,82
050,30,023,"Montana","Deer Lodge County",2,67,187,94,93
050,30,023,"Montana","Deer Lodge County",2,68,174,95,79
050,30,023,"Montana","Deer Lodge County",2,69,163,87,76
050,30,023,"Montana","Deer Lodge County",2,70,149,77,72
050,30,023,"Montana","Deer Lodge County",2,71,152,79,73
050,30,023,"Montana","Deer Lodge County",2,72,139,74,65
050,30,023,"Montana","Deer Lodge County",2,73,129,70,59
050,30,023,"Montana","Deer Lodge County",2,74,80,39,41
050,30,023,"Montana","Deer Lodge County",2,75,92,50,42
050,30,023,"Montana","Deer Lodge County",2,76,90,45,45
050,30,023,"Montana","Deer Lodge County",2,77,99,52,47
050,30,023,"Montana","Deer Lodge County",2,78,74,35,39
050,30,023,"Montana","Deer Lodge County",2,79,66,32,34
050,30,023,"Montana","Deer Lodge County",2,80,55,28,27
050,30,023,"Montana","Deer Lodge County",2,81,56,26,30
050,30,023,"Montana","Deer Lodge County",2,82,59,27,32
050,30,023,"Montana","Deer Lodge County",2,83,56,30,26
050,30,023,"Montana","Deer Lodge County",2,84,47,21,26
050,30,023,"Montana","Deer Lodge County",2,85,194,71,123
050,30,023,"Montana","Deer Lodge County",3,0,64,29,35
050,30,023,"Montana","Deer Lodge County",3,1,61,29,32
050,30,023,"Montana","Deer Lodge County",3,2,55,29,26
050,30,023,"Montana","Deer Lodge County",3,3,62,30,32
050,30,023,"Montana","Deer Lodge County",3,4,67,35,32
050,30,023,"Montana","Deer Lodge County",3,5,71,36,35
050,30,023,"Montana","Deer Lodge County",3,6,58,27,31
050,30,023,"Montana","Deer Lodge County",3,7,65,30,35
050,30,023,"Montana","Deer Lodge County",3,8,52,26,26
050,30,023,"Montana","Deer Lodge County",3,9,59,27,32
050,30,023,"Montana","Deer Lodge County",3,10,61,31,30
050,30,023,"Montana","Deer Lodge County",3,11,74,37,37
050,30,023,"Montana","Deer Lodge County",3,12,72,40,32
050,30,023,"Montana","Deer Lodge County",3,13,73,33,40
050,30,023,"Montana","Deer Lodge County",3,14,66,31,35
050,30,023,"Montana","Deer Lodge County",3,15,56,28,28
050,30,023,"Montana","Deer Lodge County",3,16,81,46,35
050,30,023,"Montana","Deer Lodge County",3,17,128,64,64
050,30,023,"Montana","Deer Lodge County",3,18,107,75,32
050,30,023,"Montana","Deer Lodge County",3,19,110,73,37
050,30,023,"Montana","Deer Lodge County",3,20,110,78,32
050,30,023,"Montana","Deer Lodge County",3,21,96,65,31
050,30,023,"Montana","Deer Lodge County",3,22,105,65,40
050,30,023,"Montana","Deer Lodge County",3,23,100,58,42
050,30,023,"Montana","Deer Lodge County",3,24,96,56,40
050,30,023,"Montana","Deer Lodge County",3,25,112,61,51
050,30,023,"Montana","Deer Lodge County",3,26,87,49,38
050,30,023,"Montana","Deer Lodge County",3,27,91,54,37
050,30,023,"Montana","Deer Lodge County",3,28,94,50,44
050,30,023,"Montana","Deer Lodge County",3,29,130,59,71
050,30,023,"Montana","Deer Lodge County",3,30,104,51,53
050,30,023,"Montana","Deer Lodge County",3,31,125,68,57
050,30,023,"Montana","Deer Lodge County",3,32,130,80,50
050,30,023,"Montana","Deer Lodge County",3,33,121,72,49
050,30,023,"Montana","Deer Lodge County",3,34,116,64,52
050,30,023,"Montana","Deer Lodge County",3,35,112,63,49
050,30,023,"Montana","Deer Lodge County",3,36,100,55,45
050,30,023,"Montana","Deer Lodge County",3,37,101,58,43
050,30,023,"Montana","Deer Lodge County",3,38,113,68,45
050,30,023,"Montana","Deer Lodge County",3,39,115,64,51
050,30,023,"Montana","Deer Lodge County",3,40,108,55,53
050,30,023,"Montana","Deer Lodge County",3,41,112,58,54
050,30,023,"Montana","Deer Lodge County",3,42,105,51,54
050,30,023,"Montana","Deer Lodge County",3,43,128,76,52
050,30,023,"Montana","Deer Lodge County",3,44,111,66,45
050,30,023,"Montana","Deer Lodge County",3,45,107,57,50
050,30,023,"Montana","Deer Lodge County",3,46,111,63,48
050,30,023,"Montana","Deer Lodge County",3,47,108,62,46
050,30,023,"Montana","Deer Lodge County",3,48,125,62,63
050,30,023,"Montana","Deer Lodge County",3,49,141,75,66
050,30,023,"Montana","Deer Lodge County",3,50,143,74,69
050,30,023,"Montana","Deer Lodge County",3,51,138,71,67
050,30,023,"Montana","Deer Lodge County",3,52,136,74,62
050,30,023,"Montana","Deer Lodge County",3,53,125,71,54
050,30,023,"Montana","Deer Lodge County",3,54,127,67,60
050,30,023,"Montana","Deer Lodge County",3,55,122,63,59
050,30,023,"Montana","Deer Lodge County",3,56,129,70,59
050,30,023,"Montana","Deer Lodge County",3,57,155,90,65
050,30,023,"Montana","Deer Lodge County",3,58,157,73,84
050,30,023,"Montana","Deer Lodge County",3,59,173,82,91
050,30,023,"Montana","Deer Lodge County",3,60,194,92,102
050,30,023,"Montana","Deer Lodge County",3,61,178,94,84
050,30,023,"Montana","Deer Lodge County",3,62,176,95,81
050,30,023,"Montana","Deer Lodge County",3,63,164,82,82
050,30,023,"Montana","Deer Lodge County",3,64,169,80,89
050,30,023,"Montana","Deer Lodge County",3,65,173,81,92
050,30,023,"Montana","Deer Lodge County",3,66,173,87,86
050,30,023,"Montana","Deer Lodge County",3,67,168,85,83
050,30,023,"Montana","Deer Lodge County",3,68,185,97,88
050,30,023,"Montana","Deer Lodge County",3,69,172,93,79
050,30,023,"Montana","Deer Lodge County",3,70,164,86,78
050,30,023,"Montana","Deer Lodge County",3,71,152,80,72
050,30,023,"Montana","Deer Lodge County",3,72,151,79,72
050,30,023,"Montana","Deer Lodge County",3,73,136,74,62
050,30,023,"Montana","Deer Lodge County",3,74,125,67,58
050,30,023,"Montana","Deer Lodge County",3,75,77,38,39
050,30,023,"Montana","Deer Lodge County",3,76,89,49,40
050,30,023,"Montana","Deer Lodge County",3,77,84,43,41
050,30,023,"Montana","Deer Lodge County",3,78,94,50,44
050,30,023,"Montana","Deer Lodge County",3,79,71,32,39
050,30,023,"Montana","Deer Lodge County",3,80,56,25,31
050,30,023,"Montana","Deer Lodge County",3,81,52,28,24
050,30,023,"Montana","Deer Lodge County",3,82,55,23,32
050,30,023,"Montana","Deer Lodge County",3,83,59,27,32
050,30,023,"Montana","Deer Lodge County",3,84,52,27,25
050,30,023,"Montana","Deer Lodge County",3,85,188,70,118
050,30,023,"Montana","Deer Lodge County",4,0,63,36,27
050,30,023,"Montana","Deer Lodge County",4,1,60,26,34
050,30,023,"Montana","Deer Lodge County",4,2,68,34,34
050,30,023,"Montana","Deer Lodge County",4,3,55,30,25
050,30,023,"Montana","Deer Lodge County",4,4,64,32,32
050,30,023,"Montana","Deer Lodge County",4,5,63,29,34
050,30,023,"Montana","Deer Lodge County",4,6,66,34,32
050,30,023,"Montana","Deer Lodge County",4,7,55,29,26
050,30,023,"Montana","Deer Lodge County",4,8,63,28,35
050,30,023,"Montana","Deer Lodge County",4,9,52,20,32
050,30,023,"Montana","Deer Lodge County",4,10,61,28,33
050,30,023,"Montana","Deer Lodge County",4,11,58,29,29
050,30,023,"Montana","Deer Lodge County",4,12,74,35,39
050,30,023,"Montana","Deer Lodge County",4,13,66,35,31
050,30,023,"Montana","Deer Lodge County",4,14,64,31,33
050,30,023,"Montana","Deer Lodge County",4,15,59,26,33
050,30,023,"Montana","Deer Lodge County",4,16,66,35,31
050,30,023,"Montana","Deer Lodge County",4,17,120,68,52
050,30,023,"Montana","Deer Lodge County",4,18,111,69,42
050,30,023,"Montana","Deer Lodge County",4,19,105,75,30
050,30,023,"Montana","Deer Lodge County",4,20,102,68,34
050,30,023,"Montana","Deer Lodge County",4,21,100,67,33
050,30,023,"Montana","Deer Lodge County",4,22,99,73,26
050,30,023,"Montana","Deer Lodge County",4,23,94,46,48
050,30,023,"Montana","Deer Lodge County",4,24,91,52,39
050,30,023,"Montana","Deer Lodge County",4,25,107,63,44
050,30,023,"Montana","Deer Lodge County",4,26,110,56,54
050,30,023,"Montana","Deer Lodge County",4,27,86,46,40
050,30,023,"Montana","Deer Lodge County",4,28,101,63,38
050,30,023,"Montana","Deer Lodge County",4,29,106,57,49
050,30,023,"Montana","Deer Lodge County",4,30,127,55,72
050,30,023,"Montana","Deer Lodge County",4,31,110,53,57
050,30,023,"Montana","Deer Lodge County",4,32,137,80,57
050,30,023,"Montana","Deer Lodge County",4,33,131,82,49
050,30,023,"Montana","Deer Lodge County",4,34,110,68,42
050,30,023,"Montana","Deer Lodge County",4,35,118,62,56
050,30,023,"Montana","Deer Lodge County",4,36,108,62,46
050,30,023,"Montana","Deer Lodge County",4,37,105,60,45
050,30,023,"Montana","Deer Lodge County",4,38,108,58,50
050,30,023,"Montana","Deer Lodge County",4,39,111,66,45
050,30,023,"Montana","Deer Lodge County",4,40,119,66,53
050,30,023,"Montana","Deer Lodge County",4,41,117,62,55
050,30,023,"Montana","Deer Lodge County",4,42,108,55,53
050,30,023,"Montana","Deer Lodge County",4,43,112,62,50
050,30,023,"Montana","Deer Lodge County",4,44,129,75,54
050,30,023,"Montana","Deer Lodge County",4,45,112,61,51
050,30,023,"Montana","Deer Lodge County",4,46,119,60,59
050,30,023,"Montana","Deer Lodge County",4,47,115,65,50
050,30,023,"Montana","Deer Lodge County",4,48,119,65,54
050,30,023,"Montana","Deer Lodge County",4,49,137,71,66
050,30,023,"Montana","Deer Lodge County",4,50,136,71,65
050,30,023,"Montana","Deer Lodge County",4,51,138,74,64
050,30,023,"Montana","Deer Lodge County",4,52,141,77,64
050,30,023,"Montana","Deer Lodge County",4,53,129,67,62
050,30,023,"Montana","Deer Lodge County",4,54,132,75,57
050,30,023,"Montana","Deer Lodge County",4,55,115,62,53
050,30,023,"Montana","Deer Lodge County",4,56,125,65,60
050,30,023,"Montana","Deer Lodge County",4,57,138,78,60
050,30,023,"Montana","Deer Lodge County",4,58,155,87,68
050,30,023,"Montana","Deer Lodge County",4,59,156,70,86
050,30,023,"Montana","Deer Lodge County",4,60,177,85,92
050,30,023,"Montana","Deer Lodge County",4,61,197,90,107
050,30,023,"Montana","Deer Lodge County",4,62,172,86,86
050,30,023,"Montana","Deer Lodge County",4,63,177,96,81
050,30,023,"Montana","Deer Lodge County",4,64,170,84,86
050,30,023,"Montana","Deer Lodge County",4,65,167,79,88
050,30,023,"Montana","Deer Lodge County",4,66,177,87,90
050,30,023,"Montana","Deer Lodge County",4,67,172,88,84
050,30,023,"Montana","Deer Lodge County",4,68,165,88,77
050,30,023,"Montana","Deer Lodge County",4,69,183,95,88
050,30,023,"Montana","Deer Lodge County",4,70,170,92,78
050,30,023,"Montana","Deer Lodge County",4,71,164,84,80
050,30,023,"Montana","Deer Lodge County",4,72,152,82,70
050,30,023,"Montana","Deer Lodge County",4,73,143,77,66
050,30,023,"Montana","Deer Lodge County",4,74,127,71,56
050,30,023,"Montana","Deer Lodge County",4,75,122,64,58
050,30,023,"Montana","Deer Lodge County",4,76,77,37,40
050,30,023,"Montana","Deer Lodge County",4,77,85,45,40
050,30,023,"Montana","Deer Lodge County",4,78,82,45,37
050,30,023,"Montana","Deer Lodge County",4,79,93,49,44
050,30,023,"Montana","Deer Lodge County",4,80,63,29,34
050,30,023,"Montana","Deer Lodge County",4,81,53,25,28
050,30,023,"Montana","Deer Lodge County",4,82,48,24,24
050,30,023,"Montana","Deer Lodge County",4,83,49,19,30
050,30,023,"Montana","Deer Lodge County",4,84,54,26,28
050,30,023,"Montana","Deer Lodge County",4,85,199,84,115
050,30,023,"Montana","Deer Lodge County",5,0,64,37,27
050,30,023,"Montana","Deer Lodge County",5,1,59,33,26
050,30,023,"Montana","Deer Lodge County",5,2,62,25,37
050,30,023,"Montana","Deer Lodge County",5,3,64,32,32
050,30,023,"Montana","Deer Lodge County",5,4,48,24,24
050,30,023,"Montana","Deer Lodge County",5,5,66,35,31
050,30,023,"Montana","Deer Lodge County",5,6,64,31,33
050,30,023,"Montana","Deer Lodge County",5,7,59,25,34
050,30,023,"Montana","Deer Lodge County",5,8,55,28,27
050,30,023,"Montana","Deer Lodge County",5,9,60,29,31
050,30,023,"Montana","Deer Lodge County",5,10,51,21,30
050,30,023,"Montana","Deer Lodge County",5,11,56,24,32
050,30,023,"Montana","Deer Lodge County",5,12,60,29,31
050,30,023,"Montana","Deer Lodge County",5,13,67,32,35
050,30,023,"Montana","Deer Lodge County",5,14,60,33,27
050,30,023,"Montana","Deer Lodge County",5,15,61,29,32
050,30,023,"Montana","Deer Lodge County",5,16,69,37,32
050,30,023,"Montana","Deer Lodge County",5,17,102,55,47
050,30,023,"Montana","Deer Lodge County",5,18,107,71,36
050,30,023,"Montana","Deer Lodge County",5,19,109,71,38
050,30,023,"Montana","Deer Lodge County",5,20,101,76,25
050,30,023,"Montana","Deer Lodge County",5,21,96,58,38
050,30,023,"Montana","Deer Lodge County",5,22,117,75,42
050,30,023,"Montana","Deer Lodge County",5,23,83,54,29
050,30,023,"Montana","Deer Lodge County",5,24,98,51,47
050,30,023,"Montana","Deer Lodge County",5,25,105,60,45
050,30,023,"Montana","Deer Lodge County",5,26,100,59,41
050,30,023,"Montana","Deer Lodge County",5,27,102,53,49
050,30,023,"Montana","Deer Lodge County",5,28,101,55,46
050,30,023,"Montana","Deer Lodge County",5,29,115,70,45
050,30,023,"Montana","Deer Lodge County",5,30,105,58,47
050,30,023,"Montana","Deer Lodge County",5,31,132,61,71
050,30,023,"Montana","Deer Lodge County",5,32,109,51,58
050,30,023,"Montana","Deer Lodge County",5,33,128,66,62
050,30,023,"Montana","Deer Lodge County",5,34,137,84,53
050,30,023,"Montana","Deer Lodge County",5,35,126,81,45
050,30,023,"Montana","Deer Lodge County",5,36,122,65,57
050,30,023,"Montana","Deer Lodge County",5,37,106,62,44
050,30,023,"Montana","Deer Lodge County",5,38,111,63,48
050,30,023,"Montana","Deer Lodge County",5,39,114,65,49
050,30,023,"Montana","Deer Lodge County",5,40,115,62,53
050,30,023,"Montana","Deer Lodge County",5,41,124,72,52
050,30,023,"Montana","Deer Lodge County",5,42,120,65,55
050,30,023,"Montana","Deer Lodge County",5,43,122,66,56
050,30,023,"Montana","Deer Lodge County",5,44,112,62,50
050,30,023,"Montana","Deer Lodge County",5,45,118,67,51
050,30,023,"Montana","Deer Lodge County",5,46,118,64,54
050,30,023,"Montana","Deer Lodge County",5,47,124,62,62
050,30,023,"Montana","Deer Lodge County",5,48,117,67,50
050,30,023,"Montana","Deer Lodge County",5,49,136,72,64
050,30,023,"Montana","Deer Lodge County",5,50,130,66,64
050,30,023,"Montana","Deer Lodge County",5,51,135,68,67
050,30,023,"Montana","Deer Lodge County",5,52,138,76,62
050,30,023,"Montana","Deer Lodge County",5,53,149,75,74
050,30,023,"Montana","Deer Lodge County",5,54,130,68,62
050,30,023,"Montana","Deer Lodge County",5,55,133,76,57
050,30,023,"Montana","Deer Lodge County",5,56,129,67,62
050,30,023,"Montana","Deer Lodge County",5,57,141,78,63
050,30,023,"Montana","Deer Lodge County",5,58,137,73,64
050,30,023,"Montana","Deer Lodge County",5,59,160,82,78
050,30,023,"Montana","Deer Lodge County",5,60,162,75,87
050,30,023,"Montana","Deer Lodge County",5,61,189,91,98
050,30,023,"Montana","Deer Lodge County",5,62,192,88,104
050,30,023,"Montana","Deer Lodge County",5,63,180,91,89
050,30,023,"Montana","Deer Lodge County",5,64,181,97,84
050,30,023,"Montana","Deer Lodge County",5,65,175,85,90
050,30,023,"Montana","Deer Lodge County",5,66,166,81,85
050,30,023,"Montana","Deer Lodge County",5,67,175,86,89
050,30,023,"Montana","Deer Lodge County",5,68,171,92,79
050,30,023,"Montana","Deer Lodge County",5,69,165,89,76
050,30,023,"Montana","Deer Lodge County",5,70,181,95,86
050,30,023,"Montana","Deer Lodge County",5,71,174,93,81
050,30,023,"Montana","Deer Lodge County",5,72,158,79,79
050,30,023,"Montana","Deer Lodge County",5,73,150,81,69
050,30,023,"Montana","Deer Lodge County",5,74,137,72,65
050,30,023,"Montana","Deer Lodge County",5,75,124,68,56
050,30,023,"Montana","Deer Lodge County",5,76,119,64,55
050,30,023,"Montana","Deer Lodge County",5,77,76,35,41
050,30,023,"Montana","Deer Lodge County",5,78,82,44,38
050,30,023,"Montana","Deer Lodge County",5,79,84,46,38
050,30,023,"Montana","Deer Lodge County",5,80,82,44,38
050,30,023,"Montana","Deer Lodge County",5,81,60,27,33
050,30,023,"Montana","Deer Lodge County",5,82,51,23,28
050,30,023,"Montana","Deer Lodge County",5,83,44,23,21
050,30,023,"Montana","Deer Lodge County",5,84,43,16,27
050,30,023,"Montana","Deer Lodge County",5,85,213,95,118
050,30,025,"Montana","Fallon County",1,0,32,16,16
050,30,025,"Montana","Fallon County",1,1,36,17,19
050,30,025,"Montana","Fallon County",1,2,31,13,18
050,30,025,"Montana","Fallon County",1,3,42,18,24
050,30,025,"Montana","Fallon County",1,4,55,27,28
050,30,025,"Montana","Fallon County",1,5,50,33,17
050,30,025,"Montana","Fallon County",1,6,56,31,25
050,30,025,"Montana","Fallon County",1,7,51,24,27
050,30,025,"Montana","Fallon County",1,8,45,21,24
050,30,025,"Montana","Fallon County",1,9,48,28,20
050,30,025,"Montana","Fallon County",1,10,43,21,22
050,30,025,"Montana","Fallon County",1,11,45,21,24
050,30,025,"Montana","Fallon County",1,12,57,28,29
050,30,025,"Montana","Fallon County",1,13,49,25,24
050,30,025,"Montana","Fallon County",1,14,43,23,20
050,30,025,"Montana","Fallon County",1,15,40,15,25
050,30,025,"Montana","Fallon County",1,16,51,21,30
050,30,025,"Montana","Fallon County",1,17,51,24,27
050,30,025,"Montana","Fallon County",1,18,35,15,20
050,30,025,"Montana","Fallon County",1,19,23,13,10
050,30,025,"Montana","Fallon County",1,20,31,17,14
050,30,025,"Montana","Fallon County",1,21,31,19,12
050,30,025,"Montana","Fallon County",1,22,27,14,13
050,30,025,"Montana","Fallon County",1,23,28,18,10
050,30,025,"Montana","Fallon County",1,24,29,15,14
050,30,025,"Montana","Fallon County",1,25,40,21,19
050,30,025,"Montana","Fallon County",1,26,33,18,15
050,30,025,"Montana","Fallon County",1,27,37,17,20
050,30,025,"Montana","Fallon County",1,28,47,23,24
050,30,025,"Montana","Fallon County",1,29,34,17,17
050,30,025,"Montana","Fallon County",1,30,35,17,18
050,30,025,"Montana","Fallon County",1,31,38,22,16
050,30,025,"Montana","Fallon County",1,32,27,22,5
050,30,025,"Montana","Fallon County",1,33,40,24,16
050,30,025,"Montana","Fallon County",1,34,42,23,19
050,30,025,"Montana","Fallon County",1,35,46,26,20
050,30,025,"Montana","Fallon County",1,36,34,18,16
050,30,025,"Montana","Fallon County",1,37,33,14,19
050,30,025,"Montana","Fallon County",1,38,32,13,19
050,30,025,"Montana","Fallon County",1,39,37,16,21
050,30,025,"Montana","Fallon County",1,40,36,23,13
050,30,025,"Montana","Fallon County",1,41,41,22,19
050,30,025,"Montana","Fallon County",1,42,42,22,20
050,30,025,"Montana","Fallon County",1,43,33,22,11
050,30,025,"Montana","Fallon County",1,44,28,16,12
050,30,025,"Montana","Fallon County",1,45,24,12,12
050,30,025,"Montana","Fallon County",1,46,32,13,19
050,30,025,"Montana","Fallon County",1,47,34,16,18
050,30,025,"Montana","Fallon County",1,48,34,21,13
050,30,025,"Montana","Fallon County",1,49,33,21,12
050,30,025,"Montana","Fallon County",1,50,38,18,20
050,30,025,"Montana","Fallon County",1,51,28,11,17
050,30,025,"Montana","Fallon County",1,52,28,15,13
050,30,025,"Montana","Fallon County",1,53,31,15,16
050,30,025,"Montana","Fallon County",1,54,34,19,15
050,30,025,"Montana","Fallon County",1,55,34,19,15
050,30,025,"Montana","Fallon County",1,56,41,20,21
050,30,025,"Montana","Fallon County",1,57,30,17,13
050,30,025,"Montana","Fallon County",1,58,29,17,12
050,30,025,"Montana","Fallon County",1,59,42,20,22
050,30,025,"Montana","Fallon County",1,60,46,19,27
050,30,025,"Montana","Fallon County",1,61,55,28,27
050,30,025,"Montana","Fallon County",1,62,57,31,26
050,30,025,"Montana","Fallon County",1,63,47,23,24
050,30,025,"Montana","Fallon County",1,64,48,24,24
050,30,025,"Montana","Fallon County",1,65,47,26,21
050,30,025,"Montana","Fallon County",1,66,38,20,18
050,30,025,"Montana","Fallon County",1,67,41,19,22
050,30,025,"Montana","Fallon County",1,68,37,18,19
050,30,025,"Montana","Fallon County",1,69,30,13,17
050,30,025,"Montana","Fallon County",1,70,33,15,18
050,30,025,"Montana","Fallon County",1,71,35,20,15
050,30,025,"Montana","Fallon County",1,72,36,19,17
050,30,025,"Montana","Fallon County",1,73,24,12,12
050,30,025,"Montana","Fallon County",1,74,13,7,6
050,30,025,"Montana","Fallon County",1,75,11,6,5
050,30,025,"Montana","Fallon County",1,76,12,5,7
050,30,025,"Montana","Fallon County",1,77,17,8,9
050,30,025,"Montana","Fallon County",1,78,18,7,11
050,30,025,"Montana","Fallon County",1,79,12,6,6
050,30,025,"Montana","Fallon County",1,80,14,9,5
050,30,025,"Montana","Fallon County",1,81,15,9,6
050,30,025,"Montana","Fallon County",1,82,17,8,9
050,30,025,"Montana","Fallon County",1,83,13,7,6
050,30,025,"Montana","Fallon County",1,84,8,3,5
050,30,025,"Montana","Fallon County",1,85,69,19,50
050,30,025,"Montana","Fallon County",2,0,29,15,14
050,30,025,"Montana","Fallon County",2,1,34,16,18
050,30,025,"Montana","Fallon County",2,2,33,14,19
050,30,025,"Montana","Fallon County",2,3,40,17,23
050,30,025,"Montana","Fallon County",2,4,52,25,27
050,30,025,"Montana","Fallon County",2,5,51,32,19
050,30,025,"Montana","Fallon County",2,6,55,31,24
050,30,025,"Montana","Fallon County",2,7,51,25,26
050,30,025,"Montana","Fallon County",2,8,46,21,25
050,30,025,"Montana","Fallon County",2,9,47,26,21
050,30,025,"Montana","Fallon County",2,10,43,22,21
050,30,025,"Montana","Fallon County",2,11,45,21,24
050,30,025,"Montana","Fallon County",2,12,54,26,28
050,30,025,"Montana","Fallon County",2,13,50,25,25
050,30,025,"Montana","Fallon County",2,14,44,23,21
050,30,025,"Montana","Fallon County",2,15,41,17,24
050,30,025,"Montana","Fallon County",2,16,48,20,28
050,30,025,"Montana","Fallon County",2,17,50,22,28
050,30,025,"Montana","Fallon County",2,18,36,16,20
050,30,025,"Montana","Fallon County",2,19,23,12,11
050,30,025,"Montana","Fallon County",2,20,31,17,14
050,30,025,"Montana","Fallon County",2,21,30,18,12
050,30,025,"Montana","Fallon County",2,22,28,15,13
050,30,025,"Montana","Fallon County",2,23,28,17,11
050,30,025,"Montana","Fallon County",2,24,29,15,14
050,30,025,"Montana","Fallon County",2,25,37,20,17
050,30,025,"Montana","Fallon County",2,26,34,18,16
050,30,025,"Montana","Fallon County",2,27,37,17,20
050,30,025,"Montana","Fallon County",2,28,46,22,24
050,30,025,"Montana","Fallon County",2,29,38,19,19
050,30,025,"Montana","Fallon County",2,30,34,16,18
050,30,025,"Montana","Fallon County",2,31,38,22,16
050,30,025,"Montana","Fallon County",2,32,30,22,8
050,30,025,"Montana","Fallon County",2,33,37,24,13
050,30,025,"Montana","Fallon County",2,34,41,23,18
050,30,025,"Montana","Fallon County",2,35,44,25,19
050,30,025,"Montana","Fallon County",2,36,35,19,16
050,30,025,"Montana","Fallon County",2,37,32,14,18
050,30,025,"Montana","Fallon County",2,38,33,14,19
050,30,025,"Montana","Fallon County",2,39,36,15,21
050,30,025,"Montana","Fallon County",2,40,37,22,15
050,30,025,"Montana","Fallon County",2,41,39,22,17
050,30,025,"Montana","Fallon County",2,42,42,23,19
050,30,025,"Montana","Fallon County",2,43,35,22,13
050,30,025,"Montana","Fallon County",2,44,28,17,11
050,30,025,"Montana","Fallon County",2,45,25,13,12
050,30,025,"Montana","Fallon County",2,46,30,13,17
050,30,025,"Montana","Fallon County",2,47,33,14,19
050,30,025,"Montana","Fallon County",2,48,34,20,14
050,30,025,"Montana","Fallon County",2,49,34,22,12
050,30,025,"Montana","Fallon County",2,50,37,19,18
050,30,025,"Montana","Fallon County",2,51,30,12,18
050,30,025,"Montana","Fallon County",2,52,27,13,14
050,30,025,"Montana","Fallon County",2,53,30,15,15
050,30,025,"Montana","Fallon County",2,54,33,18,15
050,30,025,"Montana","Fallon County",2,55,34,19,15
050,30,025,"Montana","Fallon County",2,56,40,20,20
050,30,025,"Montana","Fallon County",2,57,33,18,15
050,30,025,"Montana","Fallon County",2,58,28,16,12
050,30,025,"Montana","Fallon County",2,59,39,19,20
050,30,025,"Montana","Fallon County",2,60,45,19,26
050,30,025,"Montana","Fallon County",2,61,52,25,27
050,30,025,"Montana","Fallon County",2,62,56,30,26
050,30,025,"Montana","Fallon County",2,63,48,24,24
050,30,025,"Montana","Fallon County",2,64,47,23,24
050,30,025,"Montana","Fallon County",2,65,47,25,22
050,30,025,"Montana","Fallon County",2,66,40,21,19
050,30,025,"Montana","Fallon County",2,67,41,20,21
050,30,025,"Montana","Fallon County",2,68,38,19,19
050,30,025,"Montana","Fallon County",2,69,31,14,17
050,30,025,"Montana","Fallon County",2,70,33,15,18
050,30,025,"Montana","Fallon County",2,71,35,19,16
050,30,025,"Montana","Fallon County",2,72,36,19,17
050,30,025,"Montana","Fallon County",2,73,27,14,13
050,30,025,"Montana","Fallon County",2,74,14,7,7
050,30,025,"Montana","Fallon County",2,75,11,6,5
050,30,025,"Montana","Fallon County",2,76,11,4,7
050,30,025,"Montana","Fallon County",2,77,16,7,9
050,30,025,"Montana","Fallon County",2,78,17,7,10
050,30,025,"Montana","Fallon County",2,79,13,6,7
050,30,025,"Montana","Fallon County",2,80,13,8,5
050,30,025,"Montana","Fallon County",2,81,15,9,6
050,30,025,"Montana","Fallon County",2,82,17,8,9
050,30,025,"Montana","Fallon County",2,83,14,7,7
050,30,025,"Montana","Fallon County",2,84,8,4,4
050,30,025,"Montana","Fallon County",2,85,66,19,47
050,30,025,"Montana","Fallon County",3,0,36,15,21
050,30,025,"Montana","Fallon County",3,1,28,17,11
050,30,025,"Montana","Fallon County",3,2,31,15,16
050,30,025,"Montana","Fallon County",3,3,29,13,16
050,30,025,"Montana","Fallon County",3,4,35,15,20
050,30,025,"Montana","Fallon County",3,5,51,27,24
050,30,025,"Montana","Fallon County",3,6,46,30,16
050,30,025,"Montana","Fallon County",3,7,58,33,25
050,30,025,"Montana","Fallon County",3,8,50,25,25
050,30,025,"Montana","Fallon County",3,9,47,23,24
050,30,025,"Montana","Fallon County",3,10,44,26,18
050,30,025,"Montana","Fallon County",3,11,46,22,24
050,30,025,"Montana","Fallon County",3,12,45,21,24
050,30,025,"Montana","Fallon County",3,13,51,25,26
050,30,025,"Montana","Fallon County",3,14,52,25,27
050,30,025,"Montana","Fallon County",3,15,44,23,21
050,30,025,"Montana","Fallon County",3,16,44,18,26
050,30,025,"Montana","Fallon County",3,17,49,20,29
050,30,025,"Montana","Fallon County",3,18,39,16,23
050,30,025,"Montana","Fallon County",3,19,29,11,18
050,30,025,"Montana","Fallon County",3,20,25,14,11
050,30,025,"Montana","Fallon County",3,21,34,20,14
050,30,025,"Montana","Fallon County",3,22,31,18,13
050,30,025,"Montana","Fallon County",3,23,31,20,11
050,30,025,"Montana","Fallon County",3,24,26,16,10
050,30,025,"Montana","Fallon County",3,25,31,13,18
050,30,025,"Montana","Fallon County",3,26,37,21,16
050,30,025,"Montana","Fallon County",3,27,31,17,14
050,30,025,"Montana","Fallon County",3,28,35,15,20
050,30,025,"Montana","Fallon County",3,29,46,23,23
050,30,025,"Montana","Fallon County",3,30,35,18,17
050,30,025,"Montana","Fallon County",3,31,36,17,19
050,30,025,"Montana","Fallon County",3,32,36,22,14
050,30,025,"Montana","Fallon County",3,33,28,20,8
050,30,025,"Montana","Fallon County",3,34,35,23,12
050,30,025,"Montana","Fallon County",3,35,41,23,18
050,30,025,"Montana","Fallon County",3,36,53,30,23
050,30,025,"Montana","Fallon County",3,37,38,20,18
050,30,025,"Montana","Fallon County",3,38,32,14,18
050,30,025,"Montana","Fallon County",3,39,33,14,19
050,30,025,"Montana","Fallon County",3,40,36,15,21
050,30,025,"Montana","Fallon County",3,41,35,21,14
050,30,025,"Montana","Fallon County",3,42,40,22,18
050,30,025,"Montana","Fallon County",3,43,43,24,19
050,30,025,"Montana","Fallon County",3,44,33,20,13
050,30,025,"Montana","Fallon County",3,45,29,17,12
050,30,025,"Montana","Fallon County",3,46,26,14,12
050,30,025,"Montana","Fallon County",3,47,29,12,17
050,30,025,"Montana","Fallon County",3,48,36,14,22
050,30,025,"Montana","Fallon County",3,49,33,21,12
050,30,025,"Montana","Fallon County",3,50,35,23,12
050,30,025,"Montana","Fallon County",3,51,36,18,18
050,30,025,"Montana","Fallon County",3,52,31,13,18
050,30,025,"Montana","Fallon County",3,53,25,12,13
050,30,025,"Montana","Fallon County",3,54,30,15,15
050,30,025,"Montana","Fallon County",3,55,33,18,15
050,30,025,"Montana","Fallon County",3,56,35,20,15
050,30,025,"Montana","Fallon County",3,57,40,19,21
050,30,025,"Montana","Fallon County",3,58,33,18,15
050,30,025,"Montana","Fallon County",3,59,27,15,12
050,30,025,"Montana","Fallon County",3,60,38,18,20
050,30,025,"Montana","Fallon County",3,61,44,19,25
050,30,025,"Montana","Fallon County",3,62,50,23,27
050,30,025,"Montana","Fallon County",3,63,54,28,26
050,30,025,"Montana","Fallon County",3,64,49,26,23
050,30,025,"Montana","Fallon County",3,65,48,23,25
050,30,025,"Montana","Fallon County",3,66,46,24,22
050,30,025,"Montana","Fallon County",3,67,38,19,19
050,30,025,"Montana","Fallon County",3,68,40,20,20
050,30,025,"Montana","Fallon County",3,69,38,20,18
050,30,025,"Montana","Fallon County",3,70,29,14,15
050,30,025,"Montana","Fallon County",3,71,29,12,17
050,30,025,"Montana","Fallon County",3,72,32,17,15
050,30,025,"Montana","Fallon County",3,73,35,20,15
050,30,025,"Montana","Fallon County",3,74,25,13,12
050,30,025,"Montana","Fallon County",3,75,14,8,6
050,30,025,"Montana","Fallon County",3,76,11,5,6
050,30,025,"Montana","Fallon County",3,77,10,4,6
050,30,025,"Montana","Fallon County",3,78,16,6,10
050,30,025,"Montana","Fallon County",3,79,15,7,8
050,30,025,"Montana","Fallon County",3,80,14,7,7
050,30,025,"Montana","Fallon County",3,81,13,8,5
050,30,025,"Montana","Fallon County",3,82,16,10,6
050,30,025,"Montana","Fallon County",3,83,16,6,10
050,30,025,"Montana","Fallon County",3,84,9,5,4
050,30,025,"Montana","Fallon County",3,85,69,22,47
050,30,025,"Montana","Fallon County",4,0,35,17,18
050,30,025,"Montana","Fallon County",4,1,32,15,17
050,30,025,"Montana","Fallon County",4,2,33,21,12
050,30,025,"Montana","Fallon County",4,3,35,19,16
050,30,025,"Montana","Fallon County",4,4,29,12,17
050,30,025,"Montana","Fallon County",4,5,39,17,22
050,30,025,"Montana","Fallon County",4,6,57,28,29
050,30,025,"Montana","Fallon County",4,7,51,34,17
050,30,025,"Montana","Fallon County",4,8,61,36,25
050,30,025,"Montana","Fallon County",4,9,54,28,26
050,30,025,"Montana","Fallon County",4,10,46,24,22
050,30,025,"Montana","Fallon County",4,11,48,30,18
050,30,025,"Montana","Fallon County",4,12,47,22,25
050,30,025,"Montana","Fallon County",4,13,47,22,25
050,30,025,"Montana","Fallon County",4,14,48,24,24
050,30,025,"Montana","Fallon County",4,15,52,25,27
050,30,025,"Montana","Fallon County",4,16,47,23,24
050,30,025,"Montana","Fallon County",4,17,47,19,28
050,30,025,"Montana","Fallon County",4,18,40,18,22
050,30,025,"Montana","Fallon County",4,19,30,14,16
050,30,025,"Montana","Fallon County",4,20,30,10,20
050,30,025,"Montana","Fallon County",4,21,29,16,13
050,30,025,"Montana","Fallon County",4,22,35,19,16
050,30,025,"Montana","Fallon County",4,23,29,16,13
050,30,025,"Montana","Fallon County",4,24,29,20,9
050,30,025,"Montana","Fallon County",4,25,26,15,11
050,30,025,"Montana","Fallon County",4,26,26,12,14
050,30,025,"Montana","Fallon County",4,27,41,22,19
050,30,025,"Montana","Fallon County",4,28,31,16,15
050,30,025,"Montana","Fallon County",4,29,31,11,20
050,30,025,"Montana","Fallon County",4,30,46,23,23
050,30,025,"Montana","Fallon County",4,31,37,19,18
050,30,025,"Montana","Fallon County",4,32,36,17,19
050,30,025,"Montana","Fallon County",4,33,38,23,15
050,30,025,"Montana","Fallon County",4,34,28,20,8
050,30,025,"Montana","Fallon County",4,35,33,21,12
050,30,025,"Montana","Fallon County",4,36,41,22,19
050,30,025,"Montana","Fallon County",4,37,54,32,22
050,30,025,"Montana","Fallon County",4,38,42,20,22
050,30,025,"Montana","Fallon County",4,39,34,15,19
050,30,025,"Montana","Fallon County",4,40,34,14,20
050,30,025,"Montana","Fallon County",4,41,36,15,21
050,30,025,"Montana","Fallon County",4,42,36,21,15
050,30,025,"Montana","Fallon County",4,43,41,22,19
050,30,025,"Montana","Fallon County",4,44,43,23,20
050,30,025,"Montana","Fallon County",4,45,36,23,13
050,30,025,"Montana","Fallon County",4,46,32,20,12
050,30,025,"Montana","Fallon County",4,47,25,12,13
050,30,025,"Montana","Fallon County",4,48,32,14,18
050,30,025,"Montana","Fallon County",4,49,36,15,21
050,30,025,"Montana","Fallon County",4,50,33,21,12
050,30,025,"Montana","Fallon County",4,51,33,20,13
050,30,025,"Montana","Fallon County",4,52,37,20,17
050,30,025,"Montana","Fallon County",4,53,32,13,19
050,30,025,"Montana","Fallon County",4,54,27,14,13
050,30,025,"Montana","Fallon County",4,55,27,14,13
050,30,025,"Montana","Fallon County",4,56,29,16,13
050,30,025,"Montana","Fallon County",4,57,37,19,18
050,30,025,"Montana","Fallon County",4,58,42,22,20
050,30,025,"Montana","Fallon County",4,59,33,18,15
050,30,025,"Montana","Fallon County",4,60,27,16,11
050,30,025,"Montana","Fallon County",4,61,36,16,20
050,30,025,"Montana","Fallon County",4,62,46,20,26
050,30,025,"Montana","Fallon County",4,63,46,21,25
050,30,025,"Montana","Fallon County",4,64,53,27,26
050,30,025,"Montana","Fallon County",4,65,47,24,23
050,30,025,"Montana","Fallon County",4,66,48,23,25
050,30,025,"Montana","Fallon County",4,67,48,25,23
050,30,025,"Montana","Fallon County",4,68,40,19,21
050,30,025,"Montana","Fallon County",4,69,36,18,18
050,30,025,"Montana","Fallon County",4,70,38,19,19
050,30,025,"Montana","Fallon County",4,71,27,13,14
050,30,025,"Montana","Fallon County",4,72,29,11,18
050,30,025,"Montana","Fallon County",4,73,30,16,14
050,30,025,"Montana","Fallon County",4,74,33,19,14
050,30,025,"Montana","Fallon County",4,75,26,14,12
050,30,025,"Montana","Fallon County",4,76,14,7,7
050,30,025,"Montana","Fallon County",4,77,10,5,5
050,30,025,"Montana","Fallon County",4,78,12,4,8
050,30,025,"Montana","Fallon County",4,79,12,5,7
050,30,025,"Montana","Fallon County",4,80,15,7,8
050,30,025,"Montana","Fallon County",4,81,13,7,6
050,30,025,"Montana","Fallon County",4,82,13,9,4
050,30,025,"Montana","Fallon County",4,83,15,8,7
050,30,025,"Montana","Fallon County",4,84,11,4,7
050,30,025,"Montana","Fallon County",4,85,70,22,48
050,30,025,"Montana","Fallon County",5,0,34,17,17
050,30,025,"Montana","Fallon County",5,1,38,19,19
050,30,025,"Montana","Fallon County",5,2,33,15,18
050,30,025,"Montana","Fallon County",5,3,32,19,13
050,30,025,"Montana","Fallon County",5,4,36,18,18
050,30,025,"Montana","Fallon County",5,5,30,12,18
050,30,025,"Montana","Fallon County",5,6,38,17,21
050,30,025,"Montana","Fallon County",5,7,52,24,28
050,30,025,"Montana","Fallon County",5,8,51,32,19
050,30,025,"Montana","Fallon County",5,9,58,34,24
050,30,025,"Montana","Fallon County",5,10,50,27,23
050,30,025,"Montana","Fallon County",5,11,45,25,20
050,30,025,"Montana","Fallon County",5,12,44,26,18
050,30,025,"Montana","Fallon County",5,13,47,22,25
050,30,025,"Montana","Fallon County",5,14,43,21,22
050,30,025,"Montana","Fallon County",5,15,43,25,18
050,30,025,"Montana","Fallon County",5,16,51,25,26
050,30,025,"Montana","Fallon County",5,17,44,23,21
050,30,025,"Montana","Fallon County",5,18,38,17,21
050,30,025,"Montana","Fallon County",5,19,29,13,16
050,30,025,"Montana","Fallon County",5,20,27,11,16
050,30,025,"Montana","Fallon County",5,21,31,12,19
050,30,025,"Montana","Fallon County",5,22,33,17,16
050,30,025,"Montana","Fallon County",5,23,32,18,14
050,30,025,"Montana","Fallon County",5,24,39,22,17
050,30,025,"Montana","Fallon County",5,25,28,17,11
050,30,025,"Montana","Fallon County",5,26,24,15,9
050,30,025,"Montana","Fallon County",5,27,27,12,15
050,30,025,"Montana","Fallon County",5,28,41,22,19
050,30,025,"Montana","Fallon County",5,29,32,18,14
050,30,025,"Montana","Fallon County",5,30,35,13,22
050,30,025,"Montana","Fallon County",5,31,44,23,21
050,30,025,"Montana","Fallon County",5,32,37,18,19
050,30,025,"Montana","Fallon County",5,33,36,17,19
050,30,025,"Montana","Fallon County",5,34,39,25,14
050,30,025,"Montana","Fallon County",5,35,28,19,9
050,30,025,"Montana","Fallon County",5,36,30,17,13
050,30,025,"Montana","Fallon County",5,37,41,23,18
050,30,025,"Montana","Fallon County",5,38,48,28,20
050,30,025,"Montana","Fallon County",5,39,39,17,22
050,30,025,"Montana","Fallon County",5,40,31,12,19
050,30,025,"Montana","Fallon County",5,41,33,15,18
050,30,025,"Montana","Fallon County",5,42,35,15,20
050,30,025,"Montana","Fallon County",5,43,33,19,14
050,30,025,"Montana","Fallon County",5,44,40,21,19
050,30,025,"Montana","Fallon County",5,45,40,20,20
050,30,025,"Montana","Fallon County",5,46,38,24,14
050,30,025,"Montana","Fallon County",5,47,28,19,9
050,30,025,"Montana","Fallon County",5,48,22,9,13
050,30,025,"Montana","Fallon County",5,49,33,16,17
050,30,025,"Montana","Fallon County",5,50,35,13,22
050,30,025,"Montana","Fallon County",5,51,40,25,15
050,30,025,"Montana","Fallon County",5,52,33,20,13
050,30,025,"Montana","Fallon County",5,53,36,20,16
050,30,025,"Montana","Fallon County",5,54,32,13,19
050,30,025,"Montana","Fallon County",5,55,28,15,13
050,30,025,"Montana","Fallon County",5,56,28,16,12
050,30,025,"Montana","Fallon County",5,57,28,15,13
050,30,025,"Montana","Fallon County",5,58,36,18,18
050,30,025,"Montana","Fallon County",5,59,40,20,20
050,30,025,"Montana","Fallon County",5,60,34,18,16
050,30,025,"Montana","Fallon County",5,61,27,16,11
050,30,025,"Montana","Fallon County",5,62,35,15,20
050,30,025,"Montana","Fallon County",5,63,48,19,29
050,30,025,"Montana","Fallon County",5,64,43,20,23
050,30,025,"Montana","Fallon County",5,65,54,27,27
050,30,025,"Montana","Fallon County",5,66,47,24,23
050,30,025,"Montana","Fallon County",5,67,45,23,22
050,30,025,"Montana","Fallon County",5,68,48,25,23
050,30,025,"Montana","Fallon County",5,69,39,18,21
050,30,025,"Montana","Fallon County",5,70,36,18,18
050,30,025,"Montana","Fallon County",5,71,37,17,20
050,30,025,"Montana","Fallon County",5,72,28,13,15
050,30,025,"Montana","Fallon County",5,73,27,10,17
050,30,025,"Montana","Fallon County",5,74,28,15,13
050,30,025,"Montana","Fallon County",5,75,34,20,14
050,30,025,"Montana","Fallon County",5,76,26,13,13
050,30,025,"Montana","Fallon County",5,77,12,7,5
050,30,025,"Montana","Fallon County",5,78,12,5,7
050,30,025,"Montana","Fallon County",5,79,5,2,3
050,30,025,"Montana","Fallon County",5,80,12,5,7
050,30,025,"Montana","Fallon County",5,81,15,7,8
050,30,025,"Montana","Fallon County",5,82,13,8,5
050,30,025,"Montana","Fallon County",5,83,13,7,6
050,30,025,"Montana","Fallon County",5,84,9,6,3
050,30,025,"Montana","Fallon County",5,85,71,22,49
050,30,027,"Montana","Fergus County",1,0,112,57,55
050,30,027,"Montana","Fergus County",1,1,126,67,59
050,30,027,"Montana","Fergus County",1,2,133,75,58
050,30,027,"Montana","Fergus County",1,3,127,67,60
050,30,027,"Montana","Fergus County",1,4,126,68,58
050,30,027,"Montana","Fergus County",1,5,143,81,62
050,30,027,"Montana","Fergus County",1,6,129,70,59
050,30,027,"Montana","Fergus County",1,7,131,76,55
050,30,027,"Montana","Fergus County",1,8,126,72,54
050,30,027,"Montana","Fergus County",1,9,138,75,63
050,30,027,"Montana","Fergus County",1,10,140,74,66
050,30,027,"Montana","Fergus County",1,11,146,66,80
050,30,027,"Montana","Fergus County",1,12,141,64,77
050,30,027,"Montana","Fergus County",1,13,141,69,72
050,30,027,"Montana","Fergus County",1,14,148,72,76
050,30,027,"Montana","Fergus County",1,15,134,75,59
050,30,027,"Montana","Fergus County",1,16,137,80,57
050,30,027,"Montana","Fergus County",1,17,145,78,67
050,30,027,"Montana","Fergus County",1,18,103,53,50
050,30,027,"Montana","Fergus County",1,19,90,48,42
050,30,027,"Montana","Fergus County",1,20,106,56,50
050,30,027,"Montana","Fergus County",1,21,89,45,44
050,30,027,"Montana","Fergus County",1,22,91,48,43
050,30,027,"Montana","Fergus County",1,23,101,52,49
050,30,027,"Montana","Fergus County",1,24,96,49,47
050,30,027,"Montana","Fergus County",1,25,110,51,59
050,30,027,"Montana","Fergus County",1,26,118,59,59
050,30,027,"Montana","Fergus County",1,27,134,86,48
050,30,027,"Montana","Fergus County",1,28,137,71,66
050,30,027,"Montana","Fergus County",1,29,125,67,58
050,30,027,"Montana","Fergus County",1,30,124,62,62
050,30,027,"Montana","Fergus County",1,31,118,65,53
050,30,027,"Montana","Fergus County",1,32,125,63,62
050,30,027,"Montana","Fergus County",1,33,123,63,60
050,30,027,"Montana","Fergus County",1,34,137,71,66
050,30,027,"Montana","Fergus County",1,35,123,57,66
050,30,027,"Montana","Fergus County",1,36,126,63,63
050,30,027,"Montana","Fergus County",1,37,120,62,58
050,30,027,"Montana","Fergus County",1,38,156,77,79
050,30,027,"Montana","Fergus County",1,39,149,77,72
050,30,027,"Montana","Fergus County",1,40,144,71,73
050,30,027,"Montana","Fergus County",1,41,137,62,75
050,30,027,"Montana","Fergus County",1,42,149,69,80
050,30,027,"Montana","Fergus County",1,43,129,65,64
050,30,027,"Montana","Fergus County",1,44,120,62,58
050,30,027,"Montana","Fergus County",1,45,107,58,49
050,30,027,"Montana","Fergus County",1,46,122,68,54
050,30,027,"Montana","Fergus County",1,47,111,59,52
050,30,027,"Montana","Fergus County",1,48,123,62,61
050,30,027,"Montana","Fergus County",1,49,127,66,61
050,30,027,"Montana","Fergus County",1,50,128,61,67
050,30,027,"Montana","Fergus County",1,51,106,54,52
050,30,027,"Montana","Fergus County",1,52,117,65,52
050,30,027,"Montana","Fergus County",1,53,128,62,66
050,30,027,"Montana","Fergus County",1,54,128,54,74
050,30,027,"Montana","Fergus County",1,55,148,68,80
050,30,027,"Montana","Fergus County",1,56,147,83,64
050,30,027,"Montana","Fergus County",1,57,163,86,77
050,30,027,"Montana","Fergus County",1,58,186,98,88
050,30,027,"Montana","Fergus County",1,59,171,91,80
050,30,027,"Montana","Fergus County",1,60,190,91,99
050,30,027,"Montana","Fergus County",1,61,187,97,90
050,30,027,"Montana","Fergus County",1,62,179,89,90
050,30,027,"Montana","Fergus County",1,63,175,87,88
050,30,027,"Montana","Fergus County",1,64,195,96,99
050,30,027,"Montana","Fergus County",1,65,174,83,91
050,30,027,"Montana","Fergus County",1,66,183,93,90
050,30,027,"Montana","Fergus County",1,67,176,80,96
050,30,027,"Montana","Fergus County",1,68,180,86,94
050,30,027,"Montana","Fergus County",1,69,170,85,85
050,30,027,"Montana","Fergus County",1,70,163,85,78
050,30,027,"Montana","Fergus County",1,71,163,84,79
050,30,027,"Montana","Fergus County",1,72,175,95,80
050,30,027,"Montana","Fergus County",1,73,160,82,78
050,30,027,"Montana","Fergus County",1,74,113,61,52
050,30,027,"Montana","Fergus County",1,75,105,56,49
050,30,027,"Montana","Fergus County",1,76,112,62,50
050,30,027,"Montana","Fergus County",1,77,104,53,51
050,30,027,"Montana","Fergus County",1,78,96,45,51
050,30,027,"Montana","Fergus County",1,79,88,47,41
050,30,027,"Montana","Fergus County",1,80,81,40,41
050,30,027,"Montana","Fergus County",1,81,75,41,34
050,30,027,"Montana","Fergus County",1,82,61,23,38
050,30,027,"Montana","Fergus County",1,83,59,29,30
050,30,027,"Montana","Fergus County",1,84,60,28,32
050,30,027,"Montana","Fergus County",1,85,308,125,183
050,30,027,"Montana","Fergus County",2,0,117,57,60
050,30,027,"Montana","Fergus County",2,1,125,65,60
050,30,027,"Montana","Fergus County",2,2,134,74,60
050,30,027,"Montana","Fergus County",2,3,130,68,62
050,30,027,"Montana","Fergus County",2,4,126,69,57
050,30,027,"Montana","Fergus County",2,5,141,80,61
050,30,027,"Montana","Fergus County",2,6,132,71,61
050,30,027,"Montana","Fergus County",2,7,131,74,57
050,30,027,"Montana","Fergus County",2,8,128,74,54
050,30,027,"Montana","Fergus County",2,9,134,72,62
050,30,027,"Montana","Fergus County",2,10,140,75,65
050,30,027,"Montana","Fergus County",2,11,145,67,78
050,30,027,"Montana","Fergus County",2,12,143,65,78
050,30,027,"Montana","Fergus County",2,13,140,68,72
050,30,027,"Montana","Fergus County",2,14,146,71,75
050,30,027,"Montana","Fergus County",2,15,135,74,61
050,30,027,"Montana","Fergus County",2,16,136,79,57
050,30,027,"Montana","Fergus County",2,17,143,78,65
050,30,027,"Montana","Fergus County",2,18,106,56,50
050,30,027,"Montana","Fergus County",2,19,88,47,41
050,30,027,"Montana","Fergus County",2,20,107,56,51
050,30,027,"Montana","Fergus County",2,21,94,48,46
050,30,027,"Montana","Fergus County",2,22,93,49,44
050,30,027,"Montana","Fergus County",2,23,101,52,49
050,30,027,"Montana","Fergus County",2,24,99,49,50
050,30,027,"Montana","Fergus County",2,25,108,52,56
050,30,027,"Montana","Fergus County",2,26,118,59,59
050,30,027,"Montana","Fergus County",2,27,130,79,51
050,30,027,"Montana","Fergus County",2,28,136,76,60
050,30,027,"Montana","Fergus County",2,29,131,69,62
050,30,027,"Montana","Fergus County",2,30,128,67,61
050,30,027,"Montana","Fergus County",2,31,122,66,56
050,30,027,"Montana","Fergus County",2,32,124,64,60
050,30,027,"Montana","Fergus County",2,33,124,63,61
050,30,027,"Montana","Fergus County",2,34,137,71,66
050,30,027,"Montana","Fergus County",2,35,127,60,67
050,30,027,"Montana","Fergus County",2,36,122,60,62
050,30,027,"Montana","Fergus County",2,37,121,62,59
050,30,027,"Montana","Fergus County",2,38,150,74,76
050,30,027,"Montana","Fergus County",2,39,149,75,74
050,30,027,"Montana","Fergus County",2,40,145,73,72
050,30,027,"Montana","Fergus County",2,41,138,64,74
050,30,027,"Montana","Fergus County",2,42,147,68,79
050,30,027,"Montana","Fergus County",2,43,133,65,68
050,30,027,"Montana","Fergus County",2,44,122,63,59
050,30,027,"Montana","Fergus County",2,45,111,59,52
050,30,027,"Montana","Fergus County",2,46,117,66,51
050,30,027,"Montana","Fergus County",2,47,111,59,52
050,30,027,"Montana","Fergus County",2,48,120,61,59
050,30,027,"Montana","Fergus County",2,49,125,63,62
050,30,027,"Montana","Fergus County",2,50,129,63,66
050,30,027,"Montana","Fergus County",2,51,111,57,54
050,30,027,"Montana","Fergus County",2,52,117,64,53
050,30,027,"Montana","Fergus County",2,53,123,60,63
050,30,027,"Montana","Fergus County",2,54,129,56,73
050,30,027,"Montana","Fergus County",2,55,143,66,77
050,30,027,"Montana","Fergus County",2,56,146,78,68
050,30,027,"Montana","Fergus County",2,57,160,85,75
050,30,027,"Montana","Fergus County",2,58,179,94,85
050,30,027,"Montana","Fergus County",2,59,178,94,84
050,30,027,"Montana","Fergus County",2,60,186,92,94
050,30,027,"Montana","Fergus County",2,61,190,96,94
050,30,027,"Montana","Fergus County",2,62,178,90,88
050,30,027,"Montana","Fergus County",2,63,179,90,89
050,30,027,"Montana","Fergus County",2,64,191,94,97
050,30,027,"Montana","Fergus County",2,65,178,86,92
050,30,027,"Montana","Fergus County",2,66,182,91,91
050,30,027,"Montana","Fergus County",2,67,176,82,94
050,30,027,"Montana","Fergus County",2,68,176,83,93
050,30,027,"Montana","Fergus County",2,69,175,86,89
050,30,027,"Montana","Fergus County",2,70,163,85,78
050,30,027,"Montana","Fergus County",2,71,166,86,80
050,30,027,"Montana","Fergus County",2,72,170,91,79
050,30,027,"Montana","Fergus County",2,73,173,90,83
050,30,027,"Montana","Fergus County",2,74,115,61,54
050,30,027,"Montana","Fergus County",2,75,108,57,51
050,30,027,"Montana","Fergus County",2,76,110,61,49
050,30,027,"Montana","Fergus County",2,77,108,57,51
050,30,027,"Montana","Fergus County",2,78,95,46,49
050,30,027,"Montana","Fergus County",2,79,87,44,43
050,30,027,"Montana","Fergus County",2,80,83,42,41
050,30,027,"Montana","Fergus County",2,81,76,41,35
050,30,027,"Montana","Fergus County",2,82,63,26,37
050,30,027,"Montana","Fergus County",2,83,59,27,32
050,30,027,"Montana","Fergus County",2,84,60,28,32
050,30,027,"Montana","Fergus County",2,85,303,123,180
050,30,027,"Montana","Fergus County",3,0,120,58,62
050,30,027,"Montana","Fergus County",3,1,129,65,64
050,30,027,"Montana","Fergus County",3,2,122,62,60
050,30,027,"Montana","Fergus County",3,3,141,75,66
050,30,027,"Montana","Fergus County",3,4,131,67,64
050,30,027,"Montana","Fergus County",3,5,133,74,59
050,30,027,"Montana","Fergus County",3,6,140,76,64
050,30,027,"Montana","Fergus County",3,7,140,72,68
050,30,027,"Montana","Fergus County",3,8,131,77,54
050,30,027,"Montana","Fergus County",3,9,135,76,59
050,30,027,"Montana","Fergus County",3,10,128,70,58
050,30,027,"Montana","Fergus County",3,11,150,84,66
050,30,027,"Montana","Fergus County",3,12,153,75,78
050,30,027,"Montana","Fergus County",3,13,151,71,80
050,30,027,"Montana","Fergus County",3,14,138,62,76
050,30,027,"Montana","Fergus County",3,15,142,72,70
050,30,027,"Montana","Fergus County",3,16,132,76,56
050,30,027,"Montana","Fergus County",3,17,143,83,60
050,30,027,"Montana","Fergus County",3,18,121,66,55
050,30,027,"Montana","Fergus County",3,19,81,43,38
050,30,027,"Montana","Fergus County",3,20,96,53,43
050,30,027,"Montana","Fergus County",3,21,102,54,48
050,30,027,"Montana","Fergus County",3,22,96,51,45
050,30,027,"Montana","Fergus County",3,23,110,60,50
050,30,027,"Montana","Fergus County",3,24,98,47,51
050,30,027,"Montana","Fergus County",3,25,111,58,53
050,30,027,"Montana","Fergus County",3,26,111,49,62
050,30,027,"Montana","Fergus County",3,27,126,58,68
050,30,027,"Montana","Fergus County",3,28,130,77,53
050,30,027,"Montana","Fergus County",3,29,143,80,63
050,30,027,"Montana","Fergus County",3,30,139,73,66
050,30,027,"Montana","Fergus County",3,31,126,68,58
050,30,027,"Montana","Fergus County",3,32,132,68,64
050,30,027,"Montana","Fergus County",3,33,123,64,59
050,30,027,"Montana","Fergus County",3,34,141,75,66
050,30,027,"Montana","Fergus County",3,35,140,70,70
050,30,027,"Montana","Fergus County",3,36,129,64,65
050,30,027,"Montana","Fergus County",3,37,118,57,61
050,30,027,"Montana","Fergus County",3,38,130,70,60
050,30,027,"Montana","Fergus County",3,39,152,71,81
050,30,027,"Montana","Fergus County",3,40,153,78,75
050,30,027,"Montana","Fergus County",3,41,152,77,75
050,30,027,"Montana","Fergus County",3,42,139,65,74
050,30,027,"Montana","Fergus County",3,43,143,68,75
050,30,027,"Montana","Fergus County",3,44,148,70,78
050,30,027,"Montana","Fergus County",3,45,120,62,58
050,30,027,"Montana","Fergus County",3,46,115,63,52
050,30,027,"Montana","Fergus County",3,47,122,65,57
050,30,027,"Montana","Fergus County",3,48,114,61,53
050,30,027,"Montana","Fergus County",3,49,123,61,62
050,30,027,"Montana","Fergus County",3,50,134,68,66
050,30,027,"Montana","Fergus County",3,51,131,65,66
050,30,027,"Montana","Fergus County",3,52,122,62,60
050,30,027,"Montana","Fergus County",3,53,112,63,49
050,30,027,"Montana","Fergus County",3,54,121,58,63
050,30,027,"Montana","Fergus County",3,55,134,62,72
050,30,027,"Montana","Fergus County",3,56,152,73,79
050,30,027,"Montana","Fergus County",3,57,150,82,68
050,30,027,"Montana","Fergus County",3,58,163,84,79
050,30,027,"Montana","Fergus County",3,59,179,90,89
050,30,027,"Montana","Fergus County",3,60,178,96,82
050,30,027,"Montana","Fergus County",3,61,191,95,96
050,30,027,"Montana","Fergus County",3,62,189,95,94
050,30,027,"Montana","Fergus County",3,63,176,92,84
050,30,027,"Montana","Fergus County",3,64,185,93,92
050,30,027,"Montana","Fergus County",3,65,182,94,88
050,30,027,"Montana","Fergus County",3,66,184,88,96
050,30,027,"Montana","Fergus County",3,67,174,88,86
050,30,027,"Montana","Fergus County",3,68,181,86,95
050,30,027,"Montana","Fergus County",3,69,168,79,89
050,30,027,"Montana","Fergus County",3,70,166,82,84
050,30,027,"Montana","Fergus County",3,71,168,88,80
050,30,027,"Montana","Fergus County",3,72,168,87,81
050,30,027,"Montana","Fergus County",3,73,163,88,75
050,30,027,"Montana","Fergus County",3,74,170,89,81
050,30,027,"Montana","Fergus County",3,75,107,53,54
050,30,027,"Montana","Fergus County",3,76,109,58,51
050,30,027,"Montana","Fergus County",3,77,106,59,47
050,30,027,"Montana","Fergus County",3,78,102,55,47
050,30,027,"Montana","Fergus County",3,79,91,41,50
050,30,027,"Montana","Fergus County",3,80,84,42,42
050,30,027,"Montana","Fergus County",3,81,82,45,37
050,30,027,"Montana","Fergus County",3,82,66,34,32
050,30,027,"Montana","Fergus County",3,83,54,23,31
050,30,027,"Montana","Fergus County",3,84,55,25,30
050,30,027,"Montana","Fergus County",3,85,282,113,169
050,30,027,"Montana","Fergus County",4,0,108,56,52
050,30,027,"Montana","Fergus County",4,1,111,50,61
050,30,027,"Montana","Fergus County",4,2,134,68,66
050,30,027,"Montana","Fergus County",4,3,123,64,59
050,30,027,"Montana","Fergus County",4,4,137,77,60
050,30,027,"Montana","Fergus County",4,5,131,74,57
050,30,027,"Montana","Fergus County",4,6,128,67,61
050,30,027,"Montana","Fergus County",4,7,152,83,69
050,30,027,"Montana","Fergus County",4,8,141,76,65
050,30,027,"Montana","Fergus County",4,9,131,77,54
050,30,027,"Montana","Fergus County",4,10,140,79,61
050,30,027,"Montana","Fergus County",4,11,132,72,60
050,30,027,"Montana","Fergus County",4,12,146,81,65
050,30,027,"Montana","Fergus County",4,13,156,72,84
050,30,027,"Montana","Fergus County",4,14,151,68,83
050,30,027,"Montana","Fergus County",4,15,132,58,74
050,30,027,"Montana","Fergus County",4,16,143,76,67
050,30,027,"Montana","Fergus County",4,17,139,75,64
050,30,027,"Montana","Fergus County",4,18,115,69,46
050,30,027,"Montana","Fergus County",4,19,89,51,38
050,30,027,"Montana","Fergus County",4,20,89,47,42
050,30,027,"Montana","Fergus County",4,21,90,51,39
050,30,027,"Montana","Fergus County",4,22,108,55,53
050,30,027,"Montana","Fergus County",4,23,107,56,51
050,30,027,"Montana","Fergus County",4,24,103,54,49
050,30,027,"Montana","Fergus County",4,25,111,57,54
050,30,027,"Montana","Fergus County",4,26,116,59,57
050,30,027,"Montana","Fergus County",4,27,121,49,72
050,30,027,"Montana","Fergus County",4,28,139,68,71
050,30,027,"Montana","Fergus County",4,29,133,72,61
050,30,027,"Montana","Fergus County",4,30,153,84,69
050,30,027,"Montana","Fergus County",4,31,143,77,66
050,30,027,"Montana","Fergus County",4,32,132,70,62
050,30,027,"Montana","Fergus County",4,33,131,69,62
050,30,027,"Montana","Fergus County",4,34,136,72,64
050,30,027,"Montana","Fergus County",4,35,135,69,66
050,30,027,"Montana","Fergus County",4,36,133,65,68
050,30,027,"Montana","Fergus County",4,37,134,64,70
050,30,027,"Montana","Fergus County",4,38,121,56,65
050,30,027,"Montana","Fergus County",4,39,133,69,64
050,30,027,"Montana","Fergus County",4,40,155,70,85
050,30,027,"Montana","Fergus County",4,41,160,80,80
050,30,027,"Montana","Fergus County",4,42,157,79,78
050,30,027,"Montana","Fergus County",4,43,140,69,71
050,30,027,"Montana","Fergus County",4,44,146,72,74
050,30,027,"Montana","Fergus County",4,45,143,64,79
050,30,027,"Montana","Fergus County",4,46,129,68,61
050,30,027,"Montana","Fergus County",4,47,107,57,50
050,30,027,"Montana","Fergus County",4,48,128,68,60
050,30,027,"Montana","Fergus County",4,49,107,58,49
050,30,027,"Montana","Fergus County",4,50,125,62,63
050,30,027,"Montana","Fergus County",4,51,132,68,64
050,30,027,"Montana","Fergus County",4,52,142,73,69
050,30,027,"Montana","Fergus County",4,53,127,64,63
050,30,027,"Montana","Fergus County",4,54,110,62,48
050,30,027,"Montana","Fergus County",4,55,125,61,64
050,30,027,"Montana","Fergus County",4,56,141,70,71
050,30,027,"Montana","Fergus County",4,57,147,72,75
050,30,027,"Montana","Fergus County",4,58,143,74,69
050,30,027,"Montana","Fergus County",4,59,166,86,80
050,30,027,"Montana","Fergus County",4,60,181,94,87
050,30,027,"Montana","Fergus County",4,61,180,95,85
050,30,027,"Montana","Fergus County",4,62,189,94,95
050,30,027,"Montana","Fergus County",4,63,187,94,93
050,30,027,"Montana","Fergus County",4,64,180,99,81
050,30,027,"Montana","Fergus County",4,65,184,91,93
050,30,027,"Montana","Fergus County",4,66,186,99,87
050,30,027,"Montana","Fergus County",4,67,181,86,95
050,30,027,"Montana","Fergus County",4,68,180,89,91
050,30,027,"Montana","Fergus County",4,69,174,82,92
050,30,027,"Montana","Fergus County",4,70,159,72,87
050,30,027,"Montana","Fergus County",4,71,167,83,84
050,30,027,"Montana","Fergus County",4,72,167,87,80
050,30,027,"Montana","Fergus County",4,73,163,86,77
050,30,027,"Montana","Fergus County",4,74,164,91,73
050,30,027,"Montana","Fergus County",4,75,161,85,76
050,30,027,"Montana","Fergus County",4,76,102,52,50
050,30,027,"Montana","Fergus County",4,77,106,55,51
050,30,027,"Montana","Fergus County",4,78,101,54,47
050,30,027,"Montana","Fergus County",4,79,98,51,47
050,30,027,"Montana","Fergus County",4,80,89,42,47
050,30,027,"Montana","Fergus County",4,81,77,40,37
050,30,027,"Montana","Fergus County",4,82,75,39,36
050,30,027,"Montana","Fergus County",4,83,58,31,27
050,30,027,"Montana","Fergus County",4,84,53,19,34
050,30,027,"Montana","Fergus County",4,85,273,113,160
050,30,027,"Montana","Fergus County",5,0,107,56,51
050,30,027,"Montana","Fergus County",5,1,114,61,53
050,30,027,"Montana","Fergus County",5,2,112,52,60
050,30,027,"Montana","Fergus County",5,3,130,63,67
050,30,027,"Montana","Fergus County",5,4,132,66,66
050,30,027,"Montana","Fergus County",5,5,143,79,64
050,30,027,"Montana","Fergus County",5,6,122,60,62
050,30,027,"Montana","Fergus County",5,7,135,75,60
050,30,027,"Montana","Fergus County",5,8,153,82,71
050,30,027,"Montana","Fergus County",5,9,141,72,69
050,30,027,"Montana","Fergus County",5,10,129,72,57
050,30,027,"Montana","Fergus County",5,11,151,84,67
050,30,027,"Montana","Fergus County",5,12,134,72,62
050,30,027,"Montana","Fergus County",5,13,154,85,69
050,30,027,"Montana","Fergus County",5,14,157,71,86
050,30,027,"Montana","Fergus County",5,15,151,67,84
050,30,027,"Montana","Fergus County",5,16,134,60,74
050,30,027,"Montana","Fergus County",5,17,157,82,75
050,30,027,"Montana","Fergus County",5,18,116,65,51
050,30,027,"Montana","Fergus County",5,19,85,55,30
050,30,027,"Montana","Fergus County",5,20,90,51,39
050,30,027,"Montana","Fergus County",5,21,86,47,39
050,30,027,"Montana","Fergus County",5,22,97,53,44
050,30,027,"Montana","Fergus County",5,23,127,61,66
050,30,027,"Montana","Fergus County",5,24,106,51,55
050,30,027,"Montana","Fergus County",5,25,121,65,56
050,30,027,"Montana","Fergus County",5,26,105,54,51
050,30,027,"Montana","Fergus County",5,27,130,67,63
050,30,027,"Montana","Fergus County",5,28,115,49,66
050,30,027,"Montana","Fergus County",5,29,139,67,72
050,30,027,"Montana","Fergus County",5,30,143,81,62
050,30,027,"Montana","Fergus County",5,31,151,84,67
050,30,027,"Montana","Fergus County",5,32,142,74,68
050,30,027,"Montana","Fergus County",5,33,139,73,66
050,30,027,"Montana","Fergus County",5,34,138,72,66
050,30,027,"Montana","Fergus County",5,35,143,74,69
050,30,027,"Montana","Fergus County",5,36,127,65,62
050,30,027,"Montana","Fergus County",5,37,135,64,71
050,30,027,"Montana","Fergus County",5,38,144,71,73
050,30,027,"Montana","Fergus County",5,39,126,59,67
050,30,027,"Montana","Fergus County",5,40,146,78,68
050,30,027,"Montana","Fergus County",5,41,166,76,90
050,30,027,"Montana","Fergus County",5,42,159,81,78
050,30,027,"Montana","Fergus County",5,43,151,79,72
050,30,027,"Montana","Fergus County",5,44,152,76,76
050,30,027,"Montana","Fergus County",5,45,146,71,75
050,30,027,"Montana","Fergus County",5,46,143,64,79
050,30,027,"Montana","Fergus County",5,47,120,57,63
050,30,027,"Montana","Fergus County",5,48,109,57,52
050,30,027,"Montana","Fergus County",5,49,124,67,57
050,30,027,"Montana","Fergus County",5,50,109,59,50
050,30,027,"Montana","Fergus County",5,51,119,60,59
050,30,027,"Montana","Fergus County",5,52,136,74,62
050,30,027,"Montana","Fergus County",5,53,139,71,68
050,30,027,"Montana","Fergus County",5,54,126,58,68
050,30,027,"Montana","Fergus County",5,55,120,64,56
050,30,027,"Montana","Fergus County",5,56,124,66,58
050,30,027,"Montana","Fergus County",5,57,141,70,71
050,30,027,"Montana","Fergus County",5,58,146,71,75
050,30,027,"Montana","Fergus County",5,59,151,76,75
050,30,027,"Montana","Fergus County",5,60,172,91,81
050,30,027,"Montana","Fergus County",5,61,181,90,91
050,30,027,"Montana","Fergus County",5,62,182,95,87
050,30,027,"Montana","Fergus County",5,63,189,94,95
050,30,027,"Montana","Fergus County",5,64,191,99,92
050,30,027,"Montana","Fergus County",5,65,177,99,78
050,30,027,"Montana","Fergus County",5,66,189,90,99
050,30,027,"Montana","Fergus County",5,67,178,95,83
050,30,027,"Montana","Fergus County",5,68,189,89,100
050,30,027,"Montana","Fergus County",5,69,177,87,90
050,30,027,"Montana","Fergus County",5,70,166,78,88
050,30,027,"Montana","Fergus County",5,71,160,74,86
050,30,027,"Montana","Fergus County",5,72,170,86,84
050,30,027,"Montana","Fergus County",5,73,162,84,78
050,30,027,"Montana","Fergus County",5,74,153,81,72
050,30,027,"Montana","Fergus County",5,75,155,86,69
050,30,027,"Montana","Fergus County",5,76,153,79,74
050,30,027,"Montana","Fergus County",5,77,102,50,52
050,30,027,"Montana","Fergus County",5,78,98,52,46
050,30,027,"Montana","Fergus County",5,79,99,52,47
050,30,027,"Montana","Fergus County",5,80,95,50,45
050,30,027,"Montana","Fergus County",5,81,85,43,42
050,30,027,"Montana","Fergus County",5,82,69,33,36
050,30,027,"Montana","Fergus County",5,83,68,38,30
050,30,027,"Montana","Fergus County",5,84,57,26,31
050,30,027,"Montana","Fergus County",5,85,267,108,159
050,30,029,"Montana","Flathead County",1,0,1087,556,531
050,30,029,"Montana","Flathead County",1,1,1083,554,529
050,30,029,"Montana","Flathead County",1,2,1140,574,566
050,30,029,"Montana","Flathead County",1,3,1236,629,607
050,30,029,"Montana","Flathead County",1,4,1216,632,584
050,30,029,"Montana","Flathead County",1,5,1203,624,579
050,30,029,"Montana","Flathead County",1,6,1241,643,598
050,30,029,"Montana","Flathead County",1,7,1310,675,635
050,30,029,"Montana","Flathead County",1,8,1284,666,618
050,30,029,"Montana","Flathead County",1,9,1316,680,636
050,30,029,"Montana","Flathead County",1,10,1311,671,640
050,30,029,"Montana","Flathead County",1,11,1364,692,672
050,30,029,"Montana","Flathead County",1,12,1396,735,661
050,30,029,"Montana","Flathead County",1,13,1328,739,589
050,30,029,"Montana","Flathead County",1,14,1346,717,629
050,30,029,"Montana","Flathead County",1,15,1331,710,621
050,30,029,"Montana","Flathead County",1,16,1323,684,639
050,30,029,"Montana","Flathead County",1,17,1300,687,613
050,30,029,"Montana","Flathead County",1,18,1110,602,508
050,30,029,"Montana","Flathead County",1,19,813,453,360
050,30,029,"Montana","Flathead County",1,20,877,472,405
050,30,029,"Montana","Flathead County",1,21,907,457,450
050,30,029,"Montana","Flathead County",1,22,986,502,484
050,30,029,"Montana","Flathead County",1,23,1014,513,501
050,30,029,"Montana","Flathead County",1,24,1076,545,531
050,30,029,"Montana","Flathead County",1,25,1123,583,540
050,30,029,"Montana","Flathead County",1,26,1151,589,562
050,30,029,"Montana","Flathead County",1,27,1258,600,658
050,30,029,"Montana","Flathead County",1,28,1321,642,679
050,30,029,"Montana","Flathead County",1,29,1293,652,641
050,30,029,"Montana","Flathead County",1,30,1255,636,619
050,30,029,"Montana","Flathead County",1,31,1238,611,627
050,30,029,"Montana","Flathead County",1,32,1265,602,663
050,30,029,"Montana","Flathead County",1,33,1239,628,611
050,30,029,"Montana","Flathead County",1,34,1237,632,605
050,30,029,"Montana","Flathead County",1,35,1322,672,650
050,30,029,"Montana","Flathead County",1,36,1358,654,704
050,30,029,"Montana","Flathead County",1,37,1443,713,730
050,30,029,"Montana","Flathead County",1,38,1386,694,692
050,30,029,"Montana","Flathead County",1,39,1384,697,687
050,30,029,"Montana","Flathead County",1,40,1412,683,729
050,30,029,"Montana","Flathead County",1,41,1407,734,673
050,30,029,"Montana","Flathead County",1,42,1308,685,623
050,30,029,"Montana","Flathead County",1,43,1266,643,623
050,30,029,"Montana","Flathead County",1,44,1244,618,626
050,30,029,"Montana","Flathead County",1,45,1246,628,618
050,30,029,"Montana","Flathead County",1,46,1169,614,555
050,30,029,"Montana","Flathead County",1,47,1120,585,535
050,30,029,"Montana","Flathead County",1,48,1194,632,562
050,30,029,"Montana","Flathead County",1,49,1326,669,657
050,30,029,"Montana","Flathead County",1,50,1284,647,637
050,30,029,"Montana","Flathead County",1,51,1278,645,633
050,30,029,"Montana","Flathead County",1,52,1213,622,591
050,30,029,"Montana","Flathead County",1,53,1179,589,590
050,30,029,"Montana","Flathead County",1,54,1243,611,632
050,30,029,"Montana","Flathead County",1,55,1312,647,665
050,30,029,"Montana","Flathead County",1,56,1379,677,702
050,30,029,"Montana","Flathead County",1,57,1437,707,730
050,30,029,"Montana","Flathead County",1,58,1527,760,767
050,30,029,"Montana","Flathead County",1,59,1545,742,803
050,30,029,"Montana","Flathead County",1,60,1579,741,838
050,30,029,"Montana","Flathead County",1,61,1590,766,824
050,30,029,"Montana","Flathead County",1,62,1658,805,853
050,30,029,"Montana","Flathead County",1,63,1667,815,852
050,30,029,"Montana","Flathead County",1,64,1679,788,891
050,30,029,"Montana","Flathead County",1,65,1680,806,874
050,30,029,"Montana","Flathead County",1,66,1597,788,809
050,30,029,"Montana","Flathead County",1,67,1571,792,779
050,30,029,"Montana","Flathead County",1,68,1521,756,765
050,30,029,"Montana","Flathead County",1,69,1356,666,690
050,30,029,"Montana","Flathead County",1,70,1314,666,648
050,30,029,"Montana","Flathead County",1,71,1265,636,629
050,30,029,"Montana","Flathead County",1,72,1265,638,627
050,30,029,"Montana","Flathead County",1,73,1189,599,590
050,30,029,"Montana","Flathead County",1,74,829,419,410
050,30,029,"Montana","Flathead County",1,75,802,402,400
050,30,029,"Montana","Flathead County",1,76,803,411,392
050,30,029,"Montana","Flathead County",1,77,742,363,379
050,30,029,"Montana","Flathead County",1,78,642,304,338
050,30,029,"Montana","Flathead County",1,79,617,301,316
050,30,029,"Montana","Flathead County",1,80,512,247,265
050,30,029,"Montana","Flathead County",1,81,486,254,232
050,30,029,"Montana","Flathead County",1,82,406,188,218
050,30,029,"Montana","Flathead County",1,83,382,181,201
050,30,029,"Montana","Flathead County",1,84,359,165,194
050,30,029,"Montana","Flathead County",1,85,1883,749,1134
050,30,029,"Montana","Flathead County",2,0,1093,557,536
050,30,029,"Montana","Flathead County",2,1,1083,555,528
050,30,029,"Montana","Flathead County",2,2,1137,575,562
050,30,029,"Montana","Flathead County",2,3,1214,616,598
050,30,029,"Montana","Flathead County",2,4,1234,638,596
050,30,029,"Montana","Flathead County",2,5,1217,635,582
050,30,029,"Montana","Flathead County",2,6,1241,646,595
050,30,029,"Montana","Flathead County",2,7,1296,671,625
050,30,029,"Montana","Flathead County",2,8,1295,673,622
050,30,029,"Montana","Flathead County",2,9,1309,678,631
050,30,029,"Montana","Flathead County",2,10,1319,676,643
050,30,029,"Montana","Flathead County",2,11,1356,690,666
050,30,029,"Montana","Flathead County",2,12,1401,734,667
050,30,029,"Montana","Flathead County",2,13,1353,745,608
050,30,029,"Montana","Flathead County",2,14,1348,726,622
050,30,029,"Montana","Flathead County",2,15,1342,716,626
050,30,029,"Montana","Flathead County",2,16,1335,695,640
050,30,029,"Montana","Flathead County",2,17,1311,687,624
050,30,029,"Montana","Flathead County",2,18,1101,601,500
050,30,029,"Montana","Flathead County",2,19,844,467,377
050,30,029,"Montana","Flathead County",2,20,887,479,408
050,30,029,"Montana","Flathead County",2,21,911,465,446
050,30,029,"Montana","Flathead County",2,22,985,498,487
050,30,029,"Montana","Flathead County",2,23,1025,520,505
050,30,029,"Montana","Flathead County",2,24,1076,548,528
050,30,029,"Montana","Flathead County",2,25,1123,578,545
050,30,029,"Montana","Flathead County",2,26,1156,591,565
050,30,029,"Montana","Flathead County",2,27,1247,606,641
050,30,029,"Montana","Flathead County",2,28,1312,637,675
050,30,029,"Montana","Flathead County",2,29,1309,657,652
050,30,029,"Montana","Flathead County",2,30,1283,651,632
050,30,029,"Montana","Flathead County",2,31,1255,622,633
050,30,029,"Montana","Flathead County",2,32,1269,607,662
050,30,029,"Montana","Flathead County",2,33,1249,621,628
050,30,029,"Montana","Flathead County",2,34,1245,637,608
050,30,029,"Montana","Flathead County",2,35,1313,668,645
050,30,029,"Montana","Flathead County",2,36,1350,658,692
050,30,029,"Montana","Flathead County",2,37,1434,704,730
050,30,029,"Montana","Flathead County",2,38,1411,703,708
050,30,029,"Montana","Flathead County",2,39,1392,698,694
050,30,029,"Montana","Flathead County",2,40,1428,700,728
050,30,029,"Montana","Flathead County",2,41,1414,724,690
050,30,029,"Montana","Flathead County",2,42,1325,694,631
050,30,029,"Montana","Flathead County",2,43,1288,659,629
050,30,029,"Montana","Flathead County",2,44,1241,620,621
050,30,029,"Montana","Flathead County",2,45,1259,635,624
050,30,029,"Montana","Flathead County",2,46,1189,617,572
050,30,029,"Montana","Flathead County",2,47,1134,594,540
050,30,029,"Montana","Flathead County",2,48,1180,621,559
050,30,029,"Montana","Flathead County",2,49,1299,666,633
050,30,029,"Montana","Flathead County",2,50,1309,661,648
050,30,029,"Montana","Flathead County",2,51,1285,647,638
050,30,029,"Montana","Flathead County",2,52,1229,629,600
050,30,029,"Montana","Flathead County",2,53,1192,599,593
050,30,029,"Montana","Flathead County",2,54,1235,609,626
050,30,029,"Montana","Flathead County",2,55,1301,637,664
050,30,029,"Montana","Flathead County",2,56,1374,678,696
050,30,029,"Montana","Flathead County",2,57,1431,706,725
050,30,029,"Montana","Flathead County",2,58,1502,741,761
050,30,029,"Montana","Flathead County",2,59,1555,753,802
050,30,029,"Montana","Flathead County",2,60,1565,737,828
050,30,029,"Montana","Flathead County",2,61,1589,759,830
050,30,029,"Montana","Flathead County",2,62,1646,800,846
050,30,029,"Montana","Flathead County",2,63,1690,827,863
050,30,029,"Montana","Flathead County",2,64,1671,789,882
050,30,029,"Montana","Flathead County",2,65,1683,799,884
050,30,029,"Montana","Flathead County",2,66,1625,795,830
050,30,029,"Montana","Flathead County",2,67,1578,788,790
050,30,029,"Montana","Flathead County",2,68,1518,759,759
050,30,029,"Montana","Flathead County",2,69,1408,695,713
050,30,029,"Montana","Flathead County",2,70,1319,661,658
050,30,029,"Montana","Flathead County",2,71,1277,641,636
050,30,029,"Montana","Flathead County",2,72,1247,630,617
050,30,029,"Montana","Flathead County",2,73,1270,641,629
050,30,029,"Montana","Flathead County",2,74,865,433,432
050,30,029,"Montana","Flathead County",2,75,804,405,399
050,30,029,"Montana","Flathead County",2,76,789,399,390
050,30,029,"Montana","Flathead County",2,77,768,376,392
050,30,029,"Montana","Flathead County",2,78,648,309,339
050,30,029,"Montana","Flathead County",2,79,619,297,322
050,30,029,"Montana","Flathead County",2,80,535,256,279
050,30,029,"Montana","Flathead County",2,81,489,254,235
050,30,029,"Montana","Flathead County",2,82,415,197,218
050,30,029,"Montana","Flathead County",2,83,380,183,197
050,30,029,"Montana","Flathead County",2,84,354,160,194
050,30,029,"Montana","Flathead County",2,85,1893,751,1142
050,30,029,"Montana","Flathead County",3,0,1091,555,536
050,30,029,"Montana","Flathead County",3,1,1124,569,555
050,30,029,"Montana","Flathead County",3,2,1153,593,560
050,30,029,"Montana","Flathead County",3,3,1211,612,599
050,30,029,"Montana","Flathead County",3,4,1271,638,633
050,30,029,"Montana","Flathead County",3,5,1313,673,640
050,30,029,"Montana","Flathead County",3,6,1292,674,618
050,30,029,"Montana","Flathead County",3,7,1297,668,629
050,30,029,"Montana","Flathead County",3,8,1380,703,677
050,30,029,"Montana","Flathead County",3,9,1384,716,668
050,30,029,"Montana","Flathead County",3,10,1338,680,658
050,30,029,"Montana","Flathead County",3,11,1381,706,675
050,30,029,"Montana","Flathead County",3,12,1391,705,686
050,30,029,"Montana","Flathead County",3,13,1450,751,699
050,30,029,"Montana","Flathead County",3,14,1388,752,636
050,30,029,"Montana","Flathead County",3,15,1390,740,650
050,30,029,"Montana","Flathead County",3,16,1367,728,639
050,30,029,"Montana","Flathead County",3,17,1405,733,672
050,30,029,"Montana","Flathead County",3,18,1137,625,512
050,30,029,"Montana","Flathead County",3,19,883,474,409
050,30,029,"Montana","Flathead County",3,20,955,517,438
050,30,029,"Montana","Flathead County",3,21,967,507,460
050,30,029,"Montana","Flathead County",3,22,1035,509,526
050,30,029,"Montana","Flathead County",3,23,1123,561,562
050,30,029,"Montana","Flathead County",3,24,1147,588,559
050,30,029,"Montana","Flathead County",3,25,1173,592,581
050,30,029,"Montana","Flathead County",3,26,1238,630,608
050,30,029,"Montana","Flathead County",3,27,1214,614,600
050,30,029,"Montana","Flathead County",3,28,1335,636,699
050,30,029,"Montana","Flathead County",3,29,1427,713,714
050,30,029,"Montana","Flathead County",3,30,1393,707,686
050,30,029,"Montana","Flathead County",3,31,1400,702,698
050,30,029,"Montana","Flathead County",3,32,1364,669,695
050,30,029,"Montana","Flathead County",3,33,1376,678,698
050,30,029,"Montana","Flathead County",3,34,1365,697,668
050,30,029,"Montana","Flathead County",3,35,1330,689,641
050,30,029,"Montana","Flathead County",3,36,1373,696,677
050,30,029,"Montana","Flathead County",3,37,1418,694,724
050,30,029,"Montana","Flathead County",3,38,1491,733,758
050,30,029,"Montana","Flathead County",3,39,1461,726,735
050,30,029,"Montana","Flathead County",3,40,1459,725,734
050,30,029,"Montana","Flathead County",3,41,1475,729,746
050,30,029,"Montana","Flathead County",3,42,1447,734,713
050,30,029,"Montana","Flathead County",3,43,1409,732,677
050,30,029,"Montana","Flathead County",3,44,1307,675,632
050,30,029,"Montana","Flathead County",3,45,1298,657,641
050,30,029,"Montana","Flathead County",3,46,1310,657,653
050,30,029,"Montana","Flathead County",3,47,1214,627,587
050,30,029,"Montana","Flathead County",3,48,1173,608,565
050,30,029,"Montana","Flathead County",3,49,1206,642,564
050,30,029,"Montana","Flathead County",3,50,1329,692,637
050,30,029,"Montana","Flathead County",3,51,1336,672,664
050,30,029,"Montana","Flathead County",3,52,1305,656,649
050,30,029,"Montana","Flathead County",3,53,1241,629,612
050,30,029,"Montana","Flathead County",3,54,1224,620,604
050,30,029,"Montana","Flathead County",3,55,1273,626,647
050,30,029,"Montana","Flathead County",3,56,1362,659,703
050,30,029,"Montana","Flathead County",3,57,1430,707,723
050,30,029,"Montana","Flathead County",3,58,1485,724,761
050,30,029,"Montana","Flathead County",3,59,1523,756,767
050,30,029,"Montana","Flathead County",3,60,1593,762,831
050,30,029,"Montana","Flathead County",3,61,1626,765,861
050,30,029,"Montana","Flathead County",3,62,1625,774,851
050,30,029,"Montana","Flathead County",3,63,1661,794,867
050,30,029,"Montana","Flathead County",3,64,1704,835,869
050,30,029,"Montana","Flathead County",3,65,1664,773,891
050,30,029,"Montana","Flathead County",3,66,1704,807,897
050,30,029,"Montana","Flathead County",3,67,1648,805,843
050,30,029,"Montana","Flathead County",3,68,1596,804,792
050,30,029,"Montana","Flathead County",3,69,1511,749,762
050,30,029,"Montana","Flathead County",3,70,1387,674,713
050,30,029,"Montana","Flathead County",3,71,1296,644,652
050,30,029,"Montana","Flathead County",3,72,1270,632,638
050,30,029,"Montana","Flathead County",3,73,1225,616,609
050,30,029,"Montana","Flathead County",3,74,1258,630,628
050,30,029,"Montana","Flathead County",3,75,827,415,412
050,30,029,"Montana","Flathead County",3,76,783,393,390
050,30,029,"Montana","Flathead County",3,77,772,386,386
050,30,029,"Montana","Flathead County",3,78,727,350,377
050,30,029,"Montana","Flathead County",3,79,629,295,334
050,30,029,"Montana","Flathead County",3,80,601,278,323
050,30,029,"Montana","Flathead County",3,81,513,248,265
050,30,029,"Montana","Flathead County",3,82,450,225,225
050,30,029,"Montana","Flathead County",3,83,395,193,202
050,30,029,"Montana","Flathead County",3,84,330,147,183
050,30,029,"Montana","Flathead County",3,85,1937,775,1162
050,30,029,"Montana","Flathead County",4,0,1156,577,579
050,30,029,"Montana","Flathead County",4,1,1142,561,581
050,30,029,"Montana","Flathead County",4,2,1175,606,569
050,30,029,"Montana","Flathead County",4,3,1222,637,585
050,30,029,"Montana","Flathead County",4,4,1279,649,630
050,30,029,"Montana","Flathead County",4,5,1321,661,660
050,30,029,"Montana","Flathead County",4,6,1395,715,680
050,30,029,"Montana","Flathead County",4,7,1368,719,649
050,30,029,"Montana","Flathead County",4,8,1328,675,653
050,30,029,"Montana","Flathead County",4,9,1420,726,694
050,30,029,"Montana","Flathead County",4,10,1430,740,690
050,30,029,"Montana","Flathead County",4,11,1392,709,683
050,30,029,"Montana","Flathead County",4,12,1427,722,705
050,30,029,"Montana","Flathead County",4,13,1435,733,702
050,30,029,"Montana","Flathead County",4,14,1486,761,725
050,30,029,"Montana","Flathead County",4,15,1438,772,666
050,30,029,"Montana","Flathead County",4,16,1453,773,680
050,30,029,"Montana","Flathead County",4,17,1416,743,673
050,30,029,"Montana","Flathead County",4,18,1167,631,536
050,30,029,"Montana","Flathead County",4,19,862,475,387
050,30,029,"Montana","Flathead County",4,20,965,514,451
050,30,029,"Montana","Flathead County",4,21,1003,533,470
050,30,029,"Montana","Flathead County",4,22,1096,524,572
050,30,029,"Montana","Flathead County",4,23,1118,573,545
050,30,029,"Montana","Flathead County",4,24,1225,620,605
050,30,029,"Montana","Flathead County",4,25,1199,615,584
050,30,029,"Montana","Flathead County",4,26,1225,631,594
050,30,029,"Montana","Flathead County",4,27,1323,679,644
050,30,029,"Montana","Flathead County",4,28,1315,653,662
050,30,029,"Montana","Flathead County",4,29,1417,663,754
050,30,029,"Montana","Flathead County",4,30,1481,734,747
050,30,029,"Montana","Flathead County",4,31,1498,759,739
050,30,029,"Montana","Flathead County",4,32,1442,721,721
050,30,029,"Montana","Flathead County",4,33,1475,747,728
050,30,029,"Montana","Flathead County",4,34,1464,722,742
050,30,029,"Montana","Flathead County",4,35,1452,750,702
050,30,029,"Montana","Flathead County",4,36,1367,690,677
050,30,029,"Montana","Flathead County",4,37,1471,744,727
050,30,029,"Montana","Flathead County",4,38,1480,736,744
050,30,029,"Montana","Flathead County",4,39,1553,773,780
050,30,029,"Montana","Flathead County",4,40,1517,769,748
050,30,029,"Montana","Flathead County",4,41,1507,745,762
050,30,029,"Montana","Flathead County",4,42,1536,749,787
050,30,029,"Montana","Flathead County",4,43,1509,779,730
050,30,029,"Montana","Flathead County",4,44,1476,760,716
050,30,029,"Montana","Flathead County",4,45,1353,713,640
050,30,029,"Montana","Flathead County",4,46,1321,663,658
050,30,029,"Montana","Flathead County",4,47,1342,664,678
050,30,029,"Montana","Flathead County",4,48,1247,646,601
050,30,029,"Montana","Flathead County",4,49,1188,610,578
050,30,029,"Montana","Flathead County",4,50,1239,666,573
050,30,029,"Montana","Flathead County",4,51,1368,702,666
050,30,029,"Montana","Flathead County",4,52,1364,690,674
050,30,029,"Montana","Flathead County",4,53,1334,671,663
050,30,029,"Montana","Flathead County",4,54,1312,665,647
050,30,029,"Montana","Flathead County",4,55,1238,628,610
050,30,029,"Montana","Flathead County",4,56,1314,653,661
050,30,029,"Montana","Flathead County",4,57,1399,684,715
050,30,029,"Montana","Flathead County",4,58,1475,735,740
050,30,029,"Montana","Flathead County",4,59,1516,729,787
050,30,029,"Montana","Flathead County",4,60,1552,758,794
050,30,029,"Montana","Flathead County",4,61,1632,778,854
050,30,029,"Montana","Flathead County",4,62,1651,782,869
050,30,029,"Montana","Flathead County",4,63,1649,783,866
050,30,029,"Montana","Flathead County",4,64,1637,773,864
050,30,029,"Montana","Flathead County",4,65,1693,835,858
050,30,029,"Montana","Flathead County",4,66,1649,765,884
050,30,029,"Montana","Flathead County",4,67,1696,808,888
050,30,029,"Montana","Flathead County",4,68,1631,800,831
050,30,029,"Montana","Flathead County",4,69,1599,809,790
050,30,029,"Montana","Flathead County",4,70,1490,731,759
050,30,029,"Montana","Flathead County",4,71,1353,672,681
050,30,029,"Montana","Flathead County",4,72,1266,634,632
050,30,029,"Montana","Flathead County",4,73,1228,601,627
050,30,029,"Montana","Flathead County",4,74,1189,592,597
050,30,029,"Montana","Flathead County",4,75,1211,604,607
050,30,029,"Montana","Flathead County",4,76,808,412,396
050,30,029,"Montana","Flathead County",4,77,751,378,373
050,30,029,"Montana","Flathead County",4,78,732,362,370
050,30,029,"Montana","Flathead County",4,79,687,328,359
050,30,029,"Montana","Flathead County",4,80,594,273,321
050,30,029,"Montana","Flathead County",4,81,559,271,288
050,30,029,"Montana","Flathead County",4,82,472,219,253
050,30,029,"Montana","Flathead County",4,83,428,219,209
050,30,029,"Montana","Flathead County",4,84,351,166,185
050,30,029,"Montana","Flathead County",4,85,1941,782,1159
050,30,029,"Montana","Flathead County",5,0,1152,576,576
050,30,029,"Montana","Flathead County",5,1,1207,601,606
050,30,029,"Montana","Flathead County",5,2,1142,561,581
050,30,029,"Montana","Flathead County",5,3,1210,626,584
050,30,029,"Montana","Flathead County",5,4,1268,657,611
050,30,029,"Montana","Flathead County",5,5,1291,656,635
050,30,029,"Montana","Flathead County",5,6,1347,676,671
050,30,029,"Montana","Flathead County",5,7,1430,737,693
050,30,029,"Montana","Flathead County",5,8,1398,744,654
050,30,029,"Montana","Flathead County",5,9,1396,712,684
050,30,029,"Montana","Flathead County",5,10,1452,740,712
050,30,029,"Montana","Flathead County",5,11,1448,743,705
050,30,029,"Montana","Flathead County",5,12,1396,718,678
050,30,029,"Montana","Flathead County",5,13,1437,726,711
050,30,029,"Montana","Flathead County",5,14,1462,756,706
050,30,029,"Montana","Flathead County",5,15,1492,774,718
050,30,029,"Montana","Flathead County",5,16,1457,791,666
050,30,029,"Montana","Flathead County",5,17,1464,792,672
050,30,029,"Montana","Flathead County",5,18,1161,639,522
050,30,029,"Montana","Flathead County",5,19,909,487,422
050,30,029,"Montana","Flathead County",5,20,954,522,432
050,30,029,"Montana","Flathead County",5,21,1051,564,487
050,30,029,"Montana","Flathead County",5,22,1119,565,554
050,30,029,"Montana","Flathead County",5,23,1168,574,594
050,30,029,"Montana","Flathead County",5,24,1165,620,545
050,30,029,"Montana","Flathead County",5,25,1253,634,619
050,30,029,"Montana","Flathead County",5,26,1278,651,627
050,30,029,"Montana","Flathead County",5,27,1283,676,607
050,30,029,"Montana","Flathead County",5,28,1398,719,679
050,30,029,"Montana","Flathead County",5,29,1397,685,712
050,30,029,"Montana","Flathead County",5,30,1479,704,775
050,30,029,"Montana","Flathead County",5,31,1530,752,778
050,30,029,"Montana","Flathead County",5,32,1526,788,738
050,30,029,"Montana","Flathead County",5,33,1515,744,771
050,30,029,"Montana","Flathead County",5,34,1529,772,757
050,30,029,"Montana","Flathead County",5,35,1527,756,771
050,30,029,"Montana","Flathead County",5,36,1459,734,725
050,30,029,"Montana","Flathead County",5,37,1452,740,712
050,30,029,"Montana","Flathead County",5,38,1504,759,745
050,30,029,"Montana","Flathead County",5,39,1486,748,738
050,30,029,"Montana","Flathead County",5,40,1573,785,788
050,30,029,"Montana","Flathead County",5,41,1547,784,763
050,30,029,"Montana","Flathead County",5,42,1553,783,770
050,30,029,"Montana","Flathead County",5,43,1574,772,802
050,30,029,"Montana","Flathead County",5,44,1511,774,737
050,30,029,"Montana","Flathead County",5,45,1471,757,714
050,30,029,"Montana","Flathead County",5,46,1373,720,653
050,30,029,"Montana","Flathead County",5,47,1350,678,672
050,30,029,"Montana","Flathead County",5,48,1366,667,699
050,30,029,"Montana","Flathead County",5,49,1239,646,593
050,30,029,"Montana","Flathead County",5,50,1225,626,599
050,30,029,"Montana","Flathead County",5,51,1255,672,583
050,30,029,"Montana","Flathead County",5,52,1380,714,666
050,30,029,"Montana","Flathead County",5,53,1366,696,670
050,30,029,"Montana","Flathead County",5,54,1354,681,673
050,30,029,"Montana","Flathead County",5,55,1307,656,651
050,30,029,"Montana","Flathead County",5,56,1255,630,625
050,30,029,"Montana","Flathead County",5,57,1327,663,664
050,30,029,"Montana","Flathead County",5,58,1406,700,706
050,30,029,"Montana","Flathead County",5,59,1483,738,745
050,30,029,"Montana","Flathead County",5,60,1532,732,800
050,30,029,"Montana","Flathead County",5,61,1586,763,823
050,30,029,"Montana","Flathead County",5,62,1618,789,829
050,30,029,"Montana","Flathead County",5,63,1624,768,856
050,30,029,"Montana","Flathead County",5,64,1648,777,871
050,30,029,"Montana","Flathead County",5,65,1608,767,841
050,30,029,"Montana","Flathead County",5,66,1666,821,845
050,30,029,"Montana","Flathead County",5,67,1641,761,880
050,30,029,"Montana","Flathead County",5,68,1667,795,872
050,30,029,"Montana","Flathead County",5,69,1619,796,823
050,30,029,"Montana","Flathead County",5,70,1585,795,790
050,30,029,"Montana","Flathead County",5,71,1465,724,741
050,30,029,"Montana","Flathead County",5,72,1333,655,678
050,30,029,"Montana","Flathead County",5,73,1253,615,638
050,30,029,"Montana","Flathead County",5,74,1227,599,628
050,30,029,"Montana","Flathead County",5,75,1150,576,574
050,30,029,"Montana","Flathead County",5,76,1166,583,583
050,30,029,"Montana","Flathead County",5,77,792,395,397
050,30,029,"Montana","Flathead County",5,78,720,361,359
050,30,029,"Montana","Flathead County",5,79,703,353,350
050,30,029,"Montana","Flathead County",5,80,661,310,351
050,30,029,"Montana","Flathead County",5,81,563,265,298
050,30,029,"Montana","Flathead County",5,82,518,246,272
050,30,029,"Montana","Flathead County",5,83,440,213,227
050,30,029,"Montana","Flathead County",5,84,395,194,201
050,30,029,"Montana","Flathead County",5,85,1992,835,1157
050,30,031,"Montana","Gallatin County",1,0,1142,586,556
050,30,031,"Montana","Gallatin County",1,1,1135,558,577
050,30,031,"Montana","Gallatin County",1,2,1199,584,615
050,30,031,"Montana","Gallatin County",1,3,1213,599,614
050,30,031,"Montana","Gallatin County",1,4,1354,683,671
050,30,031,"Montana","Gallatin County",1,5,1363,701,662
050,30,031,"Montana","Gallatin County",1,6,1376,715,661
050,30,031,"Montana","Gallatin County",1,7,1317,686,631
050,30,031,"Montana","Gallatin County",1,8,1328,676,652
050,30,031,"Montana","Gallatin County",1,9,1285,662,623
050,30,031,"Montana","Gallatin County",1,10,1356,673,683
050,30,031,"Montana","Gallatin County",1,11,1368,710,658
050,30,031,"Montana","Gallatin County",1,12,1403,714,689
050,30,031,"Montana","Gallatin County",1,13,1389,706,683
050,30,031,"Montana","Gallatin County",1,14,1347,665,682
050,30,031,"Montana","Gallatin County",1,15,1260,632,628
050,30,031,"Montana","Gallatin County",1,16,1301,666,635
050,30,031,"Montana","Gallatin County",1,17,1261,619,642
050,30,031,"Montana","Gallatin County",1,18,1782,911,871
050,30,031,"Montana","Gallatin County",1,19,2947,1666,1281
050,30,031,"Montana","Gallatin County",1,20,2846,1546,1300
050,30,031,"Montana","Gallatin County",1,21,2967,1595,1372
050,30,031,"Montana","Gallatin County",1,22,3133,1703,1430
050,30,031,"Montana","Gallatin County",1,23,2965,1684,1281
050,30,031,"Montana","Gallatin County",1,24,2520,1454,1066
050,30,031,"Montana","Gallatin County",1,25,2312,1293,1019
050,30,031,"Montana","Gallatin County",1,26,2232,1260,972
050,30,031,"Montana","Gallatin County",1,27,2069,1139,930
050,30,031,"Montana","Gallatin County",1,28,2052,1144,908
050,30,031,"Montana","Gallatin County",1,29,1924,1034,890
050,30,031,"Montana","Gallatin County",1,30,1887,968,919
050,30,031,"Montana","Gallatin County",1,31,1786,957,829
050,30,031,"Montana","Gallatin County",1,32,1763,960,803
050,30,031,"Montana","Gallatin County",1,33,1655,881,774
050,30,031,"Montana","Gallatin County",1,34,1747,892,855
050,30,031,"Montana","Gallatin County",1,35,1832,954,878
050,30,031,"Montana","Gallatin County",1,36,1773,946,827
050,30,031,"Montana","Gallatin County",1,37,1810,958,852
050,30,031,"Montana","Gallatin County",1,38,1769,914,855
050,30,031,"Montana","Gallatin County",1,39,1719,912,807
050,30,031,"Montana","Gallatin County",1,40,1711,922,789
050,30,031,"Montana","Gallatin County",1,41,1634,897,737
050,30,031,"Montana","Gallatin County",1,42,1566,859,707
050,30,031,"Montana","Gallatin County",1,43,1479,783,696
050,30,031,"Montana","Gallatin County",1,44,1371,730,641
050,30,031,"Montana","Gallatin County",1,45,1366,716,650
050,30,031,"Montana","Gallatin County",1,46,1278,679,599
050,30,031,"Montana","Gallatin County",1,47,1268,683,585
050,30,031,"Montana","Gallatin County",1,48,1302,648,654
050,30,031,"Montana","Gallatin County",1,49,1395,746,649
050,30,031,"Montana","Gallatin County",1,50,1246,655,591
050,30,031,"Montana","Gallatin County",1,51,1163,618,545
050,30,031,"Montana","Gallatin County",1,52,1087,569,518
050,30,031,"Montana","Gallatin County",1,53,1063,566,497
050,30,031,"Montana","Gallatin County",1,54,1151,589,562
050,30,031,"Montana","Gallatin County",1,55,1195,608,587
050,30,031,"Montana","Gallatin County",1,56,1214,596,618
050,30,031,"Montana","Gallatin County",1,57,1282,643,639
050,30,031,"Montana","Gallatin County",1,58,1261,672,589
050,30,031,"Montana","Gallatin County",1,59,1337,693,644
050,30,031,"Montana","Gallatin County",1,60,1346,687,659
050,30,031,"Montana","Gallatin County",1,61,1290,626,664
050,30,031,"Montana","Gallatin County",1,62,1287,653,634
050,30,031,"Montana","Gallatin County",1,63,1296,642,654
050,30,031,"Montana","Gallatin County",1,64,1268,642,626
050,30,031,"Montana","Gallatin County",1,65,1216,618,598
050,30,031,"Montana","Gallatin County",1,66,1226,604,622
050,30,031,"Montana","Gallatin County",1,67,1218,602,616
050,30,031,"Montana","Gallatin County",1,68,1132,551,581
050,30,031,"Montana","Gallatin County",1,69,987,454,533
050,30,031,"Montana","Gallatin County",1,70,967,485,482
050,30,031,"Montana","Gallatin County",1,71,899,457,442
050,30,031,"Montana","Gallatin County",1,72,909,468,441
050,30,031,"Montana","Gallatin County",1,73,871,464,407
050,30,031,"Montana","Gallatin County",1,74,574,297,277
050,30,031,"Montana","Gallatin County",1,75,542,275,267
050,30,031,"Montana","Gallatin County",1,76,552,258,294
050,30,031,"Montana","Gallatin County",1,77,528,269,259
050,30,031,"Montana","Gallatin County",1,78,444,231,213
050,30,031,"Montana","Gallatin County",1,79,382,181,201
050,30,031,"Montana","Gallatin County",1,80,346,157,189
050,30,031,"Montana","Gallatin County",1,81,319,152,167
050,30,031,"Montana","Gallatin County",1,82,259,120,139
050,30,031,"Montana","Gallatin County",1,83,222,95,127
050,30,031,"Montana","Gallatin County",1,84,216,104,112
050,30,031,"Montana","Gallatin County",1,85,1406,555,851
050,30,031,"Montana","Gallatin County",2,0,1144,579,565
050,30,031,"Montana","Gallatin County",2,1,1134,562,572
050,30,031,"Montana","Gallatin County",2,2,1180,580,600
050,30,031,"Montana","Gallatin County",2,3,1211,596,615
050,30,031,"Montana","Gallatin County",2,4,1325,664,661
050,30,031,"Montana","Gallatin County",2,5,1359,696,663
050,30,031,"Montana","Gallatin County",2,6,1376,711,665
050,30,031,"Montana","Gallatin County",2,7,1341,698,643
050,30,031,"Montana","Gallatin County",2,8,1331,681,650
050,30,031,"Montana","Gallatin County",2,9,1299,668,631
050,30,031,"Montana","Gallatin County",2,10,1334,667,667
050,30,031,"Montana","Gallatin County",2,11,1369,703,666
050,30,031,"Montana","Gallatin County",2,12,1404,718,686
050,30,031,"Montana","Gallatin County",2,13,1396,710,686
050,30,031,"Montana","Gallatin County",2,14,1359,677,682
050,30,031,"Montana","Gallatin County",2,15,1289,644,645
050,30,031,"Montana","Gallatin County",2,16,1296,659,637
050,30,031,"Montana","Gallatin County",2,17,1285,638,647
050,30,031,"Montana","Gallatin County",2,18,1820,926,894
050,30,031,"Montana","Gallatin County",2,19,2963,1668,1295
050,30,031,"Montana","Gallatin County",2,20,2855,1562,1293
050,30,031,"Montana","Gallatin County",2,21,2955,1580,1375
050,30,031,"Montana","Gallatin County",2,22,3133,1705,1428
050,30,031,"Montana","Gallatin County",2,23,2971,1684,1287
050,30,031,"Montana","Gallatin County",2,24,2535,1448,1087
050,30,031,"Montana","Gallatin County",2,25,2308,1301,1007
050,30,031,"Montana","Gallatin County",2,26,2218,1243,975
050,30,031,"Montana","Gallatin County",2,27,2088,1157,931
050,30,031,"Montana","Gallatin County",2,28,2057,1142,915
050,30,031,"Montana","Gallatin County",2,29,1957,1059,898
050,30,031,"Montana","Gallatin County",2,30,1905,987,918
050,30,031,"Montana","Gallatin County",2,31,1811,960,851
050,30,031,"Montana","Gallatin County",2,32,1769,957,812
050,30,031,"Montana","Gallatin County",2,33,1682,900,782
050,30,031,"Montana","Gallatin County",2,34,1733,891,842
050,30,031,"Montana","Gallatin County",2,35,1825,946,879
050,30,031,"Montana","Gallatin County",2,36,1773,936,837
050,30,031,"Montana","Gallatin County",2,37,1806,956,850
050,30,031,"Montana","Gallatin County",2,38,1792,932,860
050,30,031,"Montana","Gallatin County",2,39,1735,918,817
050,30,031,"Montana","Gallatin County",2,40,1724,925,799
050,30,031,"Montana","Gallatin County",2,41,1659,905,754
050,30,031,"Montana","Gallatin County",2,42,1588,871,717
050,30,031,"Montana","Gallatin County",2,43,1518,811,707
050,30,031,"Montana","Gallatin County",2,44,1390,737,653
050,30,031,"Montana","Gallatin County",2,45,1382,728,654
050,30,031,"Montana","Gallatin County",2,46,1306,693,613
050,30,031,"Montana","Gallatin County",2,47,1270,679,591
050,30,031,"Montana","Gallatin County",2,48,1298,658,640
050,30,031,"Montana","Gallatin County",2,49,1376,725,651
050,30,031,"Montana","Gallatin County",2,50,1293,683,610
050,30,031,"Montana","Gallatin County",2,51,1181,627,554
050,30,031,"Montana","Gallatin County",2,52,1098,579,519
050,30,031,"Montana","Gallatin County",2,53,1076,571,505
050,30,031,"Montana","Gallatin County",2,54,1125,581,544
050,30,031,"Montana","Gallatin County",2,55,1184,601,583
050,30,031,"Montana","Gallatin County",2,56,1212,602,610
050,30,031,"Montana","Gallatin County",2,57,1272,636,636
050,30,031,"Montana","Gallatin County",2,58,1268,665,603
050,30,031,"Montana","Gallatin County",2,59,1328,695,633
050,30,031,"Montana","Gallatin County",2,60,1334,683,651
050,30,031,"Montana","Gallatin County",2,61,1297,638,659
050,30,031,"Montana","Gallatin County",2,62,1289,644,645
050,30,031,"Montana","Gallatin County",2,63,1302,648,654
050,30,031,"Montana","Gallatin County",2,64,1272,644,628
050,30,031,"Montana","Gallatin County",2,65,1224,622,602
050,30,031,"Montana","Gallatin County",2,66,1224,605,619
050,30,031,"Montana","Gallatin County",2,67,1215,600,615
050,30,031,"Montana","Gallatin County",2,68,1144,560,584
050,30,031,"Montana","Gallatin County",2,69,1028,481,547
050,30,031,"Montana","Gallatin County",2,70,963,470,493
050,30,031,"Montana","Gallatin County",2,71,920,465,455
050,30,031,"Montana","Gallatin County",2,72,887,455,432
050,30,031,"Montana","Gallatin County",2,73,926,489,437
050,30,031,"Montana","Gallatin County",2,74,605,316,289
050,30,031,"Montana","Gallatin County",2,75,550,280,270
050,30,031,"Montana","Gallatin County",2,76,545,259,286
050,30,031,"Montana","Gallatin County",2,77,548,274,274
050,30,031,"Montana","Gallatin County",2,78,451,233,218
050,30,031,"Montana","Gallatin County",2,79,389,190,199
050,30,031,"Montana","Gallatin County",2,80,349,158,191
050,30,031,"Montana","Gallatin County",2,81,327,153,174
050,30,031,"Montana","Gallatin County",2,82,270,124,146
050,30,031,"Montana","Gallatin County",2,83,232,102,130
050,30,031,"Montana","Gallatin County",2,84,211,98,113
050,30,031,"Montana","Gallatin County",2,85,1424,566,858
050,30,031,"Montana","Gallatin County",3,0,1200,625,575
050,30,031,"Montana","Gallatin County",3,1,1164,593,571
050,30,031,"Montana","Gallatin County",3,2,1174,587,587
050,30,031,"Montana","Gallatin County",3,3,1211,604,607
050,30,031,"Montana","Gallatin County",3,4,1212,597,615
050,30,031,"Montana","Gallatin County",3,5,1346,682,664
050,30,031,"Montana","Gallatin County",3,6,1363,701,662
050,30,031,"Montana","Gallatin County",3,7,1406,736,670
050,30,031,"Montana","Gallatin County",3,8,1338,684,654
050,30,031,"Montana","Gallatin County",3,9,1365,706,659
050,30,031,"Montana","Gallatin County",3,10,1327,695,632
050,30,031,"Montana","Gallatin County",3,11,1347,682,665
050,30,031,"Montana","Gallatin County",3,12,1425,719,706
050,30,031,"Montana","Gallatin County",3,13,1412,709,703
050,30,031,"Montana","Gallatin County",3,14,1426,718,708
050,30,031,"Montana","Gallatin County",3,15,1393,702,691
050,30,031,"Montana","Gallatin County",3,16,1302,654,648
050,30,031,"Montana","Gallatin County",3,17,1322,677,645
050,30,031,"Montana","Gallatin County",3,18,1883,944,939
050,30,031,"Montana","Gallatin County",3,19,3002,1683,1319
050,30,031,"Montana","Gallatin County",3,20,2890,1592,1298
050,30,031,"Montana","Gallatin County",3,21,2994,1617,1377
050,30,031,"Montana","Gallatin County",3,22,3180,1754,1426
050,30,031,"Montana","Gallatin County",3,23,3073,1725,1348
050,30,031,"Montana","Gallatin County",3,24,2683,1515,1168
050,30,031,"Montana","Gallatin County",3,25,2331,1329,1002
050,30,031,"Montana","Gallatin County",3,26,2248,1264,984
050,30,031,"Montana","Gallatin County",3,27,2188,1245,943
050,30,031,"Montana","Gallatin County",3,28,2154,1196,958
050,30,031,"Montana","Gallatin County",3,29,2068,1135,933
050,30,031,"Montana","Gallatin County",3,30,2021,1104,917
050,30,031,"Montana","Gallatin County",3,31,1921,977,944
050,30,031,"Montana","Gallatin County",3,32,1903,1023,880
050,30,031,"Montana","Gallatin County",3,33,1805,952,853
050,30,031,"Montana","Gallatin County",3,34,1767,922,845
050,30,031,"Montana","Gallatin County",3,35,1777,922,855
050,30,031,"Montana","Gallatin County",3,36,1878,987,891
050,30,031,"Montana","Gallatin County",3,37,1815,960,855
050,30,031,"Montana","Gallatin County",3,38,1825,977,848
050,30,031,"Montana","Gallatin County",3,39,1798,927,871
050,30,031,"Montana","Gallatin County",3,40,1745,920,825
050,30,031,"Montana","Gallatin County",3,41,1782,946,836
050,30,031,"Montana","Gallatin County",3,42,1692,922,770
050,30,031,"Montana","Gallatin County",3,43,1620,888,732
050,30,031,"Montana","Gallatin County",3,44,1533,799,734
050,30,031,"Montana","Gallatin County",3,45,1405,750,655
050,30,031,"Montana","Gallatin County",3,46,1422,752,670
050,30,031,"Montana","Gallatin County",3,47,1341,705,636
050,30,031,"Montana","Gallatin County",3,48,1302,690,612
050,30,031,"Montana","Gallatin County",3,49,1323,679,644
050,30,031,"Montana","Gallatin County",3,50,1370,721,649
050,30,031,"Montana","Gallatin County",3,51,1312,685,627
050,30,031,"Montana","Gallatin County",3,52,1197,644,553
050,30,031,"Montana","Gallatin County",3,53,1133,600,533
050,30,031,"Montana","Gallatin County",3,54,1080,562,518
050,30,031,"Montana","Gallatin County",3,55,1134,588,546
050,30,031,"Montana","Gallatin County",3,56,1209,617,592
050,30,031,"Montana","Gallatin County",3,57,1232,612,620
050,30,031,"Montana","Gallatin County",3,58,1270,638,632
050,30,031,"Montana","Gallatin County",3,59,1256,644,612
050,30,031,"Montana","Gallatin County",3,60,1344,695,649
050,30,031,"Montana","Gallatin County",3,61,1340,688,652
050,30,031,"Montana","Gallatin County",3,62,1292,641,651
050,30,031,"Montana","Gallatin County",3,63,1271,632,639
050,30,031,"Montana","Gallatin County",3,64,1339,651,688
050,30,031,"Montana","Gallatin County",3,65,1256,648,608
050,30,031,"Montana","Gallatin County",3,66,1213,608,605
050,30,031,"Montana","Gallatin County",3,67,1209,605,604
050,30,031,"Montana","Gallatin County",3,68,1207,587,620
050,30,031,"Montana","Gallatin County",3,69,1139,561,578
050,30,031,"Montana","Gallatin County",3,70,1016,483,533
050,30,031,"Montana","Gallatin County",3,71,973,473,500
050,30,031,"Montana","Gallatin County",3,72,891,448,443
050,30,031,"Montana","Gallatin County",3,73,876,443,433
050,30,031,"Montana","Gallatin County",3,74,899,477,422
050,30,031,"Montana","Gallatin County",3,75,580,299,281
050,30,031,"Montana","Gallatin County",3,76,548,274,274
050,30,031,"Montana","Gallatin County",3,77,519,248,271
050,30,031,"Montana","Gallatin County",3,78,525,258,267
050,30,031,"Montana","Gallatin County",3,79,447,234,213
050,30,031,"Montana","Gallatin County",3,80,366,175,191
050,30,031,"Montana","Gallatin County",3,81,339,146,193
050,30,031,"Montana","Gallatin County",3,82,307,147,160
050,30,031,"Montana","Gallatin County",3,83,269,120,149
050,30,031,"Montana","Gallatin County",3,84,212,98,114
050,30,031,"Montana","Gallatin County",3,85,1426,582,844
050,30,031,"Montana","Gallatin County",4,0,1268,687,581
050,30,031,"Montana","Gallatin County",4,1,1147,583,564
050,30,031,"Montana","Gallatin County",4,2,1157,585,572
050,30,031,"Montana","Gallatin County",4,3,1190,595,595
050,30,031,"Montana","Gallatin County",4,4,1211,606,605
050,30,031,"Montana","Gallatin County",4,5,1224,609,615
050,30,031,"Montana","Gallatin County",4,6,1350,703,647
050,30,031,"Montana","Gallatin County",4,7,1365,710,655
050,30,031,"Montana","Gallatin County",4,8,1391,739,652
050,30,031,"Montana","Gallatin County",4,9,1335,682,653
050,30,031,"Montana","Gallatin County",4,10,1377,713,664
050,30,031,"Montana","Gallatin County",4,11,1337,692,645
050,30,031,"Montana","Gallatin County",4,12,1349,689,660
050,30,031,"Montana","Gallatin County",4,13,1434,712,722
050,30,031,"Montana","Gallatin County",4,14,1421,721,700
050,30,031,"Montana","Gallatin County",4,15,1441,725,716
050,30,031,"Montana","Gallatin County",4,16,1410,714,696
050,30,031,"Montana","Gallatin County",4,17,1302,645,657
050,30,031,"Montana","Gallatin County",4,18,1866,954,912
050,30,031,"Montana","Gallatin County",4,19,2987,1664,1323
050,30,031,"Montana","Gallatin County",4,20,2834,1554,1280
050,30,031,"Montana","Gallatin County",4,21,3020,1604,1416
050,30,031,"Montana","Gallatin County",4,22,3276,1798,1478
050,30,031,"Montana","Gallatin County",4,23,3152,1764,1388
050,30,031,"Montana","Gallatin County",4,24,2667,1462,1205
050,30,031,"Montana","Gallatin County",4,25,2516,1419,1097
050,30,031,"Montana","Gallatin County",4,26,2273,1268,1005
050,30,031,"Montana","Gallatin County",4,27,2198,1226,972
050,30,031,"Montana","Gallatin County",4,28,2130,1192,938
050,30,031,"Montana","Gallatin County",4,29,2149,1182,967
050,30,031,"Montana","Gallatin County",4,30,2025,1107,918
050,30,031,"Montana","Gallatin County",4,31,1974,1072,902
050,30,031,"Montana","Gallatin County",4,32,1983,999,984
050,30,031,"Montana","Gallatin County",4,33,1925,1005,920
050,30,031,"Montana","Gallatin County",4,34,1796,936,860
050,30,031,"Montana","Gallatin County",4,35,1736,905,831
050,30,031,"Montana","Gallatin County",4,36,1758,907,851
050,30,031,"Montana","Gallatin County",4,37,1852,964,888
050,30,031,"Montana","Gallatin County",4,38,1825,962,863
050,30,031,"Montana","Gallatin County",4,39,1835,985,850
050,30,031,"Montana","Gallatin County",4,40,1823,939,884
050,30,031,"Montana","Gallatin County",4,41,1733,897,836
050,30,031,"Montana","Gallatin County",4,42,1786,928,858
050,30,031,"Montana","Gallatin County",4,43,1721,929,792
050,30,031,"Montana","Gallatin County",4,44,1652,915,737
050,30,031,"Montana","Gallatin County",4,45,1552,815,737
050,30,031,"Montana","Gallatin County",4,46,1411,751,660
050,30,031,"Montana","Gallatin County",4,47,1419,730,689
050,30,031,"Montana","Gallatin County",4,48,1346,703,643
050,30,031,"Montana","Gallatin County",4,49,1297,682,615
050,30,031,"Montana","Gallatin County",4,50,1345,685,660
050,30,031,"Montana","Gallatin County",4,51,1401,740,661
050,30,031,"Montana","Gallatin County",4,52,1309,677,632
050,30,031,"Montana","Gallatin County",4,53,1223,643,580
050,30,031,"Montana","Gallatin County",4,54,1124,594,530
050,30,031,"Montana","Gallatin County",4,55,1107,583,524
050,30,031,"Montana","Gallatin County",4,56,1120,592,528
050,30,031,"Montana","Gallatin County",4,57,1198,609,589
050,30,031,"Montana","Gallatin County",4,58,1215,600,615
050,30,031,"Montana","Gallatin County",4,59,1257,625,632
050,30,031,"Montana","Gallatin County",4,60,1247,631,616
050,30,031,"Montana","Gallatin County",4,61,1310,679,631
050,30,031,"Montana","Gallatin County",4,62,1348,671,677
050,30,031,"Montana","Gallatin County",4,63,1291,641,650
050,30,031,"Montana","Gallatin County",4,64,1245,622,623
050,30,031,"Montana","Gallatin County",4,65,1302,623,679
050,30,031,"Montana","Gallatin County",4,66,1230,633,597
050,30,031,"Montana","Gallatin County",4,67,1210,610,600
050,30,031,"Montana","Gallatin County",4,68,1201,599,602
050,30,031,"Montana","Gallatin County",4,69,1181,566,615
050,30,031,"Montana","Gallatin County",4,70,1116,541,575
050,30,031,"Montana","Gallatin County",4,71,1002,470,532
050,30,031,"Montana","Gallatin County",4,72,955,462,493
050,30,031,"Montana","Gallatin County",4,73,889,448,441
050,30,031,"Montana","Gallatin County",4,74,855,432,423
050,30,031,"Montana","Gallatin County",4,75,861,459,402
050,30,031,"Montana","Gallatin County",4,76,580,293,287
050,30,031,"Montana","Gallatin County",4,77,528,262,266
050,30,031,"Montana","Gallatin County",4,78,493,232,261
050,30,031,"Montana","Gallatin County",4,79,504,253,251
050,30,031,"Montana","Gallatin County",4,80,433,222,211
050,30,031,"Montana","Gallatin County",4,81,359,166,193
050,30,031,"Montana","Gallatin County",4,82,316,137,179
050,30,031,"Montana","Gallatin County",4,83,295,136,159
050,30,031,"Montana","Gallatin County",4,84,247,114,133
050,30,031,"Montana","Gallatin County",4,85,1415,576,839
050,30,031,"Montana","Gallatin County",5,0,1268,689,579
050,30,031,"Montana","Gallatin County",5,1,1266,674,592
050,30,031,"Montana","Gallatin County",5,2,1113,568,545
050,30,031,"Montana","Gallatin County",5,3,1149,572,577
050,30,031,"Montana","Gallatin County",5,4,1192,610,582
050,30,031,"Montana","Gallatin County",5,5,1203,608,595
050,30,031,"Montana","Gallatin County",5,6,1203,596,607
050,30,031,"Montana","Gallatin County",5,7,1328,694,634
050,30,031,"Montana","Gallatin County",5,8,1367,703,664
050,30,031,"Montana","Gallatin County",5,9,1397,739,658
050,30,031,"Montana","Gallatin County",5,10,1326,685,641
050,30,031,"Montana","Gallatin County",5,11,1365,705,660
050,30,031,"Montana","Gallatin County",5,12,1337,683,654
050,30,031,"Montana","Gallatin County",5,13,1351,695,656
050,30,031,"Montana","Gallatin County",5,14,1427,714,713
050,30,031,"Montana","Gallatin County",5,15,1410,711,699
050,30,031,"Montana","Gallatin County",5,16,1442,724,718
050,30,031,"Montana","Gallatin County",5,17,1397,715,682
050,30,031,"Montana","Gallatin County",5,18,1839,928,911
050,30,031,"Montana","Gallatin County",5,19,2987,1680,1307
050,30,031,"Montana","Gallatin County",5,20,2906,1615,1291
050,30,031,"Montana","Gallatin County",5,21,2997,1602,1395
050,30,031,"Montana","Gallatin County",5,22,3243,1742,1501
050,30,031,"Montana","Gallatin County",5,23,3174,1784,1390
050,30,031,"Montana","Gallatin County",5,24,2789,1562,1227
050,30,031,"Montana","Gallatin County",5,25,2520,1356,1164
050,30,031,"Montana","Gallatin County",5,26,2420,1367,1053
050,30,031,"Montana","Gallatin County",5,27,2186,1228,958
050,30,031,"Montana","Gallatin County",5,28,2148,1182,966
050,30,031,"Montana","Gallatin County",5,29,2069,1147,922
050,30,031,"Montana","Gallatin County",5,30,2105,1162,943
050,30,031,"Montana","Gallatin County",5,31,2031,1106,925
050,30,031,"Montana","Gallatin County",5,32,1954,1044,910
050,30,031,"Montana","Gallatin County",5,33,1965,998,967
050,30,031,"Montana","Gallatin County",5,34,1882,974,908
050,30,031,"Montana","Gallatin County",5,35,1798,932,866
050,30,031,"Montana","Gallatin County",5,36,1769,938,831
050,30,031,"Montana","Gallatin County",5,37,1750,908,842
050,30,031,"Montana","Gallatin County",5,38,1825,965,860
050,30,031,"Montana","Gallatin County",5,39,1828,971,857
050,30,031,"Montana","Gallatin County",5,40,1818,979,839
050,30,031,"Montana","Gallatin County",5,41,1835,940,895
050,30,031,"Montana","Gallatin County",5,42,1730,905,825
050,30,031,"Montana","Gallatin County",5,43,1801,920,881
050,30,031,"Montana","Gallatin County",5,44,1691,907,784
050,30,031,"Montana","Gallatin County",5,45,1653,905,748
050,30,031,"Montana","Gallatin County",5,46,1570,830,740
050,30,031,"Montana","Gallatin County",5,47,1420,753,667
050,30,031,"Montana","Gallatin County",5,48,1419,735,684
050,30,031,"Montana","Gallatin County",5,49,1353,709,644
050,30,031,"Montana","Gallatin County",5,50,1295,684,611
050,30,031,"Montana","Gallatin County",5,51,1330,684,646
050,30,031,"Montana","Gallatin County",5,52,1401,747,654
050,30,031,"Montana","Gallatin County",5,53,1339,695,644
050,30,031,"Montana","Gallatin County",5,54,1234,662,572
050,30,031,"Montana","Gallatin County",5,55,1118,604,514
050,30,031,"Montana","Gallatin County",5,56,1117,607,510
050,30,031,"Montana","Gallatin County",5,57,1100,566,534
050,30,031,"Montana","Gallatin County",5,58,1163,583,580
050,30,031,"Montana","Gallatin County",5,59,1222,608,614
050,30,031,"Montana","Gallatin County",5,60,1262,635,627
050,30,031,"Montana","Gallatin County",5,61,1248,620,628
050,30,031,"Montana","Gallatin County",5,62,1316,677,639
050,30,031,"Montana","Gallatin County",5,63,1326,654,672
050,30,031,"Montana","Gallatin County",5,64,1288,641,647
050,30,031,"Montana","Gallatin County",5,65,1226,614,612
050,30,031,"Montana","Gallatin County",5,66,1276,613,663
050,30,031,"Montana","Gallatin County",5,67,1196,616,580
050,30,031,"Montana","Gallatin County",5,68,1183,595,588
050,30,031,"Montana","Gallatin County",5,69,1187,592,595
050,30,031,"Montana","Gallatin County",5,70,1163,566,597
050,30,031,"Montana","Gallatin County",5,71,1102,537,565
050,30,031,"Montana","Gallatin County",5,72,989,466,523
050,30,031,"Montana","Gallatin County",5,73,935,448,487
050,30,031,"Montana","Gallatin County",5,74,868,437,431
050,30,031,"Montana","Gallatin County",5,75,828,406,422
050,30,031,"Montana","Gallatin County",5,76,844,444,400
050,30,031,"Montana","Gallatin County",5,77,560,287,273
050,30,031,"Montana","Gallatin County",5,78,508,244,264
050,30,031,"Montana","Gallatin County",5,79,486,227,259
050,30,031,"Montana","Gallatin County",5,80,487,238,249
050,30,031,"Montana","Gallatin County",5,81,423,209,214
050,30,031,"Montana","Gallatin County",5,82,331,159,172
050,30,031,"Montana","Gallatin County",5,83,313,132,181
050,30,031,"Montana","Gallatin County",5,84,272,128,144
050,30,031,"Montana","Gallatin County",5,85,1457,601,856
050,30,033,"Montana","Garfield County",1,0,14,7,7
050,30,033,"Montana","Garfield County",1,1,15,5,10
050,30,033,"Montana","Garfield County",1,2,14,6,8
050,30,033,"Montana","Garfield County",1,3,12,5,7
050,30,033,"Montana","Garfield County",1,4,15,8,7
050,30,033,"Montana","Garfield County",1,5,13,6,7
050,30,033,"Montana","Garfield County",1,6,10,5,5
050,30,033,"Montana","Garfield County",1,7,17,12,5
050,30,033,"Montana","Garfield County",1,8,12,7,5
050,30,033,"Montana","Garfield County",1,9,14,5,9
050,30,033,"Montana","Garfield County",1,10,15,8,7
050,30,033,"Montana","Garfield County",1,11,21,11,10
050,30,033,"Montana","Garfield County",1,12,15,9,6
050,30,033,"Montana","Garfield County",1,13,16,10,6
050,30,033,"Montana","Garfield County",1,14,16,7,9
050,30,033,"Montana","Garfield County",1,15,14,7,7
050,30,033,"Montana","Garfield County",1,16,15,8,7
050,30,033,"Montana","Garfield County",1,17,16,5,11
050,30,033,"Montana","Garfield County",1,18,12,5,7
050,30,033,"Montana","Garfield County",1,19,6,3,3
050,30,033,"Montana","Garfield County",1,20,12,5,7
050,30,033,"Montana","Garfield County",1,21,10,6,4
050,30,033,"Montana","Garfield County",1,22,13,8,5
050,30,033,"Montana","Garfield County",1,23,10,3,7
050,30,033,"Montana","Garfield County",1,24,10,6,4
050,30,033,"Montana","Garfield County",1,25,11,5,6
050,30,033,"Montana","Garfield County",1,26,14,10,4
050,30,033,"Montana","Garfield County",1,27,7,4,3
050,30,033,"Montana","Garfield County",1,28,9,4,5
050,30,033,"Montana","Garfield County",1,29,8,3,5
050,30,033,"Montana","Garfield County",1,30,11,4,7
050,30,033,"Montana","Garfield County",1,31,12,5,7
050,30,033,"Montana","Garfield County",1,32,9,5,4
050,30,033,"Montana","Garfield County",1,33,14,8,6
050,30,033,"Montana","Garfield County",1,34,12,6,6
050,30,033,"Montana","Garfield County",1,35,7,1,6
050,30,033,"Montana","Garfield County",1,36,12,5,7
050,30,033,"Montana","Garfield County",1,37,15,7,8
050,30,033,"Montana","Garfield County",1,38,14,7,7
050,30,033,"Montana","Garfield County",1,39,16,11,5
050,30,033,"Montana","Garfield County",1,40,22,12,10
050,30,033,"Montana","Garfield County",1,41,21,11,10
050,30,033,"Montana","Garfield County",1,42,11,6,5
050,30,033,"Montana","Garfield County",1,43,15,8,7
050,30,033,"Montana","Garfield County",1,44,12,7,5
050,30,033,"Montana","Garfield County",1,45,11,4,7
050,30,033,"Montana","Garfield County",1,46,11,6,5
050,30,033,"Montana","Garfield County",1,47,13,7,6
050,30,033,"Montana","Garfield County",1,48,13,7,6
050,30,033,"Montana","Garfield County",1,49,13,8,5
050,30,033,"Montana","Garfield County",1,50,16,6,10
050,30,033,"Montana","Garfield County",1,51,12,5,7
050,30,033,"Montana","Garfield County",1,52,12,7,5
050,30,033,"Montana","Garfield County",1,53,8,4,4
050,30,033,"Montana","Garfield County",1,54,10,5,5
050,30,033,"Montana","Garfield County",1,55,15,5,10
050,30,033,"Montana","Garfield County",1,56,16,6,10
050,30,033,"Montana","Garfield County",1,57,14,6,8
050,30,033,"Montana","Garfield County",1,58,17,9,8
050,30,033,"Montana","Garfield County",1,59,18,7,11
050,30,033,"Montana","Garfield County",1,60,12,5,7
050,30,033,"Montana","Garfield County",1,61,13,8,5
050,30,033,"Montana","Garfield County",1,62,19,12,7
050,30,033,"Montana","Garfield County",1,63,19,8,11
050,30,033,"Montana","Garfield County",1,64,17,8,9
050,30,033,"Montana","Garfield County",1,65,20,11,9
050,30,033,"Montana","Garfield County",1,66,25,14,11
050,30,033,"Montana","Garfield County",1,67,12,6,6
050,30,033,"Montana","Garfield County",1,68,15,9,6
050,30,033,"Montana","Garfield County",1,69,22,15,7
050,30,033,"Montana","Garfield County",1,70,19,11,8
050,30,033,"Montana","Garfield County",1,71,20,14,6
050,30,033,"Montana","Garfield County",1,72,17,12,5
050,30,033,"Montana","Garfield County",1,73,12,7,5
050,30,033,"Montana","Garfield County",1,74,11,7,4
050,30,033,"Montana","Garfield County",1,75,10,4,6
050,30,033,"Montana","Garfield County",1,76,11,4,7
050,30,033,"Montana","Garfield County",1,77,13,5,8
050,30,033,"Montana","Garfield County",1,78,9,5,4
050,30,033,"Montana","Garfield County",1,79,12,5,7
050,30,033,"Montana","Garfield County",1,80,11,3,8
050,30,033,"Montana","Garfield County",1,81,9,3,6
050,30,033,"Montana","Garfield County",1,82,10,6,4
050,30,033,"Montana","Garfield County",1,83,8,4,4
050,30,033,"Montana","Garfield County",1,84,8,6,2
050,30,033,"Montana","Garfield County",1,85,30,11,19
050,30,033,"Montana","Garfield County",2,0,14,7,7
050,30,033,"Montana","Garfield County",2,1,15,6,9
050,30,033,"Montana","Garfield County",2,2,14,6,8
050,30,033,"Montana","Garfield County",2,3,12,5,7
050,30,033,"Montana","Garfield County",2,4,14,7,7
050,30,033,"Montana","Garfield County",2,5,14,7,7
050,30,033,"Montana","Garfield County",2,6,10,5,5
050,30,033,"Montana","Garfield County",2,7,15,10,5
050,30,033,"Montana","Garfield County",2,8,13,8,5
050,30,033,"Montana","Garfield County",2,9,14,6,8
050,30,033,"Montana","Garfield County",2,10,14,7,7
050,30,033,"Montana","Garfield County",2,11,19,10,9
050,30,033,"Montana","Garfield County",2,12,17,10,7
050,30,033,"Montana","Garfield County",2,13,16,10,6
050,30,033,"Montana","Garfield County",2,14,17,8,9
050,30,033,"Montana","Garfield County",2,15,14,7,7
050,30,033,"Montana","Garfield County",2,16,15,8,7
050,30,033,"Montana","Garfield County",2,17,16,6,10
050,30,033,"Montana","Garfield County",2,18,12,5,7
050,30,033,"Montana","Garfield County",2,19,7,3,4
050,30,033,"Montana","Garfield County",2,20,11,4,7
050,30,033,"Montana","Garfield County",2,21,10,6,4
050,30,033,"Montana","Garfield County",2,22,12,7,5
050,30,033,"Montana","Garfield County",2,23,12,5,7
050,30,033,"Montana","Garfield County",2,24,11,6,5
050,30,033,"Montana","Garfield County",2,25,11,5,6
050,30,033,"Montana","Garfield County",2,26,13,9,4
050,30,033,"Montana","Garfield County",2,27,8,5,3
050,30,033,"Montana","Garfield County",2,28,9,4,5
050,30,033,"Montana","Garfield County",2,29,8,3,5
050,30,033,"Montana","Garfield County",2,30,11,4,7
050,30,033,"Montana","Garfield County",2,31,12,5,7
050,30,033,"Montana","Garfield County",2,32,10,5,5
050,30,033,"Montana","Garfield County",2,33,13,7,6
050,30,033,"Montana","Garfield County",2,34,13,7,6
050,30,033,"Montana","Garfield County",2,35,9,3,6
050,30,033,"Montana","Garfield County",2,36,11,4,7
050,30,033,"Montana","Garfield County",2,37,15,7,8
050,30,033,"Montana","Garfield County",2,38,14,7,7
050,30,033,"Montana","Garfield County",2,39,16,11,5
050,30,033,"Montana","Garfield County",2,40,20,11,9
050,30,033,"Montana","Garfield County",2,41,20,11,9
050,30,033,"Montana","Garfield County",2,42,13,7,6
050,30,033,"Montana","Garfield County",2,43,14,8,6
050,30,033,"Montana","Garfield County",2,44,12,7,5
050,30,033,"Montana","Garfield County",2,45,10,4,6
050,30,033,"Montana","Garfield County",2,46,10,5,5
050,30,033,"Montana","Garfield County",2,47,13,7,6
050,30,033,"Montana","Garfield County",2,48,13,7,6
050,30,033,"Montana","Garfield County",2,49,13,8,5
050,30,033,"Montana","Garfield County",2,50,15,6,9
050,30,033,"Montana","Garfield County",2,51,14,6,8
050,30,033,"Montana","Garfield County",2,52,12,7,5
050,30,033,"Montana","Garfield County",2,53,9,5,4
050,30,033,"Montana","Garfield County",2,54,10,5,5
050,30,033,"Montana","Garfield County",2,55,14,5,9
050,30,033,"Montana","Garfield County",2,56,16,6,10
050,30,033,"Montana","Garfield County",2,57,15,6,9
050,30,033,"Montana","Garfield County",2,58,16,8,8
050,30,033,"Montana","Garfield County",2,59,18,8,10
050,30,033,"Montana","Garfield County",2,60,13,5,8
050,30,033,"Montana","Garfield County",2,61,12,7,5
050,30,033,"Montana","Garfield County",2,62,18,11,7
050,30,033,"Montana","Garfield County",2,63,19,9,10
050,30,033,"Montana","Garfield County",2,64,17,8,9
050,30,033,"Montana","Garfield County",2,65,19,10,9
050,30,033,"Montana","Garfield County",2,66,24,14,10
050,30,033,"Montana","Garfield County",2,67,15,8,7
050,30,033,"Montana","Garfield County",2,68,14,8,6
050,30,033,"Montana","Garfield County",2,69,20,13,7
050,30,033,"Montana","Garfield County",2,70,20,12,8
050,30,033,"Montana","Garfield County",2,71,21,14,7
050,30,033,"Montana","Garfield County",2,72,17,12,5
050,30,033,"Montana","Garfield County",2,73,14,9,5
050,30,033,"Montana","Garfield County",2,74,11,7,4
050,30,033,"Montana","Garfield County",2,75,11,5,6
050,30,033,"Montana","Garfield County",2,76,11,4,7
050,30,033,"Montana","Garfield County",2,77,12,4,8
050,30,033,"Montana","Garfield County",2,78,10,5,5
050,30,033,"Montana","Garfield County",2,79,11,5,6
050,30,033,"Montana","Garfield County",2,80,11,3,8
050,30,033,"Montana","Garfield County",2,81,9,3,6
050,30,033,"Montana","Garfield County",2,82,9,5,4
050,30,033,"Montana","Garfield County",2,83,8,4,4
050,30,033,"Montana","Garfield County",2,84,7,5,2
050,30,033,"Montana","Garfield County",2,85,31,12,19
050,30,033,"Montana","Garfield County",3,0,15,5,10
050,30,033,"Montana","Garfield County",3,1,17,10,7
050,30,033,"Montana","Garfield County",3,2,19,10,9
050,30,033,"Montana","Garfield County",3,3,14,6,8
050,30,033,"Montana","Garfield County",3,4,13,7,6
050,30,033,"Montana","Garfield County",3,5,16,8,8
050,30,033,"Montana","Garfield County",3,6,15,7,8
050,30,033,"Montana","Garfield County",3,7,11,5,6
050,30,033,"Montana","Garfield County",3,8,16,11,5
050,30,033,"Montana","Garfield County",3,9,15,10,5
050,30,033,"Montana","Garfield County",3,10,15,6,9
050,30,033,"Montana","Garfield County",3,11,11,7,4
050,30,033,"Montana","Garfield County",3,12,19,10,9
050,30,033,"Montana","Garfield County",3,13,17,10,7
050,30,033,"Montana","Garfield County",3,14,15,10,5
050,30,033,"Montana","Garfield County",3,15,19,8,11
050,30,033,"Montana","Garfield County",3,16,15,7,8
050,30,033,"Montana","Garfield County",3,17,17,8,9
050,30,033,"Montana","Garfield County",3,18,13,5,8
050,30,033,"Montana","Garfield County",3,19,7,5,2
050,30,033,"Montana","Garfield County",3,20,5,3,2
050,30,033,"Montana","Garfield County",3,21,12,4,8
050,30,033,"Montana","Garfield County",3,22,12,9,3
050,30,033,"Montana","Garfield County",3,23,16,9,7
050,30,033,"Montana","Garfield County",3,24,17,8,9
050,30,033,"Montana","Garfield County",3,25,12,8,4
050,30,033,"Montana","Garfield County",3,26,11,5,6
050,30,033,"Montana","Garfield County",3,27,14,11,3
050,30,033,"Montana","Garfield County",3,28,8,5,3
050,30,033,"Montana","Garfield County",3,29,9,4,5
050,30,033,"Montana","Garfield County",3,30,9,3,6
050,30,033,"Montana","Garfield County",3,31,11,4,7
050,30,033,"Montana","Garfield County",3,32,14,6,8
050,30,033,"Montana","Garfield County",3,33,10,5,5
050,30,033,"Montana","Garfield County",3,34,14,7,7
050,30,033,"Montana","Garfield County",3,35,16,9,7
050,30,033,"Montana","Garfield County",3,36,9,3,6
050,30,033,"Montana","Garfield County",3,37,11,5,6
050,30,033,"Montana","Garfield County",3,38,18,9,9
050,30,033,"Montana","Garfield County",3,39,16,9,7
050,30,033,"Montana","Garfield County",3,40,15,10,5
050,30,033,"Montana","Garfield County",3,41,22,11,11
050,30,033,"Montana","Garfield County",3,42,20,11,9
050,30,033,"Montana","Garfield County",3,43,13,7,6
050,30,033,"Montana","Garfield County",3,44,13,8,5
050,30,033,"Montana","Garfield County",3,45,13,8,5
050,30,033,"Montana","Garfield County",3,46,10,4,6
050,30,033,"Montana","Garfield County",3,47,10,5,5
050,30,033,"Montana","Garfield County",3,48,15,9,6
050,30,033,"Montana","Garfield County",3,49,13,7,6
050,30,033,"Montana","Garfield County",3,50,13,8,5
050,30,033,"Montana","Garfield County",3,51,16,5,11
050,30,033,"Montana","Garfield County",3,52,15,6,9
050,30,033,"Montana","Garfield County",3,53,14,7,7
050,30,033,"Montana","Garfield County",3,54,11,5,6
050,30,033,"Montana","Garfield County",3,55,10,5,5
050,30,033,"Montana","Garfield County",3,56,14,5,9
050,30,033,"Montana","Garfield County",3,57,12,3,9
050,30,033,"Montana","Garfield County",3,58,17,6,11
050,30,033,"Montana","Garfield County",3,59,18,10,8
050,30,033,"Montana","Garfield County",3,60,17,8,9
050,30,033,"Montana","Garfield County",3,61,13,5,8
050,30,033,"Montana","Garfield County",3,62,12,7,5
050,30,033,"Montana","Garfield County",3,63,18,11,7
050,30,033,"Montana","Garfield County",3,64,19,9,10
050,30,033,"Montana","Garfield County",3,65,17,8,9
050,30,033,"Montana","Garfield County",3,66,19,9,10
050,30,033,"Montana","Garfield County",3,67,23,13,10
050,30,033,"Montana","Garfield County",3,68,14,8,6
050,30,033,"Montana","Garfield County",3,69,14,8,6
050,30,033,"Montana","Garfield County",3,70,18,13,5
050,30,033,"Montana","Garfield County",3,71,20,13,7
050,30,033,"Montana","Garfield County",3,72,20,13,7
050,30,033,"Montana","Garfield County",3,73,16,11,5
050,30,033,"Montana","Garfield County",3,74,14,9,5
050,30,033,"Montana","Garfield County",3,75,11,7,4
050,30,033,"Montana","Garfield County",3,76,11,5,6
050,30,033,"Montana","Garfield County",3,77,12,3,9
050,30,033,"Montana","Garfield County",3,78,9,2,7
050,30,033,"Montana","Garfield County",3,79,11,5,6
050,30,033,"Montana","Garfield County",3,80,10,4,6
050,30,033,"Montana","Garfield County",3,81,11,3,8
050,30,033,"Montana","Garfield County",3,82,8,2,6
050,30,033,"Montana","Garfield County",3,83,9,5,4
050,30,033,"Montana","Garfield County",3,84,7,3,4
050,30,033,"Montana","Garfield County",3,85,28,13,15
050,30,033,"Montana","Garfield County",4,0,19,9,10
050,30,033,"Montana","Garfield County",4,1,15,5,10
050,30,033,"Montana","Garfield County",4,2,16,10,6
050,30,033,"Montana","Garfield County",4,3,18,8,10
050,30,033,"Montana","Garfield County",4,4,14,6,8
050,30,033,"Montana","Garfield County",4,5,14,8,6
050,30,033,"Montana","Garfield County",4,6,16,8,8
050,30,033,"Montana","Garfield County",4,7,16,8,8
050,30,033,"Montana","Garfield County",4,8,12,5,7
050,30,033,"Montana","Garfield County",4,9,16,11,5
050,30,033,"Montana","Garfield County",4,10,15,10,5
050,30,033,"Montana","Garfield County",4,11,15,6,9
050,30,033,"Montana","Garfield County",4,12,12,7,5
050,30,033,"Montana","Garfield County",4,13,19,10,9
050,30,033,"Montana","Garfield County",4,14,19,12,7
050,30,033,"Montana","Garfield County",4,15,19,12,7
050,30,033,"Montana","Garfield County",4,16,18,8,10
050,30,033,"Montana","Garfield County",4,17,14,7,7
050,30,033,"Montana","Garfield County",4,18,14,7,7
050,30,033,"Montana","Garfield County",4,19,9,4,5
050,30,033,"Montana","Garfield County",4,20,9,6,3
050,30,033,"Montana","Garfield County",4,21,6,3,3
050,30,033,"Montana","Garfield County",4,22,10,4,6
050,30,033,"Montana","Garfield County",4,23,10,7,3
050,30,033,"Montana","Garfield County",4,24,18,9,9
050,30,033,"Montana","Garfield County",4,25,19,8,11
050,30,033,"Montana","Garfield County",4,26,11,7,4
050,30,033,"Montana","Garfield County",4,27,10,5,5
050,30,033,"Montana","Garfield County",4,28,11,8,3
050,30,033,"Montana","Garfield County",4,29,8,4,4
050,30,033,"Montana","Garfield County",4,30,8,4,4
050,30,033,"Montana","Garfield County",4,31,9,3,6
050,30,033,"Montana","Garfield County",4,32,9,4,5
050,30,033,"Montana","Garfield County",4,33,12,4,8
050,30,033,"Montana","Garfield County",4,34,12,4,8
050,30,033,"Montana","Garfield County",4,35,14,7,7
050,30,033,"Montana","Garfield County",4,36,17,9,8
050,30,033,"Montana","Garfield County",4,37,10,5,5
050,30,033,"Montana","Garfield County",4,38,13,7,6
050,30,033,"Montana","Garfield County",4,39,18,9,9
050,30,033,"Montana","Garfield County",4,40,16,9,7
050,30,033,"Montana","Garfield County",4,41,17,10,7
050,30,033,"Montana","Garfield County",4,42,22,11,11
050,30,033,"Montana","Garfield County",4,43,20,11,9
050,30,033,"Montana","Garfield County",4,44,13,7,6
050,30,033,"Montana","Garfield County",4,45,17,10,7
050,30,033,"Montana","Garfield County",4,46,13,8,5
050,30,033,"Montana","Garfield County",4,47,10,4,6
050,30,033,"Montana","Garfield County",4,48,10,5,5
050,30,033,"Montana","Garfield County",4,49,15,9,6
050,30,033,"Montana","Garfield County",4,50,13,7,6
050,30,033,"Montana","Garfield County",4,51,17,10,7
050,30,033,"Montana","Garfield County",4,52,16,5,11
050,30,033,"Montana","Garfield County",4,53,15,6,9
050,30,033,"Montana","Garfield County",4,54,14,7,7
050,30,033,"Montana","Garfield County",4,55,11,5,6
050,30,033,"Montana","Garfield County",4,56,10,5,5
050,30,033,"Montana","Garfield County",4,57,14,5,9
050,30,033,"Montana","Garfield County",4,58,12,3,9
050,30,033,"Montana","Garfield County",4,59,17,6,11
050,30,033,"Montana","Garfield County",4,60,18,10,8
050,30,033,"Montana","Garfield County",4,61,17,8,9
050,30,033,"Montana","Garfield County",4,62,12,4,8
050,30,033,"Montana","Garfield County",4,63,12,7,5
050,30,033,"Montana","Garfield County",4,64,18,11,7
050,30,033,"Montana","Garfield County",4,65,20,9,11
050,30,033,"Montana","Garfield County",4,66,14,7,7
050,30,033,"Montana","Garfield County",4,67,19,9,10
050,30,033,"Montana","Garfield County",4,68,23,13,10
050,30,033,"Montana","Garfield County",4,69,16,8,8
050,30,033,"Montana","Garfield County",4,70,14,9,5
050,30,033,"Montana","Garfield County",4,71,18,13,5
050,30,033,"Montana","Garfield County",4,72,18,11,7
050,30,033,"Montana","Garfield County",4,73,17,11,6
050,30,033,"Montana","Garfield County",4,74,16,11,5
050,30,033,"Montana","Garfield County",4,75,15,10,5
050,30,033,"Montana","Garfield County",4,76,11,7,4
050,30,033,"Montana","Garfield County",4,77,9,4,5
050,30,033,"Montana","Garfield County",4,78,10,3,7
050,30,033,"Montana","Garfield County",4,79,9,2,7
050,30,033,"Montana","Garfield County",4,80,11,5,6
050,30,033,"Montana","Garfield County",4,81,10,4,6
050,30,033,"Montana","Garfield County",4,82,12,3,9
050,30,033,"Montana","Garfield County",4,83,7,2,5
050,30,033,"Montana","Garfield County",4,84,8,4,4
050,30,033,"Montana","Garfield County",4,85,28,13,15
050,30,033,"Montana","Garfield County",5,0,19,9,10
050,30,033,"Montana","Garfield County",5,1,21,9,12
050,30,033,"Montana","Garfield County",5,2,17,7,10
050,30,033,"Montana","Garfield County",5,3,13,7,6
050,30,033,"Montana","Garfield County",5,4,19,9,10
050,30,033,"Montana","Garfield County",5,5,15,7,8
050,30,033,"Montana","Garfield County",5,6,15,9,6
050,30,033,"Montana","Garfield County",5,7,16,7,9
050,30,033,"Montana","Garfield County",5,8,16,8,8
050,30,033,"Montana","Garfield County",5,9,8,3,5
050,30,033,"Montana","Garfield County",5,10,16,11,5
050,30,033,"Montana","Garfield County",5,11,14,8,6
050,30,033,"Montana","Garfield County",5,12,16,7,9
050,30,033,"Montana","Garfield County",5,13,12,7,5
050,30,033,"Montana","Garfield County",5,14,18,9,9
050,30,033,"Montana","Garfield County",5,15,21,12,9
050,30,033,"Montana","Garfield County",5,16,18,12,6
050,30,033,"Montana","Garfield County",5,17,20,8,12
050,30,033,"Montana","Garfield County",5,18,12,6,6
050,30,033,"Montana","Garfield County",5,19,11,6,5
050,30,033,"Montana","Garfield County",5,20,12,5,7
050,30,033,"Montana","Garfield County",5,21,7,5,2
050,30,033,"Montana","Garfield County",5,22,7,3,4
050,30,033,"Montana","Garfield County",5,23,13,4,9
050,30,033,"Montana","Garfield County",5,24,9,7,2
050,30,033,"Montana","Garfield County",5,25,18,8,10
050,30,033,"Montana","Garfield County",5,26,16,8,8
050,30,033,"Montana","Garfield County",5,27,9,4,5
050,30,033,"Montana","Garfield County",5,28,10,5,5
050,30,033,"Montana","Garfield County",5,29,12,9,3
050,30,033,"Montana","Garfield County",5,30,8,4,4
050,30,033,"Montana","Garfield County",5,31,11,4,7
050,30,033,"Montana","Garfield County",5,32,9,3,6
050,30,033,"Montana","Garfield County",5,33,9,4,5
050,30,033,"Montana","Garfield County",5,34,13,5,8
050,30,033,"Montana","Garfield County",5,35,12,7,5
050,30,033,"Montana","Garfield County",5,36,14,7,7
050,30,033,"Montana","Garfield County",5,37,16,9,7
050,30,033,"Montana","Garfield County",5,38,6,1,5
050,30,033,"Montana","Garfield County",5,39,13,7,6
050,30,033,"Montana","Garfield County",5,40,18,9,9
050,30,033,"Montana","Garfield County",5,41,16,9,7
050,30,033,"Montana","Garfield County",5,42,17,10,7
050,30,033,"Montana","Garfield County",5,43,17,7,10
050,30,033,"Montana","Garfield County",5,44,19,11,8
050,30,033,"Montana","Garfield County",5,45,16,9,7
050,30,033,"Montana","Garfield County",5,46,16,10,6
050,30,033,"Montana","Garfield County",5,47,13,8,5
050,30,033,"Montana","Garfield County",5,48,10,4,6
050,30,033,"Montana","Garfield County",5,49,10,5,5
050,30,033,"Montana","Garfield County",5,50,15,9,6
050,30,033,"Montana","Garfield County",5,51,13,7,6
050,30,033,"Montana","Garfield County",5,52,17,10,7
050,30,033,"Montana","Garfield County",5,53,16,5,11
050,30,033,"Montana","Garfield County",5,54,15,6,9
050,30,033,"Montana","Garfield County",5,55,14,7,7
050,30,033,"Montana","Garfield County",5,56,11,5,6
050,30,033,"Montana","Garfield County",5,57,10,5,5
050,30,033,"Montana","Garfield County",5,58,14,5,9
050,30,033,"Montana","Garfield County",5,59,12,3,9
050,30,033,"Montana","Garfield County",5,60,17,6,11
050,30,033,"Montana","Garfield County",5,61,16,8,8
050,30,033,"Montana","Garfield County",5,62,16,7,9
050,30,033,"Montana","Garfield County",5,63,12,4,8
050,30,033,"Montana","Garfield County",5,64,13,7,6
050,30,033,"Montana","Garfield County",5,65,16,9,7
050,30,033,"Montana","Garfield County",5,66,19,8,11
050,30,033,"Montana","Garfield County",5,67,14,7,7
050,30,033,"Montana","Garfield County",5,68,19,9,10
050,30,033,"Montana","Garfield County",5,69,24,13,11
050,30,033,"Montana","Garfield County",5,70,14,7,7
050,30,033,"Montana","Garfield County",5,71,14,9,5
050,30,033,"Montana","Garfield County",5,72,18,13,5
050,30,033,"Montana","Garfield County",5,73,16,9,7
050,30,033,"Montana","Garfield County",5,74,17,11,6
050,30,033,"Montana","Garfield County",5,75,16,11,5
050,30,033,"Montana","Garfield County",5,76,15,10,5
050,30,033,"Montana","Garfield County",5,77,11,6,5
050,30,033,"Montana","Garfield County",5,78,8,4,4
050,30,033,"Montana","Garfield County",5,79,10,3,7
050,30,033,"Montana","Garfield County",5,80,9,2,7
050,30,033,"Montana","Garfield County",5,81,11,5,6
050,30,033,"Montana","Garfield County",5,82,10,4,6
050,30,033,"Montana","Garfield County",5,83,11,3,8
050,30,033,"Montana","Garfield County",5,84,6,1,5
050,30,033,"Montana","Garfield County",5,85,29,15,14
050,30,035,"Montana","Glacier County",1,0,222,110,112
050,30,035,"Montana","Glacier County",1,1,233,114,119
050,30,035,"Montana","Glacier County",1,2,240,126,114
050,30,035,"Montana","Glacier County",1,3,223,111,112
050,30,035,"Montana","Glacier County",1,4,238,110,128
050,30,035,"Montana","Glacier County",1,5,266,127,139
050,30,035,"Montana","Glacier County",1,6,261,128,133
050,30,035,"Montana","Glacier County",1,7,236,109,127
050,30,035,"Montana","Glacier County",1,8,235,124,111
050,30,035,"Montana","Glacier County",1,9,250,127,123
050,30,035,"Montana","Glacier County",1,10,238,114,124
050,30,035,"Montana","Glacier County",1,11,252,118,134
050,30,035,"Montana","Glacier County",1,12,245,122,123
050,30,035,"Montana","Glacier County",1,13,233,109,124
050,30,035,"Montana","Glacier County",1,14,234,122,112
050,30,035,"Montana","Glacier County",1,15,236,123,113
050,30,035,"Montana","Glacier County",1,16,236,119,117
050,30,035,"Montana","Glacier County",1,17,225,117,108
050,30,035,"Montana","Glacier County",1,18,208,109,99
050,30,035,"Montana","Glacier County",1,19,179,90,89
050,30,035,"Montana","Glacier County",1,20,190,105,85
050,30,035,"Montana","Glacier County",1,21,177,98,79
050,30,035,"Montana","Glacier County",1,22,159,84,75
050,30,035,"Montana","Glacier County",1,23,173,89,84
050,30,035,"Montana","Glacier County",1,24,158,85,73
050,30,035,"Montana","Glacier County",1,25,165,76,89
050,30,035,"Montana","Glacier County",1,26,161,74,87
050,30,035,"Montana","Glacier County",1,27,162,81,81
050,30,035,"Montana","Glacier County",1,28,185,87,98
050,30,035,"Montana","Glacier County",1,29,184,87,97
050,30,035,"Montana","Glacier County",1,30,190,91,99
050,30,035,"Montana","Glacier County",1,31,212,104,108
050,30,035,"Montana","Glacier County",1,32,177,84,93
050,30,035,"Montana","Glacier County",1,33,164,82,82
050,30,035,"Montana","Glacier County",1,34,179,82,97
050,30,035,"Montana","Glacier County",1,35,174,88,86
050,30,035,"Montana","Glacier County",1,36,182,88,94
050,30,035,"Montana","Glacier County",1,37,182,92,90
050,30,035,"Montana","Glacier County",1,38,182,87,95
050,30,035,"Montana","Glacier County",1,39,160,74,86
050,30,035,"Montana","Glacier County",1,40,151,70,81
050,30,035,"Montana","Glacier County",1,41,167,83,84
050,30,035,"Montana","Glacier County",1,42,152,88,64
050,30,035,"Montana","Glacier County",1,43,153,85,68
050,30,035,"Montana","Glacier County",1,44,128,68,60
050,30,035,"Montana","Glacier County",1,45,137,76,61
050,30,035,"Montana","Glacier County",1,46,145,77,68
050,30,035,"Montana","Glacier County",1,47,128,60,68
050,30,035,"Montana","Glacier County",1,48,130,60,70
050,30,035,"Montana","Glacier County",1,49,142,61,81
050,30,035,"Montana","Glacier County",1,50,123,68,55
050,30,035,"Montana","Glacier County",1,51,132,67,65
050,30,035,"Montana","Glacier County",1,52,145,62,83
050,30,035,"Montana","Glacier County",1,53,134,56,78
050,30,035,"Montana","Glacier County",1,54,150,71,79
050,30,035,"Montana","Glacier County",1,55,169,76,93
050,30,035,"Montana","Glacier County",1,56,170,79,91
050,30,035,"Montana","Glacier County",1,57,169,81,88
050,30,035,"Montana","Glacier County",1,58,188,95,93
050,30,035,"Montana","Glacier County",1,59,188,93,95
050,30,035,"Montana","Glacier County",1,60,184,90,94
050,30,035,"Montana","Glacier County",1,61,175,86,89
050,30,035,"Montana","Glacier County",1,62,175,79,96
050,30,035,"Montana","Glacier County",1,63,163,72,91
050,30,035,"Montana","Glacier County",1,64,162,79,83
050,30,035,"Montana","Glacier County",1,65,122,52,70
050,30,035,"Montana","Glacier County",1,66,140,56,84
050,30,035,"Montana","Glacier County",1,67,133,65,68
050,30,035,"Montana","Glacier County",1,68,119,59,60
050,30,035,"Montana","Glacier County",1,69,101,51,50
050,30,035,"Montana","Glacier County",1,70,111,56,55
050,30,035,"Montana","Glacier County",1,71,100,49,51
050,30,035,"Montana","Glacier County",1,72,79,36,43
050,30,035,"Montana","Glacier County",1,73,106,53,53
050,30,035,"Montana","Glacier County",1,74,67,33,34
050,30,035,"Montana","Glacier County",1,75,58,29,29
050,30,035,"Montana","Glacier County",1,76,62,28,34
050,30,035,"Montana","Glacier County",1,77,56,23,33
050,30,035,"Montana","Glacier County",1,78,45,19,26
050,30,035,"Montana","Glacier County",1,79,55,27,28
050,30,035,"Montana","Glacier County",1,80,48,20,28
050,30,035,"Montana","Glacier County",1,81,38,17,21
050,30,035,"Montana","Glacier County",1,82,36,14,22
050,30,035,"Montana","Glacier County",1,83,30,8,22
050,30,035,"Montana","Glacier County",1,84,25,6,19
050,30,035,"Montana","Glacier County",1,85,180,75,105
050,30,035,"Montana","Glacier County",2,0,215,111,104
050,30,035,"Montana","Glacier County",2,1,232,115,117
050,30,035,"Montana","Glacier County",2,2,237,123,114
050,30,035,"Montana","Glacier County",2,3,229,115,114
050,30,035,"Montana","Glacier County",2,4,234,110,124
050,30,035,"Montana","Glacier County",2,5,256,121,135
050,30,035,"Montana","Glacier County",2,6,259,127,132
050,30,035,"Montana","Glacier County",2,7,244,114,130
050,30,035,"Montana","Glacier County",2,8,232,120,112
050,30,035,"Montana","Glacier County",2,9,244,124,120
050,30,035,"Montana","Glacier County",2,10,241,116,125
050,30,035,"Montana","Glacier County",2,11,246,115,131
050,30,035,"Montana","Glacier County",2,12,250,124,126
050,30,035,"Montana","Glacier County",2,13,233,110,123
050,30,035,"Montana","Glacier County",2,14,231,119,112
050,30,035,"Montana","Glacier County",2,15,237,123,114
050,30,035,"Montana","Glacier County",2,16,238,122,116
050,30,035,"Montana","Glacier County",2,17,225,118,107
050,30,035,"Montana","Glacier County",2,18,207,109,98
050,30,035,"Montana","Glacier County",2,19,180,89,91
050,30,035,"Montana","Glacier County",2,20,192,104,88
050,30,035,"Montana","Glacier County",2,21,180,100,80
050,30,035,"Montana","Glacier County",2,22,161,85,76
050,30,035,"Montana","Glacier County",2,23,169,87,82
050,30,035,"Montana","Glacier County",2,24,160,86,74
050,30,035,"Montana","Glacier County",2,25,168,79,89
050,30,035,"Montana","Glacier County",2,26,161,75,86
050,30,035,"Montana","Glacier County",2,27,159,78,81
050,30,035,"Montana","Glacier County",2,28,180,87,93
050,30,035,"Montana","Glacier County",2,29,183,88,95
050,30,035,"Montana","Glacier County",2,30,190,91,99
050,30,035,"Montana","Glacier County",2,31,206,100,106
050,30,035,"Montana","Glacier County",2,32,184,88,96
050,30,035,"Montana","Glacier County",2,33,167,82,85
050,30,035,"Montana","Glacier County",2,34,174,81,93
050,30,035,"Montana","Glacier County",2,35,175,88,87
050,30,035,"Montana","Glacier County",2,36,178,84,94
050,30,035,"Montana","Glacier County",2,37,182,91,91
050,30,035,"Montana","Glacier County",2,38,181,89,92
050,30,035,"Montana","Glacier County",2,39,164,75,89
050,30,035,"Montana","Glacier County",2,40,155,71,84
050,30,035,"Montana","Glacier County",2,41,160,79,81
050,30,035,"Montana","Glacier County",2,42,155,87,68
050,30,035,"Montana","Glacier County",2,43,153,85,68
050,30,035,"Montana","Glacier County",2,44,132,72,60
050,30,035,"Montana","Glacier County",2,45,135,74,61
050,30,035,"Montana","Glacier County",2,46,142,75,67
050,30,035,"Montana","Glacier County",2,47,129,62,67
050,30,035,"Montana","Glacier County",2,48,128,59,69
050,30,035,"Montana","Glacier County",2,49,140,61,79
050,30,035,"Montana","Glacier County",2,50,126,64,62
050,30,035,"Montana","Glacier County",2,51,130,67,63
050,30,035,"Montana","Glacier County",2,52,141,63,78
050,30,035,"Montana","Glacier County",2,53,136,57,79
050,30,035,"Montana","Glacier County",2,54,144,67,77
050,30,035,"Montana","Glacier County",2,55,163,72,91
050,30,035,"Montana","Glacier County",2,56,172,79,93
050,30,035,"Montana","Glacier County",2,57,168,81,87
050,30,035,"Montana","Glacier County",2,58,182,91,91
050,30,035,"Montana","Glacier County",2,59,185,90,95
050,30,035,"Montana","Glacier County",2,60,180,89,91
050,30,035,"Montana","Glacier County",2,61,177,86,91
050,30,035,"Montana","Glacier County",2,62,176,80,96
050,30,035,"Montana","Glacier County",2,63,169,75,94
050,30,035,"Montana","Glacier County",2,64,162,76,86
050,30,035,"Montana","Glacier County",2,65,130,58,72
050,30,035,"Montana","Glacier County",2,66,133,53,80
050,30,035,"Montana","Glacier County",2,67,135,64,71
050,30,035,"Montana","Glacier County",2,68,121,60,61
050,30,035,"Montana","Glacier County",2,69,103,54,49
050,30,035,"Montana","Glacier County",2,70,108,54,54
050,30,035,"Montana","Glacier County",2,71,99,48,51
050,30,035,"Montana","Glacier County",2,72,82,38,44
050,30,035,"Montana","Glacier County",2,73,104,51,53
050,30,035,"Montana","Glacier County",2,74,71,35,36
050,30,035,"Montana","Glacier County",2,75,60,29,31
050,30,035,"Montana","Glacier County",2,76,60,28,32
050,30,035,"Montana","Glacier County",2,77,59,25,34
050,30,035,"Montana","Glacier County",2,78,46,19,27
050,30,035,"Montana","Glacier County",2,79,52,25,27
050,30,035,"Montana","Glacier County",2,80,50,22,28
050,30,035,"Montana","Glacier County",2,81,39,17,22
050,30,035,"Montana","Glacier County",2,82,34,12,22
050,30,035,"Montana","Glacier County",2,83,30,9,21
050,30,035,"Montana","Glacier County",2,84,26,7,19
050,30,035,"Montana","Glacier County",2,85,179,75,104
050,30,035,"Montana","Glacier County",3,0,177,90,87
050,30,035,"Montana","Glacier County",3,1,201,105,96
050,30,035,"Montana","Glacier County",3,2,221,108,113
050,30,035,"Montana","Glacier County",3,3,244,123,121
050,30,035,"Montana","Glacier County",3,4,218,111,107
050,30,035,"Montana","Glacier County",3,5,232,107,125
050,30,035,"Montana","Glacier County",3,6,253,120,133
050,30,035,"Montana","Glacier County",3,7,248,118,130
050,30,035,"Montana","Glacier County",3,8,239,117,122
050,30,035,"Montana","Glacier County",3,9,224,111,113
050,30,035,"Montana","Glacier County",3,10,252,127,125
050,30,035,"Montana","Glacier County",3,11,238,116,122
050,30,035,"Montana","Glacier County",3,12,245,117,128
050,30,035,"Montana","Glacier County",3,13,255,122,133
050,30,035,"Montana","Glacier County",3,14,234,110,124
050,30,035,"Montana","Glacier County",3,15,243,129,114
050,30,035,"Montana","Glacier County",3,16,246,126,120
050,30,035,"Montana","Glacier County",3,17,237,122,115
050,30,035,"Montana","Glacier County",3,18,206,111,95
050,30,035,"Montana","Glacier County",3,19,186,97,89
050,30,035,"Montana","Glacier County",3,20,172,78,94
050,30,035,"Montana","Glacier County",3,21,190,105,85
050,30,035,"Montana","Glacier County",3,22,189,102,87
050,30,035,"Montana","Glacier County",3,23,160,85,75
050,30,035,"Montana","Glacier County",3,24,167,85,82
050,30,035,"Montana","Glacier County",3,25,162,87,75
050,30,035,"Montana","Glacier County",3,26,171,86,85
050,30,035,"Montana","Glacier County",3,27,165,68,97
050,30,035,"Montana","Glacier County",3,28,155,72,83
050,30,035,"Montana","Glacier County",3,29,178,84,94
050,30,035,"Montana","Glacier County",3,30,190,90,100
050,30,035,"Montana","Glacier County",3,31,190,91,99
050,30,035,"Montana","Glacier County",3,32,206,104,102
050,30,035,"Montana","Glacier County",3,33,182,86,96
050,30,035,"Montana","Glacier County",3,34,163,78,85
050,30,035,"Montana","Glacier County",3,35,188,90,98
050,30,035,"Montana","Glacier County",3,36,179,86,93
050,30,035,"Montana","Glacier County",3,37,175,82,93
050,30,035,"Montana","Glacier County",3,38,177,89,88
050,30,035,"Montana","Glacier County",3,39,185,88,97
050,30,035,"Montana","Glacier County",3,40,171,79,92
050,30,035,"Montana","Glacier County",3,41,155,71,84
050,30,035,"Montana","Glacier County",3,42,154,76,78
050,30,035,"Montana","Glacier County",3,43,158,86,72
050,30,035,"Montana","Glacier County",3,44,157,84,73
050,30,035,"Montana","Glacier County",3,45,136,78,58
050,30,035,"Montana","Glacier County",3,46,134,75,59
050,30,035,"Montana","Glacier County",3,47,132,69,63
050,30,035,"Montana","Glacier County",3,48,122,58,64
050,30,035,"Montana","Glacier County",3,49,132,60,72
050,30,035,"Montana","Glacier County",3,50,130,58,72
050,30,035,"Montana","Glacier County",3,51,128,65,63
050,30,035,"Montana","Glacier County",3,52,142,77,65
050,30,035,"Montana","Glacier County",3,53,130,59,71
050,30,035,"Montana","Glacier County",3,54,135,56,79
050,30,035,"Montana","Glacier County",3,55,145,65,80
050,30,035,"Montana","Glacier County",3,56,164,73,91
050,30,035,"Montana","Glacier County",3,57,163,72,91
050,30,035,"Montana","Glacier County",3,58,164,76,88
050,30,035,"Montana","Glacier County",3,59,179,85,94
050,30,035,"Montana","Glacier County",3,60,183,90,93
050,30,035,"Montana","Glacier County",3,61,181,88,93
050,30,035,"Montana","Glacier County",3,62,178,89,89
050,30,035,"Montana","Glacier County",3,63,174,81,93
050,30,035,"Montana","Glacier County",3,64,163,72,91
050,30,035,"Montana","Glacier County",3,65,158,76,82
050,30,035,"Montana","Glacier County",3,66,120,53,67
050,30,035,"Montana","Glacier County",3,67,133,54,79
050,30,035,"Montana","Glacier County",3,68,133,63,70
050,30,035,"Montana","Glacier County",3,69,112,55,57
050,30,035,"Montana","Glacier County",3,70,97,50,47
050,30,035,"Montana","Glacier County",3,71,97,49,48
050,30,035,"Montana","Glacier County",3,72,94,47,47
050,30,035,"Montana","Glacier County",3,73,78,34,44
050,30,035,"Montana","Glacier County",3,74,99,48,51
050,30,035,"Montana","Glacier County",3,75,65,32,33
050,30,035,"Montana","Glacier County",3,76,54,26,28
050,30,035,"Montana","Glacier County",3,77,55,26,29
050,30,035,"Montana","Glacier County",3,78,53,21,32
050,30,035,"Montana","Glacier County",3,79,45,17,28
050,30,035,"Montana","Glacier County",3,80,50,26,24
050,30,035,"Montana","Glacier County",3,81,49,21,28
050,30,035,"Montana","Glacier County",3,82,37,15,22
050,30,035,"Montana","Glacier County",3,83,32,11,21
050,30,035,"Montana","Glacier County",3,84,29,9,20
050,30,035,"Montana","Glacier County",3,85,181,72,109
050,30,035,"Montana","Glacier County",4,0,176,88,88
050,30,035,"Montana","Glacier County",4,1,170,91,79
050,30,035,"Montana","Glacier County",4,2,208,115,93
050,30,035,"Montana","Glacier County",4,3,223,109,114
050,30,035,"Montana","Glacier County",4,4,235,116,119
050,30,035,"Montana","Glacier County",4,5,217,113,104
050,30,035,"Montana","Glacier County",4,6,227,106,121
050,30,035,"Montana","Glacier County",4,7,253,115,138
050,30,035,"Montana","Glacier County",4,8,247,122,125
050,30,035,"Montana","Glacier County",4,9,229,106,123
050,30,035,"Montana","Glacier County",4,10,223,113,110
050,30,035,"Montana","Glacier County",4,11,246,120,126
050,30,035,"Montana","Glacier County",4,12,238,115,123
050,30,035,"Montana","Glacier County",4,13,246,114,132
050,30,035,"Montana","Glacier County",4,14,248,123,125
050,30,035,"Montana","Glacier County",4,15,237,113,124
050,30,035,"Montana","Glacier County",4,16,245,132,113
050,30,035,"Montana","Glacier County",4,17,239,123,116
050,30,035,"Montana","Glacier County",4,18,222,117,105
050,30,035,"Montana","Glacier County",4,19,184,100,84
050,30,035,"Montana","Glacier County",4,20,186,96,90
050,30,035,"Montana","Glacier County",4,21,179,80,99
050,30,035,"Montana","Glacier County",4,22,181,103,78
050,30,035,"Montana","Glacier County",4,23,202,114,88
050,30,035,"Montana","Glacier County",4,24,154,85,69
050,30,035,"Montana","Glacier County",4,25,171,81,90
050,30,035,"Montana","Glacier County",4,26,165,93,72
050,30,035,"Montana","Glacier County",4,27,163,83,80
050,30,035,"Montana","Glacier County",4,28,156,63,93
050,30,035,"Montana","Glacier County",4,29,158,71,87
050,30,035,"Montana","Glacier County",4,30,177,81,96
050,30,035,"Montana","Glacier County",4,31,180,86,94
050,30,035,"Montana","Glacier County",4,32,187,90,97
050,30,035,"Montana","Glacier County",4,33,209,109,100
050,30,035,"Montana","Glacier County",4,34,179,84,95
050,30,035,"Montana","Glacier County",4,35,175,93,82
050,30,035,"Montana","Glacier County",4,36,178,80,98
050,30,035,"Montana","Glacier County",4,37,176,84,92
050,30,035,"Montana","Glacier County",4,38,175,82,93
050,30,035,"Montana","Glacier County",4,39,180,88,92
050,30,035,"Montana","Glacier County",4,40,180,83,97
050,30,035,"Montana","Glacier County",4,41,168,79,89
050,30,035,"Montana","Glacier County",4,42,157,71,86
050,30,035,"Montana","Glacier County",4,43,153,76,77
050,30,035,"Montana","Glacier County",4,44,157,87,70
050,30,035,"Montana","Glacier County",4,45,160,87,73
050,30,035,"Montana","Glacier County",4,46,137,80,57
050,30,035,"Montana","Glacier County",4,47,137,76,61
050,30,035,"Montana","Glacier County",4,48,131,71,60
050,30,035,"Montana","Glacier County",4,49,129,60,69
050,30,035,"Montana","Glacier County",4,50,127,58,69
050,30,035,"Montana","Glacier County",4,51,126,57,69
050,30,035,"Montana","Glacier County",4,52,127,62,65
050,30,035,"Montana","Glacier County",4,53,142,76,66
050,30,035,"Montana","Glacier County",4,54,124,56,68
050,30,035,"Montana","Glacier County",4,55,139,57,82
050,30,035,"Montana","Glacier County",4,56,143,68,75
050,30,035,"Montana","Glacier County",4,57,156,70,86
050,30,035,"Montana","Glacier County",4,58,162,71,91
050,30,035,"Montana","Glacier County",4,59,161,70,91
050,30,035,"Montana","Glacier County",4,60,177,86,91
050,30,035,"Montana","Glacier County",4,61,183,90,93
050,30,035,"Montana","Glacier County",4,62,178,88,90
050,30,035,"Montana","Glacier County",4,63,179,89,90
050,30,035,"Montana","Glacier County",4,64,171,79,92
050,30,035,"Montana","Glacier County",4,65,153,69,84
050,30,035,"Montana","Glacier County",4,66,140,65,75
050,30,035,"Montana","Glacier County",4,67,115,52,63
050,30,035,"Montana","Glacier County",4,68,128,49,79
050,30,035,"Montana","Glacier County",4,69,126,62,64
050,30,035,"Montana","Glacier County",4,70,108,53,55
050,30,035,"Montana","Glacier County",4,71,95,48,47
050,30,035,"Montana","Glacier County",4,72,91,46,45
050,30,035,"Montana","Glacier County",4,73,91,42,49
050,30,035,"Montana","Glacier County",4,74,79,33,46
050,30,035,"Montana","Glacier County",4,75,92,44,48
050,30,035,"Montana","Glacier County",4,76,64,31,33
050,30,035,"Montana","Glacier County",4,77,54,27,27
050,30,035,"Montana","Glacier County",4,78,51,26,25
050,30,035,"Montana","Glacier County",4,79,51,20,31
050,30,035,"Montana","Glacier County",4,80,40,15,25
050,30,035,"Montana","Glacier County",4,81,47,24,23
050,30,035,"Montana","Glacier County",4,82,45,19,26
050,30,035,"Montana","Glacier County",4,83,29,9,20
050,30,035,"Montana","Glacier County",4,84,28,10,18
050,30,035,"Montana","Glacier County",4,85,175,62,113
050,30,035,"Montana","Glacier County",5,0,174,86,88
050,30,035,"Montana","Glacier County",5,1,173,86,87
050,30,035,"Montana","Glacier County",5,2,178,94,84
050,30,035,"Montana","Glacier County",5,3,211,114,97
050,30,035,"Montana","Glacier County",5,4,230,108,122
050,30,035,"Montana","Glacier County",5,5,230,111,119
050,30,035,"Montana","Glacier County",5,6,210,113,97
050,30,035,"Montana","Glacier County",5,7,230,108,122
050,30,035,"Montana","Glacier County",5,8,252,120,132
050,30,035,"Montana","Glacier County",5,9,239,117,122
050,30,035,"Montana","Glacier County",5,10,233,110,123
050,30,035,"Montana","Glacier County",5,11,204,101,103
050,30,035,"Montana","Glacier County",5,12,250,124,126
050,30,035,"Montana","Glacier County",5,13,243,112,131
050,30,035,"Montana","Glacier County",5,14,243,115,128
050,30,035,"Montana","Glacier County",5,15,248,123,125
050,30,035,"Montana","Glacier County",5,16,233,118,115
050,30,035,"Montana","Glacier County",5,17,244,133,111
050,30,035,"Montana","Glacier County",5,18,224,120,104
050,30,035,"Montana","Glacier County",5,19,196,97,99
050,30,035,"Montana","Glacier County",5,20,180,91,89
050,30,035,"Montana","Glacier County",5,21,179,95,84
050,30,035,"Montana","Glacier County",5,22,173,78,95
050,30,035,"Montana","Glacier County",5,23,178,103,75
050,30,035,"Montana","Glacier County",5,24,195,109,86
050,30,035,"Montana","Glacier County",5,25,153,85,68
050,30,035,"Montana","Glacier County",5,26,163,80,83
050,30,035,"Montana","Glacier County",5,27,163,92,71
050,30,035,"Montana","Glacier County",5,28,154,78,76
050,30,035,"Montana","Glacier County",5,29,159,67,92
050,30,035,"Montana","Glacier County",5,30,164,72,92
050,30,035,"Montana","Glacier County",5,31,171,79,92
050,30,035,"Montana","Glacier County",5,32,179,83,96
050,30,035,"Montana","Glacier County",5,33,202,95,107
050,30,035,"Montana","Glacier County",5,34,213,114,99
050,30,035,"Montana","Glacier County",5,35,187,90,97
050,30,035,"Montana","Glacier County",5,36,165,84,81
050,30,035,"Montana","Glacier County",5,37,171,81,90
050,30,035,"Montana","Glacier County",5,38,186,91,95
050,30,035,"Montana","Glacier County",5,39,182,82,100
050,30,035,"Montana","Glacier County",5,40,180,88,92
050,30,035,"Montana","Glacier County",5,41,176,81,95
050,30,035,"Montana","Glacier County",5,42,169,80,89
050,30,035,"Montana","Glacier County",5,43,155,68,87
050,30,035,"Montana","Glacier County",5,44,157,79,78
050,30,035,"Montana","Glacier County",5,45,165,91,74
050,30,035,"Montana","Glacier County",5,46,158,84,74
050,30,035,"Montana","Glacier County",5,47,129,77,52
050,30,035,"Montana","Glacier County",5,48,134,73,61
050,30,035,"Montana","Glacier County",5,49,133,72,61
050,30,035,"Montana","Glacier County",5,50,123,57,66
050,30,035,"Montana","Glacier County",5,51,126,59,67
050,30,035,"Montana","Glacier County",5,52,132,57,75
050,30,035,"Montana","Glacier County",5,53,117,57,60
050,30,035,"Montana","Glacier County",5,54,139,78,61
050,30,035,"Montana","Glacier County",5,55,127,57,70
050,30,035,"Montana","Glacier County",5,56,140,62,78
050,30,035,"Montana","Glacier County",5,57,143,66,77
050,30,035,"Montana","Glacier County",5,58,161,72,89
050,30,035,"Montana","Glacier County",5,59,157,66,91
050,30,035,"Montana","Glacier County",5,60,164,74,90
050,30,035,"Montana","Glacier County",5,61,168,84,84
050,30,035,"Montana","Glacier County",5,62,177,84,93
050,30,035,"Montana","Glacier County",5,63,182,91,91
050,30,035,"Montana","Glacier County",5,64,172,80,92
050,30,035,"Montana","Glacier County",5,65,163,76,87
050,30,035,"Montana","Glacier County",5,66,147,63,84
050,30,035,"Montana","Glacier County",5,67,134,65,69
050,30,035,"Montana","Glacier County",5,68,116,52,64
050,30,035,"Montana","Glacier County",5,69,125,50,75
050,30,035,"Montana","Glacier County",5,70,123,59,64
050,30,035,"Montana","Glacier County",5,71,102,51,51
050,30,035,"Montana","Glacier County",5,72,89,46,43
050,30,035,"Montana","Glacier County",5,73,87,41,46
050,30,035,"Montana","Glacier County",5,74,89,41,48
050,30,035,"Montana","Glacier County",5,75,73,31,42
050,30,035,"Montana","Glacier County",5,76,93,44,49
050,30,035,"Montana","Glacier County",5,77,64,31,33
050,30,035,"Montana","Glacier County",5,78,50,24,26
050,30,035,"Montana","Glacier County",5,79,50,26,24
050,30,035,"Montana","Glacier County",5,80,45,18,27
050,30,035,"Montana","Glacier County",5,81,36,14,22
050,30,035,"Montana","Glacier County",5,82,43,22,21
050,30,035,"Montana","Glacier County",5,83,36,12,24
050,30,035,"Montana","Glacier County",5,84,26,8,18
050,30,035,"Montana","Glacier County",5,85,172,59,113
050,30,037,"Montana","Golden Valley County",1,0,5,3,2
050,30,037,"Montana","Golden Valley County",1,1,8,5,3
050,30,037,"Montana","Golden Valley County",1,2,8,3,5
050,30,037,"Montana","Golden Valley County",1,3,7,4,3
050,30,037,"Montana","Golden Valley County",1,4,6,5,1
050,30,037,"Montana","Golden Valley County",1,5,5,3,2
050,30,037,"Montana","Golden Valley County",1,6,8,5,3
050,30,037,"Montana","Golden Valley County",1,7,11,6,5
050,30,037,"Montana","Golden Valley County",1,8,5,2,3
050,30,037,"Montana","Golden Valley County",1,9,7,3,4
050,30,037,"Montana","Golden Valley County",1,10,8,6,2
050,30,037,"Montana","Golden Valley County",1,11,6,2,4
050,30,037,"Montana","Golden Valley County",1,12,7,1,6
050,30,037,"Montana","Golden Valley County",1,13,11,7,4
050,30,037,"Montana","Golden Valley County",1,14,5,2,3
050,30,037,"Montana","Golden Valley County",1,15,7,4,3
050,30,037,"Montana","Golden Valley County",1,16,4,2,2
050,30,037,"Montana","Golden Valley County",1,17,9,5,4
050,30,037,"Montana","Golden Valley County",1,18,6,4,2
050,30,037,"Montana","Golden Valley County",1,19,4,2,2
050,30,037,"Montana","Golden Valley County",1,20,4,2,2
050,30,037,"Montana","Golden Valley County",1,21,5,2,3
050,30,037,"Montana","Golden Valley County",1,22,4,2,2
050,30,037,"Montana","Golden Valley County",1,23,4,1,3
050,30,037,"Montana","Golden Valley County",1,24,7,2,5
050,30,037,"Montana","Golden Valley County",1,25,10,5,5
050,30,037,"Montana","Golden Valley County",1,26,9,3,6
050,30,037,"Montana","Golden Valley County",1,27,8,5,3
050,30,037,"Montana","Golden Valley County",1,28,12,4,8
050,30,037,"Montana","Golden Valley County",1,29,8,6,2
050,30,037,"Montana","Golden Valley County",1,30,6,6,0
050,30,037,"Montana","Golden Valley County",1,31,9,6,3
050,30,037,"Montana","Golden Valley County",1,32,5,3,2
050,30,037,"Montana","Golden Valley County",1,33,10,5,5
050,30,037,"Montana","Golden Valley County",1,34,3,1,2
050,30,037,"Montana","Golden Valley County",1,35,9,3,6
050,30,037,"Montana","Golden Valley County",1,36,10,4,6
050,30,037,"Montana","Golden Valley County",1,37,11,6,5
050,30,037,"Montana","Golden Valley County",1,38,11,5,6
050,30,037,"Montana","Golden Valley County",1,39,10,4,6
050,30,037,"Montana","Golden Valley County",1,40,10,4,6
050,30,037,"Montana","Golden Valley County",1,41,8,4,4
050,30,037,"Montana","Golden Valley County",1,42,9,4,5
050,30,037,"Montana","Golden Valley County",1,43,9,5,4
050,30,037,"Montana","Golden Valley County",1,44,4,2,2
050,30,037,"Montana","Golden Valley County",1,45,4,1,3
050,30,037,"Montana","Golden Valley County",1,46,5,2,3
050,30,037,"Montana","Golden Valley County",1,47,3,1,2
050,30,037,"Montana","Golden Valley County",1,48,3,2,1
050,30,037,"Montana","Golden Valley County",1,49,9,4,5
050,30,037,"Montana","Golden Valley County",1,50,8,2,6
050,30,037,"Montana","Golden Valley County",1,51,9,7,2
050,30,037,"Montana","Golden Valley County",1,52,7,6,1
050,30,037,"Montana","Golden Valley County",1,53,11,6,5
050,30,037,"Montana","Golden Valley County",1,54,13,3,10
050,30,037,"Montana","Golden Valley County",1,55,12,4,8
050,30,037,"Montana","Golden Valley County",1,56,16,6,10
050,30,037,"Montana","Golden Valley County",1,57,12,7,5
050,30,037,"Montana","Golden Valley County",1,58,13,6,7
050,30,037,"Montana","Golden Valley County",1,59,15,8,7
050,30,037,"Montana","Golden Valley County",1,60,19,13,6
050,30,037,"Montana","Golden Valley County",1,61,14,6,8
050,30,037,"Montana","Golden Valley County",1,62,16,8,8
050,30,037,"Montana","Golden Valley County",1,63,16,9,7
050,30,037,"Montana","Golden Valley County",1,64,16,9,7
050,30,037,"Montana","Golden Valley County",1,65,14,6,8
050,30,037,"Montana","Golden Valley County",1,66,18,7,11
050,30,037,"Montana","Golden Valley County",1,67,20,8,12
050,30,037,"Montana","Golden Valley County",1,68,24,11,13
050,30,037,"Montana","Golden Valley County",1,69,18,8,10
050,30,037,"Montana","Golden Valley County",1,70,16,8,8
050,30,037,"Montana","Golden Valley County",1,71,15,9,6
050,30,037,"Montana","Golden Valley County",1,72,9,6,3
050,30,037,"Montana","Golden Valley County",1,73,15,7,8
050,30,037,"Montana","Golden Valley County",1,74,11,8,3
050,30,037,"Montana","Golden Valley County",1,75,10,7,3
050,30,037,"Montana","Golden Valley County",1,76,13,8,5
050,30,037,"Montana","Golden Valley County",1,77,8,4,4
050,30,037,"Montana","Golden Valley County",1,78,6,2,4
050,30,037,"Montana","Golden Valley County",1,79,5,2,3
050,30,037,"Montana","Golden Valley County",1,80,8,3,5
050,30,037,"Montana","Golden Valley County",1,81,12,4,8
050,30,037,"Montana","Golden Valley County",1,82,7,3,4
050,30,037,"Montana","Golden Valley County",1,83,4,2,2
050,30,037,"Montana","Golden Valley County",1,84,4,2,2
050,30,037,"Montana","Golden Valley County",1,85,34,17,17
050,30,037,"Montana","Golden Valley County",2,0,6,3,3
050,30,037,"Montana","Golden Valley County",2,1,8,5,3
050,30,037,"Montana","Golden Valley County",2,2,9,4,5
050,30,037,"Montana","Golden Valley County",2,3,7,4,3
050,30,037,"Montana","Golden Valley County",2,4,5,4,1
050,30,037,"Montana","Golden Valley County",2,5,5,3,2
050,30,037,"Montana","Golden Valley County",2,6,6,4,2
050,30,037,"Montana","Golden Valley County",2,7,10,6,4
050,30,037,"Montana","Golden Valley County",2,8,7,3,4
050,30,037,"Montana","Golden Valley County",2,9,7,3,4
050,30,037,"Montana","Golden Valley County",2,10,8,5,3
050,30,037,"Montana","Golden Valley County",2,11,7,3,4
050,30,037,"Montana","Golden Valley County",2,12,7,1,6
050,30,037,"Montana","Golden Valley County",2,13,10,6,4
050,30,037,"Montana","Golden Valley County",2,14,6,3,3
050,30,037,"Montana","Golden Valley County",2,15,7,4,3
050,30,037,"Montana","Golden Valley County",2,16,4,2,2
050,30,037,"Montana","Golden Valley County",2,17,7,4,3
050,30,037,"Montana","Golden Valley County",2,18,6,4,2
050,30,037,"Montana","Golden Valley County",2,19,4,2,2
050,30,037,"Montana","Golden Valley County",2,20,4,2,2
050,30,037,"Montana","Golden Valley County",2,21,5,2,3
050,30,037,"Montana","Golden Valley County",2,22,4,2,2
050,30,037,"Montana","Golden Valley County",2,23,4,1,3
050,30,037,"Montana","Golden Valley County",2,24,7,2,5
050,30,037,"Montana","Golden Valley County",2,25,10,5,5
050,30,037,"Montana","Golden Valley County",2,26,9,3,6
050,30,037,"Montana","Golden Valley County",2,27,9,5,4
050,30,037,"Montana","Golden Valley County",2,28,11,4,7
050,30,037,"Montana","Golden Valley County",2,29,9,6,3
050,30,037,"Montana","Golden Valley County",2,30,7,6,1
050,30,037,"Montana","Golden Valley County",2,31,8,6,2
050,30,037,"Montana","Golden Valley County",2,32,7,5,2
050,30,037,"Montana","Golden Valley County",2,33,8,4,4
050,30,037,"Montana","Golden Valley County",2,34,5,2,3
050,30,037,"Montana","Golden Valley County",2,35,8,3,5
050,30,037,"Montana","Golden Valley County",2,36,10,4,6
050,30,037,"Montana","Golden Valley County",2,37,11,5,6
050,30,037,"Montana","Golden Valley County",2,38,10,5,5
050,30,037,"Montana","Golden Valley County",2,39,10,4,6
050,30,037,"Montana","Golden Valley County",2,40,10,4,6
050,30,037,"Montana","Golden Valley County",2,41,8,4,4
050,30,037,"Montana","Golden Valley County",2,42,9,4,5
050,30,037,"Montana","Golden Valley County",2,43,8,4,4
050,30,037,"Montana","Golden Valley County",2,44,5,3,2
050,30,037,"Montana","Golden Valley County",2,45,4,1,3
050,30,037,"Montana","Golden Valley County",2,46,5,2,3
050,30,037,"Montana","Golden Valley County",2,47,3,1,2
050,30,037,"Montana","Golden Valley County",2,48,3,2,1
050,30,037,"Montana","Golden Valley County",2,49,8,4,4
050,30,037,"Montana","Golden Valley County",2,50,9,3,6
050,30,037,"Montana","Golden Valley County",2,51,9,6,3
050,30,037,"Montana","Golden Valley County",2,52,7,6,1
050,30,037,"Montana","Golden Valley County",2,53,10,6,4
050,30,037,"Montana","Golden Valley County",2,54,13,4,9
050,30,037,"Montana","Golden Valley County",2,55,12,3,9
050,30,037,"Montana","Golden Valley County",2,56,15,5,10
050,30,037,"Montana","Golden Valley County",2,57,12,6,6
050,30,037,"Montana","Golden Valley County",2,58,12,6,6
050,30,037,"Montana","Golden Valley County",2,59,15,8,7
050,30,037,"Montana","Golden Valley County",2,60,18,12,6
050,30,037,"Montana","Golden Valley County",2,61,15,8,7
050,30,037,"Montana","Golden Valley County",2,62,16,7,9
050,30,037,"Montana","Golden Valley County",2,63,17,9,8
050,30,037,"Montana","Golden Valley County",2,64,16,9,7
050,30,037,"Montana","Golden Valley County",2,65,15,7,8
050,30,037,"Montana","Golden Valley County",2,66,16,6,10
050,30,037,"Montana","Golden Valley County",2,67,19,7,12
050,30,037,"Montana","Golden Valley County",2,68,22,10,12
050,30,037,"Montana","Golden Valley County",2,69,20,9,11
050,30,037,"Montana","Golden Valley County",2,70,16,7,9
050,30,037,"Montana","Golden Valley County",2,71,14,8,6
050,30,037,"Montana","Golden Valley County",2,72,10,6,4
050,30,037,"Montana","Golden Valley County",2,73,16,8,8
050,30,037,"Montana","Golden Valley County",2,74,11,7,4
050,30,037,"Montana","Golden Valley County",2,75,10,7,3
050,30,037,"Montana","Golden Valley County",2,76,13,8,5
050,30,037,"Montana","Golden Valley County",2,77,9,5,4
050,30,037,"Montana","Golden Valley County",2,78,6,2,4
050,30,037,"Montana","Golden Valley County",2,79,5,2,3
050,30,037,"Montana","Golden Valley County",2,80,8,3,5
050,30,037,"Montana","Golden Valley County",2,81,10,3,7
050,30,037,"Montana","Golden Valley County",2,82,8,3,5
050,30,037,"Montana","Golden Valley County",2,83,5,2,3
050,30,037,"Montana","Golden Valley County",2,84,4,2,2
050,30,037,"Montana","Golden Valley County",2,85,33,16,17
050,30,037,"Montana","Golden Valley County",3,0,7,2,5
050,30,037,"Montana","Golden Valley County",3,1,6,3,3
050,30,037,"Montana","Golden Valley County",3,2,7,4,3
050,30,037,"Montana","Golden Valley County",3,3,10,5,5
050,30,037,"Montana","Golden Valley County",3,4,7,4,3
050,30,037,"Montana","Golden Valley County",3,5,6,4,2
050,30,037,"Montana","Golden Valley County",3,6,5,3,2
050,30,037,"Montana","Golden Valley County",3,7,7,5,2
050,30,037,"Montana","Golden Valley County",3,8,10,5,5
050,30,037,"Montana","Golden Valley County",3,9,9,4,5
050,30,037,"Montana","Golden Valley County",3,10,7,3,4
050,30,037,"Montana","Golden Valley County",3,11,7,4,3
050,30,037,"Montana","Golden Valley County",3,12,9,5,4
050,30,037,"Montana","Golden Valley County",3,13,6,1,5
050,30,037,"Montana","Golden Valley County",3,14,9,5,4
050,30,037,"Montana","Golden Valley County",3,15,7,3,4
050,30,037,"Montana","Golden Valley County",3,16,8,4,4
050,30,037,"Montana","Golden Valley County",3,17,6,4,2
050,30,037,"Montana","Golden Valley County",3,18,6,3,3
050,30,037,"Montana","Golden Valley County",3,19,3,2,1
050,30,037,"Montana","Golden Valley County",3,20,3,2,1
050,30,037,"Montana","Golden Valley County",3,21,3,1,2
050,30,037,"Montana","Golden Valley County",3,22,5,2,3
050,30,037,"Montana","Golden Valley County",3,23,3,1,2
050,30,037,"Montana","Golden Valley County",3,24,6,1,5
050,30,037,"Montana","Golden Valley County",3,25,8,3,5
050,30,037,"Montana","Golden Valley County",3,26,12,6,6
050,30,037,"Montana","Golden Valley County",3,27,12,5,7
050,30,037,"Montana","Golden Valley County",3,28,8,3,5
050,30,037,"Montana","Golden Valley County",3,29,11,6,5
050,30,037,"Montana","Golden Valley County",3,30,4,3,1
050,30,037,"Montana","Golden Valley County",3,31,10,7,3
050,30,037,"Montana","Golden Valley County",3,32,8,6,2
050,30,037,"Montana","Golden Valley County",3,33,5,3,2
050,30,037,"Montana","Golden Valley County",3,34,10,4,6
050,30,037,"Montana","Golden Valley County",3,35,7,4,3
050,30,037,"Montana","Golden Valley County",3,36,7,2,5
050,30,037,"Montana","Golden Valley County",3,37,10,4,6
050,30,037,"Montana","Golden Valley County",3,38,12,5,7
050,30,037,"Montana","Golden Valley County",3,39,9,4,5
050,30,037,"Montana","Golden Valley County",3,40,12,5,7
050,30,037,"Montana","Golden Valley County",3,41,9,3,6
050,30,037,"Montana","Golden Valley County",3,42,8,3,5
050,30,037,"Montana","Golden Valley County",3,43,9,4,5
050,30,037,"Montana","Golden Valley County",3,44,9,4,5
050,30,037,"Montana","Golden Valley County",3,45,7,6,1
050,30,037,"Montana","Golden Valley County",3,46,4,1,3
050,30,037,"Montana","Golden Valley County",3,47,5,2,3
050,30,037,"Montana","Golden Valley County",3,48,1,1,0
050,30,037,"Montana","Golden Valley County",3,49,1,1,0
050,30,037,"Montana","Golden Valley County",3,50,8,4,4
050,30,037,"Montana","Golden Valley County",3,51,10,3,7
050,30,037,"Montana","Golden Valley County",3,52,10,7,3
050,30,037,"Montana","Golden Valley County",3,53,7,6,1
050,30,037,"Montana","Golden Valley County",3,54,10,6,4
050,30,037,"Montana","Golden Valley County",3,55,14,5,9
050,30,037,"Montana","Golden Valley County",3,56,11,3,8
050,30,037,"Montana","Golden Valley County",3,57,15,5,10
050,30,037,"Montana","Golden Valley County",3,58,11,5,6
050,30,037,"Montana","Golden Valley County",3,59,11,6,5
050,30,037,"Montana","Golden Valley County",3,60,16,8,8
050,30,037,"Montana","Golden Valley County",3,61,17,10,7
050,30,037,"Montana","Golden Valley County",3,62,16,8,8
050,30,037,"Montana","Golden Valley County",3,63,13,6,7
050,30,037,"Montana","Golden Valley County",3,64,17,9,8
050,30,037,"Montana","Golden Valley County",3,65,15,8,7
050,30,037,"Montana","Golden Valley County",3,66,15,6,9
050,30,037,"Montana","Golden Valley County",3,67,16,6,10
050,30,037,"Montana","Golden Valley County",3,68,18,6,12
050,30,037,"Montana","Golden Valley County",3,69,20,9,11
050,30,037,"Montana","Golden Valley County",3,70,20,9,11
050,30,037,"Montana","Golden Valley County",3,71,16,7,9
050,30,037,"Montana","Golden Valley County",3,72,14,8,6
050,30,037,"Montana","Golden Valley County",3,73,10,6,4
050,30,037,"Montana","Golden Valley County",3,74,14,6,8
050,30,037,"Montana","Golden Valley County",3,75,12,8,4
050,30,037,"Montana","Golden Valley County",3,76,10,7,3
050,30,037,"Montana","Golden Valley County",3,77,11,8,3
050,30,037,"Montana","Golden Valley County",3,78,9,5,4
050,30,037,"Montana","Golden Valley County",3,79,5,2,3
050,30,037,"Montana","Golden Valley County",3,80,4,1,3
050,30,037,"Montana","Golden Valley County",3,81,8,3,5
050,30,037,"Montana","Golden Valley County",3,82,9,2,7
050,30,037,"Montana","Golden Valley County",3,83,6,1,5
050,30,037,"Montana","Golden Valley County",3,84,5,2,3
050,30,037,"Montana","Golden Valley County",3,85,32,16,16
050,30,037,"Montana","Golden Valley County",4,0,4,1,3
050,30,037,"Montana","Golden Valley County",4,1,8,4,4
050,30,037,"Montana","Golden Valley County",4,2,7,4,3
050,30,037,"Montana","Golden Valley County",4,3,7,4,3
050,30,037,"Montana","Golden Valley County",4,4,10,5,5
050,30,037,"Montana","Golden Valley County",4,5,7,4,3
050,30,037,"Montana","Golden Valley County",4,6,7,5,2
050,30,037,"Montana","Golden Valley County",4,7,7,3,4
050,30,037,"Montana","Golden Valley County",4,8,8,4,4
050,30,037,"Montana","Golden Valley County",4,9,10,4,6
050,30,037,"Montana","Golden Valley County",4,10,7,3,4
050,30,037,"Montana","Golden Valley County",4,11,8,4,4
050,30,037,"Montana","Golden Valley County",4,12,7,4,3
050,30,037,"Montana","Golden Valley County",4,13,9,4,5
050,30,037,"Montana","Golden Valley County",4,14,9,3,6
050,30,037,"Montana","Golden Valley County",4,15,10,5,5
050,30,037,"Montana","Golden Valley County",4,16,7,3,4
050,30,037,"Montana","Golden Valley County",4,17,9,4,5
050,30,037,"Montana","Golden Valley County",4,18,6,5,1
050,30,037,"Montana","Golden Valley County",4,19,4,2,2
050,30,037,"Montana","Golden Valley County",4,20,3,2,1
050,30,037,"Montana","Golden Valley County",4,21,4,3,1
050,30,037,"Montana","Golden Valley County",4,22,3,1,2
050,30,037,"Montana","Golden Valley County",4,23,5,1,4
050,30,037,"Montana","Golden Valley County",4,24,4,2,2
050,30,037,"Montana","Golden Valley County",4,25,5,1,4
050,30,037,"Montana","Golden Valley County",4,26,7,2,5
050,30,037,"Montana","Golden Valley County",4,27,10,5,5
050,30,037,"Montana","Golden Valley County",4,28,10,3,7
050,30,037,"Montana","Golden Valley County",4,29,11,4,7
050,30,037,"Montana","Golden Valley County",4,30,10,6,4
050,30,037,"Montana","Golden Valley County",4,31,5,3,2
050,30,037,"Montana","Golden Valley County",4,32,7,5,2
050,30,037,"Montana","Golden Valley County",4,33,10,6,4
050,30,037,"Montana","Golden Valley County",4,34,6,4,2
050,30,037,"Montana","Golden Valley County",4,35,10,5,5
050,30,037,"Montana","Golden Valley County",4,36,5,1,4
050,30,037,"Montana","Golden Valley County",4,37,7,2,5
050,30,037,"Montana","Golden Valley County",4,38,10,4,6
050,30,037,"Montana","Golden Valley County",4,39,13,7,6
050,30,037,"Montana","Golden Valley County",4,40,11,5,6
050,30,037,"Montana","Golden Valley County",4,41,10,5,5
050,30,037,"Montana","Golden Valley County",4,42,9,3,6
050,30,037,"Montana","Golden Valley County",4,43,8,3,5
050,30,037,"Montana","Golden Valley County",4,44,9,4,5
050,30,037,"Montana","Golden Valley County",4,45,9,4,5
050,30,037,"Montana","Golden Valley County",4,46,10,9,1
050,30,037,"Montana","Golden Valley County",4,47,5,1,4
050,30,037,"Montana","Golden Valley County",4,48,5,2,3
050,30,037,"Montana","Golden Valley County",4,49,1,1,0
050,30,037,"Montana","Golden Valley County",4,50,2,2,0
050,30,037,"Montana","Golden Valley County",4,51,9,5,4
050,30,037,"Montana","Golden Valley County",4,52,10,3,7
050,30,037,"Montana","Golden Valley County",4,53,7,4,3
050,30,037,"Montana","Golden Valley County",4,54,7,6,1
050,30,037,"Montana","Golden Valley County",4,55,10,6,4
050,30,037,"Montana","Golden Valley County",4,56,18,6,12
050,30,037,"Montana","Golden Valley County",4,57,10,4,6
050,30,037,"Montana","Golden Valley County",4,58,12,2,10
050,30,037,"Montana","Golden Valley County",4,59,12,5,7
050,30,037,"Montana","Golden Valley County",4,60,12,7,5
050,30,037,"Montana","Golden Valley County",4,61,17,9,8
050,30,037,"Montana","Golden Valley County",4,62,18,10,8
050,30,037,"Montana","Golden Valley County",4,63,16,8,8
050,30,037,"Montana","Golden Valley County",4,64,13,5,8
050,30,037,"Montana","Golden Valley County",4,65,17,8,9
050,30,037,"Montana","Golden Valley County",4,66,17,9,8
050,30,037,"Montana","Golden Valley County",4,67,14,5,9
050,30,037,"Montana","Golden Valley County",4,68,14,5,9
050,30,037,"Montana","Golden Valley County",4,69,16,5,11
050,30,037,"Montana","Golden Valley County",4,70,23,11,12
050,30,037,"Montana","Golden Valley County",4,71,22,10,12
050,30,037,"Montana","Golden Valley County",4,72,15,8,7
050,30,037,"Montana","Golden Valley County",4,73,15,8,7
050,30,037,"Montana","Golden Valley County",4,74,12,7,5
050,30,037,"Montana","Golden Valley County",4,75,13,6,7
050,30,037,"Montana","Golden Valley County",4,76,11,8,3
050,30,037,"Montana","Golden Valley County",4,77,9,7,2
050,30,037,"Montana","Golden Valley County",4,78,9,7,2
050,30,037,"Montana","Golden Valley County",4,79,9,5,4
050,30,037,"Montana","Golden Valley County",4,80,4,1,3
050,30,037,"Montana","Golden Valley County",4,81,4,1,3
050,30,037,"Montana","Golden Valley County",4,82,5,1,4
050,30,037,"Montana","Golden Valley County",4,83,9,2,7
050,30,037,"Montana","Golden Valley County",4,84,6,1,5
050,30,037,"Montana","Golden Valley County",4,85,36,18,18
050,30,037,"Montana","Golden Valley County",5,0,5,1,4
050,30,037,"Montana","Golden Valley County",5,1,8,1,7
050,30,037,"Montana","Golden Valley County",5,2,9,2,7
050,30,037,"Montana","Golden Valley County",5,3,8,6,2
050,30,037,"Montana","Golden Valley County",5,4,10,6,4
050,30,037,"Montana","Golden Valley County",5,5,10,5,5
050,30,037,"Montana","Golden Valley County",5,6,7,4,3
050,30,037,"Montana","Golden Valley County",5,7,8,6,2
050,30,037,"Montana","Golden Valley County",5,8,7,2,5
050,30,037,"Montana","Golden Valley County",5,9,10,6,4
050,30,037,"Montana","Golden Valley County",5,10,8,3,5
050,30,037,"Montana","Golden Valley County",5,11,6,2,4
050,30,037,"Montana","Golden Valley County",5,12,7,3,4
050,30,037,"Montana","Golden Valley County",5,13,8,5,3
050,30,037,"Montana","Golden Valley County",5,14,6,3,3
050,30,037,"Montana","Golden Valley County",5,15,9,4,5
050,30,037,"Montana","Golden Valley County",5,16,9,5,4
050,30,037,"Montana","Golden Valley County",5,17,7,3,4
050,30,037,"Montana","Golden Valley County",5,18,8,4,4
050,30,037,"Montana","Golden Valley County",5,19,4,4,0
050,30,037,"Montana","Golden Valley County",5,20,6,4,2
050,30,037,"Montana","Golden Valley County",5,21,3,2,1
050,30,037,"Montana","Golden Valley County",5,22,4,2,2
050,30,037,"Montana","Golden Valley County",5,23,5,1,4
050,30,037,"Montana","Golden Valley County",5,24,6,1,5
050,30,037,"Montana","Golden Valley County",5,25,8,5,3
050,30,037,"Montana","Golden Valley County",5,26,6,2,4
050,30,037,"Montana","Golden Valley County",5,27,7,3,4
050,30,037,"Montana","Golden Valley County",5,28,8,5,3
050,30,037,"Montana","Golden Valley County",5,29,9,3,6
050,30,037,"Montana","Golden Valley County",5,30,9,4,5
050,30,037,"Montana","Golden Valley County",5,31,8,4,4
050,30,037,"Montana","Golden Valley County",5,32,6,3,3
050,30,037,"Montana","Golden Valley County",5,33,6,4,2
050,30,037,"Montana","Golden Valley County",5,34,9,6,3
050,30,037,"Montana","Golden Valley County",5,35,5,3,2
050,30,037,"Montana","Golden Valley County",5,36,9,4,5
050,30,037,"Montana","Golden Valley County",5,37,6,2,4
050,30,037,"Montana","Golden Valley County",5,38,5,2,3
050,30,037,"Montana","Golden Valley County",5,39,12,5,7
050,30,037,"Montana","Golden Valley County",5,40,12,6,6
050,30,037,"Montana","Golden Valley County",5,41,12,6,6
050,30,037,"Montana","Golden Valley County",5,42,8,4,4
050,30,037,"Montana","Golden Valley County",5,43,9,3,6
050,30,037,"Montana","Golden Valley County",5,44,8,3,5
050,30,037,"Montana","Golden Valley County",5,45,9,4,5
050,30,037,"Montana","Golden Valley County",5,46,12,4,8
050,30,037,"Montana","Golden Valley County",5,47,11,9,2
050,30,037,"Montana","Golden Valley County",5,48,5,1,4
050,30,037,"Montana","Golden Valley County",5,49,4,2,2
050,30,037,"Montana","Golden Valley County",5,50,1,1,0
050,30,037,"Montana","Golden Valley County",5,51,2,2,0
050,30,037,"Montana","Golden Valley County",5,52,11,7,4
050,30,037,"Montana","Golden Valley County",5,53,8,3,5
050,30,037,"Montana","Golden Valley County",5,54,7,4,3
050,30,037,"Montana","Golden Valley County",5,55,7,6,1
050,30,037,"Montana","Golden Valley County",5,56,11,6,5
050,30,037,"Montana","Golden Valley County",5,57,17,6,11
050,30,037,"Montana","Golden Valley County",5,58,10,3,7
050,30,037,"Montana","Golden Valley County",5,59,13,4,9
050,30,037,"Montana","Golden Valley County",5,60,12,6,6
050,30,037,"Montana","Golden Valley County",5,61,12,7,5
050,30,037,"Montana","Golden Valley County",5,62,18,10,8
050,30,037,"Montana","Golden Valley County",5,63,20,10,10
050,30,037,"Montana","Golden Valley County",5,64,15,7,8
050,30,037,"Montana","Golden Valley County",5,65,13,6,7
050,30,037,"Montana","Golden Valley County",5,66,16,6,10
050,30,037,"Montana","Golden Valley County",5,67,17,8,9
050,30,037,"Montana","Golden Valley County",5,68,12,4,8
050,30,037,"Montana","Golden Valley County",5,69,14,5,9
050,30,037,"Montana","Golden Valley County",5,70,17,5,12
050,30,037,"Montana","Golden Valley County",5,71,21,10,11
050,30,037,"Montana","Golden Valley County",5,72,24,12,12
050,30,037,"Montana","Golden Valley County",5,73,21,14,7
050,30,037,"Montana","Golden Valley County",5,74,15,8,7
050,30,037,"Montana","Golden Valley County",5,75,12,7,5
050,30,037,"Montana","Golden Valley County",5,76,13,6,7
050,30,037,"Montana","Golden Valley County",5,77,10,8,2
050,30,037,"Montana","Golden Valley County",5,78,8,7,1
050,30,037,"Montana","Golden Valley County",5,79,9,7,2
050,30,037,"Montana","Golden Valley County",5,80,7,3,4
050,30,037,"Montana","Golden Valley County",5,81,4,2,2
050,30,037,"Montana","Golden Valley County",5,82,3,0,3
050,30,037,"Montana","Golden Valley County",5,83,5,1,4
050,30,037,"Montana","Golden Valley County",5,84,9,2,7
050,30,037,"Montana","Golden Valley County",5,85,40,19,21
050,30,039,"Montana","Granite County",1,0,18,9,9
050,30,039,"Montana","Granite County",1,1,17,12,5
050,30,039,"Montana","Granite County",1,2,21,10,11
050,30,039,"Montana","Granite County",1,3,18,8,10
050,30,039,"Montana","Granite County",1,4,32,16,16
050,30,039,"Montana","Granite County",1,5,32,14,18
050,30,039,"Montana","Granite County",1,6,28,11,17
050,30,039,"Montana","Granite County",1,7,30,16,14
050,30,039,"Montana","Granite County",1,8,28,15,13
050,30,039,"Montana","Granite County",1,9,25,9,16
050,30,039,"Montana","Granite County",1,10,29,10,19
050,30,039,"Montana","Granite County",1,11,33,20,13
050,30,039,"Montana","Granite County",1,12,31,19,12
050,30,039,"Montana","Granite County",1,13,34,21,13
050,30,039,"Montana","Granite County",1,14,31,17,14
050,30,039,"Montana","Granite County",1,15,37,17,20
050,30,039,"Montana","Granite County",1,16,29,18,11
050,30,039,"Montana","Granite County",1,17,27,17,10
050,30,039,"Montana","Granite County",1,18,32,10,22
050,30,039,"Montana","Granite County",1,19,27,13,14
050,30,039,"Montana","Granite County",1,20,19,8,11
050,30,039,"Montana","Granite County",1,21,27,13,14
050,30,039,"Montana","Granite County",1,22,28,13,15
050,30,039,"Montana","Granite County",1,23,27,12,15
050,30,039,"Montana","Granite County",1,24,31,16,15
050,30,039,"Montana","Granite County",1,25,23,13,10
050,30,039,"Montana","Granite County",1,26,26,12,14
050,30,039,"Montana","Granite County",1,27,21,10,11
050,30,039,"Montana","Granite County",1,28,31,18,13
050,30,039,"Montana","Granite County",1,29,40,19,21
050,30,039,"Montana","Granite County",1,30,28,14,14
050,30,039,"Montana","Granite County",1,31,24,10,14
050,30,039,"Montana","Granite County",1,32,28,17,11
050,30,039,"Montana","Granite County",1,33,24,12,12
050,30,039,"Montana","Granite County",1,34,30,17,13
050,30,039,"Montana","Granite County",1,35,26,14,12
050,30,039,"Montana","Granite County",1,36,40,21,19
050,30,039,"Montana","Granite County",1,37,38,25,13
050,30,039,"Montana","Granite County",1,38,39,23,16
050,30,039,"Montana","Granite County",1,39,40,16,24
050,30,039,"Montana","Granite County",1,40,34,13,21
050,30,039,"Montana","Granite County",1,41,31,13,18
050,30,039,"Montana","Granite County",1,42,41,17,24
050,30,039,"Montana","Granite County",1,43,40,23,17
050,30,039,"Montana","Granite County",1,44,33,20,13
050,30,039,"Montana","Granite County",1,45,34,22,12
050,30,039,"Montana","Granite County",1,46,32,20,12
050,30,039,"Montana","Granite County",1,47,31,17,14
050,30,039,"Montana","Granite County",1,48,38,20,18
050,30,039,"Montana","Granite County",1,49,34,20,14
050,30,039,"Montana","Granite County",1,50,38,19,19
050,30,039,"Montana","Granite County",1,51,35,16,19
050,30,039,"Montana","Granite County",1,52,36,17,19
050,30,039,"Montana","Granite County",1,53,30,15,15
050,30,039,"Montana","Granite County",1,54,42,22,20
050,30,039,"Montana","Granite County",1,55,48,26,22
050,30,039,"Montana","Granite County",1,56,54,27,27
050,30,039,"Montana","Granite County",1,57,52,35,17
050,30,039,"Montana","Granite County",1,58,63,33,30
050,30,039,"Montana","Granite County",1,59,68,32,36
050,30,039,"Montana","Granite County",1,60,75,33,42
050,30,039,"Montana","Granite County",1,61,60,28,32
050,30,039,"Montana","Granite County",1,62,66,35,31
050,30,039,"Montana","Granite County",1,63,69,31,38
050,30,039,"Montana","Granite County",1,64,63,33,30
050,30,039,"Montana","Granite County",1,65,80,44,36
050,30,039,"Montana","Granite County",1,66,68,42,26
050,30,039,"Montana","Granite County",1,67,65,37,28
050,30,039,"Montana","Granite County",1,68,74,34,40
050,30,039,"Montana","Granite County",1,69,64,32,32
050,30,039,"Montana","Granite County",1,70,56,31,25
050,30,039,"Montana","Granite County",1,71,46,23,23
050,30,039,"Montana","Granite County",1,72,52,30,22
050,30,039,"Montana","Granite County",1,73,57,35,22
050,30,039,"Montana","Granite County",1,74,47,28,19
050,30,039,"Montana","Granite County",1,75,39,21,18
050,30,039,"Montana","Granite County",1,76,33,14,19
050,30,039,"Montana","Granite County",1,77,47,25,22
050,30,039,"Montana","Granite County",1,78,41,22,19
050,30,039,"Montana","Granite County",1,79,35,17,18
050,30,039,"Montana","Granite County",1,80,29,16,13
050,30,039,"Montana","Granite County",1,81,28,17,11
050,30,039,"Montana","Granite County",1,82,27,14,13
050,30,039,"Montana","Granite County",1,83,19,9,10
050,30,039,"Montana","Granite County",1,84,16,11,5
050,30,039,"Montana","Granite County",1,85,91,40,51
050,30,039,"Montana","Granite County",2,0,22,14,8
050,30,039,"Montana","Granite County",2,1,16,11,5
050,30,039,"Montana","Granite County",2,2,20,10,10
050,30,039,"Montana","Granite County",2,3,20,10,10
050,30,039,"Montana","Granite County",2,4,30,15,15
050,30,039,"Montana","Granite County",2,5,33,14,19
050,30,039,"Montana","Granite County",2,6,30,12,18
050,30,039,"Montana","Granite County",2,7,30,15,15
050,30,039,"Montana","Granite County",2,8,28,16,12
050,30,039,"Montana","Granite County",2,9,26,10,16
050,30,039,"Montana","Granite County",2,10,28,10,18
050,30,039,"Montana","Granite County",2,11,34,19,15
050,30,039,"Montana","Granite County",2,12,31,19,12
050,30,039,"Montana","Granite County",2,13,34,21,13
050,30,039,"Montana","Granite County",2,14,30,17,13
050,30,039,"Montana","Granite County",2,15,36,17,19
050,30,039,"Montana","Granite County",2,16,30,18,12
050,30,039,"Montana","Granite County",2,17,28,18,10
050,30,039,"Montana","Granite County",2,18,30,13,17
050,30,039,"Montana","Granite County",2,19,27,12,15
050,30,039,"Montana","Granite County",2,20,22,10,12
050,30,039,"Montana","Granite County",2,21,26,13,13
050,30,039,"Montana","Granite County",2,22,28,13,15
050,30,039,"Montana","Granite County",2,23,28,13,15
050,30,039,"Montana","Granite County",2,24,29,15,14
050,30,039,"Montana","Granite County",2,25,24,13,11
050,30,039,"Montana","Granite County",2,26,25,12,13
050,30,039,"Montana","Granite County",2,27,22,11,11
050,30,039,"Montana","Granite County",2,28,30,16,14
050,30,039,"Montana","Granite County",2,29,38,19,19
050,30,039,"Montana","Granite County",2,30,30,15,15
050,30,039,"Montana","Granite County",2,31,24,11,13
050,30,039,"Montana","Granite County",2,32,27,15,12
050,30,039,"Montana","Granite County",2,33,25,13,12
050,30,039,"Montana","Granite County",2,34,29,16,13
050,30,039,"Montana","Granite County",2,35,28,15,13
050,30,039,"Montana","Granite County",2,36,35,19,16
050,30,039,"Montana","Granite County",2,37,38,24,14
050,30,039,"Montana","Granite County",2,38,40,25,15
050,30,039,"Montana","Granite County",2,39,40,18,22
050,30,039,"Montana","Granite County",2,40,37,14,23
050,30,039,"Montana","Granite County",2,41,32,14,18
050,30,039,"Montana","Granite County",2,42,40,17,23
050,30,039,"Montana","Granite County",2,43,40,21,19
050,30,039,"Montana","Granite County",2,44,35,21,14
050,30,039,"Montana","Granite County",2,45,34,21,13
050,30,039,"Montana","Granite County",2,46,33,21,12
050,30,039,"Montana","Granite County",2,47,31,17,14
050,30,039,"Montana","Granite County",2,48,36,19,17
050,30,039,"Montana","Granite County",2,49,36,21,15
050,30,039,"Montana","Granite County",2,50,36,18,18
050,30,039,"Montana","Granite County",2,51,35,16,19
050,30,039,"Montana","Granite County",2,52,36,17,19
050,30,039,"Montana","Granite County",2,53,30,15,15
050,30,039,"Montana","Granite County",2,54,40,21,19
050,30,039,"Montana","Granite County",2,55,46,25,21
050,30,039,"Montana","Granite County",2,56,53,27,26
050,30,039,"Montana","Granite County",2,57,53,34,19
050,30,039,"Montana","Granite County",2,58,60,33,27
050,30,039,"Montana","Granite County",2,59,67,32,35
050,30,039,"Montana","Granite County",2,60,73,32,41
050,30,039,"Montana","Granite County",2,61,64,30,34
050,30,039,"Montana","Granite County",2,62,65,34,31
050,30,039,"Montana","Granite County",2,63,69,33,36
050,30,039,"Montana","Granite County",2,64,64,33,31
050,30,039,"Montana","Granite County",2,65,75,41,34
050,30,039,"Montana","Granite County",2,66,70,42,28
050,30,039,"Montana","Granite County",2,67,65,38,27
050,30,039,"Montana","Granite County",2,68,71,34,37
050,30,039,"Montana","Granite County",2,69,66,33,33
050,30,039,"Montana","Granite County",2,70,55,30,25
050,30,039,"Montana","Granite County",2,71,48,25,23
050,30,039,"Montana","Granite County",2,72,50,28,22
050,30,039,"Montana","Granite County",2,73,59,36,23
050,30,039,"Montana","Granite County",2,74,47,28,19
050,30,039,"Montana","Granite County",2,75,40,22,18
050,30,039,"Montana","Granite County",2,76,34,15,19
050,30,039,"Montana","Granite County",2,77,45,23,22
050,30,039,"Montana","Granite County",2,78,41,22,19
050,30,039,"Montana","Granite County",2,79,36,18,18
050,30,039,"Montana","Granite County",2,80,31,17,14
050,30,039,"Montana","Granite County",2,81,28,17,11
050,30,039,"Montana","Granite County",2,82,26,13,13
050,30,039,"Montana","Granite County",2,83,21,10,11
050,30,039,"Montana","Granite County",2,84,17,11,6
050,30,039,"Montana","Granite County",2,85,91,41,50
050,30,039,"Montana","Granite County",3,0,32,17,15
050,30,039,"Montana","Granite County",3,1,18,9,9
050,30,039,"Montana","Granite County",3,2,17,12,5
050,30,039,"Montana","Granite County",3,3,27,13,14
050,30,039,"Montana","Granite County",3,4,18,8,10
050,30,039,"Montana","Granite County",3,5,25,10,15
050,30,039,"Montana","Granite County",3,6,33,14,19
050,30,039,"Montana","Granite County",3,7,34,11,23
050,30,039,"Montana","Granite County",3,8,29,18,11
050,30,039,"Montana","Granite County",3,9,28,14,14
050,30,039,"Montana","Granite County",3,10,27,10,17
050,30,039,"Montana","Granite County",3,11,29,10,19
050,30,039,"Montana","Granite County",3,12,31,18,13
050,30,039,"Montana","Granite County",3,13,32,18,14
050,30,039,"Montana","Granite County",3,14,31,19,12
050,30,039,"Montana","Granite County",3,15,30,16,14
050,30,039,"Montana","Granite County",3,16,37,18,19
050,30,039,"Montana","Granite County",3,17,31,19,12
050,30,039,"Montana","Granite County",3,18,26,17,9
050,30,039,"Montana","Granite County",3,19,21,11,10
050,30,039,"Montana","Granite County",3,20,30,12,18
050,30,039,"Montana","Granite County",3,21,20,8,12
050,30,039,"Montana","Granite County",3,22,25,10,15
050,30,039,"Montana","Granite County",3,23,31,17,14
050,30,039,"Montana","Granite County",3,24,38,21,17
050,30,039,"Montana","Granite County",3,25,32,17,15
050,30,039,"Montana","Granite County",3,26,32,16,16
050,30,039,"Montana","Granite County",3,27,25,13,12
050,30,039,"Montana","Granite County",3,28,26,14,12
050,30,039,"Montana","Granite County",3,29,34,20,14
050,30,039,"Montana","Granite County",3,30,37,17,20
050,30,039,"Montana","Granite County",3,31,37,21,16
050,30,039,"Montana","Granite County",3,32,28,13,15
050,30,039,"Montana","Granite County",3,33,29,18,11
050,30,039,"Montana","Granite County",3,34,27,15,12
050,30,039,"Montana","Granite County",3,35,31,18,13
050,30,039,"Montana","Granite County",3,36,26,12,14
050,30,039,"Montana","Granite County",3,37,35,18,17
050,30,039,"Montana","Granite County",3,38,36,25,11
050,30,039,"Montana","Granite County",3,39,43,25,18
050,30,039,"Montana","Granite County",3,40,43,17,26
050,30,039,"Montana","Granite County",3,41,40,15,25
050,30,039,"Montana","Granite County",3,42,30,14,16
050,30,039,"Montana","Granite County",3,43,39,17,22
050,30,039,"Montana","Granite County",3,44,46,25,21
050,30,039,"Montana","Granite County",3,45,38,23,15
050,30,039,"Montana","Granite County",3,46,35,21,14
050,30,039,"Montana","Granite County",3,47,39,23,16
050,30,039,"Montana","Granite County",3,48,33,18,15
050,30,039,"Montana","Granite County",3,49,37,18,19
050,30,039,"Montana","Granite County",3,50,39,24,15
050,30,039,"Montana","Granite County",3,51,35,18,17
050,30,039,"Montana","Granite County",3,52,39,18,21
050,30,039,"Montana","Granite County",3,53,33,16,17
050,30,039,"Montana","Granite County",3,54,32,15,17
050,30,039,"Montana","Granite County",3,55,38,19,19
050,30,039,"Montana","Granite County",3,56,47,27,20
050,30,039,"Montana","Granite County",3,57,55,27,28
050,30,039,"Montana","Granite County",3,58,54,36,18
050,30,039,"Montana","Granite County",3,59,64,37,27
050,30,039,"Montana","Granite County",3,60,67,31,36
050,30,039,"Montana","Granite County",3,61,82,38,44
050,30,039,"Montana","Granite County",3,62,60,29,31
050,30,039,"Montana","Granite County",3,63,66,35,31
050,30,039,"Montana","Granite County",3,64,68,34,34
050,30,039,"Montana","Granite County",3,65,65,30,35
050,30,039,"Montana","Granite County",3,66,73,38,35
050,30,039,"Montana","Granite County",3,67,71,43,28
050,30,039,"Montana","Granite County",3,68,58,34,24
050,30,039,"Montana","Granite County",3,69,65,31,34
050,30,039,"Montana","Granite County",3,70,67,32,35
050,30,039,"Montana","Granite County",3,71,53,29,24
050,30,039,"Montana","Granite County",3,72,48,25,23
050,30,039,"Montana","Granite County",3,73,50,28,22
050,30,039,"Montana","Granite County",3,74,58,36,22
050,30,039,"Montana","Granite County",3,75,45,28,17
050,30,039,"Montana","Granite County",3,76,38,20,18
050,30,039,"Montana","Granite County",3,77,33,16,17
050,30,039,"Montana","Granite County",3,78,41,21,20
050,30,039,"Montana","Granite County",3,79,37,19,18
050,30,039,"Montana","Granite County",3,80,35,18,17
050,30,039,"Montana","Granite County",3,81,28,16,12
050,30,039,"Montana","Granite County",3,82,25,15,10
050,30,039,"Montana","Granite County",3,83,24,13,11
050,30,039,"Montana","Granite County",3,84,20,10,10
050,30,039,"Montana","Granite County",3,85,89,38,51
050,30,039,"Montana","Granite County",4,0,32,18,14
050,30,039,"Montana","Granite County",4,1,25,13,12
050,30,039,"Montana","Granite County",4,2,18,10,8
050,30,039,"Montana","Granite County",4,3,18,12,6
050,30,039,"Montana","Granite County",4,4,26,12,14
050,30,039,"Montana","Granite County",4,5,19,9,10
050,30,039,"Montana","Granite County",4,6,29,12,17
050,30,039,"Montana","Granite County",4,7,33,13,20
050,30,039,"Montana","Granite County",4,8,34,11,23
050,30,039,"Montana","Granite County",4,9,27,16,11
050,30,039,"Montana","Granite County",4,10,30,15,15
050,30,039,"Montana","Granite County",4,11,27,9,18
050,30,039,"Montana","Granite County",4,12,28,9,19
050,30,039,"Montana","Granite County",4,13,31,17,14
050,30,039,"Montana","Granite County",4,14,30,17,13
050,30,039,"Montana","Granite County",4,15,30,18,12
050,30,039,"Montana","Granite County",4,16,34,18,16
050,30,039,"Montana","Granite County",4,17,39,18,21
050,30,039,"Montana","Granite County",4,18,25,14,11
050,30,039,"Montana","Granite County",4,19,23,15,8
050,30,039,"Montana","Granite County",4,20,22,11,11
050,30,039,"Montana","Granite County",4,21,28,11,17
050,30,039,"Montana","Granite County",4,22,17,5,12
050,30,039,"Montana","Granite County",4,23,29,15,14
050,30,039,"Montana","Granite County",4,24,33,22,11
050,30,039,"Montana","Granite County",4,25,42,23,19
050,30,039,"Montana","Granite County",4,26,36,20,16
050,30,039,"Montana","Granite County",4,27,29,17,12
050,30,039,"Montana","Granite County",4,28,33,16,17
050,30,039,"Montana","Granite County",4,29,22,13,9
050,30,039,"Montana","Granite County",4,30,44,24,20
050,30,039,"Montana","Granite County",4,31,43,18,25
050,30,039,"Montana","Granite County",4,32,43,25,18
050,30,039,"Montana","Granite County",4,33,28,14,14
050,30,039,"Montana","Granite County",4,34,29,15,14
050,30,039,"Montana","Granite County",4,35,30,18,12
050,30,039,"Montana","Granite County",4,36,33,16,17
050,30,039,"Montana","Granite County",4,37,26,13,13
050,30,039,"Montana","Granite County",4,38,34,18,16
050,30,039,"Montana","Granite County",4,39,33,21,12
050,30,039,"Montana","Granite County",4,40,39,26,13
050,30,039,"Montana","Granite County",4,41,44,18,26
050,30,039,"Montana","Granite County",4,42,44,17,27
050,30,039,"Montana","Granite County",4,43,34,17,17
050,30,039,"Montana","Granite County",4,44,39,17,22
050,30,039,"Montana","Granite County",4,45,43,22,21
050,30,039,"Montana","Granite County",4,46,39,25,14
050,30,039,"Montana","Granite County",4,47,41,23,18
050,30,039,"Montana","Granite County",4,48,39,25,14
050,30,039,"Montana","Granite County",4,49,41,20,21
050,30,039,"Montana","Granite County",4,50,37,20,17
050,30,039,"Montana","Granite County",4,51,42,24,18
050,30,039,"Montana","Granite County",4,52,33,16,17
050,30,039,"Montana","Granite County",4,53,45,20,25
050,30,039,"Montana","Granite County",4,54,36,16,20
050,30,039,"Montana","Granite County",4,55,36,17,19
050,30,039,"Montana","Granite County",4,56,40,19,21
050,30,039,"Montana","Granite County",4,57,57,35,22
050,30,039,"Montana","Granite County",4,58,60,30,30
050,30,039,"Montana","Granite County",4,59,64,37,27
050,30,039,"Montana","Granite County",4,60,73,41,32
050,30,039,"Montana","Granite County",4,61,74,33,41
050,30,039,"Montana","Granite County",4,62,87,43,44
050,30,039,"Montana","Granite County",4,63,61,29,32
050,30,039,"Montana","Granite County",4,64,70,35,35
050,30,039,"Montana","Granite County",4,65,70,36,34
050,30,039,"Montana","Granite County",4,66,72,33,39
050,30,039,"Montana","Granite County",4,67,77,41,36
050,30,039,"Montana","Granite County",4,68,72,46,26
050,30,039,"Montana","Granite County",4,69,59,34,25
050,30,039,"Montana","Granite County",4,70,64,33,31
050,30,039,"Montana","Granite County",4,71,62,28,34
050,30,039,"Montana","Granite County",4,72,52,27,25
050,30,039,"Montana","Granite County",4,73,48,26,22
050,30,039,"Montana","Granite County",4,74,49,27,22
050,30,039,"Montana","Granite County",4,75,58,35,23
050,30,039,"Montana","Granite County",4,76,45,27,18
050,30,039,"Montana","Granite County",4,77,38,20,18
050,30,039,"Montana","Granite County",4,78,30,16,14
050,30,039,"Montana","Granite County",4,79,43,21,22
050,30,039,"Montana","Granite County",4,80,36,20,16
050,30,039,"Montana","Granite County",4,81,32,15,17
050,30,039,"Montana","Granite County",4,82,30,16,14
050,30,039,"Montana","Granite County",4,83,26,15,11
050,30,039,"Montana","Granite County",4,84,24,13,11
050,30,039,"Montana","Granite County",4,85,100,45,55
050,30,039,"Montana","Granite County",5,0,31,17,14
050,30,039,"Montana","Granite County",5,1,32,20,12
050,30,039,"Montana","Granite County",5,2,28,15,13
050,30,039,"Montana","Granite County",5,3,22,12,10
050,30,039,"Montana","Granite County",5,4,24,16,8
050,30,039,"Montana","Granite County",5,5,26,12,14
050,30,039,"Montana","Granite County",5,6,26,16,10
050,30,039,"Montana","Granite County",5,7,33,14,19
050,30,039,"Montana","Granite County",5,8,37,15,22
050,30,039,"Montana","Granite County",5,9,34,11,23
050,30,039,"Montana","Granite County",5,10,34,17,17
050,30,039,"Montana","Granite County",5,11,35,17,18
050,30,039,"Montana","Granite County",5,12,25,8,17
050,30,039,"Montana","Granite County",5,13,34,13,21
050,30,039,"Montana","Granite County",5,14,31,16,15
050,30,039,"Montana","Granite County",5,15,30,17,13
050,30,039,"Montana","Granite County",5,16,32,20,12
050,30,039,"Montana","Granite County",5,17,34,18,16
050,30,039,"Montana","Granite County",5,18,35,16,19
050,30,039,"Montana","Granite County",5,19,22,12,10
050,30,039,"Montana","Granite County",5,20,28,18,10
050,30,039,"Montana","Granite County",5,21,27,14,13
050,30,039,"Montana","Granite County",5,22,28,12,16
050,30,039,"Montana","Granite County",5,23,21,8,13
050,30,039,"Montana","Granite County",5,24,29,14,15
050,30,039,"Montana","Granite County",5,25,40,22,18
050,30,039,"Montana","Granite County",5,26,41,22,19
050,30,039,"Montana","Granite County",5,27,36,18,18
050,30,039,"Montana","Granite County",5,28,33,16,17
050,30,039,"Montana","Granite County",5,29,36,19,17
050,30,039,"Montana","Granite County",5,30,36,20,16
050,30,039,"Montana","Granite County",5,31,43,22,21
050,30,039,"Montana","Granite County",5,32,52,23,29
050,30,039,"Montana","Granite County",5,33,41,26,15
050,30,039,"Montana","Granite County",5,34,34,17,17
050,30,039,"Montana","Granite County",5,35,32,16,16
050,30,039,"Montana","Granite County",5,36,24,14,10
050,30,039,"Montana","Granite County",5,37,32,16,16
050,30,039,"Montana","Granite County",5,38,33,16,17
050,30,039,"Montana","Granite County",5,39,35,19,16
050,30,039,"Montana","Granite County",5,40,37,22,15
050,30,039,"Montana","Granite County",5,41,43,28,15
050,30,039,"Montana","Granite County",5,42,45,17,28
050,30,039,"Montana","Granite County",5,43,48,19,29
050,30,039,"Montana","Granite County",5,44,36,17,19
050,30,039,"Montana","Granite County",5,45,44,22,22
050,30,039,"Montana","Granite County",5,46,42,22,20
050,30,039,"Montana","Granite County",5,47,39,22,17
050,30,039,"Montana","Granite County",5,48,40,24,16
050,30,039,"Montana","Granite County",5,49,46,27,19
050,30,039,"Montana","Granite County",5,50,40,19,21
050,30,039,"Montana","Granite County",5,51,38,21,17
050,30,039,"Montana","Granite County",5,52,49,31,18
050,30,039,"Montana","Granite County",5,53,35,19,16
050,30,039,"Montana","Granite County",5,54,47,19,28
050,30,039,"Montana","Granite County",5,55,34,19,15
050,30,039,"Montana","Granite County",5,56,38,18,20
050,30,039,"Montana","Granite County",5,57,38,19,19
050,30,039,"Montana","Granite County",5,58,52,33,19
050,30,039,"Montana","Granite County",5,59,58,27,31
050,30,039,"Montana","Granite County",5,60,65,38,27
050,30,039,"Montana","Granite County",5,61,74,44,30
050,30,039,"Montana","Granite County",5,62,71,33,38
050,30,039,"Montana","Granite County",5,63,88,43,45
050,30,039,"Montana","Granite County",5,64,58,25,33
050,30,039,"Montana","Granite County",5,65,66,33,33
050,30,039,"Montana","Granite County",5,66,76,38,38
050,30,039,"Montana","Granite County",5,67,67,28,39
050,30,039,"Montana","Granite County",5,68,70,39,31
050,30,039,"Montana","Granite County",5,69,65,44,21
050,30,039,"Montana","Granite County",5,70,56,32,24
050,30,039,"Montana","Granite County",5,71,62,31,31
050,30,039,"Montana","Granite County",5,72,61,28,33
050,30,039,"Montana","Granite County",5,73,51,27,24
050,30,039,"Montana","Granite County",5,74,45,24,21
050,30,039,"Montana","Granite County",5,75,48,27,21
050,30,039,"Montana","Granite County",5,76,53,32,21
050,30,039,"Montana","Granite County",5,77,44,26,18
050,30,039,"Montana","Granite County",5,78,34,18,16
050,30,039,"Montana","Granite County",5,79,30,15,15
050,30,039,"Montana","Granite County",5,80,42,23,19
050,30,039,"Montana","Granite County",5,81,34,18,16
050,30,039,"Montana","Granite County",5,82,32,15,17
050,30,039,"Montana","Granite County",5,83,27,14,13
050,30,039,"Montana","Granite County",5,84,26,14,12
050,30,039,"Montana","Granite County",5,85,115,51,64
050,30,041,"Montana","Hill County",1,0,283,147,136
050,30,041,"Montana","Hill County",1,1,302,158,144
050,30,041,"Montana","Hill County",1,2,287,143,144
050,30,041,"Montana","Hill County",1,3,264,123,141
050,30,041,"Montana","Hill County",1,4,285,126,159
050,30,041,"Montana","Hill County",1,5,297,139,158
050,30,041,"Montana","Hill County",1,6,255,133,122
050,30,041,"Montana","Hill County",1,7,273,142,131
050,30,041,"Montana","Hill County",1,8,264,126,138
050,30,041,"Montana","Hill County",1,9,221,118,103
050,30,041,"Montana","Hill County",1,10,228,115,113
050,30,041,"Montana","Hill County",1,11,239,134,105
050,30,041,"Montana","Hill County",1,12,231,120,111
050,30,041,"Montana","Hill County",1,13,235,122,113
050,30,041,"Montana","Hill County",1,14,264,144,120
050,30,041,"Montana","Hill County",1,15,228,125,103
050,30,041,"Montana","Hill County",1,16,232,120,112
050,30,041,"Montana","Hill County",1,17,226,114,112
050,30,041,"Montana","Hill County",1,18,225,109,116
050,30,041,"Montana","Hill County",1,19,277,160,117
050,30,041,"Montana","Hill County",1,20,238,131,107
050,30,041,"Montana","Hill County",1,21,192,103,89
050,30,041,"Montana","Hill County",1,22,199,98,101
050,30,041,"Montana","Hill County",1,23,199,99,100
050,30,041,"Montana","Hill County",1,24,215,121,94
050,30,041,"Montana","Hill County",1,25,196,98,98
050,30,041,"Montana","Hill County",1,26,203,104,99
050,30,041,"Montana","Hill County",1,27,213,98,115
050,30,041,"Montana","Hill County",1,28,223,104,119
050,30,041,"Montana","Hill County",1,29,223,123,100
050,30,041,"Montana","Hill County",1,30,236,141,95
050,30,041,"Montana","Hill County",1,31,237,132,105
050,30,041,"Montana","Hill County",1,32,203,100,103
050,30,041,"Montana","Hill County",1,33,197,102,95
050,30,041,"Montana","Hill County",1,34,205,102,103
050,30,041,"Montana","Hill County",1,35,183,89,94
050,30,041,"Montana","Hill County",1,36,210,112,98
050,30,041,"Montana","Hill County",1,37,212,107,105
050,30,041,"Montana","Hill County",1,38,190,108,82
050,30,041,"Montana","Hill County",1,39,201,102,99
050,30,041,"Montana","Hill County",1,40,186,95,91
050,30,041,"Montana","Hill County",1,41,187,96,91
050,30,041,"Montana","Hill County",1,42,169,83,86
050,30,041,"Montana","Hill County",1,43,186,88,98
050,30,041,"Montana","Hill County",1,44,179,81,98
050,30,041,"Montana","Hill County",1,45,171,86,85
050,30,041,"Montana","Hill County",1,46,146,79,67
050,30,041,"Montana","Hill County",1,47,156,83,73
050,30,041,"Montana","Hill County",1,48,174,89,85
050,30,041,"Montana","Hill County",1,49,155,80,75
050,30,041,"Montana","Hill County",1,50,174,89,85
050,30,041,"Montana","Hill County",1,51,156,79,77
050,30,041,"Montana","Hill County",1,52,149,76,73
050,30,041,"Montana","Hill County",1,53,159,83,76
050,30,041,"Montana","Hill County",1,54,156,82,74
050,30,041,"Montana","Hill County",1,55,164,76,88
050,30,041,"Montana","Hill County",1,56,186,97,89
050,30,041,"Montana","Hill County",1,57,185,100,85
050,30,041,"Montana","Hill County",1,58,223,123,100
050,30,041,"Montana","Hill County",1,59,214,112,102
050,30,041,"Montana","Hill County",1,60,216,118,98
050,30,041,"Montana","Hill County",1,61,213,104,109
050,30,041,"Montana","Hill County",1,62,231,107,124
050,30,041,"Montana","Hill County",1,63,213,97,116
050,30,041,"Montana","Hill County",1,64,200,99,101
050,30,041,"Montana","Hill County",1,65,192,96,96
050,30,041,"Montana","Hill County",1,66,171,87,84
050,30,041,"Montana","Hill County",1,67,172,91,81
050,30,041,"Montana","Hill County",1,68,170,88,82
050,30,041,"Montana","Hill County",1,69,160,84,76
050,30,041,"Montana","Hill County",1,70,161,89,72
050,30,041,"Montana","Hill County",1,71,141,80,61
050,30,041,"Montana","Hill County",1,72,131,79,52
050,30,041,"Montana","Hill County",1,73,122,67,55
050,30,041,"Montana","Hill County",1,74,92,43,49
050,30,041,"Montana","Hill County",1,75,89,32,57
050,30,041,"Montana","Hill County",1,76,88,37,51
050,30,041,"Montana","Hill County",1,77,80,39,41
050,30,041,"Montana","Hill County",1,78,55,29,26
050,30,041,"Montana","Hill County",1,79,65,29,36
050,30,041,"Montana","Hill County",1,80,64,28,36
050,30,041,"Montana","Hill County",1,81,69,29,40
050,30,041,"Montana","Hill County",1,82,55,26,29
050,30,041,"Montana","Hill County",1,83,53,23,30
050,30,041,"Montana","Hill County",1,84,51,23,28
050,30,041,"Montana","Hill County",1,85,291,112,179
050,30,041,"Montana","Hill County",2,0,272,142,130
050,30,041,"Montana","Hill County",2,1,300,158,142
050,30,041,"Montana","Hill County",2,2,284,142,142
050,30,041,"Montana","Hill County",2,3,264,125,139
050,30,041,"Montana","Hill County",2,4,276,123,153
050,30,041,"Montana","Hill County",2,5,291,134,157
050,30,041,"Montana","Hill County",2,6,265,134,131
050,30,041,"Montana","Hill County",2,7,270,140,130
050,30,041,"Montana","Hill County",2,8,262,128,134
050,30,041,"Montana","Hill County",2,9,234,121,113
050,30,041,"Montana","Hill County",2,10,224,115,109
050,30,041,"Montana","Hill County",2,11,241,133,108
050,30,041,"Montana","Hill County",2,12,229,122,107
050,30,041,"Montana","Hill County",2,13,234,122,112
050,30,041,"Montana","Hill County",2,14,258,139,119
050,30,041,"Montana","Hill County",2,15,237,129,108
050,30,041,"Montana","Hill County",2,16,235,124,111
050,30,041,"Montana","Hill County",2,17,227,115,112
050,30,041,"Montana","Hill County",2,18,223,108,115
050,30,041,"Montana","Hill County",2,19,277,158,119
050,30,041,"Montana","Hill County",2,20,232,128,104
050,30,041,"Montana","Hill County",2,21,197,105,92
050,30,041,"Montana","Hill County",2,22,194,94,100
050,30,041,"Montana","Hill County",2,23,195,98,97
050,30,041,"Montana","Hill County",2,24,208,115,93
050,30,041,"Montana","Hill County",2,25,200,103,97
050,30,041,"Montana","Hill County",2,26,200,102,98
050,30,041,"Montana","Hill County",2,27,208,96,112
050,30,041,"Montana","Hill County",2,28,221,102,119
050,30,041,"Montana","Hill County",2,29,222,119,103
050,30,041,"Montana","Hill County",2,30,228,132,96
050,30,041,"Montana","Hill County",2,31,232,131,101
050,30,041,"Montana","Hill County",2,32,209,108,101
050,30,041,"Montana","Hill County",2,33,197,101,96
050,30,041,"Montana","Hill County",2,34,200,100,100
050,30,041,"Montana","Hill County",2,35,186,90,96
050,30,041,"Montana","Hill County",2,36,203,106,97
050,30,041,"Montana","Hill County",2,37,214,109,105
050,30,041,"Montana","Hill County",2,38,193,106,87
050,30,041,"Montana","Hill County",2,39,198,103,95
050,30,041,"Montana","Hill County",2,40,189,96,93
050,30,041,"Montana","Hill County",2,41,189,95,94
050,30,041,"Montana","Hill County",2,42,171,85,86
050,30,041,"Montana","Hill County",2,43,185,87,98
050,30,041,"Montana","Hill County",2,44,178,82,96
050,30,041,"Montana","Hill County",2,45,178,89,89
050,30,041,"Montana","Hill County",2,46,150,78,72
050,30,041,"Montana","Hill County",2,47,155,81,74
050,30,041,"Montana","Hill County",2,48,169,88,81
050,30,041,"Montana","Hill County",2,49,161,83,78
050,30,041,"Montana","Hill County",2,50,170,87,83
050,30,041,"Montana","Hill County",2,51,157,79,78
050,30,041,"Montana","Hill County",2,52,150,76,74
050,30,041,"Montana","Hill County",2,53,157,81,76
050,30,041,"Montana","Hill County",2,54,155,83,72
050,30,041,"Montana","Hill County",2,55,163,78,85
050,30,041,"Montana","Hill County",2,56,187,94,93
050,30,041,"Montana","Hill County",2,57,181,98,83
050,30,041,"Montana","Hill County",2,58,214,117,97
050,30,041,"Montana","Hill County",2,59,218,115,103
050,30,041,"Montana","Hill County",2,60,214,115,99
050,30,041,"Montana","Hill County",2,61,211,106,105
050,30,041,"Montana","Hill County",2,62,223,103,120
050,30,041,"Montana","Hill County",2,63,220,101,119
050,30,041,"Montana","Hill County",2,64,199,96,103
050,30,041,"Montana","Hill County",2,65,195,97,98
050,30,041,"Montana","Hill County",2,66,174,88,86
050,30,041,"Montana","Hill County",2,67,172,90,82
050,30,041,"Montana","Hill County",2,68,170,89,81
050,30,041,"Montana","Hill County",2,69,163,85,78
050,30,041,"Montana","Hill County",2,70,158,87,71
050,30,041,"Montana","Hill County",2,71,145,82,63
050,30,041,"Montana","Hill County",2,72,128,75,53
050,30,041,"Montana","Hill County",2,73,130,75,55
050,30,041,"Montana","Hill County",2,74,91,45,46
050,30,041,"Montana","Hill County",2,75,86,33,53
050,30,041,"Montana","Hill County",2,76,87,36,51
050,30,041,"Montana","Hill County",2,77,83,39,44
050,30,041,"Montana","Hill County",2,78,57,30,27
050,30,041,"Montana","Hill County",2,79,63,28,35
050,30,041,"Montana","Hill County",2,80,64,28,36
050,30,041,"Montana","Hill County",2,81,67,28,39
050,30,041,"Montana","Hill County",2,82,61,28,33
050,30,041,"Montana","Hill County",2,83,53,24,29
050,30,041,"Montana","Hill County",2,84,51,22,29
050,30,041,"Montana","Hill County",2,85,289,111,178
050,30,041,"Montana","Hill County",3,0,246,121,125
050,30,041,"Montana","Hill County",3,1,286,148,138
050,30,041,"Montana","Hill County",3,2,276,148,128
050,30,041,"Montana","Hill County",3,3,279,142,137
050,30,041,"Montana","Hill County",3,4,257,125,132
050,30,041,"Montana","Hill County",3,5,267,120,147
050,30,041,"Montana","Hill County",3,6,272,128,144
050,30,041,"Montana","Hill County",3,7,275,139,136
050,30,041,"Montana","Hill County",3,8,257,133,124
050,30,041,"Montana","Hill County",3,9,261,123,138
050,30,041,"Montana","Hill County",3,10,234,121,113
050,30,041,"Montana","Hill County",3,11,235,125,110
050,30,041,"Montana","Hill County",3,12,221,125,96
050,30,041,"Montana","Hill County",3,13,234,125,109
050,30,041,"Montana","Hill County",3,14,229,115,114
050,30,041,"Montana","Hill County",3,15,244,126,118
050,30,041,"Montana","Hill County",3,16,247,136,111
050,30,041,"Montana","Hill County",3,17,216,110,106
050,30,041,"Montana","Hill County",3,18,227,115,112
050,30,041,"Montana","Hill County",3,19,281,168,113
050,30,041,"Montana","Hill County",3,20,225,121,104
050,30,041,"Montana","Hill County",3,21,214,109,105
050,30,041,"Montana","Hill County",3,22,201,101,100
050,30,041,"Montana","Hill County",3,23,198,97,101
050,30,041,"Montana","Hill County",3,24,206,109,97
050,30,041,"Montana","Hill County",3,25,208,125,83
050,30,041,"Montana","Hill County",3,26,194,98,96
050,30,041,"Montana","Hill County",3,27,200,101,99
050,30,041,"Montana","Hill County",3,28,204,93,111
050,30,041,"Montana","Hill County",3,29,230,115,115
050,30,041,"Montana","Hill County",3,30,221,117,104
050,30,041,"Montana","Hill County",3,31,229,132,97
050,30,041,"Montana","Hill County",3,32,217,120,97
050,30,041,"Montana","Hill County",3,33,204,106,98
050,30,041,"Montana","Hill County",3,34,187,96,91
050,30,041,"Montana","Hill County",3,35,195,96,99
050,30,041,"Montana","Hill County",3,36,190,95,95
050,30,041,"Montana","Hill County",3,37,208,105,103
050,30,041,"Montana","Hill County",3,38,216,109,107
050,30,041,"Montana","Hill County",3,39,206,114,92
050,30,041,"Montana","Hill County",3,40,195,105,90
050,30,041,"Montana","Hill County",3,41,196,96,100
050,30,041,"Montana","Hill County",3,42,188,99,89
050,30,041,"Montana","Hill County",3,43,177,88,89
050,30,041,"Montana","Hill County",3,44,175,83,92
050,30,041,"Montana","Hill County",3,45,171,82,89
050,30,041,"Montana","Hill County",3,46,166,75,91
050,30,041,"Montana","Hill County",3,47,144,76,68
050,30,041,"Montana","Hill County",3,48,164,95,69
050,30,041,"Montana","Hill County",3,49,166,89,77
050,30,041,"Montana","Hill County",3,50,163,81,82
050,30,041,"Montana","Hill County",3,51,167,84,83
050,30,041,"Montana","Hill County",3,52,159,72,87
050,30,041,"Montana","Hill County",3,53,141,73,68
050,30,041,"Montana","Hill County",3,54,151,80,71
050,30,041,"Montana","Hill County",3,55,154,81,73
050,30,041,"Montana","Hill County",3,56,170,80,90
050,30,041,"Montana","Hill County",3,57,171,89,82
050,30,041,"Montana","Hill County",3,58,185,102,83
050,30,041,"Montana","Hill County",3,59,213,115,98
050,30,041,"Montana","Hill County",3,60,207,110,97
050,30,041,"Montana","Hill County",3,61,210,111,99
050,30,041,"Montana","Hill County",3,62,216,108,108
050,30,041,"Montana","Hill County",3,63,222,103,119
050,30,041,"Montana","Hill County",3,64,213,94,119
050,30,041,"Montana","Hill County",3,65,194,93,101
050,30,041,"Montana","Hill County",3,66,191,101,90
050,30,041,"Montana","Hill County",3,67,171,87,84
050,30,041,"Montana","Hill County",3,68,160,84,76
050,30,041,"Montana","Hill County",3,69,173,88,85
050,30,041,"Montana","Hill County",3,70,160,83,77
050,30,041,"Montana","Hill County",3,71,146,84,62
050,30,041,"Montana","Hill County",3,72,148,79,69
050,30,041,"Montana","Hill County",3,73,122,71,51
050,30,041,"Montana","Hill County",3,74,115,69,46
050,30,041,"Montana","Hill County",3,75,86,41,45
050,30,041,"Montana","Hill County",3,76,76,27,49
050,30,041,"Montana","Hill County",3,77,92,38,54
050,30,041,"Montana","Hill County",3,78,75,35,40
050,30,041,"Montana","Hill County",3,79,60,30,30
050,30,041,"Montana","Hill County",3,80,64,30,34
050,30,041,"Montana","Hill County",3,81,59,23,36
050,30,041,"Montana","Hill County",3,82,62,25,37
050,30,041,"Montana","Hill County",3,83,48,23,25
050,30,041,"Montana","Hill County",3,84,47,18,29
050,30,041,"Montana","Hill County",3,85,290,116,174
050,30,041,"Montana","Hill County",4,0,244,112,132
050,30,041,"Montana","Hill County",4,1,240,123,117
050,30,041,"Montana","Hill County",4,2,279,142,137
050,30,041,"Montana","Hill County",4,3,267,143,124
050,30,041,"Montana","Hill County",4,4,281,143,138
050,30,041,"Montana","Hill County",4,5,260,130,130
050,30,041,"Montana","Hill County",4,6,263,119,144
050,30,041,"Montana","Hill County",4,7,281,132,149
050,30,041,"Montana","Hill County",4,8,256,122,134
050,30,041,"Montana","Hill County",4,9,263,132,131
050,30,041,"Montana","Hill County",4,10,252,119,133
050,30,041,"Montana","Hill County",4,11,254,136,118
050,30,041,"Montana","Hill County",4,12,219,114,105
050,30,041,"Montana","Hill County",4,13,220,118,102
050,30,041,"Montana","Hill County",4,14,235,121,114
050,30,041,"Montana","Hill County",4,15,216,108,108
050,30,041,"Montana","Hill County",4,16,255,132,123
050,30,041,"Montana","Hill County",4,17,238,129,109
050,30,041,"Montana","Hill County",4,18,221,118,103
050,30,041,"Montana","Hill County",4,19,267,160,107
050,30,041,"Montana","Hill County",4,20,213,114,99
050,30,041,"Montana","Hill County",4,21,198,96,102
050,30,041,"Montana","Hill County",4,22,214,108,106
050,30,041,"Montana","Hill County",4,23,192,98,94
050,30,041,"Montana","Hill County",4,24,197,102,95
050,30,041,"Montana","Hill County",4,25,202,103,99
050,30,041,"Montana","Hill County",4,26,190,114,76
050,30,041,"Montana","Hill County",4,27,209,105,104
050,30,041,"Montana","Hill County",4,28,190,90,100
050,30,041,"Montana","Hill County",4,29,209,97,112
050,30,041,"Montana","Hill County",4,30,222,111,111
050,30,041,"Montana","Hill County",4,31,245,137,108
050,30,041,"Montana","Hill County",4,32,220,127,93
050,30,041,"Montana","Hill County",4,33,228,122,106
050,30,041,"Montana","Hill County",4,34,198,101,97
050,30,041,"Montana","Hill County",4,35,193,97,96
050,30,041,"Montana","Hill County",4,36,194,98,96
050,30,041,"Montana","Hill County",4,37,190,95,95
050,30,041,"Montana","Hill County",4,38,200,97,103
050,30,041,"Montana","Hill County",4,39,214,108,106
050,30,041,"Montana","Hill County",4,40,201,111,90
050,30,041,"Montana","Hill County",4,41,197,103,94
050,30,041,"Montana","Hill County",4,42,187,96,91
050,30,041,"Montana","Hill County",4,43,198,97,101
050,30,041,"Montana","Hill County",4,44,166,81,85
050,30,041,"Montana","Hill County",4,45,176,89,87
050,30,041,"Montana","Hill County",4,46,159,71,88
050,30,041,"Montana","Hill County",4,47,168,75,93
050,30,041,"Montana","Hill County",4,48,149,82,67
050,30,041,"Montana","Hill County",4,49,157,94,63
050,30,041,"Montana","Hill County",4,50,170,89,81
050,30,041,"Montana","Hill County",4,51,157,78,79
050,30,041,"Montana","Hill County",4,52,169,81,88
050,30,041,"Montana","Hill County",4,53,149,70,79
050,30,041,"Montana","Hill County",4,54,138,75,63
050,30,041,"Montana","Hill County",4,55,148,75,73
050,30,041,"Montana","Hill County",4,56,165,82,83
050,30,041,"Montana","Hill County",4,57,149,72,77
050,30,041,"Montana","Hill County",4,58,176,97,79
050,30,041,"Montana","Hill County",4,59,181,98,83
050,30,041,"Montana","Hill County",4,60,201,105,96
050,30,041,"Montana","Hill County",4,61,195,101,94
050,30,041,"Montana","Hill County",4,62,208,106,102
050,30,041,"Montana","Hill County",4,63,207,103,104
050,30,041,"Montana","Hill County",4,64,204,89,115
050,30,041,"Montana","Hill County",4,65,208,94,114
050,30,041,"Montana","Hill County",4,66,186,92,94
050,30,041,"Montana","Hill County",4,67,187,95,92
050,30,041,"Montana","Hill County",4,68,163,82,81
050,30,041,"Montana","Hill County",4,69,163,84,79
050,30,041,"Montana","Hill County",4,70,166,86,80
050,30,041,"Montana","Hill County",4,71,151,85,66
050,30,041,"Montana","Hill County",4,72,149,83,66
050,30,041,"Montana","Hill County",4,73,141,76,65
050,30,041,"Montana","Hill County",4,74,110,68,42
050,30,041,"Montana","Hill County",4,75,107,60,47
050,30,041,"Montana","Hill County",4,76,81,40,41
050,30,041,"Montana","Hill County",4,77,80,27,53
050,30,041,"Montana","Hill County",4,78,83,36,47
050,30,041,"Montana","Hill County",4,79,81,37,44
050,30,041,"Montana","Hill County",4,80,64,34,30
050,30,041,"Montana","Hill County",4,81,55,25,30
050,30,041,"Montana","Hill County",4,82,62,24,38
050,30,041,"Montana","Hill County",4,83,49,20,29
050,30,041,"Montana","Hill County",4,84,41,15,26
050,30,041,"Montana","Hill County",4,85,287,116,171
050,30,041,"Montana","Hill County",5,0,244,112,132
050,30,041,"Montana","Hill County",5,1,251,109,142
050,30,041,"Montana","Hill County",5,2,230,115,115
050,30,041,"Montana","Hill County",5,3,275,142,133
050,30,041,"Montana","Hill County",5,4,275,148,127
050,30,041,"Montana","Hill County",5,5,272,134,138
050,30,041,"Montana","Hill County",5,6,266,130,136
050,30,041,"Montana","Hill County",5,7,278,126,152
050,30,041,"Montana","Hill County",5,8,278,124,154
050,30,041,"Montana","Hill County",5,9,262,131,131
050,30,041,"Montana","Hill County",5,10,270,133,137
050,30,041,"Montana","Hill County",5,11,274,132,142
050,30,041,"Montana","Hill County",5,12,241,125,116
050,30,041,"Montana","Hill County",5,13,225,113,112
050,30,041,"Montana","Hill County",5,14,223,124,99
050,30,041,"Montana","Hill County",5,15,232,121,111
050,30,041,"Montana","Hill County",5,16,227,116,111
050,30,041,"Montana","Hill County",5,17,248,126,122
050,30,041,"Montana","Hill County",5,18,242,131,111
050,30,041,"Montana","Hill County",5,19,277,168,109
050,30,041,"Montana","Hill County",5,20,223,126,97
050,30,041,"Montana","Hill County",5,21,205,101,104
050,30,041,"Montana","Hill County",5,22,203,93,110
050,30,041,"Montana","Hill County",5,23,221,113,108
050,30,041,"Montana","Hill County",5,24,186,99,87
050,30,041,"Montana","Hill County",5,25,200,106,94
050,30,041,"Montana","Hill County",5,26,207,103,104
050,30,041,"Montana","Hill County",5,27,196,117,79
050,30,041,"Montana","Hill County",5,28,203,96,107
050,30,041,"Montana","Hill County",5,29,196,95,101
050,30,041,"Montana","Hill County",5,30,211,101,110
050,30,041,"Montana","Hill County",5,31,210,103,107
050,30,041,"Montana","Hill County",5,32,230,125,105
050,30,041,"Montana","Hill County",5,33,222,127,95
050,30,041,"Montana","Hill County",5,34,223,119,104
050,30,041,"Montana","Hill County",5,35,201,105,96
050,30,041,"Montana","Hill County",5,36,195,98,97
050,30,041,"Montana","Hill County",5,37,199,99,100
050,30,041,"Montana","Hill County",5,38,183,94,89
050,30,041,"Montana","Hill County",5,39,212,109,103
050,30,041,"Montana","Hill County",5,40,216,109,107
050,30,041,"Montana","Hill County",5,41,209,115,94
050,30,041,"Montana","Hill County",5,42,189,102,87
050,30,041,"Montana","Hill County",5,43,193,97,96
050,30,041,"Montana","Hill County",5,44,189,90,99
050,30,041,"Montana","Hill County",5,45,170,90,80
050,30,041,"Montana","Hill County",5,46,174,84,90
050,30,041,"Montana","Hill County",5,47,165,75,90
050,30,041,"Montana","Hill County",5,48,169,80,89
050,30,041,"Montana","Hill County",5,49,140,80,60
050,30,041,"Montana","Hill County",5,50,160,95,65
050,30,041,"Montana","Hill County",5,51,169,82,87
050,30,041,"Montana","Hill County",5,52,157,72,85
050,30,041,"Montana","Hill County",5,53,165,79,86
050,30,041,"Montana","Hill County",5,54,143,70,73
050,30,041,"Montana","Hill County",5,55,136,70,66
050,30,041,"Montana","Hill County",5,56,157,76,81
050,30,041,"Montana","Hill County",5,57,149,75,74
050,30,041,"Montana","Hill County",5,58,154,78,76
050,30,041,"Montana","Hill County",5,59,174,95,79
050,30,041,"Montana","Hill County",5,60,175,93,82
050,30,041,"Montana","Hill County",5,61,197,102,95
050,30,041,"Montana","Hill County",5,62,190,99,91
050,30,041,"Montana","Hill County",5,63,209,110,99
050,30,041,"Montana","Hill County",5,64,202,98,104
050,30,041,"Montana","Hill County",5,65,200,84,116
050,30,041,"Montana","Hill County",5,66,204,98,106
050,30,041,"Montana","Hill County",5,67,186,89,97
050,30,041,"Montana","Hill County",5,68,179,90,89
050,30,041,"Montana","Hill County",5,69,168,83,85
050,30,041,"Montana","Hill County",5,70,164,83,81
050,30,041,"Montana","Hill County",5,71,157,85,72
050,30,041,"Montana","Hill County",5,72,150,79,71
050,30,041,"Montana","Hill County",5,73,142,80,62
050,30,041,"Montana","Hill County",5,74,136,75,61
050,30,041,"Montana","Hill County",5,75,103,61,42
050,30,041,"Montana","Hill County",5,76,98,55,43
050,30,041,"Montana","Hill County",5,77,85,40,45
050,30,041,"Montana","Hill County",5,78,74,23,51
050,30,041,"Montana","Hill County",5,79,88,38,50
050,30,041,"Montana","Hill County",5,80,85,40,45
050,30,041,"Montana","Hill County",5,81,59,28,31
050,30,041,"Montana","Hill County",5,82,53,27,26
050,30,041,"Montana","Hill County",5,83,49,20,29
050,30,041,"Montana","Hill County",5,84,43,15,28
050,30,041,"Montana","Hill County",5,85,286,118,168
050,30,043,"Montana","Jefferson County",1,0,82,41,41
050,30,043,"Montana","Jefferson County",1,1,93,42,51
050,30,043,"Montana","Jefferson County",1,2,111,58,53
050,30,043,"Montana","Jefferson County",1,3,129,68,61
050,30,043,"Montana","Jefferson County",1,4,111,53,58
050,30,043,"Montana","Jefferson County",1,5,110,42,68
050,30,043,"Montana","Jefferson County",1,6,119,59,60
050,30,043,"Montana","Jefferson County",1,7,118,67,51
050,30,043,"Montana","Jefferson County",1,8,129,69,60
050,30,043,"Montana","Jefferson County",1,9,141,67,74
050,30,043,"Montana","Jefferson County",1,10,154,78,76
050,30,043,"Montana","Jefferson County",1,11,173,88,85
050,30,043,"Montana","Jefferson County",1,12,151,82,69
050,30,043,"Montana","Jefferson County",1,13,179,92,87
050,30,043,"Montana","Jefferson County",1,14,163,80,83
050,30,043,"Montana","Jefferson County",1,15,159,81,78
050,30,043,"Montana","Jefferson County",1,16,157,78,79
050,30,043,"Montana","Jefferson County",1,17,178,90,88
050,30,043,"Montana","Jefferson County",1,18,136,68,68
050,30,043,"Montana","Jefferson County",1,19,89,47,42
050,30,043,"Montana","Jefferson County",1,20,92,57,35
050,30,043,"Montana","Jefferson County",1,21,108,58,50
050,30,043,"Montana","Jefferson County",1,22,106,60,46
050,30,043,"Montana","Jefferson County",1,23,98,57,41
050,30,043,"Montana","Jefferson County",1,24,98,56,42
050,30,043,"Montana","Jefferson County",1,25,90,47,43
050,30,043,"Montana","Jefferson County",1,26,90,45,45
050,30,043,"Montana","Jefferson County",1,27,102,48,54
050,30,043,"Montana","Jefferson County",1,28,99,52,47
050,30,043,"Montana","Jefferson County",1,29,108,54,54
050,30,043,"Montana","Jefferson County",1,30,117,50,67
050,30,043,"Montana","Jefferson County",1,31,102,49,53
050,30,043,"Montana","Jefferson County",1,32,117,63,54
050,30,043,"Montana","Jefferson County",1,33,127,66,61
050,30,043,"Montana","Jefferson County",1,34,125,63,62
050,30,043,"Montana","Jefferson County",1,35,115,61,54
050,30,043,"Montana","Jefferson County",1,36,101,54,47
050,30,043,"Montana","Jefferson County",1,37,134,66,68
050,30,043,"Montana","Jefferson County",1,38,166,84,82
050,30,043,"Montana","Jefferson County",1,39,164,75,89
050,30,043,"Montana","Jefferson County",1,40,164,84,80
050,30,043,"Montana","Jefferson County",1,41,141,73,68
050,30,043,"Montana","Jefferson County",1,42,140,74,66
050,30,043,"Montana","Jefferson County",1,43,134,64,70
050,30,043,"Montana","Jefferson County",1,44,146,78,68
050,30,043,"Montana","Jefferson County",1,45,132,66,66
050,30,043,"Montana","Jefferson County",1,46,149,78,71
050,30,043,"Montana","Jefferson County",1,47,150,80,70
050,30,043,"Montana","Jefferson County",1,48,162,90,72
050,30,043,"Montana","Jefferson County",1,49,177,101,76
050,30,043,"Montana","Jefferson County",1,50,170,84,86
050,30,043,"Montana","Jefferson County",1,51,171,90,81
050,30,043,"Montana","Jefferson County",1,52,151,73,78
050,30,043,"Montana","Jefferson County",1,53,170,85,85
050,30,043,"Montana","Jefferson County",1,54,179,87,92
050,30,043,"Montana","Jefferson County",1,55,170,81,89
050,30,043,"Montana","Jefferson County",1,56,207,103,104
050,30,043,"Montana","Jefferson County",1,57,195,100,95
050,30,043,"Montana","Jefferson County",1,58,201,106,95
050,30,043,"Montana","Jefferson County",1,59,202,96,106
050,30,043,"Montana","Jefferson County",1,60,210,93,117
050,30,043,"Montana","Jefferson County",1,61,215,109,106
050,30,043,"Montana","Jefferson County",1,62,220,124,96
050,30,043,"Montana","Jefferson County",1,63,223,105,118
050,30,043,"Montana","Jefferson County",1,64,228,106,122
050,30,043,"Montana","Jefferson County",1,65,237,111,126
050,30,043,"Montana","Jefferson County",1,66,238,109,129
050,30,043,"Montana","Jefferson County",1,67,208,105,103
050,30,043,"Montana","Jefferson County",1,68,218,116,102
050,30,043,"Montana","Jefferson County",1,69,211,114,97
050,30,043,"Montana","Jefferson County",1,70,169,89,80
050,30,043,"Montana","Jefferson County",1,71,181,103,78
050,30,043,"Montana","Jefferson County",1,72,184,100,84
050,30,043,"Montana","Jefferson County",1,73,151,83,68
050,30,043,"Montana","Jefferson County",1,74,121,59,62
050,30,043,"Montana","Jefferson County",1,75,101,54,47
050,30,043,"Montana","Jefferson County",1,76,98,53,45
050,30,043,"Montana","Jefferson County",1,77,98,51,47
050,30,043,"Montana","Jefferson County",1,78,77,44,33
050,30,043,"Montana","Jefferson County",1,79,66,43,23
050,30,043,"Montana","Jefferson County",1,80,65,36,29
050,30,043,"Montana","Jefferson County",1,81,55,22,33
050,30,043,"Montana","Jefferson County",1,82,44,22,22
050,30,043,"Montana","Jefferson County",1,83,37,23,14
050,30,043,"Montana","Jefferson County",1,84,23,15,8
050,30,043,"Montana","Jefferson County",1,85,152,69,83
050,30,043,"Montana","Jefferson County",2,0,96,52,44
050,30,043,"Montana","Jefferson County",2,1,92,42,50
050,30,043,"Montana","Jefferson County",2,2,109,56,53
050,30,043,"Montana","Jefferson County",2,3,127,67,60
050,30,043,"Montana","Jefferson County",2,4,116,56,60
050,30,043,"Montana","Jefferson County",2,5,113,46,67
050,30,043,"Montana","Jefferson County",2,6,120,56,64
050,30,043,"Montana","Jefferson County",2,7,117,64,53
050,30,043,"Montana","Jefferson County",2,8,126,67,59
050,30,043,"Montana","Jefferson County",2,9,139,68,71
050,30,043,"Montana","Jefferson County",2,10,154,76,78
050,30,043,"Montana","Jefferson County",2,11,169,85,84
050,30,043,"Montana","Jefferson County",2,12,160,84,76
050,30,043,"Montana","Jefferson County",2,13,171,88,83
050,30,043,"Montana","Jefferson County",2,14,168,84,84
050,30,043,"Montana","Jefferson County",2,15,162,81,81
050,30,043,"Montana","Jefferson County",2,16,161,80,81
050,30,043,"Montana","Jefferson County",2,17,175,87,88
050,30,043,"Montana","Jefferson County",2,18,134,69,65
050,30,043,"Montana","Jefferson County",2,19,91,48,43
050,30,043,"Montana","Jefferson County",2,20,92,55,37
050,30,043,"Montana","Jefferson County",2,21,108,59,49
050,30,043,"Montana","Jefferson County",2,22,105,60,45
050,30,043,"Montana","Jefferson County",2,23,100,58,42
050,30,043,"Montana","Jefferson County",2,24,95,55,40
050,30,043,"Montana","Jefferson County",2,25,91,48,43
050,30,043,"Montana","Jefferson County",2,26,90,44,46
050,30,043,"Montana","Jefferson County",2,27,102,49,53
050,30,043,"Montana","Jefferson County",2,28,101,51,50
050,30,043,"Montana","Jefferson County",2,29,109,54,55
050,30,043,"Montana","Jefferson County",2,30,118,52,66
050,30,043,"Montana","Jefferson County",2,31,108,53,55
050,30,043,"Montana","Jefferson County",2,32,115,59,56
050,30,043,"Montana","Jefferson County",2,33,128,68,60
050,30,043,"Montana","Jefferson County",2,34,127,63,64
050,30,043,"Montana","Jefferson County",2,35,120,63,57
050,30,043,"Montana","Jefferson County",2,36,104,55,49
050,30,043,"Montana","Jefferson County",2,37,129,65,64
050,30,043,"Montana","Jefferson County",2,38,158,79,79
050,30,043,"Montana","Jefferson County",2,39,166,78,88
050,30,043,"Montana","Jefferson County",2,40,167,84,83
050,30,043,"Montana","Jefferson County",2,41,150,76,74
050,30,043,"Montana","Jefferson County",2,42,140,74,66
050,30,043,"Montana","Jefferson County",2,43,138,68,70
050,30,043,"Montana","Jefferson County",2,44,144,76,68
050,30,043,"Montana","Jefferson County",2,45,137,70,67
050,30,043,"Montana","Jefferson County",2,46,146,76,70
050,30,043,"Montana","Jefferson County",2,47,148,79,69
050,30,043,"Montana","Jefferson County",2,48,160,88,72
050,30,043,"Montana","Jefferson County",2,49,174,100,74
050,30,043,"Montana","Jefferson County",2,50,176,90,86
050,30,043,"Montana","Jefferson County",2,51,170,89,81
050,30,043,"Montana","Jefferson County",2,52,156,77,79
050,30,043,"Montana","Jefferson County",2,53,167,83,84
050,30,043,"Montana","Jefferson County",2,54,177,87,90
050,30,043,"Montana","Jefferson County",2,55,172,82,90
050,30,043,"Montana","Jefferson County",2,56,199,98,101
050,30,043,"Montana","Jefferson County",2,57,198,101,97
050,30,043,"Montana","Jefferson County",2,58,200,105,95
050,30,043,"Montana","Jefferson County",2,59,201,97,104
050,30,043,"Montana","Jefferson County",2,60,211,95,116
050,30,043,"Montana","Jefferson County",2,61,212,104,108
050,30,043,"Montana","Jefferson County",2,62,219,121,98
050,30,043,"Montana","Jefferson County",2,63,224,110,114
050,30,043,"Montana","Jefferson County",2,64,226,106,120
050,30,043,"Montana","Jefferson County",2,65,240,113,127
050,30,043,"Montana","Jefferson County",2,66,238,110,128
050,30,043,"Montana","Jefferson County",2,67,212,106,106
050,30,043,"Montana","Jefferson County",2,68,213,112,101
050,30,043,"Montana","Jefferson County",2,69,215,116,99
050,30,043,"Montana","Jefferson County",2,70,177,94,83
050,30,043,"Montana","Jefferson County",2,71,176,98,78
050,30,043,"Montana","Jefferson County",2,72,176,96,80
050,30,043,"Montana","Jefferson County",2,73,168,92,76
050,30,043,"Montana","Jefferson County",2,74,119,61,58
050,30,043,"Montana","Jefferson County",2,75,106,55,51
050,30,043,"Montana","Jefferson County",2,76,96,52,44
050,30,043,"Montana","Jefferson County",2,77,100,53,47
050,30,043,"Montana","Jefferson County",2,78,77,42,35
050,30,043,"Montana","Jefferson County",2,79,67,41,26
050,30,043,"Montana","Jefferson County",2,80,66,38,28
050,30,043,"Montana","Jefferson County",2,81,57,25,32
050,30,043,"Montana","Jefferson County",2,82,44,21,23
050,30,043,"Montana","Jefferson County",2,83,38,23,15
050,30,043,"Montana","Jefferson County",2,84,26,16,10
050,30,043,"Montana","Jefferson County",2,85,153,69,84
050,30,043,"Montana","Jefferson County",3,0,97,57,40
050,30,043,"Montana","Jefferson County",3,1,102,58,44
050,30,043,"Montana","Jefferson County",3,2,104,53,51
050,30,043,"Montana","Jefferson County",3,3,103,54,49
050,30,043,"Montana","Jefferson County",3,4,123,62,61
050,30,043,"Montana","Jefferson County",3,5,135,69,66
050,30,043,"Montana","Jefferson County",3,6,126,51,75
050,30,043,"Montana","Jefferson County",3,7,119,56,63
050,30,043,"Montana","Jefferson County",3,8,125,66,59
050,30,043,"Montana","Jefferson County",3,9,134,74,60
050,30,043,"Montana","Jefferson County",3,10,152,72,80
050,30,043,"Montana","Jefferson County",3,11,152,81,71
050,30,043,"Montana","Jefferson County",3,12,175,86,89
050,30,043,"Montana","Jefferson County",3,13,161,88,73
050,30,043,"Montana","Jefferson County",3,14,163,84,79
050,30,043,"Montana","Jefferson County",3,15,179,88,91
050,30,043,"Montana","Jefferson County",3,16,165,81,84
050,30,043,"Montana","Jefferson County",3,17,163,80,83
050,30,043,"Montana","Jefferson County",3,18,135,75,60
050,30,043,"Montana","Jefferson County",3,19,99,51,48
050,30,043,"Montana","Jefferson County",3,20,101,50,51
050,30,043,"Montana","Jefferson County",3,21,103,59,44
050,30,043,"Montana","Jefferson County",3,22,116,67,49
050,30,043,"Montana","Jefferson County",3,23,105,62,43
050,30,043,"Montana","Jefferson County",3,24,101,51,50
050,30,043,"Montana","Jefferson County",3,25,98,53,45
050,30,043,"Montana","Jefferson County",3,26,103,50,53
050,30,043,"Montana","Jefferson County",3,27,106,53,53
050,30,043,"Montana","Jefferson County",3,28,103,50,53
050,30,043,"Montana","Jefferson County",3,29,118,57,61
050,30,043,"Montana","Jefferson County",3,30,129,69,60
050,30,043,"Montana","Jefferson County",3,31,131,64,67
050,30,043,"Montana","Jefferson County",3,32,124,65,59
050,30,043,"Montana","Jefferson County",3,33,121,64,57
050,30,043,"Montana","Jefferson County",3,34,148,86,62
050,30,043,"Montana","Jefferson County",3,35,144,74,70
050,30,043,"Montana","Jefferson County",3,36,134,68,66
050,30,043,"Montana","Jefferson County",3,37,115,60,55
050,30,043,"Montana","Jefferson County",3,38,136,67,69
050,30,043,"Montana","Jefferson County",3,39,170,85,85
050,30,043,"Montana","Jefferson County",3,40,171,86,85
050,30,043,"Montana","Jefferson County",3,41,171,77,94
050,30,043,"Montana","Jefferson County",3,42,152,84,68
050,30,043,"Montana","Jefferson County",3,43,140,67,73
050,30,043,"Montana","Jefferson County",3,44,142,72,70
050,30,043,"Montana","Jefferson County",3,45,139,70,69
050,30,043,"Montana","Jefferson County",3,46,151,82,69
050,30,043,"Montana","Jefferson County",3,47,155,74,81
050,30,043,"Montana","Jefferson County",3,48,152,83,69
050,30,043,"Montana","Jefferson County",3,49,166,96,70
050,30,043,"Montana","Jefferson County",3,50,182,96,86
050,30,043,"Montana","Jefferson County",3,51,175,83,92
050,30,043,"Montana","Jefferson County",3,52,178,90,88
050,30,043,"Montana","Jefferson County",3,53,160,76,84
050,30,043,"Montana","Jefferson County",3,54,167,88,79
050,30,043,"Montana","Jefferson County",3,55,182,92,90
050,30,043,"Montana","Jefferson County",3,56,174,81,93
050,30,043,"Montana","Jefferson County",3,57,219,109,110
050,30,043,"Montana","Jefferson County",3,58,200,98,102
050,30,043,"Montana","Jefferson County",3,59,215,111,104
050,30,043,"Montana","Jefferson County",3,60,209,102,107
050,30,043,"Montana","Jefferson County",3,61,204,91,113
050,30,043,"Montana","Jefferson County",3,62,214,105,109
050,30,043,"Montana","Jefferson County",3,63,225,121,104
050,30,043,"Montana","Jefferson County",3,64,223,115,108
050,30,043,"Montana","Jefferson County",3,65,221,105,116
050,30,043,"Montana","Jefferson County",3,66,241,110,131
050,30,043,"Montana","Jefferson County",3,67,241,111,130
050,30,043,"Montana","Jefferson County",3,68,207,99,108
050,30,043,"Montana","Jefferson County",3,69,217,117,100
050,30,043,"Montana","Jefferson County",3,70,209,111,98
050,30,043,"Montana","Jefferson County",3,71,181,96,85
050,30,043,"Montana","Jefferson County",3,72,157,84,73
050,30,043,"Montana","Jefferson County",3,73,172,94,78
050,30,043,"Montana","Jefferson County",3,74,162,92,70
050,30,043,"Montana","Jefferson County",3,75,116,58,58
050,30,043,"Montana","Jefferson County",3,76,101,52,49
050,30,043,"Montana","Jefferson County",3,77,89,47,42
050,30,043,"Montana","Jefferson County",3,78,98,51,47
050,30,043,"Montana","Jefferson County",3,79,69,39,30
050,30,043,"Montana","Jefferson County",3,80,65,38,27
050,30,043,"Montana","Jefferson County",3,81,58,31,27
050,30,043,"Montana","Jefferson County",3,82,53,23,30
050,30,043,"Montana","Jefferson County",3,83,43,23,20
050,30,043,"Montana","Jefferson County",3,84,32,18,14
050,30,043,"Montana","Jefferson County",3,85,152,70,82
050,30,043,"Montana","Jefferson County",4,0,107,53,54
050,30,043,"Montana","Jefferson County",4,1,115,62,53
050,30,043,"Montana","Jefferson County",4,2,104,57,47
050,30,043,"Montana","Jefferson County",4,3,116,58,58
050,30,043,"Montana","Jefferson County",4,4,118,61,57
050,30,043,"Montana","Jefferson County",4,5,150,71,79
050,30,043,"Montana","Jefferson County",4,6,153,74,79
050,30,043,"Montana","Jefferson County",4,7,135,54,81
050,30,043,"Montana","Jefferson County",4,8,136,66,70
050,30,043,"Montana","Jefferson County",4,9,144,80,64
050,30,043,"Montana","Jefferson County",4,10,140,73,67
050,30,043,"Montana","Jefferson County",4,11,163,82,81
050,30,043,"Montana","Jefferson County",4,12,173,89,84
050,30,043,"Montana","Jefferson County",4,13,168,83,85
050,30,043,"Montana","Jefferson County",4,14,157,81,76
050,30,043,"Montana","Jefferson County",4,15,165,86,79
050,30,043,"Montana","Jefferson County",4,16,189,93,96
050,30,043,"Montana","Jefferson County",4,17,160,79,81
050,30,043,"Montana","Jefferson County",4,18,130,67,63
050,30,043,"Montana","Jefferson County",4,19,103,58,45
050,30,043,"Montana","Jefferson County",4,20,99,49,50
050,30,043,"Montana","Jefferson County",4,21,100,52,48
050,30,043,"Montana","Jefferson County",4,22,107,59,48
050,30,043,"Montana","Jefferson County",4,23,126,71,55
050,30,043,"Montana","Jefferson County",4,24,115,73,42
050,30,043,"Montana","Jefferson County",4,25,99,49,50
050,30,043,"Montana","Jefferson County",4,26,111,58,53
050,30,043,"Montana","Jefferson County",4,27,125,57,68
050,30,043,"Montana","Jefferson County",4,28,114,51,63
050,30,043,"Montana","Jefferson County",4,29,109,50,59
050,30,043,"Montana","Jefferson County",4,30,131,66,65
050,30,043,"Montana","Jefferson County",4,31,137,72,65
050,30,043,"Montana","Jefferson County",4,32,148,72,76
050,30,043,"Montana","Jefferson County",4,33,143,79,64
050,30,043,"Montana","Jefferson County",4,34,129,65,64
050,30,043,"Montana","Jefferson County",4,35,158,86,72
050,30,043,"Montana","Jefferson County",4,36,154,82,72
050,30,043,"Montana","Jefferson County",4,37,146,77,69
050,30,043,"Montana","Jefferson County",4,38,126,72,54
050,30,043,"Montana","Jefferson County",4,39,147,74,73
050,30,043,"Montana","Jefferson County",4,40,174,87,87
050,30,043,"Montana","Jefferson County",4,41,182,86,96
050,30,043,"Montana","Jefferson County",4,42,180,84,96
050,30,043,"Montana","Jefferson County",4,43,161,85,76
050,30,043,"Montana","Jefferson County",4,44,146,74,72
050,30,043,"Montana","Jefferson County",4,45,141,73,68
050,30,043,"Montana","Jefferson County",4,46,145,77,68
050,30,043,"Montana","Jefferson County",4,47,154,84,70
050,30,043,"Montana","Jefferson County",4,48,152,69,83
050,30,043,"Montana","Jefferson County",4,49,155,85,70
050,30,043,"Montana","Jefferson County",4,50,169,96,73
050,30,043,"Montana","Jefferson County",4,51,184,97,87
050,30,043,"Montana","Jefferson County",4,52,186,89,97
050,30,043,"Montana","Jefferson County",4,53,176,88,88
050,30,043,"Montana","Jefferson County",4,54,163,76,87
050,30,043,"Montana","Jefferson County",4,55,167,85,82
050,30,043,"Montana","Jefferson County",4,56,189,95,94
050,30,043,"Montana","Jefferson County",4,57,179,85,94
050,30,043,"Montana","Jefferson County",4,58,219,112,107
050,30,043,"Montana","Jefferson County",4,59,193,94,99
050,30,043,"Montana","Jefferson County",4,60,226,122,104
050,30,043,"Montana","Jefferson County",4,61,206,98,108
050,30,043,"Montana","Jefferson County",4,62,203,90,113
050,30,043,"Montana","Jefferson County",4,63,219,102,117
050,30,043,"Montana","Jefferson County",4,64,224,120,104
050,30,043,"Montana","Jefferson County",4,65,226,116,110
050,30,043,"Montana","Jefferson County",4,66,213,100,113
050,30,043,"Montana","Jefferson County",4,67,234,108,126
050,30,043,"Montana","Jefferson County",4,68,239,109,130
050,30,043,"Montana","Jefferson County",4,69,202,98,104
050,30,043,"Montana","Jefferson County",4,70,216,116,100
050,30,043,"Montana","Jefferson County",4,71,216,113,103
050,30,043,"Montana","Jefferson County",4,72,167,85,82
050,30,043,"Montana","Jefferson County",4,73,157,84,73
050,30,043,"Montana","Jefferson County",4,74,171,92,79
050,30,043,"Montana","Jefferson County",4,75,152,85,67
050,30,043,"Montana","Jefferson County",4,76,103,55,48
050,30,043,"Montana","Jefferson County",4,77,98,47,51
050,30,043,"Montana","Jefferson County",4,78,87,46,41
050,30,043,"Montana","Jefferson County",4,79,90,47,43
050,30,043,"Montana","Jefferson County",4,80,65,37,28
050,30,043,"Montana","Jefferson County",4,81,55,30,25
050,30,043,"Montana","Jefferson County",4,82,48,26,22
050,30,043,"Montana","Jefferson County",4,83,48,22,26
050,30,043,"Montana","Jefferson County",4,84,37,21,16
050,30,043,"Montana","Jefferson County",4,85,164,74,90
050,30,043,"Montana","Jefferson County",5,0,107,53,54
050,30,043,"Montana","Jefferson County",5,1,105,57,48
050,30,043,"Montana","Jefferson County",5,2,130,69,61
050,30,043,"Montana","Jefferson County",5,3,105,58,47
050,30,043,"Montana","Jefferson County",5,4,120,59,61
050,30,043,"Montana","Jefferson County",5,5,131,68,63
050,30,043,"Montana","Jefferson County",5,6,149,69,80
050,30,043,"Montana","Jefferson County",5,7,150,71,79
050,30,043,"Montana","Jefferson County",5,8,129,48,81
050,30,043,"Montana","Jefferson County",5,9,150,72,78
050,30,043,"Montana","Jefferson County",5,10,147,87,60
050,30,043,"Montana","Jefferson County",5,11,141,71,70
050,30,043,"Montana","Jefferson County",5,12,172,88,84
050,30,043,"Montana","Jefferson County",5,13,174,93,81
050,30,043,"Montana","Jefferson County",5,14,172,84,88
050,30,043,"Montana","Jefferson County",5,15,166,84,82
050,30,043,"Montana","Jefferson County",5,16,173,89,84
050,30,043,"Montana","Jefferson County",5,17,191,98,93
050,30,043,"Montana","Jefferson County",5,18,132,74,58
050,30,043,"Montana","Jefferson County",5,19,105,51,54
050,30,043,"Montana","Jefferson County",5,20,101,55,46
050,30,043,"Montana","Jefferson County",5,21,108,52,56
050,30,043,"Montana","Jefferson County",5,22,116,60,56
050,30,043,"Montana","Jefferson County",5,23,108,59,49
050,30,043,"Montana","Jefferson County",5,24,137,74,63
050,30,043,"Montana","Jefferson County",5,25,105,69,36
050,30,043,"Montana","Jefferson County",5,26,90,47,43
050,30,043,"Montana","Jefferson County",5,27,124,67,57
050,30,043,"Montana","Jefferson County",5,28,137,64,73
050,30,043,"Montana","Jefferson County",5,29,123,56,67
050,30,043,"Montana","Jefferson County",5,30,107,46,61
050,30,043,"Montana","Jefferson County",5,31,135,72,63
050,30,043,"Montana","Jefferson County",5,32,145,75,70
050,30,043,"Montana","Jefferson County",5,33,155,79,76
050,30,043,"Montana","Jefferson County",5,34,141,75,66
050,30,043,"Montana","Jefferson County",5,35,135,70,65
050,30,043,"Montana","Jefferson County",5,36,160,83,77
050,30,043,"Montana","Jefferson County",5,37,159,86,73
050,30,043,"Montana","Jefferson County",5,38,156,88,68
050,30,043,"Montana","Jefferson County",5,39,135,78,57
050,30,043,"Montana","Jefferson County",5,40,157,77,80
050,30,043,"Montana","Jefferson County",5,41,185,87,98
050,30,043,"Montana","Jefferson County",5,42,183,86,97
050,30,043,"Montana","Jefferson County",5,43,207,91,116
050,30,043,"Montana","Jefferson County",5,44,172,93,79
050,30,043,"Montana","Jefferson County",5,45,148,78,70
050,30,043,"Montana","Jefferson County",5,46,144,78,66
050,30,043,"Montana","Jefferson County",5,47,150,77,73
050,30,043,"Montana","Jefferson County",5,48,158,82,76
050,30,043,"Montana","Jefferson County",5,49,164,76,88
050,30,043,"Montana","Jefferson County",5,50,161,85,76
050,30,043,"Montana","Jefferson County",5,51,162,92,70
050,30,043,"Montana","Jefferson County",5,52,189,97,92
050,30,043,"Montana","Jefferson County",5,53,198,91,107
050,30,043,"Montana","Jefferson County",5,54,176,91,85
050,30,043,"Montana","Jefferson County",5,55,164,82,82
050,30,043,"Montana","Jefferson County",5,56,165,84,81
050,30,043,"Montana","Jefferson County",5,57,196,98,98
050,30,043,"Montana","Jefferson County",5,58,178,84,94
050,30,043,"Montana","Jefferson County",5,59,220,114,106
050,30,043,"Montana","Jefferson County",5,60,201,96,105
050,30,043,"Montana","Jefferson County",5,61,226,120,106
050,30,043,"Montana","Jefferson County",5,62,202,93,109
050,30,043,"Montana","Jefferson County",5,63,201,89,112
050,30,043,"Montana","Jefferson County",5,64,218,103,115
050,30,043,"Montana","Jefferson County",5,65,225,120,105
050,30,043,"Montana","Jefferson County",5,66,215,107,108
050,30,043,"Montana","Jefferson County",5,67,210,102,108
050,30,043,"Montana","Jefferson County",5,68,232,105,127
050,30,043,"Montana","Jefferson County",5,69,234,107,127
050,30,043,"Montana","Jefferson County",5,70,202,98,104
050,30,043,"Montana","Jefferson County",5,71,218,114,104
050,30,043,"Montana","Jefferson County",5,72,207,109,98
050,30,043,"Montana","Jefferson County",5,73,160,83,77
050,30,043,"Montana","Jefferson County",5,74,150,78,72
050,30,043,"Montana","Jefferson County",5,75,167,86,81
050,30,043,"Montana","Jefferson County",5,76,141,82,59
050,30,043,"Montana","Jefferson County",5,77,103,53,50
050,30,043,"Montana","Jefferson County",5,78,93,47,46
050,30,043,"Montana","Jefferson County",5,79,88,42,46
050,30,043,"Montana","Jefferson County",5,80,81,41,40
050,30,043,"Montana","Jefferson County",5,81,58,33,25
050,30,043,"Montana","Jefferson County",5,82,48,27,21
050,30,043,"Montana","Jefferson County",5,83,46,26,20
050,30,043,"Montana","Jefferson County",5,84,40,19,21
050,30,043,"Montana","Jefferson County",5,85,179,82,97
050,30,045,"Montana","Judith Basin County",1,0,21,11,10
050,30,045,"Montana","Judith Basin County",1,1,18,12,6
050,30,045,"Montana","Judith Basin County",1,2,24,12,12
050,30,045,"Montana","Judith Basin County",1,3,25,12,13
050,30,045,"Montana","Judith Basin County",1,4,28,14,14
050,30,045,"Montana","Judith Basin County",1,5,17,9,8
050,30,045,"Montana","Judith Basin County",1,6,17,10,7
050,30,045,"Montana","Judith Basin County",1,7,24,13,11
050,30,045,"Montana","Judith Basin County",1,8,26,13,13
050,30,045,"Montana","Judith Basin County",1,9,23,10,13
050,30,045,"Montana","Judith Basin County",1,10,26,13,13
050,30,045,"Montana","Judith Basin County",1,11,29,17,12
050,30,045,"Montana","Judith Basin County",1,12,26,14,12
050,30,045,"Montana","Judith Basin County",1,13,21,13,8
050,30,045,"Montana","Judith Basin County",1,14,18,8,10
050,30,045,"Montana","Judith Basin County",1,15,22,12,10
050,30,045,"Montana","Judith Basin County",1,16,24,15,9
050,30,045,"Montana","Judith Basin County",1,17,33,16,17
050,30,045,"Montana","Judith Basin County",1,18,25,12,13
050,30,045,"Montana","Judith Basin County",1,19,17,7,10
050,30,045,"Montana","Judith Basin County",1,20,15,10,5
050,30,045,"Montana","Judith Basin County",1,21,14,10,4
050,30,045,"Montana","Judith Basin County",1,22,14,7,7
050,30,045,"Montana","Judith Basin County",1,23,14,8,6
050,30,045,"Montana","Judith Basin County",1,24,18,9,9
050,30,045,"Montana","Judith Basin County",1,25,18,8,10
050,30,045,"Montana","Judith Basin County",1,26,16,9,7
050,30,045,"Montana","Judith Basin County",1,27,22,12,10
050,30,045,"Montana","Judith Basin County",1,28,17,8,9
050,30,045,"Montana","Judith Basin County",1,29,19,10,9
050,30,045,"Montana","Judith Basin County",1,30,18,8,10
050,30,045,"Montana","Judith Basin County",1,31,22,11,11
050,30,045,"Montana","Judith Basin County",1,32,21,10,11
050,30,045,"Montana","Judith Basin County",1,33,18,8,10
050,30,045,"Montana","Judith Basin County",1,34,17,9,8
050,30,045,"Montana","Judith Basin County",1,35,15,8,7
050,30,045,"Montana","Judith Basin County",1,36,21,11,10
050,30,045,"Montana","Judith Basin County",1,37,26,10,16
050,30,045,"Montana","Judith Basin County",1,38,20,10,10
050,30,045,"Montana","Judith Basin County",1,39,23,10,13
050,30,045,"Montana","Judith Basin County",1,40,20,10,10
050,30,045,"Montana","Judith Basin County",1,41,17,6,11
050,30,045,"Montana","Judith Basin County",1,42,16,10,6
050,30,045,"Montana","Judith Basin County",1,43,18,9,9
050,30,045,"Montana","Judith Basin County",1,44,25,9,16
050,30,045,"Montana","Judith Basin County",1,45,21,12,9
050,30,045,"Montana","Judith Basin County",1,46,20,11,9
050,30,045,"Montana","Judith Basin County",1,47,16,8,8
050,30,045,"Montana","Judith Basin County",1,48,24,11,13
050,30,045,"Montana","Judith Basin County",1,49,22,13,9
050,30,045,"Montana","Judith Basin County",1,50,21,15,6
050,30,045,"Montana","Judith Basin County",1,51,22,15,7
050,30,045,"Montana","Judith Basin County",1,52,22,13,9
050,30,045,"Montana","Judith Basin County",1,53,20,9,11
050,30,045,"Montana","Judith Basin County",1,54,27,13,14
050,30,045,"Montana","Judith Basin County",1,55,35,19,16
050,30,045,"Montana","Judith Basin County",1,56,33,17,16
050,30,045,"Montana","Judith Basin County",1,57,33,13,20
050,30,045,"Montana","Judith Basin County",1,58,41,18,23
050,30,045,"Montana","Judith Basin County",1,59,43,23,20
050,30,045,"Montana","Judith Basin County",1,60,37,16,21
050,30,045,"Montana","Judith Basin County",1,61,34,19,15
050,30,045,"Montana","Judith Basin County",1,62,29,19,10
050,30,045,"Montana","Judith Basin County",1,63,30,19,11
050,30,045,"Montana","Judith Basin County",1,64,34,21,13
050,30,045,"Montana","Judith Basin County",1,65,37,18,19
050,30,045,"Montana","Judith Basin County",1,66,35,17,18
050,30,045,"Montana","Judith Basin County",1,67,41,21,20
050,30,045,"Montana","Judith Basin County",1,68,37,16,21
050,30,045,"Montana","Judith Basin County",1,69,34,16,18
050,30,045,"Montana","Judith Basin County",1,70,32,19,13
050,30,045,"Montana","Judith Basin County",1,71,25,14,11
050,30,045,"Montana","Judith Basin County",1,72,25,14,11
050,30,045,"Montana","Judith Basin County",1,73,29,19,10
050,30,045,"Montana","Judith Basin County",1,74,21,11,10
050,30,045,"Montana","Judith Basin County",1,75,18,9,9
050,30,045,"Montana","Judith Basin County",1,76,20,13,7
050,30,045,"Montana","Judith Basin County",1,77,22,12,10
050,30,045,"Montana","Judith Basin County",1,78,19,10,9
050,30,045,"Montana","Judith Basin County",1,79,11,5,6
050,30,045,"Montana","Judith Basin County",1,80,19,10,9
050,30,045,"Montana","Judith Basin County",1,81,20,7,13
050,30,045,"Montana","Judith Basin County",1,82,13,7,6
050,30,045,"Montana","Judith Basin County",1,83,10,5,5
050,30,045,"Montana","Judith Basin County",1,84,6,1,5
050,30,045,"Montana","Judith Basin County",1,85,50,22,28
050,30,045,"Montana","Judith Basin County",2,0,25,13,12
050,30,045,"Montana","Judith Basin County",2,1,19,12,7
050,30,045,"Montana","Judith Basin County",2,2,23,12,11
050,30,045,"Montana","Judith Basin County",2,3,25,13,12
050,30,045,"Montana","Judith Basin County",2,4,27,13,14
050,30,045,"Montana","Judith Basin County",2,5,19,10,9
050,30,045,"Montana","Judith Basin County",2,6,18,10,8
050,30,045,"Montana","Judith Basin County",2,7,23,12,11
050,30,045,"Montana","Judith Basin County",2,8,26,13,13
050,30,045,"Montana","Judith Basin County",2,9,23,10,13
050,30,045,"Montana","Judith Basin County",2,10,24,12,12
050,30,045,"Montana","Judith Basin County",2,11,27,16,11
050,30,045,"Montana","Judith Basin County",2,12,27,15,12
050,30,045,"Montana","Judith Basin County",2,13,22,13,9
050,30,045,"Montana","Judith Basin County",2,14,18,9,9
050,30,045,"Montana","Judith Basin County",2,15,21,11,10
050,30,045,"Montana","Judith Basin County",2,16,25,15,10
050,30,045,"Montana","Judith Basin County",2,17,31,16,15
050,30,045,"Montana","Judith Basin County",2,18,27,13,14
050,30,045,"Montana","Judith Basin County",2,19,18,8,10
050,30,045,"Montana","Judith Basin County",2,20,15,9,6
050,30,045,"Montana","Judith Basin County",2,21,13,9,4
050,30,045,"Montana","Judith Basin County",2,22,14,8,6
050,30,045,"Montana","Judith Basin County",2,23,15,8,7
050,30,045,"Montana","Judith Basin County",2,24,17,9,8
050,30,045,"Montana","Judith Basin County",2,25,18,8,10
050,30,045,"Montana","Judith Basin County",2,26,17,9,8
050,30,045,"Montana","Judith Basin County",2,27,21,12,9
050,30,045,"Montana","Judith Basin County",2,28,18,9,9
050,30,045,"Montana","Judith Basin County",2,29,18,9,9
050,30,045,"Montana","Judith Basin County",2,30,19,9,10
050,30,045,"Montana","Judith Basin County",2,31,22,11,11
050,30,045,"Montana","Judith Basin County",2,32,21,10,11
050,30,045,"Montana","Judith Basin County",2,33,18,8,10
050,30,045,"Montana","Judith Basin County",2,34,17,9,8
050,30,045,"Montana","Judith Basin County",2,35,15,8,7
050,30,045,"Montana","Judith Basin County",2,36,19,10,9
050,30,045,"Montana","Judith Basin County",2,37,24,10,14
050,30,045,"Montana","Judith Basin County",2,38,23,11,12
050,30,045,"Montana","Judith Basin County",2,39,22,10,12
050,30,045,"Montana","Judith Basin County",2,40,20,9,11
050,30,045,"Montana","Judith Basin County",2,41,17,7,10
050,30,045,"Montana","Judith Basin County",2,42,17,9,8
050,30,045,"Montana","Judith Basin County",2,43,18,9,9
050,30,045,"Montana","Judith Basin County",2,44,24,9,15
050,30,045,"Montana","Judith Basin County",2,45,21,11,10
050,30,045,"Montana","Judith Basin County",2,46,19,11,8
050,30,045,"Montana","Judith Basin County",2,47,17,9,8
050,30,045,"Montana","Judith Basin County",2,48,22,10,12
050,30,045,"Montana","Judith Basin County",2,49,23,13,10
050,30,045,"Montana","Judith Basin County",2,50,22,15,7
050,30,045,"Montana","Judith Basin County",2,51,22,15,7
050,30,045,"Montana","Judith Basin County",2,52,21,13,8
050,30,045,"Montana","Judith Basin County",2,53,20,10,10
050,30,045,"Montana","Judith Basin County",2,54,25,12,13
050,30,045,"Montana","Judith Basin County",2,55,32,17,15
050,30,045,"Montana","Judith Basin County",2,56,34,18,16
050,30,045,"Montana","Judith Basin County",2,57,33,14,19
050,30,045,"Montana","Judith Basin County",2,58,39,17,22
050,30,045,"Montana","Judith Basin County",2,59,42,21,21
050,30,045,"Montana","Judith Basin County",2,60,37,17,20
050,30,045,"Montana","Judith Basin County",2,61,36,19,17
050,30,045,"Montana","Judith Basin County",2,62,30,19,11
050,30,045,"Montana","Judith Basin County",2,63,30,19,11
050,30,045,"Montana","Judith Basin County",2,64,34,21,13
050,30,045,"Montana","Judith Basin County",2,65,35,18,17
050,30,045,"Montana","Judith Basin County",2,66,35,17,18
050,30,045,"Montana","Judith Basin County",2,67,40,20,20
050,30,045,"Montana","Judith Basin County",2,68,38,17,21
050,30,045,"Montana","Judith Basin County",2,69,36,17,19
050,30,045,"Montana","Judith Basin County",2,70,32,18,14
050,30,045,"Montana","Judith Basin County",2,71,28,16,12
050,30,045,"Montana","Judith Basin County",2,72,24,14,10
050,30,045,"Montana","Judith Basin County",2,73,29,19,10
050,30,045,"Montana","Judith Basin County",2,74,21,12,9
050,30,045,"Montana","Judith Basin County",2,75,19,10,9
050,30,045,"Montana","Judith Basin County",2,76,19,12,7
050,30,045,"Montana","Judith Basin County",2,77,22,12,10
050,30,045,"Montana","Judith Basin County",2,78,20,11,9
050,30,045,"Montana","Judith Basin County",2,79,12,6,6
050,30,045,"Montana","Judith Basin County",2,80,18,9,9
050,30,045,"Montana","Judith Basin County",2,81,19,7,12
050,30,045,"Montana","Judith Basin County",2,82,15,7,8
050,30,045,"Montana","Judith Basin County",2,83,11,6,5
050,30,045,"Montana","Judith Basin County",2,84,7,2,5
050,30,045,"Montana","Judith Basin County",2,85,51,22,29
050,30,045,"Montana","Judith Basin County",3,0,23,12,11
050,30,045,"Montana","Judith Basin County",3,1,24,13,11
050,30,045,"Montana","Judith Basin County",3,2,19,10,9
050,30,045,"Montana","Judith Basin County",3,3,21,10,11
050,30,045,"Montana","Judith Basin County",3,4,22,11,11
050,30,045,"Montana","Judith Basin County",3,5,26,12,14
050,30,045,"Montana","Judith Basin County",3,6,18,9,9
050,30,045,"Montana","Judith Basin County",3,7,18,9,9
050,30,045,"Montana","Judith Basin County",3,8,23,13,10
050,30,045,"Montana","Judith Basin County",3,9,29,14,15
050,30,045,"Montana","Judith Basin County",3,10,24,10,14
050,30,045,"Montana","Judith Basin County",3,11,25,12,13
050,30,045,"Montana","Judith Basin County",3,12,27,14,13
050,30,045,"Montana","Judith Basin County",3,13,25,13,12
050,30,045,"Montana","Judith Basin County",3,14,23,13,10
050,30,045,"Montana","Judith Basin County",3,15,17,7,10
050,30,045,"Montana","Judith Basin County",3,16,23,12,11
050,30,045,"Montana","Judith Basin County",3,17,27,16,11
050,30,045,"Montana","Judith Basin County",3,18,25,14,11
050,30,045,"Montana","Judith Basin County",3,19,20,9,11
050,30,045,"Montana","Judith Basin County",3,20,19,9,10
050,30,045,"Montana","Judith Basin County",3,21,16,8,8
050,30,045,"Montana","Judith Basin County",3,22,14,10,4
050,30,045,"Montana","Judith Basin County",3,23,10,6,4
050,30,045,"Montana","Judith Basin County",3,24,19,11,8
050,30,045,"Montana","Judith Basin County",3,25,13,7,6
050,30,045,"Montana","Judith Basin County",3,26,19,7,12
050,30,045,"Montana","Judith Basin County",3,27,18,10,8
050,30,045,"Montana","Judith Basin County",3,28,20,11,9
050,30,045,"Montana","Judith Basin County",3,29,20,12,8
050,30,045,"Montana","Judith Basin County",3,30,21,11,10
050,30,045,"Montana","Judith Basin County",3,31,18,10,8
050,30,045,"Montana","Judith Basin County",3,32,22,11,11
050,30,045,"Montana","Judith Basin County",3,33,20,10,10
050,30,045,"Montana","Judith Basin County",3,34,16,7,9
050,30,045,"Montana","Judith Basin County",3,35,19,11,8
050,30,045,"Montana","Judith Basin County",3,36,16,8,8
050,30,045,"Montana","Judith Basin County",3,37,20,8,12
050,30,045,"Montana","Judith Basin County",3,38,25,12,13
050,30,045,"Montana","Judith Basin County",3,39,22,10,12
050,30,045,"Montana","Judith Basin County",3,40,23,10,13
050,30,045,"Montana","Judith Basin County",3,41,24,13,11
050,30,045,"Montana","Judith Basin County",3,42,21,10,11
050,30,045,"Montana","Judith Basin County",3,43,18,9,9
050,30,045,"Montana","Judith Basin County",3,44,20,10,10
050,30,045,"Montana","Judith Basin County",3,45,23,7,16
050,30,045,"Montana","Judith Basin County",3,46,21,12,9
050,30,045,"Montana","Judith Basin County",3,47,18,10,8
050,30,045,"Montana","Judith Basin County",3,48,18,10,8
050,30,045,"Montana","Judith Basin County",3,49,21,11,10
050,30,045,"Montana","Judith Basin County",3,50,21,12,9
050,30,045,"Montana","Judith Basin County",3,51,20,12,8
050,30,045,"Montana","Judith Basin County",3,52,25,15,10
050,30,045,"Montana","Judith Basin County",3,53,18,12,6
050,30,045,"Montana","Judith Basin County",3,54,25,13,12
050,30,045,"Montana","Judith Basin County",3,55,29,14,15
050,30,045,"Montana","Judith Basin County",3,56,28,16,12
050,30,045,"Montana","Judith Basin County",3,57,35,20,15
050,30,045,"Montana","Judith Basin County",3,58,32,13,19
050,30,045,"Montana","Judith Basin County",3,59,37,16,21
050,30,045,"Montana","Judith Basin County",3,60,43,20,23
050,30,045,"Montana","Judith Basin County",3,61,43,20,23
050,30,045,"Montana","Judith Basin County",3,62,36,20,16
050,30,045,"Montana","Judith Basin County",3,63,32,19,13
050,30,045,"Montana","Judith Basin County",3,64,29,19,10
050,30,045,"Montana","Judith Basin County",3,65,36,22,14
050,30,045,"Montana","Judith Basin County",3,66,35,19,16
050,30,045,"Montana","Judith Basin County",3,67,35,17,18
050,30,045,"Montana","Judith Basin County",3,68,41,20,21
050,30,045,"Montana","Judith Basin County",3,69,39,18,21
050,30,045,"Montana","Judith Basin County",3,70,37,17,20
050,30,045,"Montana","Judith Basin County",3,71,30,16,14
050,30,045,"Montana","Judith Basin County",3,72,27,15,12
050,30,045,"Montana","Judith Basin County",3,73,23,13,10
050,30,045,"Montana","Judith Basin County",3,74,28,18,10
050,30,045,"Montana","Judith Basin County",3,75,20,12,8
050,30,045,"Montana","Judith Basin County",3,76,17,9,8
050,30,045,"Montana","Judith Basin County",3,77,19,12,7
050,30,045,"Montana","Judith Basin County",3,78,22,12,10
050,30,045,"Montana","Judith Basin County",3,79,20,10,10
050,30,045,"Montana","Judith Basin County",3,80,12,6,6
050,30,045,"Montana","Judith Basin County",3,81,17,9,8
050,30,045,"Montana","Judith Basin County",3,82,19,7,12
050,30,045,"Montana","Judith Basin County",3,83,15,7,8
050,30,045,"Montana","Judith Basin County",3,84,12,6,6
050,30,045,"Montana","Judith Basin County",3,85,48,17,31
050,30,045,"Montana","Judith Basin County",4,0,21,8,13
050,30,045,"Montana","Judith Basin County",4,1,19,11,8
050,30,045,"Montana","Judith Basin County",4,2,22,12,10
050,30,045,"Montana","Judith Basin County",4,3,21,11,10
050,30,045,"Montana","Judith Basin County",4,4,20,9,11
050,30,045,"Montana","Judith Basin County",4,5,23,11,12
050,30,045,"Montana","Judith Basin County",4,6,24,12,12
050,30,045,"Montana","Judith Basin County",4,7,19,8,11
050,30,045,"Montana","Judith Basin County",4,8,19,10,9
050,30,045,"Montana","Judith Basin County",4,9,22,13,9
050,30,045,"Montana","Judith Basin County",4,10,27,14,13
050,30,045,"Montana","Judith Basin County",4,11,26,10,16
050,30,045,"Montana","Judith Basin County",4,12,25,15,10
050,30,045,"Montana","Judith Basin County",4,13,27,14,13
050,30,045,"Montana","Judith Basin County",4,14,25,16,9
050,30,045,"Montana","Judith Basin County",4,15,21,12,9
050,30,045,"Montana","Judith Basin County",4,16,21,9,12
050,30,045,"Montana","Judith Basin County",4,17,27,14,13
050,30,045,"Montana","Judith Basin County",4,18,23,13,10
050,30,045,"Montana","Judith Basin County",4,19,18,11,7
050,30,045,"Montana","Judith Basin County",4,20,20,9,11
050,30,045,"Montana","Judith Basin County",4,21,20,8,12
050,30,045,"Montana","Judith Basin County",4,22,16,10,6
050,30,045,"Montana","Judith Basin County",4,23,20,12,8
050,30,045,"Montana","Judith Basin County",4,24,7,2,5
050,30,045,"Montana","Judith Basin County",4,25,15,9,6
050,30,045,"Montana","Judith Basin County",4,26,11,6,5
050,30,045,"Montana","Judith Basin County",4,27,20,8,12
050,30,045,"Montana","Judith Basin County",4,28,20,11,9
050,30,045,"Montana","Judith Basin County",4,29,20,11,9
050,30,045,"Montana","Judith Basin County",4,30,25,13,12
050,30,045,"Montana","Judith Basin County",4,31,26,13,13
050,30,045,"Montana","Judith Basin County",4,32,21,14,7
050,30,045,"Montana","Judith Basin County",4,33,19,9,10
050,30,045,"Montana","Judith Basin County",4,34,23,13,10
050,30,045,"Montana","Judith Basin County",4,35,17,8,9
050,30,045,"Montana","Judith Basin County",4,36,23,12,11
050,30,045,"Montana","Judith Basin County",4,37,16,8,8
050,30,045,"Montana","Judith Basin County",4,38,20,7,13
050,30,045,"Montana","Judith Basin County",4,39,26,12,14
050,30,045,"Montana","Judith Basin County",4,40,23,9,14
050,30,045,"Montana","Judith Basin County",4,41,29,16,13
050,30,045,"Montana","Judith Basin County",4,42,27,13,14
050,30,045,"Montana","Judith Basin County",4,43,19,10,9
050,30,045,"Montana","Judith Basin County",4,44,19,10,9
050,30,045,"Montana","Judith Basin County",4,45,19,9,10
050,30,045,"Montana","Judith Basin County",4,46,28,9,19
050,30,045,"Montana","Judith Basin County",4,47,27,16,11
050,30,045,"Montana","Judith Basin County",4,48,19,10,9
050,30,045,"Montana","Judith Basin County",4,49,18,10,8
050,30,045,"Montana","Judith Basin County",4,50,19,10,9
050,30,045,"Montana","Judith Basin County",4,51,25,14,11
050,30,045,"Montana","Judith Basin County",4,52,22,14,8
050,30,045,"Montana","Judith Basin County",4,53,20,14,6
050,30,045,"Montana","Judith Basin County",4,54,22,15,7
050,30,045,"Montana","Judith Basin County",4,55,28,13,15
050,30,045,"Montana","Judith Basin County",4,56,25,11,14
050,30,045,"Montana","Judith Basin County",4,57,31,17,14
050,30,045,"Montana","Judith Basin County",4,58,34,19,15
050,30,045,"Montana","Judith Basin County",4,59,32,13,19
050,30,045,"Montana","Judith Basin County",4,60,41,18,23
050,30,045,"Montana","Judith Basin County",4,61,42,21,21
050,30,045,"Montana","Judith Basin County",4,62,42,21,21
050,30,045,"Montana","Judith Basin County",4,63,36,20,16
050,30,045,"Montana","Judith Basin County",4,64,35,21,14
050,30,045,"Montana","Judith Basin County",4,65,31,21,10
050,30,045,"Montana","Judith Basin County",4,66,35,21,14
050,30,045,"Montana","Judith Basin County",4,67,36,20,16
050,30,045,"Montana","Judith Basin County",4,68,35,17,18
050,30,045,"Montana","Judith Basin County",4,69,40,20,20
050,30,045,"Montana","Judith Basin County",4,70,38,17,21
050,30,045,"Montana","Judith Basin County",4,71,34,16,18
050,30,045,"Montana","Judith Basin County",4,72,29,16,13
050,30,045,"Montana","Judith Basin County",4,73,26,14,12
050,30,045,"Montana","Judith Basin County",4,74,22,13,9
050,30,045,"Montana","Judith Basin County",4,75,27,17,10
050,30,045,"Montana","Judith Basin County",4,76,18,12,6
050,30,045,"Montana","Judith Basin County",4,77,18,9,9
050,30,045,"Montana","Judith Basin County",4,78,18,12,6
050,30,045,"Montana","Judith Basin County",4,79,19,10,9
050,30,045,"Montana","Judith Basin County",4,80,20,10,10
050,30,045,"Montana","Judith Basin County",4,81,13,7,6
050,30,045,"Montana","Judith Basin County",4,82,18,10,8
050,30,045,"Montana","Judith Basin County",4,83,20,7,13
050,30,045,"Montana","Judith Basin County",4,84,14,7,7
050,30,045,"Montana","Judith Basin County",4,85,51,18,33
050,30,045,"Montana","Judith Basin County",5,0,21,8,13
050,30,045,"Montana","Judith Basin County",5,1,22,8,14
050,30,045,"Montana","Judith Basin County",5,2,18,10,8
050,30,045,"Montana","Judith Basin County",5,3,24,13,11
050,30,045,"Montana","Judith Basin County",5,4,21,11,10
050,30,045,"Montana","Judith Basin County",5,5,17,9,8
050,30,045,"Montana","Judith Basin County",5,6,22,11,11
050,30,045,"Montana","Judith Basin County",5,7,22,9,13
050,30,045,"Montana","Judith Basin County",5,8,19,9,10
050,30,045,"Montana","Judith Basin County",5,9,16,6,10
050,30,045,"Montana","Judith Basin County",5,10,23,13,10
050,30,045,"Montana","Judith Basin County",5,11,26,13,13
050,30,045,"Montana","Judith Basin County",5,12,26,10,16
050,30,045,"Montana","Judith Basin County",5,13,25,15,10
050,30,045,"Montana","Judith Basin County",5,14,23,15,8
050,30,045,"Montana","Judith Basin County",5,15,20,11,9
050,30,045,"Montana","Judith Basin County",5,16,24,13,11
050,30,045,"Montana","Judith Basin County",5,17,20,10,10
050,30,045,"Montana","Judith Basin County",5,18,18,9,9
050,30,045,"Montana","Judith Basin County",5,19,18,9,9
050,30,045,"Montana","Judith Basin County",5,20,18,12,6
050,30,045,"Montana","Judith Basin County",5,21,20,11,9
050,30,045,"Montana","Judith Basin County",5,22,26,11,15
050,30,045,"Montana","Judith Basin County",5,23,13,8,5
050,30,045,"Montana","Judith Basin County",5,24,20,11,9
050,30,045,"Montana","Judith Basin County",5,25,10,5,5
050,30,045,"Montana","Judith Basin County",5,26,21,13,8
050,30,045,"Montana","Judith Basin County",5,27,16,10,6
050,30,045,"Montana","Judith Basin County",5,28,22,9,13
050,30,045,"Montana","Judith Basin County",5,29,21,14,7
050,30,045,"Montana","Judith Basin County",5,30,19,10,9
050,30,045,"Montana","Judith Basin County",5,31,24,10,14
050,30,045,"Montana","Judith Basin County",5,32,26,11,15
050,30,045,"Montana","Judith Basin County",5,33,16,10,6
050,30,045,"Montana","Judith Basin County",5,34,17,8,9
050,30,045,"Montana","Judith Basin County",5,35,19,11,8
050,30,045,"Montana","Judith Basin County",5,36,23,10,13
050,30,045,"Montana","Judith Basin County",5,37,25,13,12
050,30,045,"Montana","Judith Basin County",5,38,15,7,8
050,30,045,"Montana","Judith Basin County",5,39,23,9,14
050,30,045,"Montana","Judith Basin County",5,40,27,11,16
050,30,045,"Montana","Judith Basin County",5,41,24,10,14
050,30,045,"Montana","Judith Basin County",5,42,29,17,12
050,30,045,"Montana","Judith Basin County",5,43,29,13,16
050,30,045,"Montana","Judith Basin County",5,44,21,9,12
050,30,045,"Montana","Judith Basin County",5,45,20,11,9
050,30,045,"Montana","Judith Basin County",5,46,17,9,8
050,30,045,"Montana","Judith Basin County",5,47,26,9,17
050,30,045,"Montana","Judith Basin County",5,48,26,15,11
050,30,045,"Montana","Judith Basin County",5,49,19,10,9
050,30,045,"Montana","Judith Basin County",5,50,16,9,7
050,30,045,"Montana","Judith Basin County",5,51,20,10,10
050,30,045,"Montana","Judith Basin County",5,52,29,16,13
050,30,045,"Montana","Judith Basin County",5,53,18,10,8
050,30,045,"Montana","Judith Basin County",5,54,21,14,7
050,30,045,"Montana","Judith Basin County",5,55,22,15,7
050,30,045,"Montana","Judith Basin County",5,56,28,13,15
050,30,045,"Montana","Judith Basin County",5,57,25,11,14
050,30,045,"Montana","Judith Basin County",5,58,30,16,14
050,30,045,"Montana","Judith Basin County",5,59,36,19,17
050,30,045,"Montana","Judith Basin County",5,60,36,15,21
050,30,045,"Montana","Judith Basin County",5,61,42,19,23
050,30,045,"Montana","Judith Basin County",5,62,43,19,24
050,30,045,"Montana","Judith Basin County",5,63,44,23,21
050,30,045,"Montana","Judith Basin County",5,64,35,20,15
050,30,045,"Montana","Judith Basin County",5,65,35,19,16
050,30,045,"Montana","Judith Basin County",5,66,30,20,10
050,30,045,"Montana","Judith Basin County",5,67,37,22,15
050,30,045,"Montana","Judith Basin County",5,68,39,22,17
050,30,045,"Montana","Judith Basin County",5,69,36,18,18
050,30,045,"Montana","Judith Basin County",5,70,39,21,18
050,30,045,"Montana","Judith Basin County",5,71,38,18,20
050,30,045,"Montana","Judith Basin County",5,72,34,17,17
050,30,045,"Montana","Judith Basin County",5,73,29,16,13
050,30,045,"Montana","Judith Basin County",5,74,26,15,11
050,30,045,"Montana","Judith Basin County",5,75,22,13,9
050,30,045,"Montana","Judith Basin County",5,76,25,18,7
050,30,045,"Montana","Judith Basin County",5,77,18,12,6
050,30,045,"Montana","Judith Basin County",5,78,18,9,9
050,30,045,"Montana","Judith Basin County",5,79,16,11,5
050,30,045,"Montana","Judith Basin County",5,80,20,10,10
050,30,045,"Montana","Judith Basin County",5,81,19,9,10
050,30,045,"Montana","Judith Basin County",5,82,14,7,7
050,30,045,"Montana","Judith Basin County",5,83,18,10,8
050,30,045,"Montana","Judith Basin County",5,84,18,6,12
050,30,045,"Montana","Judith Basin County",5,85,60,21,39
050,30,047,"Montana","Lake County",1,0,295,148,147
050,30,047,"Montana","Lake County",1,1,320,147,173
050,30,047,"Montana","Lake County",1,2,342,172,170
050,30,047,"Montana","Lake County",1,3,366,193,173
050,30,047,"Montana","Lake County",1,4,382,205,177
050,30,047,"Montana","Lake County",1,5,419,206,213
050,30,047,"Montana","Lake County",1,6,411,211,200
050,30,047,"Montana","Lake County",1,7,393,211,182
050,30,047,"Montana","Lake County",1,8,368,184,184
050,30,047,"Montana","Lake County",1,9,365,182,183
050,30,047,"Montana","Lake County",1,10,419,220,199
050,30,047,"Montana","Lake County",1,11,493,255,238
050,30,047,"Montana","Lake County",1,12,477,252,225
050,30,047,"Montana","Lake County",1,13,471,233,238
050,30,047,"Montana","Lake County",1,14,435,210,225
050,30,047,"Montana","Lake County",1,15,391,196,195
050,30,047,"Montana","Lake County",1,16,421,220,201
050,30,047,"Montana","Lake County",1,17,406,204,202
050,30,047,"Montana","Lake County",1,18,315,166,149
050,30,047,"Montana","Lake County",1,19,308,169,139
050,30,047,"Montana","Lake County",1,20,305,159,146
050,30,047,"Montana","Lake County",1,21,307,155,152
050,30,047,"Montana","Lake County",1,22,289,152,137
050,30,047,"Montana","Lake County",1,23,316,160,156
050,30,047,"Montana","Lake County",1,24,314,164,150
050,30,047,"Montana","Lake County",1,25,292,158,134
050,30,047,"Montana","Lake County",1,26,311,173,138
050,30,047,"Montana","Lake County",1,27,332,177,155
050,30,047,"Montana","Lake County",1,28,350,179,171
050,30,047,"Montana","Lake County",1,29,343,168,175
050,30,047,"Montana","Lake County",1,30,356,160,196
050,30,047,"Montana","Lake County",1,31,321,160,161
050,30,047,"Montana","Lake County",1,32,334,160,174
050,30,047,"Montana","Lake County",1,33,315,143,172
050,30,047,"Montana","Lake County",1,34,332,159,173
050,30,047,"Montana","Lake County",1,35,342,177,165
050,30,047,"Montana","Lake County",1,36,309,149,160
050,30,047,"Montana","Lake County",1,37,376,191,185
050,30,047,"Montana","Lake County",1,38,346,181,165
050,30,047,"Montana","Lake County",1,39,338,168,170
050,30,047,"Montana","Lake County",1,40,335,170,165
050,30,047,"Montana","Lake County",1,41,363,177,186
050,30,047,"Montana","Lake County",1,42,354,152,202
050,30,047,"Montana","Lake County",1,43,357,158,199
050,30,047,"Montana","Lake County",1,44,333,148,185
050,30,047,"Montana","Lake County",1,45,311,147,164
050,30,047,"Montana","Lake County",1,46,304,150,154
050,30,047,"Montana","Lake County",1,47,323,156,167
050,30,047,"Montana","Lake County",1,48,290,152,138
050,30,047,"Montana","Lake County",1,49,317,147,170
050,30,047,"Montana","Lake County",1,50,339,150,189
050,30,047,"Montana","Lake County",1,51,338,165,173
050,30,047,"Montana","Lake County",1,52,335,161,174
050,30,047,"Montana","Lake County",1,53,345,146,199
050,30,047,"Montana","Lake County",1,54,366,167,199
050,30,047,"Montana","Lake County",1,55,385,192,193
050,30,047,"Montana","Lake County",1,56,386,185,201
050,30,047,"Montana","Lake County",1,57,420,212,208
050,30,047,"Montana","Lake County",1,58,472,237,235
050,30,047,"Montana","Lake County",1,59,480,220,260
050,30,047,"Montana","Lake County",1,60,479,214,265
050,30,047,"Montana","Lake County",1,61,519,225,294
050,30,047,"Montana","Lake County",1,62,481,230,251
050,30,047,"Montana","Lake County",1,63,502,227,275
050,30,047,"Montana","Lake County",1,64,537,259,278
050,30,047,"Montana","Lake County",1,65,512,235,277
050,30,047,"Montana","Lake County",1,66,467,218,249
050,30,047,"Montana","Lake County",1,67,508,244,264
050,30,047,"Montana","Lake County",1,68,482,244,238
050,30,047,"Montana","Lake County",1,69,431,227,204
050,30,047,"Montana","Lake County",1,70,422,209,213
050,30,047,"Montana","Lake County",1,71,402,189,213
050,30,047,"Montana","Lake County",1,72,408,203,205
050,30,047,"Montana","Lake County",1,73,408,225,183
050,30,047,"Montana","Lake County",1,74,309,168,141
050,30,047,"Montana","Lake County",1,75,300,161,139
050,30,047,"Montana","Lake County",1,76,297,158,139
050,30,047,"Montana","Lake County",1,77,286,145,141
050,30,047,"Montana","Lake County",1,78,242,129,113
050,30,047,"Montana","Lake County",1,79,218,115,103
050,30,047,"Montana","Lake County",1,80,192,91,101
050,30,047,"Montana","Lake County",1,81,176,78,98
050,30,047,"Montana","Lake County",1,82,149,75,74
050,30,047,"Montana","Lake County",1,83,127,53,74
050,30,047,"Montana","Lake County",1,84,129,59,70
050,30,047,"Montana","Lake County",1,85,681,311,370
050,30,047,"Montana","Lake County",2,0,301,148,153
050,30,047,"Montana","Lake County",2,1,319,149,170
050,30,047,"Montana","Lake County",2,2,339,167,172
050,30,047,"Montana","Lake County",2,3,366,192,174
050,30,047,"Montana","Lake County",2,4,384,203,181
050,30,047,"Montana","Lake County",2,5,408,205,203
050,30,047,"Montana","Lake County",2,6,418,213,205
050,30,047,"Montana","Lake County",2,7,398,210,188
050,30,047,"Montana","Lake County",2,8,376,190,186
050,30,047,"Montana","Lake County",2,9,368,184,184
050,30,047,"Montana","Lake County",2,10,407,212,195
050,30,047,"Montana","Lake County",2,11,474,245,229
050,30,047,"Montana","Lake County",2,12,479,253,226
050,30,047,"Montana","Lake County",2,13,473,238,235
050,30,047,"Montana","Lake County",2,14,441,215,226
050,30,047,"Montana","Lake County",2,15,401,200,201
050,30,047,"Montana","Lake County",2,16,416,216,200
050,30,047,"Montana","Lake County",2,17,406,206,200
050,30,047,"Montana","Lake County",2,18,323,169,154
050,30,047,"Montana","Lake County",2,19,301,165,136
050,30,047,"Montana","Lake County",2,20,310,163,147
050,30,047,"Montana","Lake County",2,21,311,160,151
050,30,047,"Montana","Lake County",2,22,296,155,141
050,30,047,"Montana","Lake County",2,23,314,161,153
050,30,047,"Montana","Lake County",2,24,310,162,148
050,30,047,"Montana","Lake County",2,25,302,161,141
050,30,047,"Montana","Lake County",2,26,309,170,139
050,30,047,"Montana","Lake County",2,27,328,176,152
050,30,047,"Montana","Lake County",2,28,347,179,168
050,30,047,"Montana","Lake County",2,29,352,173,179
050,30,047,"Montana","Lake County",2,30,358,163,195
050,30,047,"Montana","Lake County",2,31,333,162,171
050,30,047,"Montana","Lake County",2,32,331,160,171
050,30,047,"Montana","Lake County",2,33,320,148,172
050,30,047,"Montana","Lake County",2,34,328,154,174
050,30,047,"Montana","Lake County",2,35,341,174,167
050,30,047,"Montana","Lake County",2,36,319,158,161
050,30,047,"Montana","Lake County",2,37,362,182,180
050,30,047,"Montana","Lake County",2,38,356,185,171
050,30,047,"Montana","Lake County",2,39,340,170,170
050,30,047,"Montana","Lake County",2,40,338,171,167
050,30,047,"Montana","Lake County",2,41,353,176,177
050,30,047,"Montana","Lake County",2,42,354,157,197
050,30,047,"Montana","Lake County",2,43,361,157,204
050,30,047,"Montana","Lake County",2,44,333,148,185
050,30,047,"Montana","Lake County",2,45,318,148,170
050,30,047,"Montana","Lake County",2,46,307,151,156
050,30,047,"Montana","Lake County",2,47,320,156,164
050,30,047,"Montana","Lake County",2,48,301,155,146
050,30,047,"Montana","Lake County",2,49,313,148,165
050,30,047,"Montana","Lake County",2,50,337,151,186
050,30,047,"Montana","Lake County",2,51,340,162,178
050,30,047,"Montana","Lake County",2,52,338,160,178
050,30,047,"Montana","Lake County",2,53,342,148,194
050,30,047,"Montana","Lake County",2,54,360,161,199
050,30,047,"Montana","Lake County",2,55,385,189,196
050,30,047,"Montana","Lake County",2,56,392,189,203
050,30,047,"Montana","Lake County",2,57,413,209,204
050,30,047,"Montana","Lake County",2,58,464,232,232
050,30,047,"Montana","Lake County",2,59,483,224,259
050,30,047,"Montana","Lake County",2,60,484,217,267
050,30,047,"Montana","Lake County",2,61,513,224,289
050,30,047,"Montana","Lake County",2,62,493,230,263
050,30,047,"Montana","Lake County",2,63,504,233,271
050,30,047,"Montana","Lake County",2,64,530,253,277
050,30,047,"Montana","Lake County",2,65,512,242,270
050,30,047,"Montana","Lake County",2,66,480,224,256
050,30,047,"Montana","Lake County",2,67,498,239,259
050,30,047,"Montana","Lake County",2,68,485,241,244
050,30,047,"Montana","Lake County",2,69,443,230,213
050,30,047,"Montana","Lake County",2,70,422,213,209
050,30,047,"Montana","Lake County",2,71,406,194,212
050,30,047,"Montana","Lake County",2,72,403,200,203
050,30,047,"Montana","Lake County",2,73,428,230,198
050,30,047,"Montana","Lake County",2,74,310,169,141
050,30,047,"Montana","Lake County",2,75,302,162,140
050,30,047,"Montana","Lake County",2,76,294,156,138
050,30,047,"Montana","Lake County",2,77,296,152,144
050,30,047,"Montana","Lake County",2,78,248,131,117
050,30,047,"Montana","Lake County",2,79,215,114,101
050,30,047,"Montana","Lake County",2,80,193,95,98
050,30,047,"Montana","Lake County",2,81,179,81,98
050,30,047,"Montana","Lake County",2,82,155,73,82
050,30,047,"Montana","Lake County",2,83,130,58,72
050,30,047,"Montana","Lake County",2,84,129,57,72
050,30,047,"Montana","Lake County",2,85,689,317,372
050,30,047,"Montana","Lake County",3,0,285,140,145
050,30,047,"Montana","Lake County",3,1,313,147,166
050,30,047,"Montana","Lake County",3,2,329,153,176
050,30,047,"Montana","Lake County",3,3,334,168,166
050,30,047,"Montana","Lake County",3,4,372,186,186
050,30,047,"Montana","Lake County",3,5,391,211,180
050,30,047,"Montana","Lake County",3,6,412,211,201
050,30,047,"Montana","Lake County",3,7,421,212,209
050,30,047,"Montana","Lake County",3,8,399,210,189
050,30,047,"Montana","Lake County",3,9,390,197,193
050,30,047,"Montana","Lake County",3,10,367,189,178
050,30,047,"Montana","Lake County",3,11,418,209,209
050,30,047,"Montana","Lake County",3,12,478,246,232
050,30,047,"Montana","Lake County",3,13,492,256,236
050,30,047,"Montana","Lake County",3,14,494,245,249
050,30,047,"Montana","Lake County",3,15,466,228,238
050,30,047,"Montana","Lake County",3,16,413,208,205
050,30,047,"Montana","Lake County",3,17,435,226,209
050,30,047,"Montana","Lake County",3,18,365,194,171
050,30,047,"Montana","Lake County",3,19,282,147,135
050,30,047,"Montana","Lake County",3,20,307,163,144
050,30,047,"Montana","Lake County",3,21,320,169,151
050,30,047,"Montana","Lake County",3,22,333,162,171
050,30,047,"Montana","Lake County",3,23,322,175,147
050,30,047,"Montana","Lake County",3,24,309,156,153
050,30,047,"Montana","Lake County",3,25,321,163,158
050,30,047,"Montana","Lake County",3,26,327,170,157
050,30,047,"Montana","Lake County",3,27,333,180,153
050,30,047,"Montana","Lake County",3,28,325,165,160
050,30,047,"Montana","Lake County",3,29,346,172,174
050,30,047,"Montana","Lake County",3,30,357,183,174
050,30,047,"Montana","Lake County",3,31,378,179,199
050,30,047,"Montana","Lake County",3,32,350,170,180
050,30,047,"Montana","Lake County",3,33,345,163,182
050,30,047,"Montana","Lake County",3,34,340,163,177
050,30,047,"Montana","Lake County",3,35,359,180,179
050,30,047,"Montana","Lake County",3,36,363,182,181
050,30,047,"Montana","Lake County",3,37,346,175,171
050,30,047,"Montana","Lake County",3,38,384,192,192
050,30,047,"Montana","Lake County",3,39,372,197,175
050,30,047,"Montana","Lake County",3,40,361,176,185
050,30,047,"Montana","Lake County",3,41,348,180,168
050,30,047,"Montana","Lake County",3,42,373,183,190
050,30,047,"Montana","Lake County",3,43,368,160,208
050,30,047,"Montana","Lake County",3,44,372,166,206
050,30,047,"Montana","Lake County",3,45,347,152,195
050,30,047,"Montana","Lake County",3,46,319,152,167
050,30,047,"Montana","Lake County",3,47,321,157,164
050,30,047,"Montana","Lake County",3,48,328,160,168
050,30,047,"Montana","Lake County",3,49,309,160,149
050,30,047,"Montana","Lake County",3,50,328,166,162
050,30,047,"Montana","Lake County",3,51,352,161,191
050,30,047,"Montana","Lake County",3,52,347,163,184
050,30,047,"Montana","Lake County",3,53,346,159,187
050,30,047,"Montana","Lake County",3,54,353,163,190
050,30,047,"Montana","Lake County",3,55,376,165,211
050,30,047,"Montana","Lake County",3,56,395,184,211
050,30,047,"Montana","Lake County",3,57,395,192,203
050,30,047,"Montana","Lake County",3,58,433,225,208
050,30,047,"Montana","Lake County",3,59,469,231,238
050,30,047,"Montana","Lake County",3,60,470,215,255
050,30,047,"Montana","Lake County",3,61,509,239,270
050,30,047,"Montana","Lake County",3,62,535,235,300
050,30,047,"Montana","Lake County",3,63,501,235,266
050,30,047,"Montana","Lake County",3,64,529,245,284
050,30,047,"Montana","Lake County",3,65,548,266,282
050,30,047,"Montana","Lake County",3,66,524,248,276
050,30,047,"Montana","Lake County",3,67,492,229,263
050,30,047,"Montana","Lake County",3,68,493,231,262
050,30,047,"Montana","Lake County",3,69,493,245,248
050,30,047,"Montana","Lake County",3,70,445,228,217
050,30,047,"Montana","Lake County",3,71,421,209,212
050,30,047,"Montana","Lake County",3,72,416,207,209
050,30,047,"Montana","Lake County",3,73,399,198,201
050,30,047,"Montana","Lake County",3,74,439,234,205
050,30,047,"Montana","Lake County",3,75,298,160,138
050,30,047,"Montana","Lake County",3,76,288,149,139
050,30,047,"Montana","Lake County",3,77,299,153,146
050,30,047,"Montana","Lake County",3,78,282,145,137
050,30,047,"Montana","Lake County",3,79,251,137,114
050,30,047,"Montana","Lake County",3,80,205,107,98
050,30,047,"Montana","Lake County",3,81,180,87,93
050,30,047,"Montana","Lake County",3,82,171,80,91
050,30,047,"Montana","Lake County",3,83,139,64,75
050,30,047,"Montana","Lake County",3,84,121,48,73
050,30,047,"Montana","Lake County",3,85,709,321,388
050,30,047,"Montana","Lake County",4,0,306,159,147
050,30,047,"Montana","Lake County",4,1,295,146,149
050,30,047,"Montana","Lake County",4,2,315,140,175
050,30,047,"Montana","Lake County",4,3,345,157,188
050,30,047,"Montana","Lake County",4,4,363,182,181
050,30,047,"Montana","Lake County",4,5,384,197,187
050,30,047,"Montana","Lake County",4,6,407,218,189
050,30,047,"Montana","Lake County",4,7,433,225,208
050,30,047,"Montana","Lake County",4,8,423,219,204
050,30,047,"Montana","Lake County",4,9,409,217,192
050,30,047,"Montana","Lake County",4,10,402,207,195
050,30,047,"Montana","Lake County",4,11,368,188,180
050,30,047,"Montana","Lake County",4,12,422,216,206
050,30,047,"Montana","Lake County",4,13,470,242,228
050,30,047,"Montana","Lake County",4,14,497,257,240
050,30,047,"Montana","Lake County",4,15,494,246,248
050,30,047,"Montana","Lake County",4,16,462,225,237
050,30,047,"Montana","Lake County",4,17,431,220,211
050,30,047,"Montana","Lake County",4,18,369,200,169
050,30,047,"Montana","Lake County",4,19,312,172,140
050,30,047,"Montana","Lake County",4,20,299,155,144
050,30,047,"Montana","Lake County",4,21,320,166,154
050,30,047,"Montana","Lake County",4,22,327,176,151
050,30,047,"Montana","Lake County",4,23,365,175,190
050,30,047,"Montana","Lake County",4,24,339,183,156
050,30,047,"Montana","Lake County",4,25,312,168,144
050,30,047,"Montana","Lake County",4,26,324,168,156
050,30,047,"Montana","Lake County",4,27,339,172,167
050,30,047,"Montana","Lake County",4,28,350,186,164
050,30,047,"Montana","Lake County",4,29,322,166,156
050,30,047,"Montana","Lake County",4,30,360,180,180
050,30,047,"Montana","Lake County",4,31,379,197,182
050,30,047,"Montana","Lake County",4,32,414,201,213
050,30,047,"Montana","Lake County",4,33,357,173,184
050,30,047,"Montana","Lake County",4,34,359,174,185
050,30,047,"Montana","Lake County",4,35,361,173,188
050,30,047,"Montana","Lake County",4,36,390,203,187
050,30,047,"Montana","Lake County",4,37,376,187,189
050,30,047,"Montana","Lake County",4,38,368,177,191
050,30,047,"Montana","Lake County",4,39,414,218,196
050,30,047,"Montana","Lake County",4,40,371,193,178
050,30,047,"Montana","Lake County",4,41,360,170,190
050,30,047,"Montana","Lake County",4,42,360,186,174
050,30,047,"Montana","Lake County",4,43,388,192,196
050,30,047,"Montana","Lake County",4,44,378,169,209
050,30,047,"Montana","Lake County",4,45,372,170,202
050,30,047,"Montana","Lake County",4,46,355,151,204
050,30,047,"Montana","Lake County",4,47,330,153,177
050,30,047,"Montana","Lake County",4,48,341,160,181
050,30,047,"Montana","Lake County",4,49,345,172,173
050,30,047,"Montana","Lake County",4,50,328,168,160
050,30,047,"Montana","Lake County",4,51,342,174,168
050,30,047,"Montana","Lake County",4,52,363,162,201
050,30,047,"Montana","Lake County",4,53,354,165,189
050,30,047,"Montana","Lake County",4,54,346,160,186
050,30,047,"Montana","Lake County",4,55,370,172,198
050,30,047,"Montana","Lake County",4,56,400,176,224
050,30,047,"Montana","Lake County",4,57,408,192,216
050,30,047,"Montana","Lake County",4,58,398,190,208
050,30,047,"Montana","Lake County",4,59,450,235,215
050,30,047,"Montana","Lake County",4,60,485,242,243
050,30,047,"Montana","Lake County",4,61,510,228,282
050,30,047,"Montana","Lake County",4,62,522,239,283
050,30,047,"Montana","Lake County",4,63,545,240,305
050,30,047,"Montana","Lake County",4,64,520,251,269
050,30,047,"Montana","Lake County",4,65,537,257,280
050,30,047,"Montana","Lake County",4,66,532,257,275
050,30,047,"Montana","Lake County",4,67,525,253,272
050,30,047,"Montana","Lake County",4,68,514,236,278
050,30,047,"Montana","Lake County",4,69,502,235,267
050,30,047,"Montana","Lake County",4,70,492,241,251
050,30,047,"Montana","Lake County",4,71,456,233,223
050,30,047,"Montana","Lake County",4,72,425,221,204
050,30,047,"Montana","Lake County",4,73,399,192,207
050,30,047,"Montana","Lake County",4,74,397,195,202
050,30,047,"Montana","Lake County",4,75,426,223,203
050,30,047,"Montana","Lake County",4,76,291,155,136
050,30,047,"Montana","Lake County",4,77,292,153,139
050,30,047,"Montana","Lake County",4,78,286,148,138
050,30,047,"Montana","Lake County",4,79,275,144,131
050,30,047,"Montana","Lake County",4,80,240,129,111
050,30,047,"Montana","Lake County",4,81,191,102,89
050,30,047,"Montana","Lake County",4,82,171,81,90
050,30,047,"Montana","Lake County",4,83,156,73,83
050,30,047,"Montana","Lake County",4,84,128,58,70
050,30,047,"Montana","Lake County",4,85,695,301,394
050,30,047,"Montana","Lake County",5,0,310,164,146
050,30,047,"Montana","Lake County",5,1,323,169,154
050,30,047,"Montana","Lake County",5,2,307,154,153
050,30,047,"Montana","Lake County",5,3,312,131,181
050,30,047,"Montana","Lake County",5,4,350,162,188
050,30,047,"Montana","Lake County",5,5,355,178,177
050,30,047,"Montana","Lake County",5,6,393,201,192
050,30,047,"Montana","Lake County",5,7,399,214,185
050,30,047,"Montana","Lake County",5,8,432,219,213
050,30,047,"Montana","Lake County",5,9,425,223,202
050,30,047,"Montana","Lake County",5,10,402,215,187
050,30,047,"Montana","Lake County",5,11,417,216,201
050,30,047,"Montana","Lake County",5,12,381,200,181
050,30,047,"Montana","Lake County",5,13,419,213,206
050,30,047,"Montana","Lake County",5,14,474,247,227
050,30,047,"Montana","Lake County",5,15,511,268,243
050,30,047,"Montana","Lake County",5,16,493,251,242
050,30,047,"Montana","Lake County",5,17,472,232,240
050,30,047,"Montana","Lake County",5,18,371,196,175
050,30,047,"Montana","Lake County",5,19,324,179,145
050,30,047,"Montana","Lake County",5,20,327,170,157
050,30,047,"Montana","Lake County",5,21,319,163,156
050,30,047,"Montana","Lake County",5,22,323,165,158
050,30,047,"Montana","Lake County",5,23,346,194,152
050,30,047,"Montana","Lake County",5,24,365,177,188
050,30,047,"Montana","Lake County",5,25,349,178,171
050,30,047,"Montana","Lake County",5,26,314,174,140
050,30,047,"Montana","Lake County",5,27,332,175,157
050,30,047,"Montana","Lake County",5,28,341,176,165
050,30,047,"Montana","Lake County",5,29,345,185,160
050,30,047,"Montana","Lake County",5,30,332,176,156
050,30,047,"Montana","Lake County",5,31,368,187,181
050,30,047,"Montana","Lake County",5,32,390,203,187
050,30,047,"Montana","Lake County",5,33,422,209,213
050,30,047,"Montana","Lake County",5,34,375,178,197
050,30,047,"Montana","Lake County",5,35,369,178,191
050,30,047,"Montana","Lake County",5,36,375,180,195
050,30,047,"Montana","Lake County",5,37,396,206,190
050,30,047,"Montana","Lake County",5,38,396,200,196
050,30,047,"Montana","Lake County",5,39,382,180,202
050,30,047,"Montana","Lake County",5,40,422,216,206
050,30,047,"Montana","Lake County",5,41,383,198,185
050,30,047,"Montana","Lake County",5,42,376,179,197
050,30,047,"Montana","Lake County",5,43,375,195,180
050,30,047,"Montana","Lake County",5,44,399,192,207
050,30,047,"Montana","Lake County",5,45,389,171,218
050,30,047,"Montana","Lake County",5,46,388,182,206
050,30,047,"Montana","Lake County",5,47,368,167,201
050,30,047,"Montana","Lake County",5,48,349,164,185
050,30,047,"Montana","Lake County",5,49,343,157,186
050,30,047,"Montana","Lake County",5,50,366,186,180
050,30,047,"Montana","Lake County",5,51,331,175,156
050,30,047,"Montana","Lake County",5,52,344,169,175
050,30,047,"Montana","Lake County",5,53,365,172,193
050,30,047,"Montana","Lake County",5,54,369,173,196
050,30,047,"Montana","Lake County",5,55,365,168,197
050,30,047,"Montana","Lake County",5,56,374,172,202
050,30,047,"Montana","Lake County",5,57,405,182,223
050,30,047,"Montana","Lake County",5,58,420,191,229
050,30,047,"Montana","Lake County",5,59,420,201,219
050,30,047,"Montana","Lake County",5,60,441,226,215
050,30,047,"Montana","Lake County",5,61,474,245,229
050,30,047,"Montana","Lake County",5,62,536,237,299
050,30,047,"Montana","Lake County",5,63,542,250,292
050,30,047,"Montana","Lake County",5,64,569,252,317
050,30,047,"Montana","Lake County",5,65,515,245,270
050,30,047,"Montana","Lake County",5,66,538,263,275
050,30,047,"Montana","Lake County",5,67,540,257,283
050,30,047,"Montana","Lake County",5,68,526,251,275
050,30,047,"Montana","Lake County",5,69,507,238,269
050,30,047,"Montana","Lake County",5,70,500,225,275
050,30,047,"Montana","Lake County",5,71,487,239,248
050,30,047,"Montana","Lake County",5,72,457,245,212
050,30,047,"Montana","Lake County",5,73,413,211,202
050,30,047,"Montana","Lake County",5,74,396,194,202
050,30,047,"Montana","Lake County",5,75,378,179,199
050,30,047,"Montana","Lake County",5,76,418,215,203
050,30,047,"Montana","Lake County",5,77,288,151,137
050,30,047,"Montana","Lake County",5,78,281,147,134
050,30,047,"Montana","Lake County",5,79,278,148,130
050,30,047,"Montana","Lake County",5,80,255,135,120
050,30,047,"Montana","Lake County",5,81,215,114,101
050,30,047,"Montana","Lake County",5,82,185,99,86
050,30,047,"Montana","Lake County",5,83,151,70,81
050,30,047,"Montana","Lake County",5,84,153,70,83
050,30,047,"Montana","Lake County",5,85,708,304,404
050,30,049,"Montana","Lewis and Clark County",1,0,738,380,358
050,30,049,"Montana","Lewis and Clark County",1,1,759,383,376
050,30,049,"Montana","Lewis and Clark County",1,2,823,419,404
050,30,049,"Montana","Lewis and Clark County",1,3,817,411,406
050,30,049,"Montana","Lewis and Clark County",1,4,892,449,443
050,30,049,"Montana","Lewis and Clark County",1,5,872,415,457
050,30,049,"Montana","Lewis and Clark County",1,6,880,455,425
050,30,049,"Montana","Lewis and Clark County",1,7,868,452,416
050,30,049,"Montana","Lewis and Clark County",1,8,833,430,403
050,30,049,"Montana","Lewis and Clark County",1,9,844,423,421
050,30,049,"Montana","Lewis and Clark County",1,10,916,459,457
050,30,049,"Montana","Lewis and Clark County",1,11,920,478,442
050,30,049,"Montana","Lewis and Clark County",1,12,943,493,450
050,30,049,"Montana","Lewis and Clark County",1,13,891,447,444
050,30,049,"Montana","Lewis and Clark County",1,14,854,439,415
050,30,049,"Montana","Lewis and Clark County",1,15,848,427,421
050,30,049,"Montana","Lewis and Clark County",1,16,869,447,422
050,30,049,"Montana","Lewis and Clark County",1,17,872,434,438
050,30,049,"Montana","Lewis and Clark County",1,18,784,408,376
050,30,049,"Montana","Lewis and Clark County",1,19,796,422,374
050,30,049,"Montana","Lewis and Clark County",1,20,750,392,358
050,30,049,"Montana","Lewis and Clark County",1,21,717,390,327
050,30,049,"Montana","Lewis and Clark County",1,22,719,362,357
050,30,049,"Montana","Lewis and Clark County",1,23,756,378,378
050,30,049,"Montana","Lewis and Clark County",1,24,784,395,389
050,30,049,"Montana","Lewis and Clark County",1,25,734,388,346
050,30,049,"Montana","Lewis and Clark County",1,26,779,393,386
050,30,049,"Montana","Lewis and Clark County",1,27,834,400,434
050,30,049,"Montana","Lewis and Clark County",1,28,868,446,422
050,30,049,"Montana","Lewis and Clark County",1,29,861,435,426
050,30,049,"Montana","Lewis and Clark County",1,30,882,434,448
050,30,049,"Montana","Lewis and Clark County",1,31,888,441,447
050,30,049,"Montana","Lewis and Clark County",1,32,903,451,452
050,30,049,"Montana","Lewis and Clark County",1,33,942,459,483
050,30,049,"Montana","Lewis and Clark County",1,34,966,478,488
050,30,049,"Montana","Lewis and Clark County",1,35,991,485,506
050,30,049,"Montana","Lewis and Clark County",1,36,1024,521,503
050,30,049,"Montana","Lewis and Clark County",1,37,1004,519,485
050,30,049,"Montana","Lewis and Clark County",1,38,1001,536,465
050,30,049,"Montana","Lewis and Clark County",1,39,952,494,458
050,30,049,"Montana","Lewis and Clark County",1,40,893,460,433
050,30,049,"Montana","Lewis and Clark County",1,41,857,453,404
050,30,049,"Montana","Lewis and Clark County",1,42,889,450,439
050,30,049,"Montana","Lewis and Clark County",1,43,812,409,403
050,30,049,"Montana","Lewis and Clark County",1,44,766,389,377
050,30,049,"Montana","Lewis and Clark County",1,45,783,397,386
050,30,049,"Montana","Lewis and Clark County",1,46,783,381,402
050,30,049,"Montana","Lewis and Clark County",1,47,784,389,395
050,30,049,"Montana","Lewis and Clark County",1,48,774,385,389
050,30,049,"Montana","Lewis and Clark County",1,49,849,428,421
050,30,049,"Montana","Lewis and Clark County",1,50,838,421,417
050,30,049,"Montana","Lewis and Clark County",1,51,823,407,416
050,30,049,"Montana","Lewis and Clark County",1,52,847,415,432
050,30,049,"Montana","Lewis and Clark County",1,53,863,428,435
050,30,049,"Montana","Lewis and Clark County",1,54,869,435,434
050,30,049,"Montana","Lewis and Clark County",1,55,972,471,501
050,30,049,"Montana","Lewis and Clark County",1,56,1025,498,527
050,30,049,"Montana","Lewis and Clark County",1,57,1019,501,518
050,30,049,"Montana","Lewis and Clark County",1,58,1085,520,565
050,30,049,"Montana","Lewis and Clark County",1,59,1098,532,566
050,30,049,"Montana","Lewis and Clark County",1,60,1045,502,543
050,30,049,"Montana","Lewis and Clark County",1,61,1061,514,547
050,30,049,"Montana","Lewis and Clark County",1,62,1105,520,585
050,30,049,"Montana","Lewis and Clark County",1,63,1073,523,550
050,30,049,"Montana","Lewis and Clark County",1,64,1076,520,556
050,30,049,"Montana","Lewis and Clark County",1,65,1033,511,522
050,30,049,"Montana","Lewis and Clark County",1,66,1044,512,532
050,30,049,"Montana","Lewis and Clark County",1,67,999,494,505
050,30,049,"Montana","Lewis and Clark County",1,68,974,467,507
050,30,049,"Montana","Lewis and Clark County",1,69,925,444,481
050,30,049,"Montana","Lewis and Clark County",1,70,888,459,429
050,30,049,"Montana","Lewis and Clark County",1,71,812,418,394
050,30,049,"Montana","Lewis and Clark County",1,72,778,410,368
050,30,049,"Montana","Lewis and Clark County",1,73,772,387,385
050,30,049,"Montana","Lewis and Clark County",1,74,493,249,244
050,30,049,"Montana","Lewis and Clark County",1,75,498,249,249
050,30,049,"Montana","Lewis and Clark County",1,76,510,245,265
050,30,049,"Montana","Lewis and Clark County",1,77,473,233,240
050,30,049,"Montana","Lewis and Clark County",1,78,425,199,226
050,30,049,"Montana","Lewis and Clark County",1,79,371,188,183
050,30,049,"Montana","Lewis and Clark County",1,80,310,153,157
050,30,049,"Montana","Lewis and Clark County",1,81,298,151,147
050,30,049,"Montana","Lewis and Clark County",1,82,268,125,143
050,30,049,"Montana","Lewis and Clark County",1,83,212,95,117
050,30,049,"Montana","Lewis and Clark County",1,84,184,77,107
050,30,049,"Montana","Lewis and Clark County",1,85,1340,472,868
050,30,049,"Montana","Lewis and Clark County",2,0,757,408,349
050,30,049,"Montana","Lewis and Clark County",2,1,755,383,372
050,30,049,"Montana","Lewis and Clark County",2,2,812,413,399
050,30,049,"Montana","Lewis and Clark County",2,3,824,413,411
050,30,049,"Montana","Lewis and Clark County",2,4,884,444,440
050,30,049,"Montana","Lewis and Clark County",2,5,882,427,455
050,30,049,"Montana","Lewis and Clark County",2,6,881,446,435
050,30,049,"Montana","Lewis and Clark County",2,7,872,452,420
050,30,049,"Montana","Lewis and Clark County",2,8,842,434,408
050,30,049,"Montana","Lewis and Clark County",2,9,845,426,419
050,30,049,"Montana","Lewis and Clark County",2,10,902,453,449
050,30,049,"Montana","Lewis and Clark County",2,11,920,476,444
050,30,049,"Montana","Lewis and Clark County",2,12,944,494,450
050,30,049,"Montana","Lewis and Clark County",2,13,903,459,444
050,30,049,"Montana","Lewis and Clark County",2,14,862,439,423
050,30,049,"Montana","Lewis and Clark County",2,15,848,430,418
050,30,049,"Montana","Lewis and Clark County",2,16,865,443,422
050,30,049,"Montana","Lewis and Clark County",2,17,871,436,435
050,30,049,"Montana","Lewis and Clark County",2,18,787,402,385
050,30,049,"Montana","Lewis and Clark County",2,19,794,421,373
050,30,049,"Montana","Lewis and Clark County",2,20,766,400,366
050,30,049,"Montana","Lewis and Clark County",2,21,716,388,328
050,30,049,"Montana","Lewis and Clark County",2,22,720,366,354
050,30,049,"Montana","Lewis and Clark County",2,23,753,379,374
050,30,049,"Montana","Lewis and Clark County",2,24,778,392,386
050,30,049,"Montana","Lewis and Clark County",2,25,757,398,359
050,30,049,"Montana","Lewis and Clark County",2,26,778,396,382
050,30,049,"Montana","Lewis and Clark County",2,27,831,402,429
050,30,049,"Montana","Lewis and Clark County",2,28,870,439,431
050,30,049,"Montana","Lewis and Clark County",2,29,871,441,430
050,30,049,"Montana","Lewis and Clark County",2,30,893,442,451
050,30,049,"Montana","Lewis and Clark County",2,31,894,446,448
050,30,049,"Montana","Lewis and Clark County",2,32,904,449,455
050,30,049,"Montana","Lewis and Clark County",2,33,936,459,477
050,30,049,"Montana","Lewis and Clark County",2,34,963,477,486
050,30,049,"Montana","Lewis and Clark County",2,35,990,485,505
050,30,049,"Montana","Lewis and Clark County",2,36,1014,512,502
050,30,049,"Montana","Lewis and Clark County",2,37,1017,524,493
050,30,049,"Montana","Lewis and Clark County",2,38,1003,531,472
050,30,049,"Montana","Lewis and Clark County",2,39,962,505,457
050,30,049,"Montana","Lewis and Clark County",2,40,912,472,440
050,30,049,"Montana","Lewis and Clark County",2,41,863,451,412
050,30,049,"Montana","Lewis and Clark County",2,42,878,448,430
050,30,049,"Montana","Lewis and Clark County",2,43,842,425,417
050,30,049,"Montana","Lewis and Clark County",2,44,774,392,382
050,30,049,"Montana","Lewis and Clark County",2,45,786,397,389
050,30,049,"Montana","Lewis and Clark County",2,46,782,384,398
050,30,049,"Montana","Lewis and Clark County",2,47,782,388,394
050,30,049,"Montana","Lewis and Clark County",2,48,774,385,389
050,30,049,"Montana","Lewis and Clark County",2,49,839,423,416
050,30,049,"Montana","Lewis and Clark County",2,50,844,427,417
050,30,049,"Montana","Lewis and Clark County",2,51,825,409,416
050,30,049,"Montana","Lewis and Clark County",2,52,839,412,427
050,30,049,"Montana","Lewis and Clark County",2,53,865,428,437
050,30,049,"Montana","Lewis and Clark County",2,54,869,434,435
050,30,049,"Montana","Lewis and Clark County",2,55,944,460,484
050,30,049,"Montana","Lewis and Clark County",2,56,1017,493,524
050,30,049,"Montana","Lewis and Clark County",2,57,1020,500,520
050,30,049,"Montana","Lewis and Clark County",2,58,1066,514,552
050,30,049,"Montana","Lewis and Clark County",2,59,1097,531,566
050,30,049,"Montana","Lewis and Clark County",2,60,1055,509,546
050,30,049,"Montana","Lewis and Clark County",2,61,1058,512,546
050,30,049,"Montana","Lewis and Clark County",2,62,1094,519,575
050,30,049,"Montana","Lewis and Clark County",2,63,1093,529,564
050,30,049,"Montana","Lewis and Clark County",2,64,1069,517,552
050,30,049,"Montana","Lewis and Clark County",2,65,1040,511,529
050,30,049,"Montana","Lewis and Clark County",2,66,1039,511,528
050,30,049,"Montana","Lewis and Clark County",2,67,1007,496,511
050,30,049,"Montana","Lewis and Clark County",2,68,970,467,503
050,30,049,"Montana","Lewis and Clark County",2,69,941,453,488
050,30,049,"Montana","Lewis and Clark County",2,70,892,452,440
050,30,049,"Montana","Lewis and Clark County",2,71,834,429,405
050,30,049,"Montana","Lewis and Clark County",2,72,774,405,369
050,30,049,"Montana","Lewis and Clark County",2,73,802,410,392
050,30,049,"Montana","Lewis and Clark County",2,74,518,261,257
050,30,049,"Montana","Lewis and Clark County",2,75,494,247,247
050,30,049,"Montana","Lewis and Clark County",2,76,501,243,258
050,30,049,"Montana","Lewis and Clark County",2,77,493,241,252
050,30,049,"Montana","Lewis and Clark County",2,78,425,202,223
050,30,049,"Montana","Lewis and Clark County",2,79,383,189,194
050,30,049,"Montana","Lewis and Clark County",2,80,324,161,163
050,30,049,"Montana","Lewis and Clark County",2,81,289,146,143
050,30,049,"Montana","Lewis and Clark County",2,82,271,127,144
050,30,049,"Montana","Lewis and Clark County",2,83,220,99,121
050,30,049,"Montana","Lewis and Clark County",2,84,186,79,107
050,30,049,"Montana","Lewis and Clark County",2,85,1321,465,856
050,30,049,"Montana","Lewis and Clark County",3,0,682,366,316
050,30,049,"Montana","Lewis and Clark County",3,1,759,415,344
050,30,049,"Montana","Lewis and Clark County",3,2,784,397,387
050,30,049,"Montana","Lewis and Clark County",3,3,817,420,397
050,30,049,"Montana","Lewis and Clark County",3,4,851,427,424
050,30,049,"Montana","Lewis and Clark County",3,5,896,425,471
050,30,049,"Montana","Lewis and Clark County",3,6,914,452,462
050,30,049,"Montana","Lewis and Clark County",3,7,890,448,442
050,30,049,"Montana","Lewis and Clark County",3,8,884,461,423
050,30,049,"Montana","Lewis and Clark County",3,9,843,427,416
050,30,049,"Montana","Lewis and Clark County",3,10,857,444,413
050,30,049,"Montana","Lewis and Clark County",3,11,911,455,456
050,30,049,"Montana","Lewis and Clark County",3,12,933,479,454
050,30,049,"Montana","Lewis and Clark County",3,13,959,497,462
050,30,049,"Montana","Lewis and Clark County",3,14,931,483,448
050,30,049,"Montana","Lewis and Clark County",3,15,875,444,431
050,30,049,"Montana","Lewis and Clark County",3,16,859,437,422
050,30,049,"Montana","Lewis and Clark County",3,17,872,437,435
050,30,049,"Montana","Lewis and Clark County",3,18,814,393,421
050,30,049,"Montana","Lewis and Clark County",3,19,783,412,371
050,30,049,"Montana","Lewis and Clark County",3,20,799,423,376
050,30,049,"Montana","Lewis and Clark County",3,21,757,389,368
050,30,049,"Montana","Lewis and Clark County",3,22,743,396,347
050,30,049,"Montana","Lewis and Clark County",3,23,752,389,363
050,30,049,"Montana","Lewis and Clark County",3,24,772,385,387
050,30,049,"Montana","Lewis and Clark County",3,25,826,407,419
050,30,049,"Montana","Lewis and Clark County",3,26,787,409,378
050,30,049,"Montana","Lewis and Clark County",3,27,854,425,429
050,30,049,"Montana","Lewis and Clark County",3,28,892,432,460
050,30,049,"Montana","Lewis and Clark County",3,29,896,456,440
050,30,049,"Montana","Lewis and Clark County",3,30,897,439,458
050,30,049,"Montana","Lewis and Clark County",3,31,927,459,468
050,30,049,"Montana","Lewis and Clark County",3,32,966,477,489
050,30,049,"Montana","Lewis and Clark County",3,33,928,469,459
050,30,049,"Montana","Lewis and Clark County",3,34,984,484,500
050,30,049,"Montana","Lewis and Clark County",3,35,983,478,505
050,30,049,"Montana","Lewis and Clark County",3,36,1040,498,542
050,30,049,"Montana","Lewis and Clark County",3,37,1030,528,502
050,30,049,"Montana","Lewis and Clark County",3,38,1027,525,502
050,30,049,"Montana","Lewis and Clark County",3,39,1050,551,499
050,30,049,"Montana","Lewis and Clark County",3,40,1009,522,487
050,30,049,"Montana","Lewis and Clark County",3,41,944,500,444
050,30,049,"Montana","Lewis and Clark County",3,42,867,452,415
050,30,049,"Montana","Lewis and Clark County",3,43,889,455,434
050,30,049,"Montana","Lewis and Clark County",3,44,847,424,423
050,30,049,"Montana","Lewis and Clark County",3,45,791,404,387
050,30,049,"Montana","Lewis and Clark County",3,46,795,406,389
050,30,049,"Montana","Lewis and Clark County",3,47,809,401,408
050,30,049,"Montana","Lewis and Clark County",3,48,777,375,402
050,30,049,"Montana","Lewis and Clark County",3,49,785,387,398
050,30,049,"Montana","Lewis and Clark County",3,50,859,429,430
050,30,049,"Montana","Lewis and Clark County",3,51,849,415,434
050,30,049,"Montana","Lewis and Clark County",3,52,849,428,421
050,30,049,"Montana","Lewis and Clark County",3,53,856,433,423
050,30,049,"Montana","Lewis and Clark County",3,54,863,421,442
050,30,049,"Montana","Lewis and Clark County",3,55,882,432,450
050,30,049,"Montana","Lewis and Clark County",3,56,946,463,483
050,30,049,"Montana","Lewis and Clark County",3,57,1007,493,514
050,30,049,"Montana","Lewis and Clark County",3,58,1030,502,528
050,30,049,"Montana","Lewis and Clark County",3,59,1091,531,560
050,30,049,"Montana","Lewis and Clark County",3,60,1091,535,556
050,30,049,"Montana","Lewis and Clark County",3,61,1073,508,565
050,30,049,"Montana","Lewis and Clark County",3,62,1072,520,552
050,30,049,"Montana","Lewis and Clark County",3,63,1102,518,584
050,30,049,"Montana","Lewis and Clark County",3,64,1067,513,554
050,30,049,"Montana","Lewis and Clark County",3,65,1072,516,556
050,30,049,"Montana","Lewis and Clark County",3,66,1034,502,532
050,30,049,"Montana","Lewis and Clark County",3,67,1027,498,529
050,30,049,"Montana","Lewis and Clark County",3,68,986,476,510
050,30,049,"Montana","Lewis and Clark County",3,69,971,471,500
050,30,049,"Montana","Lewis and Clark County",3,70,929,447,482
050,30,049,"Montana","Lewis and Clark County",3,71,877,448,429
050,30,049,"Montana","Lewis and Clark County",3,72,829,434,395
050,30,049,"Montana","Lewis and Clark County",3,73,766,398,368
050,30,049,"Montana","Lewis and Clark County",3,74,781,402,379
050,30,049,"Montana","Lewis and Clark County",3,75,494,251,243
050,30,049,"Montana","Lewis and Clark County",3,76,487,241,246
050,30,049,"Montana","Lewis and Clark County",3,77,495,239,256
050,30,049,"Montana","Lewis and Clark County",3,78,453,214,239
050,30,049,"Montana","Lewis and Clark County",3,79,407,194,213
050,30,049,"Montana","Lewis and Clark County",3,80,365,179,186
050,30,049,"Montana","Lewis and Clark County",3,81,315,155,160
050,30,049,"Montana","Lewis and Clark County",3,82,277,128,149
050,30,049,"Montana","Lewis and Clark County",3,83,251,115,136
050,30,049,"Montana","Lewis and Clark County",3,84,207,94,113
050,30,049,"Montana","Lewis and Clark County",3,85,1310,463,847
050,30,049,"Montana","Lewis and Clark County",4,0,703,361,342
050,30,049,"Montana","Lewis and Clark County",4,1,708,373,335
050,30,049,"Montana","Lewis and Clark County",4,2,766,419,347
050,30,049,"Montana","Lewis and Clark County",4,3,807,400,407
050,30,049,"Montana","Lewis and Clark County",4,4,840,429,411
050,30,049,"Montana","Lewis and Clark County",4,5,873,435,438
050,30,049,"Montana","Lewis and Clark County",4,6,931,429,502
050,30,049,"Montana","Lewis and Clark County",4,7,934,467,467
050,30,049,"Montana","Lewis and Clark County",4,8,887,440,447
050,30,049,"Montana","Lewis and Clark County",4,9,892,458,434
050,30,049,"Montana","Lewis and Clark County",4,10,872,437,435
050,30,049,"Montana","Lewis and Clark County",4,11,885,462,423
050,30,049,"Montana","Lewis and Clark County",4,12,915,457,458
050,30,049,"Montana","Lewis and Clark County",4,13,961,496,465
050,30,049,"Montana","Lewis and Clark County",4,14,958,497,461
050,30,049,"Montana","Lewis and Clark County",4,15,938,479,459
050,30,049,"Montana","Lewis and Clark County",4,16,895,457,438
050,30,049,"Montana","Lewis and Clark County",4,17,872,441,431
050,30,049,"Montana","Lewis and Clark County",4,18,812,406,406
050,30,049,"Montana","Lewis and Clark County",4,19,792,392,400
050,30,049,"Montana","Lewis and Clark County",4,20,785,401,384
050,30,049,"Montana","Lewis and Clark County",4,21,749,404,345
050,30,049,"Montana","Lewis and Clark County",4,22,778,393,385
050,30,049,"Montana","Lewis and Clark County",4,23,786,434,352
050,30,049,"Montana","Lewis and Clark County",4,24,769,397,372
050,30,049,"Montana","Lewis and Clark County",4,25,811,420,391
050,30,049,"Montana","Lewis and Clark County",4,26,870,434,436
050,30,049,"Montana","Lewis and Clark County",4,27,854,453,401
050,30,049,"Montana","Lewis and Clark County",4,28,881,429,452
050,30,049,"Montana","Lewis and Clark County",4,29,902,437,465
050,30,049,"Montana","Lewis and Clark County",4,30,908,474,434
050,30,049,"Montana","Lewis and Clark County",4,31,939,464,475
050,30,049,"Montana","Lewis and Clark County",4,32,986,483,503
050,30,049,"Montana","Lewis and Clark County",4,33,1000,499,501
050,30,049,"Montana","Lewis and Clark County",4,34,992,495,497
050,30,049,"Montana","Lewis and Clark County",4,35,1003,501,502
050,30,049,"Montana","Lewis and Clark County",4,36,1031,511,520
050,30,049,"Montana","Lewis and Clark County",4,37,1039,499,540
050,30,049,"Montana","Lewis and Clark County",4,38,1041,533,508
050,30,049,"Montana","Lewis and Clark County",4,39,1077,557,520
050,30,049,"Montana","Lewis and Clark County",4,40,1072,565,507
050,30,049,"Montana","Lewis and Clark County",4,41,1051,544,507
050,30,049,"Montana","Lewis and Clark County",4,42,948,502,446
050,30,049,"Montana","Lewis and Clark County",4,43,892,456,436
050,30,049,"Montana","Lewis and Clark County",4,44,908,468,440
050,30,049,"Montana","Lewis and Clark County",4,45,844,420,424
050,30,049,"Montana","Lewis and Clark County",4,46,803,403,400
050,30,049,"Montana","Lewis and Clark County",4,47,794,406,388
050,30,049,"Montana","Lewis and Clark County",4,48,813,402,411
050,30,049,"Montana","Lewis and Clark County",4,49,788,386,402
050,30,049,"Montana","Lewis and Clark County",4,50,814,407,407
050,30,049,"Montana","Lewis and Clark County",4,51,888,439,449
050,30,049,"Montana","Lewis and Clark County",4,52,867,437,430
050,30,049,"Montana","Lewis and Clark County",4,53,860,436,424
050,30,049,"Montana","Lewis and Clark County",4,54,872,436,436
050,30,049,"Montana","Lewis and Clark County",4,55,876,440,436
050,30,049,"Montana","Lewis and Clark County",4,56,893,438,455
050,30,049,"Montana","Lewis and Clark County",4,57,950,457,493
050,30,049,"Montana","Lewis and Clark County",4,58,1011,499,512
050,30,049,"Montana","Lewis and Clark County",4,59,1055,502,553
050,30,049,"Montana","Lewis and Clark County",4,60,1092,532,560
050,30,049,"Montana","Lewis and Clark County",4,61,1086,522,564
050,30,049,"Montana","Lewis and Clark County",4,62,1058,499,559
050,30,049,"Montana","Lewis and Clark County",4,63,1063,514,549
050,30,049,"Montana","Lewis and Clark County",4,64,1098,514,584
050,30,049,"Montana","Lewis and Clark County",4,65,1069,514,555
050,30,049,"Montana","Lewis and Clark County",4,66,1078,523,555
050,30,049,"Montana","Lewis and Clark County",4,67,1011,486,525
050,30,049,"Montana","Lewis and Clark County",4,68,1024,480,544
050,30,049,"Montana","Lewis and Clark County",4,69,982,474,508
050,30,049,"Montana","Lewis and Clark County",4,70,969,471,498
050,30,049,"Montana","Lewis and Clark County",4,71,919,441,478
050,30,049,"Montana","Lewis and Clark County",4,72,868,446,422
050,30,049,"Montana","Lewis and Clark County",4,73,817,430,387
050,30,049,"Montana","Lewis and Clark County",4,74,752,388,364
050,30,049,"Montana","Lewis and Clark County",4,75,757,391,366
050,30,049,"Montana","Lewis and Clark County",4,76,492,247,245
050,30,049,"Montana","Lewis and Clark County",4,77,463,225,238
050,30,049,"Montana","Lewis and Clark County",4,78,473,222,251
050,30,049,"Montana","Lewis and Clark County",4,79,441,203,238
050,30,049,"Montana","Lewis and Clark County",4,80,394,195,199
050,30,049,"Montana","Lewis and Clark County",4,81,351,170,181
050,30,049,"Montana","Lewis and Clark County",4,82,295,137,158
050,30,049,"Montana","Lewis and Clark County",4,83,249,109,140
050,30,049,"Montana","Lewis and Clark County",4,84,231,102,129
050,30,049,"Montana","Lewis and Clark County",4,85,1311,474,837
050,30,049,"Montana","Lewis and Clark County",5,0,703,361,342
050,30,049,"Montana","Lewis and Clark County",5,1,707,356,351
050,30,049,"Montana","Lewis and Clark County",5,2,726,377,349
050,30,049,"Montana","Lewis and Clark County",5,3,807,439,368
050,30,049,"Montana","Lewis and Clark County",5,4,839,409,430
050,30,049,"Montana","Lewis and Clark County",5,5,880,447,433
050,30,049,"Montana","Lewis and Clark County",5,6,921,449,472
050,30,049,"Montana","Lewis and Clark County",5,7,949,452,497
050,30,049,"Montana","Lewis and Clark County",5,8,963,477,486
050,30,049,"Montana","Lewis and Clark County",5,9,917,456,461
050,30,049,"Montana","Lewis and Clark County",5,10,909,469,440
050,30,049,"Montana","Lewis and Clark County",5,11,915,469,446
050,30,049,"Montana","Lewis and Clark County",5,12,897,464,433
050,30,049,"Montana","Lewis and Clark County",5,13,914,451,463
050,30,049,"Montana","Lewis and Clark County",5,14,967,497,470
050,30,049,"Montana","Lewis and Clark County",5,15,968,505,463
050,30,049,"Montana","Lewis and Clark County",5,16,936,482,454
050,30,049,"Montana","Lewis and Clark County",5,17,888,437,451
050,30,049,"Montana","Lewis and Clark County",5,18,794,403,391
050,30,049,"Montana","Lewis and Clark County",5,19,765,393,372
050,30,049,"Montana","Lewis and Clark County",5,20,797,378,419
050,30,049,"Montana","Lewis and Clark County",5,21,738,389,349
050,30,049,"Montana","Lewis and Clark County",5,22,764,405,359
050,30,049,"Montana","Lewis and Clark County",5,23,809,427,382
050,30,049,"Montana","Lewis and Clark County",5,24,829,447,382
050,30,049,"Montana","Lewis and Clark County",5,25,816,421,395
050,30,049,"Montana","Lewis and Clark County",5,26,850,422,428
050,30,049,"Montana","Lewis and Clark County",5,27,911,448,463
050,30,049,"Montana","Lewis and Clark County",5,28,892,455,437
050,30,049,"Montana","Lewis and Clark County",5,29,904,447,457
050,30,049,"Montana","Lewis and Clark County",5,30,959,472,487
050,30,049,"Montana","Lewis and Clark County",5,31,930,465,465
050,30,049,"Montana","Lewis and Clark County",5,32,975,485,490
050,30,049,"Montana","Lewis and Clark County",5,33,1000,488,512
050,30,049,"Montana","Lewis and Clark County",5,34,1024,514,510
050,30,049,"Montana","Lewis and Clark County",5,35,1010,502,508
050,30,049,"Montana","Lewis and Clark County",5,36,1032,527,505
050,30,049,"Montana","Lewis and Clark County",5,37,1049,528,521
050,30,049,"Montana","Lewis and Clark County",5,38,1046,495,551
050,30,049,"Montana","Lewis and Clark County",5,39,1077,550,527
050,30,049,"Montana","Lewis and Clark County",5,40,1105,568,537
050,30,049,"Montana","Lewis and Clark County",5,41,1098,574,524
050,30,049,"Montana","Lewis and Clark County",5,42,1085,560,525
050,30,049,"Montana","Lewis and Clark County",5,43,975,517,458
050,30,049,"Montana","Lewis and Clark County",5,44,890,456,434
050,30,049,"Montana","Lewis and Clark County",5,45,914,467,447
050,30,049,"Montana","Lewis and Clark County",5,46,850,429,421
050,30,049,"Montana","Lewis and Clark County",5,47,840,428,412
050,30,049,"Montana","Lewis and Clark County",5,48,803,407,396
050,30,049,"Montana","Lewis and Clark County",5,49,810,409,401
050,30,049,"Montana","Lewis and Clark County",5,50,807,399,408
050,30,049,"Montana","Lewis and Clark County",5,51,834,419,415
050,30,049,"Montana","Lewis and Clark County",5,52,899,448,451
050,30,049,"Montana","Lewis and Clark County",5,53,871,449,422
050,30,049,"Montana","Lewis and Clark County",5,54,866,433,433
050,30,049,"Montana","Lewis and Clark County",5,55,872,428,444
050,30,049,"Montana","Lewis and Clark County",5,56,893,444,449
050,30,049,"Montana","Lewis and Clark County",5,57,894,434,460
050,30,049,"Montana","Lewis and Clark County",5,58,962,462,500
050,30,049,"Montana","Lewis and Clark County",5,59,1026,502,524
050,30,049,"Montana","Lewis and Clark County",5,60,1050,500,550
050,30,049,"Montana","Lewis and Clark County",5,61,1105,534,571
050,30,049,"Montana","Lewis and Clark County",5,62,1098,531,567
050,30,049,"Montana","Lewis and Clark County",5,63,1059,502,557
050,30,049,"Montana","Lewis and Clark County",5,64,1068,517,551
050,30,049,"Montana","Lewis and Clark County",5,65,1108,527,581
050,30,049,"Montana","Lewis and Clark County",5,66,1081,521,560
050,30,049,"Montana","Lewis and Clark County",5,67,1069,524,545
050,30,049,"Montana","Lewis and Clark County",5,68,984,459,525
050,30,049,"Montana","Lewis and Clark County",5,69,1005,465,540
050,30,049,"Montana","Lewis and Clark County",5,70,967,469,498
050,30,049,"Montana","Lewis and Clark County",5,71,940,460,480
050,30,049,"Montana","Lewis and Clark County",5,72,897,427,470
050,30,049,"Montana","Lewis and Clark County",5,73,858,438,420
050,30,049,"Montana","Lewis and Clark County",5,74,808,420,388
050,30,049,"Montana","Lewis and Clark County",5,75,712,360,352
050,30,049,"Montana","Lewis and Clark County",5,76,752,388,364
050,30,049,"Montana","Lewis and Clark County",5,77,476,237,239
050,30,049,"Montana","Lewis and Clark County",5,78,445,210,235
050,30,049,"Montana","Lewis and Clark County",5,79,451,208,243
050,30,049,"Montana","Lewis and Clark County",5,80,424,197,227
050,30,049,"Montana","Lewis and Clark County",5,81,383,186,197
050,30,049,"Montana","Lewis and Clark County",5,82,337,155,182
050,30,049,"Montana","Lewis and Clark County",5,83,271,125,146
050,30,049,"Montana","Lewis and Clark County",5,84,239,101,138
050,30,049,"Montana","Lewis and Clark County",5,85,1353,504,849
050,30,051,"Montana","Liberty County",1,0,27,14,13
050,30,051,"Montana","Liberty County",1,1,24,14,10
050,30,051,"Montana","Liberty County",1,2,19,9,10
050,30,051,"Montana","Liberty County",1,3,19,8,11
050,30,051,"Montana","Liberty County",1,4,22,13,9
050,30,051,"Montana","Liberty County",1,5,18,6,12
050,30,051,"Montana","Liberty County",1,6,27,15,12
050,30,051,"Montana","Liberty County",1,7,25,10,15
050,30,051,"Montana","Liberty County",1,8,20,8,12
050,30,051,"Montana","Liberty County",1,9,28,13,15
050,30,051,"Montana","Liberty County",1,10,24,10,14
050,30,051,"Montana","Liberty County",1,11,25,10,15
050,30,051,"Montana","Liberty County",1,12,23,11,12
050,30,051,"Montana","Liberty County",1,13,30,14,16
050,30,051,"Montana","Liberty County",1,14,25,13,12
050,30,051,"Montana","Liberty County",1,15,16,9,7
050,30,051,"Montana","Liberty County",1,16,18,10,8
050,30,051,"Montana","Liberty County",1,17,20,14,6
050,30,051,"Montana","Liberty County",1,18,22,13,9
050,30,051,"Montana","Liberty County",1,19,17,9,8
050,30,051,"Montana","Liberty County",1,20,17,7,10
050,30,051,"Montana","Liberty County",1,21,14,9,5
050,30,051,"Montana","Liberty County",1,22,18,10,8
050,30,051,"Montana","Liberty County",1,23,24,13,11
050,30,051,"Montana","Liberty County",1,24,23,14,9
050,30,051,"Montana","Liberty County",1,25,25,10,15
050,30,051,"Montana","Liberty County",1,26,22,9,13
050,30,051,"Montana","Liberty County",1,27,32,16,16
050,30,051,"Montana","Liberty County",1,28,22,11,11
050,30,051,"Montana","Liberty County",1,29,20,9,11
050,30,051,"Montana","Liberty County",1,30,27,12,15
050,30,051,"Montana","Liberty County",1,31,20,9,11
050,30,051,"Montana","Liberty County",1,32,18,8,10
050,30,051,"Montana","Liberty County",1,33,23,11,12
050,30,051,"Montana","Liberty County",1,34,23,12,11
050,30,051,"Montana","Liberty County",1,35,26,12,14
050,30,051,"Montana","Liberty County",1,36,24,13,11
050,30,051,"Montana","Liberty County",1,37,24,10,14
050,30,051,"Montana","Liberty County",1,38,21,9,12
050,30,051,"Montana","Liberty County",1,39,28,14,14
050,30,051,"Montana","Liberty County",1,40,25,13,12
050,30,051,"Montana","Liberty County",1,41,23,11,12
050,30,051,"Montana","Liberty County",1,42,23,12,11
050,30,051,"Montana","Liberty County",1,43,19,5,14
050,30,051,"Montana","Liberty County",1,44,15,8,7
050,30,051,"Montana","Liberty County",1,45,14,7,7
050,30,051,"Montana","Liberty County",1,46,17,10,7
050,30,051,"Montana","Liberty County",1,47,19,10,9
050,30,051,"Montana","Liberty County",1,48,13,5,8
050,30,051,"Montana","Liberty County",1,49,18,8,10
050,30,051,"Montana","Liberty County",1,50,16,9,7
050,30,051,"Montana","Liberty County",1,51,24,12,12
050,30,051,"Montana","Liberty County",1,52,30,14,16
050,30,051,"Montana","Liberty County",1,53,17,5,12
050,30,051,"Montana","Liberty County",1,54,24,12,12
050,30,051,"Montana","Liberty County",1,55,27,12,15
050,30,051,"Montana","Liberty County",1,56,23,10,13
050,30,051,"Montana","Liberty County",1,57,28,16,12
050,30,051,"Montana","Liberty County",1,58,29,15,14
050,30,051,"Montana","Liberty County",1,59,27,13,14
050,30,051,"Montana","Liberty County",1,60,30,15,15
050,30,051,"Montana","Liberty County",1,61,31,14,17
050,30,051,"Montana","Liberty County",1,62,39,18,21
050,30,051,"Montana","Liberty County",1,63,30,14,16
050,30,051,"Montana","Liberty County",1,64,35,15,20
050,30,051,"Montana","Liberty County",1,65,35,20,15
050,30,051,"Montana","Liberty County",1,66,30,20,10
050,30,051,"Montana","Liberty County",1,67,24,13,11
050,30,051,"Montana","Liberty County",1,68,23,12,11
050,30,051,"Montana","Liberty County",1,69,22,14,8
050,30,051,"Montana","Liberty County",1,70,22,9,13
050,30,051,"Montana","Liberty County",1,71,18,7,11
050,30,051,"Montana","Liberty County",1,72,19,10,9
050,30,051,"Montana","Liberty County",1,73,17,10,7
050,30,051,"Montana","Liberty County",1,74,13,8,5
050,30,051,"Montana","Liberty County",1,75,14,9,5
050,30,051,"Montana","Liberty County",1,76,14,9,5
050,30,051,"Montana","Liberty County",1,77,16,8,8
050,30,051,"Montana","Liberty County",1,78,18,9,9
050,30,051,"Montana","Liberty County",1,79,18,8,10
050,30,051,"Montana","Liberty County",1,80,16,6,10
050,30,051,"Montana","Liberty County",1,81,13,5,8
050,30,051,"Montana","Liberty County",1,82,13,8,5
050,30,051,"Montana","Liberty County",1,83,11,6,5
050,30,051,"Montana","Liberty County",1,84,9,2,7
050,30,051,"Montana","Liberty County",1,85,95,36,59
050,30,051,"Montana","Liberty County",2,0,25,14,11
050,30,051,"Montana","Liberty County",2,1,23,13,10
050,30,051,"Montana","Liberty County",2,2,19,9,10
050,30,051,"Montana","Liberty County",2,3,19,9,10
050,30,051,"Montana","Liberty County",2,4,21,12,9
050,30,051,"Montana","Liberty County",2,5,20,8,12
050,30,051,"Montana","Liberty County",2,6,25,12,13
050,30,051,"Montana","Liberty County",2,7,25,11,14
050,30,051,"Montana","Liberty County",2,8,23,9,14
050,30,051,"Montana","Liberty County",2,9,27,12,15
050,30,051,"Montana","Liberty County",2,10,26,11,15
050,30,051,"Montana","Liberty County",2,11,25,10,15
050,30,051,"Montana","Liberty County",2,12,22,10,12
050,30,051,"Montana","Liberty County",2,13,30,14,16
050,30,051,"Montana","Liberty County",2,14,25,12,13
050,30,051,"Montana","Liberty County",2,15,17,9,8
050,30,051,"Montana","Liberty County",2,16,18,10,8
050,30,051,"Montana","Liberty County",2,17,19,13,6
050,30,051,"Montana","Liberty County",2,18,21,12,9
050,30,051,"Montana","Liberty County",2,19,17,10,7
050,30,051,"Montana","Liberty County",2,20,18,7,11
050,30,051,"Montana","Liberty County",2,21,14,9,5
050,30,051,"Montana","Liberty County",2,22,18,10,8
050,30,051,"Montana","Liberty County",2,23,24,13,11
050,30,051,"Montana","Liberty County",2,24,23,14,9
050,30,051,"Montana","Liberty County",2,25,25,10,15
050,30,051,"Montana","Liberty County",2,26,21,9,12
050,30,051,"Montana","Liberty County",2,27,29,14,15
050,30,051,"Montana","Liberty County",2,28,24,12,12
050,30,051,"Montana","Liberty County",2,29,20,9,11
050,30,051,"Montana","Liberty County",2,30,26,12,14
050,30,051,"Montana","Liberty County",2,31,21,9,12
050,30,051,"Montana","Liberty County",2,32,19,9,10
050,30,051,"Montana","Liberty County",2,33,21,10,11
050,30,051,"Montana","Liberty County",2,34,23,12,11
050,30,051,"Montana","Liberty County",2,35,26,12,14
050,30,051,"Montana","Liberty County",2,36,24,13,11
050,30,051,"Montana","Liberty County",2,37,24,10,14
050,30,051,"Montana","Liberty County",2,38,22,10,12
050,30,051,"Montana","Liberty County",2,39,27,13,14
050,30,051,"Montana","Liberty County",2,40,24,13,11
050,30,051,"Montana","Liberty County",2,41,24,12,12
050,30,051,"Montana","Liberty County",2,42,23,12,11
050,30,051,"Montana","Liberty County",2,43,20,6,14
050,30,051,"Montana","Liberty County",2,44,16,8,8
050,30,051,"Montana","Liberty County",2,45,14,7,7
050,30,051,"Montana","Liberty County",2,46,16,9,7
050,30,051,"Montana","Liberty County",2,47,18,10,8
050,30,051,"Montana","Liberty County",2,48,14,6,8
050,30,051,"Montana","Liberty County",2,49,18,8,10
050,30,051,"Montana","Liberty County",2,50,17,9,8
050,30,051,"Montana","Liberty County",2,51,23,12,11
050,30,051,"Montana","Liberty County",2,52,28,13,15
050,30,051,"Montana","Liberty County",2,53,19,7,12
050,30,051,"Montana","Liberty County",2,54,23,11,12
050,30,051,"Montana","Liberty County",2,55,26,12,14
050,30,051,"Montana","Liberty County",2,56,23,10,13
050,30,051,"Montana","Liberty County",2,57,28,15,13
050,30,051,"Montana","Liberty County",2,58,27,14,13
050,30,051,"Montana","Liberty County",2,59,27,13,14
050,30,051,"Montana","Liberty County",2,60,29,14,15
050,30,051,"Montana","Liberty County",2,61,31,14,17
050,30,051,"Montana","Liberty County",2,62,37,17,20
050,30,051,"Montana","Liberty County",2,63,32,15,17
050,30,051,"Montana","Liberty County",2,64,34,15,19
050,30,051,"Montana","Liberty County",2,65,35,19,16
050,30,051,"Montana","Liberty County",2,66,31,20,11
050,30,051,"Montana","Liberty County",2,67,26,15,11
050,30,051,"Montana","Liberty County",2,68,23,12,11
050,30,051,"Montana","Liberty County",2,69,23,14,9
050,30,051,"Montana","Liberty County",2,70,22,10,12
050,30,051,"Montana","Liberty County",2,71,18,7,11
050,30,051,"Montana","Liberty County",2,72,18,10,8
050,30,051,"Montana","Liberty County",2,73,18,10,8
050,30,051,"Montana","Liberty County",2,74,13,8,5
050,30,051,"Montana","Liberty County",2,75,14,9,5
050,30,051,"Montana","Liberty County",2,76,14,9,5
050,30,051,"Montana","Liberty County",2,77,17,9,8
050,30,051,"Montana","Liberty County",2,78,17,9,8
050,30,051,"Montana","Liberty County",2,79,18,8,10
050,30,051,"Montana","Liberty County",2,80,16,6,10
050,30,051,"Montana","Liberty County",2,81,14,6,8
050,30,051,"Montana","Liberty County",2,82,13,7,6
050,30,051,"Montana","Liberty County",2,83,13,7,6
050,30,051,"Montana","Liberty County",2,84,8,2,6
050,30,051,"Montana","Liberty County",2,85,96,36,60
050,30,051,"Montana","Liberty County",3,0,30,16,14
050,30,051,"Montana","Liberty County",3,1,22,12,10
050,30,051,"Montana","Liberty County",3,2,20,11,9
050,30,051,"Montana","Liberty County",3,3,18,9,9
050,30,051,"Montana","Liberty County",3,4,19,12,7
050,30,051,"Montana","Liberty County",3,5,21,12,9
050,30,051,"Montana","Liberty County",3,6,19,8,11
050,30,051,"Montana","Liberty County",3,7,24,12,12
050,30,051,"Montana","Liberty County",3,8,26,11,15
050,30,051,"Montana","Liberty County",3,9,24,11,13
050,30,051,"Montana","Liberty County",3,10,26,14,12
050,30,051,"Montana","Liberty County",3,11,26,12,14
050,30,051,"Montana","Liberty County",3,12,24,8,16
050,30,051,"Montana","Liberty County",3,13,24,11,13
050,30,051,"Montana","Liberty County",3,14,27,13,14
050,30,051,"Montana","Liberty County",3,15,23,12,11
050,30,051,"Montana","Liberty County",3,16,19,9,10
050,30,051,"Montana","Liberty County",3,17,18,12,6
050,30,051,"Montana","Liberty County",3,18,21,13,8
050,30,051,"Montana","Liberty County",3,19,15,10,5
050,30,051,"Montana","Liberty County",3,20,18,9,9
050,30,051,"Montana","Liberty County",3,21,17,9,8
050,30,051,"Montana","Liberty County",3,22,13,7,6
050,30,051,"Montana","Liberty County",3,23,25,13,12
050,30,051,"Montana","Liberty County",3,24,21,12,9
050,30,051,"Montana","Liberty County",3,25,27,10,17
050,30,051,"Montana","Liberty County",3,26,22,10,12
050,30,051,"Montana","Liberty County",3,27,19,10,9
050,30,051,"Montana","Liberty County",3,28,31,15,16
050,30,051,"Montana","Liberty County",3,29,21,11,10
050,30,051,"Montana","Liberty County",3,30,20,9,11
050,30,051,"Montana","Liberty County",3,31,23,11,12
050,30,051,"Montana","Liberty County",3,32,23,10,13
050,30,051,"Montana","Liberty County",3,33,16,7,9
050,30,051,"Montana","Liberty County",3,34,21,10,11
050,30,051,"Montana","Liberty County",3,35,23,12,11
050,30,051,"Montana","Liberty County",3,36,24,13,11
050,30,051,"Montana","Liberty County",3,37,25,12,13
050,30,051,"Montana","Liberty County",3,38,22,10,12
050,30,051,"Montana","Liberty County",3,39,23,10,13
050,30,051,"Montana","Liberty County",3,40,28,12,16
050,30,051,"Montana","Liberty County",3,41,24,12,12
050,30,051,"Montana","Liberty County",3,42,22,12,10
050,30,051,"Montana","Liberty County",3,43,26,11,15
050,30,051,"Montana","Liberty County",3,44,22,7,15
050,30,051,"Montana","Liberty County",3,45,14,8,6
050,30,051,"Montana","Liberty County",3,46,14,6,8
050,30,051,"Montana","Liberty County",3,47,18,11,7
050,30,051,"Montana","Liberty County",3,48,18,11,7
050,30,051,"Montana","Liberty County",3,49,22,8,14
050,30,051,"Montana","Liberty County",3,50,16,8,8
050,30,051,"Montana","Liberty County",3,51,18,10,8
050,30,051,"Montana","Liberty County",3,52,23,10,13
050,30,051,"Montana","Liberty County",3,53,23,9,14
050,30,051,"Montana","Liberty County",3,54,25,11,14
050,30,051,"Montana","Liberty County",3,55,25,13,12
050,30,051,"Montana","Liberty County",3,56,21,9,12
050,30,051,"Montana","Liberty County",3,57,26,11,15
050,30,051,"Montana","Liberty County",3,58,25,13,12
050,30,051,"Montana","Liberty County",3,59,24,11,13
050,30,051,"Montana","Liberty County",3,60,27,12,15
050,30,051,"Montana","Liberty County",3,61,28,14,14
050,30,051,"Montana","Liberty County",3,62,29,13,16
050,30,051,"Montana","Liberty County",3,63,36,17,19
050,30,051,"Montana","Liberty County",3,64,38,18,20
050,30,051,"Montana","Liberty County",3,65,34,15,19
050,30,051,"Montana","Liberty County",3,66,30,18,12
050,30,051,"Montana","Liberty County",3,67,29,18,11
050,30,051,"Montana","Liberty County",3,68,23,13,10
050,30,051,"Montana","Liberty County",3,69,26,14,12
050,30,051,"Montana","Liberty County",3,70,23,14,9
050,30,051,"Montana","Liberty County",3,71,22,9,13
050,30,051,"Montana","Liberty County",3,72,17,8,9
050,30,051,"Montana","Liberty County",3,73,17,9,8
050,30,051,"Montana","Liberty County",3,74,20,11,9
050,30,051,"Montana","Liberty County",3,75,12,7,5
050,30,051,"Montana","Liberty County",3,76,12,8,4
050,30,051,"Montana","Liberty County",3,77,13,8,5
050,30,051,"Montana","Liberty County",3,78,15,9,6
050,30,051,"Montana","Liberty County",3,79,15,6,9
050,30,051,"Montana","Liberty County",3,80,16,7,9
050,30,051,"Montana","Liberty County",3,81,17,7,10
050,30,051,"Montana","Liberty County",3,82,14,6,8
050,30,051,"Montana","Liberty County",3,83,12,8,4
050,30,051,"Montana","Liberty County",3,84,6,1,5
050,30,051,"Montana","Liberty County",3,85,88,32,56
050,30,051,"Montana","Liberty County",4,0,23,14,9
050,30,051,"Montana","Liberty County",4,1,30,11,19
050,30,051,"Montana","Liberty County",4,2,22,10,12
050,30,051,"Montana","Liberty County",4,3,20,12,8
050,30,051,"Montana","Liberty County",4,4,22,13,9
050,30,051,"Montana","Liberty County",4,5,21,9,12
050,30,051,"Montana","Liberty County",4,6,20,12,8
050,30,051,"Montana","Liberty County",4,7,22,9,13
050,30,051,"Montana","Liberty County",4,8,26,16,10
050,30,051,"Montana","Liberty County",4,9,30,14,16
050,30,051,"Montana","Liberty County",4,10,28,11,17
050,30,051,"Montana","Liberty County",4,11,24,14,10
050,30,051,"Montana","Liberty County",4,12,24,11,13
050,30,051,"Montana","Liberty County",4,13,32,12,20
050,30,051,"Montana","Liberty County",4,14,23,11,12
050,30,051,"Montana","Liberty County",4,15,28,14,14
050,30,051,"Montana","Liberty County",4,16,26,12,14
050,30,051,"Montana","Liberty County",4,17,19,12,7
050,30,051,"Montana","Liberty County",4,18,19,12,7
050,30,051,"Montana","Liberty County",4,19,19,12,7
050,30,051,"Montana","Liberty County",4,20,15,8,7
050,30,051,"Montana","Liberty County",4,21,17,11,6
050,30,051,"Montana","Liberty County",4,22,14,6,8
050,30,051,"Montana","Liberty County",4,23,22,10,12
050,30,051,"Montana","Liberty County",4,24,23,13,10
050,30,051,"Montana","Liberty County",4,25,21,8,13
050,30,051,"Montana","Liberty County",4,26,20,10,10
050,30,051,"Montana","Liberty County",4,27,25,14,11
050,30,051,"Montana","Liberty County",4,28,17,9,8
050,30,051,"Montana","Liberty County",4,29,25,13,12
050,30,051,"Montana","Liberty County",4,30,22,11,11
050,30,051,"Montana","Liberty County",4,31,19,8,11
050,30,051,"Montana","Liberty County",4,32,26,12,14
050,30,051,"Montana","Liberty County",4,33,19,8,11
050,30,051,"Montana","Liberty County",4,34,21,8,13
050,30,051,"Montana","Liberty County",4,35,20,9,11
050,30,051,"Montana","Liberty County",4,36,25,13,12
050,30,051,"Montana","Liberty County",4,37,29,15,14
050,30,051,"Montana","Liberty County",4,38,26,12,14
050,30,051,"Montana","Liberty County",4,39,23,10,13
050,30,051,"Montana","Liberty County",4,40,22,9,13
050,30,051,"Montana","Liberty County",4,41,34,15,19
050,30,051,"Montana","Liberty County",4,42,23,11,12
050,30,051,"Montana","Liberty County",4,43,24,12,12
050,30,051,"Montana","Liberty County",4,44,30,15,15
050,30,051,"Montana","Liberty County",4,45,20,7,13
050,30,051,"Montana","Liberty County",4,46,14,7,7
050,30,051,"Montana","Liberty County",4,47,15,8,7
050,30,051,"Montana","Liberty County",4,48,16,10,6
050,30,051,"Montana","Liberty County",4,49,23,13,10
050,30,051,"Montana","Liberty County",4,50,21,8,13
050,30,051,"Montana","Liberty County",4,51,16,9,7
050,30,051,"Montana","Liberty County",4,52,21,11,10
050,30,051,"Montana","Liberty County",4,53,18,7,11
050,30,051,"Montana","Liberty County",4,54,26,11,15
050,30,051,"Montana","Liberty County",4,55,23,9,14
050,30,051,"Montana","Liberty County",4,56,21,11,10
050,30,051,"Montana","Liberty County",4,57,25,12,13
050,30,051,"Montana","Liberty County",4,58,26,11,15
050,30,051,"Montana","Liberty County",4,59,23,12,11
050,30,051,"Montana","Liberty County",4,60,30,14,16
050,30,051,"Montana","Liberty County",4,61,27,12,15
050,30,051,"Montana","Liberty County",4,62,25,12,13
050,30,051,"Montana","Liberty County",4,63,33,17,16
050,30,051,"Montana","Liberty County",4,64,37,17,20
050,30,051,"Montana","Liberty County",4,65,37,17,20
050,30,051,"Montana","Liberty County",4,66,31,15,16
050,30,051,"Montana","Liberty County",4,67,28,15,13
050,30,051,"Montana","Liberty County",4,68,28,18,10
050,30,051,"Montana","Liberty County",4,69,25,14,11
050,30,051,"Montana","Liberty County",4,70,24,13,11
050,30,051,"Montana","Liberty County",4,71,22,11,11
050,30,051,"Montana","Liberty County",4,72,21,10,11
050,30,051,"Montana","Liberty County",4,73,14,7,7
050,30,051,"Montana","Liberty County",4,74,19,10,9
050,30,051,"Montana","Liberty County",4,75,19,10,9
050,30,051,"Montana","Liberty County",4,76,14,8,6
050,30,051,"Montana","Liberty County",4,77,12,7,5
050,30,051,"Montana","Liberty County",4,78,13,9,4
050,30,051,"Montana","Liberty County",4,79,14,8,6
050,30,051,"Montana","Liberty County",4,80,13,5,8
050,30,051,"Montana","Liberty County",4,81,17,8,9
050,30,051,"Montana","Liberty County",4,82,17,7,10
050,30,051,"Montana","Liberty County",4,83,17,8,9
050,30,051,"Montana","Liberty County",4,84,7,4,3
050,30,051,"Montana","Liberty County",4,85,82,29,53
050,30,051,"Montana","Liberty County",5,0,23,14,9
050,30,051,"Montana","Liberty County",5,1,23,14,9
050,30,051,"Montana","Liberty County",5,2,28,9,19
050,30,051,"Montana","Liberty County",5,3,20,11,9
050,30,051,"Montana","Liberty County",5,4,21,13,8
050,30,051,"Montana","Liberty County",5,5,21,11,10
050,30,051,"Montana","Liberty County",5,6,24,12,12
050,30,051,"Montana","Liberty County",5,7,21,11,10
050,30,051,"Montana","Liberty County",5,8,22,9,13
050,30,051,"Montana","Liberty County",5,9,27,17,10
050,30,051,"Montana","Liberty County",5,10,30,14,16
050,30,051,"Montana","Liberty County",5,11,27,11,16
050,30,051,"Montana","Liberty County",5,12,22,11,11
050,30,051,"Montana","Liberty County",5,13,25,11,14
050,30,051,"Montana","Liberty County",5,14,31,12,19
050,30,051,"Montana","Liberty County",5,15,19,8,11
050,30,051,"Montana","Liberty County",5,16,30,14,16
050,30,051,"Montana","Liberty County",5,17,27,16,11
050,30,051,"Montana","Liberty County",5,18,19,10,9
050,30,051,"Montana","Liberty County",5,19,17,11,6
050,30,051,"Montana","Liberty County",5,20,18,10,8
050,30,051,"Montana","Liberty County",5,21,13,8,5
050,30,051,"Montana","Liberty County",5,22,19,9,10
050,30,051,"Montana","Liberty County",5,23,17,6,11
050,30,051,"Montana","Liberty County",5,24,18,10,8
050,30,051,"Montana","Liberty County",5,25,26,10,16
050,30,051,"Montana","Liberty County",5,26,17,10,7
050,30,051,"Montana","Liberty County",5,27,22,13,9
050,30,051,"Montana","Liberty County",5,28,27,15,12
050,30,051,"Montana","Liberty County",5,29,12,5,7
050,30,051,"Montana","Liberty County",5,30,26,12,14
050,30,051,"Montana","Liberty County",5,31,21,11,10
050,30,051,"Montana","Liberty County",5,32,24,11,13
050,30,051,"Montana","Liberty County",5,33,23,10,13
050,30,051,"Montana","Liberty County",5,34,21,10,11
050,30,051,"Montana","Liberty County",5,35,22,8,14
050,30,051,"Montana","Liberty County",5,36,21,10,11
050,30,051,"Montana","Liberty County",5,37,26,12,14
050,30,051,"Montana","Liberty County",5,38,27,15,12
050,30,051,"Montana","Liberty County",5,39,26,13,13
050,30,051,"Montana","Liberty County",5,40,22,9,13
050,30,051,"Montana","Liberty County",5,41,26,11,15
050,30,051,"Montana","Liberty County",5,42,27,14,13
050,30,051,"Montana","Liberty County",5,43,25,11,14
050,30,051,"Montana","Liberty County",5,44,24,12,12
050,30,051,"Montana","Liberty County",5,45,28,17,11
050,30,051,"Montana","Liberty County",5,46,21,6,15
050,30,051,"Montana","Liberty County",5,47,15,9,6
050,30,051,"Montana","Liberty County",5,48,11,6,5
050,30,051,"Montana","Liberty County",5,49,20,11,9
050,30,051,"Montana","Liberty County",5,50,20,11,9
050,30,051,"Montana","Liberty County",5,51,21,9,12
050,30,051,"Montana","Liberty County",5,52,17,8,9
050,30,051,"Montana","Liberty County",5,53,20,11,9
050,30,051,"Montana","Liberty County",5,54,19,7,12
050,30,051,"Montana","Liberty County",5,55,27,11,16
050,30,051,"Montana","Liberty County",5,56,19,7,12
050,30,051,"Montana","Liberty County",5,57,25,14,11
050,30,051,"Montana","Liberty County",5,58,21,10,11
050,30,051,"Montana","Liberty County",5,59,28,10,18
050,30,051,"Montana","Liberty County",5,60,27,13,14
050,30,051,"Montana","Liberty County",5,61,26,12,14
050,30,051,"Montana","Liberty County",5,62,25,11,14
050,30,051,"Montana","Liberty County",5,63,30,16,14
050,30,051,"Montana","Liberty County",5,64,33,15,18
050,30,051,"Montana","Liberty County",5,65,35,17,18
050,30,051,"Montana","Liberty County",5,66,36,17,19
050,30,051,"Montana","Liberty County",5,67,28,13,15
050,30,051,"Montana","Liberty County",5,68,26,14,12
050,30,051,"Montana","Liberty County",5,69,31,20,11
050,30,051,"Montana","Liberty County",5,70,24,14,10
050,30,051,"Montana","Liberty County",5,71,22,10,12
050,30,051,"Montana","Liberty County",5,72,22,12,10
050,30,051,"Montana","Liberty County",5,73,19,8,11
050,30,051,"Montana","Liberty County",5,74,16,8,8
050,30,051,"Montana","Liberty County",5,75,20,10,10
050,30,051,"Montana","Liberty County",5,76,20,10,10
050,30,051,"Montana","Liberty County",5,77,14,7,7
050,30,051,"Montana","Liberty County",5,78,12,8,4
050,30,051,"Montana","Liberty County",5,79,14,9,5
050,30,051,"Montana","Liberty County",5,80,12,7,5
050,30,051,"Montana","Liberty County",5,81,13,5,8
050,30,051,"Montana","Liberty County",5,82,16,7,9
050,30,051,"Montana","Liberty County",5,83,18,8,10
050,30,051,"Montana","Liberty County",5,84,12,4,8
050,30,051,"Montana","Liberty County",5,85,84,30,54
050,30,053,"Montana","Lincoln County",1,0,166,86,80
050,30,053,"Montana","Lincoln County",1,1,163,85,78
050,30,053,"Montana","Lincoln County",1,2,160,76,84
050,30,053,"Montana","Lincoln County",1,3,164,87,77
050,30,053,"Montana","Lincoln County",1,4,181,100,81
050,30,053,"Montana","Lincoln County",1,5,178,93,85
050,30,053,"Montana","Lincoln County",1,6,190,98,92
050,30,053,"Montana","Lincoln County",1,7,196,99,97
050,30,053,"Montana","Lincoln County",1,8,202,101,101
050,30,053,"Montana","Lincoln County",1,9,184,103,81
050,30,053,"Montana","Lincoln County",1,10,201,95,106
050,30,053,"Montana","Lincoln County",1,11,219,106,113
050,30,053,"Montana","Lincoln County",1,12,227,113,114
050,30,053,"Montana","Lincoln County",1,13,235,128,107
050,30,053,"Montana","Lincoln County",1,14,239,132,107
050,30,053,"Montana","Lincoln County",1,15,234,112,122
050,30,053,"Montana","Lincoln County",1,16,227,102,125
050,30,053,"Montana","Lincoln County",1,17,228,109,119
050,30,053,"Montana","Lincoln County",1,18,196,100,96
050,30,053,"Montana","Lincoln County",1,19,125,63,62
050,30,053,"Montana","Lincoln County",1,20,115,64,51
050,30,053,"Montana","Lincoln County",1,21,128,72,56
050,30,053,"Montana","Lincoln County",1,22,117,62,55
050,30,053,"Montana","Lincoln County",1,23,129,70,59
050,30,053,"Montana","Lincoln County",1,24,130,72,58
050,30,053,"Montana","Lincoln County",1,25,110,54,56
050,30,053,"Montana","Lincoln County",1,26,135,72,63
050,30,053,"Montana","Lincoln County",1,27,176,94,82
050,30,053,"Montana","Lincoln County",1,28,165,81,84
050,30,053,"Montana","Lincoln County",1,29,179,82,97
050,30,053,"Montana","Lincoln County",1,30,166,82,84
050,30,053,"Montana","Lincoln County",1,31,169,84,85
050,30,053,"Montana","Lincoln County",1,32,169,87,82
050,30,053,"Montana","Lincoln County",1,33,179,85,94
050,30,053,"Montana","Lincoln County",1,34,183,87,96
050,30,053,"Montana","Lincoln County",1,35,179,83,96
050,30,053,"Montana","Lincoln County",1,36,196,92,104
050,30,053,"Montana","Lincoln County",1,37,202,93,109
050,30,053,"Montana","Lincoln County",1,38,190,93,97
050,30,053,"Montana","Lincoln County",1,39,198,102,96
050,30,053,"Montana","Lincoln County",1,40,196,100,96
050,30,053,"Montana","Lincoln County",1,41,212,114,98
050,30,053,"Montana","Lincoln County",1,42,210,110,100
050,30,053,"Montana","Lincoln County",1,43,212,108,104
050,30,053,"Montana","Lincoln County",1,44,183,98,85
050,30,053,"Montana","Lincoln County",1,45,194,95,99
050,30,053,"Montana","Lincoln County",1,46,193,84,109
050,30,053,"Montana","Lincoln County",1,47,207,102,105
050,30,053,"Montana","Lincoln County",1,48,207,89,118
050,30,053,"Montana","Lincoln County",1,49,219,100,119
050,30,053,"Montana","Lincoln County",1,50,209,101,108
050,30,053,"Montana","Lincoln County",1,51,237,114,123
050,30,053,"Montana","Lincoln County",1,52,216,115,101
050,30,053,"Montana","Lincoln County",1,53,243,125,118
050,30,053,"Montana","Lincoln County",1,54,240,123,117
050,30,053,"Montana","Lincoln County",1,55,289,141,148
050,30,053,"Montana","Lincoln County",1,56,318,154,164
050,30,053,"Montana","Lincoln County",1,57,328,157,171
050,30,053,"Montana","Lincoln County",1,58,327,159,168
050,30,053,"Montana","Lincoln County",1,59,350,174,176
050,30,053,"Montana","Lincoln County",1,60,358,182,176
050,30,053,"Montana","Lincoln County",1,61,381,185,196
050,30,053,"Montana","Lincoln County",1,62,386,195,191
050,30,053,"Montana","Lincoln County",1,63,385,190,195
050,30,053,"Montana","Lincoln County",1,64,407,207,200
050,30,053,"Montana","Lincoln County",1,65,400,195,205
050,30,053,"Montana","Lincoln County",1,66,425,221,204
050,30,053,"Montana","Lincoln County",1,67,416,227,189
050,30,053,"Montana","Lincoln County",1,68,401,222,179
050,30,053,"Montana","Lincoln County",1,69,381,201,180
050,30,053,"Montana","Lincoln County",1,70,372,189,183
050,30,053,"Montana","Lincoln County",1,71,352,189,163
050,30,053,"Montana","Lincoln County",1,72,343,178,165
050,30,053,"Montana","Lincoln County",1,73,338,180,158
050,30,053,"Montana","Lincoln County",1,74,237,123,114
050,30,053,"Montana","Lincoln County",1,75,230,124,106
050,30,053,"Montana","Lincoln County",1,76,243,124,119
050,30,053,"Montana","Lincoln County",1,77,244,124,120
050,30,053,"Montana","Lincoln County",1,78,188,106,82
050,30,053,"Montana","Lincoln County",1,79,183,87,96
050,30,053,"Montana","Lincoln County",1,80,167,86,81
050,30,053,"Montana","Lincoln County",1,81,140,70,70
050,30,053,"Montana","Lincoln County",1,82,113,57,56
050,30,053,"Montana","Lincoln County",1,83,107,57,50
050,30,053,"Montana","Lincoln County",1,84,96,52,44
050,30,053,"Montana","Lincoln County",1,85,459,206,253
050,30,053,"Montana","Lincoln County",2,0,161,82,79
050,30,053,"Montana","Lincoln County",2,1,162,85,77
050,30,053,"Montana","Lincoln County",2,2,162,77,85
050,30,053,"Montana","Lincoln County",2,3,163,84,79
050,30,053,"Montana","Lincoln County",2,4,178,98,80
050,30,053,"Montana","Lincoln County",2,5,178,95,83
050,30,053,"Montana","Lincoln County",2,6,189,98,91
050,30,053,"Montana","Lincoln County",2,7,198,100,98
050,30,053,"Montana","Lincoln County",2,8,202,101,101
050,30,053,"Montana","Lincoln County",2,9,192,105,87
050,30,053,"Montana","Lincoln County",2,10,199,98,101
050,30,053,"Montana","Lincoln County",2,11,214,103,111
050,30,053,"Montana","Lincoln County",2,12,226,111,115
050,30,053,"Montana","Lincoln County",2,13,233,124,109
050,30,053,"Montana","Lincoln County",2,14,239,133,106
050,30,053,"Montana","Lincoln County",2,15,240,118,122
050,30,053,"Montana","Lincoln County",2,16,233,106,127
050,30,053,"Montana","Lincoln County",2,17,229,110,119
050,30,053,"Montana","Lincoln County",2,18,190,97,93
050,30,053,"Montana","Lincoln County",2,19,128,65,63
050,30,053,"Montana","Lincoln County",2,20,118,64,54
050,30,053,"Montana","Lincoln County",2,21,124,70,54
050,30,053,"Montana","Lincoln County",2,22,121,65,56
050,30,053,"Montana","Lincoln County",2,23,126,68,58
050,30,053,"Montana","Lincoln County",2,24,128,70,58
050,30,053,"Montana","Lincoln County",2,25,115,59,56
050,30,053,"Montana","Lincoln County",2,26,133,71,62
050,30,053,"Montana","Lincoln County",2,27,168,91,77
050,30,053,"Montana","Lincoln County",2,28,169,84,85
050,30,053,"Montana","Lincoln County",2,29,178,83,95
050,30,053,"Montana","Lincoln County",2,30,171,83,88
050,30,053,"Montana","Lincoln County",2,31,169,85,84
050,30,053,"Montana","Lincoln County",2,32,171,89,82
050,30,053,"Montana","Lincoln County",2,33,178,87,91
050,30,053,"Montana","Lincoln County",2,34,183,87,96
050,30,053,"Montana","Lincoln County",2,35,182,83,99
050,30,053,"Montana","Lincoln County",2,36,192,89,103
050,30,053,"Montana","Lincoln County",2,37,201,94,107
050,30,053,"Montana","Lincoln County",2,38,196,95,101
050,30,053,"Montana","Lincoln County",2,39,194,99,95
050,30,053,"Montana","Lincoln County",2,40,200,103,97
050,30,053,"Montana","Lincoln County",2,41,211,113,98
050,30,053,"Montana","Lincoln County",2,42,213,112,101
050,30,053,"Montana","Lincoln County",2,43,218,111,107
050,30,053,"Montana","Lincoln County",2,44,189,99,90
050,30,053,"Montana","Lincoln County",2,45,196,98,98
050,30,053,"Montana","Lincoln County",2,46,193,87,106
050,30,053,"Montana","Lincoln County",2,47,202,96,106
050,30,053,"Montana","Lincoln County",2,48,207,91,116
050,30,053,"Montana","Lincoln County",2,49,218,99,119
050,30,053,"Montana","Lincoln County",2,50,212,102,110
050,30,053,"Montana","Lincoln County",2,51,232,111,121
050,30,053,"Montana","Lincoln County",2,52,218,113,105
050,30,053,"Montana","Lincoln County",2,53,236,122,114
050,30,053,"Montana","Lincoln County",2,54,243,124,119
050,30,053,"Montana","Lincoln County",2,55,280,138,142
050,30,053,"Montana","Lincoln County",2,56,315,152,163
050,30,053,"Montana","Lincoln County",2,57,327,157,170
050,30,053,"Montana","Lincoln County",2,58,328,160,168
050,30,053,"Montana","Lincoln County",2,59,349,173,176
050,30,053,"Montana","Lincoln County",2,60,354,178,176
050,30,053,"Montana","Lincoln County",2,61,377,185,192
050,30,053,"Montana","Lincoln County",2,62,386,194,192
050,30,053,"Montana","Lincoln County",2,63,389,193,196
050,30,053,"Montana","Lincoln County",2,64,400,204,196
050,30,053,"Montana","Lincoln County",2,65,404,201,203
050,30,053,"Montana","Lincoln County",2,66,420,216,204
050,30,053,"Montana","Lincoln County",2,67,420,227,193
050,30,053,"Montana","Lincoln County",2,68,402,222,180
050,30,053,"Montana","Lincoln County",2,69,390,206,184
050,30,053,"Montana","Lincoln County",2,70,376,194,182
050,30,053,"Montana","Lincoln County",2,71,357,189,168
050,30,053,"Montana","Lincoln County",2,72,340,178,162
050,30,053,"Montana","Lincoln County",2,73,359,190,169
050,30,053,"Montana","Lincoln County",2,74,246,129,117
050,30,053,"Montana","Lincoln County",2,75,234,125,109
050,30,053,"Montana","Lincoln County",2,76,236,121,115
050,30,053,"Montana","Lincoln County",2,77,248,127,121
050,30,053,"Montana","Lincoln County",2,78,195,109,86
050,30,053,"Montana","Lincoln County",2,79,182,88,94
050,30,053,"Montana","Lincoln County",2,80,168,85,83
050,30,053,"Montana","Lincoln County",2,81,144,71,73
050,30,053,"Montana","Lincoln County",2,82,118,59,59
050,30,053,"Montana","Lincoln County",2,83,105,56,49
050,30,053,"Montana","Lincoln County",2,84,97,51,46
050,30,053,"Montana","Lincoln County",2,85,467,212,255
050,30,053,"Montana","Lincoln County",3,0,141,79,62
050,30,053,"Montana","Lincoln County",3,1,186,90,96
050,30,053,"Montana","Lincoln County",3,2,179,98,81
050,30,053,"Montana","Lincoln County",3,3,182,85,97
050,30,053,"Montana","Lincoln County",3,4,166,84,82
050,30,053,"Montana","Lincoln County",3,5,191,105,86
050,30,053,"Montana","Lincoln County",3,6,189,101,88
050,30,053,"Montana","Lincoln County",3,7,207,105,102
050,30,053,"Montana","Lincoln County",3,8,210,104,106
050,30,053,"Montana","Lincoln County",3,9,214,106,108
050,30,053,"Montana","Lincoln County",3,10,213,123,90
050,30,053,"Montana","Lincoln County",3,11,214,103,111
050,30,053,"Montana","Lincoln County",3,12,230,109,121
050,30,053,"Montana","Lincoln County",3,13,247,118,129
050,30,053,"Montana","Lincoln County",3,14,243,134,109
050,30,053,"Montana","Lincoln County",3,15,252,135,117
050,30,053,"Montana","Lincoln County",3,16,242,118,124
050,30,053,"Montana","Lincoln County",3,17,242,104,138
050,30,053,"Montana","Lincoln County",3,18,208,102,106
050,30,053,"Montana","Lincoln County",3,19,160,77,83
050,30,053,"Montana","Lincoln County",3,20,144,70,74
050,30,053,"Montana","Lincoln County",3,21,128,62,66
050,30,053,"Montana","Lincoln County",3,22,143,75,68
050,30,053,"Montana","Lincoln County",3,23,135,77,58
050,30,053,"Montana","Lincoln County",3,24,136,73,63
050,30,053,"Montana","Lincoln County",3,25,143,78,65
050,30,053,"Montana","Lincoln County",3,26,120,61,59
050,30,053,"Montana","Lincoln County",3,27,158,82,76
050,30,053,"Montana","Lincoln County",3,28,170,86,84
050,30,053,"Montana","Lincoln County",3,29,188,93,95
050,30,053,"Montana","Lincoln County",3,30,198,102,96
050,30,053,"Montana","Lincoln County",3,31,178,84,94
050,30,053,"Montana","Lincoln County",3,32,180,89,91
050,30,053,"Montana","Lincoln County",3,33,194,97,97
050,30,053,"Montana","Lincoln County",3,34,184,86,98
050,30,053,"Montana","Lincoln County",3,35,206,96,110
050,30,053,"Montana","Lincoln County",3,36,197,91,106
050,30,053,"Montana","Lincoln County",3,37,196,84,112
050,30,053,"Montana","Lincoln County",3,38,215,100,115
050,30,053,"Montana","Lincoln County",3,39,210,106,104
050,30,053,"Montana","Lincoln County",3,40,206,106,100
050,30,053,"Montana","Lincoln County",3,41,217,110,107
050,30,053,"Montana","Lincoln County",3,42,221,117,104
050,30,053,"Montana","Lincoln County",3,43,219,117,102
050,30,053,"Montana","Lincoln County",3,44,234,116,118
050,30,053,"Montana","Lincoln County",3,45,202,110,92
050,30,053,"Montana","Lincoln County",3,46,219,103,116
050,30,053,"Montana","Lincoln County",3,47,205,94,111
050,30,053,"Montana","Lincoln County",3,48,221,111,110
050,30,053,"Montana","Lincoln County",3,49,227,99,128
050,30,053,"Montana","Lincoln County",3,50,237,117,120
050,30,053,"Montana","Lincoln County",3,51,224,109,115
050,30,053,"Montana","Lincoln County",3,52,247,123,124
050,30,053,"Montana","Lincoln County",3,53,232,117,115
050,30,053,"Montana","Lincoln County",3,54,241,125,116
050,30,053,"Montana","Lincoln County",3,55,253,135,118
050,30,053,"Montana","Lincoln County",3,56,297,151,146
050,30,053,"Montana","Lincoln County",3,57,317,152,165
050,30,053,"Montana","Lincoln County",3,58,339,166,173
050,30,053,"Montana","Lincoln County",3,59,345,169,176
050,30,053,"Montana","Lincoln County",3,60,364,178,186
050,30,053,"Montana","Lincoln County",3,61,375,190,185
050,30,053,"Montana","Lincoln County",3,62,385,196,189
050,30,053,"Montana","Lincoln County",3,63,413,214,199
050,30,053,"Montana","Lincoln County",3,64,411,207,204
050,30,053,"Montana","Lincoln County",3,65,408,201,207
050,30,053,"Montana","Lincoln County",3,66,426,214,212
050,30,053,"Montana","Lincoln County",3,67,436,224,212
050,30,053,"Montana","Lincoln County",3,68,428,236,192
050,30,053,"Montana","Lincoln County",3,69,408,224,184
050,30,053,"Montana","Lincoln County",3,70,390,206,184
050,30,053,"Montana","Lincoln County",3,71,380,193,187
050,30,053,"Montana","Lincoln County",3,72,363,188,175
050,30,053,"Montana","Lincoln County",3,73,328,174,154
050,30,053,"Montana","Lincoln County",3,74,345,183,162
050,30,053,"Montana","Lincoln County",3,75,241,123,118
050,30,053,"Montana","Lincoln County",3,76,229,122,107
050,30,053,"Montana","Lincoln County",3,77,232,120,112
050,30,053,"Montana","Lincoln County",3,78,232,120,112
050,30,053,"Montana","Lincoln County",3,79,189,100,89
050,30,053,"Montana","Lincoln County",3,80,162,78,84
050,30,053,"Montana","Lincoln County",3,81,165,85,80
050,30,053,"Montana","Lincoln County",3,82,137,69,68
050,30,053,"Montana","Lincoln County",3,83,105,54,51
050,30,053,"Montana","Lincoln County",3,84,102,53,49
050,30,053,"Montana","Lincoln County",3,85,486,217,269
050,30,053,"Montana","Lincoln County",4,0,167,96,71
050,30,053,"Montana","Lincoln County",4,1,165,88,77
050,30,053,"Montana","Lincoln County",4,2,200,98,102
050,30,053,"Montana","Lincoln County",4,3,194,102,92
050,30,053,"Montana","Lincoln County",4,4,181,87,94
050,30,053,"Montana","Lincoln County",4,5,185,96,89
050,30,053,"Montana","Lincoln County",4,6,202,112,90
050,30,053,"Montana","Lincoln County",4,7,196,109,87
050,30,053,"Montana","Lincoln County",4,8,216,109,107
050,30,053,"Montana","Lincoln County",4,9,226,117,109
050,30,053,"Montana","Lincoln County",4,10,221,113,108
050,30,053,"Montana","Lincoln County",4,11,227,125,102
050,30,053,"Montana","Lincoln County",4,12,220,103,117
050,30,053,"Montana","Lincoln County",4,13,241,112,129
050,30,053,"Montana","Lincoln County",4,14,259,124,135
050,30,053,"Montana","Lincoln County",4,15,243,129,114
050,30,053,"Montana","Lincoln County",4,16,260,137,123
050,30,053,"Montana","Lincoln County",4,17,233,117,116
050,30,053,"Montana","Lincoln County",4,18,209,93,116
050,30,053,"Montana","Lincoln County",4,19,175,77,98
050,30,053,"Montana","Lincoln County",4,20,172,81,91
050,30,053,"Montana","Lincoln County",4,21,149,76,73
050,30,053,"Montana","Lincoln County",4,22,140,68,72
050,30,053,"Montana","Lincoln County",4,23,159,79,80
050,30,053,"Montana","Lincoln County",4,24,141,78,63
050,30,053,"Montana","Lincoln County",4,25,150,84,66
050,30,053,"Montana","Lincoln County",4,26,148,84,64
050,30,053,"Montana","Lincoln County",4,27,130,64,66
050,30,053,"Montana","Lincoln County",4,28,173,87,86
050,30,053,"Montana","Lincoln County",4,29,207,105,102
050,30,053,"Montana","Lincoln County",4,30,198,99,99
050,30,053,"Montana","Lincoln County",4,31,211,102,109
050,30,053,"Montana","Lincoln County",4,32,188,95,93
050,30,053,"Montana","Lincoln County",4,33,198,93,105
050,30,053,"Montana","Lincoln County",4,34,221,109,112
050,30,053,"Montana","Lincoln County",4,35,222,101,121
050,30,053,"Montana","Lincoln County",4,36,230,113,117
050,30,053,"Montana","Lincoln County",4,37,218,102,116
050,30,053,"Montana","Lincoln County",4,38,220,97,123
050,30,053,"Montana","Lincoln County",4,39,227,108,119
050,30,053,"Montana","Lincoln County",4,40,242,118,124
050,30,053,"Montana","Lincoln County",4,41,233,114,119
050,30,053,"Montana","Lincoln County",4,42,227,112,115
050,30,053,"Montana","Lincoln County",4,43,240,131,109
050,30,053,"Montana","Lincoln County",4,44,228,119,109
050,30,053,"Montana","Lincoln County",4,45,245,123,122
050,30,053,"Montana","Lincoln County",4,46,218,117,101
050,30,053,"Montana","Lincoln County",4,47,242,123,119
050,30,053,"Montana","Lincoln County",4,48,212,95,117
050,30,053,"Montana","Lincoln County",4,49,238,120,118
050,30,053,"Montana","Lincoln County",4,50,228,99,129
050,30,053,"Montana","Lincoln County",4,51,256,130,126
050,30,053,"Montana","Lincoln County",4,52,253,120,133
050,30,053,"Montana","Lincoln County",4,53,263,127,136
050,30,053,"Montana","Lincoln County",4,54,256,130,126
050,30,053,"Montana","Lincoln County",4,55,258,135,123
050,30,053,"Montana","Lincoln County",4,56,268,143,125
050,30,053,"Montana","Lincoln County",4,57,314,149,165
050,30,053,"Montana","Lincoln County",4,58,341,161,180
050,30,053,"Montana","Lincoln County",4,59,366,179,187
050,30,053,"Montana","Lincoln County",4,60,382,185,197
050,30,053,"Montana","Lincoln County",4,61,399,190,209
050,30,053,"Montana","Lincoln County",4,62,397,205,192
050,30,053,"Montana","Lincoln County",4,63,408,217,191
050,30,053,"Montana","Lincoln County",4,64,432,218,214
050,30,053,"Montana","Lincoln County",4,65,438,226,212
050,30,053,"Montana","Lincoln County",4,66,419,206,213
050,30,053,"Montana","Lincoln County",4,67,437,223,214
050,30,053,"Montana","Lincoln County",4,68,431,224,207
050,30,053,"Montana","Lincoln County",4,69,420,230,190
050,30,053,"Montana","Lincoln County",4,70,430,234,196
050,30,053,"Montana","Lincoln County",4,71,392,205,187
050,30,053,"Montana","Lincoln County",4,72,374,185,189
050,30,053,"Montana","Lincoln County",4,73,358,188,170
050,30,053,"Montana","Lincoln County",4,74,320,172,148
050,30,053,"Montana","Lincoln County",4,75,328,174,154
050,30,053,"Montana","Lincoln County",4,76,230,117,113
050,30,053,"Montana","Lincoln County",4,77,227,117,110
050,30,053,"Montana","Lincoln County",4,78,227,124,103
050,30,053,"Montana","Lincoln County",4,79,227,112,115
050,30,053,"Montana","Lincoln County",4,80,165,89,76
050,30,053,"Montana","Lincoln County",4,81,148,71,77
050,30,053,"Montana","Lincoln County",4,82,153,81,72
050,30,053,"Montana","Lincoln County",4,83,127,63,64
050,30,053,"Montana","Lincoln County",4,84,95,47,48
050,30,053,"Montana","Lincoln County",4,85,496,223,273
050,30,053,"Montana","Lincoln County",5,0,168,96,72
050,30,053,"Montana","Lincoln County",5,1,174,95,79
050,30,053,"Montana","Lincoln County",5,2,169,90,79
050,30,053,"Montana","Lincoln County",5,3,209,103,106
050,30,053,"Montana","Lincoln County",5,4,184,102,82
050,30,053,"Montana","Lincoln County",5,5,200,96,104
050,30,053,"Montana","Lincoln County",5,6,198,102,96
050,30,053,"Montana","Lincoln County",5,7,202,108,94
050,30,053,"Montana","Lincoln County",5,8,204,115,89
050,30,053,"Montana","Lincoln County",5,9,228,119,109
050,30,053,"Montana","Lincoln County",5,10,232,115,117
050,30,053,"Montana","Lincoln County",5,11,241,129,112
050,30,053,"Montana","Lincoln County",5,12,229,126,103
050,30,053,"Montana","Lincoln County",5,13,222,101,121
050,30,053,"Montana","Lincoln County",5,14,244,122,122
050,30,053,"Montana","Lincoln County",5,15,272,122,150
050,30,053,"Montana","Lincoln County",5,16,241,130,111
050,30,053,"Montana","Lincoln County",5,17,268,144,124
050,30,053,"Montana","Lincoln County",5,18,204,106,98
050,30,053,"Montana","Lincoln County",5,19,157,77,80
050,30,053,"Montana","Lincoln County",5,20,179,78,101
050,30,053,"Montana","Lincoln County",5,21,177,88,89
050,30,053,"Montana","Lincoln County",5,22,154,75,79
050,30,053,"Montana","Lincoln County",5,23,153,80,73
050,30,053,"Montana","Lincoln County",5,24,170,82,88
050,30,053,"Montana","Lincoln County",5,25,148,81,67
050,30,053,"Montana","Lincoln County",5,26,169,90,79
050,30,053,"Montana","Lincoln County",5,27,170,96,74
050,30,053,"Montana","Lincoln County",5,28,152,74,78
050,30,053,"Montana","Lincoln County",5,29,186,97,89
050,30,053,"Montana","Lincoln County",5,30,206,110,96
050,30,053,"Montana","Lincoln County",5,31,200,96,104
050,30,053,"Montana","Lincoln County",5,32,212,99,113
050,30,053,"Montana","Lincoln County",5,33,195,90,105
050,30,053,"Montana","Lincoln County",5,34,205,97,108
050,30,053,"Montana","Lincoln County",5,35,223,108,115
050,30,053,"Montana","Lincoln County",5,36,223,102,121
050,30,053,"Montana","Lincoln County",5,37,239,121,118
050,30,053,"Montana","Lincoln County",5,38,227,110,117
050,30,053,"Montana","Lincoln County",5,39,231,108,123
050,30,053,"Montana","Lincoln County",5,40,234,112,122
050,30,053,"Montana","Lincoln County",5,41,250,125,125
050,30,053,"Montana","Lincoln County",5,42,237,109,128
050,30,053,"Montana","Lincoln County",5,43,239,127,112
050,30,053,"Montana","Lincoln County",5,44,246,134,112
050,30,053,"Montana","Lincoln County",5,45,229,122,107
050,30,053,"Montana","Lincoln County",5,46,250,125,125
050,30,053,"Montana","Lincoln County",5,47,224,116,108
050,30,053,"Montana","Lincoln County",5,48,250,132,118
050,30,053,"Montana","Lincoln County",5,49,211,94,117
050,30,053,"Montana","Lincoln County",5,50,247,126,121
050,30,053,"Montana","Lincoln County",5,51,234,103,131
050,30,053,"Montana","Lincoln County",5,52,254,132,122
050,30,053,"Montana","Lincoln County",5,53,251,119,132
050,30,053,"Montana","Lincoln County",5,54,274,138,136
050,30,053,"Montana","Lincoln County",5,55,273,137,136
050,30,053,"Montana","Lincoln County",5,56,271,139,132
050,30,053,"Montana","Lincoln County",5,57,282,150,132
050,30,053,"Montana","Lincoln County",5,58,326,151,175
050,30,053,"Montana","Lincoln County",5,59,351,163,188
050,30,053,"Montana","Lincoln County",5,60,372,184,188
050,30,053,"Montana","Lincoln County",5,61,405,196,209
050,30,053,"Montana","Lincoln County",5,62,403,195,208
050,30,053,"Montana","Lincoln County",5,63,416,220,196
050,30,053,"Montana","Lincoln County",5,64,411,218,193
050,30,053,"Montana","Lincoln County",5,65,432,222,210
050,30,053,"Montana","Lincoln County",5,66,442,226,216
050,30,053,"Montana","Lincoln County",5,67,419,209,210
050,30,053,"Montana","Lincoln County",5,68,428,219,209
050,30,053,"Montana","Lincoln County",5,69,427,217,210
050,30,053,"Montana","Lincoln County",5,70,425,234,191
050,30,053,"Montana","Lincoln County",5,71,411,219,192
050,30,053,"Montana","Lincoln County",5,72,391,203,188
050,30,053,"Montana","Lincoln County",5,73,371,187,184
050,30,053,"Montana","Lincoln County",5,74,346,182,164
050,30,053,"Montana","Lincoln County",5,75,319,170,149
050,30,053,"Montana","Lincoln County",5,76,317,168,149
050,30,053,"Montana","Lincoln County",5,77,231,116,115
050,30,053,"Montana","Lincoln County",5,78,219,116,103
050,30,053,"Montana","Lincoln County",5,79,218,115,103
050,30,053,"Montana","Lincoln County",5,80,211,104,107
050,30,053,"Montana","Lincoln County",5,81,160,88,72
050,30,053,"Montana","Lincoln County",5,82,144,71,73
050,30,053,"Montana","Lincoln County",5,83,141,73,68
050,30,053,"Montana","Lincoln County",5,84,114,54,60
050,30,053,"Montana","Lincoln County",5,85,524,237,287
050,30,055,"Montana","McCone County",1,0,14,8,6
050,30,055,"Montana","McCone County",1,1,19,13,6
050,30,055,"Montana","McCone County",1,2,16,11,5
050,30,055,"Montana","McCone County",1,3,18,12,6
050,30,055,"Montana","McCone County",1,4,24,14,10
050,30,055,"Montana","McCone County",1,5,22,13,9
050,30,055,"Montana","McCone County",1,6,21,9,12
050,30,055,"Montana","McCone County",1,7,17,8,9
050,30,055,"Montana","McCone County",1,8,16,5,11
050,30,055,"Montana","McCone County",1,9,15,6,9
050,30,055,"Montana","McCone County",1,10,19,12,7
050,30,055,"Montana","McCone County",1,11,30,14,16
050,30,055,"Montana","McCone County",1,12,23,12,11
050,30,055,"Montana","McCone County",1,13,25,10,15
050,30,055,"Montana","McCone County",1,14,21,7,14
050,30,055,"Montana","McCone County",1,15,23,11,12
050,30,055,"Montana","McCone County",1,16,21,11,10
050,30,055,"Montana","McCone County",1,17,24,13,11
050,30,055,"Montana","McCone County",1,18,15,11,4
050,30,055,"Montana","McCone County",1,19,13,8,5
050,30,055,"Montana","McCone County",1,20,17,11,6
050,30,055,"Montana","McCone County",1,21,13,7,6
050,30,055,"Montana","McCone County",1,22,12,4,8
050,30,055,"Montana","McCone County",1,23,14,6,8
050,30,055,"Montana","McCone County",1,24,15,6,9
050,30,055,"Montana","McCone County",1,25,21,12,9
050,30,055,"Montana","McCone County",1,26,25,15,10
050,30,055,"Montana","McCone County",1,27,16,8,8
050,30,055,"Montana","McCone County",1,28,18,11,7
050,30,055,"Montana","McCone County",1,29,17,9,8
050,30,055,"Montana","McCone County",1,30,13,8,5
050,30,055,"Montana","McCone County",1,31,15,7,8
050,30,055,"Montana","McCone County",1,32,24,15,9
050,30,055,"Montana","McCone County",1,33,22,11,11
050,30,055,"Montana","McCone County",1,34,17,9,8
050,30,055,"Montana","McCone County",1,35,14,5,9
050,30,055,"Montana","McCone County",1,36,21,9,12
050,30,055,"Montana","McCone County",1,37,17,5,12
050,30,055,"Montana","McCone County",1,38,15,10,5
050,30,055,"Montana","McCone County",1,39,19,12,7
050,30,055,"Montana","McCone County",1,40,12,9,3
050,30,055,"Montana","McCone County",1,41,17,8,9
050,30,055,"Montana","McCone County",1,42,19,8,11
050,30,055,"Montana","McCone County",1,43,19,8,11
050,30,055,"Montana","McCone County",1,44,17,9,8
050,30,055,"Montana","McCone County",1,45,17,10,7
050,30,055,"Montana","McCone County",1,46,13,8,5
050,30,055,"Montana","McCone County",1,47,12,4,8
050,30,055,"Montana","McCone County",1,48,19,8,11
050,30,055,"Montana","McCone County",1,49,22,12,10
050,30,055,"Montana","McCone County",1,50,17,6,11
050,30,055,"Montana","McCone County",1,51,14,7,7
050,30,055,"Montana","McCone County",1,52,13,7,6
050,30,055,"Montana","McCone County",1,53,18,10,8
050,30,055,"Montana","McCone County",1,54,22,11,11
050,30,055,"Montana","McCone County",1,55,19,8,11
050,30,055,"Montana","McCone County",1,56,22,9,13
050,30,055,"Montana","McCone County",1,57,31,16,15
050,30,055,"Montana","McCone County",1,58,29,15,14
050,30,055,"Montana","McCone County",1,59,28,16,12
050,30,055,"Montana","McCone County",1,60,29,21,8
050,30,055,"Montana","McCone County",1,61,31,20,11
050,30,055,"Montana","McCone County",1,62,24,12,12
050,30,055,"Montana","McCone County",1,63,28,13,15
050,30,055,"Montana","McCone County",1,64,34,15,19
050,30,055,"Montana","McCone County",1,65,30,16,14
050,30,055,"Montana","McCone County",1,66,34,20,14
050,30,055,"Montana","McCone County",1,67,32,16,16
050,30,055,"Montana","McCone County",1,68,33,16,17
050,30,055,"Montana","McCone County",1,69,26,10,16
050,30,055,"Montana","McCone County",1,70,20,10,10
050,30,055,"Montana","McCone County",1,71,25,15,10
050,30,055,"Montana","McCone County",1,72,18,10,8
050,30,055,"Montana","McCone County",1,73,27,15,12
050,30,055,"Montana","McCone County",1,74,18,11,7
050,30,055,"Montana","McCone County",1,75,14,6,8
050,30,055,"Montana","McCone County",1,76,10,7,3
050,30,055,"Montana","McCone County",1,77,18,9,9
050,30,055,"Montana","McCone County",1,78,15,9,6
050,30,055,"Montana","McCone County",1,79,14,7,7
050,30,055,"Montana","McCone County",1,80,14,6,8
050,30,055,"Montana","McCone County",1,81,14,5,9
050,30,055,"Montana","McCone County",1,82,10,4,6
050,30,055,"Montana","McCone County",1,83,15,7,8
050,30,055,"Montana","McCone County",1,84,16,9,7
050,30,055,"Montana","McCone County",1,85,56,28,28
050,30,055,"Montana","McCone County",2,0,15,8,7
050,30,055,"Montana","McCone County",2,1,17,11,6
050,30,055,"Montana","McCone County",2,2,17,12,5
050,30,055,"Montana","McCone County",2,3,18,12,6
050,30,055,"Montana","McCone County",2,4,23,14,9
050,30,055,"Montana","McCone County",2,5,22,13,9
050,30,055,"Montana","McCone County",2,6,21,10,11
050,30,055,"Montana","McCone County",2,7,18,8,10
050,30,055,"Montana","McCone County",2,8,16,6,10
050,30,055,"Montana","McCone County",2,9,15,6,9
050,30,055,"Montana","McCone County",2,10,18,11,7
050,30,055,"Montana","McCone County",2,11,28,14,14
050,30,055,"Montana","McCone County",2,12,25,13,12
050,30,055,"Montana","McCone County",2,13,24,10,14
050,30,055,"Montana","McCone County",2,14,22,8,14
050,30,055,"Montana","McCone County",2,15,23,10,13
050,30,055,"Montana","McCone County",2,16,21,11,10
050,30,055,"Montana","McCone County",2,17,23,13,10
050,30,055,"Montana","McCone County",2,18,15,10,5
050,30,055,"Montana","McCone County",2,19,13,8,5
050,30,055,"Montana","McCone County",2,20,16,10,6
050,30,055,"Montana","McCone County",2,21,14,8,6
050,30,055,"Montana","McCone County",2,22,12,4,8
050,30,055,"Montana","McCone County",2,23,14,6,8
050,30,055,"Montana","McCone County",2,24,15,6,9
050,30,055,"Montana","McCone County",2,25,20,11,9
050,30,055,"Montana","McCone County",2,26,24,14,10
050,30,055,"Montana","McCone County",2,27,19,10,9
050,30,055,"Montana","McCone County",2,28,19,11,8
050,30,055,"Montana","McCone County",2,29,17,9,8
050,30,055,"Montana","McCone County",2,30,14,8,6
050,30,055,"Montana","McCone County",2,31,15,8,7
050,30,055,"Montana","McCone County",2,32,22,13,9
050,30,055,"Montana","McCone County",2,33,21,11,10
050,30,055,"Montana","McCone County",2,34,18,9,9
050,30,055,"Montana","McCone County",2,35,14,6,8
050,30,055,"Montana","McCone County",2,36,19,8,11
050,30,055,"Montana","McCone County",2,37,18,6,12
050,30,055,"Montana","McCone County",2,38,16,9,7
050,30,055,"Montana","McCone County",2,39,19,12,7
050,30,055,"Montana","McCone County",2,40,14,10,4
050,30,055,"Montana","McCone County",2,41,16,8,8
050,30,055,"Montana","McCone County",2,42,18,8,10
050,30,055,"Montana","McCone County",2,43,19,8,11
050,30,055,"Montana","McCone County",2,44,18,9,9
050,30,055,"Montana","McCone County",2,45,17,10,7
050,30,055,"Montana","McCone County",2,46,13,8,5
050,30,055,"Montana","McCone County",2,47,12,5,7
050,30,055,"Montana","McCone County",2,48,18,8,10
050,30,055,"Montana","McCone County",2,49,22,12,10
050,30,055,"Montana","McCone County",2,50,18,7,11
050,30,055,"Montana","McCone County",2,51,15,7,8
050,30,055,"Montana","McCone County",2,52,13,7,6
050,30,055,"Montana","McCone County",2,53,18,10,8
050,30,055,"Montana","McCone County",2,54,20,10,10
050,30,055,"Montana","McCone County",2,55,20,9,11
050,30,055,"Montana","McCone County",2,56,22,9,13
050,30,055,"Montana","McCone County",2,57,30,15,15
050,30,055,"Montana","McCone County",2,58,28,14,14
050,30,055,"Montana","McCone County",2,59,29,16,13
050,30,055,"Montana","McCone County",2,60,29,20,9
050,30,055,"Montana","McCone County",2,61,30,20,10
050,30,055,"Montana","McCone County",2,62,26,14,12
050,30,055,"Montana","McCone County",2,63,26,12,14
050,30,055,"Montana","McCone County",2,64,33,15,18
050,30,055,"Montana","McCone County",2,65,32,16,16
050,30,055,"Montana","McCone County",2,66,34,20,14
050,30,055,"Montana","McCone County",2,67,32,17,15
050,30,055,"Montana","McCone County",2,68,33,16,17
050,30,055,"Montana","McCone County",2,69,28,11,17
050,30,055,"Montana","McCone County",2,70,21,10,11
050,30,055,"Montana","McCone County",2,71,23,13,10
050,30,055,"Montana","McCone County",2,72,19,11,8
050,30,055,"Montana","McCone County",2,73,27,15,12
050,30,055,"Montana","McCone County",2,74,18,11,7
050,30,055,"Montana","McCone County",2,75,14,7,7
050,30,055,"Montana","McCone County",2,76,10,6,4
050,30,055,"Montana","McCone County",2,77,16,8,8
050,30,055,"Montana","McCone County",2,78,16,9,7
050,30,055,"Montana","McCone County",2,79,14,7,7
050,30,055,"Montana","McCone County",2,80,14,6,8
050,30,055,"Montana","McCone County",2,81,14,5,9
050,30,055,"Montana","McCone County",2,82,10,4,6
050,30,055,"Montana","McCone County",2,83,15,7,8
050,30,055,"Montana","McCone County",2,84,15,8,7
050,30,055,"Montana","McCone County",2,85,59,30,29
050,30,055,"Montana","McCone County",3,0,21,8,13
050,30,055,"Montana","McCone County",3,1,14,8,6
050,30,055,"Montana","McCone County",3,2,16,10,6
050,30,055,"Montana","McCone County",3,3,15,10,5
050,30,055,"Montana","McCone County",3,4,18,12,6
050,30,055,"Montana","McCone County",3,5,20,12,8
050,30,055,"Montana","McCone County",3,6,20,13,7
050,30,055,"Montana","McCone County",3,7,21,11,10
050,30,055,"Montana","McCone County",3,8,17,8,9
050,30,055,"Montana","McCone County",3,9,18,8,10
050,30,055,"Montana","McCone County",3,10,12,4,8
050,30,055,"Montana","McCone County",3,11,20,12,8
050,30,055,"Montana","McCone County",3,12,26,12,14
050,30,055,"Montana","McCone County",3,13,25,13,12
050,30,055,"Montana","McCone County",3,14,25,10,15
050,30,055,"Montana","McCone County",3,15,22,8,14
050,30,055,"Montana","McCone County",3,16,24,11,13
050,30,055,"Montana","McCone County",3,17,21,11,10
050,30,055,"Montana","McCone County",3,18,18,10,8
050,30,055,"Montana","McCone County",3,19,12,9,3
050,30,055,"Montana","McCone County",3,20,12,9,3
050,30,055,"Montana","McCone County",3,21,18,10,8
050,30,055,"Montana","McCone County",3,22,15,9,6
050,30,055,"Montana","McCone County",3,23,15,6,9
050,30,055,"Montana","McCone County",3,24,16,5,11
050,30,055,"Montana","McCone County",3,25,11,5,6
050,30,055,"Montana","McCone County",3,26,19,11,8
050,30,055,"Montana","McCone County",3,27,24,13,11
050,30,055,"Montana","McCone County",3,28,15,10,5
050,30,055,"Montana","McCone County",3,29,23,15,8
050,30,055,"Montana","McCone County",3,30,19,10,9
050,30,055,"Montana","McCone County",3,31,14,8,6
050,30,055,"Montana","McCone County",3,32,15,8,7
050,30,055,"Montana","McCone County",3,33,20,11,9
050,30,055,"Montana","McCone County",3,34,21,11,10
050,30,055,"Montana","McCone County",3,35,18,9,9
050,30,055,"Montana","McCone County",3,36,14,6,8
050,30,055,"Montana","McCone County",3,37,20,9,11
050,30,055,"Montana","McCone County",3,38,19,6,13
050,30,055,"Montana","McCone County",3,39,16,8,8
050,30,055,"Montana","McCone County",3,40,21,14,7
050,30,055,"Montana","McCone County",3,41,13,10,3
050,30,055,"Montana","McCone County",3,42,18,10,8
050,30,055,"Montana","McCone County",3,43,15,6,9
050,30,055,"Montana","McCone County",3,44,20,8,12
050,30,055,"Montana","McCone County",3,45,17,12,5
050,30,055,"Montana","McCone County",3,46,15,10,5
050,30,055,"Montana","McCone County",3,47,13,8,5
050,30,055,"Montana","McCone County",3,48,12,5,7
050,30,055,"Montana","McCone County",3,49,18,8,10
050,30,055,"Montana","McCone County",3,50,22,12,10
050,30,055,"Montana","McCone County",3,51,18,7,11
050,30,055,"Montana","McCone County",3,52,15,7,8
050,30,055,"Montana","McCone County",3,53,15,7,8
050,30,055,"Montana","McCone County",3,54,17,9,8
050,30,055,"Montana","McCone County",3,55,18,10,8
050,30,055,"Montana","McCone County",3,56,20,9,11
050,30,055,"Montana","McCone County",3,57,22,9,13
050,30,055,"Montana","McCone County",3,58,30,15,15
050,30,055,"Montana","McCone County",3,59,26,12,14
050,30,055,"Montana","McCone County",3,60,29,16,13
050,30,055,"Montana","McCone County",3,61,29,20,9
050,30,055,"Montana","McCone County",3,62,30,20,10
050,30,055,"Montana","McCone County",3,63,25,13,12
050,30,055,"Montana","McCone County",3,64,26,12,14
050,30,055,"Montana","McCone County",3,65,33,15,18
050,30,055,"Montana","McCone County",3,66,34,16,18
050,30,055,"Montana","McCone County",3,67,34,20,14
050,30,055,"Montana","McCone County",3,68,31,16,15
050,30,055,"Montana","McCone County",3,69,31,15,16
050,30,055,"Montana","McCone County",3,70,28,11,17
050,30,055,"Montana","McCone County",3,71,19,9,10
050,30,055,"Montana","McCone County",3,72,23,13,10
050,30,055,"Montana","McCone County",3,73,20,11,9
050,30,055,"Montana","McCone County",3,74,27,15,12
050,30,055,"Montana","McCone County",3,75,18,11,7
050,30,055,"Montana","McCone County",3,76,13,6,7
050,30,055,"Montana","McCone County",3,77,9,5,4
050,30,055,"Montana","McCone County",3,78,17,9,8
050,30,055,"Montana","McCone County",3,79,16,8,8
050,30,055,"Montana","McCone County",3,80,12,6,6
050,30,055,"Montana","McCone County",3,81,13,5,8
050,30,055,"Montana","McCone County",3,82,12,3,9
050,30,055,"Montana","McCone County",3,83,11,5,6
050,30,055,"Montana","McCone County",3,84,13,6,7
050,30,055,"Montana","McCone County",3,85,62,33,29
050,30,055,"Montana","McCone County",4,0,26,9,17
050,30,055,"Montana","McCone County",4,1,20,5,15
050,30,055,"Montana","McCone County",4,2,14,7,7
050,30,055,"Montana","McCone County",4,3,17,10,7
050,30,055,"Montana","McCone County",4,4,15,10,5
050,30,055,"Montana","McCone County",4,5,17,11,6
050,30,055,"Montana","McCone County",4,6,21,12,9
050,30,055,"Montana","McCone County",4,7,21,13,8
050,30,055,"Montana","McCone County",4,8,19,9,10
050,30,055,"Montana","McCone County",4,9,19,9,10
050,30,055,"Montana","McCone County",4,10,17,7,10
050,30,055,"Montana","McCone County",4,11,12,5,7
050,30,055,"Montana","McCone County",4,12,20,12,8
050,30,055,"Montana","McCone County",4,13,27,12,15
050,30,055,"Montana","McCone County",4,14,23,11,12
050,30,055,"Montana","McCone County",4,15,23,10,13
050,30,055,"Montana","McCone County",4,16,21,8,13
050,30,055,"Montana","McCone County",4,17,19,6,13
050,30,055,"Montana","McCone County",4,18,18,10,8
050,30,055,"Montana","McCone County",4,19,14,8,6
050,30,055,"Montana","McCone County",4,20,12,9,3
050,30,055,"Montana","McCone County",4,21,11,8,3
050,30,055,"Montana","McCone County",4,22,19,9,10
050,30,055,"Montana","McCone County",4,23,17,9,8
050,30,055,"Montana","McCone County",4,24,13,6,7
050,30,055,"Montana","McCone County",4,25,15,5,10
050,30,055,"Montana","McCone County",4,26,12,5,7
050,30,055,"Montana","McCone County",4,27,17,9,8
050,30,055,"Montana","McCone County",4,28,25,12,13
050,30,055,"Montana","McCone County",4,29,14,9,5
050,30,055,"Montana","McCone County",4,30,24,15,9
050,30,055,"Montana","McCone County",4,31,20,11,9
050,30,055,"Montana","McCone County",4,32,16,9,7
050,30,055,"Montana","McCone County",4,33,13,6,7
050,30,055,"Montana","McCone County",4,34,20,11,9
050,30,055,"Montana","McCone County",4,35,22,12,10
050,30,055,"Montana","McCone County",4,36,18,9,9
050,30,055,"Montana","McCone County",4,37,13,5,8
050,30,055,"Montana","McCone County",4,38,22,12,10
050,30,055,"Montana","McCone County",4,39,18,5,13
050,30,055,"Montana","McCone County",4,40,16,8,8
050,30,055,"Montana","McCone County",4,41,19,12,7
050,30,055,"Montana","McCone County",4,42,15,11,4
050,30,055,"Montana","McCone County",4,43,21,13,8
050,30,055,"Montana","McCone County",4,44,15,6,9
050,30,055,"Montana","McCone County",4,45,20,8,12
050,30,055,"Montana","McCone County",4,46,17,12,5
050,30,055,"Montana","McCone County",4,47,16,10,6
050,30,055,"Montana","McCone County",4,48,12,7,5
050,30,055,"Montana","McCone County",4,49,12,5,7
050,30,055,"Montana","McCone County",4,50,20,10,10
050,30,055,"Montana","McCone County",4,51,22,12,10
050,30,055,"Montana","McCone County",4,52,18,7,11
050,30,055,"Montana","McCone County",4,53,13,7,6
050,30,055,"Montana","McCone County",4,54,15,7,8
050,30,055,"Montana","McCone County",4,55,17,9,8
050,30,055,"Montana","McCone County",4,56,18,10,8
050,30,055,"Montana","McCone County",4,57,20,9,11
050,30,055,"Montana","McCone County",4,58,22,9,13
050,30,055,"Montana","McCone County",4,59,30,17,13
050,30,055,"Montana","McCone County",4,60,26,12,14
050,30,055,"Montana","McCone County",4,61,33,18,15
050,30,055,"Montana","McCone County",4,62,30,20,10
050,30,055,"Montana","McCone County",4,63,30,20,10
050,30,055,"Montana","McCone County",4,64,24,12,12
050,30,055,"Montana","McCone County",4,65,26,12,14
050,30,055,"Montana","McCone County",4,66,33,15,18
050,30,055,"Montana","McCone County",4,67,37,19,18
050,30,055,"Montana","McCone County",4,68,33,20,13
050,30,055,"Montana","McCone County",4,69,29,15,14
050,30,055,"Montana","McCone County",4,70,29,15,14
050,30,055,"Montana","McCone County",4,71,27,10,17
050,30,055,"Montana","McCone County",4,72,19,10,9
050,30,055,"Montana","McCone County",4,73,25,14,11
050,30,055,"Montana","McCone County",4,74,20,11,9
050,30,055,"Montana","McCone County",4,75,26,15,11
050,30,055,"Montana","McCone County",4,76,17,10,7
050,30,055,"Montana","McCone County",4,77,11,5,6
050,30,055,"Montana","McCone County",4,78,9,5,4
050,30,055,"Montana","McCone County",4,79,16,7,9
050,30,055,"Montana","McCone County",4,80,16,8,8
050,30,055,"Montana","McCone County",4,81,11,5,6
050,30,055,"Montana","McCone County",4,82,13,5,8
050,30,055,"Montana","McCone County",4,83,12,4,8
050,30,055,"Montana","McCone County",4,84,10,4,6
050,30,055,"Montana","McCone County",4,85,67,34,33
050,30,055,"Montana","McCone County",5,0,26,9,17
050,30,055,"Montana","McCone County",5,1,21,9,12
050,30,055,"Montana","McCone County",5,2,18,5,13
050,30,055,"Montana","McCone County",5,3,15,7,8
050,30,055,"Montana","McCone County",5,4,16,9,7
050,30,055,"Montana","McCone County",5,5,11,7,4
050,30,055,"Montana","McCone County",5,6,16,10,6
050,30,055,"Montana","McCone County",5,7,19,12,7
050,30,055,"Montana","McCone County",5,8,20,12,8
050,30,055,"Montana","McCone County",5,9,19,9,10
050,30,055,"Montana","McCone County",5,10,19,9,10
050,30,055,"Montana","McCone County",5,11,18,9,9
050,30,055,"Montana","McCone County",5,12,12,4,8
050,30,055,"Montana","McCone County",5,13,20,12,8
050,30,055,"Montana","McCone County",5,14,25,12,13
050,30,055,"Montana","McCone County",5,15,23,11,12
050,30,055,"Montana","McCone County",5,16,22,10,12
050,30,055,"Montana","McCone County",5,17,22,8,14
050,30,055,"Montana","McCone County",5,18,16,5,11
050,30,055,"Montana","McCone County",5,19,12,7,5
050,30,055,"Montana","McCone County",5,20,16,11,5
050,30,055,"Montana","McCone County",5,21,13,9,4
050,30,055,"Montana","McCone County",5,22,13,10,3
050,30,055,"Montana","McCone County",5,23,17,9,8
050,30,055,"Montana","McCone County",5,24,18,8,10
050,30,055,"Montana","McCone County",5,25,14,6,8
050,30,055,"Montana","McCone County",5,26,13,5,8
050,30,055,"Montana","McCone County",5,27,12,5,7
050,30,055,"Montana","McCone County",5,28,18,9,9
050,30,055,"Montana","McCone County",5,29,21,9,12
050,30,055,"Montana","McCone County",5,30,14,9,5
050,30,055,"Montana","McCone County",5,31,24,16,8
050,30,055,"Montana","McCone County",5,32,18,11,7
050,30,055,"Montana","McCone County",5,33,16,9,7
050,30,055,"Montana","McCone County",5,34,13,6,7
050,30,055,"Montana","McCone County",5,35,17,11,6
050,30,055,"Montana","McCone County",5,36,20,11,9
050,30,055,"Montana","McCone County",5,37,18,9,9
050,30,055,"Montana","McCone County",5,38,12,5,7
050,30,055,"Montana","McCone County",5,39,22,12,10
050,30,055,"Montana","McCone County",5,40,18,5,13
050,30,055,"Montana","McCone County",5,41,18,9,9
050,30,055,"Montana","McCone County",5,42,18,11,7
050,30,055,"Montana","McCone County",5,43,14,11,3
050,30,055,"Montana","McCone County",5,44,20,13,7
050,30,055,"Montana","McCone County",5,45,15,6,9
050,30,055,"Montana","McCone County",5,46,21,8,13
050,30,055,"Montana","McCone County",5,47,17,12,5
050,30,055,"Montana","McCone County",5,48,15,9,6
050,30,055,"Montana","McCone County",5,49,11,6,5
050,30,055,"Montana","McCone County",5,50,12,5,7
050,30,055,"Montana","McCone County",5,51,19,10,9
050,30,055,"Montana","McCone County",5,52,23,12,11
050,30,055,"Montana","McCone County",5,53,17,5,12
050,30,055,"Montana","McCone County",5,54,13,7,6
050,30,055,"Montana","McCone County",5,55,17,9,8
050,30,055,"Montana","McCone County",5,56,17,9,8
050,30,055,"Montana","McCone County",5,57,20,12,8
050,30,055,"Montana","McCone County",5,58,20,9,11
050,30,055,"Montana","McCone County",5,59,22,9,13
050,30,055,"Montana","McCone County",5,60,30,17,13
050,30,055,"Montana","McCone County",5,61,26,12,14
050,30,055,"Montana","McCone County",5,62,33,18,15
050,30,055,"Montana","McCone County",5,63,30,20,10
050,30,055,"Montana","McCone County",5,64,28,19,9
050,30,055,"Montana","McCone County",5,65,24,12,12
050,30,055,"Montana","McCone County",5,66,22,11,11
050,30,055,"Montana","McCone County",5,67,33,14,19
050,30,055,"Montana","McCone County",5,68,37,19,18
050,30,055,"Montana","McCone County",5,69,33,21,12
050,30,055,"Montana","McCone County",5,70,27,14,13
050,30,055,"Montana","McCone County",5,71,27,14,13
050,30,055,"Montana","McCone County",5,72,26,10,16
050,30,055,"Montana","McCone County",5,73,19,10,9
050,30,055,"Montana","McCone County",5,74,25,14,11
050,30,055,"Montana","McCone County",5,75,19,11,8
050,30,055,"Montana","McCone County",5,76,26,15,11
050,30,055,"Montana","McCone County",5,77,14,9,5
050,30,055,"Montana","McCone County",5,78,12,5,7
050,30,055,"Montana","McCone County",5,79,9,4,5
050,30,055,"Montana","McCone County",5,80,15,6,9
050,30,055,"Montana","McCone County",5,81,15,7,8
050,30,055,"Montana","McCone County",5,82,11,5,6
050,30,055,"Montana","McCone County",5,83,13,6,7
050,30,055,"Montana","McCone County",5,84,11,3,8
050,30,055,"Montana","McCone County",5,85,65,32,33
050,30,057,"Montana","Madison County",1,0,75,38,37
050,30,057,"Montana","Madison County",1,1,79,41,38
050,30,057,"Montana","Madison County",1,2,68,41,27
050,30,057,"Montana","Madison County",1,3,73,36,37
050,30,057,"Montana","Madison County",1,4,62,30,32
050,30,057,"Montana","Madison County",1,5,64,25,39
050,30,057,"Montana","Madison County",1,6,76,35,41
050,30,057,"Montana","Madison County",1,7,82,40,42
050,30,057,"Montana","Madison County",1,8,81,39,42
050,30,057,"Montana","Madison County",1,9,78,45,33
050,30,057,"Montana","Madison County",1,10,78,41,37
050,30,057,"Montana","Madison County",1,11,73,41,32
050,30,057,"Montana","Madison County",1,12,71,35,36
050,30,057,"Montana","Madison County",1,13,79,46,33
050,30,057,"Montana","Madison County",1,14,84,44,40
050,30,057,"Montana","Madison County",1,15,83,38,45
050,30,057,"Montana","Madison County",1,16,93,39,54
050,30,057,"Montana","Madison County",1,17,91,48,43
050,30,057,"Montana","Madison County",1,18,65,33,32
050,30,057,"Montana","Madison County",1,19,51,28,23
050,30,057,"Montana","Madison County",1,20,65,40,25
050,30,057,"Montana","Madison County",1,21,60,34,26
050,30,057,"Montana","Madison County",1,22,61,33,28
050,30,057,"Montana","Madison County",1,23,64,39,25
050,30,057,"Montana","Madison County",1,24,59,37,22
050,30,057,"Montana","Madison County",1,25,60,32,28
050,30,057,"Montana","Madison County",1,26,73,36,37
050,30,057,"Montana","Madison County",1,27,88,44,44
050,30,057,"Montana","Madison County",1,28,85,56,29
050,30,057,"Montana","Madison County",1,29,84,42,42
050,30,057,"Montana","Madison County",1,30,78,37,41
050,30,057,"Montana","Madison County",1,31,88,41,47
050,30,057,"Montana","Madison County",1,32,89,49,40
050,30,057,"Montana","Madison County",1,33,88,51,37
050,30,057,"Montana","Madison County",1,34,98,56,42
050,30,057,"Montana","Madison County",1,35,98,44,54
050,30,057,"Montana","Madison County",1,36,93,52,41
050,30,057,"Montana","Madison County",1,37,109,62,47
050,30,057,"Montana","Madison County",1,38,95,50,45
050,30,057,"Montana","Madison County",1,39,104,55,49
050,30,057,"Montana","Madison County",1,40,96,52,44
050,30,057,"Montana","Madison County",1,41,89,46,43
050,30,057,"Montana","Madison County",1,42,76,41,35
050,30,057,"Montana","Madison County",1,43,83,43,40
050,30,057,"Montana","Madison County",1,44,81,41,40
050,30,057,"Montana","Madison County",1,45,86,48,38
050,30,057,"Montana","Madison County",1,46,83,49,34
050,30,057,"Montana","Madison County",1,47,79,44,35
050,30,057,"Montana","Madison County",1,48,90,50,40
050,30,057,"Montana","Madison County",1,49,109,58,51
050,30,057,"Montana","Madison County",1,50,98,51,47
050,30,057,"Montana","Madison County",1,51,94,47,47
050,30,057,"Montana","Madison County",1,52,107,59,48
050,30,057,"Montana","Madison County",1,53,92,45,47
050,30,057,"Montana","Madison County",1,54,104,46,58
050,30,057,"Montana","Madison County",1,55,122,62,60
050,30,057,"Montana","Madison County",1,56,127,70,57
050,30,057,"Montana","Madison County",1,57,128,67,61
050,30,057,"Montana","Madison County",1,58,143,71,72
050,30,057,"Montana","Madison County",1,59,145,74,71
050,30,057,"Montana","Madison County",1,60,151,82,69
050,30,057,"Montana","Madison County",1,61,154,78,76
050,30,057,"Montana","Madison County",1,62,170,81,89
050,30,057,"Montana","Madison County",1,63,163,81,82
050,30,057,"Montana","Madison County",1,64,175,83,92
050,30,057,"Montana","Madison County",1,65,174,92,82
050,30,057,"Montana","Madison County",1,66,195,110,85
050,30,057,"Montana","Madison County",1,67,197,99,98
050,30,057,"Montana","Madison County",1,68,195,93,102
050,30,057,"Montana","Madison County",1,69,172,84,88
050,30,057,"Montana","Madison County",1,70,161,84,77
050,30,057,"Montana","Madison County",1,71,179,107,72
050,30,057,"Montana","Madison County",1,72,187,109,78
050,30,057,"Montana","Madison County",1,73,161,92,69
050,30,057,"Montana","Madison County",1,74,89,50,39
050,30,057,"Montana","Madison County",1,75,96,52,44
050,30,057,"Montana","Madison County",1,76,106,64,42
050,30,057,"Montana","Madison County",1,77,101,62,39
050,30,057,"Montana","Madison County",1,78,73,40,33
050,30,057,"Montana","Madison County",1,79,64,32,32
050,30,057,"Montana","Madison County",1,80,60,31,29
050,30,057,"Montana","Madison County",1,81,66,33,33
050,30,057,"Montana","Madison County",1,82,59,25,34
050,30,057,"Montana","Madison County",1,83,48,26,22
050,30,057,"Montana","Madison County",1,84,38,20,18
050,30,057,"Montana","Madison County",1,85,216,91,125
050,30,057,"Montana","Madison County",2,0,72,35,37
050,30,057,"Montana","Madison County",2,1,78,41,37
050,30,057,"Montana","Madison County",2,2,72,42,30
050,30,057,"Montana","Madison County",2,3,70,37,33
050,30,057,"Montana","Madison County",2,4,64,31,33
050,30,057,"Montana","Madison County",2,5,63,26,37
050,30,057,"Montana","Madison County",2,6,74,34,40
050,30,057,"Montana","Madison County",2,7,81,39,42
050,30,057,"Montana","Madison County",2,8,81,41,40
050,30,057,"Montana","Madison County",2,9,79,43,36
050,30,057,"Montana","Madison County",2,10,81,44,37
050,30,057,"Montana","Madison County",2,11,75,42,33
050,30,057,"Montana","Madison County",2,12,72,37,35
050,30,057,"Montana","Madison County",2,13,77,43,34
050,30,057,"Montana","Madison County",2,14,86,46,40
050,30,057,"Montana","Madison County",2,15,85,40,45
050,30,057,"Montana","Madison County",2,16,91,39,52
050,30,057,"Montana","Madison County",2,17,91,45,46
050,30,057,"Montana","Madison County",2,18,66,35,31
050,30,057,"Montana","Madison County",2,19,50,27,23
050,30,057,"Montana","Madison County",2,20,63,37,26
050,30,057,"Montana","Madison County",2,21,61,34,27
050,30,057,"Montana","Madison County",2,22,62,34,28
050,30,057,"Montana","Madison County",2,23,62,38,24
050,30,057,"Montana","Madison County",2,24,60,39,21
050,30,057,"Montana","Madison County",2,25,60,33,27
050,30,057,"Montana","Madison County",2,26,70,35,35
050,30,057,"Montana","Madison County",2,27,85,43,42
050,30,057,"Montana","Madison County",2,28,85,53,32
050,30,057,"Montana","Madison County",2,29,84,45,39
050,30,057,"Montana","Madison County",2,30,81,39,42
050,30,057,"Montana","Madison County",2,31,87,41,46
050,30,057,"Montana","Madison County",2,32,90,47,43
050,30,057,"Montana","Madison County",2,33,89,51,38
050,30,057,"Montana","Madison County",2,34,99,56,43
050,30,057,"Montana","Madison County",2,35,100,47,53
050,30,057,"Montana","Madison County",2,36,96,51,45
050,30,057,"Montana","Madison County",2,37,106,60,46
050,30,057,"Montana","Madison County",2,38,102,55,47
050,30,057,"Montana","Madison County",2,39,104,56,48
050,30,057,"Montana","Madison County",2,40,102,55,47
050,30,057,"Montana","Madison County",2,41,90,47,43
050,30,057,"Montana","Madison County",2,42,80,42,38
050,30,057,"Montana","Madison County",2,43,81,42,39
050,30,057,"Montana","Madison County",2,44,82,41,41
050,30,057,"Montana","Madison County",2,45,87,48,39
050,30,057,"Montana","Madison County",2,46,83,48,35
050,30,057,"Montana","Madison County",2,47,79,45,34
050,30,057,"Montana","Madison County",2,48,90,50,40
050,30,057,"Montana","Madison County",2,49,105,55,50
050,30,057,"Montana","Madison County",2,50,101,53,48
050,30,057,"Montana","Madison County",2,51,98,49,49
050,30,057,"Montana","Madison County",2,52,105,56,49
050,30,057,"Montana","Madison County",2,53,96,48,48
050,30,057,"Montana","Madison County",2,54,100,45,55
050,30,057,"Montana","Madison County",2,55,118,58,60
050,30,057,"Montana","Madison County",2,56,126,68,58
050,30,057,"Montana","Madison County",2,57,127,68,59
050,30,057,"Montana","Madison County",2,58,141,71,70
050,30,057,"Montana","Madison County",2,59,146,75,71
050,30,057,"Montana","Madison County",2,60,151,81,70
050,30,057,"Montana","Madison County",2,61,156,79,77
050,30,057,"Montana","Madison County",2,62,166,81,85
050,30,057,"Montana","Madison County",2,63,167,82,85
050,30,057,"Montana","Madison County",2,64,172,82,90
050,30,057,"Montana","Madison County",2,65,178,91,87
050,30,057,"Montana","Madison County",2,66,192,107,85
050,30,057,"Montana","Madison County",2,67,195,100,95
050,30,057,"Montana","Madison County",2,68,194,94,100
050,30,057,"Montana","Madison County",2,69,179,87,92
050,30,057,"Montana","Madison County",2,70,162,84,78
050,30,057,"Montana","Madison County",2,71,175,101,74
050,30,057,"Montana","Madison County",2,72,181,106,75
050,30,057,"Montana","Madison County",2,73,177,103,74
050,30,057,"Montana","Madison County",2,74,99,56,43
050,30,057,"Montana","Madison County",2,75,93,50,43
050,30,057,"Montana","Madison County",2,76,102,60,42
050,30,057,"Montana","Madison County",2,77,101,61,40
050,30,057,"Montana","Madison County",2,78,78,43,35
050,30,057,"Montana","Madison County",2,79,62,32,30
050,30,057,"Montana","Madison County",2,80,61,31,30
050,30,057,"Montana","Madison County",2,81,65,32,33
050,30,057,"Montana","Madison County",2,82,62,27,35
050,30,057,"Montana","Madison County",2,83,49,25,24
050,30,057,"Montana","Madison County",2,84,39,21,18
050,30,057,"Montana","Madison County",2,85,214,90,124
050,30,057,"Montana","Madison County",3,0,61,32,29
050,30,057,"Montana","Madison County",3,1,91,45,46
050,30,057,"Montana","Madison County",3,2,78,42,36
050,30,057,"Montana","Madison County",3,3,75,40,35
050,30,057,"Montana","Madison County",3,4,72,36,36
050,30,057,"Montana","Madison County",3,5,77,36,41
050,30,057,"Montana","Madison County",3,6,69,29,40
050,30,057,"Montana","Madison County",3,7,71,31,40
050,30,057,"Montana","Madison County",3,8,80,36,44
050,30,057,"Montana","Madison County",3,9,84,41,43
050,30,057,"Montana","Madison County",3,10,75,39,36
050,30,057,"Montana","Madison County",3,11,89,50,39
050,30,057,"Montana","Madison County",3,12,75,44,31
050,30,057,"Montana","Madison County",3,13,74,38,36
050,30,057,"Montana","Madison County",3,14,79,44,35
050,30,057,"Montana","Madison County",3,15,95,47,48
050,30,057,"Montana","Madison County",3,16,78,35,43
050,30,057,"Montana","Madison County",3,17,89,37,52
050,30,057,"Montana","Madison County",3,18,79,40,39
050,30,057,"Montana","Madison County",3,19,52,27,25
050,30,057,"Montana","Madison County",3,20,51,28,23
050,30,057,"Montana","Madison County",3,21,66,37,29
050,30,057,"Montana","Madison County",3,22,59,32,27
050,30,057,"Montana","Madison County",3,23,69,38,31
050,30,057,"Montana","Madison County",3,24,67,45,22
050,30,057,"Montana","Madison County",3,25,71,39,32
050,30,057,"Montana","Madison County",3,26,69,36,33
050,30,057,"Montana","Madison County",3,27,87,41,46
050,30,057,"Montana","Madison County",3,28,100,50,50
050,30,057,"Montana","Madison County",3,29,78,48,30
050,30,057,"Montana","Madison County",3,30,97,45,52
050,30,057,"Montana","Madison County",3,31,97,44,53
050,30,057,"Montana","Madison County",3,32,98,49,49
050,30,057,"Montana","Madison County",3,33,97,53,44
050,30,057,"Montana","Madison County",3,34,100,60,40
050,30,057,"Montana","Madison County",3,35,111,65,46
050,30,057,"Montana","Madison County",3,36,107,50,57
050,30,057,"Montana","Madison County",3,37,97,51,46
050,30,057,"Montana","Madison County",3,38,112,61,51
050,30,057,"Montana","Madison County",3,39,109,57,52
050,30,057,"Montana","Madison County",3,40,116,65,51
050,30,057,"Montana","Madison County",3,41,111,60,51
050,30,057,"Montana","Madison County",3,42,86,44,42
050,30,057,"Montana","Madison County",3,43,80,46,34
050,30,057,"Montana","Madison County",3,44,85,42,43
050,30,057,"Montana","Madison County",3,45,85,44,41
050,30,057,"Montana","Madison County",3,46,82,46,36
050,30,057,"Montana","Madison County",3,47,81,48,33
050,30,057,"Montana","Madison County",3,48,93,56,37
050,30,057,"Montana","Madison County",3,49,97,54,43
050,30,057,"Montana","Madison County",3,50,103,53,50
050,30,057,"Montana","Madison County",3,51,111,60,51
050,30,057,"Montana","Madison County",3,52,102,53,49
050,30,057,"Montana","Madison County",3,53,107,59,48
050,30,057,"Montana","Madison County",3,54,96,50,46
050,30,057,"Montana","Madison County",3,55,102,41,61
050,30,057,"Montana","Madison County",3,56,133,68,65
050,30,057,"Montana","Madison County",3,57,128,67,61
050,30,057,"Montana","Madison County",3,58,131,67,64
050,30,057,"Montana","Madison County",3,59,157,76,81
050,30,057,"Montana","Madison County",3,60,153,77,76
050,30,057,"Montana","Madison County",3,61,161,87,74
050,30,057,"Montana","Madison County",3,62,172,86,86
050,30,057,"Montana","Madison County",3,63,181,90,91
050,30,057,"Montana","Madison County",3,64,163,78,85
050,30,057,"Montana","Madison County",3,65,175,82,93
050,30,057,"Montana","Madison County",3,66,186,98,88
050,30,057,"Montana","Madison County",3,67,194,109,85
050,30,057,"Montana","Madison County",3,68,196,99,97
050,30,057,"Montana","Madison County",3,69,192,93,99
050,30,057,"Montana","Madison County",3,70,178,87,91
050,30,057,"Montana","Madison County",3,71,161,85,76
050,30,057,"Montana","Madison County",3,72,178,103,75
050,30,057,"Montana","Madison County",3,73,179,108,71
050,30,057,"Montana","Madison County",3,74,165,95,70
050,30,057,"Montana","Madison County",3,75,94,52,42
050,30,057,"Montana","Madison County",3,76,91,49,42
050,30,057,"Montana","Madison County",3,77,94,56,38
050,30,057,"Montana","Madison County",3,78,105,62,43
050,30,057,"Montana","Madison County",3,79,73,41,32
050,30,057,"Montana","Madison County",3,80,55,29,26
050,30,057,"Montana","Madison County",3,81,60,28,32
050,30,057,"Montana","Madison County",3,82,60,31,29
050,30,057,"Montana","Madison County",3,83,57,24,33
050,30,057,"Montana","Madison County",3,84,44,22,22
050,30,057,"Montana","Madison County",3,85,215,91,124
050,30,057,"Montana","Madison County",4,0,64,35,29
050,30,057,"Montana","Madison County",4,1,79,40,39
050,30,057,"Montana","Madison County",4,2,93,50,43
050,30,057,"Montana","Madison County",4,3,80,42,38
050,30,057,"Montana","Madison County",4,4,72,35,37
050,30,057,"Montana","Madison County",4,5,90,49,41
050,30,057,"Montana","Madison County",4,6,74,35,39
050,30,057,"Montana","Madison County",4,7,70,28,42
050,30,057,"Montana","Madison County",4,8,73,33,40
050,30,057,"Montana","Madison County",4,9,86,41,45
050,30,057,"Montana","Madison County",4,10,94,53,41
050,30,057,"Montana","Madison County",4,11,75,39,36
050,30,057,"Montana","Madison County",4,12,91,57,34
050,30,057,"Montana","Madison County",4,13,79,45,34
050,30,057,"Montana","Madison County",4,14,80,41,39
050,30,057,"Montana","Madison County",4,15,78,44,34
050,30,057,"Montana","Madison County",4,16,97,49,48
050,30,057,"Montana","Madison County",4,17,79,39,40
050,30,057,"Montana","Madison County",4,18,84,36,48
050,30,057,"Montana","Madison County",4,19,57,29,28
050,30,057,"Montana","Madison County",4,20,56,31,25
050,30,057,"Montana","Madison County",4,21,61,31,30
050,30,057,"Montana","Madison County",4,22,73,42,31
050,30,057,"Montana","Madison County",4,23,65,32,33
050,30,057,"Montana","Madison County",4,24,80,45,35
050,30,057,"Montana","Madison County",4,25,76,48,28
050,30,057,"Montana","Madison County",4,26,86,44,42
050,30,057,"Montana","Madison County",4,27,119,50,69
050,30,057,"Montana","Madison County",4,28,83,47,36
050,30,057,"Montana","Madison County",4,29,107,54,53
050,30,057,"Montana","Madison County",4,30,79,40,39
050,30,057,"Montana","Madison County",4,31,105,53,52
050,30,057,"Montana","Madison County",4,32,103,50,53
050,30,057,"Montana","Madison County",4,33,96,53,43
050,30,057,"Montana","Madison County",4,34,99,54,45
050,30,057,"Montana","Madison County",4,35,106,56,50
050,30,057,"Montana","Madison County",4,36,121,70,51
050,30,057,"Montana","Madison County",4,37,115,54,61
050,30,057,"Montana","Madison County",4,38,98,56,42
050,30,057,"Montana","Madison County",4,39,120,62,58
050,30,057,"Montana","Madison County",4,40,111,56,55
050,30,057,"Montana","Madison County",4,41,121,66,55
050,30,057,"Montana","Madison County",4,42,117,65,52
050,30,057,"Montana","Madison County",4,43,86,41,45
050,30,057,"Montana","Madison County",4,44,83,45,38
050,30,057,"Montana","Madison County",4,45,96,47,49
050,30,057,"Montana","Madison County",4,46,87,41,46
050,30,057,"Montana","Madison County",4,47,83,48,35
050,30,057,"Montana","Madison County",4,48,99,59,40
050,30,057,"Montana","Madison County",4,49,109,59,50
050,30,057,"Montana","Madison County",4,50,102,59,43
050,30,057,"Montana","Madison County",4,51,108,56,52
050,30,057,"Montana","Madison County",4,52,117,61,56
050,30,057,"Montana","Madison County",4,53,105,52,53
050,30,057,"Montana","Madison County",4,54,111,64,47
050,30,057,"Montana","Madison County",4,55,103,54,49
050,30,057,"Montana","Madison County",4,56,107,43,64
050,30,057,"Montana","Madison County",4,57,137,68,69
050,30,057,"Montana","Madison County",4,58,123,58,65
050,30,057,"Montana","Madison County",4,59,142,77,65
050,30,057,"Montana","Madison County",4,60,161,78,83
050,30,057,"Montana","Madison County",4,61,158,77,81
050,30,057,"Montana","Madison County",4,62,177,98,79
050,30,057,"Montana","Madison County",4,63,182,91,91
050,30,057,"Montana","Madison County",4,64,186,96,90
050,30,057,"Montana","Madison County",4,65,161,77,84
050,30,057,"Montana","Madison County",4,66,170,81,89
050,30,057,"Montana","Madison County",4,67,184,94,90
050,30,057,"Montana","Madison County",4,68,199,112,87
050,30,057,"Montana","Madison County",4,69,193,95,98
050,30,057,"Montana","Madison County",4,70,188,90,98
050,30,057,"Montana","Madison County",4,71,177,87,90
050,30,057,"Montana","Madison County",4,72,152,81,71
050,30,057,"Montana","Madison County",4,73,169,95,74
050,30,057,"Montana","Madison County",4,74,172,102,70
050,30,057,"Montana","Madison County",4,75,156,87,69
050,30,057,"Montana","Madison County",4,76,97,56,41
050,30,057,"Montana","Madison County",4,77,86,48,38
050,30,057,"Montana","Madison County",4,78,95,56,39
050,30,057,"Montana","Madison County",4,79,97,55,42
050,30,057,"Montana","Madison County",4,80,70,40,30
050,30,057,"Montana","Madison County",4,81,56,30,26
050,30,057,"Montana","Madison County",4,82,54,25,29
050,30,057,"Montana","Madison County",4,83,56,29,27
050,30,057,"Montana","Madison County",4,84,48,18,30
050,30,057,"Montana","Madison County",4,85,218,96,122
050,30,057,"Montana","Madison County",5,0,64,35,29
050,30,057,"Montana","Madison County",5,1,70,33,37
050,30,057,"Montana","Madison County",5,2,76,37,39
050,30,057,"Montana","Madison County",5,3,91,50,41
050,30,057,"Montana","Madison County",5,4,79,44,35
050,30,057,"Montana","Madison County",5,5,69,34,35
050,30,057,"Montana","Madison County",5,6,92,50,42
050,30,057,"Montana","Madison County",5,7,77,35,42
050,30,057,"Montana","Madison County",5,8,82,33,49
050,30,057,"Montana","Madison County",5,9,73,32,41
050,30,057,"Montana","Madison County",5,10,88,45,43
050,30,057,"Montana","Madison County",5,11,106,55,51
050,30,057,"Montana","Madison County",5,12,82,43,39
050,30,057,"Montana","Madison County",5,13,98,61,37
050,30,057,"Montana","Madison County",5,14,79,46,33
050,30,057,"Montana","Madison County",5,15,81,46,35
050,30,057,"Montana","Madison County",5,16,84,52,32
050,30,057,"Montana","Madison County",5,17,97,50,47
050,30,057,"Montana","Madison County",5,18,72,38,34
050,30,057,"Montana","Madison County",5,19,69,29,40
050,30,057,"Montana","Madison County",5,20,64,33,31
050,30,057,"Montana","Madison County",5,21,61,36,25
050,30,057,"Montana","Madison County",5,22,67,36,31
050,30,057,"Montana","Madison County",5,23,91,57,34
050,30,057,"Montana","Madison County",5,24,88,43,45
050,30,057,"Montana","Madison County",5,25,82,47,35
050,30,057,"Montana","Madison County",5,26,71,42,29
050,30,057,"Montana","Madison County",5,27,109,44,65
050,30,057,"Montana","Madison County",5,28,128,55,73
050,30,057,"Montana","Madison County",5,29,83,42,41
050,30,057,"Montana","Madison County",5,30,120,65,55
050,30,057,"Montana","Madison County",5,31,92,52,40
050,30,057,"Montana","Madison County",5,32,115,59,56
050,30,057,"Montana","Madison County",5,33,115,56,59
050,30,057,"Montana","Madison County",5,34,90,49,41
050,30,057,"Montana","Madison County",5,35,102,58,44
050,30,057,"Montana","Madison County",5,36,116,61,55
050,30,057,"Montana","Madison County",5,37,117,67,50
050,30,057,"Montana","Madison County",5,38,108,48,60
050,30,057,"Montana","Madison County",5,39,112,65,47
050,30,057,"Montana","Madison County",5,40,118,62,56
050,30,057,"Montana","Madison County",5,41,118,61,57
050,30,057,"Montana","Madison County",5,42,124,65,59
050,30,057,"Montana","Madison County",5,43,124,63,61
050,30,057,"Montana","Madison County",5,44,94,45,49
050,30,057,"Montana","Madison County",5,45,96,50,46
050,30,057,"Montana","Madison County",5,46,99,50,49
050,30,057,"Montana","Madison County",5,47,96,46,50
050,30,057,"Montana","Madison County",5,48,91,52,39
050,30,057,"Montana","Madison County",5,49,104,64,40
050,30,057,"Montana","Madison County",5,50,113,66,47
050,30,057,"Montana","Madison County",5,51,105,58,47
050,30,057,"Montana","Madison County",5,52,111,59,52
050,30,057,"Montana","Madison County",5,53,122,59,63
050,30,057,"Montana","Madison County",5,54,120,57,63
050,30,057,"Montana","Madison County",5,55,112,64,48
050,30,057,"Montana","Madison County",5,56,118,68,50
050,30,057,"Montana","Madison County",5,57,105,44,61
050,30,057,"Montana","Madison County",5,58,145,68,77
050,30,057,"Montana","Madison County",5,59,123,56,67
050,30,057,"Montana","Madison County",5,60,138,75,63
050,30,057,"Montana","Madison County",5,61,166,84,82
050,30,057,"Montana","Madison County",5,62,155,76,79
050,30,057,"Montana","Madison County",5,63,180,95,85
050,30,057,"Montana","Madison County",5,64,182,91,91
050,30,057,"Montana","Madison County",5,65,183,92,91
050,30,057,"Montana","Madison County",5,66,168,80,88
050,30,057,"Montana","Madison County",5,67,171,78,93
050,30,057,"Montana","Madison County",5,68,188,101,87
050,30,057,"Montana","Madison County",5,69,196,110,86
050,30,057,"Montana","Madison County",5,70,191,93,98
050,30,057,"Montana","Madison County",5,71,188,91,97
050,30,057,"Montana","Madison County",5,72,173,86,87
050,30,057,"Montana","Madison County",5,73,153,81,72
050,30,057,"Montana","Madison County",5,74,167,96,71
050,30,057,"Montana","Madison County",5,75,171,100,71
050,30,057,"Montana","Madison County",5,76,153,85,68
050,30,057,"Montana","Madison County",5,77,90,52,38
050,30,057,"Montana","Madison County",5,78,86,45,41
050,30,057,"Montana","Madison County",5,79,86,50,36
050,30,057,"Montana","Madison County",5,80,91,54,37
050,30,057,"Montana","Madison County",5,81,70,38,32
050,30,057,"Montana","Madison County",5,82,48,25,23
050,30,057,"Montana","Madison County",5,83,48,23,25
050,30,057,"Montana","Madison County",5,84,50,25,25
050,30,057,"Montana","Madison County",5,85,231,100,131
050,30,059,"Montana","Meagher County",1,0,22,12,10
050,30,059,"Montana","Meagher County",1,1,24,14,10
050,30,059,"Montana","Meagher County",1,2,19,11,8
050,30,059,"Montana","Meagher County",1,3,18,10,8
050,30,059,"Montana","Meagher County",1,4,19,11,8
050,30,059,"Montana","Meagher County",1,5,18,10,8
050,30,059,"Montana","Meagher County",1,6,15,6,9
050,30,059,"Montana","Meagher County",1,7,19,11,8
050,30,059,"Montana","Meagher County",1,8,22,14,8
050,30,059,"Montana","Meagher County",1,9,17,9,8
050,30,059,"Montana","Meagher County",1,10,23,15,8
050,30,059,"Montana","Meagher County",1,11,18,11,7
050,30,059,"Montana","Meagher County",1,12,14,7,7
050,30,059,"Montana","Meagher County",1,13,17,9,8
050,30,059,"Montana","Meagher County",1,14,19,11,8
050,30,059,"Montana","Meagher County",1,15,21,14,7
050,30,059,"Montana","Meagher County",1,16,28,17,11
050,30,059,"Montana","Meagher County",1,17,23,13,10
050,30,059,"Montana","Meagher County",1,18,15,9,6
050,30,059,"Montana","Meagher County",1,19,9,4,5
050,30,059,"Montana","Meagher County",1,20,9,5,4
050,30,059,"Montana","Meagher County",1,21,16,8,8
050,30,059,"Montana","Meagher County",1,22,14,8,6
050,30,059,"Montana","Meagher County",1,23,11,7,4
050,30,059,"Montana","Meagher County",1,24,15,7,8
050,30,059,"Montana","Meagher County",1,25,17,7,10
050,30,059,"Montana","Meagher County",1,26,17,10,7
050,30,059,"Montana","Meagher County",1,27,11,7,4
050,30,059,"Montana","Meagher County",1,28,14,9,5
050,30,059,"Montana","Meagher County",1,29,15,7,8
050,30,059,"Montana","Meagher County",1,30,19,9,10
050,30,059,"Montana","Meagher County",1,31,19,10,9
050,30,059,"Montana","Meagher County",1,32,14,6,8
050,30,059,"Montana","Meagher County",1,33,14,6,8
050,30,059,"Montana","Meagher County",1,34,14,6,8
050,30,059,"Montana","Meagher County",1,35,20,12,8
050,30,059,"Montana","Meagher County",1,36,22,10,12
050,30,059,"Montana","Meagher County",1,37,25,13,12
050,30,059,"Montana","Meagher County",1,38,20,11,9
050,30,059,"Montana","Meagher County",1,39,17,9,8
050,30,059,"Montana","Meagher County",1,40,19,11,8
050,30,059,"Montana","Meagher County",1,41,16,8,8
050,30,059,"Montana","Meagher County",1,42,24,11,13
050,30,059,"Montana","Meagher County",1,43,17,8,9
050,30,059,"Montana","Meagher County",1,44,23,12,11
050,30,059,"Montana","Meagher County",1,45,15,9,6
050,30,059,"Montana","Meagher County",1,46,23,12,11
050,30,059,"Montana","Meagher County",1,47,20,10,10
050,30,059,"Montana","Meagher County",1,48,12,7,5
050,30,059,"Montana","Meagher County",1,49,17,9,8
050,30,059,"Montana","Meagher County",1,50,18,9,9
050,30,059,"Montana","Meagher County",1,51,19,10,9
050,30,059,"Montana","Meagher County",1,52,14,5,9
050,30,059,"Montana","Meagher County",1,53,15,9,6
050,30,059,"Montana","Meagher County",1,54,24,15,9
050,30,059,"Montana","Meagher County",1,55,24,13,11
050,30,059,"Montana","Meagher County",1,56,26,12,14
050,30,059,"Montana","Meagher County",1,57,29,14,15
050,30,059,"Montana","Meagher County",1,58,26,11,15
050,30,059,"Montana","Meagher County",1,59,30,14,16
050,30,059,"Montana","Meagher County",1,60,36,22,14
050,30,059,"Montana","Meagher County",1,61,44,17,27
050,30,059,"Montana","Meagher County",1,62,45,22,23
050,30,059,"Montana","Meagher County",1,63,41,19,22
050,30,059,"Montana","Meagher County",1,64,38,19,19
050,30,059,"Montana","Meagher County",1,65,34,17,17
050,30,059,"Montana","Meagher County",1,66,30,13,17
050,30,059,"Montana","Meagher County",1,67,44,27,17
050,30,059,"Montana","Meagher County",1,68,45,25,20
050,30,059,"Montana","Meagher County",1,69,41,24,17
050,30,059,"Montana","Meagher County",1,70,40,20,20
050,30,059,"Montana","Meagher County",1,71,47,24,23
050,30,059,"Montana","Meagher County",1,72,39,23,16
050,30,059,"Montana","Meagher County",1,73,36,14,22
050,30,059,"Montana","Meagher County",1,74,22,10,12
050,30,059,"Montana","Meagher County",1,75,21,14,7
050,30,059,"Montana","Meagher County",1,76,33,22,11
050,30,059,"Montana","Meagher County",1,77,25,17,8
050,30,059,"Montana","Meagher County",1,78,17,9,8
050,30,059,"Montana","Meagher County",1,79,15,6,9
050,30,059,"Montana","Meagher County",1,80,8,3,5
050,30,059,"Montana","Meagher County",1,81,14,3,11
050,30,059,"Montana","Meagher County",1,82,14,8,6
050,30,059,"Montana","Meagher County",1,83,13,7,6
050,30,059,"Montana","Meagher County",1,84,10,6,4
050,30,059,"Montana","Meagher County",1,85,58,19,39
050,30,059,"Montana","Meagher County",2,0,22,11,11
050,30,059,"Montana","Meagher County",2,1,24,14,10
050,30,059,"Montana","Meagher County",2,2,21,12,9
050,30,059,"Montana","Meagher County",2,3,18,10,8
050,30,059,"Montana","Meagher County",2,4,18,11,7
050,30,059,"Montana","Meagher County",2,5,19,11,8
050,30,059,"Montana","Meagher County",2,6,16,7,9
050,30,059,"Montana","Meagher County",2,7,18,10,8
050,30,059,"Montana","Meagher County",2,8,21,13,8
050,30,059,"Montana","Meagher County",2,9,18,10,8
050,30,059,"Montana","Meagher County",2,10,21,13,8
050,30,059,"Montana","Meagher County",2,11,19,12,7
050,30,059,"Montana","Meagher County",2,12,14,7,7
050,30,059,"Montana","Meagher County",2,13,16,8,8
050,30,059,"Montana","Meagher County",2,14,19,11,8
050,30,059,"Montana","Meagher County",2,15,20,13,7
050,30,059,"Montana","Meagher County",2,16,26,16,10
050,30,059,"Montana","Meagher County",2,17,25,14,11
050,30,059,"Montana","Meagher County",2,18,16,9,7
050,30,059,"Montana","Meagher County",2,19,10,5,5
050,30,059,"Montana","Meagher County",2,20,9,5,4
050,30,059,"Montana","Meagher County",2,21,15,8,7
050,30,059,"Montana","Meagher County",2,22,14,8,6
050,30,059,"Montana","Meagher County",2,23,11,7,4
050,30,059,"Montana","Meagher County",2,24,13,6,7
050,30,059,"Montana","Meagher County",2,25,17,7,10
050,30,059,"Montana","Meagher County",2,26,17,9,8
050,30,059,"Montana","Meagher County",2,27,13,8,5
050,30,059,"Montana","Meagher County",2,28,13,9,4
050,30,059,"Montana","Meagher County",2,29,15,7,8
050,30,059,"Montana","Meagher County",2,30,18,9,9
050,30,059,"Montana","Meagher County",2,31,19,10,9
050,30,059,"Montana","Meagher County",2,32,15,7,8
050,30,059,"Montana","Meagher County",2,33,13,6,7
050,30,059,"Montana","Meagher County",2,34,14,6,8
050,30,059,"Montana","Meagher County",2,35,19,11,8
050,30,059,"Montana","Meagher County",2,36,21,10,11
050,30,059,"Montana","Meagher County",2,37,25,13,12
050,30,059,"Montana","Meagher County",2,38,21,12,9
050,30,059,"Montana","Meagher County",2,39,17,9,8
050,30,059,"Montana","Meagher County",2,40,19,10,9
050,30,059,"Montana","Meagher County",2,41,17,9,8
050,30,059,"Montana","Meagher County",2,42,22,10,12
050,30,059,"Montana","Meagher County",2,43,19,9,10
050,30,059,"Montana","Meagher County",2,44,21,11,10
050,30,059,"Montana","Meagher County",2,45,16,9,7
050,30,059,"Montana","Meagher County",2,46,20,11,9
050,30,059,"Montana","Meagher County",2,47,20,10,10
050,30,059,"Montana","Meagher County",2,48,14,8,6
050,30,059,"Montana","Meagher County",2,49,16,9,7
050,30,059,"Montana","Meagher County",2,50,17,9,8
050,30,059,"Montana","Meagher County",2,51,20,10,10
050,30,059,"Montana","Meagher County",2,52,15,6,9
050,30,059,"Montana","Meagher County",2,53,16,9,7
050,30,059,"Montana","Meagher County",2,54,23,14,9
050,30,059,"Montana","Meagher County",2,55,24,13,11
050,30,059,"Montana","Meagher County",2,56,27,13,14
050,30,059,"Montana","Meagher County",2,57,27,13,14
050,30,059,"Montana","Meagher County",2,58,27,12,15
050,30,059,"Montana","Meagher County",2,59,29,13,16
050,30,059,"Montana","Meagher County",2,60,34,20,14
050,30,059,"Montana","Meagher County",2,61,43,19,24
050,30,059,"Montana","Meagher County",2,62,45,21,24
050,30,059,"Montana","Meagher County",2,63,42,20,22
050,30,059,"Montana","Meagher County",2,64,39,19,20
050,30,059,"Montana","Meagher County",2,65,36,18,18
050,30,059,"Montana","Meagher County",2,66,31,14,17
050,30,059,"Montana","Meagher County",2,67,39,22,17
050,30,059,"Montana","Meagher County",2,68,44,25,19
050,30,059,"Montana","Meagher County",2,69,42,24,18
050,30,059,"Montana","Meagher County",2,70,42,22,20
050,30,059,"Montana","Meagher County",2,71,46,24,22
050,30,059,"Montana","Meagher County",2,72,40,22,18
050,30,059,"Montana","Meagher County",2,73,38,17,21
050,30,059,"Montana","Meagher County",2,74,23,10,13
050,30,059,"Montana","Meagher County",2,75,21,13,8
050,30,059,"Montana","Meagher County",2,76,29,20,9
050,30,059,"Montana","Meagher County",2,77,28,19,9
050,30,059,"Montana","Meagher County",2,78,18,10,8
050,30,059,"Montana","Meagher County",2,79,16,7,9
050,30,059,"Montana","Meagher County",2,80,10,4,6
050,30,059,"Montana","Meagher County",2,81,12,3,9
050,30,059,"Montana","Meagher County",2,82,13,6,7
050,30,059,"Montana","Meagher County",2,83,13,7,6
050,30,059,"Montana","Meagher County",2,84,10,6,4
050,30,059,"Montana","Meagher County",2,85,57,19,38
050,30,059,"Montana","Meagher County",3,0,16,9,7
050,30,059,"Montana","Meagher County",3,1,8,8,0
050,30,059,"Montana","Meagher County",3,2,25,14,11
050,30,059,"Montana","Meagher County",3,3,23,14,9
050,30,059,"Montana","Meagher County",3,4,18,10,8
050,30,059,"Montana","Meagher County",3,5,18,11,7
050,30,059,"Montana","Meagher County",3,6,18,10,8
050,30,059,"Montana","Meagher County",3,7,19,10,9
050,30,059,"Montana","Meagher County",3,8,18,10,8
050,30,059,"Montana","Meagher County",3,9,24,14,10
050,30,059,"Montana","Meagher County",3,10,18,8,10
050,30,059,"Montana","Meagher County",3,11,22,14,8
050,30,059,"Montana","Meagher County",3,12,22,13,9
050,30,059,"Montana","Meagher County",3,13,14,7,7
050,30,059,"Montana","Meagher County",3,14,16,7,9
050,30,059,"Montana","Meagher County",3,15,21,12,9
050,30,059,"Montana","Meagher County",3,16,20,14,6
050,30,059,"Montana","Meagher County",3,17,27,18,9
050,30,059,"Montana","Meagher County",3,18,22,13,9
050,30,059,"Montana","Meagher County",3,19,11,7,4
050,30,059,"Montana","Meagher County",3,20,9,5,4
050,30,059,"Montana","Meagher County",3,21,8,3,5
050,30,059,"Montana","Meagher County",3,22,21,11,10
050,30,059,"Montana","Meagher County",3,23,15,8,7
050,30,059,"Montana","Meagher County",3,24,9,7,2
050,30,059,"Montana","Meagher County",3,25,12,5,7
050,30,059,"Montana","Meagher County",3,26,13,7,6
050,30,059,"Montana","Meagher County",3,27,19,8,11
050,30,059,"Montana","Meagher County",3,28,13,8,5
050,30,059,"Montana","Meagher County",3,29,15,11,4
050,30,059,"Montana","Meagher County",3,30,17,9,8
050,30,059,"Montana","Meagher County",3,31,19,10,9
050,30,059,"Montana","Meagher County",3,32,18,9,9
050,30,059,"Montana","Meagher County",3,33,18,9,9
050,30,059,"Montana","Meagher County",3,34,13,6,7
050,30,059,"Montana","Meagher County",3,35,13,6,7
050,30,059,"Montana","Meagher County",3,36,20,12,8
050,30,059,"Montana","Meagher County",3,37,21,10,11
050,30,059,"Montana","Meagher County",3,38,26,14,12
050,30,059,"Montana","Meagher County",3,39,22,12,10
050,30,059,"Montana","Meagher County",3,40,19,10,9
050,30,059,"Montana","Meagher County",3,41,22,13,9
050,30,059,"Montana","Meagher County",3,42,19,10,9
050,30,059,"Montana","Meagher County",3,43,21,10,11
050,30,059,"Montana","Meagher County",3,44,20,10,10
050,30,059,"Montana","Meagher County",3,45,22,12,10
050,30,059,"Montana","Meagher County",3,46,15,8,7
050,30,059,"Montana","Meagher County",3,47,22,11,11
050,30,059,"Montana","Meagher County",3,48,23,11,12
050,30,059,"Montana","Meagher County",3,49,13,8,5
050,30,059,"Montana","Meagher County",3,50,15,9,6
050,30,059,"Montana","Meagher County",3,51,18,10,8
050,30,059,"Montana","Meagher County",3,52,23,10,13
050,30,059,"Montana","Meagher County",3,53,17,8,9
050,30,059,"Montana","Meagher County",3,54,17,10,7
050,30,059,"Montana","Meagher County",3,55,27,15,12
050,30,059,"Montana","Meagher County",3,56,27,13,14
050,30,059,"Montana","Meagher County",3,57,31,14,17
050,30,059,"Montana","Meagher County",3,58,29,15,14
050,30,059,"Montana","Meagher County",3,59,28,13,15
050,30,059,"Montana","Meagher County",3,60,30,13,17
050,30,059,"Montana","Meagher County",3,61,37,23,14
050,30,059,"Montana","Meagher County",3,62,45,21,24
050,30,059,"Montana","Meagher County",3,63,44,19,25
050,30,059,"Montana","Meagher County",3,64,39,18,21
050,30,059,"Montana","Meagher County",3,65,41,19,22
050,30,059,"Montana","Meagher County",3,66,40,21,19
050,30,059,"Montana","Meagher County",3,67,27,12,15
050,30,059,"Montana","Meagher County",3,68,39,21,18
050,30,059,"Montana","Meagher County",3,69,42,24,18
050,30,059,"Montana","Meagher County",3,70,38,23,15
050,30,059,"Montana","Meagher County",3,71,41,22,19
050,30,059,"Montana","Meagher County",3,72,47,25,22
050,30,059,"Montana","Meagher County",3,73,39,20,19
050,30,059,"Montana","Meagher County",3,74,40,19,21
050,30,059,"Montana","Meagher County",3,75,24,10,14
050,30,059,"Montana","Meagher County",3,76,18,11,7
050,30,059,"Montana","Meagher County",3,77,28,19,9
050,30,059,"Montana","Meagher County",3,78,26,17,9
050,30,059,"Montana","Meagher County",3,79,17,9,8
050,30,059,"Montana","Meagher County",3,80,16,6,10
050,30,059,"Montana","Meagher County",3,81,10,4,6
050,30,059,"Montana","Meagher County",3,82,11,3,8
050,30,059,"Montana","Meagher County",3,83,15,8,7
050,30,059,"Montana","Meagher County",3,84,12,6,6
050,30,059,"Montana","Meagher County",3,85,63,23,40
050,30,059,"Montana","Meagher County",4,0,22,16,6
050,30,059,"Montana","Meagher County",4,1,16,9,7
050,30,059,"Montana","Meagher County",4,2,10,10,0
050,30,059,"Montana","Meagher County",4,3,28,15,13
050,30,059,"Montana","Meagher County",4,4,29,20,9
050,30,059,"Montana","Meagher County",4,5,20,11,9
050,30,059,"Montana","Meagher County",4,6,22,13,9
050,30,059,"Montana","Meagher County",4,7,20,11,9
050,30,059,"Montana","Meagher County",4,8,20,10,10
050,30,059,"Montana","Meagher County",4,9,23,12,11
050,30,059,"Montana","Meagher County",4,10,26,15,11
050,30,059,"Montana","Meagher County",4,11,19,9,10
050,30,059,"Montana","Meagher County",4,12,22,14,8
050,30,059,"Montana","Meagher County",4,13,24,14,10
050,30,059,"Montana","Meagher County",4,14,15,7,8
050,30,059,"Montana","Meagher County",4,15,16,7,9
050,30,059,"Montana","Meagher County",4,16,23,13,10
050,30,059,"Montana","Meagher County",4,17,21,14,7
050,30,059,"Montana","Meagher County",4,18,22,14,8
050,30,059,"Montana","Meagher County",4,19,18,12,6
050,30,059,"Montana","Meagher County",4,20,13,7,6
050,30,059,"Montana","Meagher County",4,21,12,7,5
050,30,059,"Montana","Meagher County",4,22,9,3,6
050,30,059,"Montana","Meagher County",4,23,21,11,10
050,30,059,"Montana","Meagher County",4,24,14,6,8
050,30,059,"Montana","Meagher County",4,25,9,6,3
050,30,059,"Montana","Meagher County",4,26,12,5,7
050,30,059,"Montana","Meagher County",4,27,18,8,10
050,30,059,"Montana","Meagher County",4,28,24,11,13
050,30,059,"Montana","Meagher County",4,29,16,10,6
050,30,059,"Montana","Meagher County",4,30,18,12,6
050,30,059,"Montana","Meagher County",4,31,19,7,12
050,30,059,"Montana","Meagher County",4,32,26,13,13
050,30,059,"Montana","Meagher County",4,33,22,11,11
050,30,059,"Montana","Meagher County",4,34,20,9,11
050,30,059,"Montana","Meagher County",4,35,15,7,8
050,30,059,"Montana","Meagher County",4,36,16,10,6
050,30,059,"Montana","Meagher County",4,37,21,11,10
050,30,059,"Montana","Meagher County",4,38,21,10,11
050,30,059,"Montana","Meagher County",4,39,24,13,11
050,30,059,"Montana","Meagher County",4,40,23,13,10
050,30,059,"Montana","Meagher County",4,41,24,12,12
050,30,059,"Montana","Meagher County",4,42,25,17,8
050,30,059,"Montana","Meagher County",4,43,16,9,7
050,30,059,"Montana","Meagher County",4,44,20,10,10
050,30,059,"Montana","Meagher County",4,45,20,9,11
050,30,059,"Montana","Meagher County",4,46,26,16,10
050,30,059,"Montana","Meagher County",4,47,14,8,6
050,30,059,"Montana","Meagher County",4,48,22,11,11
050,30,059,"Montana","Meagher County",4,49,22,9,13
050,30,059,"Montana","Meagher County",4,50,16,11,5
050,30,059,"Montana","Meagher County",4,51,15,9,6
050,30,059,"Montana","Meagher County",4,52,15,8,7
050,30,059,"Montana","Meagher County",4,53,23,9,14
050,30,059,"Montana","Meagher County",4,54,17,8,9
050,30,059,"Montana","Meagher County",4,55,19,12,7
050,30,059,"Montana","Meagher County",4,56,23,14,9
050,30,059,"Montana","Meagher County",4,57,20,10,10
050,30,059,"Montana","Meagher County",4,58,38,15,23
050,30,059,"Montana","Meagher County",4,59,27,14,13
050,30,059,"Montana","Meagher County",4,60,26,11,15
050,30,059,"Montana","Meagher County",4,61,30,13,17
050,30,059,"Montana","Meagher County",4,62,39,25,14
050,30,059,"Montana","Meagher County",4,63,47,21,26
050,30,059,"Montana","Meagher County",4,64,44,19,25
050,30,059,"Montana","Meagher County",4,65,38,18,20
050,30,059,"Montana","Meagher County",4,66,40,19,21
050,30,059,"Montana","Meagher County",4,67,35,17,18
050,30,059,"Montana","Meagher County",4,68,28,13,15
050,30,059,"Montana","Meagher County",4,69,38,20,18
050,30,059,"Montana","Meagher County",4,70,41,23,18
050,30,059,"Montana","Meagher County",4,71,36,22,14
050,30,059,"Montana","Meagher County",4,72,44,26,18
050,30,059,"Montana","Meagher County",4,73,47,25,22
050,30,059,"Montana","Meagher County",4,74,38,20,18
050,30,059,"Montana","Meagher County",4,75,38,19,19
050,30,059,"Montana","Meagher County",4,76,24,10,14
050,30,059,"Montana","Meagher County",4,77,18,11,7
050,30,059,"Montana","Meagher County",4,78,27,18,9
050,30,059,"Montana","Meagher County",4,79,26,16,10
050,30,059,"Montana","Meagher County",4,80,18,9,9
050,30,059,"Montana","Meagher County",4,81,15,6,9
050,30,059,"Montana","Meagher County",4,82,7,2,5
050,30,059,"Montana","Meagher County",4,83,11,3,8
050,30,059,"Montana","Meagher County",4,84,11,4,7
050,30,059,"Montana","Meagher County",4,85,69,27,42
050,30,059,"Montana","Meagher County",5,0,22,16,6
050,30,059,"Montana","Meagher County",5,1,22,16,6
050,30,059,"Montana","Meagher County",5,2,17,9,8
050,30,059,"Montana","Meagher County",5,3,11,10,1
050,30,059,"Montana","Meagher County",5,4,29,15,14
050,30,059,"Montana","Meagher County",5,5,29,20,9
050,30,059,"Montana","Meagher County",5,6,19,10,9
050,30,059,"Montana","Meagher County",5,7,19,10,9
050,30,059,"Montana","Meagher County",5,8,20,11,9
050,30,059,"Montana","Meagher County",5,9,20,11,9
050,30,059,"Montana","Meagher County",5,10,22,14,8
050,30,059,"Montana","Meagher County",5,11,27,16,11
050,30,059,"Montana","Meagher County",5,12,16,9,7
050,30,059,"Montana","Meagher County",5,13,22,13,9
050,30,059,"Montana","Meagher County",5,14,24,15,9
050,30,059,"Montana","Meagher County",5,15,18,10,8
050,30,059,"Montana","Meagher County",5,16,16,7,9
050,30,059,"Montana","Meagher County",5,17,19,11,8
050,30,059,"Montana","Meagher County",5,18,16,11,5
050,30,059,"Montana","Meagher County",5,19,19,13,6
050,30,059,"Montana","Meagher County",5,20,18,10,8
050,30,059,"Montana","Meagher County",5,21,16,8,8
050,30,059,"Montana","Meagher County",5,22,11,7,4
050,30,059,"Montana","Meagher County",5,23,8,3,5
050,30,059,"Montana","Meagher County",5,24,28,15,13
050,30,059,"Montana","Meagher County",5,25,11,4,7
050,30,059,"Montana","Meagher County",5,26,8,6,2
050,30,059,"Montana","Meagher County",5,27,14,8,6
050,30,059,"Montana","Meagher County",5,28,16,6,10
050,30,059,"Montana","Meagher County",5,29,23,10,13
050,30,059,"Montana","Meagher County",5,30,18,10,8
050,30,059,"Montana","Meagher County",5,31,15,10,5
050,30,059,"Montana","Meagher County",5,32,21,7,14
050,30,059,"Montana","Meagher County",5,33,29,16,13
050,30,059,"Montana","Meagher County",5,34,25,11,14
050,30,059,"Montana","Meagher County",5,35,22,12,10
050,30,059,"Montana","Meagher County",5,36,18,10,8
050,30,059,"Montana","Meagher County",5,37,20,13,7
050,30,059,"Montana","Meagher County",5,38,21,11,10
050,30,059,"Montana","Meagher County",5,39,26,11,15
050,30,059,"Montana","Meagher County",5,40,25,11,14
050,30,059,"Montana","Meagher County",5,41,26,15,11
050,30,059,"Montana","Meagher County",5,42,25,9,16
050,30,059,"Montana","Meagher County",5,43,27,16,11
050,30,059,"Montana","Meagher County",5,44,16,9,7
050,30,059,"Montana","Meagher County",5,45,22,12,10
050,30,059,"Montana","Meagher County",5,46,18,9,9
050,30,059,"Montana","Meagher County",5,47,29,19,10
050,30,059,"Montana","Meagher County",5,48,14,8,6
050,30,059,"Montana","Meagher County",5,49,19,11,8
050,30,059,"Montana","Meagher County",5,50,21,9,12
050,30,059,"Montana","Meagher County",5,51,16,10,6
050,30,059,"Montana","Meagher County",5,52,16,12,4
050,30,059,"Montana","Meagher County",5,53,16,8,8
050,30,059,"Montana","Meagher County",5,54,23,7,16
050,30,059,"Montana","Meagher County",5,55,22,11,11
050,30,059,"Montana","Meagher County",5,56,22,12,10
050,30,059,"Montana","Meagher County",5,57,21,13,8
050,30,059,"Montana","Meagher County",5,58,15,7,8
050,30,059,"Montana","Meagher County",5,59,37,14,23
050,30,059,"Montana","Meagher County",5,60,29,14,15
050,30,059,"Montana","Meagher County",5,61,28,11,17
050,30,059,"Montana","Meagher County",5,62,32,13,19
050,30,059,"Montana","Meagher County",5,63,39,25,14
050,30,059,"Montana","Meagher County",5,64,51,22,29
050,30,059,"Montana","Meagher County",5,65,46,21,25
050,30,059,"Montana","Meagher County",5,66,38,18,20
050,30,059,"Montana","Meagher County",5,67,42,21,21
050,30,059,"Montana","Meagher County",5,68,37,19,18
050,30,059,"Montana","Meagher County",5,69,29,14,15
050,30,059,"Montana","Meagher County",5,70,39,19,20
050,30,059,"Montana","Meagher County",5,71,41,24,17
050,30,059,"Montana","Meagher County",5,72,37,22,15
050,30,059,"Montana","Meagher County",5,73,43,25,18
050,30,059,"Montana","Meagher County",5,74,47,25,22
050,30,059,"Montana","Meagher County",5,75,37,19,18
050,30,059,"Montana","Meagher County",5,76,38,19,19
050,30,059,"Montana","Meagher County",5,77,23,10,13
050,30,059,"Montana","Meagher County",5,78,18,11,7
050,30,059,"Montana","Meagher County",5,79,28,18,10
050,30,059,"Montana","Meagher County",5,80,26,16,10
050,30,059,"Montana","Meagher County",5,81,16,9,7
050,30,059,"Montana","Meagher County",5,82,10,4,6
050,30,059,"Montana","Meagher County",5,83,7,2,5
050,30,059,"Montana","Meagher County",5,84,9,1,8
050,30,059,"Montana","Meagher County",5,85,76,30,46
050,30,061,"Montana","Mineral County",1,0,43,23,20
050,30,061,"Montana","Mineral County",1,1,48,27,21
050,30,061,"Montana","Mineral County",1,2,48,27,21
050,30,061,"Montana","Mineral County",1,3,47,25,22
050,30,061,"Montana","Mineral County",1,4,52,30,22
050,30,061,"Montana","Mineral County",1,5,47,25,22
050,30,061,"Montana","Mineral County",1,6,47,24,23
050,30,061,"Montana","Mineral County",1,7,42,19,23
050,30,061,"Montana","Mineral County",1,8,39,22,17
050,30,061,"Montana","Mineral County",1,9,46,23,23
050,30,061,"Montana","Mineral County",1,10,42,24,18
050,30,061,"Montana","Mineral County",1,11,50,28,22
050,30,061,"Montana","Mineral County",1,12,57,24,33
050,30,061,"Montana","Mineral County",1,13,64,27,37
050,30,061,"Montana","Mineral County",1,14,49,20,29
050,30,061,"Montana","Mineral County",1,15,51,18,33
050,30,061,"Montana","Mineral County",1,16,51,25,26
050,30,061,"Montana","Mineral County",1,17,43,26,17
050,30,061,"Montana","Mineral County",1,18,41,26,15
050,30,061,"Montana","Mineral County",1,19,28,18,10
050,30,061,"Montana","Mineral County",1,20,28,12,16
050,30,061,"Montana","Mineral County",1,21,27,14,13
050,30,061,"Montana","Mineral County",1,22,27,14,13
050,30,061,"Montana","Mineral County",1,23,27,15,12
050,30,061,"Montana","Mineral County",1,24,36,21,15
050,30,061,"Montana","Mineral County",1,25,37,19,18
050,30,061,"Montana","Mineral County",1,26,40,23,17
050,30,061,"Montana","Mineral County",1,27,41,19,22
050,30,061,"Montana","Mineral County",1,28,42,18,24
050,30,061,"Montana","Mineral County",1,29,40,20,20
050,30,061,"Montana","Mineral County",1,30,43,27,16
050,30,061,"Montana","Mineral County",1,31,43,27,16
050,30,061,"Montana","Mineral County",1,32,41,20,21
050,30,061,"Montana","Mineral County",1,33,43,21,22
050,30,061,"Montana","Mineral County",1,34,47,20,27
050,30,061,"Montana","Mineral County",1,35,46,26,20
050,30,061,"Montana","Mineral County",1,36,56,30,26
050,30,061,"Montana","Mineral County",1,37,53,32,21
050,30,061,"Montana","Mineral County",1,38,54,31,23
050,30,061,"Montana","Mineral County",1,39,47,29,18
050,30,061,"Montana","Mineral County",1,40,43,23,20
050,30,061,"Montana","Mineral County",1,41,44,24,20
050,30,061,"Montana","Mineral County",1,42,44,20,24
050,30,061,"Montana","Mineral County",1,43,50,22,28
050,30,061,"Montana","Mineral County",1,44,36,19,17
050,30,061,"Montana","Mineral County",1,45,32,13,19
050,30,061,"Montana","Mineral County",1,46,39,20,19
050,30,061,"Montana","Mineral County",1,47,44,25,19
050,30,061,"Montana","Mineral County",1,48,43,23,20
050,30,061,"Montana","Mineral County",1,49,36,15,21
050,30,061,"Montana","Mineral County",1,50,48,24,24
050,30,061,"Montana","Mineral County",1,51,53,26,27
050,30,061,"Montana","Mineral County",1,52,52,26,26
050,30,061,"Montana","Mineral County",1,53,64,29,35
050,30,061,"Montana","Mineral County",1,54,65,33,32
050,30,061,"Montana","Mineral County",1,55,61,32,29
050,30,061,"Montana","Mineral County",1,56,73,40,33
050,30,061,"Montana","Mineral County",1,57,73,33,40
050,30,061,"Montana","Mineral County",1,58,81,40,41
050,30,061,"Montana","Mineral County",1,59,80,39,41
050,30,061,"Montana","Mineral County",1,60,75,29,46
050,30,061,"Montana","Mineral County",1,61,87,43,44
050,30,061,"Montana","Mineral County",1,62,78,45,33
050,30,061,"Montana","Mineral County",1,63,78,47,31
050,30,061,"Montana","Mineral County",1,64,82,37,45
050,30,061,"Montana","Mineral County",1,65,94,44,50
050,30,061,"Montana","Mineral County",1,66,103,55,48
050,30,061,"Montana","Mineral County",1,67,87,42,45
050,30,061,"Montana","Mineral County",1,68,92,55,37
050,30,061,"Montana","Mineral County",1,69,81,43,38
050,30,061,"Montana","Mineral County",1,70,94,48,46
050,30,061,"Montana","Mineral County",1,71,77,42,35
050,30,061,"Montana","Mineral County",1,72,66,34,32
050,30,061,"Montana","Mineral County",1,73,72,39,33
050,30,061,"Montana","Mineral County",1,74,50,23,27
050,30,061,"Montana","Mineral County",1,75,59,32,27
050,30,061,"Montana","Mineral County",1,76,48,28,20
050,30,061,"Montana","Mineral County",1,77,60,36,24
050,30,061,"Montana","Mineral County",1,78,49,26,23
050,30,061,"Montana","Mineral County",1,79,46,27,19
050,30,061,"Montana","Mineral County",1,80,37,21,16
050,30,061,"Montana","Mineral County",1,81,30,17,13
050,30,061,"Montana","Mineral County",1,82,22,16,6
050,30,061,"Montana","Mineral County",1,83,19,10,9
050,30,061,"Montana","Mineral County",1,84,29,17,12
050,30,061,"Montana","Mineral County",1,85,102,40,62
050,30,061,"Montana","Mineral County",2,0,47,23,24
050,30,061,"Montana","Mineral County",2,1,48,26,22
050,30,061,"Montana","Mineral County",2,2,49,28,21
050,30,061,"Montana","Mineral County",2,3,48,26,22
050,30,061,"Montana","Mineral County",2,4,52,30,22
050,30,061,"Montana","Mineral County",2,5,49,26,23
050,30,061,"Montana","Mineral County",2,6,48,25,23
050,30,061,"Montana","Mineral County",2,7,43,20,23
050,30,061,"Montana","Mineral County",2,8,41,22,19
050,30,061,"Montana","Mineral County",2,9,46,24,22
050,30,061,"Montana","Mineral County",2,10,44,24,20
050,30,061,"Montana","Mineral County",2,11,48,27,21
050,30,061,"Montana","Mineral County",2,12,58,26,32
050,30,061,"Montana","Mineral County",2,13,64,28,36
050,30,061,"Montana","Mineral County",2,14,53,22,31
050,30,061,"Montana","Mineral County",2,15,50,18,32
050,30,061,"Montana","Mineral County",2,16,50,23,27
050,30,061,"Montana","Mineral County",2,17,45,26,19
050,30,061,"Montana","Mineral County",2,18,39,25,14
050,30,061,"Montana","Mineral County",2,19,28,18,10
050,30,061,"Montana","Mineral County",2,20,29,14,15
050,30,061,"Montana","Mineral County",2,21,27,14,13
050,30,061,"Montana","Mineral County",2,22,27,14,13
050,30,061,"Montana","Mineral County",2,23,30,17,13
050,30,061,"Montana","Mineral County",2,24,34,19,15
050,30,061,"Montana","Mineral County",2,25,38,20,18
050,30,061,"Montana","Mineral County",2,26,41,22,19
050,30,061,"Montana","Mineral County",2,27,41,20,21
050,30,061,"Montana","Mineral County",2,28,42,18,24
050,30,061,"Montana","Mineral County",2,29,42,20,22
050,30,061,"Montana","Mineral County",2,30,44,27,17
050,30,061,"Montana","Mineral County",2,31,44,27,17
050,30,061,"Montana","Mineral County",2,32,44,22,22
050,30,061,"Montana","Mineral County",2,33,44,22,22
050,30,061,"Montana","Mineral County",2,34,47,20,27
050,30,061,"Montana","Mineral County",2,35,47,25,22
050,30,061,"Montana","Mineral County",2,36,52,28,24
050,30,061,"Montana","Mineral County",2,37,53,31,22
050,30,061,"Montana","Mineral County",2,38,55,32,23
050,30,061,"Montana","Mineral County",2,39,51,32,19
050,30,061,"Montana","Mineral County",2,40,46,26,20
050,30,061,"Montana","Mineral County",2,41,42,23,19
050,30,061,"Montana","Mineral County",2,42,44,21,23
050,30,061,"Montana","Mineral County",2,43,49,22,27
050,30,061,"Montana","Mineral County",2,44,38,19,19
050,30,061,"Montana","Mineral County",2,45,34,15,19
050,30,061,"Montana","Mineral County",2,46,38,19,19
050,30,061,"Montana","Mineral County",2,47,44,25,19
050,30,061,"Montana","Mineral County",2,48,42,23,19
050,30,061,"Montana","Mineral County",2,49,38,17,21
050,30,061,"Montana","Mineral County",2,50,45,22,23
050,30,061,"Montana","Mineral County",2,51,51,25,26
050,30,061,"Montana","Mineral County",2,52,52,25,27
050,30,061,"Montana","Mineral County",2,53,62,28,34
050,30,061,"Montana","Mineral County",2,54,65,32,33
050,30,061,"Montana","Mineral County",2,55,63,33,30
050,30,061,"Montana","Mineral County",2,56,71,39,32
050,30,061,"Montana","Mineral County",2,57,75,36,39
050,30,061,"Montana","Mineral County",2,58,80,39,41
050,30,061,"Montana","Mineral County",2,59,81,40,41
050,30,061,"Montana","Mineral County",2,60,78,32,46
050,30,061,"Montana","Mineral County",2,61,83,40,43
050,30,061,"Montana","Mineral County",2,62,81,46,35
050,30,061,"Montana","Mineral County",2,63,78,47,31
050,30,061,"Montana","Mineral County",2,64,80,38,42
050,30,061,"Montana","Mineral County",2,65,93,43,50
050,30,061,"Montana","Mineral County",2,66,101,52,49
050,30,061,"Montana","Mineral County",2,67,93,46,47
050,30,061,"Montana","Mineral County",2,68,87,50,37
050,30,061,"Montana","Mineral County",2,69,84,46,38
050,30,061,"Montana","Mineral County",2,70,91,47,44
050,30,061,"Montana","Mineral County",2,71,82,44,38
050,30,061,"Montana","Mineral County",2,72,67,35,32
050,30,061,"Montana","Mineral County",2,73,75,40,35
050,30,061,"Montana","Mineral County",2,74,51,25,26
050,30,061,"Montana","Mineral County",2,75,57,30,27
050,30,061,"Montana","Mineral County",2,76,48,28,20
050,30,061,"Montana","Mineral County",2,77,59,35,24
050,30,061,"Montana","Mineral County",2,78,51,28,23
050,30,061,"Montana","Mineral County",2,79,46,27,19
050,30,061,"Montana","Mineral County",2,80,40,23,17
050,30,061,"Montana","Mineral County",2,81,29,16,13
050,30,061,"Montana","Mineral County",2,82,23,16,7
050,30,061,"Montana","Mineral County",2,83,19,11,8
050,30,061,"Montana","Mineral County",2,84,26,15,11
050,30,061,"Montana","Mineral County",2,85,104,41,63
050,30,061,"Montana","Mineral County",3,0,32,17,15
050,30,061,"Montana","Mineral County",3,1,48,20,28
050,30,061,"Montana","Mineral County",3,2,59,29,30
050,30,061,"Montana","Mineral County",3,3,58,30,28
050,30,061,"Montana","Mineral County",3,4,52,26,26
050,30,061,"Montana","Mineral County",3,5,60,33,27
050,30,061,"Montana","Mineral County",3,6,55,30,25
050,30,061,"Montana","Mineral County",3,7,62,32,30
050,30,061,"Montana","Mineral County",3,8,50,23,27
050,30,061,"Montana","Mineral County",3,9,48,24,24
050,30,061,"Montana","Mineral County",3,10,48,23,25
050,30,061,"Montana","Mineral County",3,11,47,27,20
050,30,061,"Montana","Mineral County",3,12,52,30,22
050,30,061,"Montana","Mineral County",3,13,65,28,37
050,30,061,"Montana","Mineral County",3,14,59,25,34
050,30,061,"Montana","Mineral County",3,15,59,23,36
050,30,061,"Montana","Mineral County",3,16,53,20,33
050,30,061,"Montana","Mineral County",3,17,46,22,24
050,30,061,"Montana","Mineral County",3,18,41,24,17
050,30,061,"Montana","Mineral County",3,19,30,21,9
050,30,061,"Montana","Mineral County",3,20,25,18,7
050,30,061,"Montana","Mineral County",3,21,31,14,17
050,30,061,"Montana","Mineral County",3,22,29,16,13
050,30,061,"Montana","Mineral County",3,23,36,21,15
050,30,061,"Montana","Mineral County",3,24,33,16,17
050,30,061,"Montana","Mineral County",3,25,41,20,21
050,30,061,"Montana","Mineral County",3,26,40,23,17
050,30,061,"Montana","Mineral County",3,27,45,22,23
050,30,061,"Montana","Mineral County",3,28,52,27,25
050,30,061,"Montana","Mineral County",3,29,43,18,25
050,30,061,"Montana","Mineral County",3,30,54,28,26
050,30,061,"Montana","Mineral County",3,31,51,29,22
050,30,061,"Montana","Mineral County",3,32,49,29,20
050,30,061,"Montana","Mineral County",3,33,50,23,27
050,30,061,"Montana","Mineral County",3,34,48,23,25
050,30,061,"Montana","Mineral County",3,35,58,25,33
050,30,061,"Montana","Mineral County",3,36,51,24,27
050,30,061,"Montana","Mineral County",3,37,61,34,27
050,30,061,"Montana","Mineral County",3,38,64,36,28
050,30,061,"Montana","Mineral County",3,39,59,34,25
050,30,061,"Montana","Mineral County",3,40,53,36,17
050,30,061,"Montana","Mineral County",3,41,49,26,23
050,30,061,"Montana","Mineral County",3,42,46,24,22
050,30,061,"Montana","Mineral County",3,43,48,25,23
050,30,061,"Montana","Mineral County",3,44,56,30,26
050,30,061,"Montana","Mineral County",3,45,37,20,17
050,30,061,"Montana","Mineral County",3,46,32,13,19
050,30,061,"Montana","Mineral County",3,47,40,22,18
050,30,061,"Montana","Mineral County",3,48,43,24,19
050,30,061,"Montana","Mineral County",3,49,44,24,20
050,30,061,"Montana","Mineral County",3,50,45,21,24
050,30,061,"Montana","Mineral County",3,51,49,22,27
050,30,061,"Montana","Mineral County",3,52,51,25,26
050,30,061,"Montana","Mineral County",3,53,55,27,28
050,30,061,"Montana","Mineral County",3,54,69,28,41
050,30,061,"Montana","Mineral County",3,55,64,29,35
050,30,061,"Montana","Mineral County",3,56,63,31,32
050,30,061,"Montana","Mineral County",3,57,82,44,38
050,30,061,"Montana","Mineral County",3,58,76,38,38
050,30,061,"Montana","Mineral County",3,59,87,42,45
050,30,061,"Montana","Mineral County",3,60,88,45,43
050,30,061,"Montana","Mineral County",3,61,83,36,47
050,30,061,"Montana","Mineral County",3,62,88,45,43
050,30,061,"Montana","Mineral County",3,63,91,48,43
050,30,061,"Montana","Mineral County",3,64,82,52,30
050,30,061,"Montana","Mineral County",3,65,85,43,42
050,30,061,"Montana","Mineral County",3,66,96,46,50
050,30,061,"Montana","Mineral County",3,67,105,52,53
050,30,061,"Montana","Mineral County",3,68,94,46,48
050,30,061,"Montana","Mineral County",3,69,87,50,37
050,30,061,"Montana","Mineral County",3,70,83,47,36
050,30,061,"Montana","Mineral County",3,71,90,46,44
050,30,061,"Montana","Mineral County",3,72,83,45,38
050,30,061,"Montana","Mineral County",3,73,61,30,31
050,30,061,"Montana","Mineral County",3,74,78,40,38
050,30,061,"Montana","Mineral County",3,75,48,23,25
050,30,061,"Montana","Mineral County",3,76,56,30,26
050,30,061,"Montana","Mineral County",3,77,43,24,19
050,30,061,"Montana","Mineral County",3,78,59,33,26
050,30,061,"Montana","Mineral County",3,79,49,26,23
050,30,061,"Montana","Mineral County",3,80,43,27,16
050,30,061,"Montana","Mineral County",3,81,39,23,16
050,30,061,"Montana","Mineral County",3,82,29,15,14
050,30,061,"Montana","Mineral County",3,83,22,14,8
050,30,061,"Montana","Mineral County",3,84,17,10,7
050,30,061,"Montana","Mineral County",3,85,127,52,75
050,30,061,"Montana","Mineral County",4,0,34,16,18
050,30,061,"Montana","Mineral County",4,1,40,22,18
050,30,061,"Montana","Mineral County",4,2,53,22,31
050,30,061,"Montana","Mineral County",4,3,64,34,30
050,30,061,"Montana","Mineral County",4,4,62,33,29
050,30,061,"Montana","Mineral County",4,5,52,24,28
050,30,061,"Montana","Mineral County",4,6,57,35,22
050,30,061,"Montana","Mineral County",4,7,52,31,21
050,30,061,"Montana","Mineral County",4,8,60,32,28
050,30,061,"Montana","Mineral County",4,9,50,28,22
050,30,061,"Montana","Mineral County",4,10,51,32,19
050,30,061,"Montana","Mineral County",4,11,53,25,28
050,30,061,"Montana","Mineral County",4,12,46,28,18
050,30,061,"Montana","Mineral County",4,13,51,29,22
050,30,061,"Montana","Mineral County",4,14,61,30,31
050,30,061,"Montana","Mineral County",4,15,61,24,37
050,30,061,"Montana","Mineral County",4,16,59,23,36
050,30,061,"Montana","Mineral County",4,17,60,22,38
050,30,061,"Montana","Mineral County",4,18,40,20,20
050,30,061,"Montana","Mineral County",4,19,29,17,12
050,30,061,"Montana","Mineral County",4,20,24,17,7
050,30,061,"Montana","Mineral County",4,21,28,19,9
050,30,061,"Montana","Mineral County",4,22,29,10,19
050,30,061,"Montana","Mineral County",4,23,32,17,15
050,30,061,"Montana","Mineral County",4,24,34,19,15
050,30,061,"Montana","Mineral County",4,25,49,23,26
050,30,061,"Montana","Mineral County",4,26,47,25,22
050,30,061,"Montana","Mineral County",4,27,39,22,17
050,30,061,"Montana","Mineral County",4,28,45,20,25
050,30,061,"Montana","Mineral County",4,29,58,31,27
050,30,061,"Montana","Mineral County",4,30,53,26,27
050,30,061,"Montana","Mineral County",4,31,63,33,30
050,30,061,"Montana","Mineral County",4,32,57,32,25
050,30,061,"Montana","Mineral County",4,33,44,28,16
050,30,061,"Montana","Mineral County",4,34,57,30,27
050,30,061,"Montana","Mineral County",4,35,52,24,28
050,30,061,"Montana","Mineral County",4,36,63,25,38
050,30,061,"Montana","Mineral County",4,37,65,32,33
050,30,061,"Montana","Mineral County",4,38,59,33,26
050,30,061,"Montana","Mineral County",4,39,70,41,29
050,30,061,"Montana","Mineral County",4,40,54,29,25
050,30,061,"Montana","Mineral County",4,41,48,32,16
050,30,061,"Montana","Mineral County",4,42,42,22,20
050,30,061,"Montana","Mineral County",4,43,50,28,22
050,30,061,"Montana","Mineral County",4,44,53,25,28
050,30,061,"Montana","Mineral County",4,45,57,31,26
050,30,061,"Montana","Mineral County",4,46,45,22,23
050,30,061,"Montana","Mineral County",4,47,37,15,22
050,30,061,"Montana","Mineral County",4,48,38,21,17
050,30,061,"Montana","Mineral County",4,49,50,27,23
050,30,061,"Montana","Mineral County",4,50,54,30,24
050,30,061,"Montana","Mineral County",4,51,52,27,25
050,30,061,"Montana","Mineral County",4,52,52,22,30
050,30,061,"Montana","Mineral County",4,53,55,28,27
050,30,061,"Montana","Mineral County",4,54,60,29,31
050,30,061,"Montana","Mineral County",4,55,72,31,41
050,30,061,"Montana","Mineral County",4,56,77,35,42
050,30,061,"Montana","Mineral County",4,57,64,34,30
050,30,061,"Montana","Mineral County",4,58,83,45,38
050,30,061,"Montana","Mineral County",4,59,76,39,37
050,30,061,"Montana","Mineral County",4,60,96,49,47
050,30,061,"Montana","Mineral County",4,61,86,45,41
050,30,061,"Montana","Mineral County",4,62,91,41,50
050,30,061,"Montana","Mineral County",4,63,93,49,44
050,30,061,"Montana","Mineral County",4,64,91,48,43
050,30,061,"Montana","Mineral County",4,65,91,58,33
050,30,061,"Montana","Mineral County",4,66,85,41,44
050,30,061,"Montana","Mineral County",4,67,98,45,53
050,30,061,"Montana","Mineral County",4,68,102,52,50
050,30,061,"Montana","Mineral County",4,69,91,47,44
050,30,061,"Montana","Mineral County",4,70,94,52,42
050,30,061,"Montana","Mineral County",4,71,81,42,39
050,30,061,"Montana","Mineral County",4,72,93,47,46
050,30,061,"Montana","Mineral County",4,73,83,44,39
050,30,061,"Montana","Mineral County",4,74,59,28,31
050,30,061,"Montana","Mineral County",4,75,73,38,35
050,30,061,"Montana","Mineral County",4,76,45,21,24
050,30,061,"Montana","Mineral County",4,77,52,27,25
050,30,061,"Montana","Mineral County",4,78,43,24,19
050,30,061,"Montana","Mineral County",4,79,57,32,25
050,30,061,"Montana","Mineral County",4,80,44,24,20
050,30,061,"Montana","Mineral County",4,81,43,27,16
050,30,061,"Montana","Mineral County",4,82,35,20,15
050,30,061,"Montana","Mineral County",4,83,26,15,11
050,30,061,"Montana","Mineral County",4,84,20,13,7
050,30,061,"Montana","Mineral County",4,85,126,52,74
050,30,061,"Montana","Mineral County",5,0,34,16,18
050,30,061,"Montana","Mineral County",5,1,39,21,18
050,30,061,"Montana","Mineral County",5,2,41,24,17
050,30,061,"Montana","Mineral County",5,3,51,23,28
050,30,061,"Montana","Mineral County",5,4,58,34,24
050,30,061,"Montana","Mineral County",5,5,62,36,26
050,30,061,"Montana","Mineral County",5,6,53,26,27
050,30,061,"Montana","Mineral County",5,7,60,35,25
050,30,061,"Montana","Mineral County",5,8,52,29,23
050,30,061,"Montana","Mineral County",5,9,57,30,27
050,30,061,"Montana","Mineral County",5,10,53,31,22
050,30,061,"Montana","Mineral County",5,11,57,36,21
050,30,061,"Montana","Mineral County",5,12,46,24,22
050,30,061,"Montana","Mineral County",5,13,54,35,19
050,30,061,"Montana","Mineral County",5,14,53,32,21
050,30,061,"Montana","Mineral County",5,15,60,33,27
050,30,061,"Montana","Mineral County",5,16,61,27,34
050,30,061,"Montana","Mineral County",5,17,65,30,35
050,30,061,"Montana","Mineral County",5,18,47,19,28
050,30,061,"Montana","Mineral County",5,19,38,17,21
050,30,061,"Montana","Mineral County",5,20,33,21,12
050,30,061,"Montana","Mineral County",5,21,27,17,10
050,30,061,"Montana","Mineral County",5,22,28,18,10
050,30,061,"Montana","Mineral County",5,23,37,14,23
050,30,061,"Montana","Mineral County",5,24,43,21,22
050,30,061,"Montana","Mineral County",5,25,34,20,14
050,30,061,"Montana","Mineral County",5,26,46,26,20
050,30,061,"Montana","Mineral County",5,27,42,21,21
050,30,061,"Montana","Mineral County",5,28,38,20,18
050,30,061,"Montana","Mineral County",5,29,49,21,28
050,30,061,"Montana","Mineral County",5,30,63,35,28
050,30,061,"Montana","Mineral County",5,31,48,23,25
050,30,061,"Montana","Mineral County",5,32,64,33,31
050,30,061,"Montana","Mineral County",5,33,55,33,22
050,30,061,"Montana","Mineral County",5,34,47,27,20
050,30,061,"Montana","Mineral County",5,35,50,25,25
050,30,061,"Montana","Mineral County",5,36,48,19,29
050,30,061,"Montana","Mineral County",5,37,69,31,38
050,30,061,"Montana","Mineral County",5,38,65,31,34
050,30,061,"Montana","Mineral County",5,39,57,32,25
050,30,061,"Montana","Mineral County",5,40,65,38,27
050,30,061,"Montana","Mineral County",5,41,64,33,31
050,30,061,"Montana","Mineral County",5,42,54,36,18
050,30,061,"Montana","Mineral County",5,43,50,26,24
050,30,061,"Montana","Mineral County",5,44,53,27,26
050,30,061,"Montana","Mineral County",5,45,54,22,32
050,30,061,"Montana","Mineral County",5,46,63,36,27
050,30,061,"Montana","Mineral County",5,47,49,23,26
050,30,061,"Montana","Mineral County",5,48,41,17,24
050,30,061,"Montana","Mineral County",5,49,40,20,20
050,30,061,"Montana","Mineral County",5,50,49,24,25
050,30,061,"Montana","Mineral County",5,51,56,28,28
050,30,061,"Montana","Mineral County",5,52,50,26,24
050,30,061,"Montana","Mineral County",5,53,52,24,28
050,30,061,"Montana","Mineral County",5,54,58,30,28
050,30,061,"Montana","Mineral County",5,55,68,34,34
050,30,061,"Montana","Mineral County",5,56,74,32,42
050,30,061,"Montana","Mineral County",5,57,84,43,41
050,30,061,"Montana","Mineral County",5,58,73,39,34
050,30,061,"Montana","Mineral County",5,59,87,47,40
050,30,061,"Montana","Mineral County",5,60,75,42,33
050,30,061,"Montana","Mineral County",5,61,99,52,47
050,30,061,"Montana","Mineral County",5,62,89,45,44
050,30,061,"Montana","Mineral County",5,63,87,40,47
050,30,061,"Montana","Mineral County",5,64,93,51,42
050,30,061,"Montana","Mineral County",5,65,90,46,44
050,30,061,"Montana","Mineral County",5,66,87,55,32
050,30,061,"Montana","Mineral County",5,67,88,42,46
050,30,061,"Montana","Mineral County",5,68,98,46,52
050,30,061,"Montana","Mineral County",5,69,96,47,49
050,30,061,"Montana","Mineral County",5,70,88,46,42
050,30,061,"Montana","Mineral County",5,71,87,47,40
050,30,061,"Montana","Mineral County",5,72,82,43,39
050,30,061,"Montana","Mineral County",5,73,93,47,46
050,30,061,"Montana","Mineral County",5,74,78,42,36
050,30,061,"Montana","Mineral County",5,75,55,26,29
050,30,061,"Montana","Mineral County",5,76,69,34,35
050,30,061,"Montana","Mineral County",5,77,37,18,19
050,30,061,"Montana","Mineral County",5,78,52,25,27
050,30,061,"Montana","Mineral County",5,79,45,23,22
050,30,061,"Montana","Mineral County",5,80,53,29,24
050,30,061,"Montana","Mineral County",5,81,43,24,19
050,30,061,"Montana","Mineral County",5,82,40,26,14
050,30,061,"Montana","Mineral County",5,83,32,18,14
050,30,061,"Montana","Mineral County",5,84,29,17,12
050,30,061,"Montana","Mineral County",5,85,137,57,80
050,30,063,"Montana","Missoula County",1,0,1034,534,500
050,30,063,"Montana","Missoula County",1,1,1027,531,496
050,30,063,"Montana","Missoula County",1,2,1136,557,579
050,30,063,"Montana","Missoula County",1,3,1244,629,615
050,30,063,"Montana","Missoula County",1,4,1268,663,605
050,30,063,"Montana","Missoula County",1,5,1245,654,591
050,30,063,"Montana","Missoula County",1,6,1190,606,584
050,30,063,"Montana","Missoula County",1,7,1220,635,585
050,30,063,"Montana","Missoula County",1,8,1199,607,592
050,30,063,"Montana","Missoula County",1,9,1218,609,609
050,30,063,"Montana","Missoula County",1,10,1292,657,635
050,30,063,"Montana","Missoula County",1,11,1317,679,638
050,30,063,"Montana","Missoula County",1,12,1381,715,666
050,30,063,"Montana","Missoula County",1,13,1392,736,656
050,30,063,"Montana","Missoula County",1,14,1319,708,611
050,30,063,"Montana","Missoula County",1,15,1240,643,597
050,30,063,"Montana","Missoula County",1,16,1275,646,629
050,30,063,"Montana","Missoula County",1,17,1237,637,600
050,30,063,"Montana","Missoula County",1,18,1417,692,725
050,30,063,"Montana","Missoula County",1,19,2015,1049,966
050,30,063,"Montana","Missoula County",1,20,2244,1016,1228
050,30,063,"Montana","Missoula County",1,21,2488,1223,1265
050,30,063,"Montana","Missoula County",1,22,2603,1354,1249
050,30,063,"Montana","Missoula County",1,23,2337,1217,1120
050,30,063,"Montana","Missoula County",1,24,2242,1136,1106
050,30,063,"Montana","Missoula County",1,25,2112,1051,1061
050,30,063,"Montana","Missoula County",1,26,2024,1011,1013
050,30,063,"Montana","Missoula County",1,27,1913,959,954
050,30,063,"Montana","Missoula County",1,28,1925,972,953
050,30,063,"Montana","Missoula County",1,29,1988,1043,945
050,30,063,"Montana","Missoula County",1,30,1910,1034,876
050,30,063,"Montana","Missoula County",1,31,1738,898,840
050,30,063,"Montana","Missoula County",1,32,1674,851,823
050,30,063,"Montana","Missoula County",1,33,1645,827,818
050,30,063,"Montana","Missoula County",1,34,1681,855,826
050,30,063,"Montana","Missoula County",1,35,1754,893,861
050,30,063,"Montana","Missoula County",1,36,1678,876,802
050,30,063,"Montana","Missoula County",1,37,1748,917,831
050,30,063,"Montana","Missoula County",1,38,1692,897,795
050,30,063,"Montana","Missoula County",1,39,1703,866,837
050,30,063,"Montana","Missoula County",1,40,1644,853,791
050,30,063,"Montana","Missoula County",1,41,1564,817,747
050,30,063,"Montana","Missoula County",1,42,1500,771,729
050,30,063,"Montana","Missoula County",1,43,1500,770,730
050,30,063,"Montana","Missoula County",1,44,1383,693,690
050,30,063,"Montana","Missoula County",1,45,1274,631,643
050,30,063,"Montana","Missoula County",1,46,1263,667,596
050,30,063,"Montana","Missoula County",1,47,1210,624,586
050,30,063,"Montana","Missoula County",1,48,1250,667,583
050,30,063,"Montana","Missoula County",1,49,1364,719,645
050,30,063,"Montana","Missoula County",1,50,1339,727,612
050,30,063,"Montana","Missoula County",1,51,1234,626,608
050,30,063,"Montana","Missoula County",1,52,1197,592,605
050,30,063,"Montana","Missoula County",1,53,1253,643,610
050,30,063,"Montana","Missoula County",1,54,1234,608,626
050,30,063,"Montana","Missoula County",1,55,1303,610,693
050,30,063,"Montana","Missoula County",1,56,1338,674,664
050,30,063,"Montana","Missoula County",1,57,1394,697,697
050,30,063,"Montana","Missoula County",1,58,1437,695,742
050,30,063,"Montana","Missoula County",1,59,1395,677,718
050,30,063,"Montana","Missoula County",1,60,1355,645,710
050,30,063,"Montana","Missoula County",1,61,1386,701,685
050,30,063,"Montana","Missoula County",1,62,1418,690,728
050,30,063,"Montana","Missoula County",1,63,1412,675,737
050,30,063,"Montana","Missoula County",1,64,1381,669,712
050,30,063,"Montana","Missoula County",1,65,1493,690,803
050,30,063,"Montana","Missoula County",1,66,1449,668,781
050,30,063,"Montana","Missoula County",1,67,1399,679,720
050,30,063,"Montana","Missoula County",1,68,1357,687,670
050,30,063,"Montana","Missoula County",1,69,1227,629,598
050,30,063,"Montana","Missoula County",1,70,1182,593,589
050,30,063,"Montana","Missoula County",1,71,1130,580,550
050,30,063,"Montana","Missoula County",1,72,1138,596,542
050,30,063,"Montana","Missoula County",1,73,1118,565,553
050,30,063,"Montana","Missoula County",1,74,768,356,412
050,30,063,"Montana","Missoula County",1,75,743,350,393
050,30,063,"Montana","Missoula County",1,76,712,345,367
050,30,063,"Montana","Missoula County",1,77,694,326,368
050,30,063,"Montana","Missoula County",1,78,618,288,330
050,30,063,"Montana","Missoula County",1,79,517,243,274
050,30,063,"Montana","Missoula County",1,80,467,236,231
050,30,063,"Montana","Missoula County",1,81,423,201,222
050,30,063,"Montana","Missoula County",1,82,370,171,199
050,30,063,"Montana","Missoula County",1,83,339,146,193
050,30,063,"Montana","Missoula County",1,84,306,131,175
050,30,063,"Montana","Missoula County",1,85,1684,660,1024
050,30,063,"Montana","Missoula County",2,0,1042,526,516
050,30,063,"Montana","Missoula County",2,1,1033,532,501
050,30,063,"Montana","Missoula County",2,2,1118,555,563
050,30,063,"Montana","Missoula County",2,3,1216,614,602
050,30,063,"Montana","Missoula County",2,4,1271,659,612
050,30,063,"Montana","Missoula County",2,5,1261,661,600
050,30,063,"Montana","Missoula County",2,6,1212,620,592
050,30,063,"Montana","Missoula County",2,7,1214,629,585
050,30,063,"Montana","Missoula County",2,8,1202,612,590
050,30,063,"Montana","Missoula County",2,9,1215,609,606
050,30,063,"Montana","Missoula County",2,10,1281,648,633
050,30,063,"Montana","Missoula County",2,11,1306,670,636
050,30,063,"Montana","Missoula County",2,12,1372,708,664
050,30,063,"Montana","Missoula County",2,13,1391,732,659
050,30,063,"Montana","Missoula County",2,14,1337,717,620
050,30,063,"Montana","Missoula County",2,15,1267,663,604
050,30,063,"Montana","Missoula County",2,16,1268,646,622
050,30,063,"Montana","Missoula County",2,17,1249,637,612
050,30,063,"Montana","Missoula County",2,18,1424,694,730
050,30,063,"Montana","Missoula County",2,19,2021,1050,971
050,30,063,"Montana","Missoula County",2,20,2276,1032,1244
050,30,063,"Montana","Missoula County",2,21,2470,1211,1259
050,30,063,"Montana","Missoula County",2,22,2611,1365,1246
050,30,063,"Montana","Missoula County",2,23,2345,1217,1128
050,30,063,"Montana","Missoula County",2,24,2213,1120,1093
050,30,063,"Montana","Missoula County",2,25,2111,1052,1059
050,30,063,"Montana","Missoula County",2,26,1996,998,998
050,30,063,"Montana","Missoula County",2,27,1914,955,959
050,30,063,"Montana","Missoula County",2,28,1934,976,958
050,30,063,"Montana","Missoula County",2,29,1980,1033,947
050,30,063,"Montana","Missoula County",2,30,1948,1045,903
050,30,063,"Montana","Missoula County",2,31,1777,928,849
050,30,063,"Montana","Missoula County",2,32,1692,861,831
050,30,063,"Montana","Missoula County",2,33,1651,835,816
050,30,063,"Montana","Missoula County",2,34,1678,854,824
050,30,063,"Montana","Missoula County",2,35,1746,889,857
050,30,063,"Montana","Missoula County",2,36,1691,874,817
050,30,063,"Montana","Missoula County",2,37,1739,909,830
050,30,063,"Montana","Missoula County",2,38,1714,904,810
050,30,063,"Montana","Missoula County",2,39,1702,874,828
050,30,063,"Montana","Missoula County",2,40,1667,854,813
050,30,063,"Montana","Missoula County",2,41,1585,824,761
050,30,063,"Montana","Missoula County",2,42,1510,779,731
050,30,063,"Montana","Missoula County",2,43,1516,784,732
050,30,063,"Montana","Missoula County",2,44,1406,709,697
050,30,063,"Montana","Missoula County",2,45,1309,652,657
050,30,063,"Montana","Missoula County",2,46,1266,659,607
050,30,063,"Montana","Missoula County",2,47,1217,630,587
050,30,063,"Montana","Missoula County",2,48,1236,652,584
050,30,063,"Montana","Missoula County",2,49,1343,710,633
050,30,063,"Montana","Missoula County",2,50,1353,732,621
050,30,063,"Montana","Missoula County",2,51,1248,643,605
050,30,063,"Montana","Missoula County",2,52,1203,601,602
050,30,063,"Montana","Missoula County",2,53,1235,628,607
050,30,063,"Montana","Missoula County",2,54,1240,618,622
050,30,063,"Montana","Missoula County",2,55,1283,607,676
050,30,063,"Montana","Missoula County",2,56,1327,659,668
050,30,063,"Montana","Missoula County",2,57,1383,692,691
050,30,063,"Montana","Missoula County",2,58,1432,700,732
050,30,063,"Montana","Missoula County",2,59,1406,679,727
050,30,063,"Montana","Missoula County",2,60,1363,655,708
050,30,063,"Montana","Missoula County",2,61,1378,688,690
050,30,063,"Montana","Missoula County",2,62,1406,687,719
050,30,063,"Montana","Missoula County",2,63,1423,684,739
050,30,063,"Montana","Missoula County",2,64,1380,665,715
050,30,063,"Montana","Missoula County",2,65,1461,682,779
050,30,063,"Montana","Missoula County",2,66,1461,671,790
050,30,063,"Montana","Missoula County",2,67,1406,674,732
050,30,063,"Montana","Missoula County",2,68,1361,683,678
050,30,063,"Montana","Missoula County",2,69,1275,650,625
050,30,063,"Montana","Missoula County",2,70,1192,599,593
050,30,063,"Montana","Missoula County",2,71,1139,578,561
050,30,063,"Montana","Missoula County",2,72,1114,581,533
050,30,063,"Montana","Missoula County",2,73,1176,602,574
050,30,063,"Montana","Missoula County",2,74,800,379,421
050,30,063,"Montana","Missoula County",2,75,747,349,398
050,30,063,"Montana","Missoula County",2,76,704,339,365
050,30,063,"Montana","Missoula County",2,77,711,337,374
050,30,063,"Montana","Missoula County",2,78,626,295,331
050,30,063,"Montana","Missoula County",2,79,534,249,285
050,30,063,"Montana","Missoula County",2,80,476,236,240
050,30,063,"Montana","Missoula County",2,81,426,203,223
050,30,063,"Montana","Missoula County",2,82,383,182,201
050,30,063,"Montana","Missoula County",2,83,341,146,195
050,30,063,"Montana","Missoula County",2,84,312,135,177
050,30,063,"Montana","Missoula County",2,85,1699,665,1034
050,30,063,"Montana","Missoula County",3,0,1081,569,512
050,30,063,"Montana","Missoula County",3,1,1030,519,511
050,30,063,"Montana","Missoula County",3,2,1054,542,512
050,30,063,"Montana","Missoula County",3,3,1093,544,549
050,30,063,"Montana","Missoula County",3,4,1218,609,609
050,30,063,"Montana","Missoula County",3,5,1296,667,629
050,30,063,"Montana","Missoula County",3,6,1275,664,611
050,30,063,"Montana","Missoula County",3,7,1189,616,573
050,30,063,"Montana","Missoula County",3,8,1226,647,579
050,30,063,"Montana","Missoula County",3,9,1192,603,589
050,30,063,"Montana","Missoula County",3,10,1234,616,618
050,30,063,"Montana","Missoula County",3,11,1251,650,601
050,30,063,"Montana","Missoula County",3,12,1311,666,645
050,30,063,"Montana","Missoula County",3,13,1353,715,638
050,30,063,"Montana","Missoula County",3,14,1399,740,659
050,30,063,"Montana","Missoula County",3,15,1349,742,607
050,30,063,"Montana","Missoula County",3,16,1275,678,597
050,30,063,"Montana","Missoula County",3,17,1281,659,622
050,30,063,"Montana","Missoula County",3,18,1432,701,731
050,30,063,"Montana","Missoula County",3,19,2026,1043,983
050,30,063,"Montana","Missoula County",3,20,2285,1021,1264
050,30,063,"Montana","Missoula County",3,21,2454,1202,1252
050,30,063,"Montana","Missoula County",3,22,2642,1361,1281
050,30,063,"Montana","Missoula County",3,23,2383,1241,1142
050,30,063,"Montana","Missoula County",3,24,2215,1132,1083
050,30,063,"Montana","Missoula County",3,25,2074,1057,1017
050,30,063,"Montana","Missoula County",3,26,1989,977,1012
050,30,063,"Montana","Missoula County",3,27,1933,966,967
050,30,063,"Montana","Missoula County",3,28,1942,979,963
050,30,063,"Montana","Missoula County",3,29,1948,974,974
050,30,063,"Montana","Missoula County",3,30,2013,1053,960
050,30,063,"Montana","Missoula County",3,31,1944,1040,904
050,30,063,"Montana","Missoula County",3,32,1798,919,879
050,30,063,"Montana","Missoula County",3,33,1688,888,800
050,30,063,"Montana","Missoula County",3,34,1661,830,831
050,30,063,"Montana","Missoula County",3,35,1721,879,842
050,30,063,"Montana","Missoula County",3,36,1764,887,877
050,30,063,"Montana","Missoula County",3,37,1712,874,838
050,30,063,"Montana","Missoula County",3,38,1776,921,855
050,30,063,"Montana","Missoula County",3,39,1777,942,835
050,30,063,"Montana","Missoula County",3,40,1717,887,830
050,30,063,"Montana","Missoula County",3,41,1666,854,812
050,30,063,"Montana","Missoula County",3,42,1606,834,772
050,30,063,"Montana","Missoula County",3,43,1522,791,731
050,30,063,"Montana","Missoula County",3,44,1552,789,763
050,30,063,"Montana","Missoula County",3,45,1378,697,681
050,30,063,"Montana","Missoula County",3,46,1317,646,671
050,30,063,"Montana","Missoula County",3,47,1235,643,592
050,30,063,"Montana","Missoula County",3,48,1243,644,599
050,30,063,"Montana","Missoula County",3,49,1227,643,584
050,30,063,"Montana","Missoula County",3,50,1380,737,643
050,30,063,"Montana","Missoula County",3,51,1319,704,615
050,30,063,"Montana","Missoula County",3,52,1272,675,597
050,30,063,"Montana","Missoula County",3,53,1190,599,591
050,30,063,"Montana","Missoula County",3,54,1263,642,621
050,30,063,"Montana","Missoula County",3,55,1223,607,616
050,30,063,"Montana","Missoula County",3,56,1273,603,670
050,30,063,"Montana","Missoula County",3,57,1342,675,667
050,30,063,"Montana","Missoula County",3,58,1399,704,695
050,30,063,"Montana","Missoula County",3,59,1413,677,736
050,30,063,"Montana","Missoula County",3,60,1408,674,734
050,30,063,"Montana","Missoula County",3,61,1367,664,703
050,30,063,"Montana","Missoula County",3,62,1352,664,688
050,30,063,"Montana","Missoula County",3,63,1408,679,729
050,30,063,"Montana","Missoula County",3,64,1401,671,730
050,30,063,"Montana","Missoula County",3,65,1372,661,711
050,30,063,"Montana","Missoula County",3,66,1459,660,799
050,30,063,"Montana","Missoula County",3,67,1452,660,792
050,30,063,"Montana","Missoula County",3,68,1394,675,719
050,30,063,"Montana","Missoula County",3,69,1344,670,674
050,30,063,"Montana","Missoula County",3,70,1267,637,630
050,30,063,"Montana","Missoula County",3,71,1160,578,582
050,30,063,"Montana","Missoula County",3,72,1141,591,550
050,30,063,"Montana","Missoula County",3,73,1094,576,518
050,30,063,"Montana","Missoula County",3,74,1151,584,567
050,30,063,"Montana","Missoula County",3,75,778,365,413
050,30,063,"Montana","Missoula County",3,76,718,327,391
050,30,063,"Montana","Missoula County",3,77,670,315,355
050,30,063,"Montana","Missoula County",3,78,689,322,367
050,30,063,"Montana","Missoula County",3,79,590,268,322
050,30,063,"Montana","Missoula County",3,80,523,250,273
050,30,063,"Montana","Missoula County",3,81,451,223,228
050,30,063,"Montana","Missoula County",3,82,413,202,211
050,30,063,"Montana","Missoula County",3,83,375,168,207
050,30,063,"Montana","Missoula County",3,84,309,134,175
050,30,063,"Montana","Missoula County",3,85,1734,702,1032
050,30,063,"Montana","Missoula County",4,0,1108,574,534
050,30,063,"Montana","Missoula County",4,1,1083,581,502
050,30,063,"Montana","Missoula County",4,2,1074,553,521
050,30,063,"Montana","Missoula County",4,3,1030,537,493
050,30,063,"Montana","Missoula County",4,4,1072,516,556
050,30,063,"Montana","Missoula County",4,5,1215,607,608
050,30,063,"Montana","Missoula County",4,6,1261,651,610
050,30,063,"Montana","Missoula County",4,7,1272,671,601
050,30,063,"Montana","Missoula County",4,8,1197,620,577
050,30,063,"Montana","Missoula County",4,9,1202,627,575
050,30,063,"Montana","Missoula County",4,10,1203,594,609
050,30,063,"Montana","Missoula County",4,11,1209,610,599
050,30,063,"Montana","Missoula County",4,12,1279,658,621
050,30,063,"Montana","Missoula County",4,13,1301,656,645
050,30,063,"Montana","Missoula County",4,14,1374,711,663
050,30,063,"Montana","Missoula County",4,15,1432,776,656
050,30,063,"Montana","Missoula County",4,16,1343,733,610
050,30,063,"Montana","Missoula County",4,17,1290,682,608
050,30,063,"Montana","Missoula County",4,18,1447,728,719
050,30,063,"Montana","Missoula County",4,19,1990,1026,964
050,30,063,"Montana","Missoula County",4,20,2260,1013,1247
050,30,063,"Montana","Missoula County",4,21,2473,1205,1268
050,30,063,"Montana","Missoula County",4,22,2664,1386,1278
050,30,063,"Montana","Missoula County",4,23,2391,1249,1142
050,30,063,"Montana","Missoula County",4,24,2273,1159,1114
050,30,063,"Montana","Missoula County",4,25,2092,1059,1033
050,30,063,"Montana","Missoula County",4,26,1927,1004,923
050,30,063,"Montana","Missoula County",4,27,1898,913,985
050,30,063,"Montana","Missoula County",4,28,1960,978,982
050,30,063,"Montana","Missoula County",4,29,1958,1003,955
050,30,063,"Montana","Missoula County",4,30,1954,987,967
050,30,063,"Montana","Missoula County",4,31,1997,1036,961
050,30,063,"Montana","Missoula County",4,32,1949,1036,913
050,30,063,"Montana","Missoula County",4,33,1796,919,877
050,30,063,"Montana","Missoula County",4,34,1739,923,816
050,30,063,"Montana","Missoula County",4,35,1660,840,820
050,30,063,"Montana","Missoula County",4,36,1729,864,865
050,30,063,"Montana","Missoula County",4,37,1796,910,886
050,30,063,"Montana","Missoula County",4,38,1709,875,834
050,30,063,"Montana","Missoula County",4,39,1784,934,850
050,30,063,"Montana","Missoula County",4,40,1813,957,856
050,30,063,"Montana","Missoula County",4,41,1741,910,831
050,30,063,"Montana","Missoula County",4,42,1736,864,872
050,30,063,"Montana","Missoula County",4,43,1603,832,771
050,30,063,"Montana","Missoula County",4,44,1550,810,740
050,30,063,"Montana","Missoula County",4,45,1532,774,758
050,30,063,"Montana","Missoula County",4,46,1387,706,681
050,30,063,"Montana","Missoula County",4,47,1329,651,678
050,30,063,"Montana","Missoula County",4,48,1236,641,595
050,30,063,"Montana","Missoula County",4,49,1255,632,623
050,30,063,"Montana","Missoula County",4,50,1256,674,582
050,30,063,"Montana","Missoula County",4,51,1364,725,639
050,30,063,"Montana","Missoula County",4,52,1342,716,626
050,30,063,"Montana","Missoula County",4,53,1270,666,604
050,30,063,"Montana","Missoula County",4,54,1192,608,584
050,30,063,"Montana","Missoula County",4,55,1249,624,625
050,30,063,"Montana","Missoula County",4,56,1193,594,599
050,30,063,"Montana","Missoula County",4,57,1276,611,665
050,30,063,"Montana","Missoula County",4,58,1342,676,666
050,30,063,"Montana","Missoula County",4,59,1376,681,695
050,30,063,"Montana","Missoula County",4,60,1395,675,720
050,30,063,"Montana","Missoula County",4,61,1406,674,732
050,30,063,"Montana","Missoula County",4,62,1376,674,702
050,30,063,"Montana","Missoula County",4,63,1342,653,689
050,30,063,"Montana","Missoula County",4,64,1395,660,735
050,30,063,"Montana","Missoula County",4,65,1377,661,716
050,30,063,"Montana","Missoula County",4,66,1368,646,722
050,30,063,"Montana","Missoula County",4,67,1438,653,785
050,30,063,"Montana","Missoula County",4,68,1423,645,778
050,30,063,"Montana","Missoula County",4,69,1372,657,715
050,30,063,"Montana","Missoula County",4,70,1344,666,678
050,30,063,"Montana","Missoula County",4,71,1234,618,616
050,30,063,"Montana","Missoula County",4,72,1121,561,560
050,30,063,"Montana","Missoula County",4,73,1116,574,542
050,30,063,"Montana","Missoula County",4,74,1074,560,514
050,30,063,"Montana","Missoula County",4,75,1117,561,556
050,30,063,"Montana","Missoula County",4,76,763,359,404
050,30,063,"Montana","Missoula County",4,77,704,310,394
050,30,063,"Montana","Missoula County",4,78,650,298,352
050,30,063,"Montana","Missoula County",4,79,646,294,352
050,30,063,"Montana","Missoula County",4,80,569,257,312
050,30,063,"Montana","Missoula County",4,81,500,240,260
050,30,063,"Montana","Missoula County",4,82,411,204,207
050,30,063,"Montana","Missoula County",4,83,399,179,220
050,30,063,"Montana","Missoula County",4,84,331,146,185
050,30,063,"Montana","Missoula County",4,85,1707,689,1018
050,30,063,"Montana","Missoula County",5,0,1110,576,534
050,30,063,"Montana","Missoula County",5,1,1093,562,531
050,30,063,"Montana","Missoula County",5,2,1095,567,528
050,30,063,"Montana","Missoula County",5,3,1050,551,499
050,30,063,"Montana","Missoula County",5,4,1030,530,500
050,30,063,"Montana","Missoula County",5,5,1055,509,546
050,30,063,"Montana","Missoula County",5,6,1193,593,600
050,30,063,"Montana","Missoula County",5,7,1254,649,605
050,30,063,"Montana","Missoula County",5,8,1261,658,603
050,30,063,"Montana","Missoula County",5,9,1182,607,575
050,30,063,"Montana","Missoula County",5,10,1207,633,574
050,30,063,"Montana","Missoula County",5,11,1211,607,604
050,30,063,"Montana","Missoula County",5,12,1200,600,600
050,30,063,"Montana","Missoula County",5,13,1289,655,634
050,30,063,"Montana","Missoula County",5,14,1305,669,636
050,30,063,"Montana","Missoula County",5,15,1415,733,682
050,30,063,"Montana","Missoula County",5,16,1423,756,667
050,30,063,"Montana","Missoula County",5,17,1352,730,622
050,30,063,"Montana","Missoula County",5,18,1449,736,713
050,30,063,"Montana","Missoula County",5,19,2019,1066,953
050,30,063,"Montana","Missoula County",5,20,2248,1006,1242
050,30,063,"Montana","Missoula County",5,21,2446,1193,1253
050,30,063,"Montana","Missoula County",5,22,2667,1400,1267
050,30,063,"Montana","Missoula County",5,23,2435,1255,1180
050,30,063,"Montana","Missoula County",5,24,2219,1131,1088
050,30,063,"Montana","Missoula County",5,25,2082,1066,1016
050,30,063,"Montana","Missoula County",5,26,1883,946,937
050,30,063,"Montana","Missoula County",5,27,1869,979,890
050,30,063,"Montana","Missoula County",5,28,1905,921,984
050,30,063,"Montana","Missoula County",5,29,1921,976,945
050,30,063,"Montana","Missoula County",5,30,1923,984,939
050,30,063,"Montana","Missoula County",5,31,1987,1023,964
050,30,063,"Montana","Missoula County",5,32,2011,1049,962
050,30,063,"Montana","Missoula County",5,33,1952,1035,917
050,30,063,"Montana","Missoula County",5,34,1816,940,876
050,30,063,"Montana","Missoula County",5,35,1756,935,821
050,30,063,"Montana","Missoula County",5,36,1693,853,840
050,30,063,"Montana","Missoula County",5,37,1723,864,859
050,30,063,"Montana","Missoula County",5,38,1758,884,874
050,30,063,"Montana","Missoula County",5,39,1699,897,802
050,30,063,"Montana","Missoula County",5,40,1752,910,842
050,30,063,"Montana","Missoula County",5,41,1798,945,853
050,30,063,"Montana","Missoula County",5,42,1750,891,859
050,30,063,"Montana","Missoula County",5,43,1780,881,899
050,30,063,"Montana","Missoula County",5,44,1622,842,780
050,30,063,"Montana","Missoula County",5,45,1527,788,739
050,30,063,"Montana","Missoula County",5,46,1546,786,760
050,30,063,"Montana","Missoula County",5,47,1385,701,684
050,30,063,"Montana","Missoula County",5,48,1318,655,663
050,30,063,"Montana","Missoula County",5,49,1248,649,599
050,30,063,"Montana","Missoula County",5,50,1290,669,621
050,30,063,"Montana","Missoula County",5,51,1247,657,590
050,30,063,"Montana","Missoula County",5,52,1371,716,655
050,30,063,"Montana","Missoula County",5,53,1347,720,627
050,30,063,"Montana","Missoula County",5,54,1271,667,604
050,30,063,"Montana","Missoula County",5,55,1184,598,586
050,30,063,"Montana","Missoula County",5,56,1234,622,612
050,30,063,"Montana","Missoula County",5,57,1179,589,590
050,30,063,"Montana","Missoula County",5,58,1288,620,668
050,30,063,"Montana","Missoula County",5,59,1314,657,657
050,30,063,"Montana","Missoula County",5,60,1357,670,687
050,30,063,"Montana","Missoula County",5,61,1393,673,720
050,30,063,"Montana","Missoula County",5,62,1380,657,723
050,30,063,"Montana","Missoula County",5,63,1355,654,701
050,30,063,"Montana","Missoula County",5,64,1337,654,683
050,30,063,"Montana","Missoula County",5,65,1394,655,739
050,30,063,"Montana","Missoula County",5,66,1384,657,727
050,30,063,"Montana","Missoula County",5,67,1355,637,718
050,30,063,"Montana","Missoula County",5,68,1427,645,782
050,30,063,"Montana","Missoula County",5,69,1398,636,762
050,30,063,"Montana","Missoula County",5,70,1357,640,717
050,30,063,"Montana","Missoula County",5,71,1319,648,671
050,30,063,"Montana","Missoula County",5,72,1221,613,608
050,30,063,"Montana","Missoula County",5,73,1101,549,552
050,30,063,"Montana","Missoula County",5,74,1093,556,537
050,30,063,"Montana","Missoula County",5,75,1041,541,500
050,30,063,"Montana","Missoula County",5,76,1099,547,552
050,30,063,"Montana","Missoula County",5,77,742,341,401
050,30,063,"Montana","Missoula County",5,78,684,309,375
050,30,063,"Montana","Missoula County",5,79,622,273,349
050,30,063,"Montana","Missoula County",5,80,631,286,345
050,30,063,"Montana","Missoula County",5,81,548,247,301
050,30,063,"Montana","Missoula County",5,82,473,226,247
050,30,063,"Montana","Missoula County",5,83,406,190,216
050,30,063,"Montana","Missoula County",5,84,356,153,203
050,30,063,"Montana","Missoula County",5,85,1739,706,1033
050,30,065,"Montana","Musselshell County",1,0,46,24,22
050,30,065,"Montana","Musselshell County",1,1,46,31,15
050,30,065,"Montana","Musselshell County",1,2,47,24,23
050,30,065,"Montana","Musselshell County",1,3,41,19,22
050,30,065,"Montana","Musselshell County",1,4,39,19,20
050,30,065,"Montana","Musselshell County",1,5,49,22,27
050,30,065,"Montana","Musselshell County",1,6,43,22,21
050,30,065,"Montana","Musselshell County",1,7,39,23,16
050,30,065,"Montana","Musselshell County",1,8,48,28,20
050,30,065,"Montana","Musselshell County",1,9,44,22,22
050,30,065,"Montana","Musselshell County",1,10,53,30,23
050,30,065,"Montana","Musselshell County",1,11,55,28,27
050,30,065,"Montana","Musselshell County",1,12,53,27,26
050,30,065,"Montana","Musselshell County",1,13,55,30,25
050,30,065,"Montana","Musselshell County",1,14,56,31,25
050,30,065,"Montana","Musselshell County",1,15,53,27,26
050,30,065,"Montana","Musselshell County",1,16,47,20,27
050,30,065,"Montana","Musselshell County",1,17,66,34,32
050,30,065,"Montana","Musselshell County",1,18,46,22,24
050,30,065,"Montana","Musselshell County",1,19,35,16,19
050,30,065,"Montana","Musselshell County",1,20,41,22,19
050,30,065,"Montana","Musselshell County",1,21,40,23,17
050,30,065,"Montana","Musselshell County",1,22,38,22,16
050,30,065,"Montana","Musselshell County",1,23,40,23,17
050,30,065,"Montana","Musselshell County",1,24,37,23,14
050,30,065,"Montana","Musselshell County",1,25,33,11,22
050,30,065,"Montana","Musselshell County",1,26,36,17,19
050,30,065,"Montana","Musselshell County",1,27,39,18,21
050,30,065,"Montana","Musselshell County",1,28,42,23,19
050,30,065,"Montana","Musselshell County",1,29,41,21,20
050,30,065,"Montana","Musselshell County",1,30,44,23,21
050,30,065,"Montana","Musselshell County",1,31,33,14,19
050,30,065,"Montana","Musselshell County",1,32,34,17,17
050,30,065,"Montana","Musselshell County",1,33,45,18,27
050,30,065,"Montana","Musselshell County",1,34,51,20,31
050,30,065,"Montana","Musselshell County",1,35,43,23,20
050,30,065,"Montana","Musselshell County",1,36,47,26,21
050,30,065,"Montana","Musselshell County",1,37,52,29,23
050,30,065,"Montana","Musselshell County",1,38,48,25,23
050,30,065,"Montana","Musselshell County",1,39,44,21,23
050,30,065,"Montana","Musselshell County",1,40,56,29,27
050,30,065,"Montana","Musselshell County",1,41,51,24,27
050,30,065,"Montana","Musselshell County",1,42,36,17,19
050,30,065,"Montana","Musselshell County",1,43,33,14,19
050,30,065,"Montana","Musselshell County",1,44,49,21,28
050,30,065,"Montana","Musselshell County",1,45,47,22,25
050,30,065,"Montana","Musselshell County",1,46,54,33,21
050,30,065,"Montana","Musselshell County",1,47,66,41,25
050,30,065,"Montana","Musselshell County",1,48,76,47,29
050,30,065,"Montana","Musselshell County",1,49,63,37,26
050,30,065,"Montana","Musselshell County",1,50,52,25,27
050,30,065,"Montana","Musselshell County",1,51,52,23,29
050,30,065,"Montana","Musselshell County",1,52,53,25,28
050,30,065,"Montana","Musselshell County",1,53,51,28,23
050,30,065,"Montana","Musselshell County",1,54,61,37,24
050,30,065,"Montana","Musselshell County",1,55,61,30,31
050,30,065,"Montana","Musselshell County",1,56,73,32,41
050,30,065,"Montana","Musselshell County",1,57,80,36,44
050,30,065,"Montana","Musselshell County",1,58,80,37,43
050,30,065,"Montana","Musselshell County",1,59,93,47,46
050,30,065,"Montana","Musselshell County",1,60,92,51,41
050,30,065,"Montana","Musselshell County",1,61,81,44,37
050,30,065,"Montana","Musselshell County",1,62,88,44,44
050,30,065,"Montana","Musselshell County",1,63,88,42,46
050,30,065,"Montana","Musselshell County",1,64,102,51,51
050,30,065,"Montana","Musselshell County",1,65,88,43,45
050,30,065,"Montana","Musselshell County",1,66,104,59,45
050,30,065,"Montana","Musselshell County",1,67,115,58,57
050,30,065,"Montana","Musselshell County",1,68,99,50,49
050,30,065,"Montana","Musselshell County",1,69,92,40,52
050,30,065,"Montana","Musselshell County",1,70,86,44,42
050,30,065,"Montana","Musselshell County",1,71,73,38,35
050,30,065,"Montana","Musselshell County",1,72,69,38,31
050,30,065,"Montana","Musselshell County",1,73,75,34,41
050,30,065,"Montana","Musselshell County",1,74,41,24,17
050,30,065,"Montana","Musselshell County",1,75,50,29,21
050,30,065,"Montana","Musselshell County",1,76,37,20,17
050,30,065,"Montana","Musselshell County",1,77,46,28,18
050,30,065,"Montana","Musselshell County",1,78,48,21,27
050,30,065,"Montana","Musselshell County",1,79,40,19,21
050,30,065,"Montana","Musselshell County",1,80,28,15,13
050,30,065,"Montana","Musselshell County",1,81,32,14,18
050,30,065,"Montana","Musselshell County",1,82,30,20,10
050,30,065,"Montana","Musselshell County",1,83,33,17,16
050,30,065,"Montana","Musselshell County",1,84,17,6,11
050,30,065,"Montana","Musselshell County",1,85,107,48,59
050,30,065,"Montana","Musselshell County",2,0,44,24,20
050,30,065,"Montana","Musselshell County",2,1,45,28,17
050,30,065,"Montana","Musselshell County",2,2,47,25,22
050,30,065,"Montana","Musselshell County",2,3,41,20,21
050,30,065,"Montana","Musselshell County",2,4,39,19,20
050,30,065,"Montana","Musselshell County",2,5,48,22,26
050,30,065,"Montana","Musselshell County",2,6,45,21,24
050,30,065,"Montana","Musselshell County",2,7,41,24,17
050,30,065,"Montana","Musselshell County",2,8,43,25,18
050,30,065,"Montana","Musselshell County",2,9,45,24,21
050,30,065,"Montana","Musselshell County",2,10,54,29,25
050,30,065,"Montana","Musselshell County",2,11,54,29,25
050,30,065,"Montana","Musselshell County",2,12,53,27,26
050,30,065,"Montana","Musselshell County",2,13,55,30,25
050,30,065,"Montana","Musselshell County",2,14,56,31,25
050,30,065,"Montana","Musselshell County",2,15,53,27,26
050,30,065,"Montana","Musselshell County",2,16,49,22,27
050,30,065,"Montana","Musselshell County",2,17,62,32,30
050,30,065,"Montana","Musselshell County",2,18,49,24,25
050,30,065,"Montana","Musselshell County",2,19,37,17,20
050,30,065,"Montana","Musselshell County",2,20,40,21,19
050,30,065,"Montana","Musselshell County",2,21,41,24,17
050,30,065,"Montana","Musselshell County",2,22,40,23,17
050,30,065,"Montana","Musselshell County",2,23,40,23,17
050,30,065,"Montana","Musselshell County",2,24,38,22,16
050,30,065,"Montana","Musselshell County",2,25,34,14,20
050,30,065,"Montana","Musselshell County",2,26,36,16,20
050,30,065,"Montana","Musselshell County",2,27,39,18,21
050,30,065,"Montana","Musselshell County",2,28,41,22,19
050,30,065,"Montana","Musselshell County",2,29,42,22,20
050,30,065,"Montana","Musselshell County",2,30,43,22,21
050,30,065,"Montana","Musselshell County",2,31,37,16,21
050,30,065,"Montana","Musselshell County",2,32,33,16,17
050,30,065,"Montana","Musselshell County",2,33,41,18,23
050,30,065,"Montana","Musselshell County",2,34,51,21,30
050,30,065,"Montana","Musselshell County",2,35,45,23,22
050,30,065,"Montana","Musselshell County",2,36,48,26,22
050,30,065,"Montana","Musselshell County",2,37,50,27,23
050,30,065,"Montana","Musselshell County",2,38,50,27,23
050,30,065,"Montana","Musselshell County",2,39,47,22,25
050,30,065,"Montana","Musselshell County",2,40,54,27,27
050,30,065,"Montana","Musselshell County",2,41,52,25,27
050,30,065,"Montana","Musselshell County",2,42,39,19,20
050,30,065,"Montana","Musselshell County",2,43,36,16,20
050,30,065,"Montana","Musselshell County",2,44,45,19,26
050,30,065,"Montana","Musselshell County",2,45,50,23,27
050,30,065,"Montana","Musselshell County",2,46,53,32,21
050,30,065,"Montana","Musselshell County",2,47,64,39,25
050,30,065,"Montana","Musselshell County",2,48,75,46,29
050,30,065,"Montana","Musselshell County",2,49,67,40,27
050,30,065,"Montana","Musselshell County",2,50,55,27,28
050,30,065,"Montana","Musselshell County",2,51,52,23,29
050,30,065,"Montana","Musselshell County",2,52,52,24,28
050,30,065,"Montana","Musselshell County",2,53,53,29,24
050,30,065,"Montana","Musselshell County",2,54,59,35,24
050,30,065,"Montana","Musselshell County",2,55,61,31,30
050,30,065,"Montana","Musselshell County",2,56,71,32,39
050,30,065,"Montana","Musselshell County",2,57,79,36,43
050,30,065,"Montana","Musselshell County",2,58,82,38,44
050,30,065,"Montana","Musselshell County",2,59,90,46,44
050,30,065,"Montana","Musselshell County",2,60,91,50,41
050,30,065,"Montana","Musselshell County",2,61,81,44,37
050,30,065,"Montana","Musselshell County",2,62,84,42,42
050,30,065,"Montana","Musselshell County",2,63,89,43,46
050,30,065,"Montana","Musselshell County",2,64,97,48,49
050,30,065,"Montana","Musselshell County",2,65,92,46,46
050,30,065,"Montana","Musselshell County",2,66,102,57,45
050,30,065,"Montana","Musselshell County",2,67,112,58,54
050,30,065,"Montana","Musselshell County",2,68,102,51,51
050,30,065,"Montana","Musselshell County",2,69,94,43,51
050,30,065,"Montana","Musselshell County",2,70,88,43,45
050,30,065,"Montana","Musselshell County",2,71,76,40,36
050,30,065,"Montana","Musselshell County",2,72,70,38,32
050,30,065,"Montana","Musselshell County",2,73,75,35,40
050,30,065,"Montana","Musselshell County",2,74,45,24,21
050,30,065,"Montana","Musselshell County",2,75,48,28,20
050,30,065,"Montana","Musselshell County",2,76,40,22,18
050,30,065,"Montana","Musselshell County",2,77,46,27,19
050,30,065,"Montana","Musselshell County",2,78,45,20,25
050,30,065,"Montana","Musselshell County",2,79,42,19,23
050,30,065,"Montana","Musselshell County",2,80,30,16,14
050,30,065,"Montana","Musselshell County",2,81,30,14,16
050,30,065,"Montana","Musselshell County",2,82,30,18,12
050,30,065,"Montana","Musselshell County",2,83,31,17,14
050,30,065,"Montana","Musselshell County",2,84,19,8,11
050,30,065,"Montana","Musselshell County",2,85,106,47,59
050,30,065,"Montana","Musselshell County",3,0,43,20,23
050,30,065,"Montana","Musselshell County",3,1,41,22,19
050,30,065,"Montana","Musselshell County",3,2,54,30,24
050,30,065,"Montana","Musselshell County",3,3,45,23,22
050,30,065,"Montana","Musselshell County",3,4,50,26,24
050,30,065,"Montana","Musselshell County",3,5,43,20,23
050,30,065,"Montana","Musselshell County",3,6,52,26,26
050,30,065,"Montana","Musselshell County",3,7,47,22,25
050,30,065,"Montana","Musselshell County",3,8,46,27,19
050,30,065,"Montana","Musselshell County",3,9,47,28,19
050,30,065,"Montana","Musselshell County",3,10,50,29,21
050,30,065,"Montana","Musselshell County",3,11,56,31,25
050,30,065,"Montana","Musselshell County",3,12,53,27,26
050,30,065,"Montana","Musselshell County",3,13,60,31,29
050,30,065,"Montana","Musselshell County",3,14,60,34,26
050,30,065,"Montana","Musselshell County",3,15,55,32,23
050,30,065,"Montana","Musselshell County",3,16,66,34,32
050,30,065,"Montana","Musselshell County",3,17,53,24,29
050,30,065,"Montana","Musselshell County",3,18,49,23,26
050,30,065,"Montana","Musselshell County",3,19,42,18,24
050,30,065,"Montana","Musselshell County",3,20,38,19,19
050,30,065,"Montana","Musselshell County",3,21,44,25,19
050,30,065,"Montana","Musselshell County",3,22,46,24,22
050,30,065,"Montana","Musselshell County",3,23,40,23,17
050,30,065,"Montana","Musselshell County",3,24,44,23,21
050,30,065,"Montana","Musselshell County",3,25,42,26,16
050,30,065,"Montana","Musselshell County",3,26,35,18,17
050,30,065,"Montana","Musselshell County",3,27,44,19,25
050,30,065,"Montana","Musselshell County",3,28,46,23,23
050,30,065,"Montana","Musselshell County",3,29,42,22,20
050,30,065,"Montana","Musselshell County",3,30,49,26,23
050,30,065,"Montana","Musselshell County",3,31,52,24,28
050,30,065,"Montana","Musselshell County",3,32,44,18,26
050,30,065,"Montana","Musselshell County",3,33,35,18,17
050,30,065,"Montana","Musselshell County",3,34,43,19,24
050,30,065,"Montana","Musselshell County",3,35,52,22,30
050,30,065,"Montana","Musselshell County",3,36,42,22,20
050,30,065,"Montana","Musselshell County",3,37,52,31,21
050,30,065,"Montana","Musselshell County",3,38,54,29,25
050,30,065,"Montana","Musselshell County",3,39,55,29,26
050,30,065,"Montana","Musselshell County",3,40,56,26,30
050,30,065,"Montana","Musselshell County",3,41,57,29,28
050,30,065,"Montana","Musselshell County",3,42,50,26,24
050,30,065,"Montana","Musselshell County",3,43,43,18,25
050,30,065,"Montana","Musselshell County",3,44,39,16,23
050,30,065,"Montana","Musselshell County",3,45,45,19,26
050,30,065,"Montana","Musselshell County",3,46,57,25,32
050,30,065,"Montana","Musselshell County",3,47,52,30,22
050,30,065,"Montana","Musselshell County",3,48,65,40,25
050,30,065,"Montana","Musselshell County",3,49,78,48,30
050,30,065,"Montana","Musselshell County",3,50,70,43,27
050,30,065,"Montana","Musselshell County",3,51,64,36,28
050,30,065,"Montana","Musselshell County",3,52,56,27,29
050,30,065,"Montana","Musselshell County",3,53,52,23,29
050,30,065,"Montana","Musselshell County",3,54,54,31,23
050,30,065,"Montana","Musselshell County",3,55,56,34,22
050,30,065,"Montana","Musselshell County",3,56,62,29,33
050,30,065,"Montana","Musselshell County",3,57,69,31,38
050,30,065,"Montana","Musselshell County",3,58,88,39,49
050,30,065,"Montana","Musselshell County",3,59,77,34,43
050,30,065,"Montana","Musselshell County",3,60,95,48,47
050,30,065,"Montana","Musselshell County",3,61,87,47,40
050,30,065,"Montana","Musselshell County",3,62,81,42,39
050,30,065,"Montana","Musselshell County",3,63,93,47,46
050,30,065,"Montana","Musselshell County",3,64,84,42,42
050,30,065,"Montana","Musselshell County",3,65,95,45,50
050,30,065,"Montana","Musselshell County",3,66,97,50,47
050,30,065,"Montana","Musselshell County",3,67,103,56,47
050,30,065,"Montana","Musselshell County",3,68,111,56,55
050,30,065,"Montana","Musselshell County",3,69,99,50,49
050,30,065,"Montana","Musselshell County",3,70,89,39,50
050,30,065,"Montana","Musselshell County",3,71,87,42,45
050,30,065,"Montana","Musselshell County",3,72,72,39,33
050,30,065,"Montana","Musselshell County",3,73,70,39,31
050,30,065,"Montana","Musselshell County",3,74,77,36,41
050,30,065,"Montana","Musselshell County",3,75,45,24,21
050,30,065,"Montana","Musselshell County",3,76,46,26,20
050,30,065,"Montana","Musselshell County",3,77,37,20,17
050,30,065,"Montana","Musselshell County",3,78,45,27,18
050,30,065,"Montana","Musselshell County",3,79,43,19,24
050,30,065,"Montana","Musselshell County",3,80,42,21,21
050,30,065,"Montana","Musselshell County",3,81,31,19,12
050,30,065,"Montana","Musselshell County",3,82,25,13,12
050,30,065,"Montana","Musselshell County",3,83,27,17,10
050,30,065,"Montana","Musselshell County",3,84,27,15,12
050,30,065,"Montana","Musselshell County",3,85,99,40,59
050,30,065,"Montana","Musselshell County",4,0,40,19,21
050,30,065,"Montana","Musselshell County",4,1,57,31,26
050,30,065,"Montana","Musselshell County",4,2,41,25,16
050,30,065,"Montana","Musselshell County",4,3,65,39,26
050,30,065,"Montana","Musselshell County",4,4,50,25,25
050,30,065,"Montana","Musselshell County",4,5,49,27,22
050,30,065,"Montana","Musselshell County",4,6,58,30,28
050,30,065,"Montana","Musselshell County",4,7,59,32,27
050,30,065,"Montana","Musselshell County",4,8,57,29,28
050,30,065,"Montana","Musselshell County",4,9,55,33,22
050,30,065,"Montana","Musselshell County",4,10,60,36,24
050,30,065,"Montana","Musselshell County",4,11,59,34,25
050,30,065,"Montana","Musselshell County",4,12,59,32,27
050,30,065,"Montana","Musselshell County",4,13,58,29,29
050,30,065,"Montana","Musselshell County",4,14,70,35,35
050,30,065,"Montana","Musselshell County",4,15,62,33,29
050,30,065,"Montana","Musselshell County",4,16,58,33,25
050,30,065,"Montana","Musselshell County",4,17,75,40,35
050,30,065,"Montana","Musselshell County",4,18,50,24,26
050,30,065,"Montana","Musselshell County",4,19,39,18,21
050,30,065,"Montana","Musselshell County",4,20,44,19,25
050,30,065,"Montana","Musselshell County",4,21,40,20,20
050,30,065,"Montana","Musselshell County",4,22,49,26,23
050,30,065,"Montana","Musselshell County",4,23,51,29,22
050,30,065,"Montana","Musselshell County",4,24,50,30,20
050,30,065,"Montana","Musselshell County",4,25,48,25,23
050,30,065,"Montana","Musselshell County",4,26,43,29,14
050,30,065,"Montana","Musselshell County",4,27,41,20,21
050,30,065,"Montana","Musselshell County",4,28,45,24,21
050,30,065,"Montana","Musselshell County",4,29,56,29,27
050,30,065,"Montana","Musselshell County",4,30,45,23,22
050,30,065,"Montana","Musselshell County",4,31,47,25,22
050,30,065,"Montana","Musselshell County",4,32,58,29,29
050,30,065,"Montana","Musselshell County",4,33,42,18,24
050,30,065,"Montana","Musselshell County",4,34,45,20,25
050,30,065,"Montana","Musselshell County",4,35,51,22,29
050,30,065,"Montana","Musselshell County",4,36,56,24,32
050,30,065,"Montana","Musselshell County",4,37,40,21,19
050,30,065,"Montana","Musselshell County",4,38,56,32,24
050,30,065,"Montana","Musselshell County",4,39,63,36,27
050,30,065,"Montana","Musselshell County",4,40,54,25,29
050,30,065,"Montana","Musselshell County",4,41,53,24,29
050,30,065,"Montana","Musselshell County",4,42,72,35,37
050,30,065,"Montana","Musselshell County",4,43,58,30,28
050,30,065,"Montana","Musselshell County",4,44,46,21,25
050,30,065,"Montana","Musselshell County",4,45,47,17,30
050,30,065,"Montana","Musselshell County",4,46,44,19,25
050,30,065,"Montana","Musselshell County",4,47,57,26,31
050,30,065,"Montana","Musselshell County",4,48,63,37,26
050,30,065,"Montana","Musselshell County",4,49,71,45,26
050,30,065,"Montana","Musselshell County",4,50,83,51,32
050,30,065,"Montana","Musselshell County",4,51,70,37,33
050,30,065,"Montana","Musselshell County",4,52,61,35,26
050,30,065,"Montana","Musselshell County",4,53,57,27,30
050,30,065,"Montana","Musselshell County",4,54,58,22,36
050,30,065,"Montana","Musselshell County",4,55,54,31,23
050,30,065,"Montana","Musselshell County",4,56,63,39,24
050,30,065,"Montana","Musselshell County",4,57,65,30,35
050,30,065,"Montana","Musselshell County",4,58,70,31,39
050,30,065,"Montana","Musselshell County",4,59,91,41,50
050,30,065,"Montana","Musselshell County",4,60,81,34,47
050,30,065,"Montana","Musselshell County",4,61,103,50,53
050,30,065,"Montana","Musselshell County",4,62,90,47,43
050,30,065,"Montana","Musselshell County",4,63,79,45,34
050,30,065,"Montana","Musselshell County",4,64,93,45,48
050,30,065,"Montana","Musselshell County",4,65,91,44,47
050,30,065,"Montana","Musselshell County",4,66,96,47,49
050,30,065,"Montana","Musselshell County",4,67,101,55,46
050,30,065,"Montana","Musselshell County",4,68,104,56,48
050,30,065,"Montana","Musselshell County",4,69,109,54,55
050,30,065,"Montana","Musselshell County",4,70,93,46,47
050,30,065,"Montana","Musselshell County",4,71,83,36,47
050,30,065,"Montana","Musselshell County",4,72,84,41,43
050,30,065,"Montana","Musselshell County",4,73,73,39,34
050,30,065,"Montana","Musselshell County",4,74,67,36,31
050,30,065,"Montana","Musselshell County",4,75,75,34,41
050,30,065,"Montana","Musselshell County",4,76,46,24,22
050,30,065,"Montana","Musselshell County",4,77,42,24,18
050,30,065,"Montana","Musselshell County",4,78,35,19,16
050,30,065,"Montana","Musselshell County",4,79,41,24,17
050,30,065,"Montana","Musselshell County",4,80,36,16,20
050,30,065,"Montana","Musselshell County",4,81,38,20,18
050,30,065,"Montana","Musselshell County",4,82,30,19,11
050,30,065,"Montana","Musselshell County",4,83,22,11,11
050,30,065,"Montana","Musselshell County",4,84,26,13,13
050,30,065,"Montana","Musselshell County",4,85,103,47,56
050,30,065,"Montana","Musselshell County",5,0,40,19,21
050,30,065,"Montana","Musselshell County",5,1,47,28,19
050,30,065,"Montana","Musselshell County",5,2,49,24,25
050,30,065,"Montana","Musselshell County",5,3,46,29,17
050,30,065,"Montana","Musselshell County",5,4,68,37,31
050,30,065,"Montana","Musselshell County",5,5,52,25,27
050,30,065,"Montana","Musselshell County",5,6,59,33,26
050,30,065,"Montana","Musselshell County",5,7,55,30,25
050,30,065,"Montana","Musselshell County",5,8,66,37,29
050,30,065,"Montana","Musselshell County",5,9,55,27,28
050,30,065,"Montana","Musselshell County",5,10,63,41,22
050,30,065,"Montana","Musselshell County",5,11,56,28,28
050,30,065,"Montana","Musselshell County",5,12,63,37,26
050,30,065,"Montana","Musselshell County",5,13,56,31,25
050,30,065,"Montana","Musselshell County",5,14,68,35,33
050,30,065,"Montana","Musselshell County",5,15,70,35,35
050,30,065,"Montana","Musselshell County",5,16,72,39,33
050,30,065,"Montana","Musselshell County",5,17,57,32,25
050,30,065,"Montana","Musselshell County",5,18,64,37,27
050,30,065,"Montana","Musselshell County",5,19,42,21,21
050,30,065,"Montana","Musselshell County",5,20,39,18,21
050,30,065,"Montana","Musselshell County",5,21,43,18,25
050,30,065,"Montana","Musselshell County",5,22,37,16,21
050,30,065,"Montana","Musselshell County",5,23,47,29,18
050,30,065,"Montana","Musselshell County",5,24,58,31,27
050,30,065,"Montana","Musselshell County",5,25,48,28,20
050,30,065,"Montana","Musselshell County",5,26,55,31,24
050,30,065,"Montana","Musselshell County",5,27,48,29,19
050,30,065,"Montana","Musselshell County",5,28,41,18,23
050,30,065,"Montana","Musselshell County",5,29,48,27,21
050,30,065,"Montana","Musselshell County",5,30,51,27,24
050,30,065,"Montana","Musselshell County",5,31,48,25,23
050,30,065,"Montana","Musselshell County",5,32,59,28,31
050,30,065,"Montana","Musselshell County",5,33,53,27,26
050,30,065,"Montana","Musselshell County",5,34,47,18,29
050,30,065,"Montana","Musselshell County",5,35,50,24,26
050,30,065,"Montana","Musselshell County",5,36,50,26,24
050,30,065,"Montana","Musselshell County",5,37,61,26,35
050,30,065,"Montana","Musselshell County",5,38,49,27,22
050,30,065,"Montana","Musselshell County",5,39,58,33,25
050,30,065,"Montana","Musselshell County",5,40,62,34,28
050,30,065,"Montana","Musselshell County",5,41,55,25,30
050,30,065,"Montana","Musselshell County",5,42,56,24,32
050,30,065,"Montana","Musselshell County",5,43,74,34,40
050,30,065,"Montana","Musselshell County",5,44,67,37,30
050,30,065,"Montana","Musselshell County",5,45,51,23,28
050,30,065,"Montana","Musselshell County",5,46,47,17,30
050,30,065,"Montana","Musselshell County",5,47,47,20,27
050,30,065,"Montana","Musselshell County",5,48,61,29,32
050,30,065,"Montana","Musselshell County",5,49,60,35,25
050,30,065,"Montana","Musselshell County",5,50,77,48,29
050,30,065,"Montana","Musselshell County",5,51,85,50,35
050,30,065,"Montana","Musselshell County",5,52,70,41,29
050,30,065,"Montana","Musselshell County",5,53,66,38,28
050,30,065,"Montana","Musselshell County",5,54,56,29,27
050,30,065,"Montana","Musselshell County",5,55,64,25,39
050,30,065,"Montana","Musselshell County",5,56,57,33,24
050,30,065,"Montana","Musselshell County",5,57,69,40,29
050,30,065,"Montana","Musselshell County",5,58,71,32,39
050,30,065,"Montana","Musselshell County",5,59,81,36,45
050,30,065,"Montana","Musselshell County",5,60,100,41,59
050,30,065,"Montana","Musselshell County",5,61,84,37,47
050,30,065,"Montana","Musselshell County",5,62,102,51,51
050,30,065,"Montana","Musselshell County",5,63,93,49,44
050,30,065,"Montana","Musselshell County",5,64,84,44,40
050,30,065,"Montana","Musselshell County",5,65,93,45,48
050,30,065,"Montana","Musselshell County",5,66,87,41,46
050,30,065,"Montana","Musselshell County",5,67,98,44,54
050,30,065,"Montana","Musselshell County",5,68,100,54,46
050,30,065,"Montana","Musselshell County",5,69,99,53,46
050,30,065,"Montana","Musselshell County",5,70,102,49,53
050,30,065,"Montana","Musselshell County",5,71,92,47,45
050,30,065,"Montana","Musselshell County",5,72,83,35,48
050,30,065,"Montana","Musselshell County",5,73,84,42,42
050,30,065,"Montana","Musselshell County",5,74,71,36,35
050,30,065,"Montana","Musselshell County",5,75,67,36,31
050,30,065,"Montana","Musselshell County",5,76,78,37,41
050,30,065,"Montana","Musselshell County",5,77,44,22,22
050,30,065,"Montana","Musselshell County",5,78,36,22,14
050,30,065,"Montana","Musselshell County",5,79,32,16,16
050,30,065,"Montana","Musselshell County",5,80,33,21,12
050,30,065,"Montana","Musselshell County",5,81,38,17,21
050,30,065,"Montana","Musselshell County",5,82,35,18,17
050,30,065,"Montana","Musselshell County",5,83,27,16,11
050,30,065,"Montana","Musselshell County",5,84,18,7,11
050,30,065,"Montana","Musselshell County",5,85,114,52,62
050,30,067,"Montana","Park County",1,0,158,82,76
050,30,067,"Montana","Park County",1,1,185,94,91
050,30,067,"Montana","Park County",1,2,154,66,88
050,30,067,"Montana","Park County",1,3,143,75,68
050,30,067,"Montana","Park County",1,4,149,85,64
050,30,067,"Montana","Park County",1,5,143,73,70
050,30,067,"Montana","Park County",1,6,152,71,81
050,30,067,"Montana","Park County",1,7,165,83,82
050,30,067,"Montana","Park County",1,8,147,75,72
050,30,067,"Montana","Park County",1,9,163,85,78
050,30,067,"Montana","Park County",1,10,161,88,73
050,30,067,"Montana","Park County",1,11,201,122,79
050,30,067,"Montana","Park County",1,12,184,95,89
050,30,067,"Montana","Park County",1,13,187,95,92
050,30,067,"Montana","Park County",1,14,165,88,77
050,30,067,"Montana","Park County",1,15,155,88,67
050,30,067,"Montana","Park County",1,16,173,89,84
050,30,067,"Montana","Park County",1,17,168,91,77
050,30,067,"Montana","Park County",1,18,160,82,78
050,30,067,"Montana","Park County",1,19,131,70,61
050,30,067,"Montana","Park County",1,20,133,74,59
050,30,067,"Montana","Park County",1,21,136,66,70
050,30,067,"Montana","Park County",1,22,138,63,75
050,30,067,"Montana","Park County",1,23,128,63,65
050,30,067,"Montana","Park County",1,24,143,70,73
050,30,067,"Montana","Park County",1,25,139,70,69
050,30,067,"Montana","Park County",1,26,177,93,84
050,30,067,"Montana","Park County",1,27,201,100,101
050,30,067,"Montana","Park County",1,28,203,98,105
050,30,067,"Montana","Park County",1,29,199,99,100
050,30,067,"Montana","Park County",1,30,206,102,104
050,30,067,"Montana","Park County",1,31,217,104,113
050,30,067,"Montana","Park County",1,32,209,109,100
050,30,067,"Montana","Park County",1,33,213,110,103
050,30,067,"Montana","Park County",1,34,211,113,98
050,30,067,"Montana","Park County",1,35,226,119,107
050,30,067,"Montana","Park County",1,36,216,114,102
050,30,067,"Montana","Park County",1,37,218,110,108
050,30,067,"Montana","Park County",1,38,224,125,99
050,30,067,"Montana","Park County",1,39,229,116,113
050,30,067,"Montana","Park County",1,40,218,106,112
050,30,067,"Montana","Park County",1,41,217,110,107
050,30,067,"Montana","Park County",1,42,229,117,112
050,30,067,"Montana","Park County",1,43,219,112,107
050,30,067,"Montana","Park County",1,44,217,116,101
050,30,067,"Montana","Park County",1,45,211,101,110
050,30,067,"Montana","Park County",1,46,208,104,104
050,30,067,"Montana","Park County",1,47,211,102,109
050,30,067,"Montana","Park County",1,48,228,104,124
050,30,067,"Montana","Park County",1,49,231,114,117
050,30,067,"Montana","Park County",1,50,207,103,104
050,30,067,"Montana","Park County",1,51,208,111,97
050,30,067,"Montana","Park County",1,52,200,112,88
050,30,067,"Montana","Park County",1,53,196,107,89
050,30,067,"Montana","Park County",1,54,193,101,92
050,30,067,"Montana","Park County",1,55,246,123,123
050,30,067,"Montana","Park County",1,56,253,136,117
050,30,067,"Montana","Park County",1,57,275,132,143
050,30,067,"Montana","Park County",1,58,300,140,160
050,30,067,"Montana","Park County",1,59,302,139,163
050,30,067,"Montana","Park County",1,60,317,159,158
050,30,067,"Montana","Park County",1,61,310,168,142
050,30,067,"Montana","Park County",1,62,298,158,140
050,30,067,"Montana","Park County",1,63,315,179,136
050,30,067,"Montana","Park County",1,64,295,150,145
050,30,067,"Montana","Park County",1,65,288,135,153
050,30,067,"Montana","Park County",1,66,284,127,157
050,30,067,"Montana","Park County",1,67,304,147,157
050,30,067,"Montana","Park County",1,68,290,150,140
050,30,067,"Montana","Park County",1,69,265,147,118
050,30,067,"Montana","Park County",1,70,253,142,111
050,30,067,"Montana","Park County",1,71,251,125,126
050,30,067,"Montana","Park County",1,72,214,109,105
050,30,067,"Montana","Park County",1,73,238,123,115
050,30,067,"Montana","Park County",1,74,189,99,90
050,30,067,"Montana","Park County",1,75,163,84,79
050,30,067,"Montana","Park County",1,76,143,76,67
050,30,067,"Montana","Park County",1,77,143,72,71
050,30,067,"Montana","Park County",1,78,117,51,66
050,30,067,"Montana","Park County",1,79,111,52,59
050,30,067,"Montana","Park County",1,80,105,47,58
050,30,067,"Montana","Park County",1,81,103,40,63
050,30,067,"Montana","Park County",1,82,69,34,35
050,30,067,"Montana","Park County",1,83,65,26,39
050,30,067,"Montana","Park County",1,84,72,26,46
050,30,067,"Montana","Park County",1,85,409,166,243
050,30,067,"Montana","Park County",2,0,163,87,76
050,30,067,"Montana","Park County",2,1,177,90,87
050,30,067,"Montana","Park County",2,2,161,73,88
050,30,067,"Montana","Park County",2,3,145,73,72
050,30,067,"Montana","Park County",2,4,149,84,65
050,30,067,"Montana","Park County",2,5,144,75,69
050,30,067,"Montana","Park County",2,6,149,71,78
050,30,067,"Montana","Park County",2,7,158,77,81
050,30,067,"Montana","Park County",2,8,150,76,74
050,30,067,"Montana","Park County",2,9,157,82,75
050,30,067,"Montana","Park County",2,10,164,90,74
050,30,067,"Montana","Park County",2,11,191,113,78
050,30,067,"Montana","Park County",2,12,190,102,88
050,30,067,"Montana","Park County",2,13,184,94,90
050,30,067,"Montana","Park County",2,14,169,90,79
050,30,067,"Montana","Park County",2,15,156,86,70
050,30,067,"Montana","Park County",2,16,166,88,78
050,30,067,"Montana","Park County",2,17,170,90,80
050,30,067,"Montana","Park County",2,18,156,81,75
050,30,067,"Montana","Park County",2,19,128,68,60
050,30,067,"Montana","Park County",2,20,136,75,61
050,30,067,"Montana","Park County",2,21,136,68,68
050,30,067,"Montana","Park County",2,22,142,68,74
050,30,067,"Montana","Park County",2,23,134,65,69
050,30,067,"Montana","Park County",2,24,142,69,73
050,30,067,"Montana","Park County",2,25,143,71,72
050,30,067,"Montana","Park County",2,26,170,91,79
050,30,067,"Montana","Park County",2,27,195,97,98
050,30,067,"Montana","Park County",2,28,202,100,102
050,30,067,"Montana","Park County",2,29,202,101,101
050,30,067,"Montana","Park County",2,30,209,105,104
050,30,067,"Montana","Park County",2,31,217,105,112
050,30,067,"Montana","Park County",2,32,214,110,104
050,30,067,"Montana","Park County",2,33,214,110,104
050,30,067,"Montana","Park County",2,34,213,112,101
050,30,067,"Montana","Park County",2,35,227,120,107
050,30,067,"Montana","Park County",2,36,220,116,104
050,30,067,"Montana","Park County",2,37,221,113,108
050,30,067,"Montana","Park County",2,38,225,123,102
050,30,067,"Montana","Park County",2,39,227,119,108
050,30,067,"Montana","Park County",2,40,224,111,113
050,30,067,"Montana","Park County",2,41,218,109,109
050,30,067,"Montana","Park County",2,42,223,113,110
050,30,067,"Montana","Park County",2,43,224,114,110
050,30,067,"Montana","Park County",2,44,214,112,102
050,30,067,"Montana","Park County",2,45,213,103,110
050,30,067,"Montana","Park County",2,46,208,103,105
050,30,067,"Montana","Park County",2,47,207,100,107
050,30,067,"Montana","Park County",2,48,224,104,120
050,30,067,"Montana","Park County",2,49,234,113,121
050,30,067,"Montana","Park County",2,50,215,107,108
050,30,067,"Montana","Park County",2,51,208,110,98
050,30,067,"Montana","Park County",2,52,203,112,91
050,30,067,"Montana","Park County",2,53,194,106,88
050,30,067,"Montana","Park County",2,54,194,103,91
050,30,067,"Montana","Park County",2,55,237,120,117
050,30,067,"Montana","Park County",2,56,256,135,121
050,30,067,"Montana","Park County",2,57,271,133,138
050,30,067,"Montana","Park County",2,58,292,137,155
050,30,067,"Montana","Park County",2,59,303,141,162
050,30,067,"Montana","Park County",2,60,313,154,159
050,30,067,"Montana","Park County",2,61,311,166,145
050,30,067,"Montana","Park County",2,62,302,162,140
050,30,067,"Montana","Park County",2,63,314,176,138
050,30,067,"Montana","Park County",2,64,298,156,142
050,30,067,"Montana","Park County",2,65,291,139,152
050,30,067,"Montana","Park County",2,66,289,130,159
050,30,067,"Montana","Park County",2,67,300,142,158
050,30,067,"Montana","Park County",2,68,292,150,142
050,30,067,"Montana","Park County",2,69,274,150,124
050,30,067,"Montana","Park County",2,70,255,142,113
050,30,067,"Montana","Park County",2,71,249,129,120
050,30,067,"Montana","Park County",2,72,217,110,107
050,30,067,"Montana","Park County",2,73,245,125,120
050,30,067,"Montana","Park County",2,74,184,95,89
050,30,067,"Montana","Park County",2,75,165,84,81
050,30,067,"Montana","Park County",2,76,144,75,69
050,30,067,"Montana","Park County",2,77,147,74,73
050,30,067,"Montana","Park County",2,78,121,55,66
050,30,067,"Montana","Park County",2,79,109,49,60
050,30,067,"Montana","Park County",2,80,106,47,59
050,30,067,"Montana","Park County",2,81,103,41,62
050,30,067,"Montana","Park County",2,82,72,32,40
050,30,067,"Montana","Park County",2,83,65,29,36
050,30,067,"Montana","Park County",2,84,70,27,43
050,30,067,"Montana","Park County",2,85,409,160,249
050,30,067,"Montana","Park County",3,0,140,67,73
050,30,067,"Montana","Park County",3,1,158,85,73
050,30,067,"Montana","Park County",3,2,176,93,83
050,30,067,"Montana","Park County",3,3,171,79,92
050,30,067,"Montana","Park County",3,4,156,83,73
050,30,067,"Montana","Park County",3,5,164,88,76
050,30,067,"Montana","Park County",3,6,153,78,75
050,30,067,"Montana","Park County",3,7,168,78,90
050,30,067,"Montana","Park County",3,8,160,83,77
050,30,067,"Montana","Park County",3,9,151,75,76
050,30,067,"Montana","Park County",3,10,166,84,82
050,30,067,"Montana","Park County",3,11,161,92,69
050,30,067,"Montana","Park County",3,12,185,103,82
050,30,067,"Montana","Park County",3,13,187,101,86
050,30,067,"Montana","Park County",3,14,183,93,90
050,30,067,"Montana","Park County",3,15,160,83,77
050,30,067,"Montana","Park County",3,16,161,87,74
050,30,067,"Montana","Park County",3,17,172,94,78
050,30,067,"Montana","Park County",3,18,148,83,65
050,30,067,"Montana","Park County",3,19,124,65,59
050,30,067,"Montana","Park County",3,20,136,74,62
050,30,067,"Montana","Park County",3,21,141,75,66
050,30,067,"Montana","Park County",3,22,144,72,72
050,30,067,"Montana","Park County",3,23,153,73,80
050,30,067,"Montana","Park County",3,24,139,71,68
050,30,067,"Montana","Park County",3,25,163,79,84
050,30,067,"Montana","Park County",3,26,163,86,77
050,30,067,"Montana","Park County",3,27,182,97,85
050,30,067,"Montana","Park County",3,28,213,97,116
050,30,067,"Montana","Park County",3,29,231,119,112
050,30,067,"Montana","Park County",3,30,231,113,118
050,30,067,"Montana","Park County",3,31,201,101,100
050,30,067,"Montana","Park County",3,32,227,111,116
050,30,067,"Montana","Park County",3,33,224,117,107
050,30,067,"Montana","Park County",3,34,228,120,108
050,30,067,"Montana","Park County",3,35,235,118,117
050,30,067,"Montana","Park County",3,36,235,120,115
050,30,067,"Montana","Park County",3,37,235,120,115
050,30,067,"Montana","Park County",3,38,242,127,115
050,30,067,"Montana","Park County",3,39,240,135,105
050,30,067,"Montana","Park County",3,40,232,118,114
050,30,067,"Montana","Park County",3,41,227,113,114
050,30,067,"Montana","Park County",3,42,224,111,113
050,30,067,"Montana","Park County",3,43,235,117,118
050,30,067,"Montana","Park County",3,44,221,116,105
050,30,067,"Montana","Park County",3,45,210,105,105
050,30,067,"Montana","Park County",3,46,211,96,115
050,30,067,"Montana","Park County",3,47,200,97,103
050,30,067,"Montana","Park County",3,48,207,107,100
050,30,067,"Montana","Park County",3,49,224,100,124
050,30,067,"Montana","Park County",3,50,243,117,126
050,30,067,"Montana","Park County",3,51,216,103,113
050,30,067,"Montana","Park County",3,52,208,114,94
050,30,067,"Montana","Park County",3,53,202,111,91
050,30,067,"Montana","Park County",3,54,203,110,93
050,30,067,"Montana","Park County",3,55,200,109,91
050,30,067,"Montana","Park County",3,56,239,124,115
050,30,067,"Montana","Park County",3,57,261,132,129
050,30,067,"Montana","Park County",3,58,266,129,137
050,30,067,"Montana","Park County",3,59,306,147,159
050,30,067,"Montana","Park County",3,60,284,127,157
050,30,067,"Montana","Park County",3,61,332,167,165
050,30,067,"Montana","Park County",3,62,315,165,150
050,30,067,"Montana","Park County",3,63,290,154,136
050,30,067,"Montana","Park County",3,64,315,181,134
050,30,067,"Montana","Park County",3,65,297,159,138
050,30,067,"Montana","Park County",3,66,287,136,151
050,30,067,"Montana","Park County",3,67,277,124,153
050,30,067,"Montana","Park County",3,68,297,140,157
050,30,067,"Montana","Park County",3,69,294,153,141
050,30,067,"Montana","Park County",3,70,271,143,128
050,30,067,"Montana","Park County",3,71,243,135,108
050,30,067,"Montana","Park County",3,72,246,125,121
050,30,067,"Montana","Park County",3,73,208,103,105
050,30,067,"Montana","Park County",3,74,226,112,114
050,30,067,"Montana","Park County",3,75,177,93,84
050,30,067,"Montana","Park County",3,76,163,81,82
050,30,067,"Montana","Park County",3,77,145,74,71
050,30,067,"Montana","Park County",3,78,147,72,75
050,30,067,"Montana","Park County",3,79,110,48,62
050,30,067,"Montana","Park County",3,80,107,46,61
050,30,067,"Montana","Park County",3,81,103,42,61
050,30,067,"Montana","Park County",3,82,90,37,53
050,30,067,"Montana","Park County",3,83,72,36,36
050,30,067,"Montana","Park County",3,84,58,28,30
050,30,067,"Montana","Park County",3,85,419,160,259
050,30,067,"Montana","Park County",4,0,139,70,69
050,30,067,"Montana","Park County",4,1,135,61,74
050,30,067,"Montana","Park County",4,2,152,80,72
050,30,067,"Montana","Park County",4,3,181,99,82
050,30,067,"Montana","Park County",4,4,170,79,91
050,30,067,"Montana","Park County",4,5,161,89,72
050,30,067,"Montana","Park County",4,6,170,91,79
050,30,067,"Montana","Park County",4,7,159,81,78
050,30,067,"Montana","Park County",4,8,165,80,85
050,30,067,"Montana","Park County",4,9,160,78,82
050,30,067,"Montana","Park County",4,10,158,80,78
050,30,067,"Montana","Park County",4,11,164,86,78
050,30,067,"Montana","Park County",4,12,172,96,76
050,30,067,"Montana","Park County",4,13,197,111,86
050,30,067,"Montana","Park County",4,14,187,106,81
050,30,067,"Montana","Park County",4,15,181,93,88
050,30,067,"Montana","Park County",4,16,159,83,76
050,30,067,"Montana","Park County",4,17,170,94,76
050,30,067,"Montana","Park County",4,18,146,83,63
050,30,067,"Montana","Park County",4,19,118,62,56
050,30,067,"Montana","Park County",4,20,135,67,68
050,30,067,"Montana","Park County",4,21,151,76,75
050,30,067,"Montana","Park County",4,22,155,90,65
050,30,067,"Montana","Park County",4,23,146,76,70
050,30,067,"Montana","Park County",4,24,166,82,84
050,30,067,"Montana","Park County",4,25,147,73,74
050,30,067,"Montana","Park County",4,26,167,78,89
050,30,067,"Montana","Park County",4,27,164,83,81
050,30,067,"Montana","Park County",4,28,202,107,95
050,30,067,"Montana","Park County",4,29,231,110,121
050,30,067,"Montana","Park County",4,30,259,133,126
050,30,067,"Montana","Park County",4,31,241,119,122
050,30,067,"Montana","Park County",4,32,220,114,106
050,30,067,"Montana","Park County",4,33,248,131,117
050,30,067,"Montana","Park County",4,34,246,121,125
050,30,067,"Montana","Park County",4,35,232,123,109
050,30,067,"Montana","Park County",4,36,254,122,132
050,30,067,"Montana","Park County",4,37,257,130,127
050,30,067,"Montana","Park County",4,38,240,128,112
050,30,067,"Montana","Park County",4,39,250,140,110
050,30,067,"Montana","Park County",4,40,236,133,103
050,30,067,"Montana","Park County",4,41,243,126,117
050,30,067,"Montana","Park County",4,42,227,116,111
050,30,067,"Montana","Park County",4,43,228,109,119
050,30,067,"Montana","Park County",4,44,236,115,121
050,30,067,"Montana","Park County",4,45,214,111,103
050,30,067,"Montana","Park County",4,46,216,109,107
050,30,067,"Montana","Park County",4,47,218,103,115
050,30,067,"Montana","Park County",4,48,203,97,106
050,30,067,"Montana","Park County",4,49,214,105,109
050,30,067,"Montana","Park County",4,50,224,105,119
050,30,067,"Montana","Park County",4,51,241,119,122
050,30,067,"Montana","Park County",4,52,220,107,113
050,30,067,"Montana","Park County",4,53,207,109,98
050,30,067,"Montana","Park County",4,54,206,113,93
050,30,067,"Montana","Park County",4,55,209,113,96
050,30,067,"Montana","Park County",4,56,200,108,92
050,30,067,"Montana","Park County",4,57,236,123,113
050,30,067,"Montana","Park County",4,58,261,128,133
050,30,067,"Montana","Park County",4,59,274,134,140
050,30,067,"Montana","Park County",4,60,310,142,168
050,30,067,"Montana","Park County",4,61,285,126,159
050,30,067,"Montana","Park County",4,62,330,168,162
050,30,067,"Montana","Park County",4,63,320,169,151
050,30,067,"Montana","Park County",4,64,294,154,140
050,30,067,"Montana","Park County",4,65,320,177,143
050,30,067,"Montana","Park County",4,66,311,161,150
050,30,067,"Montana","Park County",4,67,282,136,146
050,30,067,"Montana","Park County",4,68,274,126,148
050,30,067,"Montana","Park County",4,69,290,141,149
050,30,067,"Montana","Park County",4,70,285,144,141
050,30,067,"Montana","Park County",4,71,259,144,115
050,30,067,"Montana","Park County",4,72,231,128,103
050,30,067,"Montana","Park County",4,73,240,122,118
050,30,067,"Montana","Park County",4,74,199,95,104
050,30,067,"Montana","Park County",4,75,215,105,110
050,30,067,"Montana","Park County",4,76,171,93,78
050,30,067,"Montana","Park County",4,77,153,74,79
050,30,067,"Montana","Park County",4,78,144,72,72
050,30,067,"Montana","Park County",4,79,132,67,65
050,30,067,"Montana","Park County",4,80,107,46,61
050,30,067,"Montana","Park County",4,81,103,42,61
050,30,067,"Montana","Park County",4,82,89,37,52
050,30,067,"Montana","Park County",4,83,86,36,50
050,30,067,"Montana","Park County",4,84,65,35,30
050,30,067,"Montana","Park County",4,85,390,144,246
050,30,067,"Montana","Park County",5,0,138,68,70
050,30,067,"Montana","Park County",5,1,151,77,74
050,30,067,"Montana","Park County",5,2,145,69,76
050,30,067,"Montana","Park County",5,3,156,84,72
050,30,067,"Montana","Park County",5,4,176,94,82
050,30,067,"Montana","Park County",5,5,176,80,96
050,30,067,"Montana","Park County",5,6,168,92,76
050,30,067,"Montana","Park County",5,7,182,97,85
050,30,067,"Montana","Park County",5,8,172,87,85
050,30,067,"Montana","Park County",5,9,170,84,86
050,30,067,"Montana","Park County",5,10,162,77,85
050,30,067,"Montana","Park County",5,11,166,87,79
050,30,067,"Montana","Park County",5,12,170,85,85
050,30,067,"Montana","Park County",5,13,163,90,73
050,30,067,"Montana","Park County",5,14,198,107,91
050,30,067,"Montana","Park County",5,15,181,102,79
050,30,067,"Montana","Park County",5,16,183,95,88
050,30,067,"Montana","Park County",5,17,165,88,77
050,30,067,"Montana","Park County",5,18,144,85,59
050,30,067,"Montana","Park County",5,19,113,66,47
050,30,067,"Montana","Park County",5,20,132,70,62
050,30,067,"Montana","Park County",5,21,136,69,67
050,30,067,"Montana","Park County",5,22,160,82,78
050,30,067,"Montana","Park County",5,23,164,97,67
050,30,067,"Montana","Park County",5,24,169,84,85
050,30,067,"Montana","Park County",5,25,167,85,82
050,30,067,"Montana","Park County",5,26,176,84,92
050,30,067,"Montana","Park County",5,27,183,90,93
050,30,067,"Montana","Park County",5,28,175,90,85
050,30,067,"Montana","Park County",5,29,217,108,109
050,30,067,"Montana","Park County",5,30,241,110,131
050,30,067,"Montana","Park County",5,31,254,130,124
050,30,067,"Montana","Park County",5,32,254,123,131
050,30,067,"Montana","Park County",5,33,242,121,121
050,30,067,"Montana","Park County",5,34,261,134,127
050,30,067,"Montana","Park County",5,35,257,127,130
050,30,067,"Montana","Park County",5,36,238,121,117
050,30,067,"Montana","Park County",5,37,260,119,141
050,30,067,"Montana","Park County",5,38,279,146,133
050,30,067,"Montana","Park County",5,39,233,125,108
050,30,067,"Montana","Park County",5,40,248,138,110
050,30,067,"Montana","Park County",5,41,236,130,106
050,30,067,"Montana","Park County",5,42,256,138,118
050,30,067,"Montana","Park County",5,43,217,112,105
050,30,067,"Montana","Park County",5,44,236,114,122
050,30,067,"Montana","Park County",5,45,232,114,118
050,30,067,"Montana","Park County",5,46,220,115,105
050,30,067,"Montana","Park County",5,47,211,109,102
050,30,067,"Montana","Park County",5,48,209,97,112
050,30,067,"Montana","Park County",5,49,200,101,99
050,30,067,"Montana","Park County",5,50,210,107,103
050,30,067,"Montana","Park County",5,51,214,99,115
050,30,067,"Montana","Park County",5,52,245,118,127
050,30,067,"Montana","Park County",5,53,220,108,112
050,30,067,"Montana","Park County",5,54,207,104,103
050,30,067,"Montana","Park County",5,55,212,115,97
050,30,067,"Montana","Park County",5,56,201,114,87
050,30,067,"Montana","Park County",5,57,203,105,98
050,30,067,"Montana","Park County",5,58,247,127,120
050,30,067,"Montana","Park County",5,59,257,122,135
050,30,067,"Montana","Park County",5,60,266,129,137
050,30,067,"Montana","Park County",5,61,308,142,166
050,30,067,"Montana","Park County",5,62,277,122,155
050,30,067,"Montana","Park County",5,63,325,167,158
050,30,067,"Montana","Park County",5,64,311,169,142
050,30,067,"Montana","Park County",5,65,286,144,142
050,30,067,"Montana","Park County",5,66,317,171,146
050,30,067,"Montana","Park County",5,67,304,162,142
050,30,067,"Montana","Park County",5,68,270,131,139
050,30,067,"Montana","Park County",5,69,277,130,147
050,30,067,"Montana","Park County",5,70,276,129,147
050,30,067,"Montana","Park County",5,71,271,140,131
050,30,067,"Montana","Park County",5,72,262,144,118
050,30,067,"Montana","Park County",5,73,217,122,95
050,30,067,"Montana","Park County",5,74,228,115,113
050,30,067,"Montana","Park County",5,75,192,95,97
050,30,067,"Montana","Park County",5,76,215,104,111
050,30,067,"Montana","Park County",5,77,173,92,81
050,30,067,"Montana","Park County",5,78,151,74,77
050,30,067,"Montana","Park County",5,79,125,62,63
050,30,067,"Montana","Park County",5,80,130,67,63
050,30,067,"Montana","Park County",5,81,103,40,63
050,30,067,"Montana","Park County",5,82,87,39,48
050,30,067,"Montana","Park County",5,83,83,36,47
050,30,067,"Montana","Park County",5,84,87,39,48
050,30,067,"Montana","Park County",5,85,404,157,247
050,30,069,"Montana","Petroleum County",1,0,2,1,1
050,30,069,"Montana","Petroleum County",1,1,3,0,3
050,30,069,"Montana","Petroleum County",1,2,5,3,2
050,30,069,"Montana","Petroleum County",1,3,5,3,2
050,30,069,"Montana","Petroleum County",1,4,2,1,1
050,30,069,"Montana","Petroleum County",1,5,3,1,2
050,30,069,"Montana","Petroleum County",1,6,5,3,2
050,30,069,"Montana","Petroleum County",1,7,5,4,1
050,30,069,"Montana","Petroleum County",1,8,7,4,3
050,30,069,"Montana","Petroleum County",1,9,6,3,3
050,30,069,"Montana","Petroleum County",1,10,4,3,1
050,30,069,"Montana","Petroleum County",1,11,4,3,1
050,30,069,"Montana","Petroleum County",1,12,6,4,2
050,30,069,"Montana","Petroleum County",1,13,3,2,1
050,30,069,"Montana","Petroleum County",1,14,5,3,2
050,30,069,"Montana","Petroleum County",1,15,5,2,3
050,30,069,"Montana","Petroleum County",1,16,3,2,1
050,30,069,"Montana","Petroleum County",1,17,3,2,1
050,30,069,"Montana","Petroleum County",1,18,4,1,3
050,30,069,"Montana","Petroleum County",1,19,4,2,2
050,30,069,"Montana","Petroleum County",1,20,2,2,0
050,30,069,"Montana","Petroleum County",1,21,6,4,2
050,30,069,"Montana","Petroleum County",1,22,4,2,2
050,30,069,"Montana","Petroleum County",1,23,5,2,3
050,30,069,"Montana","Petroleum County",1,24,7,2,5
050,30,069,"Montana","Petroleum County",1,25,5,3,2
050,30,069,"Montana","Petroleum County",1,26,5,3,2
050,30,069,"Montana","Petroleum County",1,27,4,1,3
050,30,069,"Montana","Petroleum County",1,28,4,2,2
050,30,069,"Montana","Petroleum County",1,29,3,2,1
050,30,069,"Montana","Petroleum County",1,30,4,3,1
050,30,069,"Montana","Petroleum County",1,31,6,4,2
050,30,069,"Montana","Petroleum County",1,32,6,4,2
050,30,069,"Montana","Petroleum County",1,33,4,2,2
050,30,069,"Montana","Petroleum County",1,34,7,4,3
050,30,069,"Montana","Petroleum County",1,35,3,2,1
050,30,069,"Montana","Petroleum County",1,36,8,5,3
050,30,069,"Montana","Petroleum County",1,37,3,1,2
050,30,069,"Montana","Petroleum County",1,38,3,2,1
050,30,069,"Montana","Petroleum County",1,39,4,3,1
050,30,069,"Montana","Petroleum County",1,40,4,1,3
050,30,069,"Montana","Petroleum County",1,41,2,1,1
050,30,069,"Montana","Petroleum County",1,42,5,3,2
050,30,069,"Montana","Petroleum County",1,43,5,2,3
050,30,069,"Montana","Petroleum County",1,44,5,3,2
050,30,069,"Montana","Petroleum County",1,45,4,3,1
050,30,069,"Montana","Petroleum County",1,46,1,0,1
050,30,069,"Montana","Petroleum County",1,47,4,0,4
050,30,069,"Montana","Petroleum County",1,48,3,2,1
050,30,069,"Montana","Petroleum County",1,49,4,1,3
050,30,069,"Montana","Petroleum County",1,50,8,2,6
050,30,069,"Montana","Petroleum County",1,51,13,7,6
050,30,069,"Montana","Petroleum County",1,52,5,4,1
050,30,069,"Montana","Petroleum County",1,53,3,1,2
050,30,069,"Montana","Petroleum County",1,54,8,5,3
050,30,069,"Montana","Petroleum County",1,55,12,7,5
050,30,069,"Montana","Petroleum County",1,56,9,4,5
050,30,069,"Montana","Petroleum County",1,57,10,7,3
050,30,069,"Montana","Petroleum County",1,58,10,8,2
050,30,069,"Montana","Petroleum County",1,59,11,7,4
050,30,069,"Montana","Petroleum County",1,60,9,4,5
050,30,069,"Montana","Petroleum County",1,61,8,4,4
050,30,069,"Montana","Petroleum County",1,62,14,5,9
050,30,069,"Montana","Petroleum County",1,63,14,9,5
050,30,069,"Montana","Petroleum County",1,64,9,6,3
050,30,069,"Montana","Petroleum County",1,65,11,6,5
050,30,069,"Montana","Petroleum County",1,66,9,5,4
050,30,069,"Montana","Petroleum County",1,67,8,4,4
050,30,069,"Montana","Petroleum County",1,68,6,4,2
050,30,069,"Montana","Petroleum County",1,69,6,4,2
050,30,069,"Montana","Petroleum County",1,70,5,3,2
050,30,069,"Montana","Petroleum County",1,71,6,4,2
050,30,069,"Montana","Petroleum County",1,72,4,3,1
050,30,069,"Montana","Petroleum County",1,73,7,3,4
050,30,069,"Montana","Petroleum County",1,74,5,1,4
050,30,069,"Montana","Petroleum County",1,75,3,1,2
050,30,069,"Montana","Petroleum County",1,76,2,1,1
050,30,069,"Montana","Petroleum County",1,77,3,1,2
050,30,069,"Montana","Petroleum County",1,78,8,4,4
050,30,069,"Montana","Petroleum County",1,79,10,3,7
050,30,069,"Montana","Petroleum County",1,80,8,4,4
050,30,069,"Montana","Petroleum County",1,81,4,2,2
050,30,069,"Montana","Petroleum County",1,82,3,2,1
050,30,069,"Montana","Petroleum County",1,83,4,3,1
050,30,069,"Montana","Petroleum County",1,84,6,3,3
050,30,069,"Montana","Petroleum County",1,85,20,12,8
050,30,069,"Montana","Petroleum County",2,0,5,1,4
050,30,069,"Montana","Petroleum County",2,1,4,1,3
050,30,069,"Montana","Petroleum County",2,2,4,2,2
050,30,069,"Montana","Petroleum County",2,3,5,3,2
050,30,069,"Montana","Petroleum County",2,4,2,1,1
050,30,069,"Montana","Petroleum County",2,5,3,1,2
050,30,069,"Montana","Petroleum County",2,6,4,2,2
050,30,069,"Montana","Petroleum County",2,7,5,4,1
050,30,069,"Montana","Petroleum County",2,8,7,4,3
050,30,069,"Montana","Petroleum County",2,9,6,3,3
050,30,069,"Montana","Petroleum County",2,10,4,3,1
050,30,069,"Montana","Petroleum County",2,11,4,3,1
050,30,069,"Montana","Petroleum County",2,12,5,4,1
050,30,069,"Montana","Petroleum County",2,13,4,3,1
050,30,069,"Montana","Petroleum County",2,14,4,2,2
050,30,069,"Montana","Petroleum County",2,15,5,2,3
050,30,069,"Montana","Petroleum County",2,16,3,2,1
050,30,069,"Montana","Petroleum County",2,17,3,2,1
050,30,069,"Montana","Petroleum County",2,18,4,1,3
050,30,069,"Montana","Petroleum County",2,19,3,1,2
050,30,069,"Montana","Petroleum County",2,20,3,2,1
050,30,069,"Montana","Petroleum County",2,21,5,3,2
050,30,069,"Montana","Petroleum County",2,22,4,2,2
050,30,069,"Montana","Petroleum County",2,23,5,2,3
050,30,069,"Montana","Petroleum County",2,24,7,2,5
050,30,069,"Montana","Petroleum County",2,25,6,3,3
050,30,069,"Montana","Petroleum County",2,26,5,3,2
050,30,069,"Montana","Petroleum County",2,27,4,1,3
050,30,069,"Montana","Petroleum County",2,28,4,2,2
050,30,069,"Montana","Petroleum County",2,29,3,2,1
050,30,069,"Montana","Petroleum County",2,30,4,3,1
050,30,069,"Montana","Petroleum County",2,31,6,4,2
050,30,069,"Montana","Petroleum County",2,32,6,4,2
050,30,069,"Montana","Petroleum County",2,33,5,3,2
050,30,069,"Montana","Petroleum County",2,34,7,4,3
050,30,069,"Montana","Petroleum County",2,35,4,3,1
050,30,069,"Montana","Petroleum County",2,36,6,4,2
050,30,069,"Montana","Petroleum County",2,37,4,2,2
050,30,069,"Montana","Petroleum County",2,38,3,2,1
050,30,069,"Montana","Petroleum County",2,39,4,3,1
050,30,069,"Montana","Petroleum County",2,40,5,2,3
050,30,069,"Montana","Petroleum County",2,41,2,1,1
050,30,069,"Montana","Petroleum County",2,42,5,3,2
050,30,069,"Montana","Petroleum County",2,43,5,2,3
050,30,069,"Montana","Petroleum County",2,44,5,3,2
050,30,069,"Montana","Petroleum County",2,45,4,3,1
050,30,069,"Montana","Petroleum County",2,46,2,1,1
050,30,069,"Montana","Petroleum County",2,47,3,0,3
050,30,069,"Montana","Petroleum County",2,48,2,1,1
050,30,069,"Montana","Petroleum County",2,49,3,1,2
050,30,069,"Montana","Petroleum County",2,50,7,2,5
050,30,069,"Montana","Petroleum County",2,51,12,6,6
050,30,069,"Montana","Petroleum County",2,52,7,5,2
050,30,069,"Montana","Petroleum County",2,53,4,2,2
050,30,069,"Montana","Petroleum County",2,54,7,4,3
050,30,069,"Montana","Petroleum County",2,55,11,6,5
050,30,069,"Montana","Petroleum County",2,56,10,5,5
050,30,069,"Montana","Petroleum County",2,57,10,6,4
050,30,069,"Montana","Petroleum County",2,58,10,8,2
050,30,069,"Montana","Petroleum County",2,59,11,7,4
050,30,069,"Montana","Petroleum County",2,60,10,5,5
050,30,069,"Montana","Petroleum County",2,61,8,4,4
050,30,069,"Montana","Petroleum County",2,62,13,5,8
050,30,069,"Montana","Petroleum County",2,63,14,8,6
050,30,069,"Montana","Petroleum County",2,64,10,7,3
050,30,069,"Montana","Petroleum County",2,65,11,6,5
050,30,069,"Montana","Petroleum County",2,66,9,5,4
050,30,069,"Montana","Petroleum County",2,67,8,4,4
050,30,069,"Montana","Petroleum County",2,68,6,4,2
050,30,069,"Montana","Petroleum County",2,69,6,4,2
050,30,069,"Montana","Petroleum County",2,70,5,3,2
050,30,069,"Montana","Petroleum County",2,71,6,4,2
050,30,069,"Montana","Petroleum County",2,72,4,3,1
050,30,069,"Montana","Petroleum County",2,73,7,3,4
050,30,069,"Montana","Petroleum County",2,74,5,1,4
050,30,069,"Montana","Petroleum County",2,75,4,1,3
050,30,069,"Montana","Petroleum County",2,76,2,1,1
050,30,069,"Montana","Petroleum County",2,77,3,1,2
050,30,069,"Montana","Petroleum County",2,78,6,3,3
050,30,069,"Montana","Petroleum County",2,79,9,3,6
050,30,069,"Montana","Petroleum County",2,80,8,3,5
050,30,069,"Montana","Petroleum County",2,81,6,3,3
050,30,069,"Montana","Petroleum County",2,82,3,2,1
050,30,069,"Montana","Petroleum County",2,83,4,3,1
050,30,069,"Montana","Petroleum County",2,84,6,3,3
050,30,069,"Montana","Petroleum County",2,85,22,13,9
050,30,069,"Montana","Petroleum County",3,0,6,5,1
050,30,069,"Montana","Petroleum County",3,1,5,1,4
050,30,069,"Montana","Petroleum County",3,2,5,2,3
050,30,069,"Montana","Petroleum County",3,3,3,1,2
050,30,069,"Montana","Petroleum County",3,4,5,3,2
050,30,069,"Montana","Petroleum County",3,5,2,1,1
050,30,069,"Montana","Petroleum County",3,6,3,1,2
050,30,069,"Montana","Petroleum County",3,7,3,1,2
050,30,069,"Montana","Petroleum County",3,8,5,4,1
050,30,069,"Montana","Petroleum County",3,9,6,3,3
050,30,069,"Montana","Petroleum County",3,10,6,3,3
050,30,069,"Montana","Petroleum County",3,11,4,3,1
050,30,069,"Montana","Petroleum County",3,12,4,3,1
050,30,069,"Montana","Petroleum County",3,13,5,4,1
050,30,069,"Montana","Petroleum County",3,14,4,3,1
050,30,069,"Montana","Petroleum County",3,15,4,2,2
050,30,069,"Montana","Petroleum County",3,16,5,2,3
050,30,069,"Montana","Petroleum County",3,17,3,2,1
050,30,069,"Montana","Petroleum County",3,18,3,2,1
050,30,069,"Montana","Petroleum County",3,19,4,1,3
050,30,069,"Montana","Petroleum County",3,20,1,1,0
050,30,069,"Montana","Petroleum County",3,21,5,2,3
050,30,069,"Montana","Petroleum County",3,22,5,3,2
050,30,069,"Montana","Petroleum County",3,23,4,2,2
050,30,069,"Montana","Petroleum County",3,24,5,3,2
050,30,069,"Montana","Petroleum County",3,25,6,2,4
050,30,069,"Montana","Petroleum County",3,26,5,2,3
050,30,069,"Montana","Petroleum County",3,27,5,3,2
050,30,069,"Montana","Petroleum County",3,28,5,2,3
050,30,069,"Montana","Petroleum County",3,29,4,2,2
050,30,069,"Montana","Petroleum County",3,30,3,2,1
050,30,069,"Montana","Petroleum County",3,31,4,3,1
050,30,069,"Montana","Petroleum County",3,32,5,3,2
050,30,069,"Montana","Petroleum County",3,33,6,3,3
050,30,069,"Montana","Petroleum County",3,34,5,3,2
050,30,069,"Montana","Petroleum County",3,35,8,4,4
050,30,069,"Montana","Petroleum County",3,36,6,5,1
050,30,069,"Montana","Petroleum County",3,37,6,4,2
050,30,069,"Montana","Petroleum County",3,38,6,4,2
050,30,069,"Montana","Petroleum County",3,39,4,2,2
050,30,069,"Montana","Petroleum County",3,40,4,3,1
050,30,069,"Montana","Petroleum County",3,41,5,2,3
050,30,069,"Montana","Petroleum County",3,42,2,1,1
050,30,069,"Montana","Petroleum County",3,43,2,0,2
050,30,069,"Montana","Petroleum County",3,44,5,2,3
050,30,069,"Montana","Petroleum County",3,45,5,3,2
050,30,069,"Montana","Petroleum County",3,46,4,3,1
050,30,069,"Montana","Petroleum County",3,47,2,1,1
050,30,069,"Montana","Petroleum County",3,48,5,2,3
050,30,069,"Montana","Petroleum County",3,49,2,1,1
050,30,069,"Montana","Petroleum County",3,50,5,1,4
050,30,069,"Montana","Petroleum County",3,51,7,2,5
050,30,069,"Montana","Petroleum County",3,52,12,6,6
050,30,069,"Montana","Petroleum County",3,53,11,7,4
050,30,069,"Montana","Petroleum County",3,54,7,2,5
050,30,069,"Montana","Petroleum County",3,55,7,4,3
050,30,069,"Montana","Petroleum County",3,56,13,6,7
050,30,069,"Montana","Petroleum County",3,57,10,5,5
050,30,069,"Montana","Petroleum County",3,58,13,6,7
050,30,069,"Montana","Petroleum County",3,59,12,10,2
050,30,069,"Montana","Petroleum County",3,60,11,7,4
050,30,069,"Montana","Petroleum County",3,61,10,5,5
050,30,069,"Montana","Petroleum County",3,62,8,4,4
050,30,069,"Montana","Petroleum County",3,63,16,8,8
050,30,069,"Montana","Petroleum County",3,64,14,8,6
050,30,069,"Montana","Petroleum County",3,65,12,8,4
050,30,069,"Montana","Petroleum County",3,66,10,5,5
050,30,069,"Montana","Petroleum County",3,67,8,5,3
050,30,069,"Montana","Petroleum County",3,68,8,4,4
050,30,069,"Montana","Petroleum County",3,69,7,4,3
050,30,069,"Montana","Petroleum County",3,70,6,4,2
050,30,069,"Montana","Petroleum County",3,71,5,3,2
050,30,069,"Montana","Petroleum County",3,72,6,4,2
050,30,069,"Montana","Petroleum County",3,73,4,3,1
050,30,069,"Montana","Petroleum County",3,74,7,3,4
050,30,069,"Montana","Petroleum County",3,75,5,1,4
050,30,069,"Montana","Petroleum County",3,76,4,1,3
050,30,069,"Montana","Petroleum County",3,77,1,1,0
050,30,069,"Montana","Petroleum County",3,78,3,1,2
050,30,069,"Montana","Petroleum County",3,79,4,2,2
050,30,069,"Montana","Petroleum County",3,80,8,3,5
050,30,069,"Montana","Petroleum County",3,81,7,3,4
050,30,069,"Montana","Petroleum County",3,82,6,3,3
050,30,069,"Montana","Petroleum County",3,83,3,2,1
050,30,069,"Montana","Petroleum County",3,84,4,3,1
050,30,069,"Montana","Petroleum County",3,85,25,15,10
050,30,069,"Montana","Petroleum County",4,0,11,7,4
050,30,069,"Montana","Petroleum County",4,1,6,5,1
050,30,069,"Montana","Petroleum County",4,2,5,1,4
050,30,069,"Montana","Petroleum County",4,3,4,1,3
050,30,069,"Montana","Petroleum County",4,4,3,1,2
050,30,069,"Montana","Petroleum County",4,5,5,3,2
050,30,069,"Montana","Petroleum County",4,6,2,1,1
050,30,069,"Montana","Petroleum County",4,7,3,1,2
050,30,069,"Montana","Petroleum County",4,8,3,1,2
050,30,069,"Montana","Petroleum County",4,9,5,4,1
050,30,069,"Montana","Petroleum County",4,10,6,3,3
050,30,069,"Montana","Petroleum County",4,11,5,3,2
050,30,069,"Montana","Petroleum County",4,12,4,3,1
050,30,069,"Montana","Petroleum County",4,13,4,3,1
050,30,069,"Montana","Petroleum County",4,14,5,4,1
050,30,069,"Montana","Petroleum County",4,15,4,3,1
050,30,069,"Montana","Petroleum County",4,16,5,3,2
050,30,069,"Montana","Petroleum County",4,17,4,1,3
050,30,069,"Montana","Petroleum County",4,18,3,2,1
050,30,069,"Montana","Petroleum County",4,19,3,2,1
050,30,069,"Montana","Petroleum County",4,20,3,1,2
050,30,069,"Montana","Petroleum County",4,21,2,2,0
050,30,069,"Montana","Petroleum County",4,22,4,2,2
050,30,069,"Montana","Petroleum County",4,23,3,2,1
050,30,069,"Montana","Petroleum County",4,24,4,2,2
050,30,069,"Montana","Petroleum County",4,25,5,3,2
050,30,069,"Montana","Petroleum County",4,26,6,2,4
050,30,069,"Montana","Petroleum County",4,27,5,2,3
050,30,069,"Montana","Petroleum County",4,28,5,3,2
050,30,069,"Montana","Petroleum County",4,29,5,2,3
050,30,069,"Montana","Petroleum County",4,30,5,3,2
050,30,069,"Montana","Petroleum County",4,31,1,0,1
050,30,069,"Montana","Petroleum County",4,32,4,3,1
050,30,069,"Montana","Petroleum County",4,33,5,3,2
050,30,069,"Montana","Petroleum County",4,34,6,3,3
050,30,069,"Montana","Petroleum County",4,35,5,3,2
050,30,069,"Montana","Petroleum County",4,36,7,4,3
050,30,069,"Montana","Petroleum County",4,37,6,5,1
050,30,069,"Montana","Petroleum County",4,38,6,4,2
050,30,069,"Montana","Petroleum County",4,39,6,4,2
050,30,069,"Montana","Petroleum County",4,40,4,3,1
050,30,069,"Montana","Petroleum County",4,41,4,3,1
050,30,069,"Montana","Petroleum County",4,42,5,2,3
050,30,069,"Montana","Petroleum County",4,43,2,1,1
050,30,069,"Montana","Petroleum County",4,44,2,0,2
050,30,069,"Montana","Petroleum County",4,45,5,3,2
050,30,069,"Montana","Petroleum County",4,46,4,2,2
050,30,069,"Montana","Petroleum County",4,47,4,3,1
050,30,069,"Montana","Petroleum County",4,48,3,2,1
050,30,069,"Montana","Petroleum County",4,49,5,2,3
050,30,069,"Montana","Petroleum County",4,50,2,1,1
050,30,069,"Montana","Petroleum County",4,51,5,1,4
050,30,069,"Montana","Petroleum County",4,52,7,2,5
050,30,069,"Montana","Petroleum County",4,53,13,6,7
050,30,069,"Montana","Petroleum County",4,54,12,8,4
050,30,069,"Montana","Petroleum County",4,55,7,2,5
050,30,069,"Montana","Petroleum County",4,56,9,6,3
050,30,069,"Montana","Petroleum County",4,57,13,6,7
050,30,069,"Montana","Petroleum County",4,58,10,5,5
050,30,069,"Montana","Petroleum County",4,59,13,6,7
050,30,069,"Montana","Petroleum County",4,60,10,8,2
050,30,069,"Montana","Petroleum County",4,61,11,7,4
050,30,069,"Montana","Petroleum County",4,62,10,5,5
050,30,069,"Montana","Petroleum County",4,63,8,4,4
050,30,069,"Montana","Petroleum County",4,64,18,10,8
050,30,069,"Montana","Petroleum County",4,65,14,8,6
050,30,069,"Montana","Petroleum County",4,66,12,8,4
050,30,069,"Montana","Petroleum County",4,67,11,6,5
050,30,069,"Montana","Petroleum County",4,68,8,5,3
050,30,069,"Montana","Petroleum County",4,69,8,4,4
050,30,069,"Montana","Petroleum County",4,70,7,4,3
050,30,069,"Montana","Petroleum County",4,71,6,4,2
050,30,069,"Montana","Petroleum County",4,72,5,3,2
050,30,069,"Montana","Petroleum County",4,73,6,4,2
050,30,069,"Montana","Petroleum County",4,74,4,3,1
050,30,069,"Montana","Petroleum County",4,75,7,3,4
050,30,069,"Montana","Petroleum County",4,76,5,1,4
050,30,069,"Montana","Petroleum County",4,77,3,1,2
050,30,069,"Montana","Petroleum County",4,78,0,0,0
050,30,069,"Montana","Petroleum County",4,79,1,0,1
050,30,069,"Montana","Petroleum County",4,80,3,2,1
050,30,069,"Montana","Petroleum County",4,81,9,4,5
050,30,069,"Montana","Petroleum County",4,82,6,3,3
050,30,069,"Montana","Petroleum County",4,83,6,3,3
050,30,069,"Montana","Petroleum County",4,84,3,2,1
050,30,069,"Montana","Petroleum County",4,85,28,17,11
050,30,069,"Montana","Petroleum County",5,0,11,7,4
050,30,069,"Montana","Petroleum County",5,1,11,7,4
050,30,069,"Montana","Petroleum County",5,2,6,5,1
050,30,069,"Montana","Petroleum County",5,3,7,1,6
050,30,069,"Montana","Petroleum County",5,4,4,1,3
050,30,069,"Montana","Petroleum County",5,5,4,2,2
050,30,069,"Montana","Petroleum County",5,6,7,5,2
050,30,069,"Montana","Petroleum County",5,7,2,1,1
050,30,069,"Montana","Petroleum County",5,8,3,1,2
050,30,069,"Montana","Petroleum County",5,9,3,1,2
050,30,069,"Montana","Petroleum County",5,10,5,4,1
050,30,069,"Montana","Petroleum County",5,11,6,3,3
050,30,069,"Montana","Petroleum County",5,12,7,3,4
050,30,069,"Montana","Petroleum County",5,13,4,3,1
050,30,069,"Montana","Petroleum County",5,14,4,3,1
050,30,069,"Montana","Petroleum County",5,15,7,6,1
050,30,069,"Montana","Petroleum County",5,16,4,3,1
050,30,069,"Montana","Petroleum County",5,17,5,3,2
050,30,069,"Montana","Petroleum County",5,18,5,2,3
050,30,069,"Montana","Petroleum County",5,19,3,2,1
050,30,069,"Montana","Petroleum County",5,20,4,2,2
050,30,069,"Montana","Petroleum County",5,21,2,1,1
050,30,069,"Montana","Petroleum County",5,22,2,1,1
050,30,069,"Montana","Petroleum County",5,23,3,2,1
050,30,069,"Montana","Petroleum County",5,24,3,2,1
050,30,069,"Montana","Petroleum County",5,25,5,3,2
050,30,069,"Montana","Petroleum County",5,26,5,3,2
050,30,069,"Montana","Petroleum County",5,27,8,3,5
050,30,069,"Montana","Petroleum County",5,28,5,2,3
050,30,069,"Montana","Petroleum County",5,29,5,3,2
050,30,069,"Montana","Petroleum County",5,30,6,2,4
050,30,069,"Montana","Petroleum County",5,31,3,1,2
050,30,069,"Montana","Petroleum County",5,32,2,1,1
050,30,069,"Montana","Petroleum County",5,33,4,3,1
050,30,069,"Montana","Petroleum County",5,34,6,3,3
050,30,069,"Montana","Petroleum County",5,35,6,3,3
050,30,069,"Montana","Petroleum County",5,36,5,3,2
050,30,069,"Montana","Petroleum County",5,37,7,4,3
050,30,069,"Montana","Petroleum County",5,38,7,5,2
050,30,069,"Montana","Petroleum County",5,39,6,4,2
050,30,069,"Montana","Petroleum County",5,40,7,5,2
050,30,069,"Montana","Petroleum County",5,41,4,3,1
050,30,069,"Montana","Petroleum County",5,42,4,3,1
050,30,069,"Montana","Petroleum County",5,43,7,4,3
050,30,069,"Montana","Petroleum County",5,44,2,1,1
050,30,069,"Montana","Petroleum County",5,45,2,0,2
050,30,069,"Montana","Petroleum County",5,46,5,3,2
050,30,069,"Montana","Petroleum County",5,47,4,2,2
050,30,069,"Montana","Petroleum County",5,48,4,3,1
050,30,069,"Montana","Petroleum County",5,49,3,2,1
050,30,069,"Montana","Petroleum County",5,50,5,2,3
050,30,069,"Montana","Petroleum County",5,51,3,1,2
050,30,069,"Montana","Petroleum County",5,52,4,1,3
050,30,069,"Montana","Petroleum County",5,53,7,2,5
050,30,069,"Montana","Petroleum County",5,54,16,8,8
050,30,069,"Montana","Petroleum County",5,55,12,8,4
050,30,069,"Montana","Petroleum County",5,56,7,2,5
050,30,069,"Montana","Petroleum County",5,57,9,6,3
050,30,069,"Montana","Petroleum County",5,58,15,8,7
050,30,069,"Montana","Petroleum County",5,59,10,5,5
050,30,069,"Montana","Petroleum County",5,60,13,6,7
050,30,069,"Montana","Petroleum County",5,61,14,10,4
050,30,069,"Montana","Petroleum County",5,62,11,7,4
050,30,069,"Montana","Petroleum County",5,63,10,5,5
050,30,069,"Montana","Petroleum County",5,64,10,4,6
050,30,069,"Montana","Petroleum County",5,65,17,9,8
050,30,069,"Montana","Petroleum County",5,66,14,8,6
050,30,069,"Montana","Petroleum County",5,67,12,8,4
050,30,069,"Montana","Petroleum County",5,68,11,6,5
050,30,069,"Montana","Petroleum County",5,69,8,5,3
050,30,069,"Montana","Petroleum County",5,70,9,5,4
050,30,069,"Montana","Petroleum County",5,71,6,4,2
050,30,069,"Montana","Petroleum County",5,72,7,3,4
050,30,069,"Montana","Petroleum County",5,73,5,3,2
050,30,069,"Montana","Petroleum County",5,74,6,4,2
050,30,069,"Montana","Petroleum County",5,75,4,3,1
050,30,069,"Montana","Petroleum County",5,76,7,3,4
050,30,069,"Montana","Petroleum County",5,77,2,1,1
050,30,069,"Montana","Petroleum County",5,78,2,0,2
050,30,069,"Montana","Petroleum County",5,79,0,0,0
050,30,069,"Montana","Petroleum County",5,80,0,0,0
050,30,069,"Montana","Petroleum County",5,81,3,2,1
050,30,069,"Montana","Petroleum County",5,82,10,4,6
050,30,069,"Montana","Petroleum County",5,83,6,3,3
050,30,069,"Montana","Petroleum County",5,84,6,3,3
050,30,069,"Montana","Petroleum County",5,85,29,19,10
050,30,071,"Montana","Phillips County",1,0,46,24,22
050,30,071,"Montana","Phillips County",1,1,48,23,25
050,30,071,"Montana","Phillips County",1,2,48,24,24
050,30,071,"Montana","Phillips County",1,3,56,21,35
050,30,071,"Montana","Phillips County",1,4,62,28,34
050,30,071,"Montana","Phillips County",1,5,58,25,33
050,30,071,"Montana","Phillips County",1,6,64,34,30
050,30,071,"Montana","Phillips County",1,7,45,28,17
050,30,071,"Montana","Phillips County",1,8,65,36,29
050,30,071,"Montana","Phillips County",1,9,50,26,24
050,30,071,"Montana","Phillips County",1,10,47,29,18
050,30,071,"Montana","Phillips County",1,11,48,29,19
050,30,071,"Montana","Phillips County",1,12,58,26,32
050,30,071,"Montana","Phillips County",1,13,66,33,33
050,30,071,"Montana","Phillips County",1,14,52,22,30
050,30,071,"Montana","Phillips County",1,15,62,29,33
050,30,071,"Montana","Phillips County",1,16,53,29,24
050,30,071,"Montana","Phillips County",1,17,46,25,21
050,30,071,"Montana","Phillips County",1,18,47,26,21
050,30,071,"Montana","Phillips County",1,19,36,20,16
050,30,071,"Montana","Phillips County",1,20,39,21,18
050,30,071,"Montana","Phillips County",1,21,39,23,16
050,30,071,"Montana","Phillips County",1,22,36,19,17
050,30,071,"Montana","Phillips County",1,23,38,20,18
050,30,071,"Montana","Phillips County",1,24,39,21,18
050,30,071,"Montana","Phillips County",1,25,36,18,18
050,30,071,"Montana","Phillips County",1,26,51,28,23
050,30,071,"Montana","Phillips County",1,27,45,24,21
050,30,071,"Montana","Phillips County",1,28,41,24,17
050,30,071,"Montana","Phillips County",1,29,37,19,18
050,30,071,"Montana","Phillips County",1,30,48,27,21
050,30,071,"Montana","Phillips County",1,31,42,26,16
050,30,071,"Montana","Phillips County",1,32,39,16,23
050,30,071,"Montana","Phillips County",1,33,38,17,21
050,30,071,"Montana","Phillips County",1,34,38,17,21
050,30,071,"Montana","Phillips County",1,35,35,20,15
050,30,071,"Montana","Phillips County",1,36,40,23,17
050,30,071,"Montana","Phillips County",1,37,48,30,18
050,30,071,"Montana","Phillips County",1,38,46,25,21
050,30,071,"Montana","Phillips County",1,39,54,27,27
050,30,071,"Montana","Phillips County",1,40,45,20,25
050,30,071,"Montana","Phillips County",1,41,36,14,22
050,30,071,"Montana","Phillips County",1,42,39,23,16
050,30,071,"Montana","Phillips County",1,43,50,29,21
050,30,071,"Montana","Phillips County",1,44,47,25,22
050,30,071,"Montana","Phillips County",1,45,41,24,17
050,30,071,"Montana","Phillips County",1,46,29,16,13
050,30,071,"Montana","Phillips County",1,47,29,16,13
050,30,071,"Montana","Phillips County",1,48,30,15,15
050,30,071,"Montana","Phillips County",1,49,39,17,22
050,30,071,"Montana","Phillips County",1,50,44,21,23
050,30,071,"Montana","Phillips County",1,51,50,28,22
050,30,071,"Montana","Phillips County",1,52,56,30,26
050,30,071,"Montana","Phillips County",1,53,49,24,25
050,30,071,"Montana","Phillips County",1,54,46,23,23
050,30,071,"Montana","Phillips County",1,55,58,32,26
050,30,071,"Montana","Phillips County",1,56,79,38,41
050,30,071,"Montana","Phillips County",1,57,67,34,33
050,30,071,"Montana","Phillips County",1,58,87,41,46
050,30,071,"Montana","Phillips County",1,59,81,35,46
050,30,071,"Montana","Phillips County",1,60,78,43,35
050,30,071,"Montana","Phillips County",1,61,73,36,37
050,30,071,"Montana","Phillips County",1,62,68,36,32
050,30,071,"Montana","Phillips County",1,63,65,30,35
050,30,071,"Montana","Phillips County",1,64,64,32,32
050,30,071,"Montana","Phillips County",1,65,71,31,40
050,30,071,"Montana","Phillips County",1,66,72,39,33
050,30,071,"Montana","Phillips County",1,67,70,37,33
050,30,071,"Montana","Phillips County",1,68,59,34,25
050,30,071,"Montana","Phillips County",1,69,58,33,25
050,30,071,"Montana","Phillips County",1,70,53,26,27
050,30,071,"Montana","Phillips County",1,71,54,29,25
050,30,071,"Montana","Phillips County",1,72,47,26,21
050,30,071,"Montana","Phillips County",1,73,51,23,28
050,30,071,"Montana","Phillips County",1,74,36,15,21
050,30,071,"Montana","Phillips County",1,75,30,16,14
050,30,071,"Montana","Phillips County",1,76,32,14,18
050,30,071,"Montana","Phillips County",1,77,37,18,19
050,30,071,"Montana","Phillips County",1,78,31,14,17
050,30,071,"Montana","Phillips County",1,79,34,11,23
050,30,071,"Montana","Phillips County",1,80,30,10,20
050,30,071,"Montana","Phillips County",1,81,22,10,12
050,30,071,"Montana","Phillips County",1,82,28,13,15
050,30,071,"Montana","Phillips County",1,83,25,10,15
050,30,071,"Montana","Phillips County",1,84,19,9,10
050,30,071,"Montana","Phillips County",1,85,125,50,75
050,30,071,"Montana","Phillips County",2,0,50,27,23
050,30,071,"Montana","Phillips County",2,1,48,23,25
050,30,071,"Montana","Phillips County",2,2,47,22,25
050,30,071,"Montana","Phillips County",2,3,53,21,32
050,30,071,"Montana","Phillips County",2,4,61,26,35
050,30,071,"Montana","Phillips County",2,5,59,27,32
050,30,071,"Montana","Phillips County",2,6,62,32,30
050,30,071,"Montana","Phillips County",2,7,48,29,19
050,30,071,"Montana","Phillips County",2,8,58,33,25
050,30,071,"Montana","Phillips County",2,9,53,29,24
050,30,071,"Montana","Phillips County",2,10,48,29,19
050,30,071,"Montana","Phillips County",2,11,44,27,17
050,30,071,"Montana","Phillips County",2,12,55,26,29
050,30,071,"Montana","Phillips County",2,13,62,31,31
050,30,071,"Montana","Phillips County",2,14,54,24,30
050,30,071,"Montana","Phillips County",2,15,60,27,33
050,30,071,"Montana","Phillips County",2,16,54,28,26
050,30,071,"Montana","Phillips County",2,17,48,26,22
050,30,071,"Montana","Phillips County",2,18,43,25,18
050,30,071,"Montana","Phillips County",2,19,38,21,17
050,30,071,"Montana","Phillips County",2,20,39,21,18
050,30,071,"Montana","Phillips County",2,21,40,23,17
050,30,071,"Montana","Phillips County",2,22,39,20,19
050,30,071,"Montana","Phillips County",2,23,37,19,18
050,30,071,"Montana","Phillips County",2,24,39,21,18
050,30,071,"Montana","Phillips County",2,25,36,18,18
050,30,071,"Montana","Phillips County",2,26,49,26,23
050,30,071,"Montana","Phillips County",2,27,47,25,22
050,30,071,"Montana","Phillips County",2,28,42,24,18
050,30,071,"Montana","Phillips County",2,29,38,20,18
050,30,071,"Montana","Phillips County",2,30,45,26,19
050,30,071,"Montana","Phillips County",2,31,41,25,16
050,30,071,"Montana","Phillips County",2,32,42,19,23
050,30,071,"Montana","Phillips County",2,33,36,16,20
050,30,071,"Montana","Phillips County",2,34,37,16,21
050,30,071,"Montana","Phillips County",2,35,36,20,16
050,30,071,"Montana","Phillips County",2,36,38,21,17
050,30,071,"Montana","Phillips County",2,37,45,28,17
050,30,071,"Montana","Phillips County",2,38,47,27,20
050,30,071,"Montana","Phillips County",2,39,52,27,25
050,30,071,"Montana","Phillips County",2,40,48,22,26
050,30,071,"Montana","Phillips County",2,41,38,16,22
050,30,071,"Montana","Phillips County",2,42,39,22,17
050,30,071,"Montana","Phillips County",2,43,48,27,21
050,30,071,"Montana","Phillips County",2,44,47,25,22
050,30,071,"Montana","Phillips County",2,45,44,25,19
050,30,071,"Montana","Phillips County",2,46,30,17,13
050,30,071,"Montana","Phillips County",2,47,29,16,13
050,30,071,"Montana","Phillips County",2,48,31,16,15
050,30,071,"Montana","Phillips County",2,49,38,17,21
050,30,071,"Montana","Phillips County",2,50,44,21,23
050,30,071,"Montana","Phillips County",2,51,48,26,22
050,30,071,"Montana","Phillips County",2,52,57,30,27
050,30,071,"Montana","Phillips County",2,53,49,26,23
050,30,071,"Montana","Phillips County",2,54,47,23,24
050,30,071,"Montana","Phillips County",2,55,55,30,25
050,30,071,"Montana","Phillips County",2,56,76,37,39
050,30,071,"Montana","Phillips County",2,57,69,35,34
050,30,071,"Montana","Phillips County",2,58,82,39,43
050,30,071,"Montana","Phillips County",2,59,82,36,46
050,30,071,"Montana","Phillips County",2,60,78,41,37
050,30,071,"Montana","Phillips County",2,61,75,38,37
050,30,071,"Montana","Phillips County",2,62,69,36,33
050,30,071,"Montana","Phillips County",2,63,67,32,35
050,30,071,"Montana","Phillips County",2,64,63,31,32
050,30,071,"Montana","Phillips County",2,65,71,32,39
050,30,071,"Montana","Phillips County",2,66,74,39,35
050,30,071,"Montana","Phillips County",2,67,69,36,33
050,30,071,"Montana","Phillips County",2,68,60,34,26
050,30,071,"Montana","Phillips County",2,69,59,33,26
050,30,071,"Montana","Phillips County",2,70,53,27,26
050,30,071,"Montana","Phillips County",2,71,53,27,26
050,30,071,"Montana","Phillips County",2,72,47,26,21
050,30,071,"Montana","Phillips County",2,73,53,25,28
050,30,071,"Montana","Phillips County",2,74,37,16,21
050,30,071,"Montana","Phillips County",2,75,31,16,15
050,30,071,"Montana","Phillips County",2,76,31,14,17
050,30,071,"Montana","Phillips County",2,77,38,18,20
050,30,071,"Montana","Phillips County",2,78,29,13,16
050,30,071,"Montana","Phillips County",2,79,33,12,21
050,30,071,"Montana","Phillips County",2,80,32,11,21
050,30,071,"Montana","Phillips County",2,81,22,10,12
050,30,071,"Montana","Phillips County",2,82,28,13,15
050,30,071,"Montana","Phillips County",2,83,23,10,13
050,30,071,"Montana","Phillips County",2,84,20,9,11
050,30,071,"Montana","Phillips County",2,85,127,50,77
050,30,071,"Montana","Phillips County",3,0,38,18,20
050,30,071,"Montana","Phillips County",3,1,50,27,23
050,30,071,"Montana","Phillips County",3,2,49,23,26
050,30,071,"Montana","Phillips County",3,3,51,23,28
050,30,071,"Montana","Phillips County",3,4,57,24,33
050,30,071,"Montana","Phillips County",3,5,67,27,40
050,30,071,"Montana","Phillips County",3,6,63,30,33
050,30,071,"Montana","Phillips County",3,7,63,32,31
050,30,071,"Montana","Phillips County",3,8,50,29,21
050,30,071,"Montana","Phillips County",3,9,59,34,25
050,30,071,"Montana","Phillips County",3,10,56,29,27
050,30,071,"Montana","Phillips County",3,11,51,31,20
050,30,071,"Montana","Phillips County",3,12,43,26,17
050,30,071,"Montana","Phillips County",3,13,56,28,28
050,30,071,"Montana","Phillips County",3,14,69,36,33
050,30,071,"Montana","Phillips County",3,15,55,24,31
050,30,071,"Montana","Phillips County",3,16,55,27,28
050,30,071,"Montana","Phillips County",3,17,53,27,26
050,30,071,"Montana","Phillips County",3,18,40,24,16
050,30,071,"Montana","Phillips County",3,19,38,23,15
050,30,071,"Montana","Phillips County",3,20,35,20,15
050,30,071,"Montana","Phillips County",3,21,39,20,19
050,30,071,"Montana","Phillips County",3,22,38,21,17
050,30,071,"Montana","Phillips County",3,23,45,21,24
050,30,071,"Montana","Phillips County",3,24,38,22,16
050,30,071,"Montana","Phillips County",3,25,44,24,20
050,30,071,"Montana","Phillips County",3,26,41,19,22
050,30,071,"Montana","Phillips County",3,27,43,25,18
050,30,071,"Montana","Phillips County",3,28,46,24,22
050,30,071,"Montana","Phillips County",3,29,43,20,23
050,30,071,"Montana","Phillips County",3,30,37,23,14
050,30,071,"Montana","Phillips County",3,31,39,21,18
050,30,071,"Montana","Phillips County",3,32,46,25,21
050,30,071,"Montana","Phillips County",3,33,37,17,20
050,30,071,"Montana","Phillips County",3,34,36,14,22
050,30,071,"Montana","Phillips County",3,35,46,22,24
050,30,071,"Montana","Phillips County",3,36,31,16,15
050,30,071,"Montana","Phillips County",3,37,33,20,13
050,30,071,"Montana","Phillips County",3,38,48,28,20
050,30,071,"Montana","Phillips County",3,39,44,27,17
050,30,071,"Montana","Phillips County",3,40,53,27,26
050,30,071,"Montana","Phillips County",3,41,47,22,25
050,30,071,"Montana","Phillips County",3,42,38,15,23
050,30,071,"Montana","Phillips County",3,43,42,24,18
050,30,071,"Montana","Phillips County",3,44,46,25,21
050,30,071,"Montana","Phillips County",3,45,50,25,25
050,30,071,"Montana","Phillips County",3,46,41,24,17
050,30,071,"Montana","Phillips County",3,47,30,16,14
050,30,071,"Montana","Phillips County",3,48,28,15,13
050,30,071,"Montana","Phillips County",3,49,28,14,14
050,30,071,"Montana","Phillips County",3,50,40,18,22
050,30,071,"Montana","Phillips County",3,51,40,19,21
050,30,071,"Montana","Phillips County",3,52,55,27,28
050,30,071,"Montana","Phillips County",3,53,49,29,20
050,30,071,"Montana","Phillips County",3,54,48,24,24
050,30,071,"Montana","Phillips County",3,55,47,24,23
050,30,071,"Montana","Phillips County",3,56,58,31,27
050,30,071,"Montana","Phillips County",3,57,73,32,41
050,30,071,"Montana","Phillips County",3,58,64,33,31
050,30,071,"Montana","Phillips County",3,59,82,38,44
050,30,071,"Montana","Phillips County",3,60,78,33,45
050,30,071,"Montana","Phillips County",3,61,78,40,38
050,30,071,"Montana","Phillips County",3,62,73,38,35
050,30,071,"Montana","Phillips County",3,63,72,36,36
050,30,071,"Montana","Phillips County",3,64,67,34,33
050,30,071,"Montana","Phillips County",3,65,66,30,36
050,30,071,"Montana","Phillips County",3,66,71,32,39
050,30,071,"Montana","Phillips County",3,67,69,36,33
050,30,071,"Montana","Phillips County",3,68,69,37,32
050,30,071,"Montana","Phillips County",3,69,66,37,29
050,30,071,"Montana","Phillips County",3,70,56,31,25
050,30,071,"Montana","Phillips County",3,71,53,27,26
050,30,071,"Montana","Phillips County",3,72,47,23,24
050,30,071,"Montana","Phillips County",3,73,44,25,19
050,30,071,"Montana","Phillips County",3,74,53,26,27
050,30,071,"Montana","Phillips County",3,75,38,16,22
050,30,071,"Montana","Phillips County",3,76,30,16,14
050,30,071,"Montana","Phillips County",3,77,36,15,21
050,30,071,"Montana","Phillips County",3,78,33,18,15
050,30,071,"Montana","Phillips County",3,79,27,13,14
050,30,071,"Montana","Phillips County",3,80,33,9,24
050,30,071,"Montana","Phillips County",3,81,25,9,16
050,30,071,"Montana","Phillips County",3,82,21,9,12
050,30,071,"Montana","Phillips County",3,83,28,14,14
050,30,071,"Montana","Phillips County",3,84,19,7,12
050,30,071,"Montana","Phillips County",3,85,127,51,76
050,30,071,"Montana","Phillips County",4,0,43,22,21
050,30,071,"Montana","Phillips County",4,1,37,19,18
050,30,071,"Montana","Phillips County",4,2,52,28,24
050,30,071,"Montana","Phillips County",4,3,49,19,30
050,30,071,"Montana","Phillips County",4,4,51,22,29
050,30,071,"Montana","Phillips County",4,5,59,26,33
050,30,071,"Montana","Phillips County",4,6,67,27,40
050,30,071,"Montana","Phillips County",4,7,65,34,31
050,30,071,"Montana","Phillips County",4,8,64,33,31
050,30,071,"Montana","Phillips County",4,9,50,30,20
050,30,071,"Montana","Phillips County",4,10,60,36,24
050,30,071,"Montana","Phillips County",4,11,61,31,30
050,30,071,"Montana","Phillips County",4,12,59,36,23
050,30,071,"Montana","Phillips County",4,13,43,26,17
050,30,071,"Montana","Phillips County",4,14,54,27,27
050,30,071,"Montana","Phillips County",4,15,74,38,36
050,30,071,"Montana","Phillips County",4,16,55,25,30
050,30,071,"Montana","Phillips County",4,17,63,29,34
050,30,071,"Montana","Phillips County",4,18,45,26,19
050,30,071,"Montana","Phillips County",4,19,36,21,15
050,30,071,"Montana","Phillips County",4,20,38,22,16
050,30,071,"Montana","Phillips County",4,21,31,16,15
050,30,071,"Montana","Phillips County",4,22,32,15,17
050,30,071,"Montana","Phillips County",4,23,45,22,23
050,30,071,"Montana","Phillips County",4,24,46,24,22
050,30,071,"Montana","Phillips County",4,25,40,22,18
050,30,071,"Montana","Phillips County",4,26,46,25,21
050,30,071,"Montana","Phillips County",4,27,38,18,20
050,30,071,"Montana","Phillips County",4,28,47,25,22
050,30,071,"Montana","Phillips County",4,29,48,24,24
050,30,071,"Montana","Phillips County",4,30,43,23,20
050,30,071,"Montana","Phillips County",4,31,38,23,15
050,30,071,"Montana","Phillips County",4,32,46,22,24
050,30,071,"Montana","Phillips County",4,33,42,24,18
050,30,071,"Montana","Phillips County",4,34,34,13,21
050,30,071,"Montana","Phillips County",4,35,44,22,22
050,30,071,"Montana","Phillips County",4,36,38,15,23
050,30,071,"Montana","Phillips County",4,37,30,13,17
050,30,071,"Montana","Phillips County",4,38,38,21,17
050,30,071,"Montana","Phillips County",4,39,51,31,20
050,30,071,"Montana","Phillips County",4,40,43,25,18
050,30,071,"Montana","Phillips County",4,41,56,27,29
050,30,071,"Montana","Phillips County",4,42,50,26,24
050,30,071,"Montana","Phillips County",4,43,34,12,22
050,30,071,"Montana","Phillips County",4,44,41,22,19
050,30,071,"Montana","Phillips County",4,45,47,28,19
050,30,071,"Montana","Phillips County",4,46,45,24,21
050,30,071,"Montana","Phillips County",4,47,44,24,20
050,30,071,"Montana","Phillips County",4,48,30,13,17
050,30,071,"Montana","Phillips County",4,49,30,16,14
050,30,071,"Montana","Phillips County",4,50,29,15,14
050,30,071,"Montana","Phillips County",4,51,34,13,21
050,30,071,"Montana","Phillips County",4,52,48,24,24
050,30,071,"Montana","Phillips County",4,53,52,28,24
050,30,071,"Montana","Phillips County",4,54,51,30,21
050,30,071,"Montana","Phillips County",4,55,50,26,24
050,30,071,"Montana","Phillips County",4,56,54,28,26
050,30,071,"Montana","Phillips County",4,57,55,29,26
050,30,071,"Montana","Phillips County",4,58,69,30,39
050,30,071,"Montana","Phillips County",4,59,64,32,32
050,30,071,"Montana","Phillips County",4,60,86,41,45
050,30,071,"Montana","Phillips County",4,61,80,33,47
050,30,071,"Montana","Phillips County",4,62,81,45,36
050,30,071,"Montana","Phillips County",4,63,76,39,37
050,30,071,"Montana","Phillips County",4,64,68,35,33
050,30,071,"Montana","Phillips County",4,65,68,31,37
050,30,071,"Montana","Phillips County",4,66,65,31,34
050,30,071,"Montana","Phillips County",4,67,67,30,37
050,30,071,"Montana","Phillips County",4,68,63,35,28
050,30,071,"Montana","Phillips County",4,69,75,39,36
050,30,071,"Montana","Phillips County",4,70,57,31,26
050,30,071,"Montana","Phillips County",4,71,56,30,26
050,30,071,"Montana","Phillips County",4,72,45,24,21
050,30,071,"Montana","Phillips County",4,73,44,20,24
050,30,071,"Montana","Phillips County",4,74,44,27,17
050,30,071,"Montana","Phillips County",4,75,50,25,25
050,30,071,"Montana","Phillips County",4,76,35,16,19
050,30,071,"Montana","Phillips County",4,77,31,17,14
050,30,071,"Montana","Phillips County",4,78,28,14,14
050,30,071,"Montana","Phillips County",4,79,33,18,15
050,30,071,"Montana","Phillips County",4,80,27,10,17
050,30,071,"Montana","Phillips County",4,81,26,8,18
050,30,071,"Montana","Phillips County",4,82,24,8,16
050,30,071,"Montana","Phillips County",4,83,21,11,10
050,30,071,"Montana","Phillips County",4,84,25,13,12
050,30,071,"Montana","Phillips County",4,85,125,49,76
050,30,071,"Montana","Phillips County",5,0,44,22,22
050,30,071,"Montana","Phillips County",5,1,49,23,26
050,30,071,"Montana","Phillips County",5,2,35,19,16
050,30,071,"Montana","Phillips County",5,3,55,32,23
050,30,071,"Montana","Phillips County",5,4,48,19,29
050,30,071,"Montana","Phillips County",5,5,55,24,31
050,30,071,"Montana","Phillips County",5,6,59,22,37
050,30,071,"Montana","Phillips County",5,7,67,29,38
050,30,071,"Montana","Phillips County",5,8,63,34,29
050,30,071,"Montana","Phillips County",5,9,62,32,30
050,30,071,"Montana","Phillips County",5,10,48,29,19
050,30,071,"Montana","Phillips County",5,11,67,40,27
050,30,071,"Montana","Phillips County",5,12,61,27,34
050,30,071,"Montana","Phillips County",5,13,59,38,21
050,30,071,"Montana","Phillips County",5,14,44,28,16
050,30,071,"Montana","Phillips County",5,15,58,30,28
050,30,071,"Montana","Phillips County",5,16,78,40,38
050,30,071,"Montana","Phillips County",5,17,52,22,30
050,30,071,"Montana","Phillips County",5,18,57,28,29
050,30,071,"Montana","Phillips County",5,19,41,26,15
050,30,071,"Montana","Phillips County",5,20,37,22,15
050,30,071,"Montana","Phillips County",5,21,37,20,17
050,30,071,"Montana","Phillips County",5,22,32,16,16
050,30,071,"Montana","Phillips County",5,23,33,16,17
050,30,071,"Montana","Phillips County",5,24,45,24,21
050,30,071,"Montana","Phillips County",5,25,46,25,21
050,30,071,"Montana","Phillips County",5,26,40,23,17
050,30,071,"Montana","Phillips County",5,27,50,27,23
050,30,071,"Montana","Phillips County",5,28,39,17,22
050,30,071,"Montana","Phillips County",5,29,51,22,29
050,30,071,"Montana","Phillips County",5,30,47,26,21
050,30,071,"Montana","Phillips County",5,31,37,19,18
050,30,071,"Montana","Phillips County",5,32,41,23,18
050,30,071,"Montana","Phillips County",5,33,43,23,20
050,30,071,"Montana","Phillips County",5,34,48,27,21
050,30,071,"Montana","Phillips County",5,35,39,19,20
050,30,071,"Montana","Phillips County",5,36,41,19,22
050,30,071,"Montana","Phillips County",5,37,39,15,24
050,30,071,"Montana","Phillips County",5,38,39,15,24
050,30,071,"Montana","Phillips County",5,39,42,22,20
050,30,071,"Montana","Phillips County",5,40,48,30,18
050,30,071,"Montana","Phillips County",5,41,47,31,16
050,30,071,"Montana","Phillips County",5,42,63,31,32
050,30,071,"Montana","Phillips County",5,43,47,22,25
050,30,071,"Montana","Phillips County",5,44,31,10,21
050,30,071,"Montana","Phillips County",5,45,46,22,24
050,30,071,"Montana","Phillips County",5,46,44,27,17
050,30,071,"Montana","Phillips County",5,47,43,24,19
050,30,071,"Montana","Phillips County",5,48,46,23,23
050,30,071,"Montana","Phillips County",5,49,33,13,20
050,30,071,"Montana","Phillips County",5,50,33,18,15
050,30,071,"Montana","Phillips County",5,51,30,15,15
050,30,071,"Montana","Phillips County",5,52,40,13,27
050,30,071,"Montana","Phillips County",5,53,40,23,17
050,30,071,"Montana","Phillips County",5,54,51,26,25
050,30,071,"Montana","Phillips County",5,55,52,32,20
050,30,071,"Montana","Phillips County",5,56,55,28,27
050,30,071,"Montana","Phillips County",5,57,51,25,26
050,30,071,"Montana","Phillips County",5,58,53,29,24
050,30,071,"Montana","Phillips County",5,59,67,29,38
050,30,071,"Montana","Phillips County",5,60,65,32,33
050,30,071,"Montana","Phillips County",5,61,85,40,45
050,30,071,"Montana","Phillips County",5,62,81,36,45
050,30,071,"Montana","Phillips County",5,63,84,45,39
050,30,071,"Montana","Phillips County",5,64,73,39,34
050,30,071,"Montana","Phillips County",5,65,71,33,38
050,30,071,"Montana","Phillips County",5,66,67,34,33
050,30,071,"Montana","Phillips County",5,67,61,30,31
050,30,071,"Montana","Phillips County",5,68,64,29,35
050,30,071,"Montana","Phillips County",5,69,66,34,32
050,30,071,"Montana","Phillips County",5,70,72,37,35
050,30,071,"Montana","Phillips County",5,71,58,31,27
050,30,071,"Montana","Phillips County",5,72,50,28,22
050,30,071,"Montana","Phillips County",5,73,45,24,21
050,30,071,"Montana","Phillips County",5,74,41,19,22
050,30,071,"Montana","Phillips County",5,75,43,26,17
050,30,071,"Montana","Phillips County",5,76,46,23,23
050,30,071,"Montana","Phillips County",5,77,37,17,20
050,30,071,"Montana","Phillips County",5,78,26,16,10
050,30,071,"Montana","Phillips County",5,79,27,14,13
050,30,071,"Montana","Phillips County",5,80,32,15,17
050,30,071,"Montana","Phillips County",5,81,20,9,11
050,30,071,"Montana","Phillips County",5,82,26,8,18
050,30,071,"Montana","Phillips County",5,83,24,10,14
050,30,071,"Montana","Phillips County",5,84,15,9,6
050,30,071,"Montana","Phillips County",5,85,122,53,69
050,30,073,"Montana","Pondera County",1,0,64,32,32
050,30,073,"Montana","Pondera County",1,1,74,36,38
050,30,073,"Montana","Pondera County",1,2,82,43,39
050,30,073,"Montana","Pondera County",1,3,96,58,38
050,30,073,"Montana","Pondera County",1,4,74,43,31
050,30,073,"Montana","Pondera County",1,5,76,44,32
050,30,073,"Montana","Pondera County",1,6,76,34,42
050,30,073,"Montana","Pondera County",1,7,71,27,44
050,30,073,"Montana","Pondera County",1,8,78,44,34
050,30,073,"Montana","Pondera County",1,9,86,44,42
050,30,073,"Montana","Pondera County",1,10,82,44,38
050,30,073,"Montana","Pondera County",1,11,67,38,29
050,30,073,"Montana","Pondera County",1,12,78,44,34
050,30,073,"Montana","Pondera County",1,13,71,38,33
050,30,073,"Montana","Pondera County",1,14,88,40,48
050,30,073,"Montana","Pondera County",1,15,86,43,43
050,30,073,"Montana","Pondera County",1,16,76,39,37
050,30,073,"Montana","Pondera County",1,17,72,33,39
050,30,073,"Montana","Pondera County",1,18,68,31,37
050,30,073,"Montana","Pondera County",1,19,60,29,31
050,30,073,"Montana","Pondera County",1,20,65,33,32
050,30,073,"Montana","Pondera County",1,21,60,35,25
050,30,073,"Montana","Pondera County",1,22,52,26,26
050,30,073,"Montana","Pondera County",1,23,61,33,28
050,30,073,"Montana","Pondera County",1,24,59,27,32
050,30,073,"Montana","Pondera County",1,25,57,26,31
050,30,073,"Montana","Pondera County",1,26,64,34,30
050,30,073,"Montana","Pondera County",1,27,64,33,31
050,30,073,"Montana","Pondera County",1,28,59,31,28
050,30,073,"Montana","Pondera County",1,29,69,41,28
050,30,073,"Montana","Pondera County",1,30,68,29,39
050,30,073,"Montana","Pondera County",1,31,76,35,41
050,30,073,"Montana","Pondera County",1,32,67,38,29
050,30,073,"Montana","Pondera County",1,33,51,24,27
050,30,073,"Montana","Pondera County",1,34,71,36,35
050,30,073,"Montana","Pondera County",1,35,76,42,34
050,30,073,"Montana","Pondera County",1,36,75,38,37
050,30,073,"Montana","Pondera County",1,37,68,38,30
050,30,073,"Montana","Pondera County",1,38,58,24,34
050,30,073,"Montana","Pondera County",1,39,57,25,32
050,30,073,"Montana","Pondera County",1,40,64,37,27
050,30,073,"Montana","Pondera County",1,41,65,29,36
050,30,073,"Montana","Pondera County",1,42,66,33,33
050,30,073,"Montana","Pondera County",1,43,55,23,32
050,30,073,"Montana","Pondera County",1,44,56,29,27
050,30,073,"Montana","Pondera County",1,45,58,30,28
050,30,073,"Montana","Pondera County",1,46,58,29,29
050,30,073,"Montana","Pondera County",1,47,60,32,28
050,30,073,"Montana","Pondera County",1,48,68,36,32
050,30,073,"Montana","Pondera County",1,49,60,30,30
050,30,073,"Montana","Pondera County",1,50,61,33,28
050,30,073,"Montana","Pondera County",1,51,63,30,33
050,30,073,"Montana","Pondera County",1,52,60,32,28
050,30,073,"Montana","Pondera County",1,53,54,30,24
050,30,073,"Montana","Pondera County",1,54,64,28,36
050,30,073,"Montana","Pondera County",1,55,85,39,46
050,30,073,"Montana","Pondera County",1,56,85,37,48
050,30,073,"Montana","Pondera County",1,57,83,40,43
050,30,073,"Montana","Pondera County",1,58,104,54,50
050,30,073,"Montana","Pondera County",1,59,98,48,50
050,30,073,"Montana","Pondera County",1,60,99,41,58
050,30,073,"Montana","Pondera County",1,61,91,43,48
050,30,073,"Montana","Pondera County",1,62,99,50,49
050,30,073,"Montana","Pondera County",1,63,95,47,48
050,30,073,"Montana","Pondera County",1,64,92,47,45
050,30,073,"Montana","Pondera County",1,65,91,45,46
050,30,073,"Montana","Pondera County",1,66,83,40,43
050,30,073,"Montana","Pondera County",1,67,88,46,42
050,30,073,"Montana","Pondera County",1,68,76,41,35
050,30,073,"Montana","Pondera County",1,69,66,34,32
050,30,073,"Montana","Pondera County",1,70,63,31,32
050,30,073,"Montana","Pondera County",1,71,63,31,32
050,30,073,"Montana","Pondera County",1,72,65,34,31
050,30,073,"Montana","Pondera County",1,73,59,29,30
050,30,073,"Montana","Pondera County",1,74,48,21,27
050,30,073,"Montana","Pondera County",1,75,51,26,25
050,30,073,"Montana","Pondera County",1,76,49,25,24
050,30,073,"Montana","Pondera County",1,77,42,20,22
050,30,073,"Montana","Pondera County",1,78,39,20,19
050,30,073,"Montana","Pondera County",1,79,45,21,24
050,30,073,"Montana","Pondera County",1,80,33,16,17
050,30,073,"Montana","Pondera County",1,81,20,8,12
050,30,073,"Montana","Pondera County",1,82,27,12,15
050,30,073,"Montana","Pondera County",1,83,29,16,13
050,30,073,"Montana","Pondera County",1,84,27,11,16
050,30,073,"Montana","Pondera County",1,85,194,71,123
050,30,073,"Montana","Pondera County",2,0,62,29,33
050,30,073,"Montana","Pondera County",2,1,69,33,36
050,30,073,"Montana","Pondera County",2,2,78,40,38
050,30,073,"Montana","Pondera County",2,3,91,54,37
050,30,073,"Montana","Pondera County",2,4,77,46,31
050,30,073,"Montana","Pondera County",2,5,75,43,32
050,30,073,"Montana","Pondera County",2,6,77,37,40
050,30,073,"Montana","Pondera County",2,7,71,29,42
050,30,073,"Montana","Pondera County",2,8,78,40,38
050,30,073,"Montana","Pondera County",2,9,86,45,41
050,30,073,"Montana","Pondera County",2,10,81,43,38
050,30,073,"Montana","Pondera County",2,11,69,39,30
050,30,073,"Montana","Pondera County",2,12,77,43,34
050,30,073,"Montana","Pondera County",2,13,73,40,33
050,30,073,"Montana","Pondera County",2,14,85,40,45
050,30,073,"Montana","Pondera County",2,15,86,42,44
050,30,073,"Montana","Pondera County",2,16,77,39,38
050,30,073,"Montana","Pondera County",2,17,72,35,37
050,30,073,"Montana","Pondera County",2,18,64,29,35
050,30,073,"Montana","Pondera County",2,19,59,29,30
050,30,073,"Montana","Pondera County",2,20,66,33,33
050,30,073,"Montana","Pondera County",2,21,61,35,26
050,30,073,"Montana","Pondera County",2,22,55,31,24
050,30,073,"Montana","Pondera County",2,23,60,32,28
050,30,073,"Montana","Pondera County",2,24,60,28,32
050,30,073,"Montana","Pondera County",2,25,58,27,31
050,30,073,"Montana","Pondera County",2,26,64,33,31
050,30,073,"Montana","Pondera County",2,27,63,33,30
050,30,073,"Montana","Pondera County",2,28,60,32,28
050,30,073,"Montana","Pondera County",2,29,67,38,29
050,30,073,"Montana","Pondera County",2,30,69,33,36
050,30,073,"Montana","Pondera County",2,31,75,34,41
050,30,073,"Montana","Pondera County",2,32,68,36,32
050,30,073,"Montana","Pondera County",2,33,54,27,27
050,30,073,"Montana","Pondera County",2,34,66,34,32
050,30,073,"Montana","Pondera County",2,35,75,41,34
050,30,073,"Montana","Pondera County",2,36,75,38,37
050,30,073,"Montana","Pondera County",2,37,70,38,32
050,30,073,"Montana","Pondera County",2,38,61,28,33
050,30,073,"Montana","Pondera County",2,39,56,24,32
050,30,073,"Montana","Pondera County",2,40,63,35,28
050,30,073,"Montana","Pondera County",2,41,65,31,34
050,30,073,"Montana","Pondera County",2,42,66,32,34
050,30,073,"Montana","Pondera County",2,43,58,26,32
050,30,073,"Montana","Pondera County",2,44,54,27,27
050,30,073,"Montana","Pondera County",2,45,58,29,29
050,30,073,"Montana","Pondera County",2,46,56,29,27
050,30,073,"Montana","Pondera County",2,47,58,30,28
050,30,073,"Montana","Pondera County",2,48,65,35,30
050,30,073,"Montana","Pondera County",2,49,61,31,30
050,30,073,"Montana","Pondera County",2,50,60,32,28
050,30,073,"Montana","Pondera County",2,51,62,30,32
050,30,073,"Montana","Pondera County",2,52,59,30,29
050,30,073,"Montana","Pondera County",2,53,55,31,24
050,30,073,"Montana","Pondera County",2,54,60,28,32
050,30,073,"Montana","Pondera County",2,55,80,36,44
050,30,073,"Montana","Pondera County",2,56,84,37,47
050,30,073,"Montana","Pondera County",2,57,83,39,44
050,30,073,"Montana","Pondera County",2,58,100,51,49
050,30,073,"Montana","Pondera County",2,59,99,49,50
050,30,073,"Montana","Pondera County",2,60,99,43,56
050,30,073,"Montana","Pondera County",2,61,92,42,50
050,30,073,"Montana","Pondera County",2,62,97,48,49
050,30,073,"Montana","Pondera County",2,63,98,48,50
050,30,073,"Montana","Pondera County",2,64,92,46,46
050,30,073,"Montana","Pondera County",2,65,92,47,45
050,30,073,"Montana","Pondera County",2,66,84,41,43
050,30,073,"Montana","Pondera County",2,67,85,43,42
050,30,073,"Montana","Pondera County",2,68,76,40,36
050,30,073,"Montana","Pondera County",2,69,70,36,34
050,30,073,"Montana","Pondera County",2,70,63,32,31
050,30,073,"Montana","Pondera County",2,71,63,31,32
050,30,073,"Montana","Pondera County",2,72,63,33,30
050,30,073,"Montana","Pondera County",2,73,61,31,30
050,30,073,"Montana","Pondera County",2,74,47,22,25
050,30,073,"Montana","Pondera County",2,75,52,26,26
050,30,073,"Montana","Pondera County",2,76,47,24,23
050,30,073,"Montana","Pondera County",2,77,45,22,23
050,30,073,"Montana","Pondera County",2,78,38,19,19
050,30,073,"Montana","Pondera County",2,79,44,20,24
050,30,073,"Montana","Pondera County",2,80,35,18,17
050,30,073,"Montana","Pondera County",2,81,22,9,13
050,30,073,"Montana","Pondera County",2,82,25,10,15
050,30,073,"Montana","Pondera County",2,83,27,15,12
050,30,073,"Montana","Pondera County",2,84,29,13,16
050,30,073,"Montana","Pondera County",2,85,196,72,124
050,30,073,"Montana","Pondera County",3,0,71,37,34
050,30,073,"Montana","Pondera County",3,1,51,24,27
050,30,073,"Montana","Pondera County",3,2,73,37,36
050,30,073,"Montana","Pondera County",3,3,81,41,40
050,30,073,"Montana","Pondera County",3,4,91,54,37
050,30,073,"Montana","Pondera County",3,5,75,44,31
050,30,073,"Montana","Pondera County",3,6,85,49,36
050,30,073,"Montana","Pondera County",3,7,72,33,39
050,30,073,"Montana","Pondera County",3,8,70,27,43
050,30,073,"Montana","Pondera County",3,9,81,42,39
050,30,073,"Montana","Pondera County",3,10,88,43,45
050,30,073,"Montana","Pondera County",3,11,85,46,39
050,30,073,"Montana","Pondera County",3,12,77,45,32
050,30,073,"Montana","Pondera County",3,13,80,46,34
050,30,073,"Montana","Pondera County",3,14,78,45,33
050,30,073,"Montana","Pondera County",3,15,89,42,47
050,30,073,"Montana","Pondera County",3,16,87,42,45
050,30,073,"Montana","Pondera County",3,17,76,40,36
050,30,073,"Montana","Pondera County",3,18,68,34,34
050,30,073,"Montana","Pondera County",3,19,57,24,33
050,30,073,"Montana","Pondera County",3,20,66,34,32
050,30,073,"Montana","Pondera County",3,21,63,32,31
050,30,073,"Montana","Pondera County",3,22,62,37,25
050,30,073,"Montana","Pondera County",3,23,61,32,29
050,30,073,"Montana","Pondera County",3,24,66,35,31
050,30,073,"Montana","Pondera County",3,25,64,29,35
050,30,073,"Montana","Pondera County",3,26,67,31,36
050,30,073,"Montana","Pondera County",3,27,57,30,27
050,30,073,"Montana","Pondera County",3,28,66,31,35
050,30,073,"Montana","Pondera County",3,29,60,28,32
050,30,073,"Montana","Pondera County",3,30,71,41,30
050,30,073,"Montana","Pondera County",3,31,73,33,40
050,30,073,"Montana","Pondera County",3,32,76,36,40
050,30,073,"Montana","Pondera County",3,33,67,34,33
050,30,073,"Montana","Pondera County",3,34,63,33,30
050,30,073,"Montana","Pondera County",3,35,67,36,31
050,30,073,"Montana","Pondera County",3,36,79,43,36
050,30,073,"Montana","Pondera County",3,37,77,42,35
050,30,073,"Montana","Pondera County",3,38,69,36,33
050,30,073,"Montana","Pondera County",3,39,67,35,32
050,30,073,"Montana","Pondera County",3,40,57,21,36
050,30,073,"Montana","Pondera County",3,41,70,39,31
050,30,073,"Montana","Pondera County",3,42,68,32,36
050,30,073,"Montana","Pondera County",3,43,65,32,33
050,30,073,"Montana","Pondera County",3,44,56,24,32
050,30,073,"Montana","Pondera County",3,45,58,31,27
050,30,073,"Montana","Pondera County",3,46,60,30,30
050,30,073,"Montana","Pondera County",3,47,61,32,29
050,30,073,"Montana","Pondera County",3,48,62,35,27
050,30,073,"Montana","Pondera County",3,49,71,38,33
050,30,073,"Montana","Pondera County",3,50,65,31,34
050,30,073,"Montana","Pondera County",3,51,58,33,25
050,30,073,"Montana","Pondera County",3,52,60,29,31
050,30,073,"Montana","Pondera County",3,53,62,31,31
050,30,073,"Montana","Pondera County",3,54,64,34,30
050,30,073,"Montana","Pondera County",3,55,62,28,34
050,30,073,"Montana","Pondera County",3,56,79,37,42
050,30,073,"Montana","Pondera County",3,57,89,39,50
050,30,073,"Montana","Pondera County",3,58,88,42,46
050,30,073,"Montana","Pondera County",3,59,102,53,49
050,30,073,"Montana","Pondera County",3,60,100,49,51
050,30,073,"Montana","Pondera County",3,61,95,41,54
050,30,073,"Montana","Pondera County",3,62,94,44,50
050,30,073,"Montana","Pondera County",3,63,100,49,51
050,30,073,"Montana","Pondera County",3,64,94,44,50
050,30,073,"Montana","Pondera County",3,65,90,46,44
050,30,073,"Montana","Pondera County",3,66,93,49,44
050,30,073,"Montana","Pondera County",3,67,84,40,44
050,30,073,"Montana","Pondera County",3,68,83,40,43
050,30,073,"Montana","Pondera County",3,69,78,41,37
050,30,073,"Montana","Pondera County",3,70,71,36,35
050,30,073,"Montana","Pondera County",3,71,65,34,31
050,30,073,"Montana","Pondera County",3,72,65,31,34
050,30,073,"Montana","Pondera County",3,73,62,34,28
050,30,073,"Montana","Pondera County",3,74,59,30,29
050,30,073,"Montana","Pondera County",3,75,45,22,23
050,30,073,"Montana","Pondera County",3,76,52,27,25
050,30,073,"Montana","Pondera County",3,77,44,24,20
050,30,073,"Montana","Pondera County",3,78,42,21,21
050,30,073,"Montana","Pondera County",3,79,37,14,23
050,30,073,"Montana","Pondera County",3,80,43,22,21
050,30,073,"Montana","Pondera County",3,81,32,15,17
050,30,073,"Montana","Pondera County",3,82,22,9,13
050,30,073,"Montana","Pondera County",3,83,17,5,12
050,30,073,"Montana","Pondera County",3,84,26,11,15
050,30,073,"Montana","Pondera County",3,85,192,70,122
050,30,073,"Montana","Pondera County",4,0,75,37,38
050,30,073,"Montana","Pondera County",4,1,63,31,32
050,30,073,"Montana","Pondera County",4,2,54,24,30
050,30,073,"Montana","Pondera County",4,3,82,41,41
050,30,073,"Montana","Pondera County",4,4,86,47,39
050,30,073,"Montana","Pondera County",4,5,89,52,37
050,30,073,"Montana","Pondera County",4,6,82,46,36
050,30,073,"Montana","Pondera County",4,7,84,53,31
050,30,073,"Montana","Pondera County",4,8,83,40,43
050,30,073,"Montana","Pondera County",4,9,73,28,45
050,30,073,"Montana","Pondera County",4,10,79,41,38
050,30,073,"Montana","Pondera County",4,11,96,46,50
050,30,073,"Montana","Pondera County",4,12,90,48,42
050,30,073,"Montana","Pondera County",4,13,73,49,24
050,30,073,"Montana","Pondera County",4,14,88,50,38
050,30,073,"Montana","Pondera County",4,15,78,43,35
050,30,073,"Montana","Pondera County",4,16,91,44,47
050,30,073,"Montana","Pondera County",4,17,90,43,47
050,30,073,"Montana","Pondera County",4,18,73,35,38
050,30,073,"Montana","Pondera County",4,19,53,25,28
050,30,073,"Montana","Pondera County",4,20,58,25,33
050,30,073,"Montana","Pondera County",4,21,55,31,24
050,30,073,"Montana","Pondera County",4,22,66,33,33
050,30,073,"Montana","Pondera County",4,23,58,31,27
050,30,073,"Montana","Pondera County",4,24,60,35,25
050,30,073,"Montana","Pondera County",4,25,67,34,33
050,30,073,"Montana","Pondera County",4,26,61,27,34
050,30,073,"Montana","Pondera County",4,27,59,30,29
050,30,073,"Montana","Pondera County",4,28,61,35,26
050,30,073,"Montana","Pondera County",4,29,59,28,31
050,30,073,"Montana","Pondera County",4,30,61,25,36
050,30,073,"Montana","Pondera County",4,31,76,42,34
050,30,073,"Montana","Pondera County",4,32,76,37,39
050,30,073,"Montana","Pondera County",4,33,81,40,41
050,30,073,"Montana","Pondera County",4,34,81,37,44
050,30,073,"Montana","Pondera County",4,35,65,35,30
050,30,073,"Montana","Pondera County",4,36,67,33,34
050,30,073,"Montana","Pondera County",4,37,77,45,32
050,30,073,"Montana","Pondera County",4,38,81,43,38
050,30,073,"Montana","Pondera County",4,39,74,37,37
050,30,073,"Montana","Pondera County",4,40,74,42,32
050,30,073,"Montana","Pondera County",4,41,55,20,35
050,30,073,"Montana","Pondera County",4,42,72,42,30
050,30,073,"Montana","Pondera County",4,43,65,30,35
050,30,073,"Montana","Pondera County",4,44,64,30,34
050,30,073,"Montana","Pondera County",4,45,56,24,32
050,30,073,"Montana","Pondera County",4,46,57,30,27
050,30,073,"Montana","Pondera County",4,47,62,31,31
050,30,073,"Montana","Pondera County",4,48,59,31,28
050,30,073,"Montana","Pondera County",4,49,63,33,30
050,30,073,"Montana","Pondera County",4,50,74,39,35
050,30,073,"Montana","Pondera County",4,51,64,31,33
050,30,073,"Montana","Pondera County",4,52,58,35,23
050,30,073,"Montana","Pondera County",4,53,60,33,27
050,30,073,"Montana","Pondera County",4,54,61,31,30
050,30,073,"Montana","Pondera County",4,55,65,35,30
050,30,073,"Montana","Pondera County",4,56,59,26,33
050,30,073,"Montana","Pondera County",4,57,83,40,43
050,30,073,"Montana","Pondera County",4,58,94,40,54
050,30,073,"Montana","Pondera County",4,59,89,45,44
050,30,073,"Montana","Pondera County",4,60,98,54,44
050,30,073,"Montana","Pondera County",4,61,98,47,51
050,30,073,"Montana","Pondera County",4,62,97,43,54
050,30,073,"Montana","Pondera County",4,63,94,44,50
050,30,073,"Montana","Pondera County",4,64,102,49,53
050,30,073,"Montana","Pondera County",4,65,95,45,50
050,30,073,"Montana","Pondera County",4,66,90,45,45
050,30,073,"Montana","Pondera County",4,67,94,50,44
050,30,073,"Montana","Pondera County",4,68,83,40,43
050,30,073,"Montana","Pondera County",4,69,83,40,43
050,30,073,"Montana","Pondera County",4,70,74,40,34
050,30,073,"Montana","Pondera County",4,71,67,34,33
050,30,073,"Montana","Pondera County",4,72,68,36,32
050,30,073,"Montana","Pondera County",4,73,64,31,33
050,30,073,"Montana","Pondera County",4,74,64,35,29
050,30,073,"Montana","Pondera County",4,75,54,28,26
050,30,073,"Montana","Pondera County",4,76,43,24,19
050,30,073,"Montana","Pondera County",4,77,48,25,23
050,30,073,"Montana","Pondera County",4,78,42,22,20
050,30,073,"Montana","Pondera County",4,79,44,19,25
050,30,073,"Montana","Pondera County",4,80,35,16,19
050,30,073,"Montana","Pondera County",4,81,40,20,20
050,30,073,"Montana","Pondera County",4,82,33,16,17
050,30,073,"Montana","Pondera County",4,83,17,7,10
050,30,073,"Montana","Pondera County",4,84,21,7,14
050,30,073,"Montana","Pondera County",4,85,185,66,119
050,30,073,"Montana","Pondera County",5,0,75,37,38
050,30,073,"Montana","Pondera County",5,1,71,33,38
050,30,073,"Montana","Pondera County",5,2,63,32,31
050,30,073,"Montana","Pondera County",5,3,61,27,34
050,30,073,"Montana","Pondera County",5,4,79,41,38
050,30,073,"Montana","Pondera County",5,5,81,43,38
050,30,073,"Montana","Pondera County",5,6,88,52,36
050,30,073,"Montana","Pondera County",5,7,83,46,37
050,30,073,"Montana","Pondera County",5,8,80,51,29
050,30,073,"Montana","Pondera County",5,9,89,42,47
050,30,073,"Montana","Pondera County",5,10,72,32,40
050,30,073,"Montana","Pondera County",5,11,78,40,38
050,30,073,"Montana","Pondera County",5,12,91,46,45
050,30,073,"Montana","Pondera County",5,13,84,43,41
050,30,073,"Montana","Pondera County",5,14,74,50,24
050,30,073,"Montana","Pondera County",5,15,86,47,39
050,30,073,"Montana","Pondera County",5,16,85,45,40
050,30,073,"Montana","Pondera County",5,17,94,46,48
050,30,073,"Montana","Pondera County",5,18,78,39,39
050,30,073,"Montana","Pondera County",5,19,64,27,37
050,30,073,"Montana","Pondera County",5,20,67,29,38
050,30,073,"Montana","Pondera County",5,21,49,21,28
050,30,073,"Montana","Pondera County",5,22,58,32,26
050,30,073,"Montana","Pondera County",5,23,58,26,32
050,30,073,"Montana","Pondera County",5,24,60,33,27
050,30,073,"Montana","Pondera County",5,25,66,37,29
050,30,073,"Montana","Pondera County",5,26,71,34,37
050,30,073,"Montana","Pondera County",5,27,62,32,30
050,30,073,"Montana","Pondera County",5,28,66,35,31
050,30,073,"Montana","Pondera County",5,29,61,34,27
050,30,073,"Montana","Pondera County",5,30,61,33,28
050,30,073,"Montana","Pondera County",5,31,64,27,37
050,30,073,"Montana","Pondera County",5,32,76,44,32
050,30,073,"Montana","Pondera County",5,33,80,43,37
050,30,073,"Montana","Pondera County",5,34,82,40,42
050,30,073,"Montana","Pondera County",5,35,83,44,39
050,30,073,"Montana","Pondera County",5,36,61,30,31
050,30,073,"Montana","Pondera County",5,37,66,31,35
050,30,073,"Montana","Pondera County",5,38,75,43,32
050,30,073,"Montana","Pondera County",5,39,88,46,42
050,30,073,"Montana","Pondera County",5,40,77,39,38
050,30,073,"Montana","Pondera County",5,41,75,43,32
050,30,073,"Montana","Pondera County",5,42,56,25,31
050,30,073,"Montana","Pondera County",5,43,74,43,31
050,30,073,"Montana","Pondera County",5,44,63,27,36
050,30,073,"Montana","Pondera County",5,45,61,26,35
050,30,073,"Montana","Pondera County",5,46,54,23,31
050,30,073,"Montana","Pondera County",5,47,56,27,29
050,30,073,"Montana","Pondera County",5,48,56,30,26
050,30,073,"Montana","Pondera County",5,49,59,30,29
050,30,073,"Montana","Pondera County",5,50,60,31,29
050,30,073,"Montana","Pondera County",5,51,70,39,31
050,30,073,"Montana","Pondera County",5,52,69,33,36
050,30,073,"Montana","Pondera County",5,53,64,41,23
050,30,073,"Montana","Pondera County",5,54,59,33,26
050,30,073,"Montana","Pondera County",5,55,65,31,34
050,30,073,"Montana","Pondera County",5,56,64,34,30
050,30,073,"Montana","Pondera County",5,57,60,27,33
050,30,073,"Montana","Pondera County",5,58,85,40,45
050,30,073,"Montana","Pondera County",5,59,99,46,53
050,30,073,"Montana","Pondera County",5,60,91,47,44
050,30,073,"Montana","Pondera County",5,61,97,52,45
050,30,073,"Montana","Pondera County",5,62,98,47,51
050,30,073,"Montana","Pondera County",5,63,99,45,54
050,30,073,"Montana","Pondera County",5,64,97,45,52
050,30,073,"Montana","Pondera County",5,65,105,50,55
050,30,073,"Montana","Pondera County",5,66,94,48,46
050,30,073,"Montana","Pondera County",5,67,87,44,43
050,30,073,"Montana","Pondera County",5,68,91,48,43
050,30,073,"Montana","Pondera County",5,69,87,41,46
050,30,073,"Montana","Pondera County",5,70,78,39,39
050,30,073,"Montana","Pondera County",5,71,71,38,33
050,30,073,"Montana","Pondera County",5,72,67,33,34
050,30,073,"Montana","Pondera County",5,73,65,35,30
050,30,073,"Montana","Pondera County",5,74,65,32,33
050,30,073,"Montana","Pondera County",5,75,63,34,29
050,30,073,"Montana","Pondera County",5,76,49,27,22
050,30,073,"Montana","Pondera County",5,77,37,21,16
050,30,073,"Montana","Pondera County",5,78,46,22,24
050,30,073,"Montana","Pondera County",5,79,43,19,24
050,30,073,"Montana","Pondera County",5,80,41,20,21
050,30,073,"Montana","Pondera County",5,81,34,15,19
050,30,073,"Montana","Pondera County",5,82,40,20,20
050,30,073,"Montana","Pondera County",5,83,28,14,14
050,30,073,"Montana","Pondera County",5,84,19,7,12
050,30,073,"Montana","Pondera County",5,85,177,61,116
050,30,075,"Montana","Powder River County",1,0,15,6,9
050,30,075,"Montana","Powder River County",1,1,18,8,10
050,30,075,"Montana","Powder River County",1,2,19,10,9
050,30,075,"Montana","Powder River County",1,3,19,13,6
050,30,075,"Montana","Powder River County",1,4,19,11,8
050,30,075,"Montana","Powder River County",1,5,16,11,5
050,30,075,"Montana","Powder River County",1,6,8,3,5
050,30,075,"Montana","Powder River County",1,7,9,4,5
050,30,075,"Montana","Powder River County",1,8,12,4,8
050,30,075,"Montana","Powder River County",1,9,8,3,5
050,30,075,"Montana","Powder River County",1,10,15,5,10
050,30,075,"Montana","Powder River County",1,11,14,9,5
050,30,075,"Montana","Powder River County",1,12,15,6,9
050,30,075,"Montana","Powder River County",1,13,17,7,10
050,30,075,"Montana","Powder River County",1,14,18,8,10
050,30,075,"Montana","Powder River County",1,15,23,15,8
050,30,075,"Montana","Powder River County",1,16,15,9,6
050,30,075,"Montana","Powder River County",1,17,15,9,6
050,30,075,"Montana","Powder River County",1,18,16,8,8
050,30,075,"Montana","Powder River County",1,19,16,9,7
050,30,075,"Montana","Powder River County",1,20,18,8,10
050,30,075,"Montana","Powder River County",1,21,20,5,15
050,30,075,"Montana","Powder River County",1,22,13,5,8
050,30,075,"Montana","Powder River County",1,23,15,4,11
050,30,075,"Montana","Powder River County",1,24,19,10,9
050,30,075,"Montana","Powder River County",1,25,16,10,6
050,30,075,"Montana","Powder River County",1,26,17,9,8
050,30,075,"Montana","Powder River County",1,27,18,10,8
050,30,075,"Montana","Powder River County",1,28,20,12,8
050,30,075,"Montana","Powder River County",1,29,18,9,9
050,30,075,"Montana","Powder River County",1,30,13,7,6
050,30,075,"Montana","Powder River County",1,31,18,10,8
050,30,075,"Montana","Powder River County",1,32,18,10,8
050,30,075,"Montana","Powder River County",1,33,15,11,4
050,30,075,"Montana","Powder River County",1,34,8,4,4
050,30,075,"Montana","Powder River County",1,35,14,8,6
050,30,075,"Montana","Powder River County",1,36,12,4,8
050,30,075,"Montana","Powder River County",1,37,18,10,8
050,30,075,"Montana","Powder River County",1,38,19,10,9
050,30,075,"Montana","Powder River County",1,39,15,7,8
050,30,075,"Montana","Powder River County",1,40,17,11,6
050,30,075,"Montana","Powder River County",1,41,15,9,6
050,30,075,"Montana","Powder River County",1,42,16,8,8
050,30,075,"Montana","Powder River County",1,43,14,7,7
050,30,075,"Montana","Powder River County",1,44,15,5,10
050,30,075,"Montana","Powder River County",1,45,13,5,8
050,30,075,"Montana","Powder River County",1,46,18,10,8
050,30,075,"Montana","Powder River County",1,47,7,3,4
050,30,075,"Montana","Powder River County",1,48,15,5,10
050,30,075,"Montana","Powder River County",1,49,19,5,14
050,30,075,"Montana","Powder River County",1,50,21,11,10
050,30,075,"Montana","Powder River County",1,51,19,11,8
050,30,075,"Montana","Powder River County",1,52,19,7,12
050,30,075,"Montana","Powder River County",1,53,17,8,9
050,30,075,"Montana","Powder River County",1,54,22,12,10
050,30,075,"Montana","Powder River County",1,55,25,16,9
050,30,075,"Montana","Powder River County",1,56,33,19,14
050,30,075,"Montana","Powder River County",1,57,37,14,23
050,30,075,"Montana","Powder River County",1,58,33,14,19
050,30,075,"Montana","Powder River County",1,59,35,21,14
050,30,075,"Montana","Powder River County",1,60,38,22,16
050,30,075,"Montana","Powder River County",1,61,31,15,16
050,30,075,"Montana","Powder River County",1,62,32,17,15
050,30,075,"Montana","Powder River County",1,63,35,17,18
050,30,075,"Montana","Powder River County",1,64,34,15,19
050,30,075,"Montana","Powder River County",1,65,39,18,21
050,30,075,"Montana","Powder River County",1,66,36,18,18
050,30,075,"Montana","Powder River County",1,67,37,20,17
050,30,075,"Montana","Powder River County",1,68,33,18,15
050,30,075,"Montana","Powder River County",1,69,29,19,10
050,30,075,"Montana","Powder River County",1,70,25,16,9
050,30,075,"Montana","Powder River County",1,71,24,11,13
050,30,075,"Montana","Powder River County",1,72,28,16,12
050,30,075,"Montana","Powder River County",1,73,30,18,12
050,30,075,"Montana","Powder River County",1,74,18,11,7
050,30,075,"Montana","Powder River County",1,75,15,8,7
050,30,075,"Montana","Powder River County",1,76,22,10,12
050,30,075,"Montana","Powder River County",1,77,15,5,10
050,30,075,"Montana","Powder River County",1,78,12,5,7
050,30,075,"Montana","Powder River County",1,79,15,8,7
050,30,075,"Montana","Powder River County",1,80,11,5,6
050,30,075,"Montana","Powder River County",1,81,9,3,6
050,30,075,"Montana","Powder River County",1,82,7,2,5
050,30,075,"Montana","Powder River County",1,83,9,4,5
050,30,075,"Montana","Powder River County",1,84,12,6,6
050,30,075,"Montana","Powder River County",1,85,60,25,35
050,30,075,"Montana","Powder River County",2,0,16,7,9
050,30,075,"Montana","Powder River County",2,1,18,7,11
050,30,075,"Montana","Powder River County",2,2,18,9,9
050,30,075,"Montana","Powder River County",2,3,20,13,7
050,30,075,"Montana","Powder River County",2,4,18,11,7
050,30,075,"Montana","Powder River County",2,5,16,11,5
050,30,075,"Montana","Powder River County",2,6,10,5,5
050,30,075,"Montana","Powder River County",2,7,7,3,4
050,30,075,"Montana","Powder River County",2,8,11,4,7
050,30,075,"Montana","Powder River County",2,9,8,3,5
050,30,075,"Montana","Powder River County",2,10,13,5,8
050,30,075,"Montana","Powder River County",2,11,16,9,7
050,30,075,"Montana","Powder River County",2,12,14,6,8
050,30,075,"Montana","Powder River County",2,13,17,7,10
050,30,075,"Montana","Powder River County",2,14,18,9,9
050,30,075,"Montana","Powder River County",2,15,22,14,8
050,30,075,"Montana","Powder River County",2,16,16,10,6
050,30,075,"Montana","Powder River County",2,17,15,9,6
050,30,075,"Montana","Powder River County",2,18,15,8,7
050,30,075,"Montana","Powder River County",2,19,15,8,7
050,30,075,"Montana","Powder River County",2,20,17,8,9
050,30,075,"Montana","Powder River County",2,21,18,5,13
050,30,075,"Montana","Powder River County",2,22,15,5,10
050,30,075,"Montana","Powder River County",2,23,16,5,11
050,30,075,"Montana","Powder River County",2,24,17,8,9
050,30,075,"Montana","Powder River County",2,25,17,10,7
050,30,075,"Montana","Powder River County",2,26,16,9,7
050,30,075,"Montana","Powder River County",2,27,18,10,8
050,30,075,"Montana","Powder River County",2,28,21,12,9
050,30,075,"Montana","Powder River County",2,29,18,9,9
050,30,075,"Montana","Powder River County",2,30,15,8,7
050,30,075,"Montana","Powder River County",2,31,17,10,7
050,30,075,"Montana","Powder River County",2,32,18,10,8
050,30,075,"Montana","Powder River County",2,33,15,10,5
050,30,075,"Montana","Powder River County",2,34,10,6,4
050,30,075,"Montana","Powder River County",2,35,13,7,6
050,30,075,"Montana","Powder River County",2,36,12,5,7
050,30,075,"Montana","Powder River County",2,37,17,9,8
050,30,075,"Montana","Powder River County",2,38,19,10,9
050,30,075,"Montana","Powder River County",2,39,16,8,8
050,30,075,"Montana","Powder River County",2,40,16,10,6
050,30,075,"Montana","Powder River County",2,41,15,9,6
050,30,075,"Montana","Powder River County",2,42,15,8,7
050,30,075,"Montana","Powder River County",2,43,15,8,7
050,30,075,"Montana","Powder River County",2,44,15,5,10
050,30,075,"Montana","Powder River County",2,45,13,5,8
050,30,075,"Montana","Powder River County",2,46,17,9,8
050,30,075,"Montana","Powder River County",2,47,10,5,5
050,30,075,"Montana","Powder River County",2,48,13,5,8
050,30,075,"Montana","Powder River County",2,49,18,5,13
050,30,075,"Montana","Powder River County",2,50,21,10,11
050,30,075,"Montana","Powder River County",2,51,19,11,8
050,30,075,"Montana","Powder River County",2,52,19,8,11
050,30,075,"Montana","Powder River County",2,53,17,8,9
050,30,075,"Montana","Powder River County",2,54,21,11,10
050,30,075,"Montana","Powder River County",2,55,25,16,9
050,30,075,"Montana","Powder River County",2,56,30,18,12
050,30,075,"Montana","Powder River County",2,57,37,16,21
050,30,075,"Montana","Powder River County",2,58,34,14,20
050,30,075,"Montana","Powder River County",2,59,36,21,15
050,30,075,"Montana","Powder River County",2,60,37,21,16
050,30,075,"Montana","Powder River County",2,61,32,16,16
050,30,075,"Montana","Powder River County",2,62,32,17,15
050,30,075,"Montana","Powder River County",2,63,35,18,17
050,30,075,"Montana","Powder River County",2,64,34,15,19
050,30,075,"Montana","Powder River County",2,65,38,17,21
050,30,075,"Montana","Powder River County",2,66,37,18,19
050,30,075,"Montana","Powder River County",2,67,36,19,17
050,30,075,"Montana","Powder River County",2,68,33,18,15
050,30,075,"Montana","Powder River County",2,69,31,19,12
050,30,075,"Montana","Powder River County",2,70,26,17,9
050,30,075,"Montana","Powder River County",2,71,24,12,12
050,30,075,"Montana","Powder River County",2,72,27,15,12
050,30,075,"Montana","Powder River County",2,73,31,19,12
050,30,075,"Montana","Powder River County",2,74,20,12,8
050,30,075,"Montana","Powder River County",2,75,16,9,7
050,30,075,"Montana","Powder River County",2,76,21,10,11
050,30,075,"Montana","Powder River County",2,77,16,5,11
050,30,075,"Montana","Powder River County",2,78,13,5,8
050,30,075,"Montana","Powder River County",2,79,14,7,7
050,30,075,"Montana","Powder River County",2,80,11,5,6
050,30,075,"Montana","Powder River County",2,81,9,3,6
050,30,075,"Montana","Powder River County",2,82,7,2,5
050,30,075,"Montana","Powder River County",2,83,8,3,5
050,30,075,"Montana","Powder River County",2,84,11,5,6
050,30,075,"Montana","Powder River County",2,85,63,27,36
050,30,075,"Montana","Powder River County",3,0,13,5,8
050,30,075,"Montana","Powder River County",3,1,23,14,9
050,30,075,"Montana","Powder River County",3,2,16,8,8
050,30,075,"Montana","Powder River County",3,3,19,10,9
050,30,075,"Montana","Powder River County",3,4,19,9,10
050,30,075,"Montana","Powder River County",3,5,21,12,9
050,30,075,"Montana","Powder River County",3,6,19,13,6
050,30,075,"Montana","Powder River County",3,7,12,5,7
050,30,075,"Montana","Powder River County",3,8,8,5,3
050,30,075,"Montana","Powder River County",3,9,12,5,7
050,30,075,"Montana","Powder River County",3,10,8,3,5
050,30,075,"Montana","Powder River County",3,11,14,6,8
050,30,075,"Montana","Powder River County",3,12,16,9,7
050,30,075,"Montana","Powder River County",3,13,14,6,8
050,30,075,"Montana","Powder River County",3,14,16,7,9
050,30,075,"Montana","Powder River County",3,15,19,10,9
050,30,075,"Montana","Powder River County",3,16,22,14,8
050,30,075,"Montana","Powder River County",3,17,15,9,6
050,30,075,"Montana","Powder River County",3,18,9,6,3
050,30,075,"Montana","Powder River County",3,19,10,7,3
050,30,075,"Montana","Powder River County",3,20,13,7,6
050,30,075,"Montana","Powder River County",3,21,17,8,9
050,30,075,"Montana","Powder River County",3,22,15,5,10
050,30,075,"Montana","Powder River County",3,23,13,5,8
050,30,075,"Montana","Powder River County",3,24,15,5,10
050,30,075,"Montana","Powder River County",3,25,15,6,9
050,30,075,"Montana","Powder River County",3,26,20,12,8
050,30,075,"Montana","Powder River County",3,27,15,9,6
050,30,075,"Montana","Powder River County",3,28,21,12,9
050,30,075,"Montana","Powder River County",3,29,22,15,7
050,30,075,"Montana","Powder River County",3,30,17,7,10
050,30,075,"Montana","Powder River County",3,31,15,7,8
050,30,075,"Montana","Powder River County",3,32,18,9,9
050,30,075,"Montana","Powder River County",3,33,18,11,7
050,30,075,"Montana","Powder River County",3,34,20,13,7
050,30,075,"Montana","Powder River County",3,35,11,7,4
050,30,075,"Montana","Powder River County",3,36,15,8,7
050,30,075,"Montana","Powder River County",3,37,12,5,7
050,30,075,"Montana","Powder River County",3,38,17,9,8
050,30,075,"Montana","Powder River County",3,39,19,10,9
050,30,075,"Montana","Powder River County",3,40,17,9,8
050,30,075,"Montana","Powder River County",3,41,17,11,6
050,30,075,"Montana","Powder River County",3,42,15,9,6
050,30,075,"Montana","Powder River County",3,43,15,8,7
050,30,075,"Montana","Powder River County",3,44,15,8,7
050,30,075,"Montana","Powder River County",3,45,15,5,10
050,30,075,"Montana","Powder River County",3,46,13,5,8
050,30,075,"Montana","Powder River County",3,47,16,9,7
050,30,075,"Montana","Powder River County",3,48,11,6,5
050,30,075,"Montana","Powder River County",3,49,13,5,8
050,30,075,"Montana","Powder River County",3,50,22,8,14
050,30,075,"Montana","Powder River County",3,51,19,8,11
050,30,075,"Montana","Powder River County",3,52,20,11,9
050,30,075,"Montana","Powder River County",3,53,19,7,12
050,30,075,"Montana","Powder River County",3,54,17,8,9
050,30,075,"Montana","Powder River County",3,55,25,13,12
050,30,075,"Montana","Powder River County",3,56,24,16,8
050,30,075,"Montana","Powder River County",3,57,29,18,11
050,30,075,"Montana","Powder River County",3,58,37,16,21
050,30,075,"Montana","Powder River County",3,59,31,14,17
050,30,075,"Montana","Powder River County",3,60,40,23,17
050,30,075,"Montana","Powder River County",3,61,35,19,16
050,30,075,"Montana","Powder River County",3,62,34,16,18
050,30,075,"Montana","Powder River County",3,63,32,18,14
050,30,075,"Montana","Powder River County",3,64,35,19,16
050,30,075,"Montana","Powder River County",3,65,35,15,20
050,30,075,"Montana","Powder River County",3,66,37,17,20
050,30,075,"Montana","Powder River County",3,67,37,18,19
050,30,075,"Montana","Powder River County",3,68,38,20,18
050,30,075,"Montana","Powder River County",3,69,35,19,16
050,30,075,"Montana","Powder River County",3,70,30,19,11
050,30,075,"Montana","Powder River County",3,71,27,17,10
050,30,075,"Montana","Powder River County",3,72,24,12,12
050,30,075,"Montana","Powder River County",3,73,26,14,12
050,30,075,"Montana","Powder River County",3,74,28,18,10
050,30,075,"Montana","Powder River County",3,75,20,12,8
050,30,075,"Montana","Powder River County",3,76,15,8,7
050,30,075,"Montana","Powder River County",3,77,21,9,12
050,30,075,"Montana","Powder River County",3,78,16,5,11
050,30,075,"Montana","Powder River County",3,79,11,5,6
050,30,075,"Montana","Powder River County",3,80,14,7,7
050,30,075,"Montana","Powder River County",3,81,12,5,7
050,30,075,"Montana","Powder River County",3,82,8,3,5
050,30,075,"Montana","Powder River County",3,83,7,3,4
050,30,075,"Montana","Powder River County",3,84,8,2,6
050,30,075,"Montana","Powder River County",3,85,62,28,34
050,30,075,"Montana","Powder River County",4,0,19,8,11
050,30,075,"Montana","Powder River County",4,1,13,5,8
050,30,075,"Montana","Powder River County",4,2,21,14,7
050,30,075,"Montana","Powder River County",4,3,21,9,12
050,30,075,"Montana","Powder River County",4,4,22,11,11
050,30,075,"Montana","Powder River County",4,5,21,8,13
050,30,075,"Montana","Powder River County",4,6,21,12,9
050,30,075,"Montana","Powder River County",4,7,19,13,6
050,30,075,"Montana","Powder River County",4,8,12,5,7
050,30,075,"Montana","Powder River County",4,9,10,5,5
050,30,075,"Montana","Powder River County",4,10,13,6,7
050,30,075,"Montana","Powder River County",4,11,8,3,5
050,30,075,"Montana","Powder River County",4,12,15,7,8
050,30,075,"Montana","Powder River County",4,13,17,9,8
050,30,075,"Montana","Powder River County",4,14,14,4,10
050,30,075,"Montana","Powder River County",4,15,16,7,9
050,30,075,"Montana","Powder River County",4,16,15,6,9
050,30,075,"Montana","Powder River County",4,17,24,16,8
050,30,075,"Montana","Powder River County",4,18,13,8,5
050,30,075,"Montana","Powder River County",4,19,8,5,3
050,30,075,"Montana","Powder River County",4,20,6,4,2
050,30,075,"Montana","Powder River County",4,21,13,7,6
050,30,075,"Montana","Powder River County",4,22,10,5,5
050,30,075,"Montana","Powder River County",4,23,21,8,13
050,30,075,"Montana","Powder River County",4,24,11,5,6
050,30,075,"Montana","Powder River County",4,25,14,4,10
050,30,075,"Montana","Powder River County",4,26,17,8,9
050,30,075,"Montana","Powder River County",4,27,21,13,8
050,30,075,"Montana","Powder River County",4,28,18,8,10
050,30,075,"Montana","Powder River County",4,29,21,12,9
050,30,075,"Montana","Powder River County",4,30,22,15,7
050,30,075,"Montana","Powder River County",4,31,19,8,11
050,30,075,"Montana","Powder River County",4,32,16,8,8
050,30,075,"Montana","Powder River County",4,33,19,10,9
050,30,075,"Montana","Powder River County",4,34,21,11,10
050,30,075,"Montana","Powder River County",4,35,19,13,6
050,30,075,"Montana","Powder River County",4,36,11,7,4
050,30,075,"Montana","Powder River County",4,37,16,9,7
050,30,075,"Montana","Powder River County",4,38,13,5,8
050,30,075,"Montana","Powder River County",4,39,17,9,8
050,30,075,"Montana","Powder River County",4,40,21,10,11
050,30,075,"Montana","Powder River County",4,41,17,9,8
050,30,075,"Montana","Powder River County",4,42,16,10,6
050,30,075,"Montana","Powder River County",4,43,20,13,7
050,30,075,"Montana","Powder River County",4,44,16,10,6
050,30,075,"Montana","Powder River County",4,45,10,5,5
050,30,075,"Montana","Powder River County",4,46,17,7,10
050,30,075,"Montana","Powder River County",4,47,13,5,8
050,30,075,"Montana","Powder River County",4,48,18,9,9
050,30,075,"Montana","Powder River County",4,49,10,5,5
050,30,075,"Montana","Powder River County",4,50,13,5,8
050,30,075,"Montana","Powder River County",4,51,22,6,16
050,30,075,"Montana","Powder River County",4,52,19,8,11
050,30,075,"Montana","Powder River County",4,53,19,10,9
050,30,075,"Montana","Powder River County",4,54,20,10,10
050,30,075,"Montana","Powder River County",4,55,16,8,8
050,30,075,"Montana","Powder River County",4,56,25,13,12
050,30,075,"Montana","Powder River County",4,57,26,16,10
050,30,075,"Montana","Powder River County",4,58,29,18,11
050,30,075,"Montana","Powder River County",4,59,33,12,21
050,30,075,"Montana","Powder River County",4,60,30,13,17
050,30,075,"Montana","Powder River County",4,61,42,25,17
050,30,075,"Montana","Powder River County",4,62,35,19,16
050,30,075,"Montana","Powder River County",4,63,35,17,18
050,30,075,"Montana","Powder River County",4,64,30,17,13
050,30,075,"Montana","Powder River County",4,65,35,19,16
050,30,075,"Montana","Powder River County",4,66,34,14,20
050,30,075,"Montana","Powder River County",4,67,37,17,20
050,30,075,"Montana","Powder River County",4,68,35,19,16
050,30,075,"Montana","Powder River County",4,69,40,20,20
050,30,075,"Montana","Powder River County",4,70,34,19,15
050,30,075,"Montana","Powder River County",4,71,31,20,11
050,30,075,"Montana","Powder River County",4,72,28,18,10
050,30,075,"Montana","Powder River County",4,73,24,12,12
050,30,075,"Montana","Powder River County",4,74,26,14,12
050,30,075,"Montana","Powder River County",4,75,28,19,9
050,30,075,"Montana","Powder River County",4,76,18,10,8
050,30,075,"Montana","Powder River County",4,77,16,8,8
050,30,075,"Montana","Powder River County",4,78,22,11,11
050,30,075,"Montana","Powder River County",4,79,14,5,9
050,30,075,"Montana","Powder River County",4,80,11,4,7
050,30,075,"Montana","Powder River County",4,81,15,7,8
050,30,075,"Montana","Powder River County",4,82,11,5,6
050,30,075,"Montana","Powder River County",4,83,7,3,4
050,30,075,"Montana","Powder River County",4,84,7,2,5
050,30,075,"Montana","Powder River County",4,85,60,25,35
050,30,075,"Montana","Powder River County",5,0,17,8,9
050,30,075,"Montana","Powder River County",5,1,22,11,11
050,30,075,"Montana","Powder River County",5,2,15,5,10
050,30,075,"Montana","Powder River County",5,3,18,9,9
050,30,075,"Montana","Powder River County",5,4,21,10,11
050,30,075,"Montana","Powder River County",5,5,24,11,13
050,30,075,"Montana","Powder River County",5,6,20,8,12
050,30,075,"Montana","Powder River County",5,7,21,12,9
050,30,075,"Montana","Powder River County",5,8,15,13,2
050,30,075,"Montana","Powder River County",5,9,12,5,7
050,30,075,"Montana","Powder River County",5,10,14,8,6
050,30,075,"Montana","Powder River County",5,11,13,5,8
050,30,075,"Montana","Powder River County",5,12,7,3,4
050,30,075,"Montana","Powder River County",5,13,21,7,14
050,30,075,"Montana","Powder River County",5,14,20,11,9
050,30,075,"Montana","Powder River County",5,15,13,6,7
050,30,075,"Montana","Powder River County",5,16,18,7,11
050,30,075,"Montana","Powder River County",5,17,15,6,9
050,30,075,"Montana","Powder River County",5,18,23,16,7
050,30,075,"Montana","Powder River County",5,19,10,6,4
050,30,075,"Montana","Powder River County",5,20,8,5,3
050,30,075,"Montana","Powder River County",5,21,7,4,3
050,30,075,"Montana","Powder River County",5,22,14,8,6
050,30,075,"Montana","Powder River County",5,23,13,8,5
050,30,075,"Montana","Powder River County",5,24,18,5,13
050,30,075,"Montana","Powder River County",5,25,11,6,5
050,30,075,"Montana","Powder River County",5,26,12,6,6
050,30,075,"Montana","Powder River County",5,27,20,11,9
050,30,075,"Montana","Powder River County",5,28,19,12,7
050,30,075,"Montana","Powder River County",5,29,21,7,14
050,30,075,"Montana","Powder River County",5,30,17,8,9
050,30,075,"Montana","Powder River County",5,31,20,15,5
050,30,075,"Montana","Powder River County",5,32,18,8,10
050,30,075,"Montana","Powder River County",5,33,17,8,9
050,30,075,"Montana","Powder River County",5,34,19,10,9
050,30,075,"Montana","Powder River County",5,35,22,12,10
050,30,075,"Montana","Powder River County",5,36,20,13,7
050,30,075,"Montana","Powder River County",5,37,12,7,5
050,30,075,"Montana","Powder River County",5,38,18,10,8
050,30,075,"Montana","Powder River County",5,39,13,5,8
050,30,075,"Montana","Powder River County",5,40,18,10,8
050,30,075,"Montana","Powder River County",5,41,23,13,10
050,30,075,"Montana","Powder River County",5,42,17,9,8
050,30,075,"Montana","Powder River County",5,43,18,12,6
050,30,075,"Montana","Powder River County",5,44,21,11,10
050,30,075,"Montana","Powder River County",5,45,15,10,5
050,30,075,"Montana","Powder River County",5,46,10,5,5
050,30,075,"Montana","Powder River County",5,47,18,7,11
050,30,075,"Montana","Powder River County",5,48,13,5,8
050,30,075,"Montana","Powder River County",5,49,17,8,9
050,30,075,"Montana","Powder River County",5,50,8,3,5
050,30,075,"Montana","Powder River County",5,51,14,7,7
050,30,075,"Montana","Powder River County",5,52,22,6,16
050,30,075,"Montana","Powder River County",5,53,18,7,11
050,30,075,"Montana","Powder River County",5,54,20,10,10
050,30,075,"Montana","Powder River County",5,55,17,8,9
050,30,075,"Montana","Powder River County",5,56,16,8,8
050,30,075,"Montana","Powder River County",5,57,26,14,12
050,30,075,"Montana","Powder River County",5,58,30,19,11
050,30,075,"Montana","Powder River County",5,59,29,18,11
050,30,075,"Montana","Powder River County",5,60,32,12,20
050,30,075,"Montana","Powder River County",5,61,30,13,17
050,30,075,"Montana","Powder River County",5,62,42,25,17
050,30,075,"Montana","Powder River County",5,63,38,22,16
050,30,075,"Montana","Powder River County",5,64,36,16,20
050,30,075,"Montana","Powder River County",5,65,32,18,14
050,30,075,"Montana","Powder River County",5,66,33,18,15
050,30,075,"Montana","Powder River County",5,67,36,14,22
050,30,075,"Montana","Powder River County",5,68,35,17,18
050,30,075,"Montana","Powder River County",5,69,33,19,14
050,30,075,"Montana","Powder River County",5,70,41,22,19
050,30,075,"Montana","Powder River County",5,71,32,17,15
050,30,075,"Montana","Powder River County",5,72,31,20,11
050,30,075,"Montana","Powder River County",5,73,26,17,9
050,30,075,"Montana","Powder River County",5,74,24,12,12
050,30,075,"Montana","Powder River County",5,75,26,15,11
050,30,075,"Montana","Powder River County",5,76,26,17,9
050,30,075,"Montana","Powder River County",5,77,17,8,9
050,30,075,"Montana","Powder River County",5,78,15,9,6
050,30,075,"Montana","Powder River County",5,79,20,10,10
050,30,075,"Montana","Powder River County",5,80,13,4,9
050,30,075,"Montana","Powder River County",5,81,11,4,7
050,30,075,"Montana","Powder River County",5,82,14,7,7
050,30,075,"Montana","Powder River County",5,83,9,4,5
050,30,075,"Montana","Powder River County",5,84,7,2,5
050,30,075,"Montana","Powder River County",5,85,56,23,33
050,30,077,"Montana","Powell County",1,0,55,28,27
050,30,077,"Montana","Powell County",1,1,59,32,27
050,30,077,"Montana","Powell County",1,2,62,36,26
050,30,077,"Montana","Powell County",1,3,49,28,21
050,30,077,"Montana","Powell County",1,4,65,37,28
050,30,077,"Montana","Powell County",1,5,55,29,26
050,30,077,"Montana","Powell County",1,6,43,16,27
050,30,077,"Montana","Powell County",1,7,47,19,28
050,30,077,"Montana","Powell County",1,8,60,31,29
050,30,077,"Montana","Powell County",1,9,63,34,29
050,30,077,"Montana","Powell County",1,10,67,37,30
050,30,077,"Montana","Powell County",1,11,57,30,27
050,30,077,"Montana","Powell County",1,12,58,28,30
050,30,077,"Montana","Powell County",1,13,69,43,26
050,30,077,"Montana","Powell County",1,14,59,30,29
050,30,077,"Montana","Powell County",1,15,50,22,28
050,30,077,"Montana","Powell County",1,16,58,24,34
050,30,077,"Montana","Powell County",1,17,57,32,25
050,30,077,"Montana","Powell County",1,18,60,30,30
050,30,077,"Montana","Powell County",1,19,60,39,21
050,30,077,"Montana","Powell County",1,20,74,57,17
050,30,077,"Montana","Powell County",1,21,80,56,24
050,30,077,"Montana","Powell County",1,22,89,65,24
050,30,077,"Montana","Powell County",1,23,100,84,16
050,30,077,"Montana","Powell County",1,24,102,74,28
050,30,077,"Montana","Powell County",1,25,107,77,30
050,30,077,"Montana","Powell County",1,26,84,57,27
050,30,077,"Montana","Powell County",1,27,95,73,22
050,30,077,"Montana","Powell County",1,28,101,77,24
050,30,077,"Montana","Powell County",1,29,97,73,24
050,30,077,"Montana","Powell County",1,30,76,57,19
050,30,077,"Montana","Powell County",1,31,78,63,15
050,30,077,"Montana","Powell County",1,32,88,70,18
050,30,077,"Montana","Powell County",1,33,91,67,24
050,30,077,"Montana","Powell County",1,34,82,61,21
050,30,077,"Montana","Powell County",1,35,91,66,25
050,30,077,"Montana","Powell County",1,36,87,63,24
050,30,077,"Montana","Powell County",1,37,108,82,26
050,30,077,"Montana","Powell County",1,38,102,72,30
050,30,077,"Montana","Powell County",1,39,102,71,31
050,30,077,"Montana","Powell County",1,40,108,75,33
050,30,077,"Montana","Powell County",1,41,94,63,31
050,30,077,"Montana","Powell County",1,42,91,69,22
050,30,077,"Montana","Powell County",1,43,88,64,24
050,30,077,"Montana","Powell County",1,44,93,62,31
050,30,077,"Montana","Powell County",1,45,86,68,18
050,30,077,"Montana","Powell County",1,46,96,72,24
050,30,077,"Montana","Powell County",1,47,108,82,26
050,30,077,"Montana","Powell County",1,48,96,69,27
050,30,077,"Montana","Powell County",1,49,95,68,27
050,30,077,"Montana","Powell County",1,50,96,72,24
050,30,077,"Montana","Powell County",1,51,96,69,27
050,30,077,"Montana","Powell County",1,52,100,64,36
050,30,077,"Montana","Powell County",1,53,94,57,37
050,30,077,"Montana","Powell County",1,54,109,77,32
050,30,077,"Montana","Powell County",1,55,117,82,35
050,30,077,"Montana","Powell County",1,56,115,73,42
050,30,077,"Montana","Powell County",1,57,120,69,51
050,30,077,"Montana","Powell County",1,58,110,67,43
050,30,077,"Montana","Powell County",1,59,103,61,42
050,30,077,"Montana","Powell County",1,60,125,79,46
050,30,077,"Montana","Powell County",1,61,110,64,46
050,30,077,"Montana","Powell County",1,62,99,58,41
050,30,077,"Montana","Powell County",1,63,110,59,51
050,30,077,"Montana","Powell County",1,64,88,47,41
050,30,077,"Montana","Powell County",1,65,93,54,39
050,30,077,"Montana","Powell County",1,66,103,56,47
050,30,077,"Montana","Powell County",1,67,98,55,43
050,30,077,"Montana","Powell County",1,68,84,48,36
050,30,077,"Montana","Powell County",1,69,97,57,40
050,30,077,"Montana","Powell County",1,70,96,55,41
050,30,077,"Montana","Powell County",1,71,81,47,34
050,30,077,"Montana","Powell County",1,72,64,34,30
050,30,077,"Montana","Powell County",1,73,86,46,40
050,30,077,"Montana","Powell County",1,74,59,27,32
050,30,077,"Montana","Powell County",1,75,59,31,28
050,30,077,"Montana","Powell County",1,76,48,27,21
050,30,077,"Montana","Powell County",1,77,56,35,21
050,30,077,"Montana","Powell County",1,78,53,31,22
050,30,077,"Montana","Powell County",1,79,46,23,23
050,30,077,"Montana","Powell County",1,80,26,13,13
050,30,077,"Montana","Powell County",1,81,36,15,21
050,30,077,"Montana","Powell County",1,82,41,15,26
050,30,077,"Montana","Powell County",1,83,30,17,13
050,30,077,"Montana","Powell County",1,84,23,12,11
050,30,077,"Montana","Powell County",1,85,132,59,73
050,30,077,"Montana","Powell County",2,0,55,30,25
050,30,077,"Montana","Powell County",2,1,57,30,27
050,30,077,"Montana","Powell County",2,2,60,35,25
050,30,077,"Montana","Powell County",2,3,52,30,22
050,30,077,"Montana","Powell County",2,4,62,35,27
050,30,077,"Montana","Powell County",2,5,58,31,27
050,30,077,"Montana","Powell County",2,6,45,18,27
050,30,077,"Montana","Powell County",2,7,46,19,27
050,30,077,"Montana","Powell County",2,8,58,29,29
050,30,077,"Montana","Powell County",2,9,63,32,31
050,30,077,"Montana","Powell County",2,10,66,36,30
050,30,077,"Montana","Powell County",2,11,61,32,29
050,30,077,"Montana","Powell County",2,12,60,30,30
050,30,077,"Montana","Powell County",2,13,66,39,27
050,30,077,"Montana","Powell County",2,14,61,33,28
050,30,077,"Montana","Powell County",2,15,51,23,28
050,30,077,"Montana","Powell County",2,16,56,24,32
050,30,077,"Montana","Powell County",2,17,57,31,26
050,30,077,"Montana","Powell County",2,18,59,32,27
050,30,077,"Montana","Powell County",2,19,60,38,22
050,30,077,"Montana","Powell County",2,20,77,58,19
050,30,077,"Montana","Powell County",2,21,81,57,24
050,30,077,"Montana","Powell County",2,22,88,63,25
050,30,077,"Montana","Powell County",2,23,103,84,19
050,30,077,"Montana","Powell County",2,24,102,76,26
050,30,077,"Montana","Powell County",2,25,105,76,29
050,30,077,"Montana","Powell County",2,26,85,58,27
050,30,077,"Montana","Powell County",2,27,93,69,24
050,30,077,"Montana","Powell County",2,28,102,79,23
050,30,077,"Montana","Powell County",2,29,99,75,24
050,30,077,"Montana","Powell County",2,30,75,55,20
050,30,077,"Montana","Powell County",2,31,80,64,16
050,30,077,"Montana","Powell County",2,32,87,69,18
050,30,077,"Montana","Powell County",2,33,91,68,23
050,30,077,"Montana","Powell County",2,34,83,61,22
050,30,077,"Montana","Powell County",2,35,90,66,24
050,30,077,"Montana","Powell County",2,36,86,63,23
050,30,077,"Montana","Powell County",2,37,108,83,25
050,30,077,"Montana","Powell County",2,38,102,74,28
050,30,077,"Montana","Powell County",2,39,99,68,31
050,30,077,"Montana","Powell County",2,40,107,74,33
050,30,077,"Montana","Powell County",2,41,97,65,32
050,30,077,"Montana","Powell County",2,42,93,69,24
050,30,077,"Montana","Powell County",2,43,90,66,24
050,30,077,"Montana","Powell County",2,44,88,60,28
050,30,077,"Montana","Powell County",2,45,88,68,20
050,30,077,"Montana","Powell County",2,46,94,71,23
050,30,077,"Montana","Powell County",2,47,107,81,26
050,30,077,"Montana","Powell County",2,48,95,69,26
050,30,077,"Montana","Powell County",2,49,98,71,27
050,30,077,"Montana","Powell County",2,50,95,70,25
050,30,077,"Montana","Powell County",2,51,95,69,26
050,30,077,"Montana","Powell County",2,52,99,64,35
050,30,077,"Montana","Powell County",2,53,93,56,37
050,30,077,"Montana","Powell County",2,54,104,72,32
050,30,077,"Montana","Powell County",2,55,116,81,35
050,30,077,"Montana","Powell County",2,56,114,74,40
050,30,077,"Montana","Powell County",2,57,117,69,48
050,30,077,"Montana","Powell County",2,58,114,69,45
050,30,077,"Montana","Powell County",2,59,103,61,42
050,30,077,"Montana","Powell County",2,60,122,77,45
050,30,077,"Montana","Powell County",2,61,107,62,45
050,30,077,"Montana","Powell County",2,62,101,59,42
050,30,077,"Montana","Powell County",2,63,109,59,50
050,30,077,"Montana","Powell County",2,64,91,48,43
050,30,077,"Montana","Powell County",2,65,91,53,38
050,30,077,"Montana","Powell County",2,66,100,55,45
050,30,077,"Montana","Powell County",2,67,98,56,42
050,30,077,"Montana","Powell County",2,68,84,47,37
050,30,077,"Montana","Powell County",2,69,96,57,39
050,30,077,"Montana","Powell County",2,70,97,56,41
050,30,077,"Montana","Powell County",2,71,82,46,36
050,30,077,"Montana","Powell County",2,72,67,37,30
050,30,077,"Montana","Powell County",2,73,85,45,40
050,30,077,"Montana","Powell County",2,74,61,29,32
050,30,077,"Montana","Powell County",2,75,60,30,30
050,30,077,"Montana","Powell County",2,76,50,28,22
050,30,077,"Montana","Powell County",2,77,56,35,21
050,30,077,"Montana","Powell County",2,78,51,30,21
050,30,077,"Montana","Powell County",2,79,47,25,22
050,30,077,"Montana","Powell County",2,80,28,14,14
050,30,077,"Montana","Powell County",2,81,33,13,20
050,30,077,"Montana","Powell County",2,82,38,14,24
050,30,077,"Montana","Powell County",2,83,32,16,16
050,30,077,"Montana","Powell County",2,84,24,13,11
050,30,077,"Montana","Powell County",2,85,136,61,75
050,30,077,"Montana","Powell County",3,0,42,19,23
050,30,077,"Montana","Powell County",3,1,56,32,24
050,30,077,"Montana","Powell County",3,2,51,25,26
050,30,077,"Montana","Powell County",3,3,59,37,22
050,30,077,"Montana","Powell County",3,4,53,31,22
050,30,077,"Montana","Powell County",3,5,59,33,26
050,30,077,"Montana","Powell County",3,6,62,36,26
050,30,077,"Montana","Powell County",3,7,45,19,26
050,30,077,"Montana","Powell County",3,8,48,19,29
050,30,077,"Montana","Powell County",3,9,62,30,32
050,30,077,"Montana","Powell County",3,10,69,34,35
050,30,077,"Montana","Powell County",3,11,63,32,31
050,30,077,"Montana","Powell County",3,12,61,32,29
050,30,077,"Montana","Powell County",3,13,59,29,30
050,30,077,"Montana","Powell County",3,14,64,40,24
050,30,077,"Montana","Powell County",3,15,56,32,24
050,30,077,"Montana","Powell County",3,16,52,24,28
050,30,077,"Montana","Powell County",3,17,56,26,30
050,30,077,"Montana","Powell County",3,18,51,30,21
050,30,077,"Montana","Powell County",3,19,55,38,17
050,30,077,"Montana","Powell County",3,20,77,54,23
050,30,077,"Montana","Powell County",3,21,84,61,23
050,30,077,"Montana","Powell County",3,22,75,52,23
050,30,077,"Montana","Powell County",3,23,106,82,24
050,30,077,"Montana","Powell County",3,24,105,78,27
050,30,077,"Montana","Powell County",3,25,113,85,28
050,30,077,"Montana","Powell County",3,26,88,62,26
050,30,077,"Montana","Powell County",3,27,85,59,26
050,30,077,"Montana","Powell County",3,28,108,87,21
050,30,077,"Montana","Powell County",3,29,106,82,24
050,30,077,"Montana","Powell County",3,30,80,57,23
050,30,077,"Montana","Powell County",3,31,101,77,24
050,30,077,"Montana","Powell County",3,32,86,70,16
050,30,077,"Montana","Powell County",3,33,92,72,20
050,30,077,"Montana","Powell County",3,34,88,63,25
050,30,077,"Montana","Powell County",3,35,89,66,23
050,30,077,"Montana","Powell County",3,36,89,62,27
050,30,077,"Montana","Powell County",3,37,110,84,26
050,30,077,"Montana","Powell County",3,38,111,86,25
050,30,077,"Montana","Powell County",3,39,95,68,27
050,30,077,"Montana","Powell County",3,40,109,76,33
050,30,077,"Montana","Powell County",3,41,114,77,37
050,30,077,"Montana","Powell County",3,42,102,71,31
050,30,077,"Montana","Powell County",3,43,94,72,22
050,30,077,"Montana","Powell County",3,44,86,59,27
050,30,077,"Montana","Powell County",3,45,100,71,29
050,30,077,"Montana","Powell County",3,46,93,75,18
050,30,077,"Montana","Powell County",3,47,109,83,26
050,30,077,"Montana","Powell County",3,48,92,67,25
050,30,077,"Montana","Powell County",3,49,109,80,29
050,30,077,"Montana","Powell County",3,50,106,72,34
050,30,077,"Montana","Powell County",3,51,88,65,23
050,30,077,"Montana","Powell County",3,52,88,60,28
050,30,077,"Montana","Powell County",3,53,97,58,39
050,30,077,"Montana","Powell County",3,54,92,56,36
050,30,077,"Montana","Powell County",3,55,103,71,32
050,30,077,"Montana","Powell County",3,56,113,76,37
050,30,077,"Montana","Powell County",3,57,106,65,41
050,30,077,"Montana","Powell County",3,58,111,68,43
050,30,077,"Montana","Powell County",3,59,118,70,48
050,30,077,"Montana","Powell County",3,60,112,71,41
050,30,077,"Montana","Powell County",3,61,115,67,48
050,30,077,"Montana","Powell County",3,62,110,64,46
050,30,077,"Montana","Powell County",3,63,98,59,39
050,30,077,"Montana","Powell County",3,64,104,51,53
050,30,077,"Montana","Powell County",3,65,92,49,43
050,30,077,"Montana","Powell County",3,66,97,57,40
050,30,077,"Montana","Powell County",3,67,100,53,47
050,30,077,"Montana","Powell County",3,68,88,48,40
050,30,077,"Montana","Powell County",3,69,93,56,37
050,30,077,"Montana","Powell County",3,70,94,56,38
050,30,077,"Montana","Powell County",3,71,87,49,38
050,30,077,"Montana","Powell County",3,72,81,46,35
050,30,077,"Montana","Powell County",3,73,59,31,28
050,30,077,"Montana","Powell County",3,74,86,44,42
050,30,077,"Montana","Powell County",3,75,59,29,30
050,30,077,"Montana","Powell County",3,76,60,32,28
050,30,077,"Montana","Powell County",3,77,50,27,23
050,30,077,"Montana","Powell County",3,78,53,32,21
050,30,077,"Montana","Powell County",3,79,48,27,21
050,30,077,"Montana","Powell County",3,80,41,23,18
050,30,077,"Montana","Powell County",3,81,26,12,14
050,30,077,"Montana","Powell County",3,82,29,13,16
050,30,077,"Montana","Powell County",3,83,34,14,20
050,30,077,"Montana","Powell County",3,84,28,14,14
050,30,077,"Montana","Powell County",3,85,140,65,75
050,30,077,"Montana","Powell County",4,0,41,22,19
050,30,077,"Montana","Powell County",4,1,45,24,21
050,30,077,"Montana","Powell County",4,2,57,33,24
050,30,077,"Montana","Powell County",4,3,54,27,27
050,30,077,"Montana","Powell County",4,4,64,40,24
050,30,077,"Montana","Powell County",4,5,51,30,21
050,30,077,"Montana","Powell County",4,6,67,36,31
050,30,077,"Montana","Powell County",4,7,65,36,29
050,30,077,"Montana","Powell County",4,8,50,21,29
050,30,077,"Montana","Powell County",4,9,49,20,29
050,30,077,"Montana","Powell County",4,10,60,28,32
050,30,077,"Montana","Powell County",4,11,69,35,34
050,30,077,"Montana","Powell County",4,12,61,30,31
050,30,077,"Montana","Powell County",4,13,60,34,26
050,30,077,"Montana","Powell County",4,14,64,32,32
050,30,077,"Montana","Powell County",4,15,68,40,28
050,30,077,"Montana","Powell County",4,16,57,33,24
050,30,077,"Montana","Powell County",4,17,58,26,32
050,30,077,"Montana","Powell County",4,18,49,24,25
050,30,077,"Montana","Powell County",4,19,50,35,15
050,30,077,"Montana","Powell County",4,20,75,57,18
050,30,077,"Montana","Powell County",4,21,80,51,29
050,30,077,"Montana","Powell County",4,22,79,56,23
050,30,077,"Montana","Powell County",4,23,109,85,24
050,30,077,"Montana","Powell County",4,24,111,82,29
050,30,077,"Montana","Powell County",4,25,107,84,23
050,30,077,"Montana","Powell County",4,26,95,66,29
050,30,077,"Montana","Powell County",4,27,91,67,24
050,30,077,"Montana","Powell County",4,28,92,69,23
050,30,077,"Montana","Powell County",4,29,112,92,20
050,30,077,"Montana","Powell County",4,30,72,49,23
050,30,077,"Montana","Powell County",4,31,95,68,27
050,30,077,"Montana","Powell County",4,32,98,74,24
050,30,077,"Montana","Powell County",4,33,99,77,22
050,30,077,"Montana","Powell County",4,34,83,60,23
050,30,077,"Montana","Powell County",4,35,94,68,26
050,30,077,"Montana","Powell County",4,36,83,58,25
050,30,077,"Montana","Powell County",4,37,107,76,31
050,30,077,"Montana","Powell County",4,38,107,74,33
050,30,077,"Montana","Powell County",4,39,94,71,23
050,30,077,"Montana","Powell County",4,40,95,66,29
050,30,077,"Montana","Powell County",4,41,112,79,33
050,30,077,"Montana","Powell County",4,42,116,77,39
050,30,077,"Montana","Powell County",4,43,111,80,31
050,30,077,"Montana","Powell County",4,44,89,65,24
050,30,077,"Montana","Powell County",4,45,85,61,24
050,30,077,"Montana","Powell County",4,46,101,72,29
050,30,077,"Montana","Powell County",4,47,100,82,18
050,30,077,"Montana","Powell County",4,48,94,71,23
050,30,077,"Montana","Powell County",4,49,109,81,28
050,30,077,"Montana","Powell County",4,50,100,75,25
050,30,077,"Montana","Powell County",4,51,104,69,35
050,30,077,"Montana","Powell County",4,52,87,59,28
050,30,077,"Montana","Powell County",4,53,84,54,30
050,30,077,"Montana","Powell County",4,54,94,56,38
050,30,077,"Montana","Powell County",4,55,92,52,40
050,30,077,"Montana","Powell County",4,56,100,64,36
050,30,077,"Montana","Powell County",4,57,111,76,35
050,30,077,"Montana","Powell County",4,58,106,64,42
050,30,077,"Montana","Powell County",4,59,112,70,42
050,30,077,"Montana","Powell County",4,60,134,84,50
050,30,077,"Montana","Powell County",4,61,94,53,41
050,30,077,"Montana","Powell County",4,62,115,66,49
050,30,077,"Montana","Powell County",4,63,113,63,50
050,30,077,"Montana","Powell County",4,64,92,57,35
050,30,077,"Montana","Powell County",4,65,104,51,53
050,30,077,"Montana","Powell County",4,66,89,46,43
050,30,077,"Montana","Powell County",4,67,101,59,42
050,30,077,"Montana","Powell County",4,68,96,48,48
050,30,077,"Montana","Powell County",4,69,95,56,39
050,30,077,"Montana","Powell County",4,70,94,56,38
050,30,077,"Montana","Powell County",4,71,87,51,36
050,30,077,"Montana","Powell County",4,72,88,50,38
050,30,077,"Montana","Powell County",4,73,79,44,35
050,30,077,"Montana","Powell County",4,74,59,28,31
050,30,077,"Montana","Powell County",4,75,86,41,45
050,30,077,"Montana","Powell County",4,76,59,29,30
050,30,077,"Montana","Powell County",4,77,65,33,32
050,30,077,"Montana","Powell County",4,78,44,21,23
050,30,077,"Montana","Powell County",4,79,50,32,18
050,30,077,"Montana","Powell County",4,80,44,25,19
050,30,077,"Montana","Powell County",4,81,42,21,21
050,30,077,"Montana","Powell County",4,82,23,11,12
050,30,077,"Montana","Powell County",4,83,25,12,13
050,30,077,"Montana","Powell County",4,84,29,12,17
050,30,077,"Montana","Powell County",4,85,147,70,77
050,30,077,"Montana","Powell County",5,0,41,22,19
050,30,077,"Montana","Powell County",5,1,42,23,19
050,30,077,"Montana","Powell County",5,2,44,22,22
050,30,077,"Montana","Powell County",5,3,56,33,23
050,30,077,"Montana","Powell County",5,4,58,28,30
050,30,077,"Montana","Powell County",5,5,59,38,21
050,30,077,"Montana","Powell County",5,6,51,28,23
050,30,077,"Montana","Powell County",5,7,67,36,31
050,30,077,"Montana","Powell County",5,8,65,37,28
050,30,077,"Montana","Powell County",5,9,56,27,29
050,30,077,"Montana","Powell County",5,10,52,23,29
050,30,077,"Montana","Powell County",5,11,62,29,33
050,30,077,"Montana","Powell County",5,12,72,37,35
050,30,077,"Montana","Powell County",5,13,66,31,35
050,30,077,"Montana","Powell County",5,14,63,35,28
050,30,077,"Montana","Powell County",5,15,64,33,31
050,30,077,"Montana","Powell County",5,16,66,40,26
050,30,077,"Montana","Powell County",5,17,55,31,24
050,30,077,"Montana","Powell County",5,18,53,28,25
050,30,077,"Montana","Powell County",5,19,49,29,20
050,30,077,"Montana","Powell County",5,20,74,58,16
050,30,077,"Montana","Powell County",5,21,73,53,20
050,30,077,"Montana","Powell County",5,22,83,51,32
050,30,077,"Montana","Powell County",5,23,110,81,29
050,30,077,"Montana","Powell County",5,24,103,78,25
050,30,077,"Montana","Powell County",5,25,113,84,29
050,30,077,"Montana","Powell County",5,26,93,72,21
050,30,077,"Montana","Powell County",5,27,89,58,31
050,30,077,"Montana","Powell County",5,28,108,81,27
050,30,077,"Montana","Powell County",5,29,92,71,21
050,30,077,"Montana","Powell County",5,30,91,70,21
050,30,077,"Montana","Powell County",5,31,92,69,23
050,30,077,"Montana","Powell County",5,32,96,67,29
050,30,077,"Montana","Powell County",5,33,99,76,23
050,30,077,"Montana","Powell County",5,34,94,70,24
050,30,077,"Montana","Powell County",5,35,92,68,24
050,30,077,"Montana","Powell County",5,36,98,70,28
050,30,077,"Montana","Powell County",5,37,106,81,25
050,30,077,"Montana","Powell County",5,38,101,70,31
050,30,077,"Montana","Powell County",5,39,102,70,32
050,30,077,"Montana","Powell County",5,40,100,76,24
050,30,077,"Montana","Powell County",5,41,96,66,30
050,30,077,"Montana","Powell County",5,42,116,84,32
050,30,077,"Montana","Powell County",5,43,119,79,40
050,30,077,"Montana","Powell County",5,44,104,71,33
050,30,077,"Montana","Powell County",5,45,94,70,24
050,30,077,"Montana","Powell County",5,46,87,62,25
050,30,077,"Montana","Powell County",5,47,109,81,28
050,30,077,"Montana","Powell County",5,48,87,70,17
050,30,077,"Montana","Powell County",5,49,106,84,22
050,30,077,"Montana","Powell County",5,50,106,78,28
050,30,077,"Montana","Powell County",5,51,93,68,25
050,30,077,"Montana","Powell County",5,52,103,67,36
050,30,077,"Montana","Powell County",5,53,76,47,29
050,30,077,"Montana","Powell County",5,54,88,58,30
050,30,077,"Montana","Powell County",5,55,92,55,37
050,30,077,"Montana","Powell County",5,56,87,51,36
050,30,077,"Montana","Powell County",5,57,103,62,41
050,30,077,"Montana","Powell County",5,58,112,76,36
050,30,077,"Montana","Powell County",5,59,101,58,43
050,30,077,"Montana","Powell County",5,60,113,73,40
050,30,077,"Montana","Powell County",5,61,119,68,51
050,30,077,"Montana","Powell County",5,62,98,51,47
050,30,077,"Montana","Powell County",5,63,122,71,51
050,30,077,"Montana","Powell County",5,64,109,59,50
050,30,077,"Montana","Powell County",5,65,98,64,34
050,30,077,"Montana","Powell County",5,66,107,52,55
050,30,077,"Montana","Powell County",5,67,89,45,44
050,30,077,"Montana","Powell County",5,68,91,52,39
050,30,077,"Montana","Powell County",5,69,103,56,47
050,30,077,"Montana","Powell County",5,70,96,56,40
050,30,077,"Montana","Powell County",5,71,86,49,37
050,30,077,"Montana","Powell County",5,72,84,50,34
050,30,077,"Montana","Powell County",5,73,84,46,38
050,30,077,"Montana","Powell County",5,74,77,42,35
050,30,077,"Montana","Powell County",5,75,55,25,30
050,30,077,"Montana","Powell County",5,76,85,39,46
050,30,077,"Montana","Powell County",5,77,60,30,30
050,30,077,"Montana","Powell County",5,78,60,30,30
050,30,077,"Montana","Powell County",5,79,41,23,18
050,30,077,"Montana","Powell County",5,80,45,29,16
050,30,077,"Montana","Powell County",5,81,46,25,21
050,30,077,"Montana","Powell County",5,82,39,20,19
050,30,077,"Montana","Powell County",5,83,17,8,9
050,30,077,"Montana","Powell County",5,84,20,10,10
050,30,077,"Montana","Powell County",5,85,160,75,85
050,30,079,"Montana","Prairie County",1,0,17,9,8
050,30,079,"Montana","Prairie County",1,1,17,7,10
050,30,079,"Montana","Prairie County",1,2,12,7,5
050,30,079,"Montana","Prairie County",1,3,10,6,4
050,30,079,"Montana","Prairie County",1,4,12,7,5
050,30,079,"Montana","Prairie County",1,5,17,11,6
050,30,079,"Montana","Prairie County",1,6,10,7,3
050,30,079,"Montana","Prairie County",1,7,8,5,3
050,30,079,"Montana","Prairie County",1,8,13,6,7
050,30,079,"Montana","Prairie County",1,9,14,7,7
050,30,079,"Montana","Prairie County",1,10,13,10,3
050,30,079,"Montana","Prairie County",1,11,15,9,6
050,30,079,"Montana","Prairie County",1,12,12,7,5
050,30,079,"Montana","Prairie County",1,13,7,4,3
050,30,079,"Montana","Prairie County",1,14,9,1,8
050,30,079,"Montana","Prairie County",1,15,5,2,3
050,30,079,"Montana","Prairie County",1,16,10,2,8
050,30,079,"Montana","Prairie County",1,17,9,3,6
050,30,079,"Montana","Prairie County",1,18,10,7,3
050,30,079,"Montana","Prairie County",1,19,5,3,2
050,30,079,"Montana","Prairie County",1,20,6,3,3
050,30,079,"Montana","Prairie County",1,21,8,6,2
050,30,079,"Montana","Prairie County",1,22,6,4,2
050,30,079,"Montana","Prairie County",1,23,7,3,4
050,30,079,"Montana","Prairie County",1,24,4,3,1
050,30,079,"Montana","Prairie County",1,25,9,5,4
050,30,079,"Montana","Prairie County",1,26,7,1,6
050,30,079,"Montana","Prairie County",1,27,10,4,6
050,30,079,"Montana","Prairie County",1,28,6,2,4
050,30,079,"Montana","Prairie County",1,29,9,4,5
050,30,079,"Montana","Prairie County",1,30,11,6,5
050,30,079,"Montana","Prairie County",1,31,12,8,4
050,30,079,"Montana","Prairie County",1,32,10,8,2
050,30,079,"Montana","Prairie County",1,33,8,6,2
050,30,079,"Montana","Prairie County",1,34,8,6,2
050,30,079,"Montana","Prairie County",1,35,12,5,7
050,30,079,"Montana","Prairie County",1,36,9,4,5
050,30,079,"Montana","Prairie County",1,37,11,4,7
050,30,079,"Montana","Prairie County",1,38,9,2,7
050,30,079,"Montana","Prairie County",1,39,11,6,5
050,30,079,"Montana","Prairie County",1,40,12,6,6
050,30,079,"Montana","Prairie County",1,41,9,6,3
050,30,079,"Montana","Prairie County",1,42,10,9,1
050,30,079,"Montana","Prairie County",1,43,9,7,2
050,30,079,"Montana","Prairie County",1,44,12,7,5
050,30,079,"Montana","Prairie County",1,45,11,7,4
050,30,079,"Montana","Prairie County",1,46,13,8,5
050,30,079,"Montana","Prairie County",1,47,12,8,4
050,30,079,"Montana","Prairie County",1,48,15,8,7
050,30,079,"Montana","Prairie County",1,49,12,6,6
050,30,079,"Montana","Prairie County",1,50,9,4,5
050,30,079,"Montana","Prairie County",1,51,10,4,6
050,30,079,"Montana","Prairie County",1,52,6,3,3
050,30,079,"Montana","Prairie County",1,53,7,4,3
050,30,079,"Montana","Prairie County",1,54,10,6,4
050,30,079,"Montana","Prairie County",1,55,14,6,8
050,30,079,"Montana","Prairie County",1,56,14,8,6
050,30,079,"Montana","Prairie County",1,57,10,3,7
050,30,079,"Montana","Prairie County",1,58,15,7,8
050,30,079,"Montana","Prairie County",1,59,22,11,11
050,30,079,"Montana","Prairie County",1,60,17,7,10
050,30,079,"Montana","Prairie County",1,61,18,9,9
050,30,079,"Montana","Prairie County",1,62,21,10,11
050,30,079,"Montana","Prairie County",1,63,22,12,10
050,30,079,"Montana","Prairie County",1,64,18,11,7
050,30,079,"Montana","Prairie County",1,65,25,16,9
050,30,079,"Montana","Prairie County",1,66,24,13,11
050,30,079,"Montana","Prairie County",1,67,17,9,8
050,30,079,"Montana","Prairie County",1,68,22,12,10
050,30,079,"Montana","Prairie County",1,69,27,13,14
050,30,079,"Montana","Prairie County",1,70,26,10,16
050,30,079,"Montana","Prairie County",1,71,20,9,11
050,30,079,"Montana","Prairie County",1,72,24,13,11
050,30,079,"Montana","Prairie County",1,73,22,12,10
050,30,079,"Montana","Prairie County",1,74,16,10,6
050,30,079,"Montana","Prairie County",1,75,15,8,7
050,30,079,"Montana","Prairie County",1,76,18,9,9
050,30,079,"Montana","Prairie County",1,77,13,7,6
050,30,079,"Montana","Prairie County",1,78,12,9,3
050,30,079,"Montana","Prairie County",1,79,9,5,4
050,30,079,"Montana","Prairie County",1,80,8,2,6
050,30,079,"Montana","Prairie County",1,81,9,2,7
050,30,079,"Montana","Prairie County",1,82,10,7,3
050,30,079,"Montana","Prairie County",1,83,7,5,2
050,30,079,"Montana","Prairie County",1,84,5,1,4
050,30,079,"Montana","Prairie County",1,85,36,13,23
050,30,079,"Montana","Prairie County",2,0,18,8,10
050,30,079,"Montana","Prairie County",2,1,16,7,9
050,30,079,"Montana","Prairie County",2,2,12,6,6
050,30,079,"Montana","Prairie County",2,3,10,6,4
050,30,079,"Montana","Prairie County",2,4,12,7,5
050,30,079,"Montana","Prairie County",2,5,16,10,6
050,30,079,"Montana","Prairie County",2,6,11,8,3
050,30,079,"Montana","Prairie County",2,7,9,6,3
050,30,079,"Montana","Prairie County",2,8,12,6,6
050,30,079,"Montana","Prairie County",2,9,14,7,7
050,30,079,"Montana","Prairie County",2,10,13,10,3
050,30,079,"Montana","Prairie County",2,11,15,9,6
050,30,079,"Montana","Prairie County",2,12,12,7,5
050,30,079,"Montana","Prairie County",2,13,8,5,3
050,30,079,"Montana","Prairie County",2,14,9,2,7
050,30,079,"Montana","Prairie County",2,15,7,2,5
050,30,079,"Montana","Prairie County",2,16,8,2,6
050,30,079,"Montana","Prairie County",2,17,9,3,6
050,30,079,"Montana","Prairie County",2,18,9,6,3
050,30,079,"Montana","Prairie County",2,19,6,4,2
050,30,079,"Montana","Prairie County",2,20,6,3,3
050,30,079,"Montana","Prairie County",2,21,7,5,2
050,30,079,"Montana","Prairie County",2,22,7,5,2
050,30,079,"Montana","Prairie County",2,23,6,3,3
050,30,079,"Montana","Prairie County",2,24,5,3,2
050,30,079,"Montana","Prairie County",2,25,8,4,4
050,30,079,"Montana","Prairie County",2,26,6,1,5
050,30,079,"Montana","Prairie County",2,27,10,4,6
050,30,079,"Montana","Prairie County",2,28,6,2,4
050,30,079,"Montana","Prairie County",2,29,8,4,4
050,30,079,"Montana","Prairie County",2,30,10,5,5
050,30,079,"Montana","Prairie County",2,31,12,8,4
050,30,079,"Montana","Prairie County",2,32,11,8,3
050,30,079,"Montana","Prairie County",2,33,8,6,2
050,30,079,"Montana","Prairie County",2,34,8,6,2
050,30,079,"Montana","Prairie County",2,35,12,6,6
050,30,079,"Montana","Prairie County",2,36,10,4,6
050,30,079,"Montana","Prairie County",2,37,11,4,7
050,30,079,"Montana","Prairie County",2,38,10,3,7
050,30,079,"Montana","Prairie County",2,39,9,4,5
050,30,079,"Montana","Prairie County",2,40,13,7,6
050,30,079,"Montana","Prairie County",2,41,9,6,3
050,30,079,"Montana","Prairie County",2,42,10,8,2
050,30,079,"Montana","Prairie County",2,43,9,7,2
050,30,079,"Montana","Prairie County",2,44,10,7,3
050,30,079,"Montana","Prairie County",2,45,12,8,4
050,30,079,"Montana","Prairie County",2,46,13,8,5
050,30,079,"Montana","Prairie County",2,47,13,8,5
050,30,079,"Montana","Prairie County",2,48,14,8,6
050,30,079,"Montana","Prairie County",2,49,13,6,7
050,30,079,"Montana","Prairie County",2,50,9,4,5
050,30,079,"Montana","Prairie County",2,51,9,4,5
050,30,079,"Montana","Prairie County",2,52,7,3,4
050,30,079,"Montana","Prairie County",2,53,7,4,3
050,30,079,"Montana","Prairie County",2,54,9,5,4
050,30,079,"Montana","Prairie County",2,55,13,6,7
050,30,079,"Montana","Prairie County",2,56,14,7,7
050,30,079,"Montana","Prairie County",2,57,11,4,7
050,30,079,"Montana","Prairie County",2,58,14,6,8
050,30,079,"Montana","Prairie County",2,59,20,10,10
050,30,079,"Montana","Prairie County",2,60,18,8,10
050,30,079,"Montana","Prairie County",2,61,17,8,9
050,30,079,"Montana","Prairie County",2,62,21,10,11
050,30,079,"Montana","Prairie County",2,63,22,12,10
050,30,079,"Montana","Prairie County",2,64,19,11,8
050,30,079,"Montana","Prairie County",2,65,24,15,9
050,30,079,"Montana","Prairie County",2,66,24,13,11
050,30,079,"Montana","Prairie County",2,67,19,10,9
050,30,079,"Montana","Prairie County",2,68,21,11,10
050,30,079,"Montana","Prairie County",2,69,26,12,14
050,30,079,"Montana","Prairie County",2,70,26,11,15
050,30,079,"Montana","Prairie County",2,71,21,9,12
050,30,079,"Montana","Prairie County",2,72,23,12,11
050,30,079,"Montana","Prairie County",2,73,23,13,10
050,30,079,"Montana","Prairie County",2,74,17,10,7
050,30,079,"Montana","Prairie County",2,75,15,9,6
050,30,079,"Montana","Prairie County",2,76,17,9,8
050,30,079,"Montana","Prairie County",2,77,15,8,7
050,30,079,"Montana","Prairie County",2,78,11,8,3
050,30,079,"Montana","Prairie County",2,79,10,6,4
050,30,079,"Montana","Prairie County",2,80,8,3,5
050,30,079,"Montana","Prairie County",2,81,9,2,7
050,30,079,"Montana","Prairie County",2,82,10,6,4
050,30,079,"Montana","Prairie County",2,83,8,6,2
050,30,079,"Montana","Prairie County",2,84,6,2,4
050,30,079,"Montana","Prairie County",2,85,36,13,23
050,30,079,"Montana","Prairie County",3,0,3,2,1
050,30,079,"Montana","Prairie County",3,1,15,5,10
050,30,079,"Montana","Prairie County",3,2,16,6,10
050,30,079,"Montana","Prairie County",3,3,13,7,6
050,30,079,"Montana","Prairie County",3,4,11,8,3
050,30,079,"Montana","Prairie County",3,5,13,7,6
050,30,079,"Montana","Prairie County",3,6,17,11,6
050,30,079,"Montana","Prairie County",3,7,12,8,4
050,30,079,"Montana","Prairie County",3,8,12,5,7
050,30,079,"Montana","Prairie County",3,9,12,7,5
050,30,079,"Montana","Prairie County",3,10,16,7,9
050,30,079,"Montana","Prairie County",3,11,18,10,8
050,30,079,"Montana","Prairie County",3,12,16,10,6
050,30,079,"Montana","Prairie County",3,13,12,8,4
050,30,079,"Montana","Prairie County",3,14,10,6,4
050,30,079,"Montana","Prairie County",3,15,8,3,5
050,30,079,"Montana","Prairie County",3,16,8,2,6
050,30,079,"Montana","Prairie County",3,17,7,2,5
050,30,079,"Montana","Prairie County",3,18,11,5,6
050,30,079,"Montana","Prairie County",3,19,6,4,2
050,30,079,"Montana","Prairie County",3,20,4,3,1
050,30,079,"Montana","Prairie County",3,21,4,1,3
050,30,079,"Montana","Prairie County",3,22,7,5,2
050,30,079,"Montana","Prairie County",3,23,8,5,3
050,30,079,"Montana","Prairie County",3,24,4,2,2
050,30,079,"Montana","Prairie County",3,25,6,4,2
050,30,079,"Montana","Prairie County",3,26,5,4,1
050,30,079,"Montana","Prairie County",3,27,8,1,7
050,30,079,"Montana","Prairie County",3,28,13,6,7
050,30,079,"Montana","Prairie County",3,29,8,2,6
050,30,079,"Montana","Prairie County",3,30,9,4,5
050,30,079,"Montana","Prairie County",3,31,9,3,6
050,30,079,"Montana","Prairie County",3,32,14,8,6
050,30,079,"Montana","Prairie County",3,33,11,7,4
050,30,079,"Montana","Prairie County",3,34,8,6,2
050,30,079,"Montana","Prairie County",3,35,7,5,2
050,30,079,"Montana","Prairie County",3,36,9,4,5
050,30,079,"Montana","Prairie County",3,37,11,5,6
050,30,079,"Montana","Prairie County",3,38,10,5,5
050,30,079,"Montana","Prairie County",3,39,7,2,5
050,30,079,"Montana","Prairie County",3,40,10,5,5
050,30,079,"Montana","Prairie County",3,41,14,8,6
050,30,079,"Montana","Prairie County",3,42,8,5,3
050,30,079,"Montana","Prairie County",3,43,10,8,2
050,30,079,"Montana","Prairie County",3,44,10,8,2
050,30,079,"Montana","Prairie County",3,45,8,5,3
050,30,079,"Montana","Prairie County",3,46,12,8,4
050,30,079,"Montana","Prairie County",3,47,9,4,5
050,30,079,"Montana","Prairie County",3,48,16,9,7
050,30,079,"Montana","Prairie County",3,49,14,8,6
050,30,079,"Montana","Prairie County",3,50,15,8,7
050,30,079,"Montana","Prairie County",3,51,9,4,5
050,30,079,"Montana","Prairie County",3,52,9,4,5
050,30,079,"Montana","Prairie County",3,53,5,3,2
050,30,079,"Montana","Prairie County",3,54,6,4,2
050,30,079,"Montana","Prairie County",3,55,9,5,4
050,30,079,"Montana","Prairie County",3,56,12,5,7
050,30,079,"Montana","Prairie County",3,57,13,6,7
050,30,079,"Montana","Prairie County",3,58,11,4,7
050,30,079,"Montana","Prairie County",3,59,14,6,8
050,30,079,"Montana","Prairie County",3,60,20,10,10
050,30,079,"Montana","Prairie County",3,61,17,8,9
050,30,079,"Montana","Prairie County",3,62,18,8,10
050,30,079,"Montana","Prairie County",3,63,23,11,12
050,30,079,"Montana","Prairie County",3,64,23,13,10
050,30,079,"Montana","Prairie County",3,65,20,10,10
050,30,079,"Montana","Prairie County",3,66,25,14,11
050,30,079,"Montana","Prairie County",3,67,25,13,12
050,30,079,"Montana","Prairie County",3,68,21,11,10
050,30,079,"Montana","Prairie County",3,69,19,9,10
050,30,079,"Montana","Prairie County",3,70,25,12,13
050,30,079,"Montana","Prairie County",3,71,26,12,14
050,30,079,"Montana","Prairie County",3,72,22,9,13
050,30,079,"Montana","Prairie County",3,73,25,12,13
050,30,079,"Montana","Prairie County",3,74,22,12,10
050,30,079,"Montana","Prairie County",3,75,16,10,6
050,30,079,"Montana","Prairie County",3,76,12,8,4
050,30,079,"Montana","Prairie County",3,77,18,9,9
050,30,079,"Montana","Prairie County",3,78,11,5,6
050,30,079,"Montana","Prairie County",3,79,12,8,4
050,30,079,"Montana","Prairie County",3,80,10,6,4
050,30,079,"Montana","Prairie County",3,81,8,3,5
050,30,079,"Montana","Prairie County",3,82,11,3,8
050,30,079,"Montana","Prairie County",3,83,10,6,4
050,30,079,"Montana","Prairie County",3,84,6,4,2
050,30,079,"Montana","Prairie County",3,85,40,16,24
050,30,079,"Montana","Prairie County",4,0,5,4,1
050,30,079,"Montana","Prairie County",4,1,4,3,1
050,30,079,"Montana","Prairie County",4,2,18,7,11
050,30,079,"Montana","Prairie County",4,3,14,6,8
050,30,079,"Montana","Prairie County",4,4,14,7,7
050,30,079,"Montana","Prairie County",4,5,12,9,3
050,30,079,"Montana","Prairie County",4,6,14,7,7
050,30,079,"Montana","Prairie County",4,7,18,11,7
050,30,079,"Montana","Prairie County",4,8,12,8,4
050,30,079,"Montana","Prairie County",4,9,12,5,7
050,30,079,"Montana","Prairie County",4,10,12,7,5
050,30,079,"Montana","Prairie County",4,11,16,7,9
050,30,079,"Montana","Prairie County",4,12,16,9,7
050,30,079,"Montana","Prairie County",4,13,17,11,6
050,30,079,"Montana","Prairie County",4,14,12,8,4
050,30,079,"Montana","Prairie County",4,15,9,5,4
050,30,079,"Montana","Prairie County",4,16,8,3,5
050,30,079,"Montana","Prairie County",4,17,8,2,6
050,30,079,"Montana","Prairie County",4,18,7,2,5
050,30,079,"Montana","Prairie County",4,19,7,4,3
050,30,079,"Montana","Prairie County",4,20,5,4,1
050,30,079,"Montana","Prairie County",4,21,4,2,2
050,30,079,"Montana","Prairie County",4,22,4,1,3
050,30,079,"Montana","Prairie County",4,23,4,2,2
050,30,079,"Montana","Prairie County",4,24,6,4,2
050,30,079,"Montana","Prairie County",4,25,6,3,3
050,30,079,"Montana","Prairie County",4,26,3,1,2
050,30,079,"Montana","Prairie County",4,27,6,5,1
050,30,079,"Montana","Prairie County",4,28,8,1,7
050,30,079,"Montana","Prairie County",4,29,13,6,7
050,30,079,"Montana","Prairie County",4,30,8,2,6
050,30,079,"Montana","Prairie County",4,31,9,4,5
050,30,079,"Montana","Prairie County",4,32,10,5,5
050,30,079,"Montana","Prairie County",4,33,13,8,5
050,30,079,"Montana","Prairie County",4,34,12,8,4
050,30,079,"Montana","Prairie County",4,35,8,6,2
050,30,079,"Montana","Prairie County",4,36,8,6,2
050,30,079,"Montana","Prairie County",4,37,11,4,7
050,30,079,"Montana","Prairie County",4,38,11,5,6
050,30,079,"Montana","Prairie County",4,39,10,5,5
050,30,079,"Montana","Prairie County",4,40,8,3,5
050,30,079,"Montana","Prairie County",4,41,11,6,5
050,30,079,"Montana","Prairie County",4,42,15,8,7
050,30,079,"Montana","Prairie County",4,43,8,5,3
050,30,079,"Montana","Prairie County",4,44,10,8,2
050,30,079,"Montana","Prairie County",4,45,10,8,2
050,30,079,"Montana","Prairie County",4,46,8,5,3
050,30,079,"Montana","Prairie County",4,47,12,8,4
050,30,079,"Montana","Prairie County",4,48,8,3,5
050,30,079,"Montana","Prairie County",4,49,17,10,7
050,30,079,"Montana","Prairie County",4,50,14,8,6
050,30,079,"Montana","Prairie County",4,51,13,8,5
050,30,079,"Montana","Prairie County",4,52,8,3,5
050,30,079,"Montana","Prairie County",4,53,9,4,5
050,30,079,"Montana","Prairie County",4,54,6,3,3
050,30,079,"Montana","Prairie County",4,55,6,4,2
050,30,079,"Montana","Prairie County",4,56,14,10,4
050,30,079,"Montana","Prairie County",4,57,12,5,7
050,30,079,"Montana","Prairie County",4,58,18,8,10
050,30,079,"Montana","Prairie County",4,59,11,4,7
050,30,079,"Montana","Prairie County",4,60,14,7,7
050,30,079,"Montana","Prairie County",4,61,19,9,10
050,30,079,"Montana","Prairie County",4,62,17,8,9
050,30,079,"Montana","Prairie County",4,63,18,8,10
050,30,079,"Montana","Prairie County",4,64,23,11,12
050,30,079,"Montana","Prairie County",4,65,21,12,9
050,30,079,"Montana","Prairie County",4,66,19,10,9
050,30,079,"Montana","Prairie County",4,67,27,15,12
050,30,079,"Montana","Prairie County",4,68,24,12,12
050,30,079,"Montana","Prairie County",4,69,25,13,12
050,30,079,"Montana","Prairie County",4,70,23,13,10
050,30,079,"Montana","Prairie County",4,71,25,12,13
050,30,079,"Montana","Prairie County",4,72,26,12,14
050,30,079,"Montana","Prairie County",4,73,23,10,13
050,30,079,"Montana","Prairie County",4,74,27,13,14
050,30,079,"Montana","Prairie County",4,75,20,11,9
050,30,079,"Montana","Prairie County",4,76,14,10,4
050,30,079,"Montana","Prairie County",4,77,13,8,5
050,30,079,"Montana","Prairie County",4,78,15,7,8
050,30,079,"Montana","Prairie County",4,79,12,5,7
050,30,079,"Montana","Prairie County",4,80,12,8,4
050,30,079,"Montana","Prairie County",4,81,10,7,3
050,30,079,"Montana","Prairie County",4,82,6,1,5
050,30,079,"Montana","Prairie County",4,83,12,3,9
050,30,079,"Montana","Prairie County",4,84,9,5,4
050,30,079,"Montana","Prairie County",4,85,42,20,22
050,30,079,"Montana","Prairie County",5,0,5,4,1
050,30,079,"Montana","Prairie County",5,1,5,4,1
050,30,079,"Montana","Prairie County",5,2,4,3,1
050,30,079,"Montana","Prairie County",5,3,13,6,7
050,30,079,"Montana","Prairie County",5,4,14,8,6
050,30,079,"Montana","Prairie County",5,5,14,7,7
050,30,079,"Montana","Prairie County",5,6,12,9,3
050,30,079,"Montana","Prairie County",5,7,13,6,7
050,30,079,"Montana","Prairie County",5,8,16,10,6
050,30,079,"Montana","Prairie County",5,9,11,8,3
050,30,079,"Montana","Prairie County",5,10,13,6,7
050,30,079,"Montana","Prairie County",5,11,13,7,6
050,30,079,"Montana","Prairie County",5,12,17,8,9
050,30,079,"Montana","Prairie County",5,13,17,10,7
050,30,079,"Montana","Prairie County",5,14,18,9,9
050,30,079,"Montana","Prairie County",5,15,9,6,3
050,30,079,"Montana","Prairie County",5,16,10,5,5
050,30,079,"Montana","Prairie County",5,17,6,1,5
050,30,079,"Montana","Prairie County",5,18,6,2,4
050,30,079,"Montana","Prairie County",5,19,6,3,3
050,30,079,"Montana","Prairie County",5,20,5,1,4
050,30,079,"Montana","Prairie County",5,21,6,5,1
050,30,079,"Montana","Prairie County",5,22,4,2,2
050,30,079,"Montana","Prairie County",5,23,2,1,1
050,30,079,"Montana","Prairie County",5,24,4,2,2
050,30,079,"Montana","Prairie County",5,25,8,5,3
050,30,079,"Montana","Prairie County",5,26,7,3,4
050,30,079,"Montana","Prairie County",5,27,4,1,3
050,30,079,"Montana","Prairie County",5,28,6,5,1
050,30,079,"Montana","Prairie County",5,29,9,2,7
050,30,079,"Montana","Prairie County",5,30,10,5,5
050,30,079,"Montana","Prairie County",5,31,7,2,5
050,30,079,"Montana","Prairie County",5,32,11,4,7
050,30,079,"Montana","Prairie County",5,33,12,6,6
050,30,079,"Montana","Prairie County",5,34,12,8,4
050,30,079,"Montana","Prairie County",5,35,11,7,4
050,30,079,"Montana","Prairie County",5,36,8,5,3
050,30,079,"Montana","Prairie County",5,37,9,7,2
050,30,079,"Montana","Prairie County",5,38,11,4,7
050,30,079,"Montana","Prairie County",5,39,12,5,7
050,30,079,"Montana","Prairie County",5,40,14,5,9
050,30,079,"Montana","Prairie County",5,41,8,3,5
050,30,079,"Montana","Prairie County",5,42,13,8,5
050,30,079,"Montana","Prairie County",5,43,15,8,7
050,30,079,"Montana","Prairie County",5,44,8,5,3
050,30,079,"Montana","Prairie County",5,45,10,8,2
050,30,079,"Montana","Prairie County",5,46,11,8,3
050,30,079,"Montana","Prairie County",5,47,8,5,3
050,30,079,"Montana","Prairie County",5,48,11,7,4
050,30,079,"Montana","Prairie County",5,49,10,3,7
050,30,079,"Montana","Prairie County",5,50,15,9,6
050,30,079,"Montana","Prairie County",5,51,13,8,5
050,30,079,"Montana","Prairie County",5,52,13,8,5
050,30,079,"Montana","Prairie County",5,53,8,3,5
050,30,079,"Montana","Prairie County",5,54,9,4,5
050,30,079,"Montana","Prairie County",5,55,7,5,2
050,30,079,"Montana","Prairie County",5,56,6,4,2
050,30,079,"Montana","Prairie County",5,57,14,10,4
050,30,079,"Montana","Prairie County",5,58,12,5,7
050,30,079,"Montana","Prairie County",5,59,18,8,10
050,30,079,"Montana","Prairie County",5,60,11,4,7
050,30,079,"Montana","Prairie County",5,61,16,7,9
050,30,079,"Montana","Prairie County",5,62,19,9,10
050,30,079,"Montana","Prairie County",5,63,17,8,9
050,30,079,"Montana","Prairie County",5,64,18,8,10
050,30,079,"Montana","Prairie County",5,65,23,11,12
050,30,079,"Montana","Prairie County",5,66,22,12,10
050,30,079,"Montana","Prairie County",5,67,20,11,9
050,30,079,"Montana","Prairie County",5,68,27,14,13
050,30,079,"Montana","Prairie County",5,69,25,12,13
050,30,079,"Montana","Prairie County",5,70,25,13,12
050,30,079,"Montana","Prairie County",5,71,23,14,9
050,30,079,"Montana","Prairie County",5,72,25,12,13
050,30,079,"Montana","Prairie County",5,73,26,12,14
050,30,079,"Montana","Prairie County",5,74,24,10,14
050,30,079,"Montana","Prairie County",5,75,27,13,14
050,30,079,"Montana","Prairie County",5,76,20,13,7
050,30,079,"Montana","Prairie County",5,77,17,11,6
050,30,079,"Montana","Prairie County",5,78,8,5,3
050,30,079,"Montana","Prairie County",5,79,17,7,10
050,30,079,"Montana","Prairie County",5,80,12,5,7
050,30,079,"Montana","Prairie County",5,81,12,8,4
050,30,079,"Montana","Prairie County",5,82,11,8,3
050,30,079,"Montana","Prairie County",5,83,6,1,5
050,30,079,"Montana","Prairie County",5,84,11,2,9
050,30,079,"Montana","Prairie County",5,85,47,24,23
050,30,081,"Montana","Ravalli County",1,0,384,198,186
050,30,081,"Montana","Ravalli County",1,1,392,212,180
050,30,081,"Montana","Ravalli County",1,2,383,207,176
050,30,081,"Montana","Ravalli County",1,3,397,216,181
050,30,081,"Montana","Ravalli County",1,4,446,226,220
050,30,081,"Montana","Ravalli County",1,5,465,260,205
050,30,081,"Montana","Ravalli County",1,6,457,235,222
050,30,081,"Montana","Ravalli County",1,7,430,216,214
050,30,081,"Montana","Ravalli County",1,8,449,236,213
050,30,081,"Montana","Ravalli County",1,9,455,233,222
050,30,081,"Montana","Ravalli County",1,10,465,251,214
050,30,081,"Montana","Ravalli County",1,11,476,248,228
050,30,081,"Montana","Ravalli County",1,12,490,244,246
050,30,081,"Montana","Ravalli County",1,13,518,266,252
050,30,081,"Montana","Ravalli County",1,14,531,286,245
050,30,081,"Montana","Ravalli County",1,15,507,269,238
050,30,081,"Montana","Ravalli County",1,16,530,283,247
050,30,081,"Montana","Ravalli County",1,17,544,287,257
050,30,081,"Montana","Ravalli County",1,18,503,274,229
050,30,081,"Montana","Ravalli County",1,19,392,211,181
050,30,081,"Montana","Ravalli County",1,20,367,214,153
050,30,081,"Montana","Ravalli County",1,21,389,227,162
050,30,081,"Montana","Ravalli County",1,22,386,201,185
050,30,081,"Montana","Ravalli County",1,23,366,193,173
050,30,081,"Montana","Ravalli County",1,24,393,219,174
050,30,081,"Montana","Ravalli County",1,25,376,195,181
050,30,081,"Montana","Ravalli County",1,26,352,186,166
050,30,081,"Montana","Ravalli County",1,27,380,196,184
050,30,081,"Montana","Ravalli County",1,28,400,211,189
050,30,081,"Montana","Ravalli County",1,29,385,189,196
050,30,081,"Montana","Ravalli County",1,30,407,194,213
050,30,081,"Montana","Ravalli County",1,31,440,217,223
050,30,081,"Montana","Ravalli County",1,32,431,217,214
050,30,081,"Montana","Ravalli County",1,33,425,213,212
050,30,081,"Montana","Ravalli County",1,34,457,221,236
050,30,081,"Montana","Ravalli County",1,35,454,235,219
050,30,081,"Montana","Ravalli County",1,36,484,266,218
050,30,081,"Montana","Ravalli County",1,37,508,264,244
050,30,081,"Montana","Ravalli County",1,38,499,236,263
050,30,081,"Montana","Ravalli County",1,39,474,229,245
050,30,081,"Montana","Ravalli County",1,40,530,261,269
050,30,081,"Montana","Ravalli County",1,41,494,244,250
050,30,081,"Montana","Ravalli County",1,42,532,260,272
050,30,081,"Montana","Ravalli County",1,43,496,256,240
050,30,081,"Montana","Ravalli County",1,44,434,226,208
050,30,081,"Montana","Ravalli County",1,45,424,201,223
050,30,081,"Montana","Ravalli County",1,46,444,217,227
050,30,081,"Montana","Ravalli County",1,47,491,248,243
050,30,081,"Montana","Ravalli County",1,48,491,251,240
050,30,081,"Montana","Ravalli County",1,49,556,264,292
050,30,081,"Montana","Ravalli County",1,50,566,273,293
050,30,081,"Montana","Ravalli County",1,51,534,237,297
050,30,081,"Montana","Ravalli County",1,52,487,245,242
050,30,081,"Montana","Ravalli County",1,53,517,262,255
050,30,081,"Montana","Ravalli County",1,54,586,311,275
050,30,081,"Montana","Ravalli County",1,55,620,312,308
050,30,081,"Montana","Ravalli County",1,56,679,334,345
050,30,081,"Montana","Ravalli County",1,57,691,327,364
050,30,081,"Montana","Ravalli County",1,58,699,341,358
050,30,081,"Montana","Ravalli County",1,59,723,344,379
050,30,081,"Montana","Ravalli County",1,60,688,321,367
050,30,081,"Montana","Ravalli County",1,61,775,375,400
050,30,081,"Montana","Ravalli County",1,62,807,380,427
050,30,081,"Montana","Ravalli County",1,63,819,384,435
050,30,081,"Montana","Ravalli County",1,64,809,391,418
050,30,081,"Montana","Ravalli County",1,65,779,360,419
050,30,081,"Montana","Ravalli County",1,66,812,393,419
050,30,081,"Montana","Ravalli County",1,67,782,386,396
050,30,081,"Montana","Ravalli County",1,68,773,382,391
050,30,081,"Montana","Ravalli County",1,69,715,335,380
050,30,081,"Montana","Ravalli County",1,70,725,360,365
050,30,081,"Montana","Ravalli County",1,71,732,356,376
050,30,081,"Montana","Ravalli County",1,72,746,373,373
050,30,081,"Montana","Ravalli County",1,73,718,374,344
050,30,081,"Montana","Ravalli County",1,74,489,246,243
050,30,081,"Montana","Ravalli County",1,75,517,261,256
050,30,081,"Montana","Ravalli County",1,76,479,261,218
050,30,081,"Montana","Ravalli County",1,77,436,226,210
050,30,081,"Montana","Ravalli County",1,78,383,187,196
050,30,081,"Montana","Ravalli County",1,79,337,157,180
050,30,081,"Montana","Ravalli County",1,80,308,155,153
050,30,081,"Montana","Ravalli County",1,81,295,154,141
050,30,081,"Montana","Ravalli County",1,82,276,137,139
050,30,081,"Montana","Ravalli County",1,83,221,112,109
050,30,081,"Montana","Ravalli County",1,84,200,101,99
050,30,081,"Montana","Ravalli County",1,85,969,405,564
050,30,081,"Montana","Ravalli County",2,0,395,202,193
050,30,081,"Montana","Ravalli County",2,1,391,208,183
050,30,081,"Montana","Ravalli County",2,2,388,210,178
050,30,081,"Montana","Ravalli County",2,3,398,216,182
050,30,081,"Montana","Ravalli County",2,4,437,227,210
050,30,081,"Montana","Ravalli County",2,5,463,252,211
050,30,081,"Montana","Ravalli County",2,6,460,242,218
050,30,081,"Montana","Ravalli County",2,7,439,221,218
050,30,081,"Montana","Ravalli County",2,8,444,231,213
050,30,081,"Montana","Ravalli County",2,9,453,233,220
050,30,081,"Montana","Ravalli County",2,10,464,247,217
050,30,081,"Montana","Ravalli County",2,11,472,246,226
050,30,081,"Montana","Ravalli County",2,12,492,247,245
050,30,081,"Montana","Ravalli County",2,13,512,262,250
050,30,081,"Montana","Ravalli County",2,14,528,281,247
050,30,081,"Montana","Ravalli County",2,15,513,274,239
050,30,081,"Montana","Ravalli County",2,16,530,281,249
050,30,081,"Montana","Ravalli County",2,17,546,292,254
050,30,081,"Montana","Ravalli County",2,18,494,270,224
050,30,081,"Montana","Ravalli County",2,19,397,216,181
050,30,081,"Montana","Ravalli County",2,20,377,214,163
050,30,081,"Montana","Ravalli County",2,21,388,224,164
050,30,081,"Montana","Ravalli County",2,22,387,203,184
050,30,081,"Montana","Ravalli County",2,23,377,199,178
050,30,081,"Montana","Ravalli County",2,24,392,214,178
050,30,081,"Montana","Ravalli County",2,25,382,200,182
050,30,081,"Montana","Ravalli County",2,26,358,190,168
050,30,081,"Montana","Ravalli County",2,27,379,199,180
050,30,081,"Montana","Ravalli County",2,28,397,208,189
050,30,081,"Montana","Ravalli County",2,29,390,194,196
050,30,081,"Montana","Ravalli County",2,30,414,197,217
050,30,081,"Montana","Ravalli County",2,31,438,214,224
050,30,081,"Montana","Ravalli County",2,32,437,220,217
050,30,081,"Montana","Ravalli County",2,33,434,217,217
050,30,081,"Montana","Ravalli County",2,34,457,222,235
050,30,081,"Montana","Ravalli County",2,35,467,239,228
050,30,081,"Montana","Ravalli County",2,36,481,261,220
050,30,081,"Montana","Ravalli County",2,37,509,268,241
050,30,081,"Montana","Ravalli County",2,38,504,244,260
050,30,081,"Montana","Ravalli County",2,39,484,231,253
050,30,081,"Montana","Ravalli County",2,40,524,254,270
050,30,081,"Montana","Ravalli County",2,41,509,251,258
050,30,081,"Montana","Ravalli County",2,42,522,256,266
050,30,081,"Montana","Ravalli County",2,43,508,259,249
050,30,081,"Montana","Ravalli County",2,44,446,234,212
050,30,081,"Montana","Ravalli County",2,45,431,211,220
050,30,081,"Montana","Ravalli County",2,46,438,212,226
050,30,081,"Montana","Ravalli County",2,47,482,243,239
050,30,081,"Montana","Ravalli County",2,48,492,252,240
050,30,081,"Montana","Ravalli County",2,49,547,266,281
050,30,081,"Montana","Ravalli County",2,50,566,270,296
050,30,081,"Montana","Ravalli County",2,51,541,245,296
050,30,081,"Montana","Ravalli County",2,52,501,243,258
050,30,081,"Montana","Ravalli County",2,53,515,260,255
050,30,081,"Montana","Ravalli County",2,54,569,298,271
050,30,081,"Montana","Ravalli County",2,55,620,316,304
050,30,081,"Montana","Ravalli County",2,56,674,332,342
050,30,081,"Montana","Ravalli County",2,57,692,330,362
050,30,081,"Montana","Ravalli County",2,58,705,341,364
050,30,081,"Montana","Ravalli County",2,59,728,350,378
050,30,081,"Montana","Ravalli County",2,60,703,330,373
050,30,081,"Montana","Ravalli County",2,61,760,364,396
050,30,081,"Montana","Ravalli County",2,62,805,383,422
050,30,081,"Montana","Ravalli County",2,63,831,392,439
050,30,081,"Montana","Ravalli County",2,64,811,388,423
050,30,081,"Montana","Ravalli County",2,65,790,370,420
050,30,081,"Montana","Ravalli County",2,66,813,389,424
050,30,081,"Montana","Ravalli County",2,67,793,391,402
050,30,081,"Montana","Ravalli County",2,68,773,384,389
050,30,081,"Montana","Ravalli County",2,69,736,350,386
050,30,081,"Montana","Ravalli County",2,70,721,354,367
050,30,081,"Montana","Ravalli County",2,71,737,360,377
050,30,081,"Montana","Ravalli County",2,72,730,365,365
050,30,081,"Montana","Ravalli County",2,73,762,394,368
050,30,081,"Montana","Ravalli County",2,74,509,260,249
050,30,081,"Montana","Ravalli County",2,75,510,258,252
050,30,081,"Montana","Ravalli County",2,76,479,256,223
050,30,081,"Montana","Ravalli County",2,77,457,240,217
050,30,081,"Montana","Ravalli County",2,78,385,189,196
050,30,081,"Montana","Ravalli County",2,79,346,164,182
050,30,081,"Montana","Ravalli County",2,80,315,155,160
050,30,081,"Montana","Ravalli County",2,81,291,153,138
050,30,081,"Montana","Ravalli County",2,82,277,138,139
050,30,081,"Montana","Ravalli County",2,83,230,116,114
050,30,081,"Montana","Ravalli County",2,84,202,102,100
050,30,081,"Montana","Ravalli County",2,85,967,410,557
050,30,081,"Montana","Ravalli County",3,0,367,193,174
050,30,081,"Montana","Ravalli County",3,1,421,226,195
050,30,081,"Montana","Ravalli County",3,2,422,229,193
050,30,081,"Montana","Ravalli County",3,3,412,223,189
050,30,081,"Montana","Ravalli County",3,4,429,240,189
050,30,081,"Montana","Ravalli County",3,5,454,225,229
050,30,081,"Montana","Ravalli County",3,6,486,262,224
050,30,081,"Montana","Ravalli County",3,7,502,274,228
050,30,081,"Montana","Ravalli County",3,8,473,245,228
050,30,081,"Montana","Ravalli County",3,9,468,245,223
050,30,081,"Montana","Ravalli County",3,10,468,246,222
050,30,081,"Montana","Ravalli County",3,11,501,266,235
050,30,081,"Montana","Ravalli County",3,12,504,265,239
050,30,081,"Montana","Ravalli County",3,13,528,269,259
050,30,081,"Montana","Ravalli County",3,14,537,269,268
050,30,081,"Montana","Ravalli County",3,15,548,289,259
050,30,081,"Montana","Ravalli County",3,16,530,275,255
050,30,081,"Montana","Ravalli County",3,17,568,305,263
050,30,081,"Montana","Ravalli County",3,18,501,280,221
050,30,081,"Montana","Ravalli County",3,19,400,218,182
050,30,081,"Montana","Ravalli County",3,20,396,216,180
050,30,081,"Montana","Ravalli County",3,21,415,234,181
050,30,081,"Montana","Ravalli County",3,22,403,220,183
050,30,081,"Montana","Ravalli County",3,23,407,223,184
050,30,081,"Montana","Ravalli County",3,24,394,205,189
050,30,081,"Montana","Ravalli County",3,25,440,236,204
050,30,081,"Montana","Ravalli County",3,26,397,208,189
050,30,081,"Montana","Ravalli County",3,27,381,206,175
050,30,081,"Montana","Ravalli County",3,28,443,230,213
050,30,081,"Montana","Ravalli County",3,29,449,224,225
050,30,081,"Montana","Ravalli County",3,30,439,215,224
050,30,081,"Montana","Ravalli County",3,31,454,216,238
050,30,081,"Montana","Ravalli County",3,32,483,235,248
050,30,081,"Montana","Ravalli County",3,33,481,239,242
050,30,081,"Montana","Ravalli County",3,34,499,254,245
050,30,081,"Montana","Ravalli County",3,35,484,237,247
050,30,081,"Montana","Ravalli County",3,36,500,264,236
050,30,081,"Montana","Ravalli County",3,37,520,279,241
050,30,081,"Montana","Ravalli County",3,38,503,274,229
050,30,081,"Montana","Ravalli County",3,39,542,269,273
050,30,081,"Montana","Ravalli County",3,40,519,244,275
050,30,081,"Montana","Ravalli County",3,41,567,285,282
050,30,081,"Montana","Ravalli County",3,42,536,262,274
050,30,081,"Montana","Ravalli County",3,43,544,272,272
050,30,081,"Montana","Ravalli County",3,44,531,268,263
050,30,081,"Montana","Ravalli County",3,45,487,252,235
050,30,081,"Montana","Ravalli County",3,46,447,218,229
050,30,081,"Montana","Ravalli County",3,47,450,226,224
050,30,081,"Montana","Ravalli County",3,48,492,253,239
050,30,081,"Montana","Ravalli County",3,49,502,259,243
050,30,081,"Montana","Ravalli County",3,50,570,275,295
050,30,081,"Montana","Ravalli County",3,51,580,277,303
050,30,081,"Montana","Ravalli County",3,52,566,262,304
050,30,081,"Montana","Ravalli County",3,53,542,261,281
050,30,081,"Montana","Ravalli County",3,54,539,271,268
050,30,081,"Montana","Ravalli County",3,55,603,314,289
050,30,081,"Montana","Ravalli County",3,56,644,325,319
050,30,081,"Montana","Ravalli County",3,57,696,339,357
050,30,081,"Montana","Ravalli County",3,58,710,339,371
050,30,081,"Montana","Ravalli County",3,59,752,366,386
050,30,081,"Montana","Ravalli County",3,60,751,367,384
050,30,081,"Montana","Ravalli County",3,61,741,350,391
050,30,081,"Montana","Ravalli County",3,62,802,390,412
050,30,081,"Montana","Ravalli County",3,63,843,403,440
050,30,081,"Montana","Ravalli County",3,64,877,417,460
050,30,081,"Montana","Ravalli County",3,65,821,390,431
050,30,081,"Montana","Ravalli County",3,66,800,385,415
050,30,081,"Montana","Ravalli County",3,67,819,390,429
050,30,081,"Montana","Ravalli County",3,68,801,388,413
050,30,081,"Montana","Ravalli County",3,69,785,390,395
050,30,081,"Montana","Ravalli County",3,70,735,347,388
050,30,081,"Montana","Ravalli County",3,71,722,357,365
050,30,081,"Montana","Ravalli County",3,72,712,345,367
050,30,081,"Montana","Ravalli County",3,73,723,357,366
050,30,081,"Montana","Ravalli County",3,74,750,390,360
050,30,081,"Montana","Ravalli County",3,75,482,244,238
050,30,081,"Montana","Ravalli County",3,76,501,258,243
050,30,081,"Montana","Ravalli County",3,77,469,245,224
050,30,081,"Montana","Ravalli County",3,78,445,235,210
050,30,081,"Montana","Ravalli County",3,79,357,174,183
050,30,081,"Montana","Ravalli County",3,80,329,154,175
050,30,081,"Montana","Ravalli County",3,81,288,140,148
050,30,081,"Montana","Ravalli County",3,82,272,138,134
050,30,081,"Montana","Ravalli County",3,83,250,123,127
050,30,081,"Montana","Ravalli County",3,84,213,107,106
050,30,081,"Montana","Ravalli County",3,85,970,414,556
050,30,081,"Montana","Ravalli County",4,0,405,221,184
050,30,081,"Montana","Ravalli County",4,1,410,230,180
050,30,081,"Montana","Ravalli County",4,2,436,226,210
050,30,081,"Montana","Ravalli County",4,3,433,235,198
050,30,081,"Montana","Ravalli County",4,4,438,238,200
050,30,081,"Montana","Ravalli County",4,5,466,263,203
050,30,081,"Montana","Ravalli County",4,6,490,244,246
050,30,081,"Montana","Ravalli County",4,7,501,271,230
050,30,081,"Montana","Ravalli County",4,8,535,290,245
050,30,081,"Montana","Ravalli County",4,9,486,252,234
050,30,081,"Montana","Ravalli County",4,10,491,261,230
050,30,081,"Montana","Ravalli County",4,11,490,265,225
050,30,081,"Montana","Ravalli County",4,12,507,277,230
050,30,081,"Montana","Ravalli County",4,13,534,283,251
050,30,081,"Montana","Ravalli County",4,14,525,261,264
050,30,081,"Montana","Ravalli County",4,15,541,267,274
050,30,081,"Montana","Ravalli County",4,16,555,293,262
050,30,081,"Montana","Ravalli County",4,17,550,296,254
050,30,081,"Montana","Ravalli County",4,18,504,277,227
050,30,081,"Montana","Ravalli County",4,19,392,228,164
050,30,081,"Montana","Ravalli County",4,20,394,211,183
050,30,081,"Montana","Ravalli County",4,21,400,212,188
050,30,081,"Montana","Ravalli County",4,22,421,227,194
050,30,081,"Montana","Ravalli County",4,23,413,215,198
050,30,081,"Montana","Ravalli County",4,24,424,235,189
050,30,081,"Montana","Ravalli County",4,25,400,217,183
050,30,081,"Montana","Ravalli County",4,26,457,238,219
050,30,081,"Montana","Ravalli County",4,27,420,221,199
050,30,081,"Montana","Ravalli County",4,28,384,214,170
050,30,081,"Montana","Ravalli County",4,29,460,232,228
050,30,081,"Montana","Ravalli County",4,30,492,237,255
050,30,081,"Montana","Ravalli County",4,31,510,241,269
050,30,081,"Montana","Ravalli County",4,32,493,244,249
050,30,081,"Montana","Ravalli County",4,33,518,257,261
050,30,081,"Montana","Ravalli County",4,34,512,246,266
050,30,081,"Montana","Ravalli County",4,35,544,278,266
050,30,081,"Montana","Ravalli County",4,36,508,252,256
050,30,081,"Montana","Ravalli County",4,37,519,272,247
050,30,081,"Montana","Ravalli County",4,38,564,298,266
050,30,081,"Montana","Ravalli County",4,39,543,293,250
050,30,081,"Montana","Ravalli County",4,40,565,280,285
050,30,081,"Montana","Ravalli County",4,41,542,261,281
050,30,081,"Montana","Ravalli County",4,42,602,302,300
050,30,081,"Montana","Ravalli County",4,43,553,269,284
050,30,081,"Montana","Ravalli County",4,44,566,289,277
050,30,081,"Montana","Ravalli County",4,45,551,283,268
050,30,081,"Montana","Ravalli County",4,46,499,252,247
050,30,081,"Montana","Ravalli County",4,47,461,222,239
050,30,081,"Montana","Ravalli County",4,48,462,231,231
050,30,081,"Montana","Ravalli County",4,49,502,263,239
050,30,081,"Montana","Ravalli County",4,50,513,263,250
050,30,081,"Montana","Ravalli County",4,51,586,286,300
050,30,081,"Montana","Ravalli County",4,52,582,283,299
050,30,081,"Montana","Ravalli County",4,53,589,273,316
050,30,081,"Montana","Ravalli County",4,54,570,270,300
050,30,081,"Montana","Ravalli County",4,55,545,283,262
050,30,081,"Montana","Ravalli County",4,56,611,316,295
050,30,081,"Montana","Ravalli County",4,57,662,341,321
050,30,081,"Montana","Ravalli County",4,58,731,358,373
050,30,081,"Montana","Ravalli County",4,59,745,351,394
050,30,081,"Montana","Ravalli County",4,60,759,367,392
050,30,081,"Montana","Ravalli County",4,61,774,367,407
050,30,081,"Montana","Ravalli County",4,62,741,354,387
050,30,081,"Montana","Ravalli County",4,63,834,401,433
050,30,081,"Montana","Ravalli County",4,64,886,437,449
050,30,081,"Montana","Ravalli County",4,65,885,421,464
050,30,081,"Montana","Ravalli County",4,66,838,401,437
050,30,081,"Montana","Ravalli County",4,67,808,385,423
050,30,081,"Montana","Ravalli County",4,68,829,389,440
050,30,081,"Montana","Ravalli County",4,69,810,398,412
050,30,081,"Montana","Ravalli County",4,70,782,400,382
050,30,081,"Montana","Ravalli County",4,71,725,342,383
050,30,081,"Montana","Ravalli County",4,72,713,348,365
050,30,081,"Montana","Ravalli County",4,73,703,343,360
050,30,081,"Montana","Ravalli County",4,74,716,350,366
050,30,081,"Montana","Ravalli County",4,75,725,375,350
050,30,081,"Montana","Ravalli County",4,76,463,232,231
050,30,081,"Montana","Ravalli County",4,77,474,234,240
050,30,081,"Montana","Ravalli County",4,78,457,236,221
050,30,081,"Montana","Ravalli County",4,79,420,211,209
050,30,081,"Montana","Ravalli County",4,80,338,161,177
050,30,081,"Montana","Ravalli County",4,81,299,140,159
050,30,081,"Montana","Ravalli County",4,82,258,122,136
050,30,081,"Montana","Ravalli County",4,83,242,122,120
050,30,081,"Montana","Ravalli County",4,84,226,111,115
050,30,081,"Montana","Ravalli County",4,85,970,414,556
050,30,081,"Montana","Ravalli County",5,0,408,221,187
050,30,081,"Montana","Ravalli County",5,1,417,232,185
050,30,081,"Montana","Ravalli County",5,2,409,226,183
050,30,081,"Montana","Ravalli County",5,3,437,230,207
050,30,081,"Montana","Ravalli County",5,4,450,255,195
050,30,081,"Montana","Ravalli County",5,5,450,241,209
050,30,081,"Montana","Ravalli County",5,6,487,280,207
050,30,081,"Montana","Ravalli County",5,7,506,250,256
050,30,081,"Montana","Ravalli County",5,8,519,280,239
050,30,081,"Montana","Ravalli County",5,9,560,299,261
050,30,081,"Montana","Ravalli County",5,10,498,245,253
050,30,081,"Montana","Ravalli County",5,11,479,244,235
050,30,081,"Montana","Ravalli County",5,12,499,268,231
050,30,081,"Montana","Ravalli County",5,13,516,284,232
050,30,081,"Montana","Ravalli County",5,14,521,276,245
050,30,081,"Montana","Ravalli County",5,15,523,263,260
050,30,081,"Montana","Ravalli County",5,16,538,267,271
050,30,081,"Montana","Ravalli County",5,17,596,327,269
050,30,081,"Montana","Ravalli County",5,18,485,275,210
050,30,081,"Montana","Ravalli County",5,19,395,220,175
050,30,081,"Montana","Ravalli County",5,20,395,218,177
050,30,081,"Montana","Ravalli County",5,21,417,219,198
050,30,081,"Montana","Ravalli County",5,22,385,191,194
050,30,081,"Montana","Ravalli County",5,23,434,235,199
050,30,081,"Montana","Ravalli County",5,24,411,218,193
050,30,081,"Montana","Ravalli County",5,25,425,233,192
050,30,081,"Montana","Ravalli County",5,26,385,206,179
050,30,081,"Montana","Ravalli County",5,27,448,233,215
050,30,081,"Montana","Ravalli County",5,28,434,221,213
050,30,081,"Montana","Ravalli County",5,29,399,213,186
050,30,081,"Montana","Ravalli County",5,30,489,239,250
050,30,081,"Montana","Ravalli County",5,31,525,250,275
050,30,081,"Montana","Ravalli County",5,32,557,259,298
050,30,081,"Montana","Ravalli County",5,33,526,266,260
050,30,081,"Montana","Ravalli County",5,34,517,256,261
050,30,081,"Montana","Ravalli County",5,35,519,253,266
050,30,081,"Montana","Ravalli County",5,36,561,287,274
050,30,081,"Montana","Ravalli County",5,37,519,254,265
050,30,081,"Montana","Ravalli County",5,38,554,283,271
050,30,081,"Montana","Ravalli County",5,39,584,307,277
050,30,081,"Montana","Ravalli County",5,40,570,306,264
050,30,081,"Montana","Ravalli County",5,41,577,289,288
050,30,081,"Montana","Ravalli County",5,42,562,275,287
050,30,081,"Montana","Ravalli County",5,43,601,296,305
050,30,081,"Montana","Ravalli County",5,44,560,281,279
050,30,081,"Montana","Ravalli County",5,45,577,306,271
050,30,081,"Montana","Ravalli County",5,46,556,281,275
050,30,081,"Montana","Ravalli County",5,47,518,260,258
050,30,081,"Montana","Ravalli County",5,48,457,219,238
050,30,081,"Montana","Ravalli County",5,49,467,235,232
050,30,081,"Montana","Ravalli County",5,50,510,268,242
050,30,081,"Montana","Ravalli County",5,51,528,270,258
050,30,081,"Montana","Ravalli County",5,52,587,294,293
050,30,081,"Montana","Ravalli County",5,53,599,291,308
050,30,081,"Montana","Ravalli County",5,54,603,277,326
050,30,081,"Montana","Ravalli County",5,55,584,274,310
050,30,081,"Montana","Ravalli County",5,56,551,283,268
050,30,081,"Montana","Ravalli County",5,57,624,321,303
050,30,081,"Montana","Ravalli County",5,58,674,345,329
050,30,081,"Montana","Ravalli County",5,59,758,372,386
050,30,081,"Montana","Ravalli County",5,60,757,358,399
050,30,081,"Montana","Ravalli County",5,61,803,382,421
050,30,081,"Montana","Ravalli County",5,62,800,382,418
050,30,081,"Montana","Ravalli County",5,63,762,364,398
050,30,081,"Montana","Ravalli County",5,64,836,394,442
050,30,081,"Montana","Ravalli County",5,65,885,432,453
050,30,081,"Montana","Ravalli County",5,66,887,419,468
050,30,081,"Montana","Ravalli County",5,67,837,400,437
050,30,081,"Montana","Ravalli County",5,68,805,386,419
050,30,081,"Montana","Ravalli County",5,69,833,388,445
050,30,081,"Montana","Ravalli County",5,70,800,393,407
050,30,081,"Montana","Ravalli County",5,71,782,402,380
050,30,081,"Montana","Ravalli County",5,72,720,337,383
050,30,081,"Montana","Ravalli County",5,73,706,346,360
050,30,081,"Montana","Ravalli County",5,74,692,337,355
050,30,081,"Montana","Ravalli County",5,75,680,330,350
050,30,081,"Montana","Ravalli County",5,76,697,359,338
050,30,081,"Montana","Ravalli County",5,77,442,215,227
050,30,081,"Montana","Ravalli County",5,78,452,219,233
050,30,081,"Montana","Ravalli County",5,79,442,220,222
050,30,081,"Montana","Ravalli County",5,80,409,203,206
050,30,081,"Montana","Ravalli County",5,81,312,148,164
050,30,081,"Montana","Ravalli County",5,82,276,125,151
050,30,081,"Montana","Ravalli County",5,83,232,109,123
050,30,081,"Montana","Ravalli County",5,84,225,112,113
050,30,081,"Montana","Ravalli County",5,85,1026,443,583
050,30,083,"Montana","Richland County",1,0,159,81,78
050,30,083,"Montana","Richland County",1,1,146,75,71
050,30,083,"Montana","Richland County",1,2,131,82,49
050,30,083,"Montana","Richland County",1,3,160,80,80
050,30,083,"Montana","Richland County",1,4,159,88,71
050,30,083,"Montana","Richland County",1,5,168,91,77
050,30,083,"Montana","Richland County",1,6,176,89,87
050,30,083,"Montana","Richland County",1,7,185,90,95
050,30,083,"Montana","Richland County",1,8,155,75,80
050,30,083,"Montana","Richland County",1,9,178,85,93
050,30,083,"Montana","Richland County",1,10,162,75,87
050,30,083,"Montana","Richland County",1,11,167,86,81
050,30,083,"Montana","Richland County",1,12,199,103,96
050,30,083,"Montana","Richland County",1,13,165,81,84
050,30,083,"Montana","Richland County",1,14,159,84,75
050,30,083,"Montana","Richland County",1,15,164,75,89
050,30,083,"Montana","Richland County",1,16,161,85,76
050,30,083,"Montana","Richland County",1,17,149,73,76
050,30,083,"Montana","Richland County",1,18,118,60,58
050,30,083,"Montana","Richland County",1,19,99,52,47
050,30,083,"Montana","Richland County",1,20,104,60,44
050,30,083,"Montana","Richland County",1,21,115,62,53
050,30,083,"Montana","Richland County",1,22,131,69,62
050,30,083,"Montana","Richland County",1,23,127,68,59
050,30,083,"Montana","Richland County",1,24,126,66,60
050,30,083,"Montana","Richland County",1,25,152,85,67
050,30,083,"Montana","Richland County",1,26,147,79,68
050,30,083,"Montana","Richland County",1,27,163,90,73
050,30,083,"Montana","Richland County",1,28,170,87,83
050,30,083,"Montana","Richland County",1,29,176,92,84
050,30,083,"Montana","Richland County",1,30,161,81,80
050,30,083,"Montana","Richland County",1,31,153,82,71
050,30,083,"Montana","Richland County",1,32,139,81,58
050,30,083,"Montana","Richland County",1,33,133,68,65
050,30,083,"Montana","Richland County",1,34,146,74,72
050,30,083,"Montana","Richland County",1,35,144,76,68
050,30,083,"Montana","Richland County",1,36,155,94,61
050,30,083,"Montana","Richland County",1,37,149,78,71
050,30,083,"Montana","Richland County",1,38,149,77,72
050,30,083,"Montana","Richland County",1,39,164,81,83
050,30,083,"Montana","Richland County",1,40,142,73,69
050,30,083,"Montana","Richland County",1,41,145,69,76
050,30,083,"Montana","Richland County",1,42,145,73,72
050,30,083,"Montana","Richland County",1,43,137,77,60
050,30,083,"Montana","Richland County",1,44,130,67,63
050,30,083,"Montana","Richland County",1,45,136,72,64
050,30,083,"Montana","Richland County",1,46,144,77,67
050,30,083,"Montana","Richland County",1,47,134,73,61
050,30,083,"Montana","Richland County",1,48,134,76,58
050,30,083,"Montana","Richland County",1,49,150,81,69
050,30,083,"Montana","Richland County",1,50,135,68,67
050,30,083,"Montana","Richland County",1,51,111,49,62
050,30,083,"Montana","Richland County",1,52,133,70,63
050,30,083,"Montana","Richland County",1,53,136,67,69
050,30,083,"Montana","Richland County",1,54,127,64,63
050,30,083,"Montana","Richland County",1,55,150,78,72
050,30,083,"Montana","Richland County",1,56,146,73,73
050,30,083,"Montana","Richland County",1,57,146,80,66
050,30,083,"Montana","Richland County",1,58,169,99,70
050,30,083,"Montana","Richland County",1,59,161,88,73
050,30,083,"Montana","Richland County",1,60,165,90,75
050,30,083,"Montana","Richland County",1,61,178,95,83
050,30,083,"Montana","Richland County",1,62,164,81,83
050,30,083,"Montana","Richland County",1,63,162,82,80
050,30,083,"Montana","Richland County",1,64,163,92,71
050,30,083,"Montana","Richland County",1,65,122,74,48
050,30,083,"Montana","Richland County",1,66,140,82,58
050,30,083,"Montana","Richland County",1,67,141,73,68
050,30,083,"Montana","Richland County",1,68,126,67,59
050,30,083,"Montana","Richland County",1,69,94,56,38
050,30,083,"Montana","Richland County",1,70,88,46,42
050,30,083,"Montana","Richland County",1,71,101,57,44
050,30,083,"Montana","Richland County",1,72,104,53,51
050,30,083,"Montana","Richland County",1,73,88,44,44
050,30,083,"Montana","Richland County",1,74,71,32,39
050,30,083,"Montana","Richland County",1,75,71,38,33
050,30,083,"Montana","Richland County",1,76,68,31,37
050,30,083,"Montana","Richland County",1,77,71,33,38
050,30,083,"Montana","Richland County",1,78,53,27,26
050,30,083,"Montana","Richland County",1,79,48,23,25
050,30,083,"Montana","Richland County",1,80,43,20,23
050,30,083,"Montana","Richland County",1,81,38,22,16
050,30,083,"Montana","Richland County",1,82,41,23,18
050,30,083,"Montana","Richland County",1,83,37,20,17
050,30,083,"Montana","Richland County",1,84,35,18,17
050,30,083,"Montana","Richland County",1,85,207,89,118
050,30,083,"Montana","Richland County",2,0,166,84,82
050,30,083,"Montana","Richland County",2,1,147,76,71
050,30,083,"Montana","Richland County",2,2,137,81,56
050,30,083,"Montana","Richland County",2,3,150,79,71
050,30,083,"Montana","Richland County",2,4,161,86,75
050,30,083,"Montana","Richland County",2,5,166,91,75
050,30,083,"Montana","Richland County",2,6,177,92,85
050,30,083,"Montana","Richland County",2,7,184,89,95
050,30,083,"Montana","Richland County",2,8,164,80,84
050,30,083,"Montana","Richland County",2,9,175,84,91
050,30,083,"Montana","Richland County",2,10,165,77,88
050,30,083,"Montana","Richland County",2,11,167,84,83
050,30,083,"Montana","Richland County",2,12,193,100,93
050,30,083,"Montana","Richland County",2,13,172,86,86
050,30,083,"Montana","Richland County",2,14,160,82,78
050,30,083,"Montana","Richland County",2,15,166,80,86
050,30,083,"Montana","Richland County",2,16,163,82,81
050,30,083,"Montana","Richland County",2,17,151,75,76
050,30,083,"Montana","Richland County",2,18,118,60,58
050,30,083,"Montana","Richland County",2,19,97,51,46
050,30,083,"Montana","Richland County",2,20,106,60,46
050,30,083,"Montana","Richland County",2,21,117,63,54
050,30,083,"Montana","Richland County",2,22,131,69,62
050,30,083,"Montana","Richland County",2,23,127,67,60
050,30,083,"Montana","Richland County",2,24,130,68,62
050,30,083,"Montana","Richland County",2,25,149,82,67
050,30,083,"Montana","Richland County",2,26,152,83,69
050,30,083,"Montana","Richland County",2,27,160,87,73
050,30,083,"Montana","Richland County",2,28,169,87,82
050,30,083,"Montana","Richland County",2,29,176,92,84
050,30,083,"Montana","Richland County",2,30,166,85,81
050,30,083,"Montana","Richland County",2,31,154,81,73
050,30,083,"Montana","Richland County",2,32,142,80,62
050,30,083,"Montana","Richland County",2,33,136,72,64
050,30,083,"Montana","Richland County",2,34,141,72,69
050,30,083,"Montana","Richland County",2,35,146,78,68
050,30,083,"Montana","Richland County",2,36,150,88,62
050,30,083,"Montana","Richland County",2,37,151,82,69
050,30,083,"Montana","Richland County",2,38,152,79,73
050,30,083,"Montana","Richland County",2,39,161,80,81
050,30,083,"Montana","Richland County",2,40,148,75,73
050,30,083,"Montana","Richland County",2,41,143,68,75
050,30,083,"Montana","Richland County",2,42,144,72,72
050,30,083,"Montana","Richland County",2,43,141,77,64
050,30,083,"Montana","Richland County",2,44,130,68,62
050,30,083,"Montana","Richland County",2,45,138,73,65
050,30,083,"Montana","Richland County",2,46,141,75,66
050,30,083,"Montana","Richland County",2,47,135,73,62
050,30,083,"Montana","Richland County",2,48,134,75,59
050,30,083,"Montana","Richland County",2,49,148,81,67
050,30,083,"Montana","Richland County",2,50,135,70,65
050,30,083,"Montana","Richland County",2,51,117,54,63
050,30,083,"Montana","Richland County",2,52,125,63,62
050,30,083,"Montana","Richland County",2,53,135,68,67
050,30,083,"Montana","Richland County",2,54,129,65,64
050,30,083,"Montana","Richland County",2,55,143,74,69
050,30,083,"Montana","Richland County",2,56,147,76,71
050,30,083,"Montana","Richland County",2,57,147,80,67
050,30,083,"Montana","Richland County",2,58,164,95,69
050,30,083,"Montana","Richland County",2,59,163,91,72
050,30,083,"Montana","Richland County",2,60,163,89,74
050,30,083,"Montana","Richland County",2,61,173,93,80
050,30,083,"Montana","Richland County",2,62,165,83,82
050,30,083,"Montana","Richland County",2,63,161,81,80
050,30,083,"Montana","Richland County",2,64,161,88,73
050,30,083,"Montana","Richland County",2,65,130,77,53
050,30,083,"Montana","Richland County",2,66,135,79,56
050,30,083,"Montana","Richland County",2,67,139,74,65
050,30,083,"Montana","Richland County",2,68,128,68,60
050,30,083,"Montana","Richland County",2,69,102,58,44
050,30,083,"Montana","Richland County",2,70,89,48,41
050,30,083,"Montana","Richland County",2,71,99,54,45
050,30,083,"Montana","Richland County",2,72,101,53,48
050,30,083,"Montana","Richland County",2,73,96,48,48
050,30,083,"Montana","Richland County",2,74,72,34,38
050,30,083,"Montana","Richland County",2,75,70,37,33
050,30,083,"Montana","Richland County",2,76,68,32,36
050,30,083,"Montana","Richland County",2,77,72,33,39
050,30,083,"Montana","Richland County",2,78,56,28,28
050,30,083,"Montana","Richland County",2,79,48,24,24
050,30,083,"Montana","Richland County",2,80,44,21,23
050,30,083,"Montana","Richland County",2,81,39,21,18
050,30,083,"Montana","Richland County",2,82,38,22,16
050,30,083,"Montana","Richland County",2,83,37,20,17
050,30,083,"Montana","Richland County",2,84,36,19,17
050,30,083,"Montana","Richland County",2,85,210,92,118
050,30,083,"Montana","Richland County",3,0,144,73,71
050,30,083,"Montana","Richland County",3,1,169,79,90
050,30,083,"Montana","Richland County",3,2,146,76,70
050,30,083,"Montana","Richland County",3,3,119,75,44
050,30,083,"Montana","Richland County",3,4,142,74,68
050,30,083,"Montana","Richland County",3,5,161,86,75
050,30,083,"Montana","Richland County",3,6,156,86,70
050,30,083,"Montana","Richland County",3,7,174,91,83
050,30,083,"Montana","Richland County",3,8,178,85,93
050,30,083,"Montana","Richland County",3,9,167,86,81
050,30,083,"Montana","Richland County",3,10,162,82,80
050,30,083,"Montana","Richland County",3,11,154,71,83
050,30,083,"Montana","Richland County",3,12,165,77,88
050,30,083,"Montana","Richland County",3,13,176,90,86
050,30,083,"Montana","Richland County",3,14,172,86,86
050,30,083,"Montana","Richland County",3,15,149,76,73
050,30,083,"Montana","Richland County",3,16,170,86,84
050,30,083,"Montana","Richland County",3,17,154,78,76
050,30,083,"Montana","Richland County",3,18,132,68,64
050,30,083,"Montana","Richland County",3,19,99,53,46
050,30,083,"Montana","Richland County",3,20,101,53,48
050,30,083,"Montana","Richland County",3,21,111,62,49
050,30,083,"Montana","Richland County",3,22,128,63,65
050,30,083,"Montana","Richland County",3,23,139,69,70
050,30,083,"Montana","Richland County",3,24,132,64,68
050,30,083,"Montana","Richland County",3,25,132,68,64
050,30,083,"Montana","Richland County",3,26,151,83,68
050,30,083,"Montana","Richland County",3,27,143,79,64
050,30,083,"Montana","Richland County",3,28,131,70,61
050,30,083,"Montana","Richland County",3,29,163,77,86
050,30,083,"Montana","Richland County",3,30,173,90,83
050,30,083,"Montana","Richland County",3,31,155,83,72
050,30,083,"Montana","Richland County",3,32,160,84,76
050,30,083,"Montana","Richland County",3,33,129,77,52
050,30,083,"Montana","Richland County",3,34,140,78,62
050,30,083,"Montana","Richland County",3,35,135,66,69
050,30,083,"Montana","Richland County",3,36,141,70,71
050,30,083,"Montana","Richland County",3,37,154,92,62
050,30,083,"Montana","Richland County",3,38,147,79,68
050,30,083,"Montana","Richland County",3,39,156,79,77
050,30,083,"Montana","Richland County",3,40,151,75,76
050,30,083,"Montana","Richland County",3,41,145,72,73
050,30,083,"Montana","Richland County",3,42,141,68,73
050,30,083,"Montana","Richland County",3,43,135,69,66
050,30,083,"Montana","Richland County",3,44,139,79,60
050,30,083,"Montana","Richland County",3,45,123,67,56
050,30,083,"Montana","Richland County",3,46,141,72,69
050,30,083,"Montana","Richland County",3,47,132,67,65
050,30,083,"Montana","Richland County",3,48,125,71,54
050,30,083,"Montana","Richland County",3,49,123,70,53
050,30,083,"Montana","Richland County",3,50,145,78,67
050,30,083,"Montana","Richland County",3,51,135,72,63
050,30,083,"Montana","Richland County",3,52,109,46,63
050,30,083,"Montana","Richland County",3,53,127,66,61
050,30,083,"Montana","Richland County",3,54,133,65,68
050,30,083,"Montana","Richland County",3,55,122,60,62
050,30,083,"Montana","Richland County",3,56,144,73,71
050,30,083,"Montana","Richland County",3,57,149,76,73
050,30,083,"Montana","Richland County",3,58,141,79,62
050,30,083,"Montana","Richland County",3,59,158,93,65
050,30,083,"Montana","Richland County",3,60,160,89,71
050,30,083,"Montana","Richland County",3,61,160,85,75
050,30,083,"Montana","Richland County",3,62,173,89,84
050,30,083,"Montana","Richland County",3,63,165,83,82
050,30,083,"Montana","Richland County",3,64,162,80,82
050,30,083,"Montana","Richland County",3,65,162,88,74
050,30,083,"Montana","Richland County",3,66,128,76,52
050,30,083,"Montana","Richland County",3,67,132,75,57
050,30,083,"Montana","Richland County",3,68,138,73,65
050,30,083,"Montana","Richland County",3,69,125,67,58
050,30,083,"Montana","Richland County",3,70,99,56,43
050,30,083,"Montana","Richland County",3,71,86,45,41
050,30,083,"Montana","Richland County",3,72,97,49,48
050,30,083,"Montana","Richland County",3,73,97,50,47
050,30,083,"Montana","Richland County",3,74,92,45,47
050,30,083,"Montana","Richland County",3,75,64,29,35
050,30,083,"Montana","Richland County",3,76,66,35,31
050,30,083,"Montana","Richland County",3,77,66,31,35
050,30,083,"Montana","Richland County",3,78,65,28,37
050,30,083,"Montana","Richland County",3,79,51,27,24
050,30,083,"Montana","Richland County",3,80,45,22,23
050,30,083,"Montana","Richland County",3,81,42,20,22
050,30,083,"Montana","Richland County",3,82,36,20,16
050,30,083,"Montana","Richland County",3,83,39,22,17
050,30,083,"Montana","Richland County",3,84,36,20,16
050,30,083,"Montana","Richland County",3,85,215,97,118
050,30,083,"Montana","Richland County",4,0,144,73,71
050,30,083,"Montana","Richland County",4,1,148,74,74
050,30,083,"Montana","Richland County",4,2,166,78,88
050,30,083,"Montana","Richland County",4,3,136,71,65
050,30,083,"Montana","Richland County",4,4,119,68,51
050,30,083,"Montana","Richland County",4,5,133,72,61
050,30,083,"Montana","Richland County",4,6,162,85,77
050,30,083,"Montana","Richland County",4,7,156,85,71
050,30,083,"Montana","Richland County",4,8,161,88,73
050,30,083,"Montana","Richland County",4,9,191,107,84
050,30,083,"Montana","Richland County",4,10,155,80,75
050,30,083,"Montana","Richland County",4,11,169,85,84
050,30,083,"Montana","Richland County",4,12,152,68,84
050,30,083,"Montana","Richland County",4,13,157,70,87
050,30,083,"Montana","Richland County",4,14,181,92,89
050,30,083,"Montana","Richland County",4,15,172,87,85
050,30,083,"Montana","Richland County",4,16,144,73,71
050,30,083,"Montana","Richland County",4,17,168,81,87
050,30,083,"Montana","Richland County",4,18,137,71,66
050,30,083,"Montana","Richland County",4,19,105,54,51
050,30,083,"Montana","Richland County",4,20,101,55,46
050,30,083,"Montana","Richland County",4,21,107,54,53
050,30,083,"Montana","Richland County",4,22,112,60,52
050,30,083,"Montana","Richland County",4,23,126,60,66
050,30,083,"Montana","Richland County",4,24,133,68,65
050,30,083,"Montana","Richland County",4,25,142,68,74
050,30,083,"Montana","Richland County",4,26,129,64,65
050,30,083,"Montana","Richland County",4,27,141,80,61
050,30,083,"Montana","Richland County",4,28,131,71,60
050,30,083,"Montana","Richland County",4,29,131,67,64
050,30,083,"Montana","Richland County",4,30,161,76,85
050,30,083,"Montana","Richland County",4,31,183,105,78
050,30,083,"Montana","Richland County",4,32,155,87,68
050,30,083,"Montana","Richland County",4,33,148,79,69
050,30,083,"Montana","Richland County",4,34,128,76,52
050,30,083,"Montana","Richland County",4,35,148,84,64
050,30,083,"Montana","Richland County",4,36,134,65,69
050,30,083,"Montana","Richland County",4,37,139,69,70
050,30,083,"Montana","Richland County",4,38,149,91,58
050,30,083,"Montana","Richland County",4,39,150,83,67
050,30,083,"Montana","Richland County",4,40,148,70,78
050,30,083,"Montana","Richland County",4,41,152,78,74
050,30,083,"Montana","Richland County",4,42,147,72,75
050,30,083,"Montana","Richland County",4,43,138,66,72
050,30,083,"Montana","Richland County",4,44,132,69,63
050,30,083,"Montana","Richland County",4,45,141,81,60
050,30,083,"Montana","Richland County",4,46,127,71,56
050,30,083,"Montana","Richland County",4,47,151,75,76
050,30,083,"Montana","Richland County",4,48,135,71,64
050,30,083,"Montana","Richland County",4,49,123,70,53
050,30,083,"Montana","Richland County",4,50,124,71,53
050,30,083,"Montana","Richland County",4,51,144,78,66
050,30,083,"Montana","Richland County",4,52,134,69,65
050,30,083,"Montana","Richland County",4,53,107,47,60
050,30,083,"Montana","Richland County",4,54,123,63,60
050,30,083,"Montana","Richland County",4,55,137,65,72
050,30,083,"Montana","Richland County",4,56,119,60,59
050,30,083,"Montana","Richland County",4,57,139,72,67
050,30,083,"Montana","Richland County",4,58,147,74,73
050,30,083,"Montana","Richland County",4,59,144,79,65
050,30,083,"Montana","Richland County",4,60,156,90,66
050,30,083,"Montana","Richland County",4,61,159,88,71
050,30,083,"Montana","Richland County",4,62,159,85,74
050,30,083,"Montana","Richland County",4,63,169,90,79
050,30,083,"Montana","Richland County",4,64,163,82,81
050,30,083,"Montana","Richland County",4,65,160,78,82
050,30,083,"Montana","Richland County",4,66,153,84,69
050,30,083,"Montana","Richland County",4,67,125,72,53
050,30,083,"Montana","Richland County",4,68,130,76,54
050,30,083,"Montana","Richland County",4,69,137,73,64
050,30,083,"Montana","Richland County",4,70,112,56,56
050,30,083,"Montana","Richland County",4,71,95,53,42
050,30,083,"Montana","Richland County",4,72,82,43,39
050,30,083,"Montana","Richland County",4,73,94,48,46
050,30,083,"Montana","Richland County",4,74,91,45,46
050,30,083,"Montana","Richland County",4,75,83,40,43
050,30,083,"Montana","Richland County",4,76,62,28,34
050,30,083,"Montana","Richland County",4,77,63,34,29
050,30,083,"Montana","Richland County",4,78,63,32,31
050,30,083,"Montana","Richland County",4,79,58,26,32
050,30,083,"Montana","Richland County",4,80,48,25,23
050,30,083,"Montana","Richland County",4,81,42,19,23
050,30,083,"Montana","Richland County",4,82,41,20,21
050,30,083,"Montana","Richland County",4,83,33,19,14
050,30,083,"Montana","Richland County",4,84,38,22,16
050,30,083,"Montana","Richland County",4,85,198,95,103
050,30,083,"Montana","Richland County",5,0,144,73,71
050,30,083,"Montana","Richland County",5,1,133,66,67
050,30,083,"Montana","Richland County",5,2,156,78,78
050,30,083,"Montana","Richland County",5,3,160,74,86
050,30,083,"Montana","Richland County",5,4,145,73,72
050,30,083,"Montana","Richland County",5,5,124,76,48
050,30,083,"Montana","Richland County",5,6,138,78,60
050,30,083,"Montana","Richland County",5,7,159,85,74
050,30,083,"Montana","Richland County",5,8,166,90,76
050,30,083,"Montana","Richland County",5,9,167,94,73
050,30,083,"Montana","Richland County",5,10,194,111,83
050,30,083,"Montana","Richland County",5,11,153,82,71
050,30,083,"Montana","Richland County",5,12,172,85,87
050,30,083,"Montana","Richland County",5,13,150,67,83
050,30,083,"Montana","Richland County",5,14,159,71,88
050,30,083,"Montana","Richland County",5,15,180,90,90
050,30,083,"Montana","Richland County",5,16,171,85,86
050,30,083,"Montana","Richland County",5,17,144,75,69
050,30,083,"Montana","Richland County",5,18,139,69,70
050,30,083,"Montana","Richland County",5,19,101,53,48
050,30,083,"Montana","Richland County",5,20,103,52,51
050,30,083,"Montana","Richland County",5,21,108,55,53
050,30,083,"Montana","Richland County",5,22,102,56,46
050,30,083,"Montana","Richland County",5,23,110,61,49
050,30,083,"Montana","Richland County",5,24,128,65,63
050,30,083,"Montana","Richland County",5,25,130,68,62
050,30,083,"Montana","Richland County",5,26,138,65,73
050,30,083,"Montana","Richland County",5,27,123,60,63
050,30,083,"Montana","Richland County",5,28,143,78,65
050,30,083,"Montana","Richland County",5,29,131,69,62
050,30,083,"Montana","Richland County",5,30,124,66,58
050,30,083,"Montana","Richland County",5,31,169,83,86
050,30,083,"Montana","Richland County",5,32,195,113,82
050,30,083,"Montana","Richland County",5,33,157,87,70
050,30,083,"Montana","Richland County",5,34,144,81,63
050,30,083,"Montana","Richland County",5,35,134,75,59
050,30,083,"Montana","Richland County",5,36,151,85,66
050,30,083,"Montana","Richland County",5,37,136,65,71
050,30,083,"Montana","Richland County",5,38,136,69,67
050,30,083,"Montana","Richland County",5,39,153,95,58
050,30,083,"Montana","Richland County",5,40,162,91,71
050,30,083,"Montana","Richland County",5,41,142,70,72
050,30,083,"Montana","Richland County",5,42,152,79,73
050,30,083,"Montana","Richland County",5,43,153,76,77
050,30,083,"Montana","Richland County",5,44,130,63,67
050,30,083,"Montana","Richland County",5,45,130,67,63
050,30,083,"Montana","Richland County",5,46,133,77,56
050,30,083,"Montana","Richland County",5,47,118,64,54
050,30,083,"Montana","Richland County",5,48,143,71,72
050,30,083,"Montana","Richland County",5,49,132,71,61
050,30,083,"Montana","Richland County",5,50,123,67,56
050,30,083,"Montana","Richland County",5,51,121,69,52
050,30,083,"Montana","Richland County",5,52,138,75,63
050,30,083,"Montana","Richland County",5,53,135,70,65
050,30,083,"Montana","Richland County",5,54,102,45,57
050,30,083,"Montana","Richland County",5,55,115,60,55
050,30,083,"Montana","Richland County",5,56,135,65,70
050,30,083,"Montana","Richland County",5,57,126,64,62
050,30,083,"Montana","Richland County",5,58,137,71,66
050,30,083,"Montana","Richland County",5,59,142,75,67
050,30,083,"Montana","Richland County",5,60,141,79,62
050,30,083,"Montana","Richland County",5,61,152,84,68
050,30,083,"Montana","Richland County",5,62,151,84,67
050,30,083,"Montana","Richland County",5,63,155,82,73
050,30,083,"Montana","Richland County",5,64,166,88,78
050,30,083,"Montana","Richland County",5,65,160,80,80
050,30,083,"Montana","Richland County",5,66,155,73,82
050,30,083,"Montana","Richland County",5,67,148,78,70
050,30,083,"Montana","Richland County",5,68,125,73,52
050,30,083,"Montana","Richland County",5,69,127,75,52
050,30,083,"Montana","Richland County",5,70,131,66,65
050,30,083,"Montana","Richland County",5,71,109,54,55
050,30,083,"Montana","Richland County",5,72,90,50,40
050,30,083,"Montana","Richland County",5,73,80,40,40
050,30,083,"Montana","Richland County",5,74,90,46,44
050,30,083,"Montana","Richland County",5,75,81,41,40
050,30,083,"Montana","Richland County",5,76,83,39,44
050,30,083,"Montana","Richland County",5,77,60,27,33
050,30,083,"Montana","Richland County",5,78,59,34,25
050,30,083,"Montana","Richland County",5,79,59,32,27
050,30,083,"Montana","Richland County",5,80,54,24,30
050,30,083,"Montana","Richland County",5,81,43,22,21
050,30,083,"Montana","Richland County",5,82,40,17,23
050,30,083,"Montana","Richland County",5,83,40,19,21
050,30,083,"Montana","Richland County",5,84,32,19,13
050,30,083,"Montana","Richland County",5,85,203,103,100
050,30,085,"Montana","Roosevelt County",1,0,192,97,95
050,30,085,"Montana","Roosevelt County",1,1,168,85,83
050,30,085,"Montana","Roosevelt County",1,2,199,99,100
050,30,085,"Montana","Roosevelt County",1,3,224,117,107
050,30,085,"Montana","Roosevelt County",1,4,221,120,101
050,30,085,"Montana","Roosevelt County",1,5,207,101,106
050,30,085,"Montana","Roosevelt County",1,6,217,117,100
050,30,085,"Montana","Roosevelt County",1,7,208,119,89
050,30,085,"Montana","Roosevelt County",1,8,192,106,86
050,30,085,"Montana","Roosevelt County",1,9,188,97,91
050,30,085,"Montana","Roosevelt County",1,10,205,99,106
050,30,085,"Montana","Roosevelt County",1,11,209,112,97
050,30,085,"Montana","Roosevelt County",1,12,216,100,116
050,30,085,"Montana","Roosevelt County",1,13,199,96,103
050,30,085,"Montana","Roosevelt County",1,14,191,103,88
050,30,085,"Montana","Roosevelt County",1,15,202,99,103
050,30,085,"Montana","Roosevelt County",1,16,175,90,85
050,30,085,"Montana","Roosevelt County",1,17,180,83,97
050,30,085,"Montana","Roosevelt County",1,18,156,77,79
050,30,085,"Montana","Roosevelt County",1,19,147,80,67
050,30,085,"Montana","Roosevelt County",1,20,130,66,64
050,30,085,"Montana","Roosevelt County",1,21,129,66,63
050,30,085,"Montana","Roosevelt County",1,22,132,73,59
050,30,085,"Montana","Roosevelt County",1,23,131,71,60
050,30,085,"Montana","Roosevelt County",1,24,134,73,61
050,30,085,"Montana","Roosevelt County",1,25,118,67,51
050,30,085,"Montana","Roosevelt County",1,26,124,57,67
050,30,085,"Montana","Roosevelt County",1,27,144,75,69
050,30,085,"Montana","Roosevelt County",1,28,140,76,64
050,30,085,"Montana","Roosevelt County",1,29,155,81,74
050,30,085,"Montana","Roosevelt County",1,30,158,72,86
050,30,085,"Montana","Roosevelt County",1,31,145,70,75
050,30,085,"Montana","Roosevelt County",1,32,157,83,74
050,30,085,"Montana","Roosevelt County",1,33,174,93,81
050,30,085,"Montana","Roosevelt County",1,34,139,73,66
050,30,085,"Montana","Roosevelt County",1,35,128,55,73
050,30,085,"Montana","Roosevelt County",1,36,136,63,73
050,30,085,"Montana","Roosevelt County",1,37,134,56,78
050,30,085,"Montana","Roosevelt County",1,38,135,52,83
050,30,085,"Montana","Roosevelt County",1,39,132,79,53
050,30,085,"Montana","Roosevelt County",1,40,121,72,49
050,30,085,"Montana","Roosevelt County",1,41,112,63,49
050,30,085,"Montana","Roosevelt County",1,42,101,55,46
050,30,085,"Montana","Roosevelt County",1,43,110,59,51
050,30,085,"Montana","Roosevelt County",1,44,106,54,52
050,30,085,"Montana","Roosevelt County",1,45,111,57,54
050,30,085,"Montana","Roosevelt County",1,46,111,53,58
050,30,085,"Montana","Roosevelt County",1,47,107,48,59
050,30,085,"Montana","Roosevelt County",1,48,101,52,49
050,30,085,"Montana","Roosevelt County",1,49,100,51,49
050,30,085,"Montana","Roosevelt County",1,50,91,45,46
050,30,085,"Montana","Roosevelt County",1,51,97,42,55
050,30,085,"Montana","Roosevelt County",1,52,92,49,43
050,30,085,"Montana","Roosevelt County",1,53,98,56,42
050,30,085,"Montana","Roosevelt County",1,54,101,53,48
050,30,085,"Montana","Roosevelt County",1,55,131,67,64
050,30,085,"Montana","Roosevelt County",1,56,134,67,67
050,30,085,"Montana","Roosevelt County",1,57,131,65,66
050,30,085,"Montana","Roosevelt County",1,58,135,73,62
050,30,085,"Montana","Roosevelt County",1,59,127,60,67
050,30,085,"Montana","Roosevelt County",1,60,129,61,68
050,30,085,"Montana","Roosevelt County",1,61,125,57,68
050,30,085,"Montana","Roosevelt County",1,62,129,53,76
050,30,085,"Montana","Roosevelt County",1,63,131,59,72
050,30,085,"Montana","Roosevelt County",1,64,141,65,76
050,30,085,"Montana","Roosevelt County",1,65,107,49,58
050,30,085,"Montana","Roosevelt County",1,66,98,48,50
050,30,085,"Montana","Roosevelt County",1,67,98,53,45
050,30,085,"Montana","Roosevelt County",1,68,96,46,50
050,30,085,"Montana","Roosevelt County",1,69,98,53,45
050,30,085,"Montana","Roosevelt County",1,70,76,37,39
050,30,085,"Montana","Roosevelt County",1,71,63,30,33
050,30,085,"Montana","Roosevelt County",1,72,65,27,38
050,30,085,"Montana","Roosevelt County",1,73,54,24,30
050,30,085,"Montana","Roosevelt County",1,74,41,18,23
050,30,085,"Montana","Roosevelt County",1,75,50,20,30
050,30,085,"Montana","Roosevelt County",1,76,44,22,22
050,30,085,"Montana","Roosevelt County",1,77,38,21,17
050,30,085,"Montana","Roosevelt County",1,78,35,20,15
050,30,085,"Montana","Roosevelt County",1,79,29,12,17
050,30,085,"Montana","Roosevelt County",1,80,28,15,13
050,30,085,"Montana","Roosevelt County",1,81,26,7,19
050,30,085,"Montana","Roosevelt County",1,82,28,15,13
050,30,085,"Montana","Roosevelt County",1,83,29,11,18
050,30,085,"Montana","Roosevelt County",1,84,20,8,12
050,30,085,"Montana","Roosevelt County",1,85,132,39,93
050,30,085,"Montana","Roosevelt County",2,0,192,97,95
050,30,085,"Montana","Roosevelt County",2,1,171,88,83
050,30,085,"Montana","Roosevelt County",2,2,190,95,95
050,30,085,"Montana","Roosevelt County",2,3,217,112,105
050,30,085,"Montana","Roosevelt County",2,4,220,118,102
050,30,085,"Montana","Roosevelt County",2,5,212,106,106
050,30,085,"Montana","Roosevelt County",2,6,217,114,103
050,30,085,"Montana","Roosevelt County",2,7,206,116,90
050,30,085,"Montana","Roosevelt County",2,8,200,112,88
050,30,085,"Montana","Roosevelt County",2,9,188,99,89
050,30,085,"Montana","Roosevelt County",2,10,201,99,102
050,30,085,"Montana","Roosevelt County",2,11,207,108,99
050,30,085,"Montana","Roosevelt County",2,12,215,104,111
050,30,085,"Montana","Roosevelt County",2,13,201,97,104
050,30,085,"Montana","Roosevelt County",2,14,194,102,92
050,30,085,"Montana","Roosevelt County",2,15,201,100,101
050,30,085,"Montana","Roosevelt County",2,16,182,93,89
050,30,085,"Montana","Roosevelt County",2,17,178,85,93
050,30,085,"Montana","Roosevelt County",2,18,156,75,81
050,30,085,"Montana","Roosevelt County",2,19,143,78,65
050,30,085,"Montana","Roosevelt County",2,20,133,67,66
050,30,085,"Montana","Roosevelt County",2,21,129,67,62
050,30,085,"Montana","Roosevelt County",2,22,136,75,61
050,30,085,"Montana","Roosevelt County",2,23,131,71,60
050,30,085,"Montana","Roosevelt County",2,24,134,73,61
050,30,085,"Montana","Roosevelt County",2,25,120,65,55
050,30,085,"Montana","Roosevelt County",2,26,122,60,62
050,30,085,"Montana","Roosevelt County",2,27,142,74,68
050,30,085,"Montana","Roosevelt County",2,28,140,74,66
050,30,085,"Montana","Roosevelt County",2,29,151,81,70
050,30,085,"Montana","Roosevelt County",2,30,157,75,82
050,30,085,"Montana","Roosevelt County",2,31,145,68,77
050,30,085,"Montana","Roosevelt County",2,32,155,82,73
050,30,085,"Montana","Roosevelt County",2,33,168,90,78
050,30,085,"Montana","Roosevelt County",2,34,149,78,71
050,30,085,"Montana","Roosevelt County",2,35,131,60,71
050,30,085,"Montana","Roosevelt County",2,36,136,62,74
050,30,085,"Montana","Roosevelt County",2,37,128,53,75
050,30,085,"Montana","Roosevelt County",2,38,135,53,82
050,30,085,"Montana","Roosevelt County",2,39,131,71,60
050,30,085,"Montana","Roosevelt County",2,40,125,74,51
050,30,085,"Montana","Roosevelt County",2,41,114,66,48
050,30,085,"Montana","Roosevelt County",2,42,101,55,46
050,30,085,"Montana","Roosevelt County",2,43,108,58,50
050,30,085,"Montana","Roosevelt County",2,44,106,54,52
050,30,085,"Montana","Roosevelt County",2,45,112,58,54
050,30,085,"Montana","Roosevelt County",2,46,108,52,56
050,30,085,"Montana","Roosevelt County",2,47,106,48,58
050,30,085,"Montana","Roosevelt County",2,48,102,52,50
050,30,085,"Montana","Roosevelt County",2,49,101,52,49
050,30,085,"Montana","Roosevelt County",2,50,90,44,46
050,30,085,"Montana","Roosevelt County",2,51,94,42,52
050,30,085,"Montana","Roosevelt County",2,52,93,47,46
050,30,085,"Montana","Roosevelt County",2,53,96,55,41
050,30,085,"Montana","Roosevelt County",2,54,100,53,47
050,30,085,"Montana","Roosevelt County",2,55,124,63,61
050,30,085,"Montana","Roosevelt County",2,56,133,67,66
050,30,085,"Montana","Roosevelt County",2,57,134,68,66
050,30,085,"Montana","Roosevelt County",2,58,135,71,64
050,30,085,"Montana","Roosevelt County",2,59,131,64,67
050,30,085,"Montana","Roosevelt County",2,60,130,62,68
050,30,085,"Montana","Roosevelt County",2,61,125,57,68
050,30,085,"Montana","Roosevelt County",2,62,128,54,74
050,30,085,"Montana","Roosevelt County",2,63,133,59,74
050,30,085,"Montana","Roosevelt County",2,64,138,63,75
050,30,085,"Montana","Roosevelt County",2,65,114,52,62
050,30,085,"Montana","Roosevelt County",2,66,99,48,51
050,30,085,"Montana","Roosevelt County",2,67,96,51,45
050,30,085,"Montana","Roosevelt County",2,68,96,47,49
050,30,085,"Montana","Roosevelt County",2,69,97,52,45
050,30,085,"Montana","Roosevelt County",2,70,81,41,40
050,30,085,"Montana","Roosevelt County",2,71,66,32,34
050,30,085,"Montana","Roosevelt County",2,72,65,27,38
050,30,085,"Montana","Roosevelt County",2,73,57,25,32
050,30,085,"Montana","Roosevelt County",2,74,42,19,23
050,30,085,"Montana","Roosevelt County",2,75,48,20,28
050,30,085,"Montana","Roosevelt County",2,76,45,22,23
050,30,085,"Montana","Roosevelt County",2,77,40,22,18
050,30,085,"Montana","Roosevelt County",2,78,36,21,15
050,30,085,"Montana","Roosevelt County",2,79,29,12,17
050,30,085,"Montana","Roosevelt County",2,80,24,12,12
050,30,085,"Montana","Roosevelt County",2,81,27,9,18
050,30,085,"Montana","Roosevelt County",2,82,27,15,12
050,30,085,"Montana","Roosevelt County",2,83,26,11,15
050,30,085,"Montana","Roosevelt County",2,84,23,8,15
050,30,085,"Montana","Roosevelt County",2,85,132,40,92
050,30,085,"Montana","Roosevelt County",3,0,166,95,71
050,30,085,"Montana","Roosevelt County",3,1,193,104,89
050,30,085,"Montana","Roosevelt County",3,2,169,92,77
050,30,085,"Montana","Roosevelt County",3,3,196,100,96
050,30,085,"Montana","Roosevelt County",3,4,215,110,105
050,30,085,"Montana","Roosevelt County",3,5,218,120,98
050,30,085,"Montana","Roosevelt County",3,6,222,114,108
050,30,085,"Montana","Roosevelt County",3,7,221,116,105
050,30,085,"Montana","Roosevelt County",3,8,206,115,91
050,30,085,"Montana","Roosevelt County",3,9,202,114,88
050,30,085,"Montana","Roosevelt County",3,10,191,102,89
050,30,085,"Montana","Roosevelt County",3,11,208,100,108
050,30,085,"Montana","Roosevelt County",3,12,209,112,97
050,30,085,"Montana","Roosevelt County",3,13,222,108,114
050,30,085,"Montana","Roosevelt County",3,14,216,104,112
050,30,085,"Montana","Roosevelt County",3,15,193,105,88
050,30,085,"Montana","Roosevelt County",3,16,203,101,102
050,30,085,"Montana","Roosevelt County",3,17,180,92,88
050,30,085,"Montana","Roosevelt County",3,18,164,78,86
050,30,085,"Montana","Roosevelt County",3,19,142,78,64
050,30,085,"Montana","Roosevelt County",3,20,137,64,73
050,30,085,"Montana","Roosevelt County",3,21,138,68,70
050,30,085,"Montana","Roosevelt County",3,22,136,73,63
050,30,085,"Montana","Roosevelt County",3,23,125,72,53
050,30,085,"Montana","Roosevelt County",3,24,139,79,60
050,30,085,"Montana","Roosevelt County",3,25,127,63,64
050,30,085,"Montana","Roosevelt County",3,26,115,64,51
050,30,085,"Montana","Roosevelt County",3,27,122,61,61
050,30,085,"Montana","Roosevelt County",3,28,140,70,70
050,30,085,"Montana","Roosevelt County",3,29,148,82,66
050,30,085,"Montana","Roosevelt County",3,30,158,80,78
050,30,085,"Montana","Roosevelt County",3,31,152,69,83
050,30,085,"Montana","Roosevelt County",3,32,143,71,72
050,30,085,"Montana","Roosevelt County",3,33,155,80,75
050,30,085,"Montana","Roosevelt County",3,34,165,90,75
050,30,085,"Montana","Roosevelt County",3,35,152,81,71
050,30,085,"Montana","Roosevelt County",3,36,145,65,80
050,30,085,"Montana","Roosevelt County",3,37,116,53,63
050,30,085,"Montana","Roosevelt County",3,38,134,58,76
050,30,085,"Montana","Roosevelt County",3,39,133,55,78
050,30,085,"Montana","Roosevelt County",3,40,132,68,64
050,30,085,"Montana","Roosevelt County",3,41,132,80,52
050,30,085,"Montana","Roosevelt County",3,42,111,62,49
050,30,085,"Montana","Roosevelt County",3,43,107,61,46
050,30,085,"Montana","Roosevelt County",3,44,101,53,48
050,30,085,"Montana","Roosevelt County",3,45,111,60,51
050,30,085,"Montana","Roosevelt County",3,46,104,53,51
050,30,085,"Montana","Roosevelt County",3,47,103,51,52
050,30,085,"Montana","Roosevelt County",3,48,101,44,57
050,30,085,"Montana","Roosevelt County",3,49,106,57,49
050,30,085,"Montana","Roosevelt County",3,50,92,45,47
050,30,085,"Montana","Roosevelt County",3,51,85,42,43
050,30,085,"Montana","Roosevelt County",3,52,91,39,52
050,30,085,"Montana","Roosevelt County",3,53,90,46,44
050,30,085,"Montana","Roosevelt County",3,54,97,55,42
050,30,085,"Montana","Roosevelt County",3,55,100,49,51
050,30,085,"Montana","Roosevelt County",3,56,122,62,60
050,30,085,"Montana","Roosevelt County",3,57,128,67,61
050,30,085,"Montana","Roosevelt County",3,58,134,65,69
050,30,085,"Montana","Roosevelt County",3,59,122,62,60
050,30,085,"Montana","Roosevelt County",3,60,130,66,64
050,30,085,"Montana","Roosevelt County",3,61,124,59,65
050,30,085,"Montana","Roosevelt County",3,62,120,54,66
050,30,085,"Montana","Roosevelt County",3,63,121,51,70
050,30,085,"Montana","Roosevelt County",3,64,128,59,69
050,30,085,"Montana","Roosevelt County",3,65,128,58,70
050,30,085,"Montana","Roosevelt County",3,66,104,48,56
050,30,085,"Montana","Roosevelt County",3,67,93,49,44
050,30,085,"Montana","Roosevelt County",3,68,96,50,46
050,30,085,"Montana","Roosevelt County",3,69,87,43,44
050,30,085,"Montana","Roosevelt County",3,70,93,50,43
050,30,085,"Montana","Roosevelt County",3,71,72,33,39
050,30,085,"Montana","Roosevelt County",3,72,60,24,36
050,30,085,"Montana","Roosevelt County",3,73,55,24,31
050,30,085,"Montana","Roosevelt County",3,74,54,22,32
050,30,085,"Montana","Roosevelt County",3,75,43,19,24
050,30,085,"Montana","Roosevelt County",3,76,43,18,25
050,30,085,"Montana","Roosevelt County",3,77,44,22,22
050,30,085,"Montana","Roosevelt County",3,78,35,22,13
050,30,085,"Montana","Roosevelt County",3,79,32,15,17
050,30,085,"Montana","Roosevelt County",3,80,21,9,12
050,30,085,"Montana","Roosevelt County",3,81,24,11,13
050,30,085,"Montana","Roosevelt County",3,82,24,11,13
050,30,085,"Montana","Roosevelt County",3,83,18,11,7
050,30,085,"Montana","Roosevelt County",3,84,24,7,17
050,30,085,"Montana","Roosevelt County",3,85,130,38,92
050,30,085,"Montana","Roosevelt County",4,0,152,74,78
050,30,085,"Montana","Roosevelt County",4,1,171,105,66
050,30,085,"Montana","Roosevelt County",4,2,189,103,86
050,30,085,"Montana","Roosevelt County",4,3,159,83,76
050,30,085,"Montana","Roosevelt County",4,4,189,101,88
050,30,085,"Montana","Roosevelt County",4,5,207,108,99
050,30,085,"Montana","Roosevelt County",4,6,216,120,96
050,30,085,"Montana","Roosevelt County",4,7,204,101,103
050,30,085,"Montana","Roosevelt County",4,8,212,112,100
050,30,085,"Montana","Roosevelt County",4,9,208,116,92
050,30,085,"Montana","Roosevelt County",4,10,186,105,81
050,30,085,"Montana","Roosevelt County",4,11,187,104,83
050,30,085,"Montana","Roosevelt County",4,12,197,94,103
050,30,085,"Montana","Roosevelt County",4,13,203,107,96
050,30,085,"Montana","Roosevelt County",4,14,225,105,120
050,30,085,"Montana","Roosevelt County",4,15,207,99,108
050,30,085,"Montana","Roosevelt County",4,16,199,111,88
050,30,085,"Montana","Roosevelt County",4,17,201,103,98
050,30,085,"Montana","Roosevelt County",4,18,158,82,76
050,30,085,"Montana","Roosevelt County",4,19,146,71,75
050,30,085,"Montana","Roosevelt County",4,20,126,61,65
050,30,085,"Montana","Roosevelt County",4,21,129,60,69
050,30,085,"Montana","Roosevelt County",4,22,158,80,78
050,30,085,"Montana","Roosevelt County",4,23,125,72,53
050,30,085,"Montana","Roosevelt County",4,24,132,74,58
050,30,085,"Montana","Roosevelt County",4,25,148,76,72
050,30,085,"Montana","Roosevelt County",4,26,120,60,60
050,30,085,"Montana","Roosevelt County",4,27,116,69,47
050,30,085,"Montana","Roosevelt County",4,28,110,51,59
050,30,085,"Montana","Roosevelt County",4,29,134,71,63
050,30,085,"Montana","Roosevelt County",4,30,151,81,70
050,30,085,"Montana","Roosevelt County",4,31,144,73,71
050,30,085,"Montana","Roosevelt County",4,32,155,75,80
050,30,085,"Montana","Roosevelt County",4,33,136,68,68
050,30,085,"Montana","Roosevelt County",4,34,148,75,73
050,30,085,"Montana","Roosevelt County",4,35,161,90,71
050,30,085,"Montana","Roosevelt County",4,36,149,76,73
050,30,085,"Montana","Roosevelt County",4,37,119,56,63
050,30,085,"Montana","Roosevelt County",4,38,109,50,59
050,30,085,"Montana","Roosevelt County",4,39,130,55,75
050,30,085,"Montana","Roosevelt County",4,40,127,50,77
050,30,085,"Montana","Roosevelt County",4,41,131,69,62
050,30,085,"Montana","Roosevelt County",4,42,128,76,52
050,30,085,"Montana","Roosevelt County",4,43,108,61,47
050,30,085,"Montana","Roosevelt County",4,44,106,58,48
050,30,085,"Montana","Roosevelt County",4,45,99,55,44
050,30,085,"Montana","Roosevelt County",4,46,101,54,47
050,30,085,"Montana","Roosevelt County",4,47,101,52,49
050,30,085,"Montana","Roosevelt County",4,48,99,51,48
050,30,085,"Montana","Roosevelt County",4,49,106,50,56
050,30,085,"Montana","Roosevelt County",4,50,102,52,50
050,30,085,"Montana","Roosevelt County",4,51,92,45,47
050,30,085,"Montana","Roosevelt County",4,52,82,38,44
050,30,085,"Montana","Roosevelt County",4,53,97,43,54
050,30,085,"Montana","Roosevelt County",4,54,83,40,43
050,30,085,"Montana","Roosevelt County",4,55,97,52,45
050,30,085,"Montana","Roosevelt County",4,56,102,52,50
050,30,085,"Montana","Roosevelt County",4,57,115,62,53
050,30,085,"Montana","Roosevelt County",4,58,118,60,58
050,30,085,"Montana","Roosevelt County",4,59,126,60,66
050,30,085,"Montana","Roosevelt County",4,60,126,66,60
050,30,085,"Montana","Roosevelt County",4,61,129,62,67
050,30,085,"Montana","Roosevelt County",4,62,119,56,63
050,30,085,"Montana","Roosevelt County",4,63,116,53,63
050,30,085,"Montana","Roosevelt County",4,64,113,48,65
050,30,085,"Montana","Roosevelt County",4,65,120,55,65
050,30,085,"Montana","Roosevelt County",4,66,122,55,67
050,30,085,"Montana","Roosevelt County",4,67,96,46,50
050,30,085,"Montana","Roosevelt County",4,68,93,48,45
050,30,085,"Montana","Roosevelt County",4,69,86,45,41
050,30,085,"Montana","Roosevelt County",4,70,82,40,42
050,30,085,"Montana","Roosevelt County",4,71,87,47,40
050,30,085,"Montana","Roosevelt County",4,72,70,30,40
050,30,085,"Montana","Roosevelt County",4,73,52,22,30
050,30,085,"Montana","Roosevelt County",4,74,55,25,30
050,30,085,"Montana","Roosevelt County",4,75,55,22,33
050,30,085,"Montana","Roosevelt County",4,76,38,17,21
050,30,085,"Montana","Roosevelt County",4,77,37,15,22
050,30,085,"Montana","Roosevelt County",4,78,45,23,22
050,30,085,"Montana","Roosevelt County",4,79,28,15,13
050,30,085,"Montana","Roosevelt County",4,80,23,12,11
050,30,085,"Montana","Roosevelt County",4,81,24,7,17
050,30,085,"Montana","Roosevelt County",4,82,23,14,9
050,30,085,"Montana","Roosevelt County",4,83,16,6,10
050,30,085,"Montana","Roosevelt County",4,84,15,7,8
050,30,085,"Montana","Roosevelt County",4,85,131,38,93
050,30,085,"Montana","Roosevelt County",5,0,144,70,74
050,30,085,"Montana","Roosevelt County",5,1,158,75,83
050,30,085,"Montana","Roosevelt County",5,2,174,109,65
050,30,085,"Montana","Roosevelt County",5,3,187,105,82
050,30,085,"Montana","Roosevelt County",5,4,153,81,72
050,30,085,"Montana","Roosevelt County",5,5,179,94,85
050,30,085,"Montana","Roosevelt County",5,6,211,110,101
050,30,085,"Montana","Roosevelt County",5,7,213,116,97
050,30,085,"Montana","Roosevelt County",5,8,192,97,95
050,30,085,"Montana","Roosevelt County",5,9,215,112,103
050,30,085,"Montana","Roosevelt County",5,10,205,117,88
050,30,085,"Montana","Roosevelt County",5,11,183,104,79
050,30,085,"Montana","Roosevelt County",5,12,187,104,83
050,30,085,"Montana","Roosevelt County",5,13,191,90,101
050,30,085,"Montana","Roosevelt County",5,14,205,110,95
050,30,085,"Montana","Roosevelt County",5,15,214,100,114
050,30,085,"Montana","Roosevelt County",5,16,202,97,105
050,30,085,"Montana","Roosevelt County",5,17,188,106,82
050,30,085,"Montana","Roosevelt County",5,18,181,95,86
050,30,085,"Montana","Roosevelt County",5,19,135,75,60
050,30,085,"Montana","Roosevelt County",5,20,131,58,73
050,30,085,"Montana","Roosevelt County",5,21,129,61,68
050,30,085,"Montana","Roosevelt County",5,22,145,69,76
050,30,085,"Montana","Roosevelt County",5,23,143,72,71
050,30,085,"Montana","Roosevelt County",5,24,134,79,55
050,30,085,"Montana","Roosevelt County",5,25,130,64,66
050,30,085,"Montana","Roosevelt County",5,26,135,69,66
050,30,085,"Montana","Roosevelt County",5,27,124,66,58
050,30,085,"Montana","Roosevelt County",5,28,117,61,56
050,30,085,"Montana","Roosevelt County",5,29,111,56,55
050,30,085,"Montana","Roosevelt County",5,30,133,71,62
050,30,085,"Montana","Roosevelt County",5,31,140,73,67
050,30,085,"Montana","Roosevelt County",5,32,148,77,71
050,30,085,"Montana","Roosevelt County",5,33,147,67,80
050,30,085,"Montana","Roosevelt County",5,34,126,65,61
050,30,085,"Montana","Roosevelt County",5,35,145,75,70
050,30,085,"Montana","Roosevelt County",5,36,173,94,79
050,30,085,"Montana","Roosevelt County",5,37,133,70,63
050,30,085,"Montana","Roosevelt County",5,38,119,56,63
050,30,085,"Montana","Roosevelt County",5,39,103,47,56
050,30,085,"Montana","Roosevelt County",5,40,125,49,76
050,30,085,"Montana","Roosevelt County",5,41,131,55,76
050,30,085,"Montana","Roosevelt County",5,42,122,63,59
050,30,085,"Montana","Roosevelt County",5,43,123,77,46
050,30,085,"Montana","Roosevelt County",5,44,101,56,45
050,30,085,"Montana","Roosevelt County",5,45,111,62,49
050,30,085,"Montana","Roosevelt County",5,46,91,49,42
050,30,085,"Montana","Roosevelt County",5,47,95,47,48
050,30,085,"Montana","Roosevelt County",5,48,94,47,47
050,30,085,"Montana","Roosevelt County",5,49,100,54,46
050,30,085,"Montana","Roosevelt County",5,50,100,44,56
050,30,085,"Montana","Roosevelt County",5,51,96,48,48
050,30,085,"Montana","Roosevelt County",5,52,86,40,46
050,30,085,"Montana","Roosevelt County",5,53,87,42,45
050,30,085,"Montana","Roosevelt County",5,54,90,37,53
050,30,085,"Montana","Roosevelt County",5,55,88,41,47
050,30,085,"Montana","Roosevelt County",5,56,94,50,44
050,30,085,"Montana","Roosevelt County",5,57,93,53,40
050,30,085,"Montana","Roosevelt County",5,58,112,61,51
050,30,085,"Montana","Roosevelt County",5,59,111,57,54
050,30,085,"Montana","Roosevelt County",5,60,125,58,67
050,30,085,"Montana","Roosevelt County",5,61,120,62,58
050,30,085,"Montana","Roosevelt County",5,62,127,60,67
050,30,085,"Montana","Roosevelt County",5,63,113,54,59
050,30,085,"Montana","Roosevelt County",5,64,113,52,61
050,30,085,"Montana","Roosevelt County",5,65,104,44,60
050,30,085,"Montana","Roosevelt County",5,66,114,54,60
050,30,085,"Montana","Roosevelt County",5,67,116,53,63
050,30,085,"Montana","Roosevelt County",5,68,91,42,49
050,30,085,"Montana","Roosevelt County",5,69,86,44,42
050,30,085,"Montana","Roosevelt County",5,70,77,41,36
050,30,085,"Montana","Roosevelt County",5,71,78,37,41
050,30,085,"Montana","Roosevelt County",5,72,85,44,41
050,30,085,"Montana","Roosevelt County",5,73,61,26,35
050,30,085,"Montana","Roosevelt County",5,74,50,21,29
050,30,085,"Montana","Roosevelt County",5,75,53,21,32
050,30,085,"Montana","Roosevelt County",5,76,47,19,28
050,30,085,"Montana","Roosevelt County",5,77,33,14,19
050,30,085,"Montana","Roosevelt County",5,78,38,17,21
050,30,085,"Montana","Roosevelt County",5,79,40,17,23
050,30,085,"Montana","Roosevelt County",5,80,19,13,6
050,30,085,"Montana","Roosevelt County",5,81,28,12,16
050,30,085,"Montana","Roosevelt County",5,82,21,8,13
050,30,085,"Montana","Roosevelt County",5,83,15,10,5
050,30,085,"Montana","Roosevelt County",5,84,13,1,12
050,30,085,"Montana","Roosevelt County",5,85,119,36,83
050,30,087,"Montana","Rosebud County",1,0,107,53,54
050,30,087,"Montana","Rosebud County",1,1,117,61,56
050,30,087,"Montana","Rosebud County",1,2,122,60,62
050,30,087,"Montana","Rosebud County",1,3,125,64,61
050,30,087,"Montana","Rosebud County",1,4,143,80,63
050,30,087,"Montana","Rosebud County",1,5,142,77,65
050,30,087,"Montana","Rosebud County",1,6,141,80,61
050,30,087,"Montana","Rosebud County",1,7,129,66,63
050,30,087,"Montana","Rosebud County",1,8,137,71,66
050,30,087,"Montana","Rosebud County",1,9,135,64,71
050,30,087,"Montana","Rosebud County",1,10,140,64,76
050,30,087,"Montana","Rosebud County",1,11,134,69,65
050,30,087,"Montana","Rosebud County",1,12,149,80,69
050,30,087,"Montana","Rosebud County",1,13,151,73,78
050,30,087,"Montana","Rosebud County",1,14,129,66,63
050,30,087,"Montana","Rosebud County",1,15,145,79,66
050,30,087,"Montana","Rosebud County",1,16,136,71,65
050,30,087,"Montana","Rosebud County",1,17,119,52,67
050,30,087,"Montana","Rosebud County",1,18,122,55,67
050,30,087,"Montana","Rosebud County",1,19,97,50,47
050,30,087,"Montana","Rosebud County",1,20,102,55,47
050,30,087,"Montana","Rosebud County",1,21,88,47,41
050,30,087,"Montana","Rosebud County",1,22,85,41,44
050,30,087,"Montana","Rosebud County",1,23,92,45,47
050,30,087,"Montana","Rosebud County",1,24,96,50,46
050,30,087,"Montana","Rosebud County",1,25,96,45,51
050,30,087,"Montana","Rosebud County",1,26,93,46,47
050,30,087,"Montana","Rosebud County",1,27,103,55,48
050,30,087,"Montana","Rosebud County",1,28,95,48,47
050,30,087,"Montana","Rosebud County",1,29,94,44,50
050,30,087,"Montana","Rosebud County",1,30,101,50,51
050,30,087,"Montana","Rosebud County",1,31,100,42,58
050,30,087,"Montana","Rosebud County",1,32,107,52,55
050,30,087,"Montana","Rosebud County",1,33,101,56,45
050,30,087,"Montana","Rosebud County",1,34,94,45,49
050,30,087,"Montana","Rosebud County",1,35,85,45,40
050,30,087,"Montana","Rosebud County",1,36,85,45,40
050,30,087,"Montana","Rosebud County",1,37,85,42,43
050,30,087,"Montana","Rosebud County",1,38,75,39,36
050,30,087,"Montana","Rosebud County",1,39,92,48,44
050,30,087,"Montana","Rosebud County",1,40,82,33,49
050,30,087,"Montana","Rosebud County",1,41,83,43,40
050,30,087,"Montana","Rosebud County",1,42,84,42,42
050,30,087,"Montana","Rosebud County",1,43,81,44,37
050,30,087,"Montana","Rosebud County",1,44,77,42,35
050,30,087,"Montana","Rosebud County",1,45,89,46,43
050,30,087,"Montana","Rosebud County",1,46,72,43,29
050,30,087,"Montana","Rosebud County",1,47,89,46,43
050,30,087,"Montana","Rosebud County",1,48,93,51,42
050,30,087,"Montana","Rosebud County",1,49,97,55,42
050,30,087,"Montana","Rosebud County",1,50,98,56,42
050,30,087,"Montana","Rosebud County",1,51,91,45,46
050,30,087,"Montana","Rosebud County",1,52,80,35,45
050,30,087,"Montana","Rosebud County",1,53,90,46,44
050,30,087,"Montana","Rosebud County",1,54,98,51,47
050,30,087,"Montana","Rosebud County",1,55,112,56,56
050,30,087,"Montana","Rosebud County",1,56,111,44,67
050,30,087,"Montana","Rosebud County",1,57,116,59,57
050,30,087,"Montana","Rosebud County",1,58,129,69,60
050,30,087,"Montana","Rosebud County",1,59,118,55,63
050,30,087,"Montana","Rosebud County",1,60,109,59,50
050,30,087,"Montana","Rosebud County",1,61,116,61,55
050,30,087,"Montana","Rosebud County",1,62,129,61,68
050,30,087,"Montana","Rosebud County",1,63,117,60,57
050,30,087,"Montana","Rosebud County",1,64,108,57,51
050,30,087,"Montana","Rosebud County",1,65,108,56,52
050,30,087,"Montana","Rosebud County",1,66,106,56,50
050,30,087,"Montana","Rosebud County",1,67,99,51,48
050,30,087,"Montana","Rosebud County",1,68,96,49,47
050,30,087,"Montana","Rosebud County",1,69,84,41,43
050,30,087,"Montana","Rosebud County",1,70,92,38,54
050,30,087,"Montana","Rosebud County",1,71,80,35,45
050,30,087,"Montana","Rosebud County",1,72,79,40,39
050,30,087,"Montana","Rosebud County",1,73,73,42,31
050,30,087,"Montana","Rosebud County",1,74,58,35,23
050,30,087,"Montana","Rosebud County",1,75,58,35,23
050,30,087,"Montana","Rosebud County",1,76,47,23,24
050,30,087,"Montana","Rosebud County",1,77,44,20,24
050,30,087,"Montana","Rosebud County",1,78,36,17,19
050,30,087,"Montana","Rosebud County",1,79,30,18,12
050,30,087,"Montana","Rosebud County",1,80,34,17,17
050,30,087,"Montana","Rosebud County",1,81,34,18,16
050,30,087,"Montana","Rosebud County",1,82,26,10,16
050,30,087,"Montana","Rosebud County",1,83,34,15,19
050,30,087,"Montana","Rosebud County",1,84,29,14,15
050,30,087,"Montana","Rosebud County",1,85,130,53,77
050,30,087,"Montana","Rosebud County",2,0,113,63,50
050,30,087,"Montana","Rosebud County",2,1,112,58,54
050,30,087,"Montana","Rosebud County",2,2,119,60,59
050,30,087,"Montana","Rosebud County",2,3,125,63,62
050,30,087,"Montana","Rosebud County",2,4,139,76,63
050,30,087,"Montana","Rosebud County",2,5,142,77,65
050,30,087,"Montana","Rosebud County",2,6,141,79,62
050,30,087,"Montana","Rosebud County",2,7,133,70,63
050,30,087,"Montana","Rosebud County",2,8,136,70,66
050,30,087,"Montana","Rosebud County",2,9,136,66,70
050,30,087,"Montana","Rosebud County",2,10,139,65,74
050,30,087,"Montana","Rosebud County",2,11,136,69,67
050,30,087,"Montana","Rosebud County",2,12,147,78,69
050,30,087,"Montana","Rosebud County",2,13,150,74,76
050,30,087,"Montana","Rosebud County",2,14,135,68,67
050,30,087,"Montana","Rosebud County",2,15,141,75,66
050,30,087,"Montana","Rosebud County",2,16,137,72,65
050,30,087,"Montana","Rosebud County",2,17,122,56,66
050,30,087,"Montana","Rosebud County",2,18,113,50,63
050,30,087,"Montana","Rosebud County",2,19,98,49,49
050,30,087,"Montana","Rosebud County",2,20,103,55,48
050,30,087,"Montana","Rosebud County",2,21,92,50,42
050,30,087,"Montana","Rosebud County",2,22,86,42,44
050,30,087,"Montana","Rosebud County",2,23,93,46,47
050,30,087,"Montana","Rosebud County",2,24,95,48,47
050,30,087,"Montana","Rosebud County",2,25,93,44,49
050,30,087,"Montana","Rosebud County",2,26,93,46,47
050,30,087,"Montana","Rosebud County",2,27,100,53,47
050,30,087,"Montana","Rosebud County",2,28,98,50,48
050,30,087,"Montana","Rosebud County",2,29,94,44,50
050,30,087,"Montana","Rosebud County",2,30,98,47,51
050,30,087,"Montana","Rosebud County",2,31,100,44,56
050,30,087,"Montana","Rosebud County",2,32,106,50,56
050,30,087,"Montana","Rosebud County",2,33,102,54,48
050,30,087,"Montana","Rosebud County",2,34,95,47,48
050,30,087,"Montana","Rosebud County",2,35,90,47,43
050,30,087,"Montana","Rosebud County",2,36,85,46,39
050,30,087,"Montana","Rosebud County",2,37,85,44,41
050,30,087,"Montana","Rosebud County",2,38,76,39,37
050,30,087,"Montana","Rosebud County",2,39,87,45,42
050,30,087,"Montana","Rosebud County",2,40,88,38,50
050,30,087,"Montana","Rosebud County",2,41,82,41,41
050,30,087,"Montana","Rosebud County",2,42,83,42,41
050,30,087,"Montana","Rosebud County",2,43,82,44,38
050,30,087,"Montana","Rosebud County",2,44,77,42,35
050,30,087,"Montana","Rosebud County",2,45,87,46,41
050,30,087,"Montana","Rosebud County",2,46,75,43,32
050,30,087,"Montana","Rosebud County",2,47,84,45,39
050,30,087,"Montana","Rosebud County",2,48,91,49,42
050,30,087,"Montana","Rosebud County",2,49,95,53,42
050,30,087,"Montana","Rosebud County",2,50,96,54,42
050,30,087,"Montana","Rosebud County",2,51,92,47,45
050,30,087,"Montana","Rosebud County",2,52,83,38,45
050,30,087,"Montana","Rosebud County",2,53,86,42,44
050,30,087,"Montana","Rosebud County",2,54,95,49,46
050,30,087,"Montana","Rosebud County",2,55,109,55,54
050,30,087,"Montana","Rosebud County",2,56,111,47,64
050,30,087,"Montana","Rosebud County",2,57,114,56,58
050,30,087,"Montana","Rosebud County",2,58,124,65,59
050,30,087,"Montana","Rosebud County",2,59,120,58,62
050,30,087,"Montana","Rosebud County",2,60,108,58,50
050,30,087,"Montana","Rosebud County",2,61,114,61,53
050,30,087,"Montana","Rosebud County",2,62,125,60,65
050,30,087,"Montana","Rosebud County",2,63,121,61,60
050,30,087,"Montana","Rosebud County",2,64,109,57,52
050,30,087,"Montana","Rosebud County",2,65,108,57,51
050,30,087,"Montana","Rosebud County",2,66,103,54,49
050,30,087,"Montana","Rosebud County",2,67,98,50,48
050,30,087,"Montana","Rosebud County",2,68,91,45,46
050,30,087,"Montana","Rosebud County",2,69,87,41,46
050,30,087,"Montana","Rosebud County",2,70,89,38,51
050,30,087,"Montana","Rosebud County",2,71,81,34,47
050,30,087,"Montana","Rosebud County",2,72,77,37,40
050,30,087,"Montana","Rosebud County",2,73,77,43,34
050,30,087,"Montana","Rosebud County",2,74,59,35,24
050,30,087,"Montana","Rosebud County",2,75,58,35,23
050,30,087,"Montana","Rosebud County",2,76,48,26,22
050,30,087,"Montana","Rosebud County",2,77,42,21,21
050,30,087,"Montana","Rosebud County",2,78,37,18,19
050,30,087,"Montana","Rosebud County",2,79,31,17,14
050,30,087,"Montana","Rosebud County",2,80,34,18,16
050,30,087,"Montana","Rosebud County",2,81,34,18,16
050,30,087,"Montana","Rosebud County",2,82,27,12,15
050,30,087,"Montana","Rosebud County",2,83,31,13,18
050,30,087,"Montana","Rosebud County",2,84,30,15,15
050,30,087,"Montana","Rosebud County",2,85,131,54,77
050,30,087,"Montana","Rosebud County",3,0,122,65,57
050,30,087,"Montana","Rosebud County",3,1,114,64,50
050,30,087,"Montana","Rosebud County",3,2,102,50,52
050,30,087,"Montana","Rosebud County",3,3,113,57,56
050,30,087,"Montana","Rosebud County",3,4,116,60,56
050,30,087,"Montana","Rosebud County",3,5,139,75,64
050,30,087,"Montana","Rosebud County",3,6,121,67,54
050,30,087,"Montana","Rosebud County",3,7,145,80,65
050,30,087,"Montana","Rosebud County",3,8,130,69,61
050,30,087,"Montana","Rosebud County",3,9,133,69,64
050,30,087,"Montana","Rosebud County",3,10,137,69,68
050,30,087,"Montana","Rosebud County",3,11,135,62,73
050,30,087,"Montana","Rosebud County",3,12,135,69,66
050,30,087,"Montana","Rosebud County",3,13,146,75,71
050,30,087,"Montana","Rosebud County",3,14,154,80,74
050,30,087,"Montana","Rosebud County",3,15,137,69,68
050,30,087,"Montana","Rosebud County",3,16,142,76,66
050,30,087,"Montana","Rosebud County",3,17,132,70,62
050,30,087,"Montana","Rosebud County",3,18,112,54,58
050,30,087,"Montana","Rosebud County",3,19,101,41,60
050,30,087,"Montana","Rosebud County",3,20,91,48,43
050,30,087,"Montana","Rosebud County",3,21,95,52,43
050,30,087,"Montana","Rosebud County",3,22,71,38,33
050,30,087,"Montana","Rosebud County",3,23,86,39,47
050,30,087,"Montana","Rosebud County",3,24,101,46,55
050,30,087,"Montana","Rosebud County",3,25,98,48,50
050,30,087,"Montana","Rosebud County",3,26,80,37,43
050,30,087,"Montana","Rosebud County",3,27,91,47,44
050,30,087,"Montana","Rosebud County",3,28,94,48,46
050,30,087,"Montana","Rosebud County",3,29,89,45,44
050,30,087,"Montana","Rosebud County",3,30,98,46,52
050,30,087,"Montana","Rosebud County",3,31,94,49,45
050,30,087,"Montana","Rosebud County",3,32,101,48,53
050,30,087,"Montana","Rosebud County",3,33,92,43,49
050,30,087,"Montana","Rosebud County",3,34,97,54,43
050,30,087,"Montana","Rosebud County",3,35,95,49,46
050,30,087,"Montana","Rosebud County",3,36,94,51,43
050,30,087,"Montana","Rosebud County",3,37,78,41,37
050,30,087,"Montana","Rosebud County",3,38,88,45,43
050,30,087,"Montana","Rosebud County",3,39,77,39,38
050,30,087,"Montana","Rosebud County",3,40,85,43,42
050,30,087,"Montana","Rosebud County",3,41,84,36,48
050,30,087,"Montana","Rosebud County",3,42,80,40,40
050,30,087,"Montana","Rosebud County",3,43,84,41,43
050,30,087,"Montana","Rosebud County",3,44,74,39,35
050,30,087,"Montana","Rosebud County",3,45,76,40,36
050,30,087,"Montana","Rosebud County",3,46,83,48,35
050,30,087,"Montana","Rosebud County",3,47,72,40,32
050,30,087,"Montana","Rosebud County",3,48,85,45,40
050,30,087,"Montana","Rosebud County",3,49,92,49,43
050,30,087,"Montana","Rosebud County",3,50,91,50,41
050,30,087,"Montana","Rosebud County",3,51,96,56,40
050,30,087,"Montana","Rosebud County",3,52,84,43,41
050,30,087,"Montana","Rosebud County",3,53,78,38,40
050,30,087,"Montana","Rosebud County",3,54,91,43,48
050,30,087,"Montana","Rosebud County",3,55,93,49,44
050,30,087,"Montana","Rosebud County",3,56,99,45,54
050,30,087,"Montana","Rosebud County",3,57,105,43,62
050,30,087,"Montana","Rosebud County",3,58,110,54,56
050,30,087,"Montana","Rosebud County",3,59,116,60,56
050,30,087,"Montana","Rosebud County",3,60,115,52,63
050,30,087,"Montana","Rosebud County",3,61,107,55,52
050,30,087,"Montana","Rosebud County",3,62,114,61,53
050,30,087,"Montana","Rosebud County",3,63,121,57,64
050,30,087,"Montana","Rosebud County",3,64,114,56,58
050,30,087,"Montana","Rosebud County",3,65,104,56,48
050,30,087,"Montana","Rosebud County",3,66,98,50,48
050,30,087,"Montana","Rosebud County",3,67,94,43,51
050,30,087,"Montana","Rosebud County",3,68,95,48,47
050,30,087,"Montana","Rosebud County",3,69,87,44,43
050,30,087,"Montana","Rosebud County",3,70,86,41,45
050,30,087,"Montana","Rosebud County",3,71,80,31,49
050,30,087,"Montana","Rosebud County",3,72,71,32,39
050,30,087,"Montana","Rosebud County",3,73,72,33,39
050,30,087,"Montana","Rosebud County",3,74,72,41,31
050,30,087,"Montana","Rosebud County",3,75,57,30,27
050,30,087,"Montana","Rosebud County",3,76,50,28,22
050,30,087,"Montana","Rosebud County",3,77,44,23,21
050,30,087,"Montana","Rosebud County",3,78,41,21,20
050,30,087,"Montana","Rosebud County",3,79,34,18,16
050,30,087,"Montana","Rosebud County",3,80,31,17,14
050,30,087,"Montana","Rosebud County",3,81,30,15,15
050,30,087,"Montana","Rosebud County",3,82,28,14,14
050,30,087,"Montana","Rosebud County",3,83,31,13,18
050,30,087,"Montana","Rosebud County",3,84,25,11,14
050,30,087,"Montana","Rosebud County",3,85,131,55,76
050,30,087,"Montana","Rosebud County",4,0,120,54,66
050,30,087,"Montana","Rosebud County",4,1,127,67,60
050,30,087,"Montana","Rosebud County",4,2,98,54,44
050,30,087,"Montana","Rosebud County",4,3,103,53,50
050,30,087,"Montana","Rosebud County",4,4,107,56,51
050,30,087,"Montana","Rosebud County",4,5,116,60,56
050,30,087,"Montana","Rosebud County",4,6,140,76,64
050,30,087,"Montana","Rosebud County",4,7,123,66,57
050,30,087,"Montana","Rosebud County",4,8,147,82,65
050,30,087,"Montana","Rosebud County",4,9,148,73,75
050,30,087,"Montana","Rosebud County",4,10,141,70,71
050,30,087,"Montana","Rosebud County",4,11,133,71,62
050,30,087,"Montana","Rosebud County",4,12,138,64,74
050,30,087,"Montana","Rosebud County",4,13,142,72,70
050,30,087,"Montana","Rosebud County",4,14,154,79,75
050,30,087,"Montana","Rosebud County",4,15,153,81,72
050,30,087,"Montana","Rosebud County",4,16,145,73,72
050,30,087,"Montana","Rosebud County",4,17,149,78,71
050,30,087,"Montana","Rosebud County",4,18,115,60,55
050,30,087,"Montana","Rosebud County",4,19,92,44,48
050,30,087,"Montana","Rosebud County",4,20,98,41,57
050,30,087,"Montana","Rosebud County",4,21,82,43,39
050,30,087,"Montana","Rosebud County",4,22,99,56,43
050,30,087,"Montana","Rosebud County",4,23,74,38,36
050,30,087,"Montana","Rosebud County",4,24,91,42,49
050,30,087,"Montana","Rosebud County",4,25,89,39,50
050,30,087,"Montana","Rosebud County",4,26,88,47,41
050,30,087,"Montana","Rosebud County",4,27,83,39,44
050,30,087,"Montana","Rosebud County",4,28,84,39,45
050,30,087,"Montana","Rosebud County",4,29,89,43,46
050,30,087,"Montana","Rosebud County",4,30,87,44,43
050,30,087,"Montana","Rosebud County",4,31,96,45,51
050,30,087,"Montana","Rosebud County",4,32,109,52,57
050,30,087,"Montana","Rosebud County",4,33,97,48,49
050,30,087,"Montana","Rosebud County",4,34,93,42,51
050,30,087,"Montana","Rosebud County",4,35,93,54,39
050,30,087,"Montana","Rosebud County",4,36,102,51,51
050,30,087,"Montana","Rosebud County",4,37,94,50,44
050,30,087,"Montana","Rosebud County",4,38,92,52,40
050,30,087,"Montana","Rosebud County",4,39,87,48,39
050,30,087,"Montana","Rosebud County",4,40,84,43,41
050,30,087,"Montana","Rosebud County",4,41,86,42,44
050,30,087,"Montana","Rosebud County",4,42,87,38,49
050,30,087,"Montana","Rosebud County",4,43,73,35,38
050,30,087,"Montana","Rosebud County",4,44,88,42,46
050,30,087,"Montana","Rosebud County",4,45,73,37,36
050,30,087,"Montana","Rosebud County",4,46,76,40,36
050,30,087,"Montana","Rosebud County",4,47,91,51,40
050,30,087,"Montana","Rosebud County",4,48,76,42,34
050,30,087,"Montana","Rosebud County",4,49,80,40,40
050,30,087,"Montana","Rosebud County",4,50,89,47,42
050,30,087,"Montana","Rosebud County",4,51,92,50,42
050,30,087,"Montana","Rosebud County",4,52,102,62,40
050,30,087,"Montana","Rosebud County",4,53,89,44,45
050,30,087,"Montana","Rosebud County",4,54,82,39,43
050,30,087,"Montana","Rosebud County",4,55,84,41,43
050,30,087,"Montana","Rosebud County",4,56,95,49,46
050,30,087,"Montana","Rosebud County",4,57,106,54,52
050,30,087,"Montana","Rosebud County",4,58,104,43,61
050,30,087,"Montana","Rosebud County",4,59,114,53,61
050,30,087,"Montana","Rosebud County",4,60,117,62,55
050,30,087,"Montana","Rosebud County",4,61,112,51,61
050,30,087,"Montana","Rosebud County",4,62,107,52,55
050,30,087,"Montana","Rosebud County",4,63,115,64,51
050,30,087,"Montana","Rosebud County",4,64,119,56,63
050,30,087,"Montana","Rosebud County",4,65,113,58,55
050,30,087,"Montana","Rosebud County",4,66,98,52,46
050,30,087,"Montana","Rosebud County",4,67,94,46,48
050,30,087,"Montana","Rosebud County",4,68,88,40,48
050,30,087,"Montana","Rosebud County",4,69,97,48,49
050,30,087,"Montana","Rosebud County",4,70,89,44,45
050,30,087,"Montana","Rosebud County",4,71,80,37,43
050,30,087,"Montana","Rosebud County",4,72,75,31,44
050,30,087,"Montana","Rosebud County",4,73,67,30,37
050,30,087,"Montana","Rosebud County",4,74,70,32,38
050,30,087,"Montana","Rosebud County",4,75,64,32,32
050,30,087,"Montana","Rosebud County",4,76,49,27,22
050,30,087,"Montana","Rosebud County",4,77,48,27,21
050,30,087,"Montana","Rosebud County",4,78,40,22,18
050,30,087,"Montana","Rosebud County",4,79,41,21,20
050,30,087,"Montana","Rosebud County",4,80,33,17,16
050,30,087,"Montana","Rosebud County",4,81,27,15,12
050,30,087,"Montana","Rosebud County",4,82,27,11,16
050,30,087,"Montana","Rosebud County",4,83,31,14,17
050,30,087,"Montana","Rosebud County",4,84,30,15,15
050,30,087,"Montana","Rosebud County",4,85,132,51,81
050,30,087,"Montana","Rosebud County",5,0,120,54,66
050,30,087,"Montana","Rosebud County",5,1,122,59,63
050,30,087,"Montana","Rosebud County",5,2,128,70,58
050,30,087,"Montana","Rosebud County",5,3,103,51,52
050,30,087,"Montana","Rosebud County",5,4,98,53,45
050,30,087,"Montana","Rosebud County",5,5,115,57,58
050,30,087,"Montana","Rosebud County",5,6,115,58,57
050,30,087,"Montana","Rosebud County",5,7,138,76,62
050,30,087,"Montana","Rosebud County",5,8,127,68,59
050,30,087,"Montana","Rosebud County",5,9,148,75,73
050,30,087,"Montana","Rosebud County",5,10,152,77,75
050,30,087,"Montana","Rosebud County",5,11,131,66,65
050,30,087,"Montana","Rosebud County",5,12,137,73,64
050,30,087,"Montana","Rosebud County",5,13,134,60,74
050,30,087,"Montana","Rosebud County",5,14,137,70,67
050,30,087,"Montana","Rosebud County",5,15,150,75,75
050,30,087,"Montana","Rosebud County",5,16,155,82,73
050,30,087,"Montana","Rosebud County",5,17,147,73,74
050,30,087,"Montana","Rosebud County",5,18,131,68,63
050,30,087,"Montana","Rosebud County",5,19,94,48,46
050,30,087,"Montana","Rosebud County",5,20,96,44,52
050,30,087,"Montana","Rosebud County",5,21,96,42,54
050,30,087,"Montana","Rosebud County",5,22,95,49,46
050,30,087,"Montana","Rosebud County",5,23,113,60,53
050,30,087,"Montana","Rosebud County",5,24,78,38,40
050,30,087,"Montana","Rosebud County",5,25,91,43,48
050,30,087,"Montana","Rosebud County",5,26,91,40,51
050,30,087,"Montana","Rosebud County",5,27,87,47,40
050,30,087,"Montana","Rosebud County",5,28,85,40,45
050,30,087,"Montana","Rosebud County",5,29,91,40,51
050,30,087,"Montana","Rosebud County",5,30,89,42,47
050,30,087,"Montana","Rosebud County",5,31,81,45,36
050,30,087,"Montana","Rosebud County",5,32,102,45,57
050,30,087,"Montana","Rosebud County",5,33,103,46,57
050,30,087,"Montana","Rosebud County",5,34,95,49,46
050,30,087,"Montana","Rosebud County",5,35,87,39,48
050,30,087,"Montana","Rosebud County",5,36,97,56,41
050,30,087,"Montana","Rosebud County",5,37,96,53,43
050,30,087,"Montana","Rosebud County",5,38,94,53,41
050,30,087,"Montana","Rosebud County",5,39,94,53,41
050,30,087,"Montana","Rosebud County",5,40,88,47,41
050,30,087,"Montana","Rosebud County",5,41,77,39,38
050,30,087,"Montana","Rosebud County",5,42,91,45,46
050,30,087,"Montana","Rosebud County",5,43,85,38,47
050,30,087,"Montana","Rosebud County",5,44,80,40,40
050,30,087,"Montana","Rosebud County",5,45,84,41,43
050,30,087,"Montana","Rosebud County",5,46,79,39,40
050,30,087,"Montana","Rosebud County",5,47,72,38,34
050,30,087,"Montana","Rosebud County",5,48,89,50,39
050,30,087,"Montana","Rosebud County",5,49,78,43,35
050,30,087,"Montana","Rosebud County",5,50,79,39,40
050,30,087,"Montana","Rosebud County",5,51,85,45,40
050,30,087,"Montana","Rosebud County",5,52,94,50,44
050,30,087,"Montana","Rosebud County",5,53,96,59,37
050,30,087,"Montana","Rosebud County",5,54,88,42,46
050,30,087,"Montana","Rosebud County",5,55,84,45,39
050,30,087,"Montana","Rosebud County",5,56,86,41,45
050,30,087,"Montana","Rosebud County",5,57,88,46,42
050,30,087,"Montana","Rosebud County",5,58,104,53,51
050,30,087,"Montana","Rosebud County",5,59,106,45,61
050,30,087,"Montana","Rosebud County",5,60,115,55,60
050,30,087,"Montana","Rosebud County",5,61,114,59,55
050,30,087,"Montana","Rosebud County",5,62,110,49,61
050,30,087,"Montana","Rosebud County",5,63,100,48,52
050,30,087,"Montana","Rosebud County",5,64,107,59,48
050,30,087,"Montana","Rosebud County",5,65,119,57,62
050,30,087,"Montana","Rosebud County",5,66,99,47,52
050,30,087,"Montana","Rosebud County",5,67,94,48,46
050,30,087,"Montana","Rosebud County",5,68,93,46,47
050,30,087,"Montana","Rosebud County",5,69,91,43,48
050,30,087,"Montana","Rosebud County",5,70,100,47,53
050,30,087,"Montana","Rosebud County",5,71,88,42,46
050,30,087,"Montana","Rosebud County",5,72,77,39,38
050,30,087,"Montana","Rosebud County",5,73,75,29,46
050,30,087,"Montana","Rosebud County",5,74,65,29,36
050,30,087,"Montana","Rosebud County",5,75,62,24,38
050,30,087,"Montana","Rosebud County",5,76,59,30,29
050,30,087,"Montana","Rosebud County",5,77,45,24,21
050,30,087,"Montana","Rosebud County",5,78,45,26,19
050,30,087,"Montana","Rosebud County",5,79,41,21,20
050,30,087,"Montana","Rosebud County",5,80,39,19,20
050,30,087,"Montana","Rosebud County",5,81,28,15,13
050,30,087,"Montana","Rosebud County",5,82,23,12,11
050,30,087,"Montana","Rosebud County",5,83,29,11,18
050,30,087,"Montana","Rosebud County",5,84,31,15,16
050,30,087,"Montana","Rosebud County",5,85,135,55,80
050,30,089,"Montana","Sanders County",1,0,100,50,50
050,30,089,"Montana","Sanders County",1,1,95,50,45
050,30,089,"Montana","Sanders County",1,2,105,52,53
050,30,089,"Montana","Sanders County",1,3,123,60,63
050,30,089,"Montana","Sanders County",1,4,110,62,48
050,30,089,"Montana","Sanders County",1,5,133,74,59
050,30,089,"Montana","Sanders County",1,6,126,59,67
050,30,089,"Montana","Sanders County",1,7,124,62,62
050,30,089,"Montana","Sanders County",1,8,111,53,58
050,30,089,"Montana","Sanders County",1,9,113,57,56
050,30,089,"Montana","Sanders County",1,10,120,59,61
050,30,089,"Montana","Sanders County",1,11,120,61,59
050,30,089,"Montana","Sanders County",1,12,120,70,50
050,30,089,"Montana","Sanders County",1,13,139,82,57
050,30,089,"Montana","Sanders County",1,14,128,73,55
050,30,089,"Montana","Sanders County",1,15,124,75,49
050,30,089,"Montana","Sanders County",1,16,147,85,62
050,30,089,"Montana","Sanders County",1,17,151,82,69
050,30,089,"Montana","Sanders County",1,18,116,56,60
050,30,089,"Montana","Sanders County",1,19,84,42,42
050,30,089,"Montana","Sanders County",1,20,93,52,41
050,30,089,"Montana","Sanders County",1,21,75,41,34
050,30,089,"Montana","Sanders County",1,22,76,46,30
050,30,089,"Montana","Sanders County",1,23,78,47,31
050,30,089,"Montana","Sanders County",1,24,80,45,35
050,30,089,"Montana","Sanders County",1,25,91,52,39
050,30,089,"Montana","Sanders County",1,26,83,44,39
050,30,089,"Montana","Sanders County",1,27,106,51,55
050,30,089,"Montana","Sanders County",1,28,97,45,52
050,30,089,"Montana","Sanders County",1,29,94,51,43
050,30,089,"Montana","Sanders County",1,30,99,50,49
050,30,089,"Montana","Sanders County",1,31,100,41,59
050,30,089,"Montana","Sanders County",1,32,98,53,45
050,30,089,"Montana","Sanders County",1,33,103,43,60
050,30,089,"Montana","Sanders County",1,34,115,53,62
050,30,089,"Montana","Sanders County",1,35,104,51,53
050,30,089,"Montana","Sanders County",1,36,110,61,49
050,30,089,"Montana","Sanders County",1,37,118,57,61
050,30,089,"Montana","Sanders County",1,38,120,60,60
050,30,089,"Montana","Sanders County",1,39,99,53,46
050,30,089,"Montana","Sanders County",1,40,108,58,50
050,30,089,"Montana","Sanders County",1,41,114,64,50
050,30,089,"Montana","Sanders County",1,42,115,61,54
050,30,089,"Montana","Sanders County",1,43,123,57,66
050,30,089,"Montana","Sanders County",1,44,117,60,57
050,30,089,"Montana","Sanders County",1,45,118,52,66
050,30,089,"Montana","Sanders County",1,46,123,68,55
050,30,089,"Montana","Sanders County",1,47,130,70,60
050,30,089,"Montana","Sanders County",1,48,131,70,61
050,30,089,"Montana","Sanders County",1,49,150,85,65
050,30,089,"Montana","Sanders County",1,50,149,78,71
050,30,089,"Montana","Sanders County",1,51,130,74,56
050,30,089,"Montana","Sanders County",1,52,135,68,67
050,30,089,"Montana","Sanders County",1,53,133,69,64
050,30,089,"Montana","Sanders County",1,54,146,71,75
050,30,089,"Montana","Sanders County",1,55,156,70,86
050,30,089,"Montana","Sanders County",1,56,162,78,84
050,30,089,"Montana","Sanders County",1,57,190,91,99
050,30,089,"Montana","Sanders County",1,58,215,112,103
050,30,089,"Montana","Sanders County",1,59,210,112,98
050,30,089,"Montana","Sanders County",1,60,232,114,118
050,30,089,"Montana","Sanders County",1,61,251,112,139
050,30,089,"Montana","Sanders County",1,62,280,129,151
050,30,089,"Montana","Sanders County",1,63,275,135,140
050,30,089,"Montana","Sanders County",1,64,266,137,129
050,30,089,"Montana","Sanders County",1,65,252,116,136
050,30,089,"Montana","Sanders County",1,66,268,133,135
050,30,089,"Montana","Sanders County",1,67,263,140,123
050,30,089,"Montana","Sanders County",1,68,274,152,122
050,30,089,"Montana","Sanders County",1,69,252,135,117
050,30,089,"Montana","Sanders County",1,70,257,130,127
050,30,089,"Montana","Sanders County",1,71,225,114,111
050,30,089,"Montana","Sanders County",1,72,224,125,99
050,30,089,"Montana","Sanders County",1,73,226,131,95
050,30,089,"Montana","Sanders County",1,74,164,91,73
050,30,089,"Montana","Sanders County",1,75,171,90,81
050,30,089,"Montana","Sanders County",1,76,170,93,77
050,30,089,"Montana","Sanders County",1,77,162,88,74
050,30,089,"Montana","Sanders County",1,78,130,69,61
050,30,089,"Montana","Sanders County",1,79,130,75,55
050,30,089,"Montana","Sanders County",1,80,101,54,47
050,30,089,"Montana","Sanders County",1,81,94,47,47
050,30,089,"Montana","Sanders County",1,82,97,53,44
050,30,089,"Montana","Sanders County",1,83,73,39,34
050,30,089,"Montana","Sanders County",1,84,65,27,38
050,30,089,"Montana","Sanders County",1,85,313,138,175
050,30,089,"Montana","Sanders County",2,0,97,48,49
050,30,089,"Montana","Sanders County",2,1,95,49,46
050,30,089,"Montana","Sanders County",2,2,104,51,53
050,30,089,"Montana","Sanders County",2,3,118,57,61
050,30,089,"Montana","Sanders County",2,4,117,65,52
050,30,089,"Montana","Sanders County",2,5,131,72,59
050,30,089,"Montana","Sanders County",2,6,127,63,64
050,30,089,"Montana","Sanders County",2,7,125,62,63
050,30,089,"Montana","Sanders County",2,8,114,54,60
050,30,089,"Montana","Sanders County",2,9,111,55,56
050,30,089,"Montana","Sanders County",2,10,119,59,60
050,30,089,"Montana","Sanders County",2,11,120,61,59
050,30,089,"Montana","Sanders County",2,12,120,68,52
050,30,089,"Montana","Sanders County",2,13,133,78,55
050,30,089,"Montana","Sanders County",2,14,129,74,55
050,30,089,"Montana","Sanders County",2,15,126,75,51
050,30,089,"Montana","Sanders County",2,16,145,86,59
050,30,089,"Montana","Sanders County",2,17,151,83,68
050,30,089,"Montana","Sanders County",2,18,116,57,59
050,30,089,"Montana","Sanders County",2,19,85,43,42
050,30,089,"Montana","Sanders County",2,20,92,50,42
050,30,089,"Montana","Sanders County",2,21,75,42,33
050,30,089,"Montana","Sanders County",2,22,75,45,30
050,30,089,"Montana","Sanders County",2,23,78,47,31
050,30,089,"Montana","Sanders County",2,24,82,48,34
050,30,089,"Montana","Sanders County",2,25,91,52,39
050,30,089,"Montana","Sanders County",2,26,87,47,40
050,30,089,"Montana","Sanders County",2,27,101,49,52
050,30,089,"Montana","Sanders County",2,28,99,47,52
050,30,089,"Montana","Sanders County",2,29,97,52,45
050,30,089,"Montana","Sanders County",2,30,98,50,48
050,30,089,"Montana","Sanders County",2,31,102,45,57
050,30,089,"Montana","Sanders County",2,32,97,49,48
050,30,089,"Montana","Sanders County",2,33,104,46,58
050,30,089,"Montana","Sanders County",2,34,113,53,60
050,30,089,"Montana","Sanders County",2,35,111,54,57
050,30,089,"Montana","Sanders County",2,36,112,60,52
050,30,089,"Montana","Sanders County",2,37,118,59,59
050,30,089,"Montana","Sanders County",2,38,119,58,61
050,30,089,"Montana","Sanders County",2,39,103,54,49
050,30,089,"Montana","Sanders County",2,40,108,58,50
050,30,089,"Montana","Sanders County",2,41,114,64,50
050,30,089,"Montana","Sanders County",2,42,114,61,53
050,30,089,"Montana","Sanders County",2,43,122,58,64
050,30,089,"Montana","Sanders County",2,44,119,60,59
050,30,089,"Montana","Sanders County",2,45,119,54,65
050,30,089,"Montana","Sanders County",2,46,122,65,57
050,30,089,"Montana","Sanders County",2,47,127,68,59
050,30,089,"Montana","Sanders County",2,48,132,70,62
050,30,089,"Montana","Sanders County",2,49,149,83,66
050,30,089,"Montana","Sanders County",2,50,150,80,70
050,30,089,"Montana","Sanders County",2,51,136,76,60
050,30,089,"Montana","Sanders County",2,52,137,71,66
050,30,089,"Montana","Sanders County",2,53,136,70,66
050,30,089,"Montana","Sanders County",2,54,144,71,73
050,30,089,"Montana","Sanders County",2,55,154,70,84
050,30,089,"Montana","Sanders County",2,56,165,78,87
050,30,089,"Montana","Sanders County",2,57,188,90,98
050,30,089,"Montana","Sanders County",2,58,211,109,102
050,30,089,"Montana","Sanders County",2,59,213,114,99
050,30,089,"Montana","Sanders County",2,60,227,113,114
050,30,089,"Montana","Sanders County",2,61,249,114,135
050,30,089,"Montana","Sanders County",2,62,275,127,148
050,30,089,"Montana","Sanders County",2,63,282,138,144
050,30,089,"Montana","Sanders County",2,64,266,135,131
050,30,089,"Montana","Sanders County",2,65,261,124,137
050,30,089,"Montana","Sanders County",2,66,266,130,136
050,30,089,"Montana","Sanders County",2,67,266,140,126
050,30,089,"Montana","Sanders County",2,68,270,148,122
050,30,089,"Montana","Sanders County",2,69,264,143,121
050,30,089,"Montana","Sanders County",2,70,256,132,124
050,30,089,"Montana","Sanders County",2,71,233,119,114
050,30,089,"Montana","Sanders County",2,72,220,119,101
050,30,089,"Montana","Sanders County",2,73,235,136,99
050,30,089,"Montana","Sanders County",2,74,166,92,74
050,30,089,"Montana","Sanders County",2,75,167,91,76
050,30,089,"Montana","Sanders County",2,76,166,89,77
050,30,089,"Montana","Sanders County",2,77,167,90,77
050,30,089,"Montana","Sanders County",2,78,132,71,61
050,30,089,"Montana","Sanders County",2,79,125,71,54
050,30,089,"Montana","Sanders County",2,80,107,59,48
050,30,089,"Montana","Sanders County",2,81,95,48,47
050,30,089,"Montana","Sanders County",2,82,98,53,45
050,30,089,"Montana","Sanders County",2,83,76,41,35
050,30,089,"Montana","Sanders County",2,84,68,30,38
050,30,089,"Montana","Sanders County",2,85,324,143,181
050,30,089,"Montana","Sanders County",3,0,81,44,37
050,30,089,"Montana","Sanders County",3,1,95,44,51
050,30,089,"Montana","Sanders County",3,2,99,50,49
050,30,089,"Montana","Sanders County",3,3,116,51,65
050,30,089,"Montana","Sanders County",3,4,115,58,57
050,30,089,"Montana","Sanders County",3,5,128,70,58
050,30,089,"Montana","Sanders County",3,6,136,77,59
050,30,089,"Montana","Sanders County",3,7,132,63,69
050,30,089,"Montana","Sanders County",3,8,132,65,67
050,30,089,"Montana","Sanders County",3,9,113,52,61
050,30,089,"Montana","Sanders County",3,10,114,56,58
050,30,089,"Montana","Sanders County",3,11,115,59,56
050,30,089,"Montana","Sanders County",3,12,127,64,63
050,30,089,"Montana","Sanders County",3,13,122,70,52
050,30,089,"Montana","Sanders County",3,14,148,86,62
050,30,089,"Montana","Sanders County",3,15,132,75,57
050,30,089,"Montana","Sanders County",3,16,143,86,57
050,30,089,"Montana","Sanders County",3,17,150,85,65
050,30,089,"Montana","Sanders County",3,18,116,58,58
050,30,089,"Montana","Sanders County",3,19,88,42,46
050,30,089,"Montana","Sanders County",3,20,90,46,44
050,30,089,"Montana","Sanders County",3,21,91,44,47
050,30,089,"Montana","Sanders County",3,22,93,48,45
050,30,089,"Montana","Sanders County",3,23,83,49,34
050,30,089,"Montana","Sanders County",3,24,92,53,39
050,30,089,"Montana","Sanders County",3,25,86,47,39
050,30,089,"Montana","Sanders County",3,26,101,59,42
050,30,089,"Montana","Sanders County",3,27,95,51,44
050,30,089,"Montana","Sanders County",3,28,109,50,59
050,30,089,"Montana","Sanders County",3,29,124,60,64
050,30,089,"Montana","Sanders County",3,30,115,60,55
050,30,089,"Montana","Sanders County",3,31,109,55,54
050,30,089,"Montana","Sanders County",3,32,111,49,62
050,30,089,"Montana","Sanders County",3,33,105,54,51
050,30,089,"Montana","Sanders County",3,34,112,51,61
050,30,089,"Montana","Sanders County",3,35,126,61,65
050,30,089,"Montana","Sanders County",3,36,115,57,58
050,30,089,"Montana","Sanders County",3,37,125,68,57
050,30,089,"Montana","Sanders County",3,38,120,56,64
050,30,089,"Montana","Sanders County",3,39,132,66,66
050,30,089,"Montana","Sanders County",3,40,98,53,45
050,30,089,"Montana","Sanders County",3,41,115,61,54
050,30,089,"Montana","Sanders County",3,42,115,64,51
050,30,089,"Montana","Sanders County",3,43,117,63,54
050,30,089,"Montana","Sanders County",3,44,132,62,70
050,30,089,"Montana","Sanders County",3,45,120,61,59
050,30,089,"Montana","Sanders County",3,46,127,59,68
050,30,089,"Montana","Sanders County",3,47,137,74,63
050,30,089,"Montana","Sanders County",3,48,135,75,60
050,30,089,"Montana","Sanders County",3,49,142,73,69
050,30,089,"Montana","Sanders County",3,50,165,90,75
050,30,089,"Montana","Sanders County",3,51,156,84,72
050,30,089,"Montana","Sanders County",3,52,146,79,67
050,30,089,"Montana","Sanders County",3,53,148,78,70
050,30,089,"Montana","Sanders County",3,54,154,76,78
050,30,089,"Montana","Sanders County",3,55,157,80,77
050,30,089,"Montana","Sanders County",3,56,168,79,89
050,30,089,"Montana","Sanders County",3,57,167,76,91
050,30,089,"Montana","Sanders County",3,58,194,93,101
050,30,089,"Montana","Sanders County",3,59,226,120,106
050,30,089,"Montana","Sanders County",3,60,231,133,98
050,30,089,"Montana","Sanders County",3,61,249,119,130
050,30,089,"Montana","Sanders County",3,62,281,124,157
050,30,089,"Montana","Sanders County",3,63,300,145,155
050,30,089,"Montana","Sanders County",3,64,284,139,145
050,30,089,"Montana","Sanders County",3,65,277,141,136
050,30,089,"Montana","Sanders County",3,66,272,131,141
050,30,089,"Montana","Sanders County",3,67,278,142,136
050,30,089,"Montana","Sanders County",3,68,270,135,135
050,30,089,"Montana","Sanders County",3,69,272,148,124
050,30,089,"Montana","Sanders County",3,70,247,136,111
050,30,089,"Montana","Sanders County",3,71,261,138,123
050,30,089,"Montana","Sanders County",3,72,238,120,118
050,30,089,"Montana","Sanders County",3,73,218,120,98
050,30,089,"Montana","Sanders County",3,74,234,132,102
050,30,089,"Montana","Sanders County",3,75,152,84,68
050,30,089,"Montana","Sanders County",3,76,166,88,78
050,30,089,"Montana","Sanders County",3,77,156,83,73
050,30,089,"Montana","Sanders County",3,78,158,86,72
050,30,089,"Montana","Sanders County",3,79,126,68,58
050,30,089,"Montana","Sanders County",3,80,114,66,48
050,30,089,"Montana","Sanders County",3,81,102,60,42
050,30,089,"Montana","Sanders County",3,82,93,49,44
050,30,089,"Montana","Sanders County",3,83,85,45,40
050,30,089,"Montana","Sanders County",3,84,78,38,40
050,30,089,"Montana","Sanders County",3,85,347,147,200
050,30,089,"Montana","Sanders County",4,0,108,57,51
050,30,089,"Montana","Sanders County",4,1,78,42,36
050,30,089,"Montana","Sanders County",4,2,100,51,49
050,30,089,"Montana","Sanders County",4,3,101,52,49
050,30,089,"Montana","Sanders County",4,4,117,52,65
050,30,089,"Montana","Sanders County",4,5,124,65,59
050,30,089,"Montana","Sanders County",4,6,131,66,65
050,30,089,"Montana","Sanders County",4,7,146,78,68
050,30,089,"Montana","Sanders County",4,8,128,60,68
050,30,089,"Montana","Sanders County",4,9,134,65,69
050,30,089,"Montana","Sanders County",4,10,125,59,66
050,30,089,"Montana","Sanders County",4,11,121,64,57
050,30,089,"Montana","Sanders County",4,12,125,63,62
050,30,089,"Montana","Sanders County",4,13,134,64,70
050,30,089,"Montana","Sanders County",4,14,131,70,61
050,30,089,"Montana","Sanders County",4,15,171,102,69
050,30,089,"Montana","Sanders County",4,16,148,87,61
050,30,089,"Montana","Sanders County",4,17,150,87,63
050,30,089,"Montana","Sanders County",4,18,118,68,50
050,30,089,"Montana","Sanders County",4,19,85,46,39
050,30,089,"Montana","Sanders County",4,20,94,43,51
050,30,089,"Montana","Sanders County",4,21,90,45,45
050,30,089,"Montana","Sanders County",4,22,96,43,53
050,30,089,"Montana","Sanders County",4,23,104,55,49
050,30,089,"Montana","Sanders County",4,24,93,48,45
050,30,089,"Montana","Sanders County",4,25,92,50,42
050,30,089,"Montana","Sanders County",4,26,92,49,43
050,30,089,"Montana","Sanders County",4,27,104,60,44
050,30,089,"Montana","Sanders County",4,28,110,59,51
050,30,089,"Montana","Sanders County",4,29,123,62,61
050,30,089,"Montana","Sanders County",4,30,123,60,63
050,30,089,"Montana","Sanders County",4,31,126,62,64
050,30,089,"Montana","Sanders County",4,32,112,57,55
050,30,089,"Montana","Sanders County",4,33,121,51,70
050,30,089,"Montana","Sanders County",4,34,116,62,54
050,30,089,"Montana","Sanders County",4,35,120,53,67
050,30,089,"Montana","Sanders County",4,36,126,61,65
050,30,089,"Montana","Sanders County",4,37,128,64,64
050,30,089,"Montana","Sanders County",4,38,133,72,61
050,30,089,"Montana","Sanders County",4,39,126,58,68
050,30,089,"Montana","Sanders County",4,40,144,73,71
050,30,089,"Montana","Sanders County",4,41,108,53,55
050,30,089,"Montana","Sanders County",4,42,120,69,51
050,30,089,"Montana","Sanders County",4,43,133,72,61
050,30,089,"Montana","Sanders County",4,44,126,64,62
050,30,089,"Montana","Sanders County",4,45,129,60,69
050,30,089,"Montana","Sanders County",4,46,131,64,67
050,30,089,"Montana","Sanders County",4,47,139,63,76
050,30,089,"Montana","Sanders County",4,48,143,78,65
050,30,089,"Montana","Sanders County",4,49,146,76,70
050,30,089,"Montana","Sanders County",4,50,145,77,68
050,30,089,"Montana","Sanders County",4,51,179,98,81
050,30,089,"Montana","Sanders County",4,52,163,88,75
050,30,089,"Montana","Sanders County",4,53,159,83,76
050,30,089,"Montana","Sanders County",4,54,156,87,69
050,30,089,"Montana","Sanders County",4,55,164,81,83
050,30,089,"Montana","Sanders County",4,56,169,84,85
050,30,089,"Montana","Sanders County",4,57,171,83,88
050,30,089,"Montana","Sanders County",4,58,181,75,106
050,30,089,"Montana","Sanders County",4,59,212,100,112
050,30,089,"Montana","Sanders County",4,60,242,126,116
050,30,089,"Montana","Sanders County",4,61,241,136,105
050,30,089,"Montana","Sanders County",4,62,271,134,137
050,30,089,"Montana","Sanders County",4,63,298,131,167
050,30,089,"Montana","Sanders County",4,64,305,143,162
050,30,089,"Montana","Sanders County",4,65,291,144,147
050,30,089,"Montana","Sanders County",4,66,301,156,145
050,30,089,"Montana","Sanders County",4,67,282,134,148
050,30,089,"Montana","Sanders County",4,68,278,150,128
050,30,089,"Montana","Sanders County",4,69,277,137,140
050,30,089,"Montana","Sanders County",4,70,258,141,117
050,30,089,"Montana","Sanders County",4,71,255,143,112
050,30,089,"Montana","Sanders County",4,72,258,139,119
050,30,089,"Montana","Sanders County",4,73,236,123,113
050,30,089,"Montana","Sanders County",4,74,216,121,95
050,30,089,"Montana","Sanders County",4,75,227,127,100
050,30,089,"Montana","Sanders County",4,76,144,74,70
050,30,089,"Montana","Sanders County",4,77,162,85,77
050,30,089,"Montana","Sanders County",4,78,146,79,67
050,30,089,"Montana","Sanders County",4,79,151,84,67
050,30,089,"Montana","Sanders County",4,80,114,66,48
050,30,089,"Montana","Sanders County",4,81,107,64,43
050,30,089,"Montana","Sanders County",4,82,93,59,34
050,30,089,"Montana","Sanders County",4,83,73,35,38
050,30,089,"Montana","Sanders County",4,84,77,37,40
050,30,089,"Montana","Sanders County",4,85,359,155,204
050,30,089,"Montana","Sanders County",5,0,109,60,49
050,30,089,"Montana","Sanders County",5,1,114,59,55
050,30,089,"Montana","Sanders County",5,2,80,45,35
050,30,089,"Montana","Sanders County",5,3,99,44,55
050,30,089,"Montana","Sanders County",5,4,103,55,48
050,30,089,"Montana","Sanders County",5,5,117,54,63
050,30,089,"Montana","Sanders County",5,6,134,71,63
050,30,089,"Montana","Sanders County",5,7,139,73,66
050,30,089,"Montana","Sanders County",5,8,142,76,66
050,30,089,"Montana","Sanders County",5,9,126,60,66
050,30,089,"Montana","Sanders County",5,10,136,69,67
050,30,089,"Montana","Sanders County",5,11,120,51,69
050,30,089,"Montana","Sanders County",5,12,126,69,57
050,30,089,"Montana","Sanders County",5,13,133,67,66
050,30,089,"Montana","Sanders County",5,14,142,67,75
050,30,089,"Montana","Sanders County",5,15,145,78,67
050,30,089,"Montana","Sanders County",5,16,184,112,72
050,30,089,"Montana","Sanders County",5,17,149,82,67
050,30,089,"Montana","Sanders County",5,18,116,65,51
050,30,089,"Montana","Sanders County",5,19,88,52,36
050,30,089,"Montana","Sanders County",5,20,89,51,38
050,30,089,"Montana","Sanders County",5,21,98,41,57
050,30,089,"Montana","Sanders County",5,22,96,49,47
050,30,089,"Montana","Sanders County",5,23,113,56,57
050,30,089,"Montana","Sanders County",5,24,115,57,58
050,30,089,"Montana","Sanders County",5,25,99,55,44
050,30,089,"Montana","Sanders County",5,26,103,58,45
050,30,089,"Montana","Sanders County",5,27,94,50,44
050,30,089,"Montana","Sanders County",5,28,102,56,46
050,30,089,"Montana","Sanders County",5,29,129,72,57
050,30,089,"Montana","Sanders County",5,30,126,63,63
050,30,089,"Montana","Sanders County",5,31,134,63,71
050,30,089,"Montana","Sanders County",5,32,126,60,66
050,30,089,"Montana","Sanders County",5,33,120,58,62
050,30,089,"Montana","Sanders County",5,34,127,55,72
050,30,089,"Montana","Sanders County",5,35,121,66,55
050,30,089,"Montana","Sanders County",5,36,125,59,66
050,30,089,"Montana","Sanders County",5,37,138,68,70
050,30,089,"Montana","Sanders County",5,38,133,66,67
050,30,089,"Montana","Sanders County",5,39,144,75,69
050,30,089,"Montana","Sanders County",5,40,126,59,67
050,30,089,"Montana","Sanders County",5,41,146,73,73
050,30,089,"Montana","Sanders County",5,42,115,58,57
050,30,089,"Montana","Sanders County",5,43,131,73,58
050,30,089,"Montana","Sanders County",5,44,143,76,67
050,30,089,"Montana","Sanders County",5,45,138,73,65
050,30,089,"Montana","Sanders County",5,46,137,62,75
050,30,089,"Montana","Sanders County",5,47,141,70,71
050,30,089,"Montana","Sanders County",5,48,144,67,77
050,30,089,"Montana","Sanders County",5,49,144,78,66
050,30,089,"Montana","Sanders County",5,50,151,82,69
050,30,089,"Montana","Sanders County",5,51,155,79,76
050,30,089,"Montana","Sanders County",5,52,187,105,82
050,30,089,"Montana","Sanders County",5,53,183,99,84
050,30,089,"Montana","Sanders County",5,54,178,90,88
050,30,089,"Montana","Sanders County",5,55,173,95,78
050,30,089,"Montana","Sanders County",5,56,178,87,91
050,30,089,"Montana","Sanders County",5,57,175,89,86
050,30,089,"Montana","Sanders County",5,58,170,82,88
050,30,089,"Montana","Sanders County",5,59,184,76,108
050,30,089,"Montana","Sanders County",5,60,217,97,120
050,30,089,"Montana","Sanders County",5,61,242,125,117
050,30,089,"Montana","Sanders County",5,62,240,136,104
050,30,089,"Montana","Sanders County",5,63,288,143,145
050,30,089,"Montana","Sanders County",5,64,295,131,164
050,30,089,"Montana","Sanders County",5,65,315,148,167
050,30,089,"Montana","Sanders County",5,66,296,151,145
050,30,089,"Montana","Sanders County",5,67,303,157,146
050,30,089,"Montana","Sanders County",5,68,289,137,152
050,30,089,"Montana","Sanders County",5,69,279,154,125
050,30,089,"Montana","Sanders County",5,70,278,140,138
050,30,089,"Montana","Sanders County",5,71,264,145,119
050,30,089,"Montana","Sanders County",5,72,245,139,106
050,30,089,"Montana","Sanders County",5,73,250,137,113
050,30,089,"Montana","Sanders County",5,74,232,119,113
050,30,089,"Montana","Sanders County",5,75,211,119,92
050,30,089,"Montana","Sanders County",5,76,216,119,97
050,30,089,"Montana","Sanders County",5,77,136,72,64
050,30,089,"Montana","Sanders County",5,78,154,83,71
050,30,089,"Montana","Sanders County",5,79,144,77,67
050,30,089,"Montana","Sanders County",5,80,135,76,59
050,30,089,"Montana","Sanders County",5,81,107,67,40
050,30,089,"Montana","Sanders County",5,82,99,61,38
050,30,089,"Montana","Sanders County",5,83,79,49,30
050,30,089,"Montana","Sanders County",5,84,65,28,37
050,30,089,"Montana","Sanders County",5,85,372,165,207
050,30,091,"Montana","Sheridan County",1,0,41,22,19
050,30,091,"Montana","Sheridan County",1,1,43,22,21
050,30,091,"Montana","Sheridan County",1,2,39,22,17
050,30,091,"Montana","Sheridan County",1,3,39,23,16
050,30,091,"Montana","Sheridan County",1,4,44,21,23
050,30,091,"Montana","Sheridan County",1,5,41,30,11
050,30,091,"Montana","Sheridan County",1,6,31,21,10
050,30,091,"Montana","Sheridan County",1,7,43,28,15
050,30,091,"Montana","Sheridan County",1,8,45,23,22
050,30,091,"Montana","Sheridan County",1,9,42,21,21
050,30,091,"Montana","Sheridan County",1,10,39,23,16
050,30,091,"Montana","Sheridan County",1,11,41,24,17
050,30,091,"Montana","Sheridan County",1,12,38,17,21
050,30,091,"Montana","Sheridan County",1,13,44,19,25
050,30,091,"Montana","Sheridan County",1,14,49,25,24
050,30,091,"Montana","Sheridan County",1,15,53,26,27
050,30,091,"Montana","Sheridan County",1,16,44,19,25
050,30,091,"Montana","Sheridan County",1,17,29,18,11
050,30,091,"Montana","Sheridan County",1,18,33,20,13
050,30,091,"Montana","Sheridan County",1,19,25,14,11
050,30,091,"Montana","Sheridan County",1,20,27,16,11
050,30,091,"Montana","Sheridan County",1,21,31,18,13
050,30,091,"Montana","Sheridan County",1,22,27,11,16
050,30,091,"Montana","Sheridan County",1,23,35,21,14
050,30,091,"Montana","Sheridan County",1,24,38,23,15
050,30,091,"Montana","Sheridan County",1,25,32,15,17
050,30,091,"Montana","Sheridan County",1,26,35,17,18
050,30,091,"Montana","Sheridan County",1,27,31,15,16
050,30,091,"Montana","Sheridan County",1,28,35,20,15
050,30,091,"Montana","Sheridan County",1,29,25,14,11
050,30,091,"Montana","Sheridan County",1,30,30,17,13
050,30,091,"Montana","Sheridan County",1,31,32,14,18
050,30,091,"Montana","Sheridan County",1,32,36,15,21
050,30,091,"Montana","Sheridan County",1,33,41,23,18
050,30,091,"Montana","Sheridan County",1,34,39,19,20
050,30,091,"Montana","Sheridan County",1,35,42,20,22
050,30,091,"Montana","Sheridan County",1,36,49,28,21
050,30,091,"Montana","Sheridan County",1,37,61,33,28
050,30,091,"Montana","Sheridan County",1,38,51,31,20
050,30,091,"Montana","Sheridan County",1,39,40,20,20
050,30,091,"Montana","Sheridan County",1,40,37,22,15
050,30,091,"Montana","Sheridan County",1,41,44,17,27
050,30,091,"Montana","Sheridan County",1,42,43,16,27
050,30,091,"Montana","Sheridan County",1,43,42,16,26
050,30,091,"Montana","Sheridan County",1,44,34,17,17
050,30,091,"Montana","Sheridan County",1,45,33,22,11
050,30,091,"Montana","Sheridan County",1,46,40,25,15
050,30,091,"Montana","Sheridan County",1,47,47,26,21
050,30,091,"Montana","Sheridan County",1,48,35,13,22
050,30,091,"Montana","Sheridan County",1,49,32,12,20
050,30,091,"Montana","Sheridan County",1,50,31,13,18
050,30,091,"Montana","Sheridan County",1,51,33,15,18
050,30,091,"Montana","Sheridan County",1,52,33,14,19
050,30,091,"Montana","Sheridan County",1,53,41,20,21
050,30,091,"Montana","Sheridan County",1,54,47,22,25
050,30,091,"Montana","Sheridan County",1,55,53,24,29
050,30,091,"Montana","Sheridan County",1,56,57,28,29
050,30,091,"Montana","Sheridan County",1,57,61,32,29
050,30,091,"Montana","Sheridan County",1,58,55,34,21
050,30,091,"Montana","Sheridan County",1,59,54,34,20
050,30,091,"Montana","Sheridan County",1,60,48,28,20
050,30,091,"Montana","Sheridan County",1,61,57,33,24
050,30,091,"Montana","Sheridan County",1,62,66,35,31
050,30,091,"Montana","Sheridan County",1,63,77,44,33
050,30,091,"Montana","Sheridan County",1,64,75,45,30
050,30,091,"Montana","Sheridan County",1,65,61,33,28
050,30,091,"Montana","Sheridan County",1,66,63,35,28
050,30,091,"Montana","Sheridan County",1,67,66,38,28
050,30,091,"Montana","Sheridan County",1,68,64,38,26
050,30,091,"Montana","Sheridan County",1,69,51,28,23
050,30,091,"Montana","Sheridan County",1,70,39,18,21
050,30,091,"Montana","Sheridan County",1,71,45,23,22
050,30,091,"Montana","Sheridan County",1,72,34,14,20
050,30,091,"Montana","Sheridan County",1,73,35,16,19
050,30,091,"Montana","Sheridan County",1,74,29,14,15
050,30,091,"Montana","Sheridan County",1,75,25,10,15
050,30,091,"Montana","Sheridan County",1,76,33,15,18
050,30,091,"Montana","Sheridan County",1,77,29,12,17
050,30,091,"Montana","Sheridan County",1,78,20,6,14
050,30,091,"Montana","Sheridan County",1,79,22,11,11
050,30,091,"Montana","Sheridan County",1,80,24,12,12
050,30,091,"Montana","Sheridan County",1,81,25,11,14
050,30,091,"Montana","Sheridan County",1,82,21,9,12
050,30,091,"Montana","Sheridan County",1,83,21,10,11
050,30,091,"Montana","Sheridan County",1,84,22,12,10
050,30,091,"Montana","Sheridan County",1,85,102,40,62
050,30,091,"Montana","Sheridan County",2,0,43,26,17
050,30,091,"Montana","Sheridan County",2,1,43,22,21
050,30,091,"Montana","Sheridan County",2,2,41,23,18
050,30,091,"Montana","Sheridan County",2,3,39,23,16
050,30,091,"Montana","Sheridan County",2,4,42,21,21
050,30,091,"Montana","Sheridan County",2,5,42,28,14
050,30,091,"Montana","Sheridan County",2,6,35,24,11
050,30,091,"Montana","Sheridan County",2,7,39,26,13
050,30,091,"Montana","Sheridan County",2,8,44,24,20
050,30,091,"Montana","Sheridan County",2,9,41,20,21
050,30,091,"Montana","Sheridan County",2,10,39,22,17
050,30,091,"Montana","Sheridan County",2,11,39,22,17
050,30,091,"Montana","Sheridan County",2,12,39,18,21
050,30,091,"Montana","Sheridan County",2,13,44,19,25
050,30,091,"Montana","Sheridan County",2,14,47,24,23
050,30,091,"Montana","Sheridan County",2,15,52,25,27
050,30,091,"Montana","Sheridan County",2,16,46,20,26
050,30,091,"Montana","Sheridan County",2,17,32,18,14
050,30,091,"Montana","Sheridan County",2,18,30,19,11
050,30,091,"Montana","Sheridan County",2,19,25,15,10
050,30,091,"Montana","Sheridan County",2,20,27,16,11
050,30,091,"Montana","Sheridan County",2,21,31,18,13
050,30,091,"Montana","Sheridan County",2,22,29,14,15
050,30,091,"Montana","Sheridan County",2,23,35,21,14
050,30,091,"Montana","Sheridan County",2,24,37,22,15
050,30,091,"Montana","Sheridan County",2,25,32,16,16
050,30,091,"Montana","Sheridan County",2,26,33,16,17
050,30,091,"Montana","Sheridan County",2,27,31,15,16
050,30,091,"Montana","Sheridan County",2,28,32,18,14
050,30,091,"Montana","Sheridan County",2,29,28,16,12
050,30,091,"Montana","Sheridan County",2,30,29,17,12
050,30,091,"Montana","Sheridan County",2,31,33,15,18
050,30,091,"Montana","Sheridan County",2,32,36,15,21
050,30,091,"Montana","Sheridan County",2,33,39,21,18
050,30,091,"Montana","Sheridan County",2,34,38,19,19
050,30,091,"Montana","Sheridan County",2,35,41,20,21
050,30,091,"Montana","Sheridan County",2,36,47,25,22
050,30,091,"Montana","Sheridan County",2,37,57,32,25
050,30,091,"Montana","Sheridan County",2,38,54,31,23
050,30,091,"Montana","Sheridan County",2,39,42,22,20
050,30,091,"Montana","Sheridan County",2,40,39,22,17
050,30,091,"Montana","Sheridan County",2,41,43,19,24
050,30,091,"Montana","Sheridan County",2,42,42,16,26
050,30,091,"Montana","Sheridan County",2,43,42,16,26
050,30,091,"Montana","Sheridan County",2,44,36,17,19
050,30,091,"Montana","Sheridan County",2,45,34,21,13
050,30,091,"Montana","Sheridan County",2,46,39,25,14
050,30,091,"Montana","Sheridan County",2,47,46,26,20
050,30,091,"Montana","Sheridan County",2,48,38,15,23
050,30,091,"Montana","Sheridan County",2,49,32,12,20
050,30,091,"Montana","Sheridan County",2,50,31,13,18
050,30,091,"Montana","Sheridan County",2,51,33,15,18
050,30,091,"Montana","Sheridan County",2,52,33,14,19
050,30,091,"Montana","Sheridan County",2,53,40,19,21
050,30,091,"Montana","Sheridan County",2,54,45,21,24
050,30,091,"Montana","Sheridan County",2,55,51,24,27
050,30,091,"Montana","Sheridan County",2,56,56,27,29
050,30,091,"Montana","Sheridan County",2,57,61,32,29
050,30,091,"Montana","Sheridan County",2,58,55,34,21
050,30,091,"Montana","Sheridan County",2,59,53,33,20
050,30,091,"Montana","Sheridan County",2,60,50,30,20
050,30,091,"Montana","Sheridan County",2,61,55,32,23
050,30,091,"Montana","Sheridan County",2,62,63,34,29
050,30,091,"Montana","Sheridan County",2,63,76,43,33
050,30,091,"Montana","Sheridan County",2,64,74,43,31
050,30,091,"Montana","Sheridan County",2,65,64,36,28
050,30,091,"Montana","Sheridan County",2,66,63,35,28
050,30,091,"Montana","Sheridan County",2,67,65,37,28
050,30,091,"Montana","Sheridan County",2,68,65,39,26
050,30,091,"Montana","Sheridan County",2,69,53,29,24
050,30,091,"Montana","Sheridan County",2,70,42,21,21
050,30,091,"Montana","Sheridan County",2,71,44,22,22
050,30,091,"Montana","Sheridan County",2,72,36,16,20
050,30,091,"Montana","Sheridan County",2,73,35,16,19
050,30,091,"Montana","Sheridan County",2,74,29,14,15
050,30,091,"Montana","Sheridan County",2,75,26,11,15
050,30,091,"Montana","Sheridan County",2,76,30,13,17
050,30,091,"Montana","Sheridan County",2,77,30,13,17
050,30,091,"Montana","Sheridan County",2,78,21,7,14
050,30,091,"Montana","Sheridan County",2,79,21,10,11
050,30,091,"Montana","Sheridan County",2,80,23,12,11
050,30,091,"Montana","Sheridan County",2,81,25,11,14
050,30,091,"Montana","Sheridan County",2,82,22,10,12
050,30,091,"Montana","Sheridan County",2,83,21,10,11
050,30,091,"Montana","Sheridan County",2,84,22,11,11
050,30,091,"Montana","Sheridan County",2,85,103,42,61
050,30,091,"Montana","Sheridan County",3,0,37,24,13
050,30,091,"Montana","Sheridan County",3,1,43,28,15
050,30,091,"Montana","Sheridan County",3,2,41,18,23
050,30,091,"Montana","Sheridan County",3,3,45,29,16
050,30,091,"Montana","Sheridan County",3,4,40,23,17
050,30,091,"Montana","Sheridan County",3,5,39,18,21
050,30,091,"Montana","Sheridan County",3,6,44,29,15
050,30,091,"Montana","Sheridan County",3,7,35,24,11
050,30,091,"Montana","Sheridan County",3,8,39,25,14
050,30,091,"Montana","Sheridan County",3,9,46,26,20
050,30,091,"Montana","Sheridan County",3,10,41,19,22
050,30,091,"Montana","Sheridan County",3,11,41,23,18
050,30,091,"Montana","Sheridan County",3,12,38,21,17
050,30,091,"Montana","Sheridan County",3,13,41,22,19
050,30,091,"Montana","Sheridan County",3,14,42,21,21
050,30,091,"Montana","Sheridan County",3,15,40,22,18
050,30,091,"Montana","Sheridan County",3,16,55,27,28
050,30,091,"Montana","Sheridan County",3,17,45,21,24
050,30,091,"Montana","Sheridan County",3,18,27,17,10
050,30,091,"Montana","Sheridan County",3,19,26,17,9
050,30,091,"Montana","Sheridan County",3,20,31,19,12
050,30,091,"Montana","Sheridan County",3,21,27,17,10
050,30,091,"Montana","Sheridan County",3,22,35,19,16
050,30,091,"Montana","Sheridan County",3,23,32,16,16
050,30,091,"Montana","Sheridan County",3,24,34,18,16
050,30,091,"Montana","Sheridan County",3,25,35,22,13
050,30,091,"Montana","Sheridan County",3,26,30,15,15
050,30,091,"Montana","Sheridan County",3,27,33,15,18
050,30,091,"Montana","Sheridan County",3,28,38,20,18
050,30,091,"Montana","Sheridan County",3,29,34,18,16
050,30,091,"Montana","Sheridan County",3,30,30,16,14
050,30,091,"Montana","Sheridan County",3,31,33,20,13
050,30,091,"Montana","Sheridan County",3,32,31,15,16
050,30,091,"Montana","Sheridan County",3,33,43,19,24
050,30,091,"Montana","Sheridan County",3,34,40,23,17
050,30,091,"Montana","Sheridan County",3,35,35,18,17
050,30,091,"Montana","Sheridan County",3,36,37,17,20
050,30,091,"Montana","Sheridan County",3,37,45,25,20
050,30,091,"Montana","Sheridan County",3,38,58,32,26
050,30,091,"Montana","Sheridan County",3,39,53,30,23
050,30,091,"Montana","Sheridan County",3,40,42,23,19
050,30,091,"Montana","Sheridan County",3,41,40,23,17
050,30,091,"Montana","Sheridan County",3,42,44,20,24
050,30,091,"Montana","Sheridan County",3,43,42,15,27
050,30,091,"Montana","Sheridan County",3,44,42,16,26
050,30,091,"Montana","Sheridan County",3,45,37,16,21
050,30,091,"Montana","Sheridan County",3,46,33,19,14
050,30,091,"Montana","Sheridan County",3,47,39,27,12
050,30,091,"Montana","Sheridan County",3,48,49,25,24
050,30,091,"Montana","Sheridan County",3,49,34,13,21
050,30,091,"Montana","Sheridan County",3,50,37,14,23
050,30,091,"Montana","Sheridan County",3,51,36,15,21
050,30,091,"Montana","Sheridan County",3,52,33,16,17
050,30,091,"Montana","Sheridan County",3,53,33,14,19
050,30,091,"Montana","Sheridan County",3,54,39,18,21
050,30,091,"Montana","Sheridan County",3,55,48,24,24
050,30,091,"Montana","Sheridan County",3,56,55,27,28
050,30,091,"Montana","Sheridan County",3,57,62,28,34
050,30,091,"Montana","Sheridan County",3,58,58,32,26
050,30,091,"Montana","Sheridan County",3,59,56,34,22
050,30,091,"Montana","Sheridan County",3,60,56,35,21
050,30,091,"Montana","Sheridan County",3,61,49,29,20
050,30,091,"Montana","Sheridan County",3,62,53,31,22
050,30,091,"Montana","Sheridan County",3,63,61,33,28
050,30,091,"Montana","Sheridan County",3,64,73,41,32
050,30,091,"Montana","Sheridan County",3,65,76,43,33
050,30,091,"Montana","Sheridan County",3,66,64,35,29
050,30,091,"Montana","Sheridan County",3,67,64,34,30
050,30,091,"Montana","Sheridan County",3,68,64,37,27
050,30,091,"Montana","Sheridan County",3,69,60,35,25
050,30,091,"Montana","Sheridan County",3,70,52,28,24
050,30,091,"Montana","Sheridan County",3,71,41,20,21
050,30,091,"Montana","Sheridan County",3,72,43,22,21
050,30,091,"Montana","Sheridan County",3,73,37,16,21
050,30,091,"Montana","Sheridan County",3,74,35,16,19
050,30,091,"Montana","Sheridan County",3,75,29,14,15
050,30,091,"Montana","Sheridan County",3,76,28,12,16
050,30,091,"Montana","Sheridan County",3,77,25,11,14
050,30,091,"Montana","Sheridan County",3,78,29,13,16
050,30,091,"Montana","Sheridan County",3,79,21,7,14
050,30,091,"Montana","Sheridan County",3,80,21,10,11
050,30,091,"Montana","Sheridan County",3,81,22,10,12
050,30,091,"Montana","Sheridan County",3,82,24,12,12
050,30,091,"Montana","Sheridan County",3,83,22,11,11
050,30,091,"Montana","Sheridan County",3,84,21,7,14
050,30,091,"Montana","Sheridan County",3,85,108,48,60
050,30,091,"Montana","Sheridan County",4,0,36,19,17
050,30,091,"Montana","Sheridan County",4,1,39,26,13
050,30,091,"Montana","Sheridan County",4,2,49,32,17
050,30,091,"Montana","Sheridan County",4,3,41,19,22
050,30,091,"Montana","Sheridan County",4,4,47,31,16
050,30,091,"Montana","Sheridan County",4,5,45,26,19
050,30,091,"Montana","Sheridan County",4,6,41,19,22
050,30,091,"Montana","Sheridan County",4,7,42,27,15
050,30,091,"Montana","Sheridan County",4,8,37,25,12
050,30,091,"Montana","Sheridan County",4,9,37,23,14
050,30,091,"Montana","Sheridan County",4,10,44,27,17
050,30,091,"Montana","Sheridan County",4,11,41,19,22
050,30,091,"Montana","Sheridan County",4,12,38,21,17
050,30,091,"Montana","Sheridan County",4,13,37,20,17
050,30,091,"Montana","Sheridan County",4,14,41,22,19
050,30,091,"Montana","Sheridan County",4,15,43,22,21
050,30,091,"Montana","Sheridan County",4,16,44,25,19
050,30,091,"Montana","Sheridan County",4,17,54,26,28
050,30,091,"Montana","Sheridan County",4,18,38,20,18
050,30,091,"Montana","Sheridan County",4,19,20,13,7
050,30,091,"Montana","Sheridan County",4,20,28,18,10
050,30,091,"Montana","Sheridan County",4,21,31,18,13
050,30,091,"Montana","Sheridan County",4,22,26,16,10
050,30,091,"Montana","Sheridan County",4,23,33,19,14
050,30,091,"Montana","Sheridan County",4,24,33,14,19
050,30,091,"Montana","Sheridan County",4,25,32,17,15
050,30,091,"Montana","Sheridan County",4,26,31,21,10
050,30,091,"Montana","Sheridan County",4,27,35,18,17
050,30,091,"Montana","Sheridan County",4,28,37,17,20
050,30,091,"Montana","Sheridan County",4,29,41,23,18
050,30,091,"Montana","Sheridan County",4,30,34,18,16
050,30,091,"Montana","Sheridan County",4,31,29,16,13
050,30,091,"Montana","Sheridan County",4,32,33,18,15
050,30,091,"Montana","Sheridan County",4,33,34,18,16
050,30,091,"Montana","Sheridan County",4,34,46,20,26
050,30,091,"Montana","Sheridan County",4,35,40,24,16
050,30,091,"Montana","Sheridan County",4,36,33,17,16
050,30,091,"Montana","Sheridan County",4,37,34,17,17
050,30,091,"Montana","Sheridan County",4,38,45,24,21
050,30,091,"Montana","Sheridan County",4,39,59,33,26
050,30,091,"Montana","Sheridan County",4,40,49,28,21
050,30,091,"Montana","Sheridan County",4,41,37,19,18
050,30,091,"Montana","Sheridan County",4,42,40,23,17
050,30,091,"Montana","Sheridan County",4,43,46,21,25
050,30,091,"Montana","Sheridan County",4,44,43,15,28
050,30,091,"Montana","Sheridan County",4,45,46,20,26
050,30,091,"Montana","Sheridan County",4,46,37,16,21
050,30,091,"Montana","Sheridan County",4,47,35,22,13
050,30,091,"Montana","Sheridan County",4,48,38,24,14
050,30,091,"Montana","Sheridan County",4,49,50,26,24
050,30,091,"Montana","Sheridan County",4,50,35,14,21
050,30,091,"Montana","Sheridan County",4,51,36,14,22
050,30,091,"Montana","Sheridan County",4,52,33,14,19
050,30,091,"Montana","Sheridan County",4,53,33,18,15
050,30,091,"Montana","Sheridan County",4,54,34,14,20
050,30,091,"Montana","Sheridan County",4,55,39,19,20
050,30,091,"Montana","Sheridan County",4,56,53,25,28
050,30,091,"Montana","Sheridan County",4,57,61,31,30
050,30,091,"Montana","Sheridan County",4,58,59,26,33
050,30,091,"Montana","Sheridan County",4,59,58,32,26
050,30,091,"Montana","Sheridan County",4,60,54,34,20
050,30,091,"Montana","Sheridan County",4,61,55,33,22
050,30,091,"Montana","Sheridan County",4,62,49,29,20
050,30,091,"Montana","Sheridan County",4,63,50,27,23
050,30,091,"Montana","Sheridan County",4,64,61,32,29
050,30,091,"Montana","Sheridan County",4,65,68,38,30
050,30,091,"Montana","Sheridan County",4,66,77,42,35
050,30,091,"Montana","Sheridan County",4,67,58,31,27
050,30,091,"Montana","Sheridan County",4,68,62,33,29
050,30,091,"Montana","Sheridan County",4,69,59,33,26
050,30,091,"Montana","Sheridan County",4,70,59,33,26
050,30,091,"Montana","Sheridan County",4,71,47,24,23
050,30,091,"Montana","Sheridan County",4,72,40,18,22
050,30,091,"Montana","Sheridan County",4,73,43,22,21
050,30,091,"Montana","Sheridan County",4,74,37,16,21
050,30,091,"Montana","Sheridan County",4,75,32,15,17
050,30,091,"Montana","Sheridan County",4,76,31,15,16
050,30,091,"Montana","Sheridan County",4,77,25,11,14
050,30,091,"Montana","Sheridan County",4,78,21,10,11
050,30,091,"Montana","Sheridan County",4,79,29,12,17
050,30,091,"Montana","Sheridan County",4,80,19,7,12
050,30,091,"Montana","Sheridan County",4,81,18,7,11
050,30,091,"Montana","Sheridan County",4,82,21,10,11
050,30,091,"Montana","Sheridan County",4,83,22,11,11
050,30,091,"Montana","Sheridan County",4,84,21,8,13
050,30,091,"Montana","Sheridan County",4,85,107,50,57
050,30,091,"Montana","Sheridan County",5,0,33,18,15
050,30,091,"Montana","Sheridan County",5,1,38,19,19
050,30,091,"Montana","Sheridan County",5,2,31,18,13
050,30,091,"Montana","Sheridan County",5,3,49,32,17
050,30,091,"Montana","Sheridan County",5,4,38,19,19
050,30,091,"Montana","Sheridan County",5,5,46,30,16
050,30,091,"Montana","Sheridan County",5,6,41,24,17
050,30,091,"Montana","Sheridan County",5,7,38,18,20
050,30,091,"Montana","Sheridan County",5,8,41,25,16
050,30,091,"Montana","Sheridan County",5,9,35,22,13
050,30,091,"Montana","Sheridan County",5,10,36,23,13
050,30,091,"Montana","Sheridan County",5,11,47,29,18
050,30,091,"Montana","Sheridan County",5,12,41,18,23
050,30,091,"Montana","Sheridan County",5,13,40,22,18
050,30,091,"Montana","Sheridan County",5,14,37,20,17
050,30,091,"Montana","Sheridan County",5,15,43,23,20
050,30,091,"Montana","Sheridan County",5,16,45,24,21
050,30,091,"Montana","Sheridan County",5,17,44,24,20
050,30,091,"Montana","Sheridan County",5,18,45,22,23
050,30,091,"Montana","Sheridan County",5,19,29,16,13
050,30,091,"Montana","Sheridan County",5,20,22,13,9
050,30,091,"Montana","Sheridan County",5,21,26,18,8
050,30,091,"Montana","Sheridan County",5,22,32,17,15
050,30,091,"Montana","Sheridan County",5,23,29,18,11
050,30,091,"Montana","Sheridan County",5,24,30,16,14
050,30,091,"Montana","Sheridan County",5,25,27,12,15
050,30,091,"Montana","Sheridan County",5,26,30,16,14
050,30,091,"Montana","Sheridan County",5,27,29,18,11
050,30,091,"Montana","Sheridan County",5,28,39,19,20
050,30,091,"Montana","Sheridan County",5,29,46,22,24
050,30,091,"Montana","Sheridan County",5,30,40,23,17
050,30,091,"Montana","Sheridan County",5,31,36,20,16
050,30,091,"Montana","Sheridan County",5,32,33,19,14
050,30,091,"Montana","Sheridan County",5,33,32,20,12
050,30,091,"Montana","Sheridan County",5,34,34,16,18
050,30,091,"Montana","Sheridan County",5,35,45,20,25
050,30,091,"Montana","Sheridan County",5,36,46,27,19
050,30,091,"Montana","Sheridan County",5,37,32,18,14
050,30,091,"Montana","Sheridan County",5,38,36,20,16
050,30,091,"Montana","Sheridan County",5,39,42,24,18
050,30,091,"Montana","Sheridan County",5,40,55,32,23
050,30,091,"Montana","Sheridan County",5,41,49,27,22
050,30,091,"Montana","Sheridan County",5,42,36,19,17
050,30,091,"Montana","Sheridan County",5,43,39,24,15
050,30,091,"Montana","Sheridan County",5,44,46,20,26
050,30,091,"Montana","Sheridan County",5,45,40,14,26
050,30,091,"Montana","Sheridan County",5,46,45,18,27
050,30,091,"Montana","Sheridan County",5,47,40,18,22
050,30,091,"Montana","Sheridan County",5,48,32,18,14
050,30,091,"Montana","Sheridan County",5,49,38,25,13
050,30,091,"Montana","Sheridan County",5,50,50,27,23
050,30,091,"Montana","Sheridan County",5,51,35,14,21
050,30,091,"Montana","Sheridan County",5,52,36,15,21
050,30,091,"Montana","Sheridan County",5,53,31,13,18
050,30,091,"Montana","Sheridan County",5,54,33,17,16
050,30,091,"Montana","Sheridan County",5,55,37,17,20
050,30,091,"Montana","Sheridan County",5,56,40,16,24
050,30,091,"Montana","Sheridan County",5,57,56,25,31
050,30,091,"Montana","Sheridan County",5,58,61,33,28
050,30,091,"Montana","Sheridan County",5,59,59,26,33
050,30,091,"Montana","Sheridan County",5,60,57,32,25
050,30,091,"Montana","Sheridan County",5,61,54,34,20
050,30,091,"Montana","Sheridan County",5,62,57,34,23
050,30,091,"Montana","Sheridan County",5,63,43,22,21
050,30,091,"Montana","Sheridan County",5,64,49,26,23
050,30,091,"Montana","Sheridan County",5,65,60,31,29
050,30,091,"Montana","Sheridan County",5,66,68,37,31
050,30,091,"Montana","Sheridan County",5,67,75,42,33
050,30,091,"Montana","Sheridan County",5,68,62,34,28
050,30,091,"Montana","Sheridan County",5,69,57,28,29
050,30,091,"Montana","Sheridan County",5,70,55,32,23
050,30,091,"Montana","Sheridan County",5,71,52,28,24
050,30,091,"Montana","Sheridan County",5,72,45,22,23
050,30,091,"Montana","Sheridan County",5,73,40,18,22
050,30,091,"Montana","Sheridan County",5,74,43,23,20
050,30,091,"Montana","Sheridan County",5,75,34,15,19
050,30,091,"Montana","Sheridan County",5,76,32,15,17
050,30,091,"Montana","Sheridan County",5,77,29,14,15
050,30,091,"Montana","Sheridan County",5,78,20,8,12
050,30,091,"Montana","Sheridan County",5,79,19,9,10
050,30,091,"Montana","Sheridan County",5,80,25,12,13
050,30,091,"Montana","Sheridan County",5,81,16,4,12
050,30,091,"Montana","Sheridan County",5,82,17,7,10
050,30,091,"Montana","Sheridan County",5,83,17,7,10
050,30,091,"Montana","Sheridan County",5,84,21,9,12
050,30,091,"Montana","Sheridan County",5,85,110,52,58
050,30,093,"Montana","Silver Bow County",1,0,362,185,177
050,30,093,"Montana","Silver Bow County",1,1,346,180,166
050,30,093,"Montana","Silver Bow County",1,2,383,193,190
050,30,093,"Montana","Silver Bow County",1,3,409,209,200
050,30,093,"Montana","Silver Bow County",1,4,421,229,192
050,30,093,"Montana","Silver Bow County",1,5,435,234,201
050,30,093,"Montana","Silver Bow County",1,6,418,216,202
050,30,093,"Montana","Silver Bow County",1,7,413,215,198
050,30,093,"Montana","Silver Bow County",1,8,420,223,197
050,30,093,"Montana","Silver Bow County",1,9,394,198,196
050,30,093,"Montana","Silver Bow County",1,10,425,205,220
050,30,093,"Montana","Silver Bow County",1,11,407,208,199
050,30,093,"Montana","Silver Bow County",1,12,437,234,203
050,30,093,"Montana","Silver Bow County",1,13,424,226,198
050,30,093,"Montana","Silver Bow County",1,14,362,191,171
050,30,093,"Montana","Silver Bow County",1,15,383,204,179
050,30,093,"Montana","Silver Bow County",1,16,403,191,212
050,30,093,"Montana","Silver Bow County",1,17,382,192,190
050,30,093,"Montana","Silver Bow County",1,18,398,219,179
050,30,093,"Montana","Silver Bow County",1,19,503,295,208
050,30,093,"Montana","Silver Bow County",1,20,541,331,210
050,30,093,"Montana","Silver Bow County",1,21,625,342,283
050,30,093,"Montana","Silver Bow County",1,22,571,289,282
050,30,093,"Montana","Silver Bow County",1,23,631,307,324
050,30,093,"Montana","Silver Bow County",1,24,543,258,285
050,30,093,"Montana","Silver Bow County",1,25,537,256,281
050,30,093,"Montana","Silver Bow County",1,26,497,256,241
050,30,093,"Montana","Silver Bow County",1,27,483,250,233
050,30,093,"Montana","Silver Bow County",1,28,476,245,231
050,30,093,"Montana","Silver Bow County",1,29,451,230,221
050,30,093,"Montana","Silver Bow County",1,30,406,209,197
050,30,093,"Montana","Silver Bow County",1,31,394,204,190
050,30,093,"Montana","Silver Bow County",1,32,406,198,208
050,30,093,"Montana","Silver Bow County",1,33,376,211,165
050,30,093,"Montana","Silver Bow County",1,34,403,216,187
050,30,093,"Montana","Silver Bow County",1,35,387,213,174
050,30,093,"Montana","Silver Bow County",1,36,422,222,200
050,30,093,"Montana","Silver Bow County",1,37,417,223,194
050,30,093,"Montana","Silver Bow County",1,38,434,228,206
050,30,093,"Montana","Silver Bow County",1,39,447,239,208
050,30,093,"Montana","Silver Bow County",1,40,435,231,204
050,30,093,"Montana","Silver Bow County",1,41,402,217,185
050,30,093,"Montana","Silver Bow County",1,42,403,217,186
050,30,093,"Montana","Silver Bow County",1,43,359,192,167
050,30,093,"Montana","Silver Bow County",1,44,373,197,176
050,30,093,"Montana","Silver Bow County",1,45,355,172,183
050,30,093,"Montana","Silver Bow County",1,46,335,173,162
050,30,093,"Montana","Silver Bow County",1,47,360,185,175
050,30,093,"Montana","Silver Bow County",1,48,362,178,184
050,30,093,"Montana","Silver Bow County",1,49,422,214,208
050,30,093,"Montana","Silver Bow County",1,50,398,204,194
050,30,093,"Montana","Silver Bow County",1,51,398,201,197
050,30,093,"Montana","Silver Bow County",1,52,401,207,194
050,30,093,"Montana","Silver Bow County",1,53,407,214,193
050,30,093,"Montana","Silver Bow County",1,54,420,204,216
050,30,093,"Montana","Silver Bow County",1,55,444,241,203
050,30,093,"Montana","Silver Bow County",1,56,459,241,218
050,30,093,"Montana","Silver Bow County",1,57,475,242,233
050,30,093,"Montana","Silver Bow County",1,58,489,247,242
050,30,093,"Montana","Silver Bow County",1,59,514,253,261
050,30,093,"Montana","Silver Bow County",1,60,536,267,269
050,30,093,"Montana","Silver Bow County",1,61,568,279,289
050,30,093,"Montana","Silver Bow County",1,62,543,271,272
050,30,093,"Montana","Silver Bow County",1,63,529,271,258
050,30,093,"Montana","Silver Bow County",1,64,490,236,254
050,30,093,"Montana","Silver Bow County",1,65,493,239,254
050,30,093,"Montana","Silver Bow County",1,66,454,230,224
050,30,093,"Montana","Silver Bow County",1,67,473,234,239
050,30,093,"Montana","Silver Bow County",1,68,471,233,238
050,30,093,"Montana","Silver Bow County",1,69,424,207,217
050,30,093,"Montana","Silver Bow County",1,70,371,181,190
050,30,093,"Montana","Silver Bow County",1,71,351,163,188
050,30,093,"Montana","Silver Bow County",1,72,342,174,168
050,30,093,"Montana","Silver Bow County",1,73,358,182,176
050,30,093,"Montana","Silver Bow County",1,74,254,131,123
050,30,093,"Montana","Silver Bow County",1,75,243,125,118
050,30,093,"Montana","Silver Bow County",1,76,243,111,132
050,30,093,"Montana","Silver Bow County",1,77,253,119,134
050,30,093,"Montana","Silver Bow County",1,78,226,105,121
050,30,093,"Montana","Silver Bow County",1,79,214,94,120
050,30,093,"Montana","Silver Bow County",1,80,188,94,94
050,30,093,"Montana","Silver Bow County",1,81,174,83,91
050,30,093,"Montana","Silver Bow County",1,82,157,73,84
050,30,093,"Montana","Silver Bow County",1,83,152,71,81
050,30,093,"Montana","Silver Bow County",1,84,120,49,71
050,30,093,"Montana","Silver Bow County",1,85,722,240,482
050,30,093,"Montana","Silver Bow County",2,0,358,178,180
050,30,093,"Montana","Silver Bow County",2,1,350,182,168
050,30,093,"Montana","Silver Bow County",2,2,376,191,185
050,30,093,"Montana","Silver Bow County",2,3,405,206,199
050,30,093,"Montana","Silver Bow County",2,4,417,223,194
050,30,093,"Montana","Silver Bow County",2,5,438,236,202
050,30,093,"Montana","Silver Bow County",2,6,423,221,202
050,30,093,"Montana","Silver Bow County",2,7,415,216,199
050,30,093,"Montana","Silver Bow County",2,8,417,221,196
050,30,093,"Montana","Silver Bow County",2,9,402,205,197
050,30,093,"Montana","Silver Bow County",2,10,421,206,215
050,30,093,"Montana","Silver Bow County",2,11,412,207,205
050,30,093,"Montana","Silver Bow County",2,12,431,230,201
050,30,093,"Montana","Silver Bow County",2,13,424,227,197
050,30,093,"Montana","Silver Bow County",2,14,378,200,178
050,30,093,"Montana","Silver Bow County",2,15,382,203,179
050,30,093,"Montana","Silver Bow County",2,16,401,197,204
050,30,093,"Montana","Silver Bow County",2,17,389,192,197
050,30,093,"Montana","Silver Bow County",2,18,401,219,182
050,30,093,"Montana","Silver Bow County",2,19,502,295,207
050,30,093,"Montana","Silver Bow County",2,20,546,335,211
050,30,093,"Montana","Silver Bow County",2,21,623,342,281
050,30,093,"Montana","Silver Bow County",2,22,565,287,278
050,30,093,"Montana","Silver Bow County",2,23,632,310,322
050,30,093,"Montana","Silver Bow County",2,24,541,258,283
050,30,093,"Montana","Silver Bow County",2,25,531,258,273
050,30,093,"Montana","Silver Bow County",2,26,503,255,248
050,30,093,"Montana","Silver Bow County",2,27,486,251,235
050,30,093,"Montana","Silver Bow County",2,28,478,246,232
050,30,093,"Montana","Silver Bow County",2,29,457,232,225
050,30,093,"Montana","Silver Bow County",2,30,419,216,203
050,30,093,"Montana","Silver Bow County",2,31,395,202,193
050,30,093,"Montana","Silver Bow County",2,32,401,200,201
050,30,093,"Montana","Silver Bow County",2,33,382,207,175
050,30,093,"Montana","Silver Bow County",2,34,404,218,186
050,30,093,"Montana","Silver Bow County",2,35,396,217,179
050,30,093,"Montana","Silver Bow County",2,36,415,223,192
050,30,093,"Montana","Silver Bow County",2,37,422,222,200
050,30,093,"Montana","Silver Bow County",2,38,432,227,205
050,30,093,"Montana","Silver Bow County",2,39,445,237,208
050,30,093,"Montana","Silver Bow County",2,40,441,236,205
050,30,093,"Montana","Silver Bow County",2,41,413,224,189
050,30,093,"Montana","Silver Bow County",2,42,400,214,186
050,30,093,"Montana","Silver Bow County",2,43,374,200,174
050,30,093,"Montana","Silver Bow County",2,44,370,198,172
050,30,093,"Montana","Silver Bow County",2,45,360,177,183
050,30,093,"Montana","Silver Bow County",2,46,340,174,166
050,30,093,"Montana","Silver Bow County",2,47,352,181,171
050,30,093,"Montana","Silver Bow County",2,48,362,179,183
050,30,093,"Montana","Silver Bow County",2,49,410,210,200
050,30,093,"Montana","Silver Bow County",2,50,397,201,196
050,30,093,"Montana","Silver Bow County",2,51,398,201,197
050,30,093,"Montana","Silver Bow County",2,52,397,205,192
050,30,093,"Montana","Silver Bow County",2,53,404,210,194
050,30,093,"Montana","Silver Bow County",2,54,415,204,211
050,30,093,"Montana","Silver Bow County",2,55,437,232,205
050,30,093,"Montana","Silver Bow County",2,56,458,243,215
050,30,093,"Montana","Silver Bow County",2,57,472,241,231
050,30,093,"Montana","Silver Bow County",2,58,486,245,241
050,30,093,"Montana","Silver Bow County",2,59,513,255,258
050,30,093,"Montana","Silver Bow County",2,60,530,262,268
050,30,093,"Montana","Silver Bow County",2,61,560,275,285
050,30,093,"Montana","Silver Bow County",2,62,547,273,274
050,30,093,"Montana","Silver Bow County",2,63,540,274,266
050,30,093,"Montana","Silver Bow County",2,64,492,240,252
050,30,093,"Montana","Silver Bow County",2,65,490,239,251
050,30,093,"Montana","Silver Bow County",2,66,464,232,232
050,30,093,"Montana","Silver Bow County",2,67,466,231,235
050,30,093,"Montana","Silver Bow County",2,68,466,231,235
050,30,093,"Montana","Silver Bow County",2,69,434,211,223
050,30,093,"Montana","Silver Bow County",2,70,380,185,195
050,30,093,"Montana","Silver Bow County",2,71,355,166,189
050,30,093,"Montana","Silver Bow County",2,72,339,167,172
050,30,093,"Montana","Silver Bow County",2,73,369,188,181
050,30,093,"Montana","Silver Bow County",2,74,257,130,127
050,30,093,"Montana","Silver Bow County",2,75,243,125,118
050,30,093,"Montana","Silver Bow County",2,76,239,112,127
050,30,093,"Montana","Silver Bow County",2,77,256,120,136
050,30,093,"Montana","Silver Bow County",2,78,228,105,123
050,30,093,"Montana","Silver Bow County",2,79,213,93,120
050,30,093,"Montana","Silver Bow County",2,80,191,93,98
050,30,093,"Montana","Silver Bow County",2,81,177,85,92
050,30,093,"Montana","Silver Bow County",2,82,157,73,84
050,30,093,"Montana","Silver Bow County",2,83,151,69,82
050,30,093,"Montana","Silver Bow County",2,84,126,53,73
050,30,093,"Montana","Silver Bow County",2,85,726,243,483
050,30,093,"Montana","Silver Bow County",3,0,333,138,195
050,30,093,"Montana","Silver Bow County",3,1,363,182,181
050,30,093,"Montana","Silver Bow County",3,2,342,167,175
050,30,093,"Montana","Silver Bow County",3,3,387,207,180
050,30,093,"Montana","Silver Bow County",3,4,407,211,196
050,30,093,"Montana","Silver Bow County",3,5,426,227,199
050,30,093,"Montana","Silver Bow County",3,6,435,238,197
050,30,093,"Montana","Silver Bow County",3,7,410,215,195
050,30,093,"Montana","Silver Bow County",3,8,413,214,199
050,30,093,"Montana","Silver Bow County",3,9,413,213,200
050,30,093,"Montana","Silver Bow County",3,10,408,209,199
050,30,093,"Montana","Silver Bow County",3,11,424,213,211
050,30,093,"Montana","Silver Bow County",3,12,409,211,198
050,30,093,"Montana","Silver Bow County",3,13,432,234,198
050,30,093,"Montana","Silver Bow County",3,14,438,231,207
050,30,093,"Montana","Silver Bow County",3,15,397,204,193
050,30,093,"Montana","Silver Bow County",3,16,387,193,194
050,30,093,"Montana","Silver Bow County",3,17,407,200,207
050,30,093,"Montana","Silver Bow County",3,18,408,218,190
050,30,093,"Montana","Silver Bow County",3,19,497,290,207
050,30,093,"Montana","Silver Bow County",3,20,560,353,207
050,30,093,"Montana","Silver Bow County",3,21,663,375,288
050,30,093,"Montana","Silver Bow County",3,22,569,313,256
050,30,093,"Montana","Silver Bow County",3,23,628,317,311
050,30,093,"Montana","Silver Bow County",3,24,530,247,283
050,30,093,"Montana","Silver Bow County",3,25,500,250,250
050,30,093,"Montana","Silver Bow County",3,26,465,237,228
050,30,093,"Montana","Silver Bow County",3,27,491,242,249
050,30,093,"Montana","Silver Bow County",3,28,489,249,240
050,30,093,"Montana","Silver Bow County",3,29,476,248,228
050,30,093,"Montana","Silver Bow County",3,30,479,245,234
050,30,093,"Montana","Silver Bow County",3,31,407,212,195
050,30,093,"Montana","Silver Bow County",3,32,408,206,202
050,30,093,"Montana","Silver Bow County",3,33,405,206,199
050,30,093,"Montana","Silver Bow County",3,34,393,221,172
050,30,093,"Montana","Silver Bow County",3,35,411,227,184
050,30,093,"Montana","Silver Bow County",3,36,410,229,181
050,30,093,"Montana","Silver Bow County",3,37,422,224,198
050,30,093,"Montana","Silver Bow County",3,38,418,221,197
050,30,093,"Montana","Silver Bow County",3,39,444,227,217
050,30,093,"Montana","Silver Bow County",3,40,462,241,221
050,30,093,"Montana","Silver Bow County",3,41,438,236,202
050,30,093,"Montana","Silver Bow County",3,42,420,224,196
050,30,093,"Montana","Silver Bow County",3,43,407,221,186
050,30,093,"Montana","Silver Bow County",3,44,388,217,171
050,30,093,"Montana","Silver Bow County",3,45,381,194,187
050,30,093,"Montana","Silver Bow County",3,46,365,183,182
050,30,093,"Montana","Silver Bow County",3,47,334,171,163
050,30,093,"Montana","Silver Bow County",3,48,374,193,181
050,30,093,"Montana","Silver Bow County",3,49,378,195,183
050,30,093,"Montana","Silver Bow County",3,50,390,193,197
050,30,093,"Montana","Silver Bow County",3,51,411,208,203
050,30,093,"Montana","Silver Bow County",3,52,402,216,186
050,30,093,"Montana","Silver Bow County",3,53,394,201,193
050,30,093,"Montana","Silver Bow County",3,54,411,207,204
050,30,093,"Montana","Silver Bow County",3,55,428,218,210
050,30,093,"Montana","Silver Bow County",3,56,437,229,208
050,30,093,"Montana","Silver Bow County",3,57,462,245,217
050,30,093,"Montana","Silver Bow County",3,58,480,247,233
050,30,093,"Montana","Silver Bow County",3,59,507,264,243
050,30,093,"Montana","Silver Bow County",3,60,527,251,276
050,30,093,"Montana","Silver Bow County",3,61,531,256,275
050,30,093,"Montana","Silver Bow County",3,62,556,273,283
050,30,093,"Montana","Silver Bow County",3,63,558,278,280
050,30,093,"Montana","Silver Bow County",3,64,522,257,265
050,30,093,"Montana","Silver Bow County",3,65,479,235,244
050,30,093,"Montana","Silver Bow County",3,66,481,234,247
050,30,093,"Montana","Silver Bow County",3,67,465,236,229
050,30,093,"Montana","Silver Bow County",3,68,469,231,238
050,30,093,"Montana","Silver Bow County",3,69,458,224,234
050,30,093,"Montana","Silver Bow County",3,70,417,206,211
050,30,093,"Montana","Silver Bow County",3,71,369,180,189
050,30,093,"Montana","Silver Bow County",3,72,344,160,184
050,30,093,"Montana","Silver Bow County",3,73,329,163,166
050,30,093,"Montana","Silver Bow County",3,74,353,173,180
050,30,093,"Montana","Silver Bow County",3,75,252,127,125
050,30,093,"Montana","Silver Bow County",3,76,232,122,110
050,30,093,"Montana","Silver Bow County",3,77,230,102,128
050,30,093,"Montana","Silver Bow County",3,78,244,114,130
050,30,093,"Montana","Silver Bow County",3,79,216,95,121
050,30,093,"Montana","Silver Bow County",3,80,181,82,99
050,30,093,"Montana","Silver Bow County",3,81,188,96,92
050,30,093,"Montana","Silver Bow County",3,82,158,77,81
050,30,093,"Montana","Silver Bow County",3,83,135,61,74
050,30,093,"Montana","Silver Bow County",3,84,130,57,73
050,30,093,"Montana","Silver Bow County",3,85,705,227,478
050,30,093,"Montana","Silver Bow County",4,0,355,145,210
050,30,093,"Montana","Silver Bow County",4,1,339,140,199
050,30,093,"Montana","Silver Bow County",4,2,368,187,181
050,30,093,"Montana","Silver Bow County",4,3,340,158,182
050,30,093,"Montana","Silver Bow County",4,4,377,202,175
050,30,093,"Montana","Silver Bow County",4,5,400,207,193
050,30,093,"Montana","Silver Bow County",4,6,432,234,198
050,30,093,"Montana","Silver Bow County",4,7,448,250,198
050,30,093,"Montana","Silver Bow County",4,8,411,213,198
050,30,093,"Montana","Silver Bow County",4,9,401,202,199
050,30,093,"Montana","Silver Bow County",4,10,431,220,211
050,30,093,"Montana","Silver Bow County",4,11,410,215,195
050,30,093,"Montana","Silver Bow County",4,12,428,209,219
050,30,093,"Montana","Silver Bow County",4,13,414,216,198
050,30,093,"Montana","Silver Bow County",4,14,453,242,211
050,30,093,"Montana","Silver Bow County",4,15,428,225,203
050,30,093,"Montana","Silver Bow County",4,16,391,208,183
050,30,093,"Montana","Silver Bow County",4,17,395,198,197
050,30,093,"Montana","Silver Bow County",4,18,412,220,192
050,30,093,"Montana","Silver Bow County",4,19,497,295,202
050,30,093,"Montana","Silver Bow County",4,20,555,344,211
050,30,093,"Montana","Silver Bow County",4,21,693,414,279
050,30,093,"Montana","Silver Bow County",4,22,609,352,257
050,30,093,"Montana","Silver Bow County",4,23,648,350,298
050,30,093,"Montana","Silver Bow County",4,24,539,256,283
050,30,093,"Montana","Silver Bow County",4,25,508,251,257
050,30,093,"Montana","Silver Bow County",4,26,457,229,228
050,30,093,"Montana","Silver Bow County",4,27,452,229,223
050,30,093,"Montana","Silver Bow County",4,28,489,244,245
050,30,093,"Montana","Silver Bow County",4,29,489,240,249
050,30,093,"Montana","Silver Bow County",4,30,500,267,233
050,30,093,"Montana","Silver Bow County",4,31,472,244,228
050,30,093,"Montana","Silver Bow County",4,32,430,217,213
050,30,093,"Montana","Silver Bow County",4,33,424,221,203
050,30,093,"Montana","Silver Bow County",4,34,422,214,208
050,30,093,"Montana","Silver Bow County",4,35,406,229,177
050,30,093,"Montana","Silver Bow County",4,36,431,231,200
050,30,093,"Montana","Silver Bow County",4,37,417,231,186
050,30,093,"Montana","Silver Bow County",4,38,416,216,200
050,30,093,"Montana","Silver Bow County",4,39,442,231,211
050,30,093,"Montana","Silver Bow County",4,40,457,234,223
050,30,093,"Montana","Silver Bow County",4,41,479,253,226
050,30,093,"Montana","Silver Bow County",4,42,439,229,210
050,30,093,"Montana","Silver Bow County",4,43,423,221,202
050,30,093,"Montana","Silver Bow County",4,44,425,231,194
050,30,093,"Montana","Silver Bow County",4,45,396,212,184
050,30,093,"Montana","Silver Bow County",4,46,408,212,196
050,30,093,"Montana","Silver Bow County",4,47,381,203,178
050,30,093,"Montana","Silver Bow County",4,48,359,187,172
050,30,093,"Montana","Silver Bow County",4,49,389,211,178
050,30,093,"Montana","Silver Bow County",4,50,378,188,190
050,30,093,"Montana","Silver Bow County",4,51,428,207,221
050,30,093,"Montana","Silver Bow County",4,52,417,220,197
050,30,093,"Montana","Silver Bow County",4,53,398,219,179
050,30,093,"Montana","Silver Bow County",4,54,403,207,196
050,30,093,"Montana","Silver Bow County",4,55,421,213,208
050,30,093,"Montana","Silver Bow County",4,56,433,220,213
050,30,093,"Montana","Silver Bow County",4,57,433,224,209
050,30,093,"Montana","Silver Bow County",4,58,472,250,222
050,30,093,"Montana","Silver Bow County",4,59,491,261,230
050,30,093,"Montana","Silver Bow County",4,60,526,260,266
050,30,093,"Montana","Silver Bow County",4,61,509,233,276
050,30,093,"Montana","Silver Bow County",4,62,522,253,269
050,30,093,"Montana","Silver Bow County",4,63,559,272,287
050,30,093,"Montana","Silver Bow County",4,64,531,261,270
050,30,093,"Montana","Silver Bow County",4,65,515,257,258
050,30,093,"Montana","Silver Bow County",4,66,456,220,236
050,30,093,"Montana","Silver Bow County",4,67,481,236,245
050,30,093,"Montana","Silver Bow County",4,68,450,231,219
050,30,093,"Montana","Silver Bow County",4,69,447,218,229
050,30,093,"Montana","Silver Bow County",4,70,442,214,228
050,30,093,"Montana","Silver Bow County",4,71,415,201,214
050,30,093,"Montana","Silver Bow County",4,72,362,179,183
050,30,093,"Montana","Silver Bow County",4,73,316,142,174
050,30,093,"Montana","Silver Bow County",4,74,315,149,166
050,30,093,"Montana","Silver Bow County",4,75,334,163,171
050,30,093,"Montana","Silver Bow County",4,76,245,120,125
050,30,093,"Montana","Silver Bow County",4,77,230,119,111
050,30,093,"Montana","Silver Bow County",4,78,221,94,127
050,30,093,"Montana","Silver Bow County",4,79,222,98,124
050,30,093,"Montana","Silver Bow County",4,80,191,88,103
050,30,093,"Montana","Silver Bow County",4,81,173,79,94
050,30,093,"Montana","Silver Bow County",4,82,169,90,79
050,30,093,"Montana","Silver Bow County",4,83,142,69,73
050,30,093,"Montana","Silver Bow County",4,84,118,49,69
050,30,093,"Montana","Silver Bow County",4,85,697,236,461
050,30,093,"Montana","Silver Bow County",5,0,358,145,213
050,30,093,"Montana","Silver Bow County",5,1,337,141,196
050,30,093,"Montana","Silver Bow County",5,2,339,151,188
050,30,093,"Montana","Silver Bow County",5,3,387,193,194
050,30,093,"Montana","Silver Bow County",5,4,346,166,180
050,30,093,"Montana","Silver Bow County",5,5,378,201,177
050,30,093,"Montana","Silver Bow County",5,6,400,199,201
050,30,093,"Montana","Silver Bow County",5,7,442,244,198
050,30,093,"Montana","Silver Bow County",5,8,470,254,216
050,30,093,"Montana","Silver Bow County",5,9,408,202,206
050,30,093,"Montana","Silver Bow County",5,10,423,218,205
050,30,093,"Montana","Silver Bow County",5,11,441,229,212
050,30,093,"Montana","Silver Bow County",5,12,410,211,199
050,30,093,"Montana","Silver Bow County",5,13,436,218,218
050,30,093,"Montana","Silver Bow County",5,14,426,221,205
050,30,093,"Montana","Silver Bow County",5,15,459,247,212
050,30,093,"Montana","Silver Bow County",5,16,437,228,209
050,30,093,"Montana","Silver Bow County",5,17,398,212,186
050,30,093,"Montana","Silver Bow County",5,18,409,228,181
050,30,093,"Montana","Silver Bow County",5,19,514,302,212
050,30,093,"Montana","Silver Bow County",5,20,551,345,206
050,30,093,"Montana","Silver Bow County",5,21,651,370,281
050,30,093,"Montana","Silver Bow County",5,22,624,383,241
050,30,093,"Montana","Silver Bow County",5,23,675,385,290
050,30,093,"Montana","Silver Bow County",5,24,535,285,250
050,30,093,"Montana","Silver Bow County",5,25,522,255,267
050,30,093,"Montana","Silver Bow County",5,26,480,236,244
050,30,093,"Montana","Silver Bow County",5,27,468,233,235
050,30,093,"Montana","Silver Bow County",5,28,446,231,215
050,30,093,"Montana","Silver Bow County",5,29,511,254,257
050,30,093,"Montana","Silver Bow County",5,30,497,256,241
050,30,093,"Montana","Silver Bow County",5,31,495,263,232
050,30,093,"Montana","Silver Bow County",5,32,482,251,231
050,30,093,"Montana","Silver Bow County",5,33,450,230,220
050,30,093,"Montana","Silver Bow County",5,34,429,217,212
050,30,093,"Montana","Silver Bow County",5,35,432,219,213
050,30,093,"Montana","Silver Bow County",5,36,422,236,186
050,30,093,"Montana","Silver Bow County",5,37,430,222,208
050,30,093,"Montana","Silver Bow County",5,38,413,229,184
050,30,093,"Montana","Silver Bow County",5,39,428,224,204
050,30,093,"Montana","Silver Bow County",5,40,455,242,213
050,30,093,"Montana","Silver Bow County",5,41,461,241,220
050,30,093,"Montana","Silver Bow County",5,42,469,245,224
050,30,093,"Montana","Silver Bow County",5,43,448,233,215
050,30,093,"Montana","Silver Bow County",5,44,436,234,202
050,30,093,"Montana","Silver Bow County",5,45,427,222,205
050,30,093,"Montana","Silver Bow County",5,46,416,222,194
050,30,093,"Montana","Silver Bow County",5,47,408,211,197
050,30,093,"Montana","Silver Bow County",5,48,394,210,184
050,30,093,"Montana","Silver Bow County",5,49,371,202,169
050,30,093,"Montana","Silver Bow County",5,50,387,203,184
050,30,093,"Montana","Silver Bow County",5,51,397,201,196
050,30,093,"Montana","Silver Bow County",5,52,425,214,211
050,30,093,"Montana","Silver Bow County",5,53,410,216,194
050,30,093,"Montana","Silver Bow County",5,54,420,222,198
050,30,093,"Montana","Silver Bow County",5,55,413,214,199
050,30,093,"Montana","Silver Bow County",5,56,429,220,209
050,30,093,"Montana","Silver Bow County",5,57,443,229,214
050,30,093,"Montana","Silver Bow County",5,58,429,221,208
050,30,093,"Montana","Silver Bow County",5,59,475,258,217
050,30,093,"Montana","Silver Bow County",5,60,498,258,240
050,30,093,"Montana","Silver Bow County",5,61,521,247,274
050,30,093,"Montana","Silver Bow County",5,62,501,233,268
050,30,093,"Montana","Silver Bow County",5,63,521,258,263
050,30,093,"Montana","Silver Bow County",5,64,550,266,284
050,30,093,"Montana","Silver Bow County",5,65,535,267,268
050,30,093,"Montana","Silver Bow County",5,66,499,247,252
050,30,093,"Montana","Silver Bow County",5,67,458,223,235
050,30,093,"Montana","Silver Bow County",5,68,471,233,238
050,30,093,"Montana","Silver Bow County",5,69,433,218,215
050,30,093,"Montana","Silver Bow County",5,70,436,209,227
050,30,093,"Montana","Silver Bow County",5,71,430,206,224
050,30,093,"Montana","Silver Bow County",5,72,397,193,204
050,30,093,"Montana","Silver Bow County",5,73,348,167,181
050,30,093,"Montana","Silver Bow County",5,74,306,128,178
050,30,093,"Montana","Silver Bow County",5,75,305,140,165
050,30,093,"Montana","Silver Bow County",5,76,322,159,163
050,30,093,"Montana","Silver Bow County",5,77,237,113,124
050,30,093,"Montana","Silver Bow County",5,78,223,114,109
050,30,093,"Montana","Silver Bow County",5,79,204,78,126
050,30,093,"Montana","Silver Bow County",5,80,190,87,103
050,30,093,"Montana","Silver Bow County",5,81,186,92,94
050,30,093,"Montana","Silver Bow County",5,82,151,70,81
050,30,093,"Montana","Silver Bow County",5,83,154,81,73
050,30,093,"Montana","Silver Bow County",5,84,128,56,72
050,30,093,"Montana","Silver Bow County",5,85,684,242,442
050,30,095,"Montana","Stillwater County",1,0,79,40,39
050,30,095,"Montana","Stillwater County",1,1,77,39,38
050,30,095,"Montana","Stillwater County",1,2,83,47,36
050,30,095,"Montana","Stillwater County",1,3,84,44,40
050,30,095,"Montana","Stillwater County",1,4,72,40,32
050,30,095,"Montana","Stillwater County",1,5,107,57,50
050,30,095,"Montana","Stillwater County",1,6,102,54,48
050,30,095,"Montana","Stillwater County",1,7,91,47,44
050,30,095,"Montana","Stillwater County",1,8,93,48,45
050,30,095,"Montana","Stillwater County",1,9,114,62,52
050,30,095,"Montana","Stillwater County",1,10,118,65,53
050,30,095,"Montana","Stillwater County",1,11,115,61,54
050,30,095,"Montana","Stillwater County",1,12,132,59,73
050,30,095,"Montana","Stillwater County",1,13,127,64,63
050,30,095,"Montana","Stillwater County",1,14,134,67,67
050,30,095,"Montana","Stillwater County",1,15,128,68,60
050,30,095,"Montana","Stillwater County",1,16,133,74,59
050,30,095,"Montana","Stillwater County",1,17,129,66,63
050,30,095,"Montana","Stillwater County",1,18,107,57,50
050,30,095,"Montana","Stillwater County",1,19,87,45,42
050,30,095,"Montana","Stillwater County",1,20,64,35,29
050,30,095,"Montana","Stillwater County",1,21,67,36,31
050,30,095,"Montana","Stillwater County",1,22,74,36,38
050,30,095,"Montana","Stillwater County",1,23,73,39,34
050,30,095,"Montana","Stillwater County",1,24,67,35,32
050,30,095,"Montana","Stillwater County",1,25,69,35,34
050,30,095,"Montana","Stillwater County",1,26,93,45,48
050,30,095,"Montana","Stillwater County",1,27,78,44,34
050,30,095,"Montana","Stillwater County",1,28,71,35,36
050,30,095,"Montana","Stillwater County",1,29,71,38,33
050,30,095,"Montana","Stillwater County",1,30,86,50,36
050,30,095,"Montana","Stillwater County",1,31,83,47,36
050,30,095,"Montana","Stillwater County",1,32,72,40,32
050,30,095,"Montana","Stillwater County",1,33,78,44,34
050,30,095,"Montana","Stillwater County",1,34,82,41,41
050,30,095,"Montana","Stillwater County",1,35,77,31,46
050,30,095,"Montana","Stillwater County",1,36,95,42,53
050,30,095,"Montana","Stillwater County",1,37,109,48,61
050,30,095,"Montana","Stillwater County",1,38,95,48,47
050,30,095,"Montana","Stillwater County",1,39,95,44,51
050,30,095,"Montana","Stillwater County",1,40,105,49,56
050,30,095,"Montana","Stillwater County",1,41,115,56,59
050,30,095,"Montana","Stillwater County",1,42,115,61,54
050,30,095,"Montana","Stillwater County",1,43,89,45,44
050,30,095,"Montana","Stillwater County",1,44,100,47,53
050,30,095,"Montana","Stillwater County",1,45,101,55,46
050,30,095,"Montana","Stillwater County",1,46,100,56,44
050,30,095,"Montana","Stillwater County",1,47,91,42,49
050,30,095,"Montana","Stillwater County",1,48,113,62,51
050,30,095,"Montana","Stillwater County",1,49,111,61,50
050,30,095,"Montana","Stillwater County",1,50,115,66,49
050,30,095,"Montana","Stillwater County",1,51,127,59,68
050,30,095,"Montana","Stillwater County",1,52,115,51,64
050,30,095,"Montana","Stillwater County",1,53,104,57,47
050,30,095,"Montana","Stillwater County",1,54,110,57,53
050,30,095,"Montana","Stillwater County",1,55,129,68,61
050,30,095,"Montana","Stillwater County",1,56,129,73,56
050,30,095,"Montana","Stillwater County",1,57,147,73,74
050,30,095,"Montana","Stillwater County",1,58,162,82,80
050,30,095,"Montana","Stillwater County",1,59,149,74,75
050,30,095,"Montana","Stillwater County",1,60,154,67,87
050,30,095,"Montana","Stillwater County",1,61,156,74,82
050,30,095,"Montana","Stillwater County",1,62,148,74,74
050,30,095,"Montana","Stillwater County",1,63,172,85,87
050,30,095,"Montana","Stillwater County",1,64,166,92,74
050,30,095,"Montana","Stillwater County",1,65,158,85,73
050,30,095,"Montana","Stillwater County",1,66,161,84,77
050,30,095,"Montana","Stillwater County",1,67,159,80,79
050,30,095,"Montana","Stillwater County",1,68,148,76,72
050,30,095,"Montana","Stillwater County",1,69,133,70,63
050,30,095,"Montana","Stillwater County",1,70,144,74,70
050,30,095,"Montana","Stillwater County",1,71,136,73,63
050,30,095,"Montana","Stillwater County",1,72,120,66,54
050,30,095,"Montana","Stillwater County",1,73,113,63,50
050,30,095,"Montana","Stillwater County",1,74,96,53,43
050,30,095,"Montana","Stillwater County",1,75,77,40,37
050,30,095,"Montana","Stillwater County",1,76,77,41,36
050,30,095,"Montana","Stillwater County",1,77,86,42,44
050,30,095,"Montana","Stillwater County",1,78,74,39,35
050,30,095,"Montana","Stillwater County",1,79,65,38,27
050,30,095,"Montana","Stillwater County",1,80,43,19,24
050,30,095,"Montana","Stillwater County",1,81,40,20,20
050,30,095,"Montana","Stillwater County",1,82,40,25,15
050,30,095,"Montana","Stillwater County",1,83,38,22,16
050,30,095,"Montana","Stillwater County",1,84,34,18,16
050,30,095,"Montana","Stillwater County",1,85,188,74,114
050,30,095,"Montana","Stillwater County",2,0,72,35,37
050,30,095,"Montana","Stillwater County",2,1,78,40,38
050,30,095,"Montana","Stillwater County",2,2,83,45,38
050,30,095,"Montana","Stillwater County",2,3,84,45,39
050,30,095,"Montana","Stillwater County",2,4,79,43,36
050,30,095,"Montana","Stillwater County",2,5,100,53,47
050,30,095,"Montana","Stillwater County",2,6,106,56,50
050,30,095,"Montana","Stillwater County",2,7,95,49,46
050,30,095,"Montana","Stillwater County",2,8,94,49,45
050,30,095,"Montana","Stillwater County",2,9,111,60,51
050,30,095,"Montana","Stillwater County",2,10,115,64,51
050,30,095,"Montana","Stillwater County",2,11,117,63,54
050,30,095,"Montana","Stillwater County",2,12,129,59,70
050,30,095,"Montana","Stillwater County",2,13,128,62,66
050,30,095,"Montana","Stillwater County",2,14,134,67,67
050,30,095,"Montana","Stillwater County",2,15,130,69,61
050,30,095,"Montana","Stillwater County",2,16,133,73,60
050,30,095,"Montana","Stillwater County",2,17,130,67,63
050,30,095,"Montana","Stillwater County",2,18,106,56,50
050,30,095,"Montana","Stillwater County",2,19,86,45,41
050,30,095,"Montana","Stillwater County",2,20,68,37,31
050,30,095,"Montana","Stillwater County",2,21,67,36,31
050,30,095,"Montana","Stillwater County",2,22,71,36,35
050,30,095,"Montana","Stillwater County",2,23,74,38,36
050,30,095,"Montana","Stillwater County",2,24,68,37,31
050,30,095,"Montana","Stillwater County",2,25,72,36,36
050,30,095,"Montana","Stillwater County",2,26,88,44,44
050,30,095,"Montana","Stillwater County",2,27,82,45,37
050,30,095,"Montana","Stillwater County",2,28,75,38,37
050,30,095,"Montana","Stillwater County",2,29,74,39,35
050,30,095,"Montana","Stillwater County",2,30,85,49,36
050,30,095,"Montana","Stillwater County",2,31,83,47,36
050,30,095,"Montana","Stillwater County",2,32,76,42,34
050,30,095,"Montana","Stillwater County",2,33,76,43,33
050,30,095,"Montana","Stillwater County",2,34,83,43,40
050,30,095,"Montana","Stillwater County",2,35,78,33,45
050,30,095,"Montana","Stillwater County",2,36,92,40,52
050,30,095,"Montana","Stillwater County",2,37,107,47,60
050,30,095,"Montana","Stillwater County",2,38,99,48,51
050,30,095,"Montana","Stillwater County",2,39,100,48,52
050,30,095,"Montana","Stillwater County",2,40,104,49,55
050,30,095,"Montana","Stillwater County",2,41,114,55,59
050,30,095,"Montana","Stillwater County",2,42,113,59,54
050,30,095,"Montana","Stillwater County",2,43,98,51,47
050,30,095,"Montana","Stillwater County",2,44,95,46,49
050,30,095,"Montana","Stillwater County",2,45,102,54,48
050,30,095,"Montana","Stillwater County",2,46,101,56,45
050,30,095,"Montana","Stillwater County",2,47,96,47,49
050,30,095,"Montana","Stillwater County",2,48,109,58,51
050,30,095,"Montana","Stillwater County",2,49,110,60,50
050,30,095,"Montana","Stillwater County",2,50,115,65,50
050,30,095,"Montana","Stillwater County",2,51,124,60,64
050,30,095,"Montana","Stillwater County",2,52,119,54,65
050,30,095,"Montana","Stillwater County",2,53,109,57,52
050,30,095,"Montana","Stillwater County",2,54,109,57,52
050,30,095,"Montana","Stillwater County",2,55,126,66,60
050,30,095,"Montana","Stillwater County",2,56,128,72,56
050,30,095,"Montana","Stillwater County",2,57,143,72,71
050,30,095,"Montana","Stillwater County",2,58,160,81,79
050,30,095,"Montana","Stillwater County",2,59,154,75,79
050,30,095,"Montana","Stillwater County",2,60,153,69,84
050,30,095,"Montana","Stillwater County",2,61,154,71,83
050,30,095,"Montana","Stillwater County",2,62,153,76,77
050,30,095,"Montana","Stillwater County",2,63,169,83,86
050,30,095,"Montana","Stillwater County",2,64,166,90,76
050,30,095,"Montana","Stillwater County",2,65,159,86,73
050,30,095,"Montana","Stillwater County",2,66,162,84,78
050,30,095,"Montana","Stillwater County",2,67,159,80,79
050,30,095,"Montana","Stillwater County",2,68,150,76,74
050,30,095,"Montana","Stillwater County",2,69,138,71,67
050,30,095,"Montana","Stillwater County",2,70,140,72,68
050,30,095,"Montana","Stillwater County",2,71,139,75,64
050,30,095,"Montana","Stillwater County",2,72,122,66,56
050,30,095,"Montana","Stillwater County",2,73,118,66,52
050,30,095,"Montana","Stillwater County",2,74,94,52,42
050,30,095,"Montana","Stillwater County",2,75,80,42,38
050,30,095,"Montana","Stillwater County",2,76,78,41,37
050,30,095,"Montana","Stillwater County",2,77,87,44,43
050,30,095,"Montana","Stillwater County",2,78,74,38,36
050,30,095,"Montana","Stillwater County",2,79,63,36,27
050,30,095,"Montana","Stillwater County",2,80,46,22,24
050,30,095,"Montana","Stillwater County",2,81,40,20,20
050,30,095,"Montana","Stillwater County",2,82,38,21,17
050,30,095,"Montana","Stillwater County",2,83,38,23,15
050,30,095,"Montana","Stillwater County",2,84,36,20,16
050,30,095,"Montana","Stillwater County",2,85,190,78,112
050,30,095,"Montana","Stillwater County",3,0,83,35,48
050,30,095,"Montana","Stillwater County",3,1,76,39,37
050,30,095,"Montana","Stillwater County",3,2,84,42,42
050,30,095,"Montana","Stillwater County",3,3,77,47,30
050,30,095,"Montana","Stillwater County",3,4,86,46,40
050,30,095,"Montana","Stillwater County",3,5,79,47,32
050,30,095,"Montana","Stillwater County",3,6,101,50,51
050,30,095,"Montana","Stillwater County",3,7,102,52,50
050,30,095,"Montana","Stillwater County",3,8,98,55,43
050,30,095,"Montana","Stillwater County",3,9,96,52,44
050,30,095,"Montana","Stillwater County",3,10,114,58,56
050,30,095,"Montana","Stillwater County",3,11,112,59,53
050,30,095,"Montana","Stillwater County",3,12,127,64,63
050,30,095,"Montana","Stillwater County",3,13,133,66,67
050,30,095,"Montana","Stillwater County",3,14,128,60,68
050,30,095,"Montana","Stillwater County",3,15,128,63,65
050,30,095,"Montana","Stillwater County",3,16,141,78,63
050,30,095,"Montana","Stillwater County",3,17,131,66,65
050,30,095,"Montana","Stillwater County",3,18,109,62,47
050,30,095,"Montana","Stillwater County",3,19,82,44,38
050,30,095,"Montana","Stillwater County",3,20,87,41,46
050,30,095,"Montana","Stillwater County",3,21,72,38,34
050,30,095,"Montana","Stillwater County",3,22,67,35,32
050,30,095,"Montana","Stillwater County",3,23,80,45,35
050,30,095,"Montana","Stillwater County",3,24,74,33,41
050,30,095,"Montana","Stillwater County",3,25,75,40,35
050,30,095,"Montana","Stillwater County",3,26,68,33,35
050,30,095,"Montana","Stillwater County",3,27,80,41,39
050,30,095,"Montana","Stillwater County",3,28,81,40,41
050,30,095,"Montana","Stillwater County",3,29,78,41,37
050,30,095,"Montana","Stillwater County",3,30,85,45,40
050,30,095,"Montana","Stillwater County",3,31,92,53,39
050,30,095,"Montana","Stillwater County",3,32,90,49,41
050,30,095,"Montana","Stillwater County",3,33,75,42,33
050,30,095,"Montana","Stillwater County",3,34,78,44,34
050,30,095,"Montana","Stillwater County",3,35,88,47,41
050,30,095,"Montana","Stillwater County",3,36,88,40,48
050,30,095,"Montana","Stillwater County",3,37,95,40,55
050,30,095,"Montana","Stillwater County",3,38,106,48,58
050,30,095,"Montana","Stillwater County",3,39,106,54,52
050,30,095,"Montana","Stillwater County",3,40,100,54,46
050,30,095,"Montana","Stillwater County",3,41,114,57,57
050,30,095,"Montana","Stillwater County",3,42,104,51,53
050,30,095,"Montana","Stillwater County",3,43,117,56,61
050,30,095,"Montana","Stillwater County",3,44,98,53,45
050,30,095,"Montana","Stillwater County",3,45,95,46,49
050,30,095,"Montana","Stillwater County",3,46,107,59,48
050,30,095,"Montana","Stillwater County",3,47,106,55,51
050,30,095,"Montana","Stillwater County",3,48,92,45,47
050,30,095,"Montana","Stillwater County",3,49,108,54,54
050,30,095,"Montana","Stillwater County",3,50,111,64,47
050,30,095,"Montana","Stillwater County",3,51,114,63,51
050,30,095,"Montana","Stillwater County",3,52,130,63,67
050,30,095,"Montana","Stillwater County",3,53,113,53,60
050,30,095,"Montana","Stillwater County",3,54,102,53,49
050,30,095,"Montana","Stillwater County",3,55,112,58,54
050,30,095,"Montana","Stillwater County",3,56,124,66,58
050,30,095,"Montana","Stillwater County",3,57,132,72,60
050,30,095,"Montana","Stillwater County",3,58,148,72,76
050,30,095,"Montana","Stillwater County",3,59,162,84,78
050,30,095,"Montana","Stillwater County",3,60,155,78,77
050,30,095,"Montana","Stillwater County",3,61,153,70,83
050,30,095,"Montana","Stillwater County",3,62,151,67,84
050,30,095,"Montana","Stillwater County",3,63,156,75,81
050,30,095,"Montana","Stillwater County",3,64,165,82,83
050,30,095,"Montana","Stillwater County",3,65,168,88,80
050,30,095,"Montana","Stillwater County",3,66,154,82,72
050,30,095,"Montana","Stillwater County",3,67,153,80,73
050,30,095,"Montana","Stillwater County",3,68,162,79,83
050,30,095,"Montana","Stillwater County",3,69,152,79,73
050,30,095,"Montana","Stillwater County",3,70,137,71,66
050,30,095,"Montana","Stillwater County",3,71,140,75,65
050,30,095,"Montana","Stillwater County",3,72,134,67,67
050,30,095,"Montana","Stillwater County",3,73,113,62,51
050,30,095,"Montana","Stillwater County",3,74,121,69,52
050,30,095,"Montana","Stillwater County",3,75,89,48,41
050,30,095,"Montana","Stillwater County",3,76,76,37,39
050,30,095,"Montana","Stillwater County",3,77,76,39,37
050,30,095,"Montana","Stillwater County",3,78,78,40,38
050,30,095,"Montana","Stillwater County",3,79,64,31,33
050,30,095,"Montana","Stillwater County",3,80,59,35,24
050,30,095,"Montana","Stillwater County",3,81,37,17,20
050,30,095,"Montana","Stillwater County",3,82,32,13,19
050,30,095,"Montana","Stillwater County",3,83,34,18,16
050,30,095,"Montana","Stillwater County",3,84,35,19,16
050,30,095,"Montana","Stillwater County",3,85,189,79,110
050,30,095,"Montana","Stillwater County",4,0,86,40,46
050,30,095,"Montana","Stillwater County",4,1,89,41,48
050,30,095,"Montana","Stillwater County",4,2,76,37,39
050,30,095,"Montana","Stillwater County",4,3,92,49,43
050,30,095,"Montana","Stillwater County",4,4,89,59,30
050,30,095,"Montana","Stillwater County",4,5,96,46,50
050,30,095,"Montana","Stillwater County",4,6,74,43,31
050,30,095,"Montana","Stillwater County",4,7,110,53,57
050,30,095,"Montana","Stillwater County",4,8,109,57,52
050,30,095,"Montana","Stillwater County",4,9,101,55,46
050,30,095,"Montana","Stillwater County",4,10,104,55,49
050,30,095,"Montana","Stillwater County",4,11,113,58,55
050,30,095,"Montana","Stillwater County",4,12,111,59,52
050,30,095,"Montana","Stillwater County",4,13,129,69,60
050,30,095,"Montana","Stillwater County",4,14,133,71,62
050,30,095,"Montana","Stillwater County",4,15,123,62,61
050,30,095,"Montana","Stillwater County",4,16,132,66,66
050,30,095,"Montana","Stillwater County",4,17,142,79,63
050,30,095,"Montana","Stillwater County",4,18,120,63,57
050,30,095,"Montana","Stillwater County",4,19,77,44,33
050,30,095,"Montana","Stillwater County",4,20,80,41,39
050,30,095,"Montana","Stillwater County",4,21,95,44,51
050,30,095,"Montana","Stillwater County",4,22,65,32,33
050,30,095,"Montana","Stillwater County",4,23,72,38,34
050,30,095,"Montana","Stillwater County",4,24,73,44,29
050,30,095,"Montana","Stillwater County",4,25,77,36,41
050,30,095,"Montana","Stillwater County",4,26,75,37,38
050,30,095,"Montana","Stillwater County",4,27,72,32,40
050,30,095,"Montana","Stillwater County",4,28,96,57,39
050,30,095,"Montana","Stillwater County",4,29,92,46,46
050,30,095,"Montana","Stillwater County",4,30,83,42,41
050,30,095,"Montana","Stillwater County",4,31,98,53,45
050,30,095,"Montana","Stillwater County",4,32,89,51,38
050,30,095,"Montana","Stillwater County",4,33,92,47,45
050,30,095,"Montana","Stillwater County",4,34,82,46,36
050,30,095,"Montana","Stillwater County",4,35,83,47,36
050,30,095,"Montana","Stillwater County",4,36,87,47,40
050,30,095,"Montana","Stillwater County",4,37,95,47,48
050,30,095,"Montana","Stillwater County",4,38,106,44,62
050,30,095,"Montana","Stillwater County",4,39,110,50,60
050,30,095,"Montana","Stillwater County",4,40,106,56,50
050,30,095,"Montana","Stillwater County",4,41,115,61,54
050,30,095,"Montana","Stillwater County",4,42,113,54,59
050,30,095,"Montana","Stillwater County",4,43,123,60,63
050,30,095,"Montana","Stillwater County",4,44,114,58,56
050,30,095,"Montana","Stillwater County",4,45,102,58,44
050,30,095,"Montana","Stillwater County",4,46,92,44,48
050,30,095,"Montana","Stillwater County",4,47,105,59,46
050,30,095,"Montana","Stillwater County",4,48,103,51,52
050,30,095,"Montana","Stillwater County",4,49,87,41,46
050,30,095,"Montana","Stillwater County",4,50,116,63,53
050,30,095,"Montana","Stillwater County",4,51,106,57,49
050,30,095,"Montana","Stillwater County",4,52,118,61,57
050,30,095,"Montana","Stillwater County",4,53,141,70,71
050,30,095,"Montana","Stillwater County",4,54,119,53,66
050,30,095,"Montana","Stillwater County",4,55,112,59,53
050,30,095,"Montana","Stillwater County",4,56,113,62,51
050,30,095,"Montana","Stillwater County",4,57,121,66,55
050,30,095,"Montana","Stillwater County",4,58,132,70,62
050,30,095,"Montana","Stillwater County",4,59,145,70,75
050,30,095,"Montana","Stillwater County",4,60,166,82,84
050,30,095,"Montana","Stillwater County",4,61,148,76,72
050,30,095,"Montana","Stillwater County",4,62,148,69,79
050,30,095,"Montana","Stillwater County",4,63,150,68,82
050,30,095,"Montana","Stillwater County",4,64,153,73,80
050,30,095,"Montana","Stillwater County",4,65,158,76,82
050,30,095,"Montana","Stillwater County",4,66,172,88,84
050,30,095,"Montana","Stillwater County",4,67,155,84,71
050,30,095,"Montana","Stillwater County",4,68,154,81,73
050,30,095,"Montana","Stillwater County",4,69,164,79,85
050,30,095,"Montana","Stillwater County",4,70,147,77,70
050,30,095,"Montana","Stillwater County",4,71,135,72,63
050,30,095,"Montana","Stillwater County",4,72,141,72,69
050,30,095,"Montana","Stillwater County",4,73,126,65,61
050,30,095,"Montana","Stillwater County",4,74,110,60,50
050,30,095,"Montana","Stillwater County",4,75,114,64,50
050,30,095,"Montana","Stillwater County",4,76,90,48,42
050,30,095,"Montana","Stillwater County",4,77,80,40,40
050,30,095,"Montana","Stillwater County",4,78,74,37,37
050,30,095,"Montana","Stillwater County",4,79,67,34,33
050,30,095,"Montana","Stillwater County",4,80,66,30,36
050,30,095,"Montana","Stillwater County",4,81,54,28,26
050,30,095,"Montana","Stillwater County",4,82,33,15,18
050,30,095,"Montana","Stillwater County",4,83,31,12,19
050,30,095,"Montana","Stillwater County",4,84,33,16,17
050,30,095,"Montana","Stillwater County",4,85,189,80,109
050,30,095,"Montana","Stillwater County",5,0,87,40,47
050,30,095,"Montana","Stillwater County",5,1,84,42,42
050,30,095,"Montana","Stillwater County",5,2,83,37,46
050,30,095,"Montana","Stillwater County",5,3,75,36,39
050,30,095,"Montana","Stillwater County",5,4,93,49,44
050,30,095,"Montana","Stillwater County",5,5,97,63,34
050,30,095,"Montana","Stillwater County",5,6,94,48,46
050,30,095,"Montana","Stillwater County",5,7,83,45,38
050,30,095,"Montana","Stillwater County",5,8,108,52,56
050,30,095,"Montana","Stillwater County",5,9,110,57,53
050,30,095,"Montana","Stillwater County",5,10,99,55,44
050,30,095,"Montana","Stillwater County",5,11,114,61,53
050,30,095,"Montana","Stillwater County",5,12,122,59,63
050,30,095,"Montana","Stillwater County",5,13,117,59,58
050,30,095,"Montana","Stillwater County",5,14,128,67,61
050,30,095,"Montana","Stillwater County",5,15,138,71,67
050,30,095,"Montana","Stillwater County",5,16,117,58,59
050,30,095,"Montana","Stillwater County",5,17,124,61,63
050,30,095,"Montana","Stillwater County",5,18,117,67,50
050,30,095,"Montana","Stillwater County",5,19,92,50,42
050,30,095,"Montana","Stillwater County",5,20,82,49,33
050,30,095,"Montana","Stillwater County",5,21,78,40,38
050,30,095,"Montana","Stillwater County",5,22,90,42,48
050,30,095,"Montana","Stillwater County",5,23,70,35,35
050,30,095,"Montana","Stillwater County",5,24,73,36,37
050,30,095,"Montana","Stillwater County",5,25,77,44,33
050,30,095,"Montana","Stillwater County",5,26,77,33,44
050,30,095,"Montana","Stillwater County",5,27,77,40,37
050,30,095,"Montana","Stillwater County",5,28,87,38,49
050,30,095,"Montana","Stillwater County",5,29,84,47,37
050,30,095,"Montana","Stillwater County",5,30,92,50,42
050,30,095,"Montana","Stillwater County",5,31,90,48,42
050,30,095,"Montana","Stillwater County",5,32,86,41,45
050,30,095,"Montana","Stillwater County",5,33,93,56,37
050,30,095,"Montana","Stillwater County",5,34,103,54,49
050,30,095,"Montana","Stillwater County",5,35,79,43,36
050,30,095,"Montana","Stillwater County",5,36,84,47,37
050,30,095,"Montana","Stillwater County",5,37,92,48,44
050,30,095,"Montana","Stillwater County",5,38,94,45,49
050,30,095,"Montana","Stillwater County",5,39,110,50,60
050,30,095,"Montana","Stillwater County",5,40,109,49,60
050,30,095,"Montana","Stillwater County",5,41,123,67,56
050,30,095,"Montana","Stillwater County",5,42,114,62,52
050,30,095,"Montana","Stillwater County",5,43,116,53,63
050,30,095,"Montana","Stillwater County",5,44,119,63,56
050,30,095,"Montana","Stillwater County",5,45,115,60,55
050,30,095,"Montana","Stillwater County",5,46,103,55,48
050,30,095,"Montana","Stillwater County",5,47,92,45,47
050,30,095,"Montana","Stillwater County",5,48,105,61,44
050,30,095,"Montana","Stillwater County",5,49,103,49,54
050,30,095,"Montana","Stillwater County",5,50,88,42,46
050,30,095,"Montana","Stillwater County",5,51,114,60,54
050,30,095,"Montana","Stillwater County",5,52,110,59,51
050,30,095,"Montana","Stillwater County",5,53,120,62,58
050,30,095,"Montana","Stillwater County",5,54,145,67,78
050,30,095,"Montana","Stillwater County",5,55,118,51,67
050,30,095,"Montana","Stillwater County",5,56,112,57,55
050,30,095,"Montana","Stillwater County",5,57,112,60,52
050,30,095,"Montana","Stillwater County",5,58,119,63,56
050,30,095,"Montana","Stillwater County",5,59,133,71,62
050,30,095,"Montana","Stillwater County",5,60,151,77,74
050,30,095,"Montana","Stillwater County",5,61,160,82,78
050,30,095,"Montana","Stillwater County",5,62,140,71,69
050,30,095,"Montana","Stillwater County",5,63,144,65,79
050,30,095,"Montana","Stillwater County",5,64,147,64,83
050,30,095,"Montana","Stillwater County",5,65,151,76,75
050,30,095,"Montana","Stillwater County",5,66,155,73,82
050,30,095,"Montana","Stillwater County",5,67,170,86,84
050,30,095,"Montana","Stillwater County",5,68,148,77,71
050,30,095,"Montana","Stillwater County",5,69,152,79,73
050,30,095,"Montana","Stillwater County",5,70,160,78,82
050,30,095,"Montana","Stillwater County",5,71,145,81,64
050,30,095,"Montana","Stillwater County",5,72,130,65,65
050,30,095,"Montana","Stillwater County",5,73,139,73,66
050,30,095,"Montana","Stillwater County",5,74,125,64,61
050,30,095,"Montana","Stillwater County",5,75,108,58,50
050,30,095,"Montana","Stillwater County",5,76,118,67,51
050,30,095,"Montana","Stillwater County",5,77,94,49,45
050,30,095,"Montana","Stillwater County",5,78,78,39,39
050,30,095,"Montana","Stillwater County",5,79,67,34,33
050,30,095,"Montana","Stillwater County",5,80,65,34,31
050,30,095,"Montana","Stillwater County",5,81,62,26,36
050,30,095,"Montana","Stillwater County",5,82,46,24,22
050,30,095,"Montana","Stillwater County",5,83,30,12,18
050,30,095,"Montana","Stillwater County",5,84,25,8,17
050,30,095,"Montana","Stillwater County",5,85,193,81,112
050,30,097,"Montana","Sweet Grass County",1,0,28,15,13
050,30,097,"Montana","Sweet Grass County",1,1,31,17,14
050,30,097,"Montana","Sweet Grass County",1,2,29,16,13
050,30,097,"Montana","Sweet Grass County",1,3,37,22,15
050,30,097,"Montana","Sweet Grass County",1,4,39,22,17
050,30,097,"Montana","Sweet Grass County",1,5,33,21,12
050,30,097,"Montana","Sweet Grass County",1,6,36,18,18
050,30,097,"Montana","Sweet Grass County",1,7,46,20,26
050,30,097,"Montana","Sweet Grass County",1,8,38,21,17
050,30,097,"Montana","Sweet Grass County",1,9,32,14,18
050,30,097,"Montana","Sweet Grass County",1,10,35,18,17
050,30,097,"Montana","Sweet Grass County",1,11,50,25,25
050,30,097,"Montana","Sweet Grass County",1,12,48,25,23
050,30,097,"Montana","Sweet Grass County",1,13,49,24,25
050,30,097,"Montana","Sweet Grass County",1,14,50,20,30
050,30,097,"Montana","Sweet Grass County",1,15,60,32,28
050,30,097,"Montana","Sweet Grass County",1,16,49,27,22
050,30,097,"Montana","Sweet Grass County",1,17,44,24,20
050,30,097,"Montana","Sweet Grass County",1,18,42,23,19
050,30,097,"Montana","Sweet Grass County",1,19,29,15,14
050,30,097,"Montana","Sweet Grass County",1,20,34,21,13
050,30,097,"Montana","Sweet Grass County",1,21,42,22,20
050,30,097,"Montana","Sweet Grass County",1,22,36,24,12
050,30,097,"Montana","Sweet Grass County",1,23,34,21,13
050,30,097,"Montana","Sweet Grass County",1,24,32,16,16
050,30,097,"Montana","Sweet Grass County",1,25,36,21,15
050,30,097,"Montana","Sweet Grass County",1,26,40,22,18
050,30,097,"Montana","Sweet Grass County",1,27,29,16,13
050,30,097,"Montana","Sweet Grass County",1,28,35,16,19
050,30,097,"Montana","Sweet Grass County",1,29,24,12,12
050,30,097,"Montana","Sweet Grass County",1,30,31,15,16
050,30,097,"Montana","Sweet Grass County",1,31,36,18,18
050,30,097,"Montana","Sweet Grass County",1,32,31,17,14
050,30,097,"Montana","Sweet Grass County",1,33,37,18,19
050,30,097,"Montana","Sweet Grass County",1,34,40,18,22
050,30,097,"Montana","Sweet Grass County",1,35,41,22,19
050,30,097,"Montana","Sweet Grass County",1,36,30,19,11
050,30,097,"Montana","Sweet Grass County",1,37,34,19,15
050,30,097,"Montana","Sweet Grass County",1,38,38,18,20
050,30,097,"Montana","Sweet Grass County",1,39,35,20,15
050,30,097,"Montana","Sweet Grass County",1,40,40,20,20
050,30,097,"Montana","Sweet Grass County",1,41,39,20,19
050,30,097,"Montana","Sweet Grass County",1,42,44,24,20
050,30,097,"Montana","Sweet Grass County",1,43,40,25,15
050,30,097,"Montana","Sweet Grass County",1,44,36,22,14
050,30,097,"Montana","Sweet Grass County",1,45,41,23,18
050,30,097,"Montana","Sweet Grass County",1,46,38,19,19
050,30,097,"Montana","Sweet Grass County",1,47,37,16,21
050,30,097,"Montana","Sweet Grass County",1,48,32,14,18
050,30,097,"Montana","Sweet Grass County",1,49,48,21,27
050,30,097,"Montana","Sweet Grass County",1,50,44,25,19
050,30,097,"Montana","Sweet Grass County",1,51,46,28,18
050,30,097,"Montana","Sweet Grass County",1,52,39,22,17
050,30,097,"Montana","Sweet Grass County",1,53,48,30,18
050,30,097,"Montana","Sweet Grass County",1,54,45,21,24
050,30,097,"Montana","Sweet Grass County",1,55,52,24,28
050,30,097,"Montana","Sweet Grass County",1,56,55,24,31
050,30,097,"Montana","Sweet Grass County",1,57,52,27,25
050,30,097,"Montana","Sweet Grass County",1,58,57,29,28
050,30,097,"Montana","Sweet Grass County",1,59,56,24,32
050,30,097,"Montana","Sweet Grass County",1,60,53,25,28
050,30,097,"Montana","Sweet Grass County",1,61,45,23,22
050,30,097,"Montana","Sweet Grass County",1,62,65,26,39
050,30,097,"Montana","Sweet Grass County",1,63,61,31,30
050,30,097,"Montana","Sweet Grass County",1,64,65,28,37
050,30,097,"Montana","Sweet Grass County",1,65,59,27,32
050,30,097,"Montana","Sweet Grass County",1,66,62,32,30
050,30,097,"Montana","Sweet Grass County",1,67,67,35,32
050,30,097,"Montana","Sweet Grass County",1,68,67,34,33
050,30,097,"Montana","Sweet Grass County",1,69,52,31,21
050,30,097,"Montana","Sweet Grass County",1,70,56,36,20
050,30,097,"Montana","Sweet Grass County",1,71,51,28,23
050,30,097,"Montana","Sweet Grass County",1,72,60,28,32
050,30,097,"Montana","Sweet Grass County",1,73,60,19,41
050,30,097,"Montana","Sweet Grass County",1,74,37,17,20
050,30,097,"Montana","Sweet Grass County",1,75,37,21,16
050,30,097,"Montana","Sweet Grass County",1,76,39,25,14
050,30,097,"Montana","Sweet Grass County",1,77,39,26,13
050,30,097,"Montana","Sweet Grass County",1,78,34,17,17
050,30,097,"Montana","Sweet Grass County",1,79,29,15,14
050,30,097,"Montana","Sweet Grass County",1,80,26,11,15
050,30,097,"Montana","Sweet Grass County",1,81,25,13,12
050,30,097,"Montana","Sweet Grass County",1,82,21,12,9
050,30,097,"Montana","Sweet Grass County",1,83,19,12,7
050,30,097,"Montana","Sweet Grass County",1,84,17,9,8
050,30,097,"Montana","Sweet Grass County",1,85,142,52,90
050,30,097,"Montana","Sweet Grass County",2,0,30,16,14
050,30,097,"Montana","Sweet Grass County",2,1,29,16,13
050,30,097,"Montana","Sweet Grass County",2,2,31,17,14
050,30,097,"Montana","Sweet Grass County",2,3,36,21,15
050,30,097,"Montana","Sweet Grass County",2,4,39,22,17
050,30,097,"Montana","Sweet Grass County",2,5,33,20,13
050,30,097,"Montana","Sweet Grass County",2,6,36,19,17
050,30,097,"Montana","Sweet Grass County",2,7,44,20,24
050,30,097,"Montana","Sweet Grass County",2,8,39,21,18
050,30,097,"Montana","Sweet Grass County",2,9,33,16,17
050,30,097,"Montana","Sweet Grass County",2,10,34,17,17
050,30,097,"Montana","Sweet Grass County",2,11,45,23,22
050,30,097,"Montana","Sweet Grass County",2,12,49,25,24
050,30,097,"Montana","Sweet Grass County",2,13,48,24,24
050,30,097,"Montana","Sweet Grass County",2,14,50,21,29
050,30,097,"Montana","Sweet Grass County",2,15,57,29,28
050,30,097,"Montana","Sweet Grass County",2,16,52,28,24
050,30,097,"Montana","Sweet Grass County",2,17,45,25,20
050,30,097,"Montana","Sweet Grass County",2,18,40,22,18
050,30,097,"Montana","Sweet Grass County",2,19,29,15,14
050,30,097,"Montana","Sweet Grass County",2,20,33,19,14
050,30,097,"Montana","Sweet Grass County",2,21,40,21,19
050,30,097,"Montana","Sweet Grass County",2,22,36,23,13
050,30,097,"Montana","Sweet Grass County",2,23,33,21,12
050,30,097,"Montana","Sweet Grass County",2,24,32,16,16
050,30,097,"Montana","Sweet Grass County",2,25,35,20,15
050,30,097,"Montana","Sweet Grass County",2,26,38,22,16
050,30,097,"Montana","Sweet Grass County",2,27,32,18,14
050,30,097,"Montana","Sweet Grass County",2,28,34,16,18
050,30,097,"Montana","Sweet Grass County",2,29,27,13,14
050,30,097,"Montana","Sweet Grass County",2,30,29,14,15
050,30,097,"Montana","Sweet Grass County",2,31,34,17,17
050,30,097,"Montana","Sweet Grass County",2,32,32,18,14
050,30,097,"Montana","Sweet Grass County",2,33,36,18,18
050,30,097,"Montana","Sweet Grass County",2,34,41,18,23
050,30,097,"Montana","Sweet Grass County",2,35,41,22,19
050,30,097,"Montana","Sweet Grass County",2,36,32,19,13
050,30,097,"Montana","Sweet Grass County",2,37,33,19,14
050,30,097,"Montana","Sweet Grass County",2,38,37,19,18
050,30,097,"Montana","Sweet Grass County",2,39,36,20,16
050,30,097,"Montana","Sweet Grass County",2,40,39,20,19
050,30,097,"Montana","Sweet Grass County",2,41,40,20,20
050,30,097,"Montana","Sweet Grass County",2,42,42,23,19
050,30,097,"Montana","Sweet Grass County",2,43,41,25,16
050,30,097,"Montana","Sweet Grass County",2,44,37,23,14
050,30,097,"Montana","Sweet Grass County",2,45,39,23,16
050,30,097,"Montana","Sweet Grass County",2,46,38,19,19
050,30,097,"Montana","Sweet Grass County",2,47,38,17,21
050,30,097,"Montana","Sweet Grass County",2,48,34,15,19
050,30,097,"Montana","Sweet Grass County",2,49,45,20,25
050,30,097,"Montana","Sweet Grass County",2,50,44,24,20
050,30,097,"Montana","Sweet Grass County",2,51,45,27,18
050,30,097,"Montana","Sweet Grass County",2,52,42,25,17
050,30,097,"Montana","Sweet Grass County",2,53,45,28,17
050,30,097,"Montana","Sweet Grass County",2,54,46,23,23
050,30,097,"Montana","Sweet Grass County",2,55,50,23,27
050,30,097,"Montana","Sweet Grass County",2,56,55,25,30
050,30,097,"Montana","Sweet Grass County",2,57,53,27,26
050,30,097,"Montana","Sweet Grass County",2,58,56,28,28
050,30,097,"Montana","Sweet Grass County",2,59,57,25,32
050,30,097,"Montana","Sweet Grass County",2,60,54,25,29
050,30,097,"Montana","Sweet Grass County",2,61,48,24,24
050,30,097,"Montana","Sweet Grass County",2,62,60,25,35
050,30,097,"Montana","Sweet Grass County",2,63,64,31,33
050,30,097,"Montana","Sweet Grass County",2,64,64,29,35
050,30,097,"Montana","Sweet Grass County",2,65,60,27,33
050,30,097,"Montana","Sweet Grass County",2,66,63,31,32
050,30,097,"Montana","Sweet Grass County",2,67,65,34,31
050,30,097,"Montana","Sweet Grass County",2,68,66,34,32
050,30,097,"Montana","Sweet Grass County",2,69,57,32,25
050,30,097,"Montana","Sweet Grass County",2,70,54,34,20
050,30,097,"Montana","Sweet Grass County",2,71,52,30,22
050,30,097,"Montana","Sweet Grass County",2,72,56,27,29
050,30,097,"Montana","Sweet Grass County",2,73,61,21,40
050,30,097,"Montana","Sweet Grass County",2,74,39,16,23
050,30,097,"Montana","Sweet Grass County",2,75,36,19,17
050,30,097,"Montana","Sweet Grass County",2,76,38,24,14
050,30,097,"Montana","Sweet Grass County",2,77,40,26,14
050,30,097,"Montana","Sweet Grass County",2,78,34,18,16
050,30,097,"Montana","Sweet Grass County",2,79,30,16,14
050,30,097,"Montana","Sweet Grass County",2,80,27,12,15
050,30,097,"Montana","Sweet Grass County",2,81,25,12,13
050,30,097,"Montana","Sweet Grass County",2,82,21,12,9
050,30,097,"Montana","Sweet Grass County",2,83,20,12,8
050,30,097,"Montana","Sweet Grass County",2,84,17,10,7
050,30,097,"Montana","Sweet Grass County",2,85,143,52,91
050,30,097,"Montana","Sweet Grass County",3,0,17,8,9
050,30,097,"Montana","Sweet Grass County",3,1,29,15,14
050,30,097,"Montana","Sweet Grass County",3,2,25,13,12
050,30,097,"Montana","Sweet Grass County",3,3,34,17,17
050,30,097,"Montana","Sweet Grass County",3,4,33,19,14
050,30,097,"Montana","Sweet Grass County",3,5,40,21,19
050,30,097,"Montana","Sweet Grass County",3,6,35,18,17
050,30,097,"Montana","Sweet Grass County",3,7,38,18,20
050,30,097,"Montana","Sweet Grass County",3,8,46,21,25
050,30,097,"Montana","Sweet Grass County",3,9,41,22,19
050,30,097,"Montana","Sweet Grass County",3,10,36,17,19
050,30,097,"Montana","Sweet Grass County",3,11,41,17,24
050,30,097,"Montana","Sweet Grass County",3,12,44,21,23
050,30,097,"Montana","Sweet Grass County",3,13,46,23,23
050,30,097,"Montana","Sweet Grass County",3,14,48,26,22
050,30,097,"Montana","Sweet Grass County",3,15,54,23,31
050,30,097,"Montana","Sweet Grass County",3,16,59,30,29
050,30,097,"Montana","Sweet Grass County",3,17,51,27,24
050,30,097,"Montana","Sweet Grass County",3,18,35,21,14
050,30,097,"Montana","Sweet Grass County",3,19,30,17,13
050,30,097,"Montana","Sweet Grass County",3,20,28,15,13
050,30,097,"Montana","Sweet Grass County",3,21,34,18,16
050,30,097,"Montana","Sweet Grass County",3,22,43,24,19
050,30,097,"Montana","Sweet Grass County",3,23,32,22,10
050,30,097,"Montana","Sweet Grass County",3,24,36,22,14
050,30,097,"Montana","Sweet Grass County",3,25,34,18,16
050,30,097,"Montana","Sweet Grass County",3,26,35,17,18
050,30,097,"Montana","Sweet Grass County",3,27,39,22,17
050,30,097,"Montana","Sweet Grass County",3,28,35,19,16
050,30,097,"Montana","Sweet Grass County",3,29,38,19,19
050,30,097,"Montana","Sweet Grass County",3,30,37,17,20
050,30,097,"Montana","Sweet Grass County",3,31,25,12,13
050,30,097,"Montana","Sweet Grass County",3,32,40,19,21
050,30,097,"Montana","Sweet Grass County",3,33,32,18,14
050,30,097,"Montana","Sweet Grass County",3,34,38,20,18
050,30,097,"Montana","Sweet Grass County",3,35,43,17,26
050,30,097,"Montana","Sweet Grass County",3,36,40,21,19
050,30,097,"Montana","Sweet Grass County",3,37,34,23,11
050,30,097,"Montana","Sweet Grass County",3,38,33,17,16
050,30,097,"Montana","Sweet Grass County",3,39,39,19,20
050,30,097,"Montana","Sweet Grass County",3,40,39,19,20
050,30,097,"Montana","Sweet Grass County",3,41,41,21,20
050,30,097,"Montana","Sweet Grass County",3,42,43,25,18
050,30,097,"Montana","Sweet Grass County",3,43,42,23,19
050,30,097,"Montana","Sweet Grass County",3,44,41,25,16
050,30,097,"Montana","Sweet Grass County",3,45,42,26,16
050,30,097,"Montana","Sweet Grass County",3,46,37,21,16
050,30,097,"Montana","Sweet Grass County",3,47,40,17,23
050,30,097,"Montana","Sweet Grass County",3,48,40,20,20
050,30,097,"Montana","Sweet Grass County",3,49,34,17,17
050,30,097,"Montana","Sweet Grass County",3,50,44,20,24
050,30,097,"Montana","Sweet Grass County",3,51,52,28,24
050,30,097,"Montana","Sweet Grass County",3,52,47,27,20
050,30,097,"Montana","Sweet Grass County",3,53,42,25,17
050,30,097,"Montana","Sweet Grass County",3,54,47,30,17
050,30,097,"Montana","Sweet Grass County",3,55,50,25,25
050,30,097,"Montana","Sweet Grass County",3,56,43,20,23
050,30,097,"Montana","Sweet Grass County",3,57,56,25,31
050,30,097,"Montana","Sweet Grass County",3,58,53,27,26
050,30,097,"Montana","Sweet Grass County",3,59,55,29,26
050,30,097,"Montana","Sweet Grass County",3,60,59,27,32
050,30,097,"Montana","Sweet Grass County",3,61,57,28,29
050,30,097,"Montana","Sweet Grass County",3,62,50,25,25
050,30,097,"Montana","Sweet Grass County",3,63,57,27,30
050,30,097,"Montana","Sweet Grass County",3,64,62,28,34
050,30,097,"Montana","Sweet Grass County",3,65,66,30,36
050,30,097,"Montana","Sweet Grass County",3,66,61,30,31
050,30,097,"Montana","Sweet Grass County",3,67,66,32,34
050,30,097,"Montana","Sweet Grass County",3,68,64,33,31
050,30,097,"Montana","Sweet Grass County",3,69,66,34,32
050,30,097,"Montana","Sweet Grass County",3,70,62,36,26
050,30,097,"Montana","Sweet Grass County",3,71,51,33,18
050,30,097,"Montana","Sweet Grass County",3,72,47,27,20
050,30,097,"Montana","Sweet Grass County",3,73,56,26,30
050,30,097,"Montana","Sweet Grass County",3,74,60,21,39
050,30,097,"Montana","Sweet Grass County",3,75,37,15,22
050,30,097,"Montana","Sweet Grass County",3,76,33,16,17
050,30,097,"Montana","Sweet Grass County",3,77,39,26,13
050,30,097,"Montana","Sweet Grass County",3,78,37,23,14
050,30,097,"Montana","Sweet Grass County",3,79,33,18,15
050,30,097,"Montana","Sweet Grass County",3,80,29,15,14
050,30,097,"Montana","Sweet Grass County",3,81,29,12,17
050,30,097,"Montana","Sweet Grass County",3,82,20,9,11
050,30,097,"Montana","Sweet Grass County",3,83,19,10,9
050,30,097,"Montana","Sweet Grass County",3,84,15,7,8
050,30,097,"Montana","Sweet Grass County",3,85,142,55,87
050,30,097,"Montana","Sweet Grass County",4,0,24,10,14
050,30,097,"Montana","Sweet Grass County",4,1,12,6,6
050,30,097,"Montana","Sweet Grass County",4,2,36,17,19
050,30,097,"Montana","Sweet Grass County",4,3,24,14,10
050,30,097,"Montana","Sweet Grass County",4,4,34,17,17
050,30,097,"Montana","Sweet Grass County",4,5,34,17,17
050,30,097,"Montana","Sweet Grass County",4,6,38,19,19
050,30,097,"Montana","Sweet Grass County",4,7,32,17,15
050,30,097,"Montana","Sweet Grass County",4,8,36,18,18
050,30,097,"Montana","Sweet Grass County",4,9,47,21,26
050,30,097,"Montana","Sweet Grass County",4,10,41,22,19
050,30,097,"Montana","Sweet Grass County",4,11,37,19,18
050,30,097,"Montana","Sweet Grass County",4,12,45,20,25
050,30,097,"Montana","Sweet Grass County",4,13,51,24,27
050,30,097,"Montana","Sweet Grass County",4,14,51,23,28
050,30,097,"Montana","Sweet Grass County",4,15,49,29,20
050,30,097,"Montana","Sweet Grass County",4,16,60,24,36
050,30,097,"Montana","Sweet Grass County",4,17,56,28,28
050,30,097,"Montana","Sweet Grass County",4,18,46,25,21
050,30,097,"Montana","Sweet Grass County",4,19,28,17,11
050,30,097,"Montana","Sweet Grass County",4,20,32,19,13
050,30,097,"Montana","Sweet Grass County",4,21,25,14,11
050,30,097,"Montana","Sweet Grass County",4,22,31,17,14
050,30,097,"Montana","Sweet Grass County",4,23,47,25,22
050,30,097,"Montana","Sweet Grass County",4,24,31,22,9
050,30,097,"Montana","Sweet Grass County",4,25,36,25,11
050,30,097,"Montana","Sweet Grass County",4,26,30,18,12
050,30,097,"Montana","Sweet Grass County",4,27,32,13,19
050,30,097,"Montana","Sweet Grass County",4,28,36,19,17
050,30,097,"Montana","Sweet Grass County",4,29,37,19,18
050,30,097,"Montana","Sweet Grass County",4,30,33,16,17
050,30,097,"Montana","Sweet Grass County",4,31,37,15,22
050,30,097,"Montana","Sweet Grass County",4,32,29,12,17
050,30,097,"Montana","Sweet Grass County",4,33,39,20,19
050,30,097,"Montana","Sweet Grass County",4,34,37,23,14
050,30,097,"Montana","Sweet Grass County",4,35,38,20,18
050,30,097,"Montana","Sweet Grass County",4,36,45,20,25
050,30,097,"Montana","Sweet Grass County",4,37,47,24,23
050,30,097,"Montana","Sweet Grass County",4,38,34,24,10
050,30,097,"Montana","Sweet Grass County",4,39,35,18,17
050,30,097,"Montana","Sweet Grass County",4,40,41,18,23
050,30,097,"Montana","Sweet Grass County",4,41,45,24,21
050,30,097,"Montana","Sweet Grass County",4,42,47,23,24
050,30,097,"Montana","Sweet Grass County",4,43,44,26,18
050,30,097,"Montana","Sweet Grass County",4,44,42,24,18
050,30,097,"Montana","Sweet Grass County",4,45,40,24,16
050,30,097,"Montana","Sweet Grass County",4,46,43,26,17
050,30,097,"Montana","Sweet Grass County",4,47,37,20,17
050,30,097,"Montana","Sweet Grass County",4,48,39,15,24
050,30,097,"Montana","Sweet Grass County",4,49,40,22,18
050,30,097,"Montana","Sweet Grass County",4,50,32,13,19
050,30,097,"Montana","Sweet Grass County",4,51,43,20,23
050,30,097,"Montana","Sweet Grass County",4,52,54,28,26
050,30,097,"Montana","Sweet Grass County",4,53,47,27,20
050,30,097,"Montana","Sweet Grass County",4,54,41,24,17
050,30,097,"Montana","Sweet Grass County",4,55,50,32,18
050,30,097,"Montana","Sweet Grass County",4,56,52,27,25
050,30,097,"Montana","Sweet Grass County",4,57,49,23,26
050,30,097,"Montana","Sweet Grass County",4,58,58,25,33
050,30,097,"Montana","Sweet Grass County",4,59,52,23,29
050,30,097,"Montana","Sweet Grass County",4,60,59,32,27
050,30,097,"Montana","Sweet Grass County",4,61,58,27,31
050,30,097,"Montana","Sweet Grass County",4,62,55,26,29
050,30,097,"Montana","Sweet Grass County",4,63,50,27,23
050,30,097,"Montana","Sweet Grass County",4,64,56,26,30
050,30,097,"Montana","Sweet Grass County",4,65,64,28,36
050,30,097,"Montana","Sweet Grass County",4,66,69,33,36
050,30,097,"Montana","Sweet Grass County",4,67,62,29,33
050,30,097,"Montana","Sweet Grass County",4,68,66,34,32
050,30,097,"Montana","Sweet Grass County",4,69,64,32,32
050,30,097,"Montana","Sweet Grass County",4,70,65,35,30
050,30,097,"Montana","Sweet Grass County",4,71,65,36,29
050,30,097,"Montana","Sweet Grass County",4,72,47,30,17
050,30,097,"Montana","Sweet Grass County",4,73,46,27,19
050,30,097,"Montana","Sweet Grass County",4,74,56,28,28
050,30,097,"Montana","Sweet Grass County",4,75,60,22,38
050,30,097,"Montana","Sweet Grass County",4,76,36,14,22
050,30,097,"Montana","Sweet Grass County",4,77,31,17,14
050,30,097,"Montana","Sweet Grass County",4,78,34,22,12
050,30,097,"Montana","Sweet Grass County",4,79,37,25,12
050,30,097,"Montana","Sweet Grass County",4,80,33,18,15
050,30,097,"Montana","Sweet Grass County",4,81,29,15,14
050,30,097,"Montana","Sweet Grass County",4,82,26,11,15
050,30,097,"Montana","Sweet Grass County",4,83,18,8,10
050,30,097,"Montana","Sweet Grass County",4,84,16,8,8
050,30,097,"Montana","Sweet Grass County",4,85,137,54,83
050,30,097,"Montana","Sweet Grass County",5,0,24,10,14
050,30,097,"Montana","Sweet Grass County",5,1,23,16,7
050,30,097,"Montana","Sweet Grass County",5,2,14,8,6
050,30,097,"Montana","Sweet Grass County",5,3,34,17,17
050,30,097,"Montana","Sweet Grass County",5,4,26,15,11
050,30,097,"Montana","Sweet Grass County",5,5,34,19,15
050,30,097,"Montana","Sweet Grass County",5,6,37,19,18
050,30,097,"Montana","Sweet Grass County",5,7,42,19,23
050,30,097,"Montana","Sweet Grass County",5,8,37,22,15
050,30,097,"Montana","Sweet Grass County",5,9,35,18,17
050,30,097,"Montana","Sweet Grass County",5,10,48,20,28
050,30,097,"Montana","Sweet Grass County",5,11,41,22,19
050,30,097,"Montana","Sweet Grass County",5,12,35,18,17
050,30,097,"Montana","Sweet Grass County",5,13,44,19,25
050,30,097,"Montana","Sweet Grass County",5,14,50,28,22
050,30,097,"Montana","Sweet Grass County",5,15,50,26,24
050,30,097,"Montana","Sweet Grass County",5,16,53,27,26
050,30,097,"Montana","Sweet Grass County",5,17,49,16,33
050,30,097,"Montana","Sweet Grass County",5,18,46,25,21
050,30,097,"Montana","Sweet Grass County",5,19,39,20,19
050,30,097,"Montana","Sweet Grass County",5,20,31,18,13
050,30,097,"Montana","Sweet Grass County",5,21,31,17,14
050,30,097,"Montana","Sweet Grass County",5,22,27,17,10
050,30,097,"Montana","Sweet Grass County",5,23,39,18,21
050,30,097,"Montana","Sweet Grass County",5,24,37,18,19
050,30,097,"Montana","Sweet Grass County",5,25,38,29,9
050,30,097,"Montana","Sweet Grass County",5,26,42,21,21
050,30,097,"Montana","Sweet Grass County",5,27,29,16,13
050,30,097,"Montana","Sweet Grass County",5,28,36,16,20
050,30,097,"Montana","Sweet Grass County",5,29,35,18,17
050,30,097,"Montana","Sweet Grass County",5,30,36,17,19
050,30,097,"Montana","Sweet Grass County",5,31,38,17,21
050,30,097,"Montana","Sweet Grass County",5,32,36,15,21
050,30,097,"Montana","Sweet Grass County",5,33,30,12,18
050,30,097,"Montana","Sweet Grass County",5,34,45,25,20
050,30,097,"Montana","Sweet Grass County",5,35,44,27,17
050,30,097,"Montana","Sweet Grass County",5,36,37,19,18
050,30,097,"Montana","Sweet Grass County",5,37,42,20,22
050,30,097,"Montana","Sweet Grass County",5,38,50,23,27
050,30,097,"Montana","Sweet Grass County",5,39,39,29,10
050,30,097,"Montana","Sweet Grass County",5,40,35,19,16
050,30,097,"Montana","Sweet Grass County",5,41,48,21,27
050,30,097,"Montana","Sweet Grass County",5,42,46,26,20
050,30,097,"Montana","Sweet Grass County",5,43,46,23,23
050,30,097,"Montana","Sweet Grass County",5,44,46,24,22
050,30,097,"Montana","Sweet Grass County",5,45,42,23,19
050,30,097,"Montana","Sweet Grass County",5,46,38,21,17
050,30,097,"Montana","Sweet Grass County",5,47,45,27,18
050,30,097,"Montana","Sweet Grass County",5,48,39,21,18
050,30,097,"Montana","Sweet Grass County",5,49,41,18,23
050,30,097,"Montana","Sweet Grass County",5,50,41,21,20
050,30,097,"Montana","Sweet Grass County",5,51,32,13,19
050,30,097,"Montana","Sweet Grass County",5,52,45,22,23
050,30,097,"Montana","Sweet Grass County",5,53,54,27,27
050,30,097,"Montana","Sweet Grass County",5,54,48,28,20
050,30,097,"Montana","Sweet Grass County",5,55,43,25,18
050,30,097,"Montana","Sweet Grass County",5,56,52,35,17
050,30,097,"Montana","Sweet Grass County",5,57,54,29,25
050,30,097,"Montana","Sweet Grass County",5,58,49,23,26
050,30,097,"Montana","Sweet Grass County",5,59,66,31,35
050,30,097,"Montana","Sweet Grass County",5,60,51,22,29
050,30,097,"Montana","Sweet Grass County",5,61,51,29,22
050,30,097,"Montana","Sweet Grass County",5,62,62,28,34
050,30,097,"Montana","Sweet Grass County",5,63,52,23,29
050,30,097,"Montana","Sweet Grass County",5,64,54,29,25
050,30,097,"Montana","Sweet Grass County",5,65,62,29,33
050,30,097,"Montana","Sweet Grass County",5,66,62,28,34
050,30,097,"Montana","Sweet Grass County",5,67,71,34,37
050,30,097,"Montana","Sweet Grass County",5,68,58,29,29
050,30,097,"Montana","Sweet Grass County",5,69,64,32,32
050,30,097,"Montana","Sweet Grass County",5,70,62,32,30
050,30,097,"Montana","Sweet Grass County",5,71,65,33,32
050,30,097,"Montana","Sweet Grass County",5,72,60,32,28
050,30,097,"Montana","Sweet Grass County",5,73,48,30,18
050,30,097,"Montana","Sweet Grass County",5,74,45,26,19
050,30,097,"Montana","Sweet Grass County",5,75,56,29,27
050,30,097,"Montana","Sweet Grass County",5,76,59,22,37
050,30,097,"Montana","Sweet Grass County",5,77,34,13,21
050,30,097,"Montana","Sweet Grass County",5,78,32,18,14
050,30,097,"Montana","Sweet Grass County",5,79,33,22,11
050,30,097,"Montana","Sweet Grass County",5,80,37,25,12
050,30,097,"Montana","Sweet Grass County",5,81,32,18,14
050,30,097,"Montana","Sweet Grass County",5,82,25,12,13
050,30,097,"Montana","Sweet Grass County",5,83,27,10,17
050,30,097,"Montana","Sweet Grass County",5,84,17,6,11
050,30,097,"Montana","Sweet Grass County",5,85,131,55,76
050,30,099,"Montana","Teton County",1,0,80,41,39
050,30,099,"Montana","Teton County",1,1,77,46,31
050,30,099,"Montana","Teton County",1,2,87,50,37
050,30,099,"Montana","Teton County",1,3,94,47,47
050,30,099,"Montana","Teton County",1,4,89,44,45
050,30,099,"Montana","Teton County",1,5,79,37,42
050,30,099,"Montana","Teton County",1,6,87,43,44
050,30,099,"Montana","Teton County",1,7,93,49,44
050,30,099,"Montana","Teton County",1,8,101,41,60
050,30,099,"Montana","Teton County",1,9,80,36,44
050,30,099,"Montana","Teton County",1,10,71,36,35
050,30,099,"Montana","Teton County",1,11,81,40,41
050,30,099,"Montana","Teton County",1,12,80,43,37
050,30,099,"Montana","Teton County",1,13,86,44,42
050,30,099,"Montana","Teton County",1,14,95,46,49
050,30,099,"Montana","Teton County",1,15,96,48,48
050,30,099,"Montana","Teton County",1,16,84,45,39
050,30,099,"Montana","Teton County",1,17,87,47,40
050,30,099,"Montana","Teton County",1,18,69,41,28
050,30,099,"Montana","Teton County",1,19,56,29,27
050,30,099,"Montana","Teton County",1,20,51,23,28
050,30,099,"Montana","Teton County",1,21,59,30,29
050,30,099,"Montana","Teton County",1,22,52,25,27
050,30,099,"Montana","Teton County",1,23,61,38,23
050,30,099,"Montana","Teton County",1,24,59,31,28
050,30,099,"Montana","Teton County",1,25,59,32,27
050,30,099,"Montana","Teton County",1,26,61,34,27
050,30,099,"Montana","Teton County",1,27,61,29,32
050,30,099,"Montana","Teton County",1,28,61,32,29
050,30,099,"Montana","Teton County",1,29,48,25,23
050,30,099,"Montana","Teton County",1,30,49,27,22
050,30,099,"Montana","Teton County",1,31,58,33,25
050,30,099,"Montana","Teton County",1,32,52,23,29
050,30,099,"Montana","Teton County",1,33,60,27,33
050,30,099,"Montana","Teton County",1,34,59,29,30
050,30,099,"Montana","Teton County",1,35,72,36,36
050,30,099,"Montana","Teton County",1,36,76,36,40
050,30,099,"Montana","Teton County",1,37,67,29,38
050,30,099,"Montana","Teton County",1,38,72,32,40
050,30,099,"Montana","Teton County",1,39,67,38,29
050,30,099,"Montana","Teton County",1,40,83,31,52
050,30,099,"Montana","Teton County",1,41,69,33,36
050,30,099,"Montana","Teton County",1,42,60,31,29
050,30,099,"Montana","Teton County",1,43,60,32,28
050,30,099,"Montana","Teton County",1,44,63,33,30
050,30,099,"Montana","Teton County",1,45,54,24,30
050,30,099,"Montana","Teton County",1,46,59,31,28
050,30,099,"Montana","Teton County",1,47,66,33,33
050,30,099,"Montana","Teton County",1,48,66,30,36
050,30,099,"Montana","Teton County",1,49,76,45,31
050,30,099,"Montana","Teton County",1,50,64,30,34
050,30,099,"Montana","Teton County",1,51,66,32,34
050,30,099,"Montana","Teton County",1,52,62,31,31
050,30,099,"Montana","Teton County",1,53,71,39,32
050,30,099,"Montana","Teton County",1,54,81,36,45
050,30,099,"Montana","Teton County",1,55,88,44,44
050,30,099,"Montana","Teton County",1,56,105,50,55
050,30,099,"Montana","Teton County",1,57,91,45,46
050,30,099,"Montana","Teton County",1,58,91,48,43
050,30,099,"Montana","Teton County",1,59,92,49,43
050,30,099,"Montana","Teton County",1,60,105,53,52
050,30,099,"Montana","Teton County",1,61,94,48,46
050,30,099,"Montana","Teton County",1,62,82,43,39
050,30,099,"Montana","Teton County",1,63,84,43,41
050,30,099,"Montana","Teton County",1,64,92,49,43
050,30,099,"Montana","Teton County",1,65,80,39,41
050,30,099,"Montana","Teton County",1,66,78,40,38
050,30,099,"Montana","Teton County",1,67,82,44,38
050,30,099,"Montana","Teton County",1,68,80,47,33
050,30,099,"Montana","Teton County",1,69,75,40,35
050,30,099,"Montana","Teton County",1,70,79,42,37
050,30,099,"Montana","Teton County",1,71,78,36,42
050,30,099,"Montana","Teton County",1,72,67,30,37
050,30,099,"Montana","Teton County",1,73,70,31,39
050,30,099,"Montana","Teton County",1,74,60,27,33
050,30,099,"Montana","Teton County",1,75,62,33,29
050,30,099,"Montana","Teton County",1,76,62,34,28
050,30,099,"Montana","Teton County",1,77,61,33,28
050,30,099,"Montana","Teton County",1,78,48,28,20
050,30,099,"Montana","Teton County",1,79,45,23,22
050,30,099,"Montana","Teton County",1,80,40,20,20
050,30,099,"Montana","Teton County",1,81,41,14,27
050,30,099,"Montana","Teton County",1,82,35,16,19
050,30,099,"Montana","Teton County",1,83,44,22,22
050,30,099,"Montana","Teton County",1,84,40,21,19
050,30,099,"Montana","Teton County",1,85,199,80,119
050,30,099,"Montana","Teton County",2,0,84,43,41
050,30,099,"Montana","Teton County",2,1,76,45,31
050,30,099,"Montana","Teton County",2,2,86,50,36
050,30,099,"Montana","Teton County",2,3,92,48,44
050,30,099,"Montana","Teton County",2,4,90,44,46
050,30,099,"Montana","Teton County",2,5,82,39,43
050,30,099,"Montana","Teton County",2,6,88,43,45
050,30,099,"Montana","Teton County",2,7,92,47,45
050,30,099,"Montana","Teton County",2,8,100,43,57
050,30,099,"Montana","Teton County",2,9,86,37,49
050,30,099,"Montana","Teton County",2,10,73,36,37
050,30,099,"Montana","Teton County",2,11,82,41,41
050,30,099,"Montana","Teton County",2,12,82,43,39
050,30,099,"Montana","Teton County",2,13,85,43,42
050,30,099,"Montana","Teton County",2,14,94,45,49
050,30,099,"Montana","Teton County",2,15,95,48,47
050,30,099,"Montana","Teton County",2,16,88,47,41
050,30,099,"Montana","Teton County",2,17,86,46,40
050,30,099,"Montana","Teton County",2,18,69,40,29
050,30,099,"Montana","Teton County",2,19,55,29,26
050,30,099,"Montana","Teton County",2,20,54,26,28
050,30,099,"Montana","Teton County",2,21,56,27,29
050,30,099,"Montana","Teton County",2,22,55,28,27
050,30,099,"Montana","Teton County",2,23,60,36,24
050,30,099,"Montana","Teton County",2,24,59,32,27
050,30,099,"Montana","Teton County",2,25,58,31,27
050,30,099,"Montana","Teton County",2,26,59,33,26
050,30,099,"Montana","Teton County",2,27,62,31,31
050,30,099,"Montana","Teton County",2,28,61,32,29
050,30,099,"Montana","Teton County",2,29,52,27,25
050,30,099,"Montana","Teton County",2,30,48,26,22
050,30,099,"Montana","Teton County",2,31,57,33,24
050,30,099,"Montana","Teton County",2,32,55,26,29
050,30,099,"Montana","Teton County",2,33,60,28,32
050,30,099,"Montana","Teton County",2,34,59,28,31
050,30,099,"Montana","Teton County",2,35,70,35,35
050,30,099,"Montana","Teton County",2,36,73,36,37
050,30,099,"Montana","Teton County",2,37,71,31,40
050,30,099,"Montana","Teton County",2,38,72,32,40
050,30,099,"Montana","Teton County",2,39,68,36,32
050,30,099,"Montana","Teton County",2,40,81,33,48
050,30,099,"Montana","Teton County",2,41,73,33,40
050,30,099,"Montana","Teton County",2,42,63,32,31
050,30,099,"Montana","Teton County",2,43,61,32,29
050,30,099,"Montana","Teton County",2,44,61,32,29
050,30,099,"Montana","Teton County",2,45,56,26,30
050,30,099,"Montana","Teton County",2,46,58,29,29
050,30,099,"Montana","Teton County",2,47,66,33,33
050,30,099,"Montana","Teton County",2,48,66,31,35
050,30,099,"Montana","Teton County",2,49,76,43,33
050,30,099,"Montana","Teton County",2,50,64,31,33
050,30,099,"Montana","Teton County",2,51,66,32,34
050,30,099,"Montana","Teton County",2,52,61,31,30
050,30,099,"Montana","Teton County",2,53,69,37,32
050,30,099,"Montana","Teton County",2,54,79,36,43
050,30,099,"Montana","Teton County",2,55,90,43,47
050,30,099,"Montana","Teton County",2,56,101,49,52
050,30,099,"Montana","Teton County",2,57,94,46,48
050,30,099,"Montana","Teton County",2,58,90,46,44
050,30,099,"Montana","Teton County",2,59,93,50,43
050,30,099,"Montana","Teton County",2,60,103,53,50
050,30,099,"Montana","Teton County",2,61,95,49,46
050,30,099,"Montana","Teton County",2,62,84,44,40
050,30,099,"Montana","Teton County",2,63,84,43,41
050,30,099,"Montana","Teton County",2,64,89,46,43
050,30,099,"Montana","Teton County",2,65,82,41,41
050,30,099,"Montana","Teton County",2,66,80,41,39
050,30,099,"Montana","Teton County",2,67,80,42,38
050,30,099,"Montana","Teton County",2,68,80,47,33
050,30,099,"Montana","Teton County",2,69,76,41,35
050,30,099,"Montana","Teton County",2,70,78,41,37
050,30,099,"Montana","Teton County",2,71,80,38,42
050,30,099,"Montana","Teton County",2,72,68,30,38
050,30,099,"Montana","Teton County",2,73,73,33,40
050,30,099,"Montana","Teton County",2,74,59,26,33
050,30,099,"Montana","Teton County",2,75,61,31,30
050,30,099,"Montana","Teton County",2,76,59,32,27
050,30,099,"Montana","Teton County",2,77,63,34,29
050,30,099,"Montana","Teton County",2,78,50,28,22
050,30,099,"Montana","Teton County",2,79,44,23,21
050,30,099,"Montana","Teton County",2,80,41,21,20
050,30,099,"Montana","Teton County",2,81,41,15,26
050,30,099,"Montana","Teton County",2,82,37,16,21
050,30,099,"Montana","Teton County",2,83,42,21,21
050,30,099,"Montana","Teton County",2,84,39,21,18
050,30,099,"Montana","Teton County",2,85,202,82,120
050,30,099,"Montana","Teton County",3,0,68,28,40
050,30,099,"Montana","Teton County",3,1,82,40,42
050,30,099,"Montana","Teton County",3,2,72,42,30
050,30,099,"Montana","Teton County",3,3,91,51,40
050,30,099,"Montana","Teton County",3,4,89,47,42
050,30,099,"Montana","Teton County",3,5,87,43,44
050,30,099,"Montana","Teton County",3,6,83,38,45
050,30,099,"Montana","Teton County",3,7,86,43,43
050,30,099,"Montana","Teton County",3,8,90,44,46
050,30,099,"Montana","Teton County",3,9,97,43,54
050,30,099,"Montana","Teton County",3,10,87,35,52
050,30,099,"Montana","Teton County",3,11,78,36,42
050,30,099,"Montana","Teton County",3,12,84,40,44
050,30,099,"Montana","Teton County",3,13,80,43,37
050,30,099,"Montana","Teton County",3,14,79,39,40
050,30,099,"Montana","Teton County",3,15,89,43,46
050,30,099,"Montana","Teton County",3,16,98,51,47
050,30,099,"Montana","Teton County",3,17,84,45,39
050,30,099,"Montana","Teton County",3,18,79,40,39
050,30,099,"Montana","Teton County",3,19,52,29,23
050,30,099,"Montana","Teton County",3,20,61,33,28
050,30,099,"Montana","Teton County",3,21,60,30,30
050,30,099,"Montana","Teton County",3,22,67,32,35
050,30,099,"Montana","Teton County",3,23,47,24,23
050,30,099,"Montana","Teton County",3,24,70,39,31
050,30,099,"Montana","Teton County",3,25,71,38,33
050,30,099,"Montana","Teton County",3,26,62,27,35
050,30,099,"Montana","Teton County",3,27,64,35,29
050,30,099,"Montana","Teton County",3,28,60,32,28
050,30,099,"Montana","Teton County",3,29,66,34,32
050,30,099,"Montana","Teton County",3,30,49,24,25
050,30,099,"Montana","Teton County",3,31,61,36,25
050,30,099,"Montana","Teton County",3,32,60,34,26
050,30,099,"Montana","Teton County",3,33,56,27,29
050,30,099,"Montana","Teton County",3,34,61,24,37
050,30,099,"Montana","Teton County",3,35,59,27,32
050,30,099,"Montana","Teton County",3,36,63,32,31
050,30,099,"Montana","Teton County",3,37,79,38,41
050,30,099,"Montana","Teton County",3,38,72,35,37
050,30,099,"Montana","Teton County",3,39,67,29,38
050,30,099,"Montana","Teton County",3,40,65,37,28
050,30,099,"Montana","Teton County",3,41,79,31,48
050,30,099,"Montana","Teton County",3,42,77,38,39
050,30,099,"Montana","Teton County",3,43,61,32,29
050,30,099,"Montana","Teton County",3,44,63,33,30
050,30,099,"Montana","Teton County",3,45,58,33,25
050,30,099,"Montana","Teton County",3,46,57,27,30
050,30,099,"Montana","Teton County",3,47,57,28,29
050,30,099,"Montana","Teton County",3,48,64,33,31
050,30,099,"Montana","Teton County",3,49,65,30,35
050,30,099,"Montana","Teton County",3,50,71,40,31
050,30,099,"Montana","Teton County",3,51,62,28,34
050,30,099,"Montana","Teton County",3,52,67,32,35
050,30,099,"Montana","Teton County",3,53,61,31,30
050,30,099,"Montana","Teton County",3,54,72,36,36
050,30,099,"Montana","Teton County",3,55,85,38,47
050,30,099,"Montana","Teton County",3,56,94,46,48
050,30,099,"Montana","Teton County",3,57,99,51,48
050,30,099,"Montana","Teton County",3,58,101,48,53
050,30,099,"Montana","Teton County",3,59,86,44,42
050,30,099,"Montana","Teton County",3,60,93,50,43
050,30,099,"Montana","Teton County",3,61,98,49,49
050,30,099,"Montana","Teton County",3,62,95,48,47
050,30,099,"Montana","Teton County",3,63,84,44,40
050,30,099,"Montana","Teton County",3,64,83,42,41
050,30,099,"Montana","Teton County",3,65,86,43,43
050,30,099,"Montana","Teton County",3,66,82,44,38
050,30,099,"Montana","Teton County",3,67,81,41,40
050,30,099,"Montana","Teton County",3,68,81,42,39
050,30,099,"Montana","Teton County",3,69,78,43,35
050,30,099,"Montana","Teton County",3,70,77,42,35
050,30,099,"Montana","Teton County",3,71,78,43,35
050,30,099,"Montana","Teton County",3,72,79,38,41
050,30,099,"Montana","Teton County",3,73,68,32,36
050,30,099,"Montana","Teton County",3,74,75,34,41
050,30,099,"Montana","Teton County",3,75,58,25,33
050,30,099,"Montana","Teton County",3,76,61,31,30
050,30,099,"Montana","Teton County",3,77,53,29,24
050,30,099,"Montana","Teton County",3,78,62,32,30
050,30,099,"Montana","Teton County",3,79,45,22,23
050,30,099,"Montana","Teton County",3,80,44,23,21
050,30,099,"Montana","Teton County",3,81,41,20,21
050,30,099,"Montana","Teton County",3,82,32,11,21
050,30,099,"Montana","Teton County",3,83,35,14,21
050,30,099,"Montana","Teton County",3,84,40,17,23
050,30,099,"Montana","Teton County",3,85,212,92,120
050,30,099,"Montana","Teton County",4,0,68,29,39
050,30,099,"Montana","Teton County",4,1,72,33,39
050,30,099,"Montana","Teton County",4,2,78,38,40
050,30,099,"Montana","Teton County",4,3,80,45,35
050,30,099,"Montana","Teton County",4,4,90,49,41
050,30,099,"Montana","Teton County",4,5,100,52,48
050,30,099,"Montana","Teton County",4,6,92,45,47
050,30,099,"Montana","Teton County",4,7,90,39,51
050,30,099,"Montana","Teton County",4,8,86,44,42
050,30,099,"Montana","Teton County",4,9,92,44,48
050,30,099,"Montana","Teton County",4,10,102,47,55
050,30,099,"Montana","Teton County",4,11,93,40,53
050,30,099,"Montana","Teton County",4,12,79,37,42
050,30,099,"Montana","Teton County",4,13,91,45,46
050,30,099,"Montana","Teton County",4,14,79,43,36
050,30,099,"Montana","Teton County",4,15,84,43,41
050,30,099,"Montana","Teton County",4,16,94,44,50
050,30,099,"Montana","Teton County",4,17,90,48,42
050,30,099,"Montana","Teton County",4,18,71,36,35
050,30,099,"Montana","Teton County",4,19,64,31,33
050,30,099,"Montana","Teton County",4,20,56,33,23
050,30,099,"Montana","Teton County",4,21,62,33,29
050,30,099,"Montana","Teton County",4,22,64,30,34
050,30,099,"Montana","Teton County",4,23,56,33,23
050,30,099,"Montana","Teton County",4,24,55,27,28
050,30,099,"Montana","Teton County",4,25,65,39,26
050,30,099,"Montana","Teton County",4,26,63,34,29
050,30,099,"Montana","Teton County",4,27,71,31,40
050,30,099,"Montana","Teton County",4,28,64,35,29
050,30,099,"Montana","Teton County",4,29,63,34,29
050,30,099,"Montana","Teton County",4,30,71,38,33
050,30,099,"Montana","Teton County",4,31,58,33,25
050,30,099,"Montana","Teton County",4,32,63,35,28
050,30,099,"Montana","Teton County",4,33,63,34,29
050,30,099,"Montana","Teton County",4,34,58,28,30
050,30,099,"Montana","Teton County",4,35,63,24,39
050,30,099,"Montana","Teton County",4,36,55,28,27
050,30,099,"Montana","Teton County",4,37,71,34,37
050,30,099,"Montana","Teton County",4,38,83,45,38
050,30,099,"Montana","Teton County",4,39,77,37,40
050,30,099,"Montana","Teton County",4,40,69,30,39
050,30,099,"Montana","Teton County",4,41,65,36,29
050,30,099,"Montana","Teton County",4,42,78,32,46
050,30,099,"Montana","Teton County",4,43,75,37,38
050,30,099,"Montana","Teton County",4,44,65,34,31
050,30,099,"Montana","Teton County",4,45,65,33,32
050,30,099,"Montana","Teton County",4,46,66,37,29
050,30,099,"Montana","Teton County",4,47,63,30,33
050,30,099,"Montana","Teton County",4,48,60,28,32
050,30,099,"Montana","Teton County",4,49,65,34,31
050,30,099,"Montana","Teton County",4,50,62,30,32
050,30,099,"Montana","Teton County",4,51,74,39,35
050,30,099,"Montana","Teton County",4,52,61,28,33
050,30,099,"Montana","Teton County",4,53,68,28,40
050,30,099,"Montana","Teton County",4,54,66,33,33
050,30,099,"Montana","Teton County",4,55,67,32,35
050,30,099,"Montana","Teton County",4,56,88,42,46
050,30,099,"Montana","Teton County",4,57,94,46,48
050,30,099,"Montana","Teton County",4,58,104,52,52
050,30,099,"Montana","Teton County",4,59,95,45,50
050,30,099,"Montana","Teton County",4,60,89,48,41
050,30,099,"Montana","Teton County",4,61,84,42,42
050,30,099,"Montana","Teton County",4,62,103,49,54
050,30,099,"Montana","Teton County",4,63,94,45,49
050,30,099,"Montana","Teton County",4,64,83,42,41
050,30,099,"Montana","Teton County",4,65,82,41,41
050,30,099,"Montana","Teton County",4,66,88,46,42
050,30,099,"Montana","Teton County",4,67,82,42,40
050,30,099,"Montana","Teton County",4,68,83,44,39
050,30,099,"Montana","Teton County",4,69,76,37,39
050,30,099,"Montana","Teton County",4,70,78,41,37
050,30,099,"Montana","Teton County",4,71,75,42,33
050,30,099,"Montana","Teton County",4,72,76,43,33
050,30,099,"Montana","Teton County",4,73,72,36,36
050,30,099,"Montana","Teton County",4,74,68,31,37
050,30,099,"Montana","Teton County",4,75,69,29,40
050,30,099,"Montana","Teton County",4,76,54,23,31
050,30,099,"Montana","Teton County",4,77,57,30,27
050,30,099,"Montana","Teton County",4,78,48,27,21
050,30,099,"Montana","Teton County",4,79,56,29,27
050,30,099,"Montana","Teton County",4,80,43,20,23
050,30,099,"Montana","Teton County",4,81,45,24,21
050,30,099,"Montana","Teton County",4,82,36,17,19
050,30,099,"Montana","Teton County",4,83,28,9,19
050,30,099,"Montana","Teton County",4,84,30,10,20
050,30,099,"Montana","Teton County",4,85,221,96,125
050,30,099,"Montana","Teton County",5,0,68,29,39
050,30,099,"Montana","Teton County",5,1,65,31,34
050,30,099,"Montana","Teton County",5,2,72,32,40
050,30,099,"Montana","Teton County",5,3,90,44,46
050,30,099,"Montana","Teton County",5,4,93,53,40
050,30,099,"Montana","Teton County",5,5,99,53,46
050,30,099,"Montana","Teton County",5,6,109,54,55
050,30,099,"Montana","Teton County",5,7,94,45,49
050,30,099,"Montana","Teton County",5,8,97,49,48
050,30,099,"Montana","Teton County",5,9,87,43,44
050,30,099,"Montana","Teton County",5,10,95,47,48
050,30,099,"Montana","Teton County",5,11,105,51,54
050,30,099,"Montana","Teton County",5,12,98,41,57
050,30,099,"Montana","Teton County",5,13,82,36,46
050,30,099,"Montana","Teton County",5,14,86,40,46
050,30,099,"Montana","Teton County",5,15,76,41,35
050,30,099,"Montana","Teton County",5,16,86,43,43
050,30,099,"Montana","Teton County",5,17,91,46,45
050,30,099,"Montana","Teton County",5,18,78,42,36
050,30,099,"Montana","Teton County",5,19,55,29,26
050,30,099,"Montana","Teton County",5,20,63,32,31
050,30,099,"Montana","Teton County",5,21,62,36,26
050,30,099,"Montana","Teton County",5,22,67,34,33
050,30,099,"Montana","Teton County",5,23,61,28,33
050,30,099,"Montana","Teton County",5,24,63,36,27
050,30,099,"Montana","Teton County",5,25,56,25,31
050,30,099,"Montana","Teton County",5,26,63,33,30
050,30,099,"Montana","Teton County",5,27,70,39,31
050,30,099,"Montana","Teton County",5,28,74,34,40
050,30,099,"Montana","Teton County",5,29,69,33,36
050,30,099,"Montana","Teton County",5,30,65,34,31
050,30,099,"Montana","Teton County",5,31,77,43,34
050,30,099,"Montana","Teton County",5,32,62,36,26
050,30,099,"Montana","Teton County",5,33,62,33,29
050,30,099,"Montana","Teton County",5,34,66,33,33
050,30,099,"Montana","Teton County",5,35,63,28,35
050,30,099,"Montana","Teton County",5,36,71,33,38
050,30,099,"Montana","Teton County",5,37,63,29,34
050,30,099,"Montana","Teton County",5,38,77,39,38
050,30,099,"Montana","Teton County",5,39,89,49,40
050,30,099,"Montana","Teton County",5,40,80,39,41
050,30,099,"Montana","Teton County",5,41,70,33,37
050,30,099,"Montana","Teton County",5,42,60,40,20
050,30,099,"Montana","Teton County",5,43,77,33,44
050,30,099,"Montana","Teton County",5,44,73,34,39
050,30,099,"Montana","Teton County",5,45,63,30,33
050,30,099,"Montana","Teton County",5,46,62,31,31
050,30,099,"Montana","Teton County",5,47,71,38,33
050,30,099,"Montana","Teton County",5,48,60,30,30
050,30,099,"Montana","Teton County",5,49,64,30,34
050,30,099,"Montana","Teton County",5,50,63,31,32
050,30,099,"Montana","Teton County",5,51,62,30,32
050,30,099,"Montana","Teton County",5,52,74,40,34
050,30,099,"Montana","Teton County",5,53,61,28,33
050,30,099,"Montana","Teton County",5,54,67,26,41
050,30,099,"Montana","Teton County",5,55,65,29,36
050,30,099,"Montana","Teton County",5,56,72,33,39
050,30,099,"Montana","Teton County",5,57,87,42,45
050,30,099,"Montana","Teton County",5,58,99,48,51
050,30,099,"Montana","Teton County",5,59,95,46,49
050,30,099,"Montana","Teton County",5,60,96,48,48
050,30,099,"Montana","Teton County",5,61,87,44,43
050,30,099,"Montana","Teton County",5,62,88,43,45
050,30,099,"Montana","Teton County",5,63,100,46,54
050,30,099,"Montana","Teton County",5,64,92,43,49
050,30,099,"Montana","Teton County",5,65,84,40,44
050,30,099,"Montana","Teton County",5,66,81,41,40
050,30,099,"Montana","Teton County",5,67,83,42,41
050,30,099,"Montana","Teton County",5,68,82,44,38
050,30,099,"Montana","Teton County",5,69,81,41,40
050,30,099,"Montana","Teton County",5,70,77,36,41
050,30,099,"Montana","Teton County",5,71,74,39,35
050,30,099,"Montana","Teton County",5,72,68,37,31
050,30,099,"Montana","Teton County",5,73,72,43,29
050,30,099,"Montana","Teton County",5,74,73,35,38
050,30,099,"Montana","Teton County",5,75,61,24,37
050,30,099,"Montana","Teton County",5,76,69,29,40
050,30,099,"Montana","Teton County",5,77,51,23,28
050,30,099,"Montana","Teton County",5,78,55,30,25
050,30,099,"Montana","Teton County",5,79,44,24,20
050,30,099,"Montana","Teton County",5,80,52,27,25
050,30,099,"Montana","Teton County",5,81,43,21,22
050,30,099,"Montana","Teton County",5,82,42,22,20
050,30,099,"Montana","Teton County",5,83,35,18,17
050,30,099,"Montana","Teton County",5,84,24,5,19
050,30,099,"Montana","Teton County",5,85,222,96,126
050,30,101,"Montana","Toole County",1,0,62,33,29
050,30,101,"Montana","Toole County",1,1,63,37,26
050,30,101,"Montana","Toole County",1,2,61,29,32
050,30,101,"Montana","Toole County",1,3,57,27,30
050,30,101,"Montana","Toole County",1,4,66,30,36
050,30,101,"Montana","Toole County",1,5,66,36,30
050,30,101,"Montana","Toole County",1,6,55,30,25
050,30,101,"Montana","Toole County",1,7,61,30,31
050,30,101,"Montana","Toole County",1,8,60,34,26
050,30,101,"Montana","Toole County",1,9,65,41,24
050,30,101,"Montana","Toole County",1,10,51,32,19
050,30,101,"Montana","Toole County",1,11,54,30,24
050,30,101,"Montana","Toole County",1,12,61,31,30
050,30,101,"Montana","Toole County",1,13,68,40,28
050,30,101,"Montana","Toole County",1,14,51,18,33
050,30,101,"Montana","Toole County",1,15,55,25,30
050,30,101,"Montana","Toole County",1,16,51,27,24
050,30,101,"Montana","Toole County",1,17,57,28,29
050,30,101,"Montana","Toole County",1,18,46,25,21
050,30,101,"Montana","Toole County",1,19,35,20,15
050,30,101,"Montana","Toole County",1,20,39,26,13
050,30,101,"Montana","Toole County",1,21,42,28,14
050,30,101,"Montana","Toole County",1,22,64,45,19
050,30,101,"Montana","Toole County",1,23,58,40,18
050,30,101,"Montana","Toole County",1,24,70,52,18
050,30,101,"Montana","Toole County",1,25,51,36,15
050,30,101,"Montana","Toole County",1,26,78,49,29
050,30,101,"Montana","Toole County",1,27,68,45,23
050,30,101,"Montana","Toole County",1,28,65,44,21
050,30,101,"Montana","Toole County",1,29,69,46,23
050,30,101,"Montana","Toole County",1,30,67,46,21
050,30,101,"Montana","Toole County",1,31,60,45,15
050,30,101,"Montana","Toole County",1,32,80,60,20
050,30,101,"Montana","Toole County",1,33,84,60,24
050,30,101,"Montana","Toole County",1,34,70,52,18
050,30,101,"Montana","Toole County",1,35,70,42,28
050,30,101,"Montana","Toole County",1,36,77,46,31
050,30,101,"Montana","Toole County",1,37,76,52,24
050,30,101,"Montana","Toole County",1,38,69,47,22
050,30,101,"Montana","Toole County",1,39,73,49,24
050,30,101,"Montana","Toole County",1,40,71,44,27
050,30,101,"Montana","Toole County",1,41,62,37,25
050,30,101,"Montana","Toole County",1,42,62,43,19
050,30,101,"Montana","Toole County",1,43,62,37,25
050,30,101,"Montana","Toole County",1,44,73,46,27
050,30,101,"Montana","Toole County",1,45,55,32,23
050,30,101,"Montana","Toole County",1,46,53,31,22
050,30,101,"Montana","Toole County",1,47,62,39,23
050,30,101,"Montana","Toole County",1,48,56,36,20
050,30,101,"Montana","Toole County",1,49,59,34,25
050,30,101,"Montana","Toole County",1,50,63,43,20
050,30,101,"Montana","Toole County",1,51,53,35,18
050,30,101,"Montana","Toole County",1,52,67,42,25
050,30,101,"Montana","Toole County",1,53,44,25,19
050,30,101,"Montana","Toole County",1,54,65,45,20
050,30,101,"Montana","Toole County",1,55,64,38,26
050,30,101,"Montana","Toole County",1,56,50,23,27
050,30,101,"Montana","Toole County",1,57,73,42,31
050,30,101,"Montana","Toole County",1,58,84,43,41
050,30,101,"Montana","Toole County",1,59,87,45,42
050,30,101,"Montana","Toole County",1,60,84,42,42
050,30,101,"Montana","Toole County",1,61,75,42,33
050,30,101,"Montana","Toole County",1,62,66,37,29
050,30,101,"Montana","Toole County",1,63,73,43,30
050,30,101,"Montana","Toole County",1,64,69,36,33
050,30,101,"Montana","Toole County",1,65,58,32,26
050,30,101,"Montana","Toole County",1,66,64,40,24
050,30,101,"Montana","Toole County",1,67,66,36,30
050,30,101,"Montana","Toole County",1,68,67,31,36
050,30,101,"Montana","Toole County",1,69,58,32,26
050,30,101,"Montana","Toole County",1,70,46,25,21
050,30,101,"Montana","Toole County",1,71,43,19,24
050,30,101,"Montana","Toole County",1,72,48,26,22
050,30,101,"Montana","Toole County",1,73,47,31,16
050,30,101,"Montana","Toole County",1,74,33,21,12
050,30,101,"Montana","Toole County",1,75,19,12,7
050,30,101,"Montana","Toole County",1,76,29,15,14
050,30,101,"Montana","Toole County",1,77,27,13,14
050,30,101,"Montana","Toole County",1,78,20,11,9
050,30,101,"Montana","Toole County",1,79,23,10,13
050,30,101,"Montana","Toole County",1,80,18,7,11
050,30,101,"Montana","Toole County",1,81,18,6,12
050,30,101,"Montana","Toole County",1,82,15,4,11
050,30,101,"Montana","Toole County",1,83,16,7,9
050,30,101,"Montana","Toole County",1,84,19,12,7
050,30,101,"Montana","Toole County",1,85,134,50,84
050,30,101,"Montana","Toole County",2,0,64,33,31
050,30,101,"Montana","Toole County",2,1,61,36,25
050,30,101,"Montana","Toole County",2,2,61,30,31
050,30,101,"Montana","Toole County",2,3,59,28,31
050,30,101,"Montana","Toole County",2,4,66,29,37
050,30,101,"Montana","Toole County",2,5,66,35,31
050,30,101,"Montana","Toole County",2,6,61,32,29
050,30,101,"Montana","Toole County",2,7,59,31,28
050,30,101,"Montana","Toole County",2,8,60,32,28
050,30,101,"Montana","Toole County",2,9,64,39,25
050,30,101,"Montana","Toole County",2,10,53,33,20
050,30,101,"Montana","Toole County",2,11,52,29,23
050,30,101,"Montana","Toole County",2,12,60,31,29
050,30,101,"Montana","Toole County",2,13,67,38,29
050,30,101,"Montana","Toole County",2,14,53,21,32
050,30,101,"Montana","Toole County",2,15,55,24,31
050,30,101,"Montana","Toole County",2,16,51,26,25
050,30,101,"Montana","Toole County",2,17,56,27,29
050,30,101,"Montana","Toole County",2,18,46,24,22
050,30,101,"Montana","Toole County",2,19,36,21,15
050,30,101,"Montana","Toole County",2,20,39,26,13
050,30,101,"Montana","Toole County",2,21,42,28,14
050,30,101,"Montana","Toole County",2,22,62,44,18
050,30,101,"Montana","Toole County",2,23,57,39,18
050,30,101,"Montana","Toole County",2,24,70,52,18
050,30,101,"Montana","Toole County",2,25,54,38,16
050,30,101,"Montana","Toole County",2,26,76,48,28
050,30,101,"Montana","Toole County",2,27,68,45,23
050,30,101,"Montana","Toole County",2,28,67,44,23
050,30,101,"Montana","Toole County",2,29,67,45,22
050,30,101,"Montana","Toole County",2,30,67,46,21
050,30,101,"Montana","Toole County",2,31,62,45,17
050,30,101,"Montana","Toole County",2,32,79,60,19
050,30,101,"Montana","Toole County",2,33,85,60,25
050,30,101,"Montana","Toole County",2,34,73,54,19
050,30,101,"Montana","Toole County",2,35,70,43,27
050,30,101,"Montana","Toole County",2,36,76,46,30
050,30,101,"Montana","Toole County",2,37,77,52,25
050,30,101,"Montana","Toole County",2,38,70,48,22
050,30,101,"Montana","Toole County",2,39,70,46,24
050,30,101,"Montana","Toole County",2,40,71,45,26
050,30,101,"Montana","Toole County",2,41,62,38,24
050,30,101,"Montana","Toole County",2,42,62,43,19
050,30,101,"Montana","Toole County",2,43,62,38,24
050,30,101,"Montana","Toole County",2,44,72,46,26
050,30,101,"Montana","Toole County",2,45,56,32,24
050,30,101,"Montana","Toole County",2,46,53,32,21
050,30,101,"Montana","Toole County",2,47,63,40,23
050,30,101,"Montana","Toole County",2,48,54,34,20
050,30,101,"Montana","Toole County",2,49,57,32,25
050,30,101,"Montana","Toole County",2,50,63,43,20
050,30,101,"Montana","Toole County",2,51,55,37,18
050,30,101,"Montana","Toole County",2,52,63,40,23
050,30,101,"Montana","Toole County",2,53,46,26,20
050,30,101,"Montana","Toole County",2,54,62,43,19
050,30,101,"Montana","Toole County",2,55,64,39,25
050,30,101,"Montana","Toole County",2,56,54,26,28
050,30,101,"Montana","Toole County",2,57,68,38,30
050,30,101,"Montana","Toole County",2,58,79,41,38
050,30,101,"Montana","Toole County",2,59,85,44,41
050,30,101,"Montana","Toole County",2,60,85,42,43
050,30,101,"Montana","Toole County",2,61,76,40,36
050,30,101,"Montana","Toole County",2,62,65,36,29
050,30,101,"Montana","Toole County",2,63,72,42,30
050,30,101,"Montana","Toole County",2,64,68,37,31
050,30,101,"Montana","Toole County",2,65,59,33,26
050,30,101,"Montana","Toole County",2,66,63,39,24
050,30,101,"Montana","Toole County",2,67,67,38,29
050,30,101,"Montana","Toole County",2,68,65,31,34
050,30,101,"Montana","Toole County",2,69,60,32,28
050,30,101,"Montana","Toole County",2,70,47,25,22
050,30,101,"Montana","Toole County",2,71,44,20,24
050,30,101,"Montana","Toole County",2,72,45,24,21
050,30,101,"Montana","Toole County",2,73,49,30,19
050,30,101,"Montana","Toole County",2,74,33,21,12
050,30,101,"Montana","Toole County",2,75,21,13,8
050,30,101,"Montana","Toole County",2,76,26,14,12
050,30,101,"Montana","Toole County",2,77,29,14,15
050,30,101,"Montana","Toole County",2,78,19,11,8
050,30,101,"Montana","Toole County",2,79,22,10,12
050,30,101,"Montana","Toole County",2,80,20,8,12
050,30,101,"Montana","Toole County",2,81,19,6,13
050,30,101,"Montana","Toole County",2,82,15,5,10
050,30,101,"Montana","Toole County",2,83,16,7,9
050,30,101,"Montana","Toole County",2,84,18,11,7
050,30,101,"Montana","Toole County",2,85,137,52,85
050,30,101,"Montana","Toole County",3,0,43,21,22
050,30,101,"Montana","Toole County",3,1,61,33,28
050,30,101,"Montana","Toole County",3,2,56,28,28
050,30,101,"Montana","Toole County",3,3,64,26,38
050,30,101,"Montana","Toole County",3,4,60,31,29
050,30,101,"Montana","Toole County",3,5,65,31,34
050,30,101,"Montana","Toole County",3,6,70,40,30
050,30,101,"Montana","Toole County",3,7,56,33,23
050,30,101,"Montana","Toole County",3,8,65,34,31
050,30,101,"Montana","Toole County",3,9,61,35,26
050,30,101,"Montana","Toole County",3,10,64,37,27
050,30,101,"Montana","Toole County",3,11,54,30,24
050,30,101,"Montana","Toole County",3,12,57,29,28
050,30,101,"Montana","Toole County",3,13,68,38,30
050,30,101,"Montana","Toole County",3,14,58,29,29
050,30,101,"Montana","Toole County",3,15,57,22,35
050,30,101,"Montana","Toole County",3,16,47,19,28
050,30,101,"Montana","Toole County",3,17,48,27,21
050,30,101,"Montana","Toole County",3,18,50,25,25
050,30,101,"Montana","Toole County",3,19,41,23,18
050,30,101,"Montana","Toole County",3,20,44,32,12
050,30,101,"Montana","Toole County",3,21,43,32,11
050,30,101,"Montana","Toole County",3,22,57,38,19
050,30,101,"Montana","Toole County",3,23,54,41,13
050,30,101,"Montana","Toole County",3,24,80,58,22
050,30,101,"Montana","Toole County",3,25,57,38,19
050,30,101,"Montana","Toole County",3,26,68,45,23
050,30,101,"Montana","Toole County",3,27,66,44,22
050,30,101,"Montana","Toole County",3,28,77,48,29
050,30,101,"Montana","Toole County",3,29,72,49,23
050,30,101,"Montana","Toole County",3,30,81,56,25
050,30,101,"Montana","Toole County",3,31,62,43,19
050,30,101,"Montana","Toole County",3,32,69,49,20
050,30,101,"Montana","Toole County",3,33,89,60,29
050,30,101,"Montana","Toole County",3,34,86,64,22
050,30,101,"Montana","Toole County",3,35,67,46,21
050,30,101,"Montana","Toole County",3,36,72,45,27
050,30,101,"Montana","Toole County",3,37,79,48,31
050,30,101,"Montana","Toole County",3,38,76,57,19
050,30,101,"Montana","Toole County",3,39,69,42,27
050,30,101,"Montana","Toole County",3,40,70,43,27
050,30,101,"Montana","Toole County",3,41,62,39,23
050,30,101,"Montana","Toole County",3,42,70,49,21
050,30,101,"Montana","Toole County",3,43,59,40,19
050,30,101,"Montana","Toole County",3,44,84,53,31
050,30,101,"Montana","Toole County",3,45,53,32,21
050,30,101,"Montana","Toole County",3,46,63,39,24
050,30,101,"Montana","Toole County",3,47,62,39,23
050,30,101,"Montana","Toole County",3,48,50,31,19
050,30,101,"Montana","Toole County",3,49,46,25,21
050,30,101,"Montana","Toole County",3,50,71,45,26
050,30,101,"Montana","Toole County",3,51,62,41,21
050,30,101,"Montana","Toole County",3,52,65,43,22
050,30,101,"Montana","Toole County",3,53,44,24,20
050,30,101,"Montana","Toole County",3,54,59,39,20
050,30,101,"Montana","Toole County",3,55,58,38,20
050,30,101,"Montana","Toole County",3,56,56,33,23
050,30,101,"Montana","Toole County",3,57,60,30,30
050,30,101,"Montana","Toole County",3,58,63,34,29
050,30,101,"Montana","Toole County",3,59,70,40,30
050,30,101,"Montana","Toole County",3,60,79,42,37
050,30,101,"Montana","Toole County",3,61,80,40,40
050,30,101,"Montana","Toole County",3,62,69,36,33
050,30,101,"Montana","Toole County",3,63,65,38,27
050,30,101,"Montana","Toole County",3,64,70,38,32
050,30,101,"Montana","Toole County",3,65,63,35,28
050,30,101,"Montana","Toole County",3,66,58,33,25
050,30,101,"Montana","Toole County",3,67,61,38,23
050,30,101,"Montana","Toole County",3,68,64,35,29
050,30,101,"Montana","Toole County",3,69,64,30,34
050,30,101,"Montana","Toole County",3,70,56,29,27
050,30,101,"Montana","Toole County",3,71,47,25,22
050,30,101,"Montana","Toole County",3,72,40,19,21
050,30,101,"Montana","Toole County",3,73,45,24,21
050,30,101,"Montana","Toole County",3,74,53,34,19
050,30,101,"Montana","Toole County",3,75,28,17,11
050,30,101,"Montana","Toole County",3,76,21,14,7
050,30,101,"Montana","Toole County",3,77,27,14,13
050,30,101,"Montana","Toole County",3,78,26,13,13
050,30,101,"Montana","Toole County",3,79,15,8,7
050,30,101,"Montana","Toole County",3,80,19,10,9
050,30,101,"Montana","Toole County",3,81,24,8,16
050,30,101,"Montana","Toole County",3,82,10,4,6
050,30,101,"Montana","Toole County",3,83,12,5,7
050,30,101,"Montana","Toole County",3,84,13,6,7
050,30,101,"Montana","Toole County",3,85,143,56,87
050,30,101,"Montana","Toole County",4,0,56,29,27
050,30,101,"Montana","Toole County",4,1,42,19,23
050,30,101,"Montana","Toole County",4,2,52,24,28
050,30,101,"Montana","Toole County",4,3,63,28,35
050,30,101,"Montana","Toole County",4,4,63,26,37
050,30,101,"Montana","Toole County",4,5,53,33,20
050,30,101,"Montana","Toole County",4,6,67,33,34
050,30,101,"Montana","Toole County",4,7,76,42,34
050,30,101,"Montana","Toole County",4,8,57,34,23
050,30,101,"Montana","Toole County",4,9,70,40,30
050,30,101,"Montana","Toole County",4,10,62,35,27
050,30,101,"Montana","Toole County",4,11,72,40,32
050,30,101,"Montana","Toole County",4,12,53,30,23
050,30,101,"Montana","Toole County",4,13,65,37,28
050,30,101,"Montana","Toole County",4,14,63,31,32
050,30,101,"Montana","Toole County",4,15,60,31,29
050,30,101,"Montana","Toole County",4,16,53,21,32
050,30,101,"Montana","Toole County",4,17,54,24,30
050,30,101,"Montana","Toole County",4,18,44,24,20
050,30,101,"Montana","Toole County",4,19,46,23,23
050,30,101,"Montana","Toole County",4,20,74,56,18
050,30,101,"Montana","Toole County",4,21,55,40,15
050,30,101,"Montana","Toole County",4,22,52,42,10
050,30,101,"Montana","Toole County",4,23,52,35,17
050,30,101,"Montana","Toole County",4,24,79,60,19
050,30,101,"Montana","Toole County",4,25,68,48,20
050,30,101,"Montana","Toole County",4,26,74,47,27
050,30,101,"Montana","Toole County",4,27,68,46,22
050,30,101,"Montana","Toole County",4,28,76,48,28
050,30,101,"Montana","Toole County",4,29,83,52,31
050,30,101,"Montana","Toole County",4,30,75,51,24
050,30,101,"Montana","Toole County",4,31,77,54,23
050,30,101,"Montana","Toole County",4,32,76,54,22
050,30,101,"Montana","Toole County",4,33,79,53,26
050,30,101,"Montana","Toole County",4,34,80,57,23
050,30,101,"Montana","Toole County",4,35,75,55,20
050,30,101,"Montana","Toole County",4,36,70,50,20
050,30,101,"Montana","Toole County",4,37,75,47,28
050,30,101,"Montana","Toole County",4,38,89,57,32
050,30,101,"Montana","Toole County",4,39,67,45,22
050,30,101,"Montana","Toole County",4,40,68,39,29
050,30,101,"Montana","Toole County",4,41,64,39,25
050,30,101,"Montana","Toole County",4,42,73,49,24
050,30,101,"Montana","Toole County",4,43,66,47,19
050,30,101,"Montana","Toole County",4,44,76,50,26
050,30,101,"Montana","Toole County",4,45,69,45,24
050,30,101,"Montana","Toole County",4,46,62,39,23
050,30,101,"Montana","Toole County",4,47,75,49,26
050,30,101,"Montana","Toole County",4,48,58,37,21
050,30,101,"Montana","Toole County",4,49,46,26,20
050,30,101,"Montana","Toole County",4,50,59,36,23
050,30,101,"Montana","Toole County",4,51,69,44,25
050,30,101,"Montana","Toole County",4,52,69,44,25
050,30,101,"Montana","Toole County",4,53,43,24,19
050,30,101,"Montana","Toole County",4,54,55,34,21
050,30,101,"Montana","Toole County",4,55,56,35,21
050,30,101,"Montana","Toole County",4,56,56,35,21
050,30,101,"Montana","Toole County",4,57,67,40,27
050,30,101,"Montana","Toole County",4,58,55,26,29
050,30,101,"Montana","Toole County",4,59,60,34,26
050,30,101,"Montana","Toole County",4,60,66,38,28
050,30,101,"Montana","Toole County",4,61,77,41,36
050,30,101,"Montana","Toole County",4,62,72,34,38
050,30,101,"Montana","Toole County",4,63,68,36,32
050,30,101,"Montana","Toole County",4,64,59,34,25
050,30,101,"Montana","Toole County",4,65,64,33,31
050,30,101,"Montana","Toole County",4,66,61,36,25
050,30,101,"Montana","Toole County",4,67,59,32,27
050,30,101,"Montana","Toole County",4,68,57,36,21
050,30,101,"Montana","Toole County",4,69,59,32,27
050,30,101,"Montana","Toole County",4,70,56,25,31
050,30,101,"Montana","Toole County",4,71,55,28,27
050,30,101,"Montana","Toole County",4,72,40,22,18
050,30,101,"Montana","Toole County",4,73,38,16,22
050,30,101,"Montana","Toole County",4,74,43,25,18
050,30,101,"Montana","Toole County",4,75,49,27,22
050,30,101,"Montana","Toole County",4,76,23,14,9
050,30,101,"Montana","Toole County",4,77,20,13,7
050,30,101,"Montana","Toole County",4,78,24,13,11
050,30,101,"Montana","Toole County",4,79,21,10,11
050,30,101,"Montana","Toole County",4,80,11,7,4
050,30,101,"Montana","Toole County",4,81,22,9,13
050,30,101,"Montana","Toole County",4,82,17,6,11
050,30,101,"Montana","Toole County",4,83,6,5,1
050,30,101,"Montana","Toole County",4,84,13,5,8
050,30,101,"Montana","Toole County",4,85,136,51,85
050,30,101,"Montana","Toole County",5,0,56,29,27
050,30,101,"Montana","Toole County",5,1,57,30,27
050,30,101,"Montana","Toole County",5,2,39,16,23
050,30,101,"Montana","Toole County",5,3,52,20,32
050,30,101,"Montana","Toole County",5,4,62,26,36
050,30,101,"Montana","Toole County",5,5,60,26,34
050,30,101,"Montana","Toole County",5,6,64,39,25
050,30,101,"Montana","Toole County",5,7,71,42,29
050,30,101,"Montana","Toole County",5,8,72,34,38
050,30,101,"Montana","Toole County",5,9,56,35,21
050,30,101,"Montana","Toole County",5,10,71,39,32
050,30,101,"Montana","Toole County",5,11,68,35,33
050,30,101,"Montana","Toole County",5,12,80,42,38
050,30,101,"Montana","Toole County",5,13,60,37,23
050,30,101,"Montana","Toole County",5,14,60,30,30
050,30,101,"Montana","Toole County",5,15,65,30,35
050,30,101,"Montana","Toole County",5,16,50,22,28
050,30,101,"Montana","Toole County",5,17,54,22,32
050,30,101,"Montana","Toole County",5,18,47,23,24
050,30,101,"Montana","Toole County",5,19,39,24,15
050,30,101,"Montana","Toole County",5,20,58,39,19
050,30,101,"Montana","Toole County",5,21,70,53,17
050,30,101,"Montana","Toole County",5,22,59,46,13
050,30,101,"Montana","Toole County",5,23,52,40,12
050,30,101,"Montana","Toole County",5,24,69,51,18
050,30,101,"Montana","Toole County",5,25,57,41,16
050,30,101,"Montana","Toole County",5,26,87,57,30
050,30,101,"Montana","Toole County",5,27,66,45,21
050,30,101,"Montana","Toole County",5,28,73,46,27
050,30,101,"Montana","Toole County",5,29,77,50,27
050,30,101,"Montana","Toole County",5,30,90,56,34
050,30,101,"Montana","Toole County",5,31,75,51,24
050,30,101,"Montana","Toole County",5,32,86,62,24
050,30,101,"Montana","Toole County",5,33,73,48,25
050,30,101,"Montana","Toole County",5,34,74,56,18
050,30,101,"Montana","Toole County",5,35,74,50,24
050,30,101,"Montana","Toole County",5,36,78,57,21
050,30,101,"Montana","Toole County",5,37,77,57,20
050,30,101,"Montana","Toole County",5,38,83,54,29
050,30,101,"Montana","Toole County",5,39,89,52,37
050,30,101,"Montana","Toole County",5,40,69,42,27
050,30,101,"Montana","Toole County",5,41,62,31,31
050,30,101,"Montana","Toole County",5,42,73,50,23
050,30,101,"Montana","Toole County",5,43,69,44,25
050,30,101,"Montana","Toole County",5,44,85,61,24
050,30,101,"Montana","Toole County",5,45,61,37,24
050,30,101,"Montana","Toole County",5,46,73,49,24
050,30,101,"Montana","Toole County",5,47,70,49,21
050,30,101,"Montana","Toole County",5,48,67,42,25
050,30,101,"Montana","Toole County",5,49,48,29,19
050,30,101,"Montana","Toole County",5,50,54,35,19
050,30,101,"Montana","Toole County",5,51,63,35,28
050,30,101,"Montana","Toole County",5,52,78,48,30
050,30,101,"Montana","Toole County",5,53,49,27,22
050,30,101,"Montana","Toole County",5,54,61,39,22
050,30,101,"Montana","Toole County",5,55,48,31,17
050,30,101,"Montana","Toole County",5,56,52,29,23
050,30,101,"Montana","Toole County",5,57,63,40,23
050,30,101,"Montana","Toole County",5,58,61,35,26
050,30,101,"Montana","Toole County",5,59,57,27,30
050,30,101,"Montana","Toole County",5,60,58,33,25
050,30,101,"Montana","Toole County",5,61,61,35,26
050,30,101,"Montana","Toole County",5,62,73,40,33
050,30,101,"Montana","Toole County",5,63,71,35,36
050,30,101,"Montana","Toole County",5,64,68,35,33
050,30,101,"Montana","Toole County",5,65,56,32,24
050,30,101,"Montana","Toole County",5,66,66,35,31
050,30,101,"Montana","Toole County",5,67,62,36,26
050,30,101,"Montana","Toole County",5,68,59,30,29
050,30,101,"Montana","Toole County",5,69,54,35,19
050,30,101,"Montana","Toole County",5,70,57,31,26
050,30,101,"Montana","Toole County",5,71,56,24,32
050,30,101,"Montana","Toole County",5,72,48,25,23
050,30,101,"Montana","Toole County",5,73,40,22,18
050,30,101,"Montana","Toole County",5,74,42,20,22
050,30,101,"Montana","Toole County",5,75,39,22,17
050,30,101,"Montana","Toole County",5,76,46,26,20
050,30,101,"Montana","Toole County",5,77,24,14,10
050,30,101,"Montana","Toole County",5,78,17,12,5
050,30,101,"Montana","Toole County",5,79,19,10,9
050,30,101,"Montana","Toole County",5,80,18,9,9
050,30,101,"Montana","Toole County",5,81,15,7,8
050,30,101,"Montana","Toole County",5,82,15,7,8
050,30,101,"Montana","Toole County",5,83,15,6,9
050,30,101,"Montana","Toole County",5,84,6,4,2
050,30,101,"Montana","Toole County",5,85,135,48,87
050,30,103,"Montana","Treasure County",1,0,19,10,9
050,30,103,"Montana","Treasure County",1,1,14,9,5
050,30,103,"Montana","Treasure County",1,2,12,7,5
050,30,103,"Montana","Treasure County",1,3,17,8,9
050,30,103,"Montana","Treasure County",1,4,16,9,7
050,30,103,"Montana","Treasure County",1,5,13,6,7
050,30,103,"Montana","Treasure County",1,6,9,7,2
050,30,103,"Montana","Treasure County",1,7,7,4,3
050,30,103,"Montana","Treasure County",1,8,6,4,2
050,30,103,"Montana","Treasure County",1,9,12,6,6
050,30,103,"Montana","Treasure County",1,10,10,2,8
050,30,103,"Montana","Treasure County",1,11,9,4,5
050,30,103,"Montana","Treasure County",1,12,4,2,2
050,30,103,"Montana","Treasure County",1,13,8,2,6
050,30,103,"Montana","Treasure County",1,14,7,2,5
050,30,103,"Montana","Treasure County",1,15,3,2,1
050,30,103,"Montana","Treasure County",1,16,6,5,1
050,30,103,"Montana","Treasure County",1,17,7,2,5
050,30,103,"Montana","Treasure County",1,18,6,3,3
050,30,103,"Montana","Treasure County",1,19,6,1,5
050,30,103,"Montana","Treasure County",1,20,1,0,1
050,30,103,"Montana","Treasure County",1,21,7,4,3
050,30,103,"Montana","Treasure County",1,22,6,2,4
050,30,103,"Montana","Treasure County",1,23,8,5,3
050,30,103,"Montana","Treasure County",1,24,6,4,2
050,30,103,"Montana","Treasure County",1,25,5,2,3
050,30,103,"Montana","Treasure County",1,26,10,3,7
050,30,103,"Montana","Treasure County",1,27,8,4,4
050,30,103,"Montana","Treasure County",1,28,6,5,1
050,30,103,"Montana","Treasure County",1,29,5,3,2
050,30,103,"Montana","Treasure County",1,30,6,3,3
050,30,103,"Montana","Treasure County",1,31,6,4,2
050,30,103,"Montana","Treasure County",1,32,14,7,7
050,30,103,"Montana","Treasure County",1,33,9,3,6
050,30,103,"Montana","Treasure County",1,34,6,3,3
050,30,103,"Montana","Treasure County",1,35,4,2,2
050,30,103,"Montana","Treasure County",1,36,7,3,4
050,30,103,"Montana","Treasure County",1,37,9,6,3
050,30,103,"Montana","Treasure County",1,38,13,6,7
050,30,103,"Montana","Treasure County",1,39,9,6,3
050,30,103,"Montana","Treasure County",1,40,5,3,2
050,30,103,"Montana","Treasure County",1,41,4,1,3
050,30,103,"Montana","Treasure County",1,42,10,3,7
050,30,103,"Montana","Treasure County",1,43,6,4,2
050,30,103,"Montana","Treasure County",1,44,2,0,2
050,30,103,"Montana","Treasure County",1,45,4,1,3
050,30,103,"Montana","Treasure County",1,46,2,1,1
050,30,103,"Montana","Treasure County",1,47,3,2,1
050,30,103,"Montana","Treasure County",1,48,4,2,2
050,30,103,"Montana","Treasure County",1,49,3,1,2
050,30,103,"Montana","Treasure County",1,50,5,3,2
050,30,103,"Montana","Treasure County",1,51,6,1,5
050,30,103,"Montana","Treasure County",1,52,5,3,2
050,30,103,"Montana","Treasure County",1,53,6,5,1
050,30,103,"Montana","Treasure County",1,54,11,8,3
050,30,103,"Montana","Treasure County",1,55,13,5,8
050,30,103,"Montana","Treasure County",1,56,8,5,3
050,30,103,"Montana","Treasure County",1,57,7,4,3
050,30,103,"Montana","Treasure County",1,58,10,7,3
050,30,103,"Montana","Treasure County",1,59,17,11,6
050,30,103,"Montana","Treasure County",1,60,11,6,5
050,30,103,"Montana","Treasure County",1,61,15,8,7
050,30,103,"Montana","Treasure County",1,62,16,8,8
050,30,103,"Montana","Treasure County",1,63,16,7,9
050,30,103,"Montana","Treasure County",1,64,15,7,8
050,30,103,"Montana","Treasure County",1,65,14,7,7
050,30,103,"Montana","Treasure County",1,66,16,8,8
050,30,103,"Montana","Treasure County",1,67,16,9,7
050,30,103,"Montana","Treasure County",1,68,13,7,6
050,30,103,"Montana","Treasure County",1,69,13,7,6
050,30,103,"Montana","Treasure County",1,70,7,3,4
050,30,103,"Montana","Treasure County",1,71,7,3,4
050,30,103,"Montana","Treasure County",1,72,14,7,7
050,30,103,"Montana","Treasure County",1,73,13,7,6
050,30,103,"Montana","Treasure County",1,74,12,8,4
050,30,103,"Montana","Treasure County",1,75,10,5,5
050,30,103,"Montana","Treasure County",1,76,8,5,3
050,30,103,"Montana","Treasure County",1,77,7,3,4
050,30,103,"Montana","Treasure County",1,78,6,2,4
050,30,103,"Montana","Treasure County",1,79,5,2,3
050,30,103,"Montana","Treasure County",1,80,5,3,2
050,30,103,"Montana","Treasure County",1,81,3,3,0
050,30,103,"Montana","Treasure County",1,82,2,1,1
050,30,103,"Montana","Treasure County",1,83,5,1,4
050,30,103,"Montana","Treasure County",1,84,11,4,7
050,30,103,"Montana","Treasure County",1,85,33,13,20
050,30,103,"Montana","Treasure County",2,0,19,7,12
050,30,103,"Montana","Treasure County",2,1,15,9,6
050,30,103,"Montana","Treasure County",2,2,12,7,5
050,30,103,"Montana","Treasure County",2,3,16,8,8
050,30,103,"Montana","Treasure County",2,4,17,9,8
050,30,103,"Montana","Treasure County",2,5,13,6,7
050,30,103,"Montana","Treasure County",2,6,10,7,3
050,30,103,"Montana","Treasure County",2,7,8,5,3
050,30,103,"Montana","Treasure County",2,8,6,4,2
050,30,103,"Montana","Treasure County",2,9,10,5,5
050,30,103,"Montana","Treasure County",2,10,11,3,8
050,30,103,"Montana","Treasure County",2,11,8,3,5
050,30,103,"Montana","Treasure County",2,12,5,2,3
050,30,103,"Montana","Treasure County",2,13,7,2,5
050,30,103,"Montana","Treasure County",2,14,7,2,5
050,30,103,"Montana","Treasure County",2,15,4,2,2
050,30,103,"Montana","Treasure County",2,16,5,4,1
050,30,103,"Montana","Treasure County",2,17,7,3,4
050,30,103,"Montana","Treasure County",2,18,6,2,4
050,30,103,"Montana","Treasure County",2,19,6,1,5
050,30,103,"Montana","Treasure County",2,20,3,1,2
050,30,103,"Montana","Treasure County",2,21,7,4,3
050,30,103,"Montana","Treasure County",2,22,7,3,4
050,30,103,"Montana","Treasure County",2,23,8,5,3
050,30,103,"Montana","Treasure County",2,24,6,4,2
050,30,103,"Montana","Treasure County",2,25,5,2,3
050,30,103,"Montana","Treasure County",2,26,9,3,6
050,30,103,"Montana","Treasure County",2,27,8,4,4
050,30,103,"Montana","Treasure County",2,28,7,5,2
050,30,103,"Montana","Treasure County",2,29,6,4,2
050,30,103,"Montana","Treasure County",2,30,6,3,3
050,30,103,"Montana","Treasure County",2,31,6,4,2
050,30,103,"Montana","Treasure County",2,32,12,7,5
050,30,103,"Montana","Treasure County",2,33,10,4,6
050,30,103,"Montana","Treasure County",2,34,7,3,4
050,30,103,"Montana","Treasure County",2,35,5,3,2
050,30,103,"Montana","Treasure County",2,36,6,2,4
050,30,103,"Montana","Treasure County",2,37,8,5,3
050,30,103,"Montana","Treasure County",2,38,11,6,5
050,30,103,"Montana","Treasure County",2,39,10,6,4
050,30,103,"Montana","Treasure County",2,40,6,4,2
050,30,103,"Montana","Treasure County",2,41,3,1,2
050,30,103,"Montana","Treasure County",2,42,8,2,6
050,30,103,"Montana","Treasure County",2,43,7,4,3
050,30,103,"Montana","Treasure County",2,44,3,1,2
050,30,103,"Montana","Treasure County",2,45,4,1,3
050,30,103,"Montana","Treasure County",2,46,2,1,1
050,30,103,"Montana","Treasure County",2,47,3,2,1
050,30,103,"Montana","Treasure County",2,48,4,2,2
050,30,103,"Montana","Treasure County",2,49,4,2,2
050,30,103,"Montana","Treasure County",2,50,5,3,2
050,30,103,"Montana","Treasure County",2,51,6,1,5
050,30,103,"Montana","Treasure County",2,52,4,2,2
050,30,103,"Montana","Treasure County",2,53,6,5,1
050,30,103,"Montana","Treasure County",2,54,10,8,2
050,30,103,"Montana","Treasure County",2,55,11,5,6
050,30,103,"Montana","Treasure County",2,56,9,5,4
050,30,103,"Montana","Treasure County",2,57,7,4,3
050,30,103,"Montana","Treasure County",2,58,9,6,3
050,30,103,"Montana","Treasure County",2,59,16,11,5
050,30,103,"Montana","Treasure County",2,60,12,7,5
050,30,103,"Montana","Treasure County",2,61,14,8,6
050,30,103,"Montana","Treasure County",2,62,15,7,8
050,30,103,"Montana","Treasure County",2,63,16,7,9
050,30,103,"Montana","Treasure County",2,64,15,7,8
050,30,103,"Montana","Treasure County",2,65,14,7,7
050,30,103,"Montana","Treasure County",2,66,15,8,7
050,30,103,"Montana","Treasure County",2,67,16,9,7
050,30,103,"Montana","Treasure County",2,68,14,8,6
050,30,103,"Montana","Treasure County",2,69,13,7,6
050,30,103,"Montana","Treasure County",2,70,8,4,4
050,30,103,"Montana","Treasure County",2,71,7,3,4
050,30,103,"Montana","Treasure County",2,72,12,6,6
050,30,103,"Montana","Treasure County",2,73,14,7,7
050,30,103,"Montana","Treasure County",2,74,11,7,4
050,30,103,"Montana","Treasure County",2,75,10,6,4
050,30,103,"Montana","Treasure County",2,76,8,5,3
050,30,103,"Montana","Treasure County",2,77,8,4,4
050,30,103,"Montana","Treasure County",2,78,6,2,4
050,30,103,"Montana","Treasure County",2,79,5,2,3
050,30,103,"Montana","Treasure County",2,80,5,3,2
050,30,103,"Montana","Treasure County",2,81,3,3,0
050,30,103,"Montana","Treasure County",2,82,3,2,1
050,30,103,"Montana","Treasure County",2,83,4,1,3
050,30,103,"Montana","Treasure County",2,84,10,4,6
050,30,103,"Montana","Treasure County",2,85,35,14,21
050,30,103,"Montana","Treasure County",3,0,9,5,4
050,30,103,"Montana","Treasure County",3,1,18,7,11
050,30,103,"Montana","Treasure County",3,2,14,9,5
050,30,103,"Montana","Treasure County",3,3,12,7,5
050,30,103,"Montana","Treasure County",3,4,15,8,7
050,30,103,"Montana","Treasure County",3,5,16,7,9
050,30,103,"Montana","Treasure County",3,6,13,6,7
050,30,103,"Montana","Treasure County",3,7,11,7,4
050,30,103,"Montana","Treasure County",3,8,7,6,1
050,30,103,"Montana","Treasure County",3,9,6,4,2
050,30,103,"Montana","Treasure County",3,10,10,4,6
050,30,103,"Montana","Treasure County",3,11,11,3,8
050,30,103,"Montana","Treasure County",3,12,8,3,5
050,30,103,"Montana","Treasure County",3,13,3,1,2
050,30,103,"Montana","Treasure County",3,14,7,1,6
050,30,103,"Montana","Treasure County",3,15,5,1,4
050,30,103,"Montana","Treasure County",3,16,4,2,2
050,30,103,"Montana","Treasure County",3,17,6,4,2
050,30,103,"Montana","Treasure County",3,18,5,3,2
050,30,103,"Montana","Treasure County",3,19,6,2,4
050,30,103,"Montana","Treasure County",3,20,9,3,6
050,30,103,"Montana","Treasure County",3,21,7,3,4
050,30,103,"Montana","Treasure County",3,22,5,3,2
050,30,103,"Montana","Treasure County",3,23,7,3,4
050,30,103,"Montana","Treasure County",3,24,9,5,4
050,30,103,"Montana","Treasure County",3,25,8,5,3
050,30,103,"Montana","Treasure County",3,26,5,2,3
050,30,103,"Montana","Treasure County",3,27,10,4,6
050,30,103,"Montana","Treasure County",3,28,8,3,5
050,30,103,"Montana","Treasure County",3,29,7,5,2
050,30,103,"Montana","Treasure County",3,30,4,3,1
050,30,103,"Montana","Treasure County",3,31,6,2,4
050,30,103,"Montana","Treasure County",3,32,8,5,3
050,30,103,"Montana","Treasure County",3,33,13,7,6
050,30,103,"Montana","Treasure County",3,34,9,4,5
050,30,103,"Montana","Treasure County",3,35,8,4,4
050,30,103,"Montana","Treasure County",3,36,5,3,2
050,30,103,"Montana","Treasure County",3,37,6,2,4
050,30,103,"Montana","Treasure County",3,38,11,6,5
050,30,103,"Montana","Treasure County",3,39,10,6,4
050,30,103,"Montana","Treasure County",3,40,11,6,5
050,30,103,"Montana","Treasure County",3,41,5,3,2
050,30,103,"Montana","Treasure County",3,42,4,1,3
050,30,103,"Montana","Treasure County",3,43,8,2,6
050,30,103,"Montana","Treasure County",3,44,4,3,1
050,30,103,"Montana","Treasure County",3,45,3,1,2
050,30,103,"Montana","Treasure County",3,46,7,4,3
050,30,103,"Montana","Treasure County",3,47,2,1,1
050,30,103,"Montana","Treasure County",3,48,2,1,1
050,30,103,"Montana","Treasure County",3,49,3,2,1
050,30,103,"Montana","Treasure County",3,50,4,2,2
050,30,103,"Montana","Treasure County",3,51,4,2,2
050,30,103,"Montana","Treasure County",3,52,6,1,5
050,30,103,"Montana","Treasure County",3,53,4,2,2
050,30,103,"Montana","Treasure County",3,54,6,5,1
050,30,103,"Montana","Treasure County",3,55,10,8,2
050,30,103,"Montana","Treasure County",3,56,11,5,6
050,30,103,"Montana","Treasure County",3,57,9,5,4
050,30,103,"Montana","Treasure County",3,58,7,4,3
050,30,103,"Montana","Treasure County",3,59,11,5,6
050,30,103,"Montana","Treasure County",3,60,18,12,6
050,30,103,"Montana","Treasure County",3,61,12,7,5
050,30,103,"Montana","Treasure County",3,62,15,7,8
050,30,103,"Montana","Treasure County",3,63,13,5,8
050,30,103,"Montana","Treasure County",3,64,16,7,9
050,30,103,"Montana","Treasure County",3,65,16,8,8
050,30,103,"Montana","Treasure County",3,66,14,7,7
050,30,103,"Montana","Treasure County",3,67,17,10,7
050,30,103,"Montana","Treasure County",3,68,17,9,8
050,30,103,"Montana","Treasure County",3,69,14,8,6
050,30,103,"Montana","Treasure County",3,70,10,5,5
050,30,103,"Montana","Treasure County",3,71,8,4,4
050,30,103,"Montana","Treasure County",3,72,7,3,4
050,30,103,"Montana","Treasure County",3,73,12,6,6
050,30,103,"Montana","Treasure County",3,74,14,7,7
050,30,103,"Montana","Treasure County",3,75,11,7,4
050,30,103,"Montana","Treasure County",3,76,10,6,4
050,30,103,"Montana","Treasure County",3,77,8,5,3
050,30,103,"Montana","Treasure County",3,78,6,4,2
050,30,103,"Montana","Treasure County",3,79,7,2,5
050,30,103,"Montana","Treasure County",3,80,5,2,3
050,30,103,"Montana","Treasure County",3,81,4,3,1
050,30,103,"Montana","Treasure County",3,82,3,3,0
050,30,103,"Montana","Treasure County",3,83,3,3,0
050,30,103,"Montana","Treasure County",3,84,3,1,2
050,30,103,"Montana","Treasure County",3,85,43,17,26
050,30,103,"Montana","Treasure County",4,0,9,5,4
050,30,103,"Montana","Treasure County",4,1,7,5,2
050,30,103,"Montana","Treasure County",4,2,17,7,10
050,30,103,"Montana","Treasure County",4,3,13,10,3
050,30,103,"Montana","Treasure County",4,4,10,7,3
050,30,103,"Montana","Treasure County",4,5,16,5,11
050,30,103,"Montana","Treasure County",4,6,16,7,9
050,30,103,"Montana","Treasure County",4,7,11,5,6
050,30,103,"Montana","Treasure County",4,8,11,7,4
050,30,103,"Montana","Treasure County",4,9,6,5,1
050,30,103,"Montana","Treasure County",4,10,7,5,2
050,30,103,"Montana","Treasure County",4,11,10,4,6
050,30,103,"Montana","Treasure County",4,12,12,4,8
050,30,103,"Montana","Treasure County",4,13,7,2,5
050,30,103,"Montana","Treasure County",4,14,2,1,1
050,30,103,"Montana","Treasure County",4,15,7,2,5
050,30,103,"Montana","Treasure County",4,16,5,1,4
050,30,103,"Montana","Treasure County",4,17,4,2,2
050,30,103,"Montana","Treasure County",4,18,5,3,2
050,30,103,"Montana","Treasure County",4,19,4,3,1
050,30,103,"Montana","Treasure County",4,20,5,2,3
050,30,103,"Montana","Treasure County",4,21,8,2,6
050,30,103,"Montana","Treasure County",4,22,4,2,2
050,30,103,"Montana","Treasure County",4,23,4,3,1
050,30,103,"Montana","Treasure County",4,24,6,4,2
050,30,103,"Montana","Treasure County",4,25,9,5,4
050,30,103,"Montana","Treasure County",4,26,10,5,5
050,30,103,"Montana","Treasure County",4,27,5,2,3
050,30,103,"Montana","Treasure County",4,28,4,2,2
050,30,103,"Montana","Treasure County",4,29,9,3,6
050,30,103,"Montana","Treasure County",4,30,9,4,5
050,30,103,"Montana","Treasure County",4,31,7,4,3
050,30,103,"Montana","Treasure County",4,32,8,4,4
050,30,103,"Montana","Treasure County",4,33,5,3,2
050,30,103,"Montana","Treasure County",4,34,12,7,5
050,30,103,"Montana","Treasure County",4,35,9,3,6
050,30,103,"Montana","Treasure County",4,36,8,4,4
050,30,103,"Montana","Treasure County",4,37,6,3,3
050,30,103,"Montana","Treasure County",4,38,5,1,4
050,30,103,"Montana","Treasure County",4,39,12,7,5
050,30,103,"Montana","Treasure County",4,40,10,6,4
050,30,103,"Montana","Treasure County",4,41,11,6,5
050,30,103,"Montana","Treasure County",4,42,5,3,2
050,30,103,"Montana","Treasure County",4,43,6,2,4
050,30,103,"Montana","Treasure County",4,44,10,3,7
050,30,103,"Montana","Treasure County",4,45,4,3,1
050,30,103,"Montana","Treasure County",4,46,3,1,2
050,30,103,"Montana","Treasure County",4,47,7,4,3
050,30,103,"Montana","Treasure County",4,48,2,1,1
050,30,103,"Montana","Treasure County",4,49,2,1,1
050,30,103,"Montana","Treasure County",4,50,3,2,1
050,30,103,"Montana","Treasure County",4,51,4,2,2
050,30,103,"Montana","Treasure County",4,52,4,2,2
050,30,103,"Montana","Treasure County",4,53,6,1,5
050,30,103,"Montana","Treasure County",4,54,4,2,2
050,30,103,"Montana","Treasure County",4,55,7,5,2
050,30,103,"Montana","Treasure County",4,56,11,9,2
050,30,103,"Montana","Treasure County",4,57,11,5,6
050,30,103,"Montana","Treasure County",4,58,9,5,4
050,30,103,"Montana","Treasure County",4,59,6,3,3
050,30,103,"Montana","Treasure County",4,60,10,4,6
050,30,103,"Montana","Treasure County",4,61,18,12,6
050,30,103,"Montana","Treasure County",4,62,13,8,5
050,30,103,"Montana","Treasure County",4,63,15,7,8
050,30,103,"Montana","Treasure County",4,64,13,5,8
050,30,103,"Montana","Treasure County",4,65,16,7,9
050,30,103,"Montana","Treasure County",4,66,15,7,8
050,30,103,"Montana","Treasure County",4,67,14,7,7
050,30,103,"Montana","Treasure County",4,68,18,11,7
050,30,103,"Montana","Treasure County",4,69,17,9,8
050,30,103,"Montana","Treasure County",4,70,13,8,5
050,30,103,"Montana","Treasure County",4,71,10,5,5
050,30,103,"Montana","Treasure County",4,72,7,4,3
050,30,103,"Montana","Treasure County",4,73,7,3,4
050,30,103,"Montana","Treasure County",4,74,12,6,6
050,30,103,"Montana","Treasure County",4,75,13,6,7
050,30,103,"Montana","Treasure County",4,76,11,7,4
050,30,103,"Montana","Treasure County",4,77,9,5,4
050,30,103,"Montana","Treasure County",4,78,7,5,2
050,30,103,"Montana","Treasure County",4,79,7,4,3
050,30,103,"Montana","Treasure County",4,80,7,2,5
050,30,103,"Montana","Treasure County",4,81,5,2,3
050,30,103,"Montana","Treasure County",4,82,4,3,1
050,30,103,"Montana","Treasure County",4,83,3,3,0
050,30,103,"Montana","Treasure County",4,84,3,3,0
050,30,103,"Montana","Treasure County",4,85,38,16,22
050,30,103,"Montana","Treasure County",5,0,9,5,4
050,30,103,"Montana","Treasure County",5,1,9,5,4
050,30,103,"Montana","Treasure County",5,2,8,5,3
050,30,103,"Montana","Treasure County",5,3,17,7,10
050,30,103,"Montana","Treasure County",5,4,12,9,3
050,30,103,"Montana","Treasure County",5,5,10,6,4
050,30,103,"Montana","Treasure County",5,6,12,3,9
050,30,103,"Montana","Treasure County",5,7,17,8,9
050,30,103,"Montana","Treasure County",5,8,11,4,7
050,30,103,"Montana","Treasure County",5,9,12,8,4
050,30,103,"Montana","Treasure County",5,10,7,6,1
050,30,103,"Montana","Treasure County",5,11,8,6,2
050,30,103,"Montana","Treasure County",5,12,11,5,6
050,30,103,"Montana","Treasure County",5,13,14,4,10
050,30,103,"Montana","Treasure County",5,14,9,2,7
050,30,103,"Montana","Treasure County",5,15,3,1,2
050,30,103,"Montana","Treasure County",5,16,9,2,7
050,30,103,"Montana","Treasure County",5,17,8,4,4
050,30,103,"Montana","Treasure County",5,18,4,2,2
050,30,103,"Montana","Treasure County",5,19,3,2,1
050,30,103,"Montana","Treasure County",5,20,4,2,2
050,30,103,"Montana","Treasure County",5,21,6,3,3
050,30,103,"Montana","Treasure County",5,22,9,3,6
050,30,103,"Montana","Treasure County",5,23,6,2,4
050,30,103,"Montana","Treasure County",5,24,7,6,1
050,30,103,"Montana","Treasure County",5,25,6,3,3
050,30,103,"Montana","Treasure County",5,26,10,6,4
050,30,103,"Montana","Treasure County",5,27,7,5,2
050,30,103,"Montana","Treasure County",5,28,5,2,3
050,30,103,"Montana","Treasure County",5,29,3,3,0
050,30,103,"Montana","Treasure County",5,30,9,3,6
050,30,103,"Montana","Treasure County",5,31,7,3,4
050,30,103,"Montana","Treasure County",5,32,7,5,2
050,30,103,"Montana","Treasure County",5,33,7,3,4
050,30,103,"Montana","Treasure County",5,34,7,3,4
050,30,103,"Montana","Treasure County",5,35,12,7,5
050,30,103,"Montana","Treasure County",5,36,9,4,5
050,30,103,"Montana","Treasure County",5,37,7,3,4
050,30,103,"Montana","Treasure County",5,38,6,2,4
050,30,103,"Montana","Treasure County",5,39,5,1,4
050,30,103,"Montana","Treasure County",5,40,16,8,8
050,30,103,"Montana","Treasure County",5,41,11,6,5
050,30,103,"Montana","Treasure County",5,42,12,7,5
050,30,103,"Montana","Treasure County",5,43,5,3,2
050,30,103,"Montana","Treasure County",5,44,4,1,3
050,30,103,"Montana","Treasure County",5,45,8,2,6
050,30,103,"Montana","Treasure County",5,46,4,3,1
050,30,103,"Montana","Treasure County",5,47,2,1,1
050,30,103,"Montana","Treasure County",5,48,7,4,3
050,30,103,"Montana","Treasure County",5,49,2,1,1
050,30,103,"Montana","Treasure County",5,50,2,1,1
050,30,103,"Montana","Treasure County",5,51,3,2,1
050,30,103,"Montana","Treasure County",5,52,3,1,2
050,30,103,"Montana","Treasure County",5,53,5,2,3
050,30,103,"Montana","Treasure County",5,54,5,1,4
050,30,103,"Montana","Treasure County",5,55,5,2,3
050,30,103,"Montana","Treasure County",5,56,7,5,2
050,30,103,"Montana","Treasure County",5,57,11,9,2
050,30,103,"Montana","Treasure County",5,58,11,5,6
050,30,103,"Montana","Treasure County",5,59,10,6,4
050,30,103,"Montana","Treasure County",5,60,7,4,3
050,30,103,"Montana","Treasure County",5,61,10,4,6
050,30,103,"Montana","Treasure County",5,62,18,12,6
050,30,103,"Montana","Treasure County",5,63,13,8,5
050,30,103,"Montana","Treasure County",5,64,15,6,9
050,30,103,"Montana","Treasure County",5,65,15,6,9
050,30,103,"Montana","Treasure County",5,66,16,7,9
050,30,103,"Montana","Treasure County",5,67,16,8,8
050,30,103,"Montana","Treasure County",5,68,15,8,7
050,30,103,"Montana","Treasure County",5,69,18,11,7
050,30,103,"Montana","Treasure County",5,70,17,9,8
050,30,103,"Montana","Treasure County",5,71,13,8,5
050,30,103,"Montana","Treasure County",5,72,8,3,5
050,30,103,"Montana","Treasure County",5,73,8,4,4
050,30,103,"Montana","Treasure County",5,74,7,3,4
050,30,103,"Montana","Treasure County",5,75,12,6,6
050,30,103,"Montana","Treasure County",5,76,13,6,7
050,30,103,"Montana","Treasure County",5,77,11,7,4
050,30,103,"Montana","Treasure County",5,78,7,5,2
050,30,103,"Montana","Treasure County",5,79,7,5,2
050,30,103,"Montana","Treasure County",5,80,7,4,3
050,30,103,"Montana","Treasure County",5,81,7,2,5
050,30,103,"Montana","Treasure County",5,82,5,2,3
050,30,103,"Montana","Treasure County",5,83,3,3,0
050,30,103,"Montana","Treasure County",5,84,3,3,0
050,30,103,"Montana","Treasure County",5,85,36,16,20
050,30,105,"Montana","Valley County",1,0,86,44,42
050,30,105,"Montana","Valley County",1,1,85,45,40
050,30,105,"Montana","Valley County",1,2,94,54,40
050,30,105,"Montana","Valley County",1,3,81,38,43
050,30,105,"Montana","Valley County",1,4,91,45,46
050,30,105,"Montana","Valley County",1,5,89,47,42
050,30,105,"Montana","Valley County",1,6,101,57,44
050,30,105,"Montana","Valley County",1,7,102,49,53
050,30,105,"Montana","Valley County",1,8,95,52,43
050,30,105,"Montana","Valley County",1,9,93,45,48
050,30,105,"Montana","Valley County",1,10,88,47,41
050,30,105,"Montana","Valley County",1,11,101,50,51
050,30,105,"Montana","Valley County",1,12,101,54,47
050,30,105,"Montana","Valley County",1,13,108,58,50
050,30,105,"Montana","Valley County",1,14,106,53,53
050,30,105,"Montana","Valley County",1,15,100,50,50
050,30,105,"Montana","Valley County",1,16,115,56,59
050,30,105,"Montana","Valley County",1,17,106,56,50
050,30,105,"Montana","Valley County",1,18,85,47,38
050,30,105,"Montana","Valley County",1,19,73,40,33
050,30,105,"Montana","Valley County",1,20,72,40,32
050,30,105,"Montana","Valley County",1,21,67,32,35
050,30,105,"Montana","Valley County",1,22,69,33,36
050,30,105,"Montana","Valley County",1,23,76,40,36
050,30,105,"Montana","Valley County",1,24,59,26,33
050,30,105,"Montana","Valley County",1,25,69,32,37
050,30,105,"Montana","Valley County",1,26,83,39,44
050,30,105,"Montana","Valley County",1,27,83,39,44
050,30,105,"Montana","Valley County",1,28,81,41,40
050,30,105,"Montana","Valley County",1,29,75,36,39
050,30,105,"Montana","Valley County",1,30,81,43,38
050,30,105,"Montana","Valley County",1,31,70,36,34
050,30,105,"Montana","Valley County",1,32,64,36,28
050,30,105,"Montana","Valley County",1,33,81,48,33
050,30,105,"Montana","Valley County",1,34,84,42,42
050,30,105,"Montana","Valley County",1,35,75,32,43
050,30,105,"Montana","Valley County",1,36,85,40,45
050,30,105,"Montana","Valley County",1,37,88,44,44
050,30,105,"Montana","Valley County",1,38,84,41,43
050,30,105,"Montana","Valley County",1,39,81,44,37
050,30,105,"Montana","Valley County",1,40,85,46,39
050,30,105,"Montana","Valley County",1,41,88,48,40
050,30,105,"Montana","Valley County",1,42,85,40,45
050,30,105,"Montana","Valley County",1,43,94,51,43
050,30,105,"Montana","Valley County",1,44,84,51,33
050,30,105,"Montana","Valley County",1,45,79,43,36
050,30,105,"Montana","Valley County",1,46,69,35,34
050,30,105,"Montana","Valley County",1,47,73,34,39
050,30,105,"Montana","Valley County",1,48,83,42,41
050,30,105,"Montana","Valley County",1,49,81,48,33
050,30,105,"Montana","Valley County",1,50,67,35,32
050,30,105,"Montana","Valley County",1,51,82,41,41
050,30,105,"Montana","Valley County",1,52,68,30,38
050,30,105,"Montana","Valley County",1,53,83,45,38
050,30,105,"Montana","Valley County",1,54,83,50,33
050,30,105,"Montana","Valley County",1,55,103,57,46
050,30,105,"Montana","Valley County",1,56,102,45,57
050,30,105,"Montana","Valley County",1,57,99,44,55
050,30,105,"Montana","Valley County",1,58,117,58,59
050,30,105,"Montana","Valley County",1,59,117,53,64
050,30,105,"Montana","Valley County",1,60,126,65,61
050,30,105,"Montana","Valley County",1,61,122,61,61
050,30,105,"Montana","Valley County",1,62,138,73,65
050,30,105,"Montana","Valley County",1,63,116,62,54
050,30,105,"Montana","Valley County",1,64,107,61,46
050,30,105,"Montana","Valley County",1,65,119,65,54
050,30,105,"Montana","Valley County",1,66,109,61,48
050,30,105,"Montana","Valley County",1,67,117,63,54
050,30,105,"Montana","Valley County",1,68,112,61,51
050,30,105,"Montana","Valley County",1,69,111,57,54
050,30,105,"Montana","Valley County",1,70,107,56,51
050,30,105,"Montana","Valley County",1,71,99,47,52
050,30,105,"Montana","Valley County",1,72,84,39,45
050,30,105,"Montana","Valley County",1,73,78,37,41
050,30,105,"Montana","Valley County",1,74,50,27,23
050,30,105,"Montana","Valley County",1,75,53,30,23
050,30,105,"Montana","Valley County",1,76,59,31,28
050,30,105,"Montana","Valley County",1,77,76,32,44
050,30,105,"Montana","Valley County",1,78,56,26,30
050,30,105,"Montana","Valley County",1,79,61,28,33
050,30,105,"Montana","Valley County",1,80,45,23,22
050,30,105,"Montana","Valley County",1,81,47,18,29
050,30,105,"Montana","Valley County",1,82,53,19,34
050,30,105,"Montana","Valley County",1,83,41,19,22
050,30,105,"Montana","Valley County",1,84,44,18,26
050,30,105,"Montana","Valley County",1,85,277,103,174
050,30,105,"Montana","Valley County",2,0,81,44,37
050,30,105,"Montana","Valley County",2,1,84,44,40
050,30,105,"Montana","Valley County",2,2,90,51,39
050,30,105,"Montana","Valley County",2,3,82,41,41
050,30,105,"Montana","Valley County",2,4,90,44,46
050,30,105,"Montana","Valley County",2,5,91,48,43
050,30,105,"Montana","Valley County",2,6,99,55,44
050,30,105,"Montana","Valley County",2,7,100,50,50
050,30,105,"Montana","Valley County",2,8,95,50,45
050,30,105,"Montana","Valley County",2,9,94,46,48
050,30,105,"Montana","Valley County",2,10,92,47,45
050,30,105,"Montana","Valley County",2,11,97,49,48
050,30,105,"Montana","Valley County",2,12,101,53,48
050,30,105,"Montana","Valley County",2,13,106,56,50
050,30,105,"Montana","Valley County",2,14,107,55,52
050,30,105,"Montana","Valley County",2,15,103,51,52
050,30,105,"Montana","Valley County",2,16,110,55,55
050,30,105,"Montana","Valley County",2,17,108,56,52
050,30,105,"Montana","Valley County",2,18,84,46,38
050,30,105,"Montana","Valley County",2,19,72,39,33
050,30,105,"Montana","Valley County",2,20,74,41,33
050,30,105,"Montana","Valley County",2,21,68,34,34
050,30,105,"Montana","Valley County",2,22,70,33,37
050,30,105,"Montana","Valley County",2,23,73,37,36
050,30,105,"Montana","Valley County",2,24,64,29,35
050,30,105,"Montana","Valley County",2,25,66,30,36
050,30,105,"Montana","Valley County",2,26,79,37,42
050,30,105,"Montana","Valley County",2,27,82,38,44
050,30,105,"Montana","Valley County",2,28,82,40,42
050,30,105,"Montana","Valley County",2,29,74,36,38
050,30,105,"Montana","Valley County",2,30,79,41,38
050,30,105,"Montana","Valley County",2,31,72,37,35
050,30,105,"Montana","Valley County",2,32,67,37,30
050,30,105,"Montana","Valley County",2,33,77,45,32
050,30,105,"Montana","Valley County",2,34,81,43,38
050,30,105,"Montana","Valley County",2,35,77,35,42
050,30,105,"Montana","Valley County",2,36,83,39,44
050,30,105,"Montana","Valley County",2,37,88,43,45
050,30,105,"Montana","Valley County",2,38,85,41,44
050,30,105,"Montana","Valley County",2,39,82,43,39
050,30,105,"Montana","Valley County",2,40,85,46,39
050,30,105,"Montana","Valley County",2,41,88,48,40
050,30,105,"Montana","Valley County",2,42,84,41,43
050,30,105,"Montana","Valley County",2,43,94,49,45
050,30,105,"Montana","Valley County",2,44,86,51,35
050,30,105,"Montana","Valley County",2,45,80,45,35
050,30,105,"Montana","Valley County",2,46,71,37,34
050,30,105,"Montana","Valley County",2,47,73,35,38
050,30,105,"Montana","Valley County",2,48,80,41,39
050,30,105,"Montana","Valley County",2,49,82,47,35
050,30,105,"Montana","Valley County",2,50,70,37,33
050,30,105,"Montana","Valley County",2,51,78,39,39
050,30,105,"Montana","Valley County",2,52,71,32,39
050,30,105,"Montana","Valley County",2,53,81,42,39
050,30,105,"Montana","Valley County",2,54,83,49,34
050,30,105,"Montana","Valley County",2,55,98,55,43
050,30,105,"Montana","Valley County",2,56,104,49,55
050,30,105,"Montana","Valley County",2,57,98,43,55
050,30,105,"Montana","Valley County",2,58,111,54,57
050,30,105,"Montana","Valley County",2,59,119,55,64
050,30,105,"Montana","Valley County",2,60,124,62,62
050,30,105,"Montana","Valley County",2,61,122,61,61
050,30,105,"Montana","Valley County",2,62,135,72,63
050,30,105,"Montana","Valley County",2,63,121,64,57
050,30,105,"Montana","Valley County",2,64,108,61,47
050,30,105,"Montana","Valley County",2,65,116,63,53
050,30,105,"Montana","Valley County",2,66,113,63,50
050,30,105,"Montana","Valley County",2,67,115,63,52
050,30,105,"Montana","Valley County",2,68,113,61,52
050,30,105,"Montana","Valley County",2,69,111,57,54
050,30,105,"Montana","Valley County",2,70,108,56,52
050,30,105,"Montana","Valley County",2,71,100,48,52
050,30,105,"Montana","Valley County",2,72,85,39,46
050,30,105,"Montana","Valley County",2,73,83,39,44
050,30,105,"Montana","Valley County",2,74,53,27,26
050,30,105,"Montana","Valley County",2,75,52,29,23
050,30,105,"Montana","Valley County",2,76,57,31,26
050,30,105,"Montana","Valley County",2,77,74,32,42
050,30,105,"Montana","Valley County",2,78,59,27,32
050,30,105,"Montana","Valley County",2,79,60,27,33
050,30,105,"Montana","Valley County",2,80,46,23,23
050,30,105,"Montana","Valley County",2,81,44,18,26
050,30,105,"Montana","Valley County",2,82,50,19,31
050,30,105,"Montana","Valley County",2,83,41,16,25
050,30,105,"Montana","Valley County",2,84,42,17,25
050,30,105,"Montana","Valley County",2,85,279,104,175
050,30,105,"Montana","Valley County",3,0,67,34,33
050,30,105,"Montana","Valley County",3,1,85,46,39
050,30,105,"Montana","Valley County",3,2,85,46,39
050,30,105,"Montana","Valley County",3,3,94,52,42
050,30,105,"Montana","Valley County",3,4,86,42,44
050,30,105,"Montana","Valley County",3,5,103,50,53
050,30,105,"Montana","Valley County",3,6,91,44,47
050,30,105,"Montana","Valley County",3,7,96,54,42
050,30,105,"Montana","Valley County",3,8,96,48,48
050,30,105,"Montana","Valley County",3,9,93,50,43
050,30,105,"Montana","Valley County",3,10,92,47,45
050,30,105,"Montana","Valley County",3,11,89,46,43
050,30,105,"Montana","Valley County",3,12,92,47,45
050,30,105,"Montana","Valley County",3,13,99,52,47
050,30,105,"Montana","Valley County",3,14,106,57,49
050,30,105,"Montana","Valley County",3,15,108,55,53
050,30,105,"Montana","Valley County",3,16,103,53,50
050,30,105,"Montana","Valley County",3,17,108,56,52
050,30,105,"Montana","Valley County",3,18,88,47,41
050,30,105,"Montana","Valley County",3,19,64,35,29
050,30,105,"Montana","Valley County",3,20,78,42,36
050,30,105,"Montana","Valley County",3,21,77,42,35
050,30,105,"Montana","Valley County",3,22,75,41,34
050,30,105,"Montana","Valley County",3,23,81,40,41
050,30,105,"Montana","Valley County",3,24,72,38,34
050,30,105,"Montana","Valley County",3,25,65,32,33
050,30,105,"Montana","Valley County",3,26,71,33,38
050,30,105,"Montana","Valley County",3,27,80,39,41
050,30,105,"Montana","Valley County",3,28,76,35,41
050,30,105,"Montana","Valley County",3,29,82,43,39
050,30,105,"Montana","Valley County",3,30,77,40,37
050,30,105,"Montana","Valley County",3,31,78,41,37
050,30,105,"Montana","Valley County",3,32,73,37,36
050,30,105,"Montana","Valley County",3,33,65,34,31
050,30,105,"Montana","Valley County",3,34,73,43,30
050,30,105,"Montana","Valley County",3,35,82,46,36
050,30,105,"Montana","Valley County",3,36,82,38,44
050,30,105,"Montana","Valley County",3,37,89,45,44
050,30,105,"Montana","Valley County",3,38,91,46,45
050,30,105,"Montana","Valley County",3,39,89,44,45
050,30,105,"Montana","Valley County",3,40,79,43,36
050,30,105,"Montana","Valley County",3,41,88,48,40
050,30,105,"Montana","Valley County",3,42,87,45,42
050,30,105,"Montana","Valley County",3,43,86,44,42
050,30,105,"Montana","Valley County",3,44,93,49,44
050,30,105,"Montana","Valley County",3,45,88,52,36
050,30,105,"Montana","Valley County",3,46,87,49,38
050,30,105,"Montana","Valley County",3,47,74,36,38
050,30,105,"Montana","Valley County",3,48,76,37,39
050,30,105,"Montana","Valley County",3,49,74,37,37
050,30,105,"Montana","Valley County",3,50,88,50,38
050,30,105,"Montana","Valley County",3,51,69,34,35
050,30,105,"Montana","Valley County",3,52,77,38,39
050,30,105,"Montana","Valley County",3,53,71,33,38
050,30,105,"Montana","Valley County",3,54,80,41,39
050,30,105,"Montana","Valley County",3,55,75,47,28
050,30,105,"Montana","Valley County",3,56,99,55,44
050,30,105,"Montana","Valley County",3,57,100,45,55
050,30,105,"Montana","Valley County",3,58,96,40,56
050,30,105,"Montana","Valley County",3,59,116,56,60
050,30,105,"Montana","Valley County",3,60,122,56,66
050,30,105,"Montana","Valley County",3,61,127,63,64
050,30,105,"Montana","Valley County",3,62,129,69,60
050,30,105,"Montana","Valley County",3,63,128,60,68
050,30,105,"Montana","Valley County",3,64,117,64,53
050,30,105,"Montana","Valley County",3,65,105,56,49
050,30,105,"Montana","Valley County",3,66,118,65,53
050,30,105,"Montana","Valley County",3,67,118,65,53
050,30,105,"Montana","Valley County",3,68,110,61,49
050,30,105,"Montana","Valley County",3,69,109,56,53
050,30,105,"Montana","Valley County",3,70,110,57,53
050,30,105,"Montana","Valley County",3,71,109,57,52
050,30,105,"Montana","Valley County",3,72,95,45,50
050,30,105,"Montana","Valley County",3,73,81,36,45
050,30,105,"Montana","Valley County",3,74,84,39,45
050,30,105,"Montana","Valley County",3,75,48,23,25
050,30,105,"Montana","Valley County",3,76,52,28,24
050,30,105,"Montana","Valley County",3,77,61,33,28
050,30,105,"Montana","Valley County",3,78,69,31,38
050,30,105,"Montana","Valley County",3,79,53,21,32
050,30,105,"Montana","Valley County",3,80,57,27,30
050,30,105,"Montana","Valley County",3,81,45,21,24
050,30,105,"Montana","Valley County",3,82,45,19,26
050,30,105,"Montana","Valley County",3,83,49,21,28
050,30,105,"Montana","Valley County",3,84,40,13,27
050,30,105,"Montana","Valley County",3,85,275,99,176
050,30,105,"Montana","Valley County",4,0,84,45,39
050,30,105,"Montana","Valley County",4,1,74,34,40
050,30,105,"Montana","Valley County",4,2,79,42,37
050,30,105,"Montana","Valley County",4,3,87,47,40
050,30,105,"Montana","Valley County",4,4,91,52,39
050,30,105,"Montana","Valley County",4,5,85,43,42
050,30,105,"Montana","Valley County",4,6,107,52,55
050,30,105,"Montana","Valley County",4,7,90,46,44
050,30,105,"Montana","Valley County",4,8,94,53,41
050,30,105,"Montana","Valley County",4,9,95,46,49
050,30,105,"Montana","Valley County",4,10,98,52,46
050,30,105,"Montana","Valley County",4,11,91,47,44
050,30,105,"Montana","Valley County",4,12,91,49,42
050,30,105,"Montana","Valley County",4,13,95,48,47
050,30,105,"Montana","Valley County",4,14,101,51,50
050,30,105,"Montana","Valley County",4,15,107,57,50
050,30,105,"Montana","Valley County",4,16,104,52,52
050,30,105,"Montana","Valley County",4,17,104,58,46
050,30,105,"Montana","Valley County",4,18,89,48,41
050,30,105,"Montana","Valley County",4,19,64,34,30
050,30,105,"Montana","Valley County",4,20,63,36,27
050,30,105,"Montana","Valley County",4,21,80,40,40
050,30,105,"Montana","Valley County",4,22,69,38,31
050,30,105,"Montana","Valley County",4,23,70,39,31
050,30,105,"Montana","Valley County",4,24,80,40,40
050,30,105,"Montana","Valley County",4,25,68,34,34
050,30,105,"Montana","Valley County",4,26,68,38,30
050,30,105,"Montana","Valley County",4,27,72,36,36
050,30,105,"Montana","Valley County",4,28,84,40,44
050,30,105,"Montana","Valley County",4,29,74,30,44
050,30,105,"Montana","Valley County",4,30,87,44,43
050,30,105,"Montana","Valley County",4,31,80,42,38
050,30,105,"Montana","Valley County",4,32,76,40,36
050,30,105,"Montana","Valley County",4,33,78,42,36
050,30,105,"Montana","Valley County",4,34,72,38,34
050,30,105,"Montana","Valley County",4,35,72,43,29
050,30,105,"Montana","Valley County",4,36,84,48,36
050,30,105,"Montana","Valley County",4,37,88,45,43
050,30,105,"Montana","Valley County",4,38,92,49,43
050,30,105,"Montana","Valley County",4,39,94,47,47
050,30,105,"Montana","Valley County",4,40,90,44,46
050,30,105,"Montana","Valley County",4,41,80,43,37
050,30,105,"Montana","Valley County",4,42,86,46,40
050,30,105,"Montana","Valley County",4,43,83,45,38
050,30,105,"Montana","Valley County",4,44,87,42,45
050,30,105,"Montana","Valley County",4,45,90,46,44
050,30,105,"Montana","Valley County",4,46,90,53,37
050,30,105,"Montana","Valley County",4,47,89,50,39
050,30,105,"Montana","Valley County",4,48,73,36,37
050,30,105,"Montana","Valley County",4,49,76,35,41
050,30,105,"Montana","Valley County",4,50,77,37,40
050,30,105,"Montana","Valley County",4,51,91,49,42
050,30,105,"Montana","Valley County",4,52,72,33,39
050,30,105,"Montana","Valley County",4,53,77,38,39
050,30,105,"Montana","Valley County",4,54,72,34,38
050,30,105,"Montana","Valley County",4,55,80,42,38
050,30,105,"Montana","Valley County",4,56,76,48,28
050,30,105,"Montana","Valley County",4,57,98,53,45
050,30,105,"Montana","Valley County",4,58,102,47,55
050,30,105,"Montana","Valley County",4,59,97,40,57
050,30,105,"Montana","Valley County",4,60,114,53,61
050,30,105,"Montana","Valley County",4,61,121,57,64
050,30,105,"Montana","Valley County",4,62,127,68,59
050,30,105,"Montana","Valley County",4,63,126,61,65
050,30,105,"Montana","Valley County",4,64,128,65,63
050,30,105,"Montana","Valley County",4,65,112,56,56
050,30,105,"Montana","Valley County",4,66,105,58,47
050,30,105,"Montana","Valley County",4,67,116,63,53
050,30,105,"Montana","Valley County",4,68,116,64,52
050,30,105,"Montana","Valley County",4,69,106,58,48
050,30,105,"Montana","Valley County",4,70,107,54,53
050,30,105,"Montana","Valley County",4,71,111,56,55
050,30,105,"Montana","Valley County",4,72,99,50,49
050,30,105,"Montana","Valley County",4,73,91,43,48
050,30,105,"Montana","Valley County",4,74,80,38,42
050,30,105,"Montana","Valley County",4,75,77,36,41
050,30,105,"Montana","Valley County",4,76,45,19,26
050,30,105,"Montana","Valley County",4,77,52,28,24
050,30,105,"Montana","Valley County",4,78,58,33,25
050,30,105,"Montana","Valley County",4,79,66,26,40
050,30,105,"Montana","Valley County",4,80,49,23,26
050,30,105,"Montana","Valley County",4,81,55,25,30
050,30,105,"Montana","Valley County",4,82,40,19,21
050,30,105,"Montana","Valley County",4,83,44,19,25
050,30,105,"Montana","Valley County",4,84,50,19,31
050,30,105,"Montana","Valley County",4,85,280,104,176
050,30,105,"Montana","Valley County",5,0,84,45,39
050,30,105,"Montana","Valley County",5,1,83,45,38
050,30,105,"Montana","Valley County",5,2,81,35,46
050,30,105,"Montana","Valley County",5,3,81,43,38
050,30,105,"Montana","Valley County",5,4,90,50,40
050,30,105,"Montana","Valley County",5,5,91,51,40
050,30,105,"Montana","Valley County",5,6,88,45,43
050,30,105,"Montana","Valley County",5,7,107,52,55
050,30,105,"Montana","Valley County",5,8,90,46,44
050,30,105,"Montana","Valley County",5,9,90,52,38
050,30,105,"Montana","Valley County",5,10,95,48,47
050,30,105,"Montana","Valley County",5,11,95,52,43
050,30,105,"Montana","Valley County",5,12,89,45,44
050,30,105,"Montana","Valley County",5,13,86,48,38
050,30,105,"Montana","Valley County",5,14,95,48,47
050,30,105,"Montana","Valley County",5,15,98,48,50
050,30,105,"Montana","Valley County",5,16,104,54,50
050,30,105,"Montana","Valley County",5,17,107,53,54
050,30,105,"Montana","Valley County",5,18,87,47,40
050,30,105,"Montana","Valley County",5,19,74,36,38
050,30,105,"Montana","Valley County",5,20,65,34,31
050,30,105,"Montana","Valley County",5,21,68,36,32
050,30,105,"Montana","Valley County",5,22,86,45,41
050,30,105,"Montana","Valley County",5,23,62,35,27
050,30,105,"Montana","Valley County",5,24,78,43,35
050,30,105,"Montana","Valley County",5,25,74,38,36
050,30,105,"Montana","Valley County",5,26,68,36,32
050,30,105,"Montana","Valley County",5,27,67,36,31
050,30,105,"Montana","Valley County",5,28,73,36,37
050,30,105,"Montana","Valley County",5,29,95,46,49
050,30,105,"Montana","Valley County",5,30,77,31,46
050,30,105,"Montana","Valley County",5,31,81,42,39
050,30,105,"Montana","Valley County",5,32,85,44,41
050,30,105,"Montana","Valley County",5,33,76,40,36
050,30,105,"Montana","Valley County",5,34,75,41,34
050,30,105,"Montana","Valley County",5,35,74,38,36
050,30,105,"Montana","Valley County",5,36,73,42,31
050,30,105,"Montana","Valley County",5,37,79,44,35
050,30,105,"Montana","Valley County",5,38,83,40,43
050,30,105,"Montana","Valley County",5,39,87,45,42
050,30,105,"Montana","Valley County",5,40,92,45,47
050,30,105,"Montana","Valley County",5,41,87,46,41
050,30,105,"Montana","Valley County",5,42,81,43,38
050,30,105,"Montana","Valley County",5,43,90,48,42
050,30,105,"Montana","Valley County",5,44,84,46,38
050,30,105,"Montana","Valley County",5,45,91,46,45
050,30,105,"Montana","Valley County",5,46,93,46,47
050,30,105,"Montana","Valley County",5,47,83,50,33
050,30,105,"Montana","Valley County",5,48,87,48,39
050,30,105,"Montana","Valley County",5,49,71,36,35
050,30,105,"Montana","Valley County",5,50,77,37,40
050,30,105,"Montana","Valley County",5,51,78,36,42
050,30,105,"Montana","Valley County",5,52,87,46,41
050,30,105,"Montana","Valley County",5,53,67,29,38
050,30,105,"Montana","Valley County",5,54,74,38,36
050,30,105,"Montana","Valley County",5,55,68,31,37
050,30,105,"Montana","Valley County",5,56,79,42,37
050,30,105,"Montana","Valley County",5,57,77,46,31
050,30,105,"Montana","Valley County",5,58,93,49,44
050,30,105,"Montana","Valley County",5,59,97,41,56
050,30,105,"Montana","Valley County",5,60,96,38,58
050,30,105,"Montana","Valley County",5,61,114,54,60
050,30,105,"Montana","Valley County",5,62,122,60,62
050,30,105,"Montana","Valley County",5,63,123,60,63
050,30,105,"Montana","Valley County",5,64,116,59,57
050,30,105,"Montana","Valley County",5,65,123,62,61
050,30,105,"Montana","Valley County",5,66,109,53,56
050,30,105,"Montana","Valley County",5,67,107,58,49
050,30,105,"Montana","Valley County",5,68,114,64,50
050,30,105,"Montana","Valley County",5,69,113,64,49
050,30,105,"Montana","Valley County",5,70,102,55,47
050,30,105,"Montana","Valley County",5,71,109,56,53
050,30,105,"Montana","Valley County",5,72,107,52,55
050,30,105,"Montana","Valley County",5,73,95,48,47
050,30,105,"Montana","Valley County",5,74,93,46,47
050,30,105,"Montana","Valley County",5,75,72,33,39
050,30,105,"Montana","Valley County",5,76,72,31,41
050,30,105,"Montana","Valley County",5,77,47,20,27
050,30,105,"Montana","Valley County",5,78,48,28,20
050,30,105,"Montana","Valley County",5,79,53,28,25
050,30,105,"Montana","Valley County",5,80,63,27,36
050,30,105,"Montana","Valley County",5,81,45,20,25
050,30,105,"Montana","Valley County",5,82,51,22,29
050,30,105,"Montana","Valley County",5,83,40,20,20
050,30,105,"Montana","Valley County",5,84,48,19,29
050,30,105,"Montana","Valley County",5,85,295,109,186
050,30,107,"Montana","Wheatland County",1,0,25,12,13
050,30,107,"Montana","Wheatland County",1,1,30,19,11
050,30,107,"Montana","Wheatland County",1,2,27,17,10
050,30,107,"Montana","Wheatland County",1,3,22,14,8
050,30,107,"Montana","Wheatland County",1,4,21,13,8
050,30,107,"Montana","Wheatland County",1,5,23,11,12
050,30,107,"Montana","Wheatland County",1,6,31,15,16
050,30,107,"Montana","Wheatland County",1,7,29,11,18
050,30,107,"Montana","Wheatland County",1,8,35,21,14
050,30,107,"Montana","Wheatland County",1,9,31,17,14
050,30,107,"Montana","Wheatland County",1,10,37,16,21
050,30,107,"Montana","Wheatland County",1,11,44,22,22
050,30,107,"Montana","Wheatland County",1,12,35,24,11
050,30,107,"Montana","Wheatland County",1,13,31,20,11
050,30,107,"Montana","Wheatland County",1,14,40,26,14
050,30,107,"Montana","Wheatland County",1,15,22,12,10
050,30,107,"Montana","Wheatland County",1,16,34,8,26
050,30,107,"Montana","Wheatland County",1,17,27,16,11
050,30,107,"Montana","Wheatland County",1,18,26,10,16
050,30,107,"Montana","Wheatland County",1,19,22,9,13
050,30,107,"Montana","Wheatland County",1,20,19,8,11
050,30,107,"Montana","Wheatland County",1,21,18,10,8
050,30,107,"Montana","Wheatland County",1,22,24,14,10
050,30,107,"Montana","Wheatland County",1,23,16,12,4
050,30,107,"Montana","Wheatland County",1,24,32,15,17
050,30,107,"Montana","Wheatland County",1,25,20,13,7
050,30,107,"Montana","Wheatland County",1,26,22,10,12
050,30,107,"Montana","Wheatland County",1,27,13,4,9
050,30,107,"Montana","Wheatland County",1,28,12,6,6
050,30,107,"Montana","Wheatland County",1,29,19,11,8
050,30,107,"Montana","Wheatland County",1,30,22,15,7
050,30,107,"Montana","Wheatland County",1,31,19,9,10
050,30,107,"Montana","Wheatland County",1,32,17,11,6
050,30,107,"Montana","Wheatland County",1,33,18,10,8
050,30,107,"Montana","Wheatland County",1,34,23,11,12
050,30,107,"Montana","Wheatland County",1,35,20,13,7
050,30,107,"Montana","Wheatland County",1,36,17,4,13
050,30,107,"Montana","Wheatland County",1,37,11,3,8
050,30,107,"Montana","Wheatland County",1,38,17,7,10
050,30,107,"Montana","Wheatland County",1,39,25,10,15
050,30,107,"Montana","Wheatland County",1,40,16,5,11
050,30,107,"Montana","Wheatland County",1,41,23,12,11
050,30,107,"Montana","Wheatland County",1,42,21,13,8
050,30,107,"Montana","Wheatland County",1,43,26,13,13
050,30,107,"Montana","Wheatland County",1,44,31,15,16
050,30,107,"Montana","Wheatland County",1,45,22,8,14
050,30,107,"Montana","Wheatland County",1,46,25,17,8
050,30,107,"Montana","Wheatland County",1,47,22,14,8
050,30,107,"Montana","Wheatland County",1,48,26,10,16
050,30,107,"Montana","Wheatland County",1,49,21,10,11
050,30,107,"Montana","Wheatland County",1,50,27,19,8
050,30,107,"Montana","Wheatland County",1,51,22,13,9
050,30,107,"Montana","Wheatland County",1,52,26,18,8
050,30,107,"Montana","Wheatland County",1,53,23,13,10
050,30,107,"Montana","Wheatland County",1,54,18,10,8
050,30,107,"Montana","Wheatland County",1,55,16,11,5
050,30,107,"Montana","Wheatland County",1,56,13,8,5
050,30,107,"Montana","Wheatland County",1,57,25,13,12
050,30,107,"Montana","Wheatland County",1,58,20,11,9
050,30,107,"Montana","Wheatland County",1,59,30,15,15
050,30,107,"Montana","Wheatland County",1,60,30,17,13
050,30,107,"Montana","Wheatland County",1,61,34,15,19
050,30,107,"Montana","Wheatland County",1,62,32,19,13
050,30,107,"Montana","Wheatland County",1,63,41,16,25
050,30,107,"Montana","Wheatland County",1,64,31,13,18
050,30,107,"Montana","Wheatland County",1,65,35,22,13
050,30,107,"Montana","Wheatland County",1,66,34,16,18
050,30,107,"Montana","Wheatland County",1,67,26,13,13
050,30,107,"Montana","Wheatland County",1,68,35,12,23
050,30,107,"Montana","Wheatland County",1,69,31,13,18
050,30,107,"Montana","Wheatland County",1,70,20,14,6
050,30,107,"Montana","Wheatland County",1,71,27,19,8
050,30,107,"Montana","Wheatland County",1,72,32,17,15
050,30,107,"Montana","Wheatland County",1,73,23,12,11
050,30,107,"Montana","Wheatland County",1,74,24,12,12
050,30,107,"Montana","Wheatland County",1,75,19,11,8
050,30,107,"Montana","Wheatland County",1,76,17,8,9
050,30,107,"Montana","Wheatland County",1,77,18,9,9
050,30,107,"Montana","Wheatland County",1,78,20,9,11
050,30,107,"Montana","Wheatland County",1,79,15,5,10
050,30,107,"Montana","Wheatland County",1,80,14,9,5
050,30,107,"Montana","Wheatland County",1,81,8,5,3
050,30,107,"Montana","Wheatland County",1,82,9,6,3
050,30,107,"Montana","Wheatland County",1,83,5,3,2
050,30,107,"Montana","Wheatland County",1,84,8,2,6
050,30,107,"Montana","Wheatland County",1,85,53,19,34
050,30,107,"Montana","Wheatland County",2,0,24,10,14
050,30,107,"Montana","Wheatland County",2,1,30,19,11
050,30,107,"Montana","Wheatland County",2,2,27,16,11
050,30,107,"Montana","Wheatland County",2,3,23,15,8
050,30,107,"Montana","Wheatland County",2,4,22,14,8
050,30,107,"Montana","Wheatland County",2,5,22,10,12
050,30,107,"Montana","Wheatland County",2,6,31,15,16
050,30,107,"Montana","Wheatland County",2,7,29,11,18
050,30,107,"Montana","Wheatland County",2,8,33,20,13
050,30,107,"Montana","Wheatland County",2,9,33,18,15
050,30,107,"Montana","Wheatland County",2,10,37,16,21
050,30,107,"Montana","Wheatland County",2,11,44,22,22
050,30,107,"Montana","Wheatland County",2,12,36,23,13
050,30,107,"Montana","Wheatland County",2,13,33,21,12
050,30,107,"Montana","Wheatland County",2,14,39,25,14
050,30,107,"Montana","Wheatland County",2,15,24,14,10
050,30,107,"Montana","Wheatland County",2,16,32,7,25
050,30,107,"Montana","Wheatland County",2,17,29,16,13
050,30,107,"Montana","Wheatland County",2,18,26,10,16
050,30,107,"Montana","Wheatland County",2,19,21,8,13
050,30,107,"Montana","Wheatland County",2,20,19,8,11
050,30,107,"Montana","Wheatland County",2,21,17,9,8
050,30,107,"Montana","Wheatland County",2,22,22,13,9
050,30,107,"Montana","Wheatland County",2,23,17,12,5
050,30,107,"Montana","Wheatland County",2,24,31,15,16
050,30,107,"Montana","Wheatland County",2,25,21,14,7
050,30,107,"Montana","Wheatland County",2,26,21,9,12
050,30,107,"Montana","Wheatland County",2,27,15,6,9
050,30,107,"Montana","Wheatland County",2,28,10,5,5
050,30,107,"Montana","Wheatland County",2,29,19,12,7
050,30,107,"Montana","Wheatland County",2,30,21,13,8
050,30,107,"Montana","Wheatland County",2,31,20,10,10
050,30,107,"Montana","Wheatland County",2,32,19,12,7
050,30,107,"Montana","Wheatland County",2,33,18,10,8
050,30,107,"Montana","Wheatland County",2,34,24,11,13
050,30,107,"Montana","Wheatland County",2,35,19,13,6
050,30,107,"Montana","Wheatland County",2,36,17,5,12
050,30,107,"Montana","Wheatland County",2,37,12,3,9
050,30,107,"Montana","Wheatland County",2,38,17,7,10
050,30,107,"Montana","Wheatland County",2,39,25,10,15
050,30,107,"Montana","Wheatland County",2,40,18,6,12
050,30,107,"Montana","Wheatland County",2,41,23,12,11
050,30,107,"Montana","Wheatland County",2,42,21,12,9
050,30,107,"Montana","Wheatland County",2,43,27,14,13
050,30,107,"Montana","Wheatland County",2,44,30,15,15
050,30,107,"Montana","Wheatland County",2,45,23,8,15
050,30,107,"Montana","Wheatland County",2,46,25,17,8
050,30,107,"Montana","Wheatland County",2,47,22,14,8
050,30,107,"Montana","Wheatland County",2,48,25,10,15
050,30,107,"Montana","Wheatland County",2,49,21,10,11
050,30,107,"Montana","Wheatland County",2,50,26,18,8
050,30,107,"Montana","Wheatland County",2,51,23,14,9
050,30,107,"Montana","Wheatland County",2,52,27,18,9
050,30,107,"Montana","Wheatland County",2,53,25,14,11
050,30,107,"Montana","Wheatland County",2,54,18,11,7
050,30,107,"Montana","Wheatland County",2,55,18,11,7
050,30,107,"Montana","Wheatland County",2,56,14,9,5
050,30,107,"Montana","Wheatland County",2,57,24,13,11
050,30,107,"Montana","Wheatland County",2,58,19,10,9
050,30,107,"Montana","Wheatland County",2,59,28,14,14
050,30,107,"Montana","Wheatland County",2,60,30,17,13
050,30,107,"Montana","Wheatland County",2,61,35,16,19
050,30,107,"Montana","Wheatland County",2,62,30,17,13
050,30,107,"Montana","Wheatland County",2,63,39,16,23
050,30,107,"Montana","Wheatland County",2,64,33,13,20
050,30,107,"Montana","Wheatland County",2,65,35,21,14
050,30,107,"Montana","Wheatland County",2,66,34,16,18
050,30,107,"Montana","Wheatland County",2,67,27,14,13
050,30,107,"Montana","Wheatland County",2,68,32,11,21
050,30,107,"Montana","Wheatland County",2,69,31,13,18
050,30,107,"Montana","Wheatland County",2,70,23,14,9
050,30,107,"Montana","Wheatland County",2,71,26,18,8
050,30,107,"Montana","Wheatland County",2,72,30,17,13
050,30,107,"Montana","Wheatland County",2,73,26,14,12
050,30,107,"Montana","Wheatland County",2,74,24,12,12
050,30,107,"Montana","Wheatland County",2,75,19,11,8
050,30,107,"Montana","Wheatland County",2,76,17,8,9
050,30,107,"Montana","Wheatland County",2,77,18,9,9
050,30,107,"Montana","Wheatland County",2,78,19,10,9
050,30,107,"Montana","Wheatland County",2,79,16,6,10
050,30,107,"Montana","Wheatland County",2,80,14,8,6
050,30,107,"Montana","Wheatland County",2,81,9,6,3
050,30,107,"Montana","Wheatland County",2,82,9,6,3
050,30,107,"Montana","Wheatland County",2,83,6,4,2
050,30,107,"Montana","Wheatland County",2,84,7,2,5
050,30,107,"Montana","Wheatland County",2,85,51,18,33
050,30,107,"Montana","Wheatland County",3,0,30,12,18
050,30,107,"Montana","Wheatland County",3,1,27,16,11
050,30,107,"Montana","Wheatland County",3,2,22,11,11
050,30,107,"Montana","Wheatland County",3,3,22,16,6
050,30,107,"Montana","Wheatland County",3,4,21,14,7
050,30,107,"Montana","Wheatland County",3,5,19,6,13
050,30,107,"Montana","Wheatland County",3,6,26,12,14
050,30,107,"Montana","Wheatland County",3,7,30,10,20
050,30,107,"Montana","Wheatland County",3,8,29,17,12
050,30,107,"Montana","Wheatland County",3,9,31,21,10
050,30,107,"Montana","Wheatland County",3,10,37,19,18
050,30,107,"Montana","Wheatland County",3,11,38,22,16
050,30,107,"Montana","Wheatland County",3,12,40,23,17
050,30,107,"Montana","Wheatland County",3,13,35,19,16
050,30,107,"Montana","Wheatland County",3,14,31,18,13
050,30,107,"Montana","Wheatland County",3,15,29,23,6
050,30,107,"Montana","Wheatland County",3,16,35,11,24
050,30,107,"Montana","Wheatland County",3,17,24,13,11
050,30,107,"Montana","Wheatland County",3,18,34,13,21
050,30,107,"Montana","Wheatland County",3,19,16,6,10
050,30,107,"Montana","Wheatland County",3,20,15,6,9
050,30,107,"Montana","Wheatland County",3,21,12,7,5
050,30,107,"Montana","Wheatland County",3,22,20,7,13
050,30,107,"Montana","Wheatland County",3,23,20,13,7
050,30,107,"Montana","Wheatland County",3,24,30,16,14
050,30,107,"Montana","Wheatland County",3,25,20,11,9
050,30,107,"Montana","Wheatland County",3,26,21,12,9
050,30,107,"Montana","Wheatland County",3,27,19,6,13
050,30,107,"Montana","Wheatland County",3,28,11,7,4
050,30,107,"Montana","Wheatland County",3,29,13,8,5
050,30,107,"Montana","Wheatland County",3,30,20,9,11
050,30,107,"Montana","Wheatland County",3,31,15,9,6
050,30,107,"Montana","Wheatland County",3,32,20,15,5
050,30,107,"Montana","Wheatland County",3,33,20,12,8
050,30,107,"Montana","Wheatland County",3,34,26,11,15
050,30,107,"Montana","Wheatland County",3,35,20,14,6
050,30,107,"Montana","Wheatland County",3,36,16,7,9
050,30,107,"Montana","Wheatland County",3,37,17,6,11
050,30,107,"Montana","Wheatland County",3,38,12,6,6
050,30,107,"Montana","Wheatland County",3,39,24,8,16
050,30,107,"Montana","Wheatland County",3,40,20,8,12
050,30,107,"Montana","Wheatland County",3,41,22,13,9
050,30,107,"Montana","Wheatland County",3,42,21,9,12
050,30,107,"Montana","Wheatland County",3,43,25,12,13
050,30,107,"Montana","Wheatland County",3,44,30,17,13
050,30,107,"Montana","Wheatland County",3,45,25,7,18
050,30,107,"Montana","Wheatland County",3,46,24,14,10
050,30,107,"Montana","Wheatland County",3,47,24,15,9
050,30,107,"Montana","Wheatland County",3,48,24,10,14
050,30,107,"Montana","Wheatland County",3,49,20,10,10
050,30,107,"Montana","Wheatland County",3,50,24,13,11
050,30,107,"Montana","Wheatland County",3,51,23,16,7
050,30,107,"Montana","Wheatland County",3,52,26,18,8
050,30,107,"Montana","Wheatland County",3,53,29,15,14
050,30,107,"Montana","Wheatland County",3,54,20,14,6
050,30,107,"Montana","Wheatland County",3,55,19,10,9
050,30,107,"Montana","Wheatland County",3,56,13,8,5
050,30,107,"Montana","Wheatland County",3,57,20,12,8
050,30,107,"Montana","Wheatland County",3,58,16,8,8
050,30,107,"Montana","Wheatland County",3,59,20,10,10
050,30,107,"Montana","Wheatland County",3,60,31,16,15
050,30,107,"Montana","Wheatland County",3,61,40,20,20
050,30,107,"Montana","Wheatland County",3,62,27,14,13
050,30,107,"Montana","Wheatland County",3,63,26,12,14
050,30,107,"Montana","Wheatland County",3,64,38,14,24
050,30,107,"Montana","Wheatland County",3,65,34,15,19
050,30,107,"Montana","Wheatland County",3,66,36,20,16
050,30,107,"Montana","Wheatland County",3,67,30,15,15
050,30,107,"Montana","Wheatland County",3,68,29,13,16
050,30,107,"Montana","Wheatland County",3,69,27,11,16
050,30,107,"Montana","Wheatland County",3,70,29,12,17
050,30,107,"Montana","Wheatland County",3,71,23,14,9
050,30,107,"Montana","Wheatland County",3,72,34,22,12
050,30,107,"Montana","Wheatland County",3,73,24,14,10
050,30,107,"Montana","Wheatland County",3,74,31,17,14
050,30,107,"Montana","Wheatland County",3,75,19,10,9
050,30,107,"Montana","Wheatland County",3,76,16,8,8
050,30,107,"Montana","Wheatland County",3,77,18,8,10
050,30,107,"Montana","Wheatland County",3,78,23,14,9
050,30,107,"Montana","Wheatland County",3,79,16,7,9
050,30,107,"Montana","Wheatland County",3,80,14,6,8
050,30,107,"Montana","Wheatland County",3,81,14,8,6
050,30,107,"Montana","Wheatland County",3,82,9,6,3
050,30,107,"Montana","Wheatland County",3,83,9,6,3
050,30,107,"Montana","Wheatland County",3,84,4,1,3
050,30,107,"Montana","Wheatland County",3,85,49,16,33
050,30,107,"Montana","Wheatland County",4,0,32,13,19
050,30,107,"Montana","Wheatland County",4,1,22,11,11
050,30,107,"Montana","Wheatland County",4,2,26,11,15
050,30,107,"Montana","Wheatland County",4,3,23,14,9
050,30,107,"Montana","Wheatland County",4,4,23,15,8
050,30,107,"Montana","Wheatland County",4,5,19,8,11
050,30,107,"Montana","Wheatland County",4,6,26,10,16
050,30,107,"Montana","Wheatland County",4,7,27,8,19
050,30,107,"Montana","Wheatland County",4,8,32,17,15
050,30,107,"Montana","Wheatland County",4,9,27,17,10
050,30,107,"Montana","Wheatland County",4,10,34,19,15
050,30,107,"Montana","Wheatland County",4,11,38,22,16
050,30,107,"Montana","Wheatland County",4,12,32,22,10
050,30,107,"Montana","Wheatland County",4,13,40,21,19
050,30,107,"Montana","Wheatland County",4,14,35,15,20
050,30,107,"Montana","Wheatland County",4,15,17,11,6
050,30,107,"Montana","Wheatland County",4,16,39,20,19
050,30,107,"Montana","Wheatland County",4,17,28,18,10
050,30,107,"Montana","Wheatland County",4,18,28,9,19
050,30,107,"Montana","Wheatland County",4,19,24,9,15
050,30,107,"Montana","Wheatland County",4,20,14,5,9
050,30,107,"Montana","Wheatland County",4,21,14,7,7
050,30,107,"Montana","Wheatland County",4,22,16,6,10
050,30,107,"Montana","Wheatland County",4,23,14,6,8
050,30,107,"Montana","Wheatland County",4,24,36,20,16
050,30,107,"Montana","Wheatland County",4,25,18,13,5
050,30,107,"Montana","Wheatland County",4,26,27,14,13
050,30,107,"Montana","Wheatland County",4,27,22,13,9
050,30,107,"Montana","Wheatland County",4,28,18,8,10
050,30,107,"Montana","Wheatland County",4,29,18,10,8
050,30,107,"Montana","Wheatland County",4,30,16,8,8
050,30,107,"Montana","Wheatland County",4,31,17,6,11
050,30,107,"Montana","Wheatland County",4,32,17,13,4
050,30,107,"Montana","Wheatland County",4,33,19,15,4
050,30,107,"Montana","Wheatland County",4,34,24,11,13
050,30,107,"Montana","Wheatland County",4,35,22,13,9
050,30,107,"Montana","Wheatland County",4,36,15,6,9
050,30,107,"Montana","Wheatland County",4,37,15,7,8
050,30,107,"Montana","Wheatland County",4,38,19,10,9
050,30,107,"Montana","Wheatland County",4,39,21,7,14
050,30,107,"Montana","Wheatland County",4,40,17,4,13
050,30,107,"Montana","Wheatland County",4,41,23,14,9
050,30,107,"Montana","Wheatland County",4,42,17,9,8
050,30,107,"Montana","Wheatland County",4,43,26,9,17
050,30,107,"Montana","Wheatland County",4,44,27,14,13
050,30,107,"Montana","Wheatland County",4,45,26,10,16
050,30,107,"Montana","Wheatland County",4,46,25,13,12
050,30,107,"Montana","Wheatland County",4,47,20,10,10
050,30,107,"Montana","Wheatland County",4,48,26,11,15
050,30,107,"Montana","Wheatland County",4,49,18,10,8
050,30,107,"Montana","Wheatland County",4,50,22,13,9
050,30,107,"Montana","Wheatland County",4,51,21,10,11
050,30,107,"Montana","Wheatland County",4,52,30,23,7
050,30,107,"Montana","Wheatland County",4,53,26,15,11
050,30,107,"Montana","Wheatland County",4,54,25,13,12
050,30,107,"Montana","Wheatland County",4,55,26,16,10
050,30,107,"Montana","Wheatland County",4,56,17,10,7
050,30,107,"Montana","Wheatland County",4,57,19,11,8
050,30,107,"Montana","Wheatland County",4,58,15,9,6
050,30,107,"Montana","Wheatland County",4,59,14,6,8
050,30,107,"Montana","Wheatland County",4,60,22,12,10
050,30,107,"Montana","Wheatland County",4,61,38,19,19
050,30,107,"Montana","Wheatland County",4,62,31,17,14
050,30,107,"Montana","Wheatland County",4,63,24,11,13
050,30,107,"Montana","Wheatland County",4,64,27,13,14
050,30,107,"Montana","Wheatland County",4,65,40,15,25
050,30,107,"Montana","Wheatland County",4,66,33,12,21
050,30,107,"Montana","Wheatland County",4,67,35,22,13
050,30,107,"Montana","Wheatland County",4,68,33,15,18
050,30,107,"Montana","Wheatland County",4,69,27,14,13
050,30,107,"Montana","Wheatland County",4,70,23,8,15
050,30,107,"Montana","Wheatland County",4,71,30,13,17
050,30,107,"Montana","Wheatland County",4,72,29,17,12
050,30,107,"Montana","Wheatland County",4,73,28,19,9
050,30,107,"Montana","Wheatland County",4,74,27,15,12
050,30,107,"Montana","Wheatland County",4,75,27,16,11
050,30,107,"Montana","Wheatland County",4,76,16,7,9
050,30,107,"Montana","Wheatland County",4,77,16,8,8
050,30,107,"Montana","Wheatland County",4,78,20,11,9
050,30,107,"Montana","Wheatland County",4,79,18,9,9
050,30,107,"Montana","Wheatland County",4,80,15,7,8
050,30,107,"Montana","Wheatland County",4,81,13,5,8
050,30,107,"Montana","Wheatland County",4,82,13,7,6
050,30,107,"Montana","Wheatland County",4,83,7,6,1
050,30,107,"Montana","Wheatland County",4,84,7,4,3
050,30,107,"Montana","Wheatland County",4,85,45,15,30
050,30,107,"Montana","Wheatland County",5,0,32,13,19
050,30,107,"Montana","Wheatland County",5,1,26,16,10
050,30,107,"Montana","Wheatland County",5,2,17,6,11
050,30,107,"Montana","Wheatland County",5,3,29,18,11
050,30,107,"Montana","Wheatland County",5,4,26,15,11
050,30,107,"Montana","Wheatland County",5,5,18,7,11
050,30,107,"Montana","Wheatland County",5,6,29,13,16
050,30,107,"Montana","Wheatland County",5,7,27,6,21
050,30,107,"Montana","Wheatland County",5,8,29,15,14
050,30,107,"Montana","Wheatland County",5,9,25,15,10
050,30,107,"Montana","Wheatland County",5,10,31,18,13
050,30,107,"Montana","Wheatland County",5,11,38,26,12
050,30,107,"Montana","Wheatland County",5,12,32,22,10
050,30,107,"Montana","Wheatland County",5,13,34,22,12
050,30,107,"Montana","Wheatland County",5,14,41,18,23
050,30,107,"Montana","Wheatland County",5,15,26,12,14
050,30,107,"Montana","Wheatland County",5,16,29,11,18
050,30,107,"Montana","Wheatland County",5,17,34,26,8
050,30,107,"Montana","Wheatland County",5,18,31,14,17
050,30,107,"Montana","Wheatland County",5,19,19,7,12
050,30,107,"Montana","Wheatland County",5,20,21,9,12
050,30,107,"Montana","Wheatland County",5,21,9,4,5
050,30,107,"Montana","Wheatland County",5,22,21,8,13
050,30,107,"Montana","Wheatland County",5,23,13,6,7
050,30,107,"Montana","Wheatland County",5,24,31,10,21
050,30,107,"Montana","Wheatland County",5,25,26,18,8
050,30,107,"Montana","Wheatland County",5,26,21,11,10
050,30,107,"Montana","Wheatland County",5,27,29,17,12
050,30,107,"Montana","Wheatland County",5,28,16,10,6
050,30,107,"Montana","Wheatland County",5,29,23,13,10
050,30,107,"Montana","Wheatland County",5,30,20,10,10
050,30,107,"Montana","Wheatland County",5,31,12,4,8
050,30,107,"Montana","Wheatland County",5,32,15,9,6
050,30,107,"Montana","Wheatland County",5,33,16,13,3
050,30,107,"Montana","Wheatland County",5,34,21,11,10
050,30,107,"Montana","Wheatland County",5,35,23,16,7
050,30,107,"Montana","Wheatland County",5,36,13,5,8
050,30,107,"Montana","Wheatland County",5,37,13,5,8
050,30,107,"Montana","Wheatland County",5,38,17,10,7
050,30,107,"Montana","Wheatland County",5,39,24,9,15
050,30,107,"Montana","Wheatland County",5,40,16,5,11
050,30,107,"Montana","Wheatland County",5,41,24,11,13
050,30,107,"Montana","Wheatland County",5,42,20,10,10
050,30,107,"Montana","Wheatland County",5,43,23,9,14
050,30,107,"Montana","Wheatland County",5,44,30,13,17
050,30,107,"Montana","Wheatland County",5,45,26,10,16
050,30,107,"Montana","Wheatland County",5,46,27,16,11
050,30,107,"Montana","Wheatland County",5,47,22,9,13
050,30,107,"Montana","Wheatland County",5,48,25,8,17
050,30,107,"Montana","Wheatland County",5,49,19,10,9
050,30,107,"Montana","Wheatland County",5,50,20,13,7
050,30,107,"Montana","Wheatland County",5,51,21,11,10
050,30,107,"Montana","Wheatland County",5,52,25,14,11
050,30,107,"Montana","Wheatland County",5,53,31,19,12
050,30,107,"Montana","Wheatland County",5,54,24,15,9
050,30,107,"Montana","Wheatland County",5,55,25,11,14
050,30,107,"Montana","Wheatland County",5,56,24,17,7
050,30,107,"Montana","Wheatland County",5,57,25,13,12
050,30,107,"Montana","Wheatland County",5,58,13,8,5
050,30,107,"Montana","Wheatland County",5,59,14,9,5
050,30,107,"Montana","Wheatland County",5,60,17,11,6
050,30,107,"Montana","Wheatland County",5,61,31,14,17
050,30,107,"Montana","Wheatland County",5,62,32,18,14
050,30,107,"Montana","Wheatland County",5,63,25,13,12
050,30,107,"Montana","Wheatland County",5,64,26,13,13
050,30,107,"Montana","Wheatland County",5,65,30,16,14
050,30,107,"Montana","Wheatland County",5,66,37,12,25
050,30,107,"Montana","Wheatland County",5,67,28,10,18
050,30,107,"Montana","Wheatland County",5,68,40,23,17
050,30,107,"Montana","Wheatland County",5,69,33,17,16
050,30,107,"Montana","Wheatland County",5,70,24,13,11
050,30,107,"Montana","Wheatland County",5,71,25,9,16
050,30,107,"Montana","Wheatland County",5,72,36,16,20
050,30,107,"Montana","Wheatland County",5,73,20,12,8
050,30,107,"Montana","Wheatland County",5,74,34,22,12
050,30,107,"Montana","Wheatland County",5,75,25,15,10
050,30,107,"Montana","Wheatland County",5,76,25,14,11
050,30,107,"Montana","Wheatland County",5,77,16,7,9
050,30,107,"Montana","Wheatland County",5,78,19,11,8
050,30,107,"Montana","Wheatland County",5,79,17,8,9
050,30,107,"Montana","Wheatland County",5,80,18,8,10
050,30,107,"Montana","Wheatland County",5,81,13,5,8
050,30,107,"Montana","Wheatland County",5,82,13,4,9
050,30,107,"Montana","Wheatland County",5,83,12,6,6
050,30,107,"Montana","Wheatland County",5,84,5,4,1
050,30,107,"Montana","Wheatland County",5,85,45,17,28
050,30,109,"Montana","Wibaux County",1,0,5,3,2
050,30,109,"Montana","Wibaux County",1,1,7,5,2
050,30,109,"Montana","Wibaux County",1,2,12,8,4
050,30,109,"Montana","Wibaux County",1,3,9,2,7
050,30,109,"Montana","Wibaux County",1,4,10,3,7
050,30,109,"Montana","Wibaux County",1,5,16,9,7
050,30,109,"Montana","Wibaux County",1,6,15,6,9
050,30,109,"Montana","Wibaux County",1,7,10,5,5
050,30,109,"Montana","Wibaux County",1,8,9,6,3
050,30,109,"Montana","Wibaux County",1,9,10,6,4
050,30,109,"Montana","Wibaux County",1,10,10,5,5
050,30,109,"Montana","Wibaux County",1,11,14,7,7
050,30,109,"Montana","Wibaux County",1,12,9,6,3
050,30,109,"Montana","Wibaux County",1,13,9,8,1
050,30,109,"Montana","Wibaux County",1,14,11,6,5
050,30,109,"Montana","Wibaux County",1,15,12,4,8
050,30,109,"Montana","Wibaux County",1,16,10,3,7
050,30,109,"Montana","Wibaux County",1,17,11,7,4
050,30,109,"Montana","Wibaux County",1,18,7,2,5
050,30,109,"Montana","Wibaux County",1,19,11,4,7
050,30,109,"Montana","Wibaux County",1,20,12,5,7
050,30,109,"Montana","Wibaux County",1,21,10,5,5
050,30,109,"Montana","Wibaux County",1,22,9,4,5
050,30,109,"Montana","Wibaux County",1,23,8,5,3
050,30,109,"Montana","Wibaux County",1,24,9,5,4
050,30,109,"Montana","Wibaux County",1,25,7,1,6
050,30,109,"Montana","Wibaux County",1,26,10,8,2
050,30,109,"Montana","Wibaux County",1,27,11,7,4
050,30,109,"Montana","Wibaux County",1,28,9,6,3
050,30,109,"Montana","Wibaux County",1,29,6,3,3
050,30,109,"Montana","Wibaux County",1,30,4,2,2
050,30,109,"Montana","Wibaux County",1,31,11,4,7
050,30,109,"Montana","Wibaux County",1,32,4,2,2
050,30,109,"Montana","Wibaux County",1,33,4,2,2
050,30,109,"Montana","Wibaux County",1,34,8,3,5
050,30,109,"Montana","Wibaux County",1,35,12,7,5
050,30,109,"Montana","Wibaux County",1,36,13,7,6
050,30,109,"Montana","Wibaux County",1,37,11,6,5
050,30,109,"Montana","Wibaux County",1,38,11,5,6
050,30,109,"Montana","Wibaux County",1,39,13,5,8
050,30,109,"Montana","Wibaux County",1,40,9,5,4
050,30,109,"Montana","Wibaux County",1,41,8,5,3
050,30,109,"Montana","Wibaux County",1,42,9,3,6
050,30,109,"Montana","Wibaux County",1,43,5,2,3
050,30,109,"Montana","Wibaux County",1,44,14,9,5
050,30,109,"Montana","Wibaux County",1,45,11,7,4
050,30,109,"Montana","Wibaux County",1,46,7,4,3
050,30,109,"Montana","Wibaux County",1,47,6,5,1
050,30,109,"Montana","Wibaux County",1,48,11,7,4
050,30,109,"Montana","Wibaux County",1,49,11,5,6
050,30,109,"Montana","Wibaux County",1,50,9,4,5
050,30,109,"Montana","Wibaux County",1,51,10,4,6
050,30,109,"Montana","Wibaux County",1,52,12,4,8
050,30,109,"Montana","Wibaux County",1,53,16,8,8
050,30,109,"Montana","Wibaux County",1,54,12,8,4
050,30,109,"Montana","Wibaux County",1,55,16,8,8
050,30,109,"Montana","Wibaux County",1,56,15,8,7
050,30,109,"Montana","Wibaux County",1,57,11,5,6
050,30,109,"Montana","Wibaux County",1,58,15,10,5
050,30,109,"Montana","Wibaux County",1,59,18,11,7
050,30,109,"Montana","Wibaux County",1,60,18,12,6
050,30,109,"Montana","Wibaux County",1,61,15,9,6
050,30,109,"Montana","Wibaux County",1,62,15,8,7
050,30,109,"Montana","Wibaux County",1,63,16,9,7
050,30,109,"Montana","Wibaux County",1,64,16,10,6
050,30,109,"Montana","Wibaux County",1,65,15,7,8
050,30,109,"Montana","Wibaux County",1,66,9,4,5
050,30,109,"Montana","Wibaux County",1,67,14,7,7
050,30,109,"Montana","Wibaux County",1,68,16,7,9
050,30,109,"Montana","Wibaux County",1,69,16,7,9
050,30,109,"Montana","Wibaux County",1,70,11,6,5
050,30,109,"Montana","Wibaux County",1,71,12,5,7
050,30,109,"Montana","Wibaux County",1,72,10,6,4
050,30,109,"Montana","Wibaux County",1,73,8,5,3
050,30,109,"Montana","Wibaux County",1,74,13,8,5
050,30,109,"Montana","Wibaux County",1,75,7,3,4
050,30,109,"Montana","Wibaux County",1,76,6,2,4
050,30,109,"Montana","Wibaux County",1,77,8,2,6
050,30,109,"Montana","Wibaux County",1,78,10,3,7
050,30,109,"Montana","Wibaux County",1,79,13,5,8
050,30,109,"Montana","Wibaux County",1,80,9,6,3
050,30,109,"Montana","Wibaux County",1,81,8,5,3
050,30,109,"Montana","Wibaux County",1,82,9,4,5
050,30,109,"Montana","Wibaux County",1,83,7,3,4
050,30,109,"Montana","Wibaux County",1,84,10,6,4
050,30,109,"Montana","Wibaux County",1,85,32,12,20
050,30,109,"Montana","Wibaux County",2,0,8,4,4
050,30,109,"Montana","Wibaux County",2,1,7,5,2
050,30,109,"Montana","Wibaux County",2,2,12,8,4
050,30,109,"Montana","Wibaux County",2,3,10,3,7
050,30,109,"Montana","Wibaux County",2,4,10,3,7
050,30,109,"Montana","Wibaux County",2,5,15,8,7
050,30,109,"Montana","Wibaux County",2,6,14,6,8
050,30,109,"Montana","Wibaux County",2,7,11,5,6
050,30,109,"Montana","Wibaux County",2,8,9,6,3
050,30,109,"Montana","Wibaux County",2,9,10,6,4
050,30,109,"Montana","Wibaux County",2,10,10,5,5
050,30,109,"Montana","Wibaux County",2,11,13,6,7
050,30,109,"Montana","Wibaux County",2,12,10,6,4
050,30,109,"Montana","Wibaux County",2,13,8,7,1
050,30,109,"Montana","Wibaux County",2,14,10,6,4
050,30,109,"Montana","Wibaux County",2,15,12,4,8
050,30,109,"Montana","Wibaux County",2,16,10,3,7
050,30,109,"Montana","Wibaux County",2,17,11,6,5
050,30,109,"Montana","Wibaux County",2,18,8,3,5
050,30,109,"Montana","Wibaux County",2,19,10,3,7
050,30,109,"Montana","Wibaux County",2,20,12,5,7
050,30,109,"Montana","Wibaux County",2,21,10,5,5
050,30,109,"Montana","Wibaux County",2,22,9,4,5
050,30,109,"Montana","Wibaux County",2,23,8,5,3
050,30,109,"Montana","Wibaux County",2,24,9,5,4
050,30,109,"Montana","Wibaux County",2,25,7,2,5
050,30,109,"Montana","Wibaux County",2,26,9,6,3
050,30,109,"Montana","Wibaux County",2,27,11,7,4
050,30,109,"Montana","Wibaux County",2,28,10,7,3
050,30,109,"Montana","Wibaux County",2,29,7,4,3
050,30,109,"Montana","Wibaux County",2,30,4,2,2
050,30,109,"Montana","Wibaux County",2,31,8,3,5
050,30,109,"Montana","Wibaux County",2,32,5,2,3
050,30,109,"Montana","Wibaux County",2,33,4,2,2
050,30,109,"Montana","Wibaux County",2,34,8,3,5
050,30,109,"Montana","Wibaux County",2,35,12,7,5
050,30,109,"Montana","Wibaux County",2,36,13,7,6
050,30,109,"Montana","Wibaux County",2,37,12,6,6
050,30,109,"Montana","Wibaux County",2,38,11,5,6
050,30,109,"Montana","Wibaux County",2,39,12,5,7
050,30,109,"Montana","Wibaux County",2,40,10,5,5
050,30,109,"Montana","Wibaux County",2,41,8,5,3
050,30,109,"Montana","Wibaux County",2,42,9,4,5
050,30,109,"Montana","Wibaux County",2,43,6,2,4
050,30,109,"Montana","Wibaux County",2,44,12,7,5
050,30,109,"Montana","Wibaux County",2,45,12,8,4
050,30,109,"Montana","Wibaux County",2,46,8,5,3
050,30,109,"Montana","Wibaux County",2,47,6,5,1
050,30,109,"Montana","Wibaux County",2,48,10,6,4
050,30,109,"Montana","Wibaux County",2,49,10,5,5
050,30,109,"Montana","Wibaux County",2,50,10,5,5
050,30,109,"Montana","Wibaux County",2,51,10,4,6
050,30,109,"Montana","Wibaux County",2,52,11,4,7
050,30,109,"Montana","Wibaux County",2,53,15,7,8
050,30,109,"Montana","Wibaux County",2,54,13,8,5
050,30,109,"Montana","Wibaux County",2,55,15,8,7
050,30,109,"Montana","Wibaux County",2,56,15,7,8
050,30,109,"Montana","Wibaux County",2,57,12,6,6
050,30,109,"Montana","Wibaux County",2,58,14,9,5
050,30,109,"Montana","Wibaux County",2,59,17,11,6
050,30,109,"Montana","Wibaux County",2,60,17,11,6
050,30,109,"Montana","Wibaux County",2,61,16,10,6
050,30,109,"Montana","Wibaux County",2,62,15,8,7
050,30,109,"Montana","Wibaux County",2,63,16,9,7
050,30,109,"Montana","Wibaux County",2,64,16,10,6
050,30,109,"Montana","Wibaux County",2,65,15,7,8
050,30,109,"Montana","Wibaux County",2,66,10,5,5
050,30,109,"Montana","Wibaux County",2,67,13,7,6
050,30,109,"Montana","Wibaux County",2,68,15,7,8
050,30,109,"Montana","Wibaux County",2,69,16,7,9
050,30,109,"Montana","Wibaux County",2,70,12,6,6
050,30,109,"Montana","Wibaux County",2,71,12,5,7
050,30,109,"Montana","Wibaux County",2,72,11,6,5
050,30,109,"Montana","Wibaux County",2,73,8,5,3
050,30,109,"Montana","Wibaux County",2,74,12,7,5
050,30,109,"Montana","Wibaux County",2,75,8,4,4
050,30,109,"Montana","Wibaux County",2,76,6,2,4
050,30,109,"Montana","Wibaux County",2,77,8,2,6
050,30,109,"Montana","Wibaux County",2,78,10,3,7
050,30,109,"Montana","Wibaux County",2,79,12,4,8
050,30,109,"Montana","Wibaux County",2,80,10,6,4
050,30,109,"Montana","Wibaux County",2,81,8,5,3
050,30,109,"Montana","Wibaux County",2,82,9,4,5
050,30,109,"Montana","Wibaux County",2,83,7,3,4
050,30,109,"Montana","Wibaux County",2,84,9,5,4
050,30,109,"Montana","Wibaux County",2,85,32,13,19
050,30,109,"Montana","Wibaux County",3,0,8,5,3
050,30,109,"Montana","Wibaux County",3,1,8,4,4
050,30,109,"Montana","Wibaux County",3,2,9,6,3
050,30,109,"Montana","Wibaux County",3,3,12,8,4
050,30,109,"Montana","Wibaux County",3,4,9,2,7
050,30,109,"Montana","Wibaux County",3,5,13,3,10
050,30,109,"Montana","Wibaux County",3,6,16,9,7
050,30,109,"Montana","Wibaux County",3,7,14,7,7
050,30,109,"Montana","Wibaux County",3,8,10,4,6
050,30,109,"Montana","Wibaux County",3,9,9,6,3
050,30,109,"Montana","Wibaux County",3,10,9,6,3
050,30,109,"Montana","Wibaux County",3,11,11,5,6
050,30,109,"Montana","Wibaux County",3,12,12,6,6
050,30,109,"Montana","Wibaux County",3,13,9,6,3
050,30,109,"Montana","Wibaux County",3,14,8,7,1
050,30,109,"Montana","Wibaux County",3,15,11,7,4
050,30,109,"Montana","Wibaux County",3,16,13,5,8
050,30,109,"Montana","Wibaux County",3,17,10,3,7
050,30,109,"Montana","Wibaux County",3,18,10,5,5
050,30,109,"Montana","Wibaux County",3,19,8,2,6
050,30,109,"Montana","Wibaux County",3,20,11,3,8
050,30,109,"Montana","Wibaux County",3,21,9,4,5
050,30,109,"Montana","Wibaux County",3,22,11,6,5
050,30,109,"Montana","Wibaux County",3,23,9,4,5
050,30,109,"Montana","Wibaux County",3,24,8,5,3
050,30,109,"Montana","Wibaux County",3,25,7,3,4
050,30,109,"Montana","Wibaux County",3,26,5,2,3
050,30,109,"Montana","Wibaux County",3,27,14,7,7
050,30,109,"Montana","Wibaux County",3,28,10,7,3
050,30,109,"Montana","Wibaux County",3,29,8,6,2
050,30,109,"Montana","Wibaux County",3,30,6,4,2
050,30,109,"Montana","Wibaux County",3,31,5,2,3
050,30,109,"Montana","Wibaux County",3,32,9,3,6
050,30,109,"Montana","Wibaux County",3,33,8,5,3
050,30,109,"Montana","Wibaux County",3,34,5,3,2
050,30,109,"Montana","Wibaux County",3,35,7,3,4
050,30,109,"Montana","Wibaux County",3,36,11,5,6
050,30,109,"Montana","Wibaux County",3,37,14,8,6
050,30,109,"Montana","Wibaux County",3,38,12,6,6
050,30,109,"Montana","Wibaux County",3,39,13,5,8
050,30,109,"Montana","Wibaux County",3,40,11,5,6
050,30,109,"Montana","Wibaux County",3,41,10,5,5
050,30,109,"Montana","Wibaux County",3,42,9,5,4
050,30,109,"Montana","Wibaux County",3,43,10,5,5
050,30,109,"Montana","Wibaux County",3,44,6,2,4
050,30,109,"Montana","Wibaux County",3,45,12,7,5
050,30,109,"Montana","Wibaux County",3,46,12,8,4
050,30,109,"Montana","Wibaux County",3,47,8,5,3
050,30,109,"Montana","Wibaux County",3,48,6,5,1
050,30,109,"Montana","Wibaux County",3,49,10,6,4
050,30,109,"Montana","Wibaux County",3,50,10,5,5
050,30,109,"Montana","Wibaux County",3,51,11,6,5
050,30,109,"Montana","Wibaux County",3,52,10,4,6
050,30,109,"Montana","Wibaux County",3,53,12,5,7
050,30,109,"Montana","Wibaux County",3,54,15,7,8
050,30,109,"Montana","Wibaux County",3,55,13,8,5
050,30,109,"Montana","Wibaux County",3,56,16,8,8
050,30,109,"Montana","Wibaux County",3,57,15,7,8
050,30,109,"Montana","Wibaux County",3,58,13,6,7
050,30,109,"Montana","Wibaux County",3,59,12,7,5
050,30,109,"Montana","Wibaux County",3,60,16,10,6
050,30,109,"Montana","Wibaux County",3,61,19,13,6
050,30,109,"Montana","Wibaux County",3,62,15,10,5
050,30,109,"Montana","Wibaux County",3,63,16,8,8
050,30,109,"Montana","Wibaux County",3,64,18,11,7
050,30,109,"Montana","Wibaux County",3,65,17,11,6
050,30,109,"Montana","Wibaux County",3,66,13,6,7
050,30,109,"Montana","Wibaux County",3,67,11,5,6
050,30,109,"Montana","Wibaux County",3,68,13,7,6
050,30,109,"Montana","Wibaux County",3,69,14,7,7
050,30,109,"Montana","Wibaux County",3,70,15,7,8
050,30,109,"Montana","Wibaux County",3,71,12,6,6
050,30,109,"Montana","Wibaux County",3,72,11,5,6
050,30,109,"Montana","Wibaux County",3,73,11,6,5
050,30,109,"Montana","Wibaux County",3,74,9,5,4
050,30,109,"Montana","Wibaux County",3,75,11,6,5
050,30,109,"Montana","Wibaux County",3,76,7,4,3
050,30,109,"Montana","Wibaux County",3,77,7,2,5
050,30,109,"Montana","Wibaux County",3,78,9,3,6
050,30,109,"Montana","Wibaux County",3,79,8,2,6
050,30,109,"Montana","Wibaux County",3,80,12,4,8
050,30,109,"Montana","Wibaux County",3,81,10,6,4
050,30,109,"Montana","Wibaux County",3,82,8,5,3
050,30,109,"Montana","Wibaux County",3,83,8,3,5
050,30,109,"Montana","Wibaux County",3,84,4,1,3
050,30,109,"Montana","Wibaux County",3,85,30,13,17
050,30,109,"Montana","Wibaux County",4,0,10,5,5
050,30,109,"Montana","Wibaux County",4,1,8,5,3
050,30,109,"Montana","Wibaux County",4,2,9,4,5
050,30,109,"Montana","Wibaux County",4,3,10,7,3
050,30,109,"Montana","Wibaux County",4,4,12,8,4
050,30,109,"Montana","Wibaux County",4,5,11,4,7
050,30,109,"Montana","Wibaux County",4,6,13,3,10
050,30,109,"Montana","Wibaux County",4,7,16,9,7
050,30,109,"Montana","Wibaux County",4,8,14,7,7
050,30,109,"Montana","Wibaux County",4,9,10,4,6
050,30,109,"Montana","Wibaux County",4,10,9,6,3
050,30,109,"Montana","Wibaux County",4,11,11,6,5
050,30,109,"Montana","Wibaux County",4,12,11,5,6
050,30,109,"Montana","Wibaux County",4,13,13,7,6
050,30,109,"Montana","Wibaux County",4,14,9,6,3
050,30,109,"Montana","Wibaux County",4,15,8,7,1
050,30,109,"Montana","Wibaux County",4,16,10,6,4
050,30,109,"Montana","Wibaux County",4,17,12,4,8
050,30,109,"Montana","Wibaux County",4,18,10,4,6
050,30,109,"Montana","Wibaux County",4,19,8,4,4
050,30,109,"Montana","Wibaux County",4,20,9,2,7
050,30,109,"Montana","Wibaux County",4,21,12,3,9
050,30,109,"Montana","Wibaux County",4,22,12,5,7
050,30,109,"Montana","Wibaux County",4,23,11,6,5
050,30,109,"Montana","Wibaux County",4,24,6,3,3
050,30,109,"Montana","Wibaux County",4,25,7,5,2
050,30,109,"Montana","Wibaux County",4,26,7,3,4
050,30,109,"Montana","Wibaux County",4,27,7,4,3
050,30,109,"Montana","Wibaux County",4,28,14,7,7
050,30,109,"Montana","Wibaux County",4,29,10,7,3
050,30,109,"Montana","Wibaux County",4,30,9,6,3
050,30,109,"Montana","Wibaux County",4,31,6,4,2
050,30,109,"Montana","Wibaux County",4,32,5,2,3
050,30,109,"Montana","Wibaux County",4,33,9,3,6
050,30,109,"Montana","Wibaux County",4,34,6,3,3
050,30,109,"Montana","Wibaux County",4,35,7,4,3
050,30,109,"Montana","Wibaux County",4,36,7,3,4
050,30,109,"Montana","Wibaux County",4,37,11,5,6
050,30,109,"Montana","Wibaux County",4,38,14,7,7
050,30,109,"Montana","Wibaux County",4,39,12,6,6
050,30,109,"Montana","Wibaux County",4,40,12,5,7
050,30,109,"Montana","Wibaux County",4,41,11,5,6
050,30,109,"Montana","Wibaux County",4,42,11,6,5
050,30,109,"Montana","Wibaux County",4,43,8,4,4
050,30,109,"Montana","Wibaux County",4,44,10,5,5
050,30,109,"Montana","Wibaux County",4,45,6,2,4
050,30,109,"Montana","Wibaux County",4,46,13,7,6
050,30,109,"Montana","Wibaux County",4,47,12,8,4
050,30,109,"Montana","Wibaux County",4,48,8,5,3
050,30,109,"Montana","Wibaux County",4,49,6,5,1
050,30,109,"Montana","Wibaux County",4,50,10,6,4
050,30,109,"Montana","Wibaux County",4,51,11,6,5
050,30,109,"Montana","Wibaux County",4,52,11,6,5
050,30,109,"Montana","Wibaux County",4,53,10,4,6
050,30,109,"Montana","Wibaux County",4,54,13,6,7
050,30,109,"Montana","Wibaux County",4,55,15,7,8
050,30,109,"Montana","Wibaux County",4,56,13,8,5
050,30,109,"Montana","Wibaux County",4,57,17,8,9
050,30,109,"Montana","Wibaux County",4,58,15,7,8
050,30,109,"Montana","Wibaux County",4,59,12,6,6
050,30,109,"Montana","Wibaux County",4,60,11,6,5
050,30,109,"Montana","Wibaux County",4,61,16,10,6
050,30,109,"Montana","Wibaux County",4,62,16,11,5
050,30,109,"Montana","Wibaux County",4,63,15,10,5
050,30,109,"Montana","Wibaux County",4,64,16,8,8
050,30,109,"Montana","Wibaux County",4,65,16,10,6
050,30,109,"Montana","Wibaux County",4,66,15,9,6
050,30,109,"Montana","Wibaux County",4,67,14,6,8
050,30,109,"Montana","Wibaux County",4,68,11,5,6
050,30,109,"Montana","Wibaux County",4,69,11,5,6
050,30,109,"Montana","Wibaux County",4,70,14,7,7
050,30,109,"Montana","Wibaux County",4,71,14,7,7
050,30,109,"Montana","Wibaux County",4,72,12,6,6
050,30,109,"Montana","Wibaux County",4,73,11,4,7
050,30,109,"Montana","Wibaux County",4,74,12,6,6
050,30,109,"Montana","Wibaux County",4,75,5,4,1
050,30,109,"Montana","Wibaux County",4,76,9,5,4
050,30,109,"Montana","Wibaux County",4,77,7,4,3
050,30,109,"Montana","Wibaux County",4,78,7,2,5
050,30,109,"Montana","Wibaux County",4,79,7,1,6
050,30,109,"Montana","Wibaux County",4,80,7,1,6
050,30,109,"Montana","Wibaux County",4,81,12,4,8
050,30,109,"Montana","Wibaux County",4,82,10,6,4
050,30,109,"Montana","Wibaux County",4,83,7,4,3
050,30,109,"Montana","Wibaux County",4,84,5,3,2
050,30,109,"Montana","Wibaux County",4,85,28,12,16
050,30,109,"Montana","Wibaux County",5,0,10,5,5
050,30,109,"Montana","Wibaux County",5,1,12,7,5
050,30,109,"Montana","Wibaux County",5,2,8,5,3
050,30,109,"Montana","Wibaux County",5,3,8,3,5
050,30,109,"Montana","Wibaux County",5,4,10,6,4
050,30,109,"Montana","Wibaux County",5,5,11,7,4
050,30,109,"Montana","Wibaux County",5,6,10,3,7
050,30,109,"Montana","Wibaux County",5,7,13,3,10
050,30,109,"Montana","Wibaux County",5,8,13,7,6
050,30,109,"Montana","Wibaux County",5,9,16,9,7
050,30,109,"Montana","Wibaux County",5,10,11,4,7
050,30,109,"Montana","Wibaux County",5,11,9,6,3
050,30,109,"Montana","Wibaux County",5,12,9,6,3
050,30,109,"Montana","Wibaux County",5,13,12,5,7
050,30,109,"Montana","Wibaux County",5,14,14,8,6
050,30,109,"Montana","Wibaux County",5,15,9,6,3
050,30,109,"Montana","Wibaux County",5,16,8,7,1
050,30,109,"Montana","Wibaux County",5,17,8,5,3
050,30,109,"Montana","Wibaux County",5,18,8,3,5
050,30,109,"Montana","Wibaux County",5,19,8,3,5
050,30,109,"Montana","Wibaux County",5,20,9,3,6
050,30,109,"Montana","Wibaux County",5,21,11,2,9
050,30,109,"Montana","Wibaux County",5,22,12,2,10
050,30,109,"Montana","Wibaux County",5,23,13,5,8
050,30,109,"Montana","Wibaux County",5,24,11,6,5
050,30,109,"Montana","Wibaux County",5,25,6,3,3
050,30,109,"Montana","Wibaux County",5,26,7,5,2
050,30,109,"Montana","Wibaux County",5,27,11,6,5
050,30,109,"Montana","Wibaux County",5,28,8,4,4
050,30,109,"Montana","Wibaux County",5,29,14,7,7
050,30,109,"Montana","Wibaux County",5,30,12,7,5
050,30,109,"Montana","Wibaux County",5,31,8,5,3
050,30,109,"Montana","Wibaux County",5,32,6,4,2
050,30,109,"Montana","Wibaux County",5,33,6,2,4
050,30,109,"Montana","Wibaux County",5,34,8,3,5
050,30,109,"Montana","Wibaux County",5,35,6,3,3
050,30,109,"Montana","Wibaux County",5,36,9,5,4
050,30,109,"Montana","Wibaux County",5,37,8,3,5
050,30,109,"Montana","Wibaux County",5,38,11,5,6
050,30,109,"Montana","Wibaux County",5,39,13,6,7
050,30,109,"Montana","Wibaux County",5,40,12,6,6
050,30,109,"Montana","Wibaux County",5,41,9,3,6
050,30,109,"Montana","Wibaux County",5,42,11,5,6
050,30,109,"Montana","Wibaux County",5,43,11,6,5
050,30,109,"Montana","Wibaux County",5,44,9,5,4
050,30,109,"Montana","Wibaux County",5,45,10,5,5
050,30,109,"Montana","Wibaux County",5,46,6,2,4
050,30,109,"Montana","Wibaux County",5,47,13,7,6
050,30,109,"Montana","Wibaux County",5,48,11,7,4
050,30,109,"Montana","Wibaux County",5,49,9,5,4
050,30,109,"Montana","Wibaux County",5,50,6,5,1
050,30,109,"Montana","Wibaux County",5,51,9,5,4
050,30,109,"Montana","Wibaux County",5,52,7,4,3
050,30,109,"Montana","Wibaux County",5,53,11,6,5
050,30,109,"Montana","Wibaux County",5,54,10,4,6
050,30,109,"Montana","Wibaux County",5,55,13,6,7
050,30,109,"Montana","Wibaux County",5,56,14,6,8
050,30,109,"Montana","Wibaux County",5,57,13,8,5
050,30,109,"Montana","Wibaux County",5,58,18,9,9
050,30,109,"Montana","Wibaux County",5,59,15,7,8
050,30,109,"Montana","Wibaux County",5,60,11,5,6
050,30,109,"Montana","Wibaux County",5,61,13,8,5
050,30,109,"Montana","Wibaux County",5,62,16,10,6
050,30,109,"Montana","Wibaux County",5,63,16,11,5
050,30,109,"Montana","Wibaux County",5,64,15,10,5
050,30,109,"Montana","Wibaux County",5,65,16,9,7
050,30,109,"Montana","Wibaux County",5,66,14,8,6
050,30,109,"Montana","Wibaux County",5,67,13,8,5
050,30,109,"Montana","Wibaux County",5,68,14,6,8
050,30,109,"Montana","Wibaux County",5,69,9,3,6
050,30,109,"Montana","Wibaux County",5,70,11,5,6
050,30,109,"Montana","Wibaux County",5,71,11,5,6
050,30,109,"Montana","Wibaux County",5,72,14,7,7
050,30,109,"Montana","Wibaux County",5,73,11,5,6
050,30,109,"Montana","Wibaux County",5,74,12,4,8
050,30,109,"Montana","Wibaux County",5,75,6,4,2
050,30,109,"Montana","Wibaux County",5,76,4,4,0
050,30,109,"Montana","Wibaux County",5,77,10,5,5
050,30,109,"Montana","Wibaux County",5,78,7,4,3
050,30,109,"Montana","Wibaux County",5,79,5,0,5
050,30,109,"Montana","Wibaux County",5,80,8,2,6
050,30,109,"Montana","Wibaux County",5,81,7,1,6
050,30,109,"Montana","Wibaux County",5,82,11,4,7
050,30,109,"Montana","Wibaux County",5,83,9,5,4
050,30,109,"Montana","Wibaux County",5,84,6,4,2
050,30,109,"Montana","Wibaux County",5,85,28,13,15
050,30,111,"Montana","Yellowstone County",1,0,1788,913,875
050,30,111,"Montana","Yellowstone County",1,1,1843,932,911
050,30,111,"Montana","Yellowstone County",1,2,1952,1028,924
050,30,111,"Montana","Yellowstone County",1,3,2045,1062,983
050,30,111,"Montana","Yellowstone County",1,4,2105,1086,1019
050,30,111,"Montana","Yellowstone County",1,5,2157,1124,1033
050,30,111,"Montana","Yellowstone County",1,6,2154,1096,1058
050,30,111,"Montana","Yellowstone County",1,7,2157,1101,1056
050,30,111,"Montana","Yellowstone County",1,8,2231,1155,1076
050,30,111,"Montana","Yellowstone County",1,9,2169,1120,1049
050,30,111,"Montana","Yellowstone County",1,10,2190,1122,1068
050,30,111,"Montana","Yellowstone County",1,11,2297,1182,1115
050,30,111,"Montana","Yellowstone County",1,12,2426,1247,1179
050,30,111,"Montana","Yellowstone County",1,13,2369,1231,1138
050,30,111,"Montana","Yellowstone County",1,14,2260,1117,1143
050,30,111,"Montana","Yellowstone County",1,15,2253,1141,1112
050,30,111,"Montana","Yellowstone County",1,16,2263,1155,1108
050,30,111,"Montana","Yellowstone County",1,17,2110,1060,1050
050,30,111,"Montana","Yellowstone County",1,18,1799,905,894
050,30,111,"Montana","Yellowstone County",1,19,1637,832,805
050,30,111,"Montana","Yellowstone County",1,20,1661,867,794
050,30,111,"Montana","Yellowstone County",1,21,1748,924,824
050,30,111,"Montana","Yellowstone County",1,22,1821,896,925
050,30,111,"Montana","Yellowstone County",1,23,1951,962,989
050,30,111,"Montana","Yellowstone County",1,24,2083,1039,1044
050,30,111,"Montana","Yellowstone County",1,25,2145,1053,1092
050,30,111,"Montana","Yellowstone County",1,26,2240,1138,1102
050,30,111,"Montana","Yellowstone County",1,27,2306,1193,1113
050,30,111,"Montana","Yellowstone County",1,28,2358,1197,1161
050,30,111,"Montana","Yellowstone County",1,29,2323,1119,1204
050,30,111,"Montana","Yellowstone County",1,30,2271,1108,1163
050,30,111,"Montana","Yellowstone County",1,31,2297,1136,1161
050,30,111,"Montana","Yellowstone County",1,32,2277,1156,1121
050,30,111,"Montana","Yellowstone County",1,33,2283,1142,1141
050,30,111,"Montana","Yellowstone County",1,34,2292,1146,1146
050,30,111,"Montana","Yellowstone County",1,35,2263,1162,1101
050,30,111,"Montana","Yellowstone County",1,36,2301,1177,1124
050,30,111,"Montana","Yellowstone County",1,37,2328,1201,1127
050,30,111,"Montana","Yellowstone County",1,38,2309,1181,1128
050,30,111,"Montana","Yellowstone County",1,39,2236,1149,1087
050,30,111,"Montana","Yellowstone County",1,40,2180,1116,1064
050,30,111,"Montana","Yellowstone County",1,41,2107,1076,1031
050,30,111,"Montana","Yellowstone County",1,42,2043,1026,1017
050,30,111,"Montana","Yellowstone County",1,43,1969,974,995
050,30,111,"Montana","Yellowstone County",1,44,1917,957,960
050,30,111,"Montana","Yellowstone County",1,45,1809,881,928
050,30,111,"Montana","Yellowstone County",1,46,1782,899,883
050,30,111,"Montana","Yellowstone County",1,47,1805,931,874
050,30,111,"Montana","Yellowstone County",1,48,1911,987,924
050,30,111,"Montana","Yellowstone County",1,49,2080,1060,1020
050,30,111,"Montana","Yellowstone County",1,50,1927,971,956
050,30,111,"Montana","Yellowstone County",1,51,1871,976,895
050,30,111,"Montana","Yellowstone County",1,52,1818,910,908
050,30,111,"Montana","Yellowstone County",1,53,1812,889,923
050,30,111,"Montana","Yellowstone County",1,54,1837,908,929
050,30,111,"Montana","Yellowstone County",1,55,1984,961,1023
050,30,111,"Montana","Yellowstone County",1,56,2140,1048,1092
050,30,111,"Montana","Yellowstone County",1,57,2163,1060,1103
050,30,111,"Montana","Yellowstone County",1,58,2198,1078,1120
050,30,111,"Montana","Yellowstone County",1,59,2207,1066,1141
050,30,111,"Montana","Yellowstone County",1,60,2196,1087,1109
050,30,111,"Montana","Yellowstone County",1,61,2272,1106,1166
050,30,111,"Montana","Yellowstone County",1,62,2248,1102,1146
050,30,111,"Montana","Yellowstone County",1,63,2149,1031,1118
050,30,111,"Montana","Yellowstone County",1,64,2082,996,1086
050,30,111,"Montana","Yellowstone County",1,65,2029,974,1055
050,30,111,"Montana","Yellowstone County",1,66,1958,948,1010
050,30,111,"Montana","Yellowstone County",1,67,1872,918,954
050,30,111,"Montana","Yellowstone County",1,68,1865,893,972
050,30,111,"Montana","Yellowstone County",1,69,1763,848,915
050,30,111,"Montana","Yellowstone County",1,70,1643,765,878
050,30,111,"Montana","Yellowstone County",1,71,1591,738,853
050,30,111,"Montana","Yellowstone County",1,72,1589,728,861
050,30,111,"Montana","Yellowstone County",1,73,1582,758,824
050,30,111,"Montana","Yellowstone County",1,74,1091,512,579
050,30,111,"Montana","Yellowstone County",1,75,1111,509,602
050,30,111,"Montana","Yellowstone County",1,76,1111,492,619
050,30,111,"Montana","Yellowstone County",1,77,1071,504,567
050,30,111,"Montana","Yellowstone County",1,78,888,433,455
050,30,111,"Montana","Yellowstone County",1,79,804,371,433
050,30,111,"Montana","Yellowstone County",1,80,727,342,385
050,30,111,"Montana","Yellowstone County",1,81,681,293,388
050,30,111,"Montana","Yellowstone County",1,82,626,267,359
050,30,111,"Montana","Yellowstone County",1,83,542,218,324
050,30,111,"Montana","Yellowstone County",1,84,524,215,309
050,30,111,"Montana","Yellowstone County",1,85,3458,1198,2260
050,30,111,"Montana","Yellowstone County",2,0,1810,921,889
050,30,111,"Montana","Yellowstone County",2,1,1845,933,912
050,30,111,"Montana","Yellowstone County",2,2,1931,1008,923
050,30,111,"Montana","Yellowstone County",2,3,2023,1053,970
050,30,111,"Montana","Yellowstone County",2,4,2102,1087,1015
050,30,111,"Montana","Yellowstone County",2,5,2140,1108,1032
050,30,111,"Montana","Yellowstone County",2,6,2155,1107,1048
050,30,111,"Montana","Yellowstone County",2,7,2171,1106,1065
050,30,111,"Montana","Yellowstone County",2,8,2213,1139,1074
050,30,111,"Montana","Yellowstone County",2,9,2175,1124,1051
050,30,111,"Montana","Yellowstone County",2,10,2186,1119,1067
050,30,111,"Montana","Yellowstone County",2,11,2270,1169,1101
050,30,111,"Montana","Yellowstone County",2,12,2411,1244,1167
050,30,111,"Montana","Yellowstone County",2,13,2385,1234,1151
050,30,111,"Montana","Yellowstone County",2,14,2294,1144,1150
050,30,111,"Montana","Yellowstone County",2,15,2268,1145,1123
050,30,111,"Montana","Yellowstone County",2,16,2278,1162,1116
050,30,111,"Montana","Yellowstone County",2,17,2147,1083,1064
050,30,111,"Montana","Yellowstone County",2,18,1810,913,897
050,30,111,"Montana","Yellowstone County",2,19,1665,837,828
050,30,111,"Montana","Yellowstone County",2,20,1696,881,815
050,30,111,"Montana","Yellowstone County",2,21,1749,921,828
050,30,111,"Montana","Yellowstone County",2,22,1839,910,929
050,30,111,"Montana","Yellowstone County",2,23,1950,960,990
050,30,111,"Montana","Yellowstone County",2,24,2077,1033,1044
050,30,111,"Montana","Yellowstone County",2,25,2151,1064,1087
050,30,111,"Montana","Yellowstone County",2,26,2228,1125,1103
050,30,111,"Montana","Yellowstone County",2,27,2295,1184,1111
050,30,111,"Montana","Yellowstone County",2,28,2342,1193,1149
050,30,111,"Montana","Yellowstone County",2,29,2349,1146,1203
050,30,111,"Montana","Yellowstone County",2,30,2305,1126,1179
050,30,111,"Montana","Yellowstone County",2,31,2297,1136,1161
050,30,111,"Montana","Yellowstone County",2,32,2284,1152,1132
050,30,111,"Montana","Yellowstone County",2,33,2296,1154,1142
050,30,111,"Montana","Yellowstone County",2,34,2286,1148,1138
050,30,111,"Montana","Yellowstone County",2,35,2293,1167,1126
050,30,111,"Montana","Yellowstone County",2,36,2275,1165,1110
050,30,111,"Montana","Yellowstone County",2,37,2324,1200,1124
050,30,111,"Montana","Yellowstone County",2,38,2320,1189,1131
050,30,111,"Montana","Yellowstone County",2,39,2251,1156,1095
050,30,111,"Montana","Yellowstone County",2,40,2199,1124,1075
050,30,111,"Montana","Yellowstone County",2,41,2131,1091,1040
050,30,111,"Montana","Yellowstone County",2,42,2059,1039,1020
050,30,111,"Montana","Yellowstone County",2,43,1996,988,1008
050,30,111,"Montana","Yellowstone County",2,44,1913,953,960
050,30,111,"Montana","Yellowstone County",2,45,1844,905,939
050,30,111,"Montana","Yellowstone County",2,46,1785,888,897
050,30,111,"Montana","Yellowstone County",2,47,1795,923,872
050,30,111,"Montana","Yellowstone County",2,48,1881,965,916
050,30,111,"Montana","Yellowstone County",2,49,2061,1058,1003
050,30,111,"Montana","Yellowstone County",2,50,1973,997,976
050,30,111,"Montana","Yellowstone County",2,51,1888,981,907
050,30,111,"Montana","Yellowstone County",2,52,1830,920,910
050,30,111,"Montana","Yellowstone County",2,53,1812,895,917
050,30,111,"Montana","Yellowstone County",2,54,1828,900,928
050,30,111,"Montana","Yellowstone County",2,55,1938,944,994
050,30,111,"Montana","Yellowstone County",2,56,2104,1035,1069
050,30,111,"Montana","Yellowstone County",2,57,2161,1058,1103
050,30,111,"Montana","Yellowstone County",2,58,2186,1071,1115
050,30,111,"Montana","Yellowstone County",2,59,2211,1074,1137
050,30,111,"Montana","Yellowstone County",2,60,2187,1077,1110
050,30,111,"Montana","Yellowstone County",2,61,2241,1091,1150
050,30,111,"Montana","Yellowstone County",2,62,2246,1103,1143
050,30,111,"Montana","Yellowstone County",2,63,2186,1055,1131
050,30,111,"Montana","Yellowstone County",2,64,2082,997,1085
050,30,111,"Montana","Yellowstone County",2,65,2022,968,1054
050,30,111,"Montana","Yellowstone County",2,66,1977,952,1025
050,30,111,"Montana","Yellowstone County",2,67,1886,923,963
050,30,111,"Montana","Yellowstone County",2,68,1850,890,960
050,30,111,"Montana","Yellowstone County",2,69,1797,862,935
050,30,111,"Montana","Yellowstone County",2,70,1662,778,884
050,30,111,"Montana","Yellowstone County",2,71,1601,740,861
050,30,111,"Montana","Yellowstone County",2,72,1569,722,847
050,30,111,"Montana","Yellowstone County",2,73,1661,786,875
050,30,111,"Montana","Yellowstone County",2,74,1140,536,604
050,30,111,"Montana","Yellowstone County",2,75,1108,510,598
050,30,111,"Montana","Yellowstone County",2,76,1100,486,614
050,30,111,"Montana","Yellowstone County",2,77,1096,506,590
050,30,111,"Montana","Yellowstone County",2,78,914,444,470
050,30,111,"Montana","Yellowstone County",2,79,826,387,439
050,30,111,"Montana","Yellowstone County",2,80,741,344,397
050,30,111,"Montana","Yellowstone County",2,81,688,302,386
050,30,111,"Montana","Yellowstone County",2,82,623,266,357
050,30,111,"Montana","Yellowstone County",2,83,542,219,323
050,30,111,"Montana","Yellowstone County",2,84,519,209,310
050,30,111,"Montana","Yellowstone County",2,85,3473,1210,2263
050,30,111,"Montana","Yellowstone County",3,0,1809,907,902
050,30,111,"Montana","Yellowstone County",3,1,1851,921,930
050,30,111,"Montana","Yellowstone County",3,2,1911,976,935
050,30,111,"Montana","Yellowstone County",3,3,1951,1029,922
050,30,111,"Montana","Yellowstone County",3,4,2059,1077,982
050,30,111,"Montana","Yellowstone County",3,5,2127,1102,1025
050,30,111,"Montana","Yellowstone County",3,6,2170,1121,1049
050,30,111,"Montana","Yellowstone County",3,7,2174,1138,1036
050,30,111,"Montana","Yellowstone County",3,8,2210,1123,1087
050,30,111,"Montana","Yellowstone County",3,9,2216,1139,1077
050,30,111,"Montana","Yellowstone County",3,10,2166,1106,1060
050,30,111,"Montana","Yellowstone County",3,11,2216,1148,1068
050,30,111,"Montana","Yellowstone County",3,12,2331,1216,1115
050,30,111,"Montana","Yellowstone County",3,13,2471,1277,1194
050,30,111,"Montana","Yellowstone County",3,14,2408,1236,1172
050,30,111,"Montana","Yellowstone County",3,15,2357,1159,1198
050,30,111,"Montana","Yellowstone County",3,16,2283,1162,1121
050,30,111,"Montana","Yellowstone County",3,17,2276,1171,1105
050,30,111,"Montana","Yellowstone County",3,18,1893,972,921
050,30,111,"Montana","Yellowstone County",3,19,1682,840,842
050,30,111,"Montana","Yellowstone County",3,20,1811,902,909
050,30,111,"Montana","Yellowstone County",3,21,1785,931,854
050,30,111,"Montana","Yellowstone County",3,22,1897,957,940
050,30,111,"Montana","Yellowstone County",3,23,2047,1042,1005
050,30,111,"Montana","Yellowstone County",3,24,2094,1043,1051
050,30,111,"Montana","Yellowstone County",3,25,2201,1098,1103
050,30,111,"Montana","Yellowstone County",3,26,2224,1117,1107
050,30,111,"Montana","Yellowstone County",3,27,2337,1188,1149
050,30,111,"Montana","Yellowstone County",3,28,2316,1176,1140
050,30,111,"Montana","Yellowstone County",3,29,2397,1209,1188
050,30,111,"Montana","Yellowstone County",3,30,2378,1193,1185
050,30,111,"Montana","Yellowstone County",3,31,2351,1139,1212
050,30,111,"Montana","Yellowstone County",3,32,2302,1150,1152
050,30,111,"Montana","Yellowstone County",3,33,2340,1168,1172
050,30,111,"Montana","Yellowstone County",3,34,2314,1162,1152
050,30,111,"Montana","Yellowstone County",3,35,2330,1170,1160
050,30,111,"Montana","Yellowstone County",3,36,2344,1185,1159
050,30,111,"Montana","Yellowstone County",3,37,2288,1182,1106
050,30,111,"Montana","Yellowstone County",3,38,2343,1189,1154
050,30,111,"Montana","Yellowstone County",3,39,2348,1193,1155
050,30,111,"Montana","Yellowstone County",3,40,2254,1158,1096
050,30,111,"Montana","Yellowstone County",3,41,2244,1131,1113
050,30,111,"Montana","Yellowstone County",3,42,2163,1107,1056
050,30,111,"Montana","Yellowstone County",3,43,2078,1048,1030
050,30,111,"Montana","Yellowstone County",3,44,1990,997,993
050,30,111,"Montana","Yellowstone County",3,45,1901,943,958
050,30,111,"Montana","Yellowstone County",3,46,1841,890,951
050,30,111,"Montana","Yellowstone County",3,47,1808,905,903
050,30,111,"Montana","Yellowstone County",3,48,1831,929,902
050,30,111,"Montana","Yellowstone County",3,49,1913,985,928
050,30,111,"Montana","Yellowstone County",3,50,2056,1061,995
050,30,111,"Montana","Yellowstone County",3,51,1984,1027,957
050,30,111,"Montana","Yellowstone County",3,52,1907,965,942
050,30,111,"Montana","Yellowstone County",3,53,1823,922,901
050,30,111,"Montana","Yellowstone County",3,54,1807,894,913
050,30,111,"Montana","Yellowstone County",3,55,1843,895,948
050,30,111,"Montana","Yellowstone County",3,56,1949,961,988
050,30,111,"Montana","Yellowstone County",3,57,2121,1049,1072
050,30,111,"Montana","Yellowstone County",3,58,2126,1033,1093
050,30,111,"Montana","Yellowstone County",3,59,2163,1065,1098
050,30,111,"Montana","Yellowstone County",3,60,2206,1089,1117
050,30,111,"Montana","Yellowstone County",3,61,2165,1042,1123
050,30,111,"Montana","Yellowstone County",3,62,2214,1087,1127
050,30,111,"Montana","Yellowstone County",3,63,2259,1110,1149
050,30,111,"Montana","Yellowstone County",3,64,2180,1054,1126
050,30,111,"Montana","Yellowstone County",3,65,2092,992,1100
050,30,111,"Montana","Yellowstone County",3,66,2019,958,1061
050,30,111,"Montana","Yellowstone County",3,67,1958,956,1002
050,30,111,"Montana","Yellowstone County",3,68,1841,889,952
050,30,111,"Montana","Yellowstone County",3,69,1853,887,966
050,30,111,"Montana","Yellowstone County",3,70,1740,832,908
050,30,111,"Montana","Yellowstone County",3,71,1665,778,887
050,30,111,"Montana","Yellowstone County",3,72,1564,729,835
050,30,111,"Montana","Yellowstone County",3,73,1527,702,825
050,30,111,"Montana","Yellowstone County",3,74,1603,757,846
050,30,111,"Montana","Yellowstone County",3,75,1099,508,591
050,30,111,"Montana","Yellowstone County",3,76,1073,486,587
050,30,111,"Montana","Yellowstone County",3,77,1048,459,589
050,30,111,"Montana","Yellowstone County",3,78,1048,494,554
050,30,111,"Montana","Yellowstone County",3,79,889,428,461
050,30,111,"Montana","Yellowstone County",3,80,771,348,423
050,30,111,"Montana","Yellowstone County",3,81,713,316,397
050,30,111,"Montana","Yellowstone County",3,82,623,282,341
050,30,111,"Montana","Yellowstone County",3,83,550,231,319
050,30,111,"Montana","Yellowstone County",3,84,507,200,307
050,30,111,"Montana","Yellowstone County",3,85,3421,1200,2221
050,30,111,"Montana","Yellowstone County",4,0,1812,925,887
050,30,111,"Montana","Yellowstone County",4,1,1865,925,940
050,30,111,"Montana","Yellowstone County",4,2,1901,961,940
050,30,111,"Montana","Yellowstone County",4,3,1950,999,951
050,30,111,"Montana","Yellowstone County",4,4,1986,1023,963
050,30,111,"Montana","Yellowstone County",4,5,2112,1100,1012
050,30,111,"Montana","Yellowstone County",4,6,2130,1093,1037
050,30,111,"Montana","Yellowstone County",4,7,2178,1121,1057
050,30,111,"Montana","Yellowstone County",4,8,2203,1149,1054
050,30,111,"Montana","Yellowstone County",4,9,2225,1126,1099
050,30,111,"Montana","Yellowstone County",4,10,2244,1153,1091
050,30,111,"Montana","Yellowstone County",4,11,2226,1134,1092
050,30,111,"Montana","Yellowstone County",4,12,2248,1164,1084
050,30,111,"Montana","Yellowstone County",4,13,2329,1207,1122
050,30,111,"Montana","Yellowstone County",4,14,2516,1298,1218
050,30,111,"Montana","Yellowstone County",4,15,2518,1285,1233
050,30,111,"Montana","Yellowstone County",4,16,2366,1153,1213
050,30,111,"Montana","Yellowstone County",4,17,2295,1153,1142
050,30,111,"Montana","Yellowstone County",4,18,2000,1038,962
050,30,111,"Montana","Yellowstone County",4,19,1691,851,840
050,30,111,"Montana","Yellowstone County",4,20,1779,902,877
050,30,111,"Montana","Yellowstone County",4,21,1878,967,911
050,30,111,"Montana","Yellowstone County",4,22,1935,985,950
050,30,111,"Montana","Yellowstone County",4,23,2051,1030,1021
050,30,111,"Montana","Yellowstone County",4,24,2200,1127,1073
050,30,111,"Montana","Yellowstone County",4,25,2197,1087,1110
050,30,111,"Montana","Yellowstone County",4,26,2289,1176,1113
050,30,111,"Montana","Yellowstone County",4,27,2322,1188,1134
050,30,111,"Montana","Yellowstone County",4,28,2375,1172,1203
050,30,111,"Montana","Yellowstone County",4,29,2418,1236,1182
050,30,111,"Montana","Yellowstone County",4,30,2456,1252,1204
050,30,111,"Montana","Yellowstone County",4,31,2471,1234,1237
050,30,111,"Montana","Yellowstone County",4,32,2382,1169,1213
050,30,111,"Montana","Yellowstone County",4,33,2353,1178,1175
050,30,111,"Montana","Yellowstone County",4,34,2358,1177,1181
050,30,111,"Montana","Yellowstone County",4,35,2402,1191,1211
050,30,111,"Montana","Yellowstone County",4,36,2366,1185,1181
050,30,111,"Montana","Yellowstone County",4,37,2405,1215,1190
050,30,111,"Montana","Yellowstone County",4,38,2325,1192,1133
050,30,111,"Montana","Yellowstone County",4,39,2393,1219,1174
050,30,111,"Montana","Yellowstone County",4,40,2371,1195,1176
050,30,111,"Montana","Yellowstone County",4,41,2300,1190,1110
050,30,111,"Montana","Yellowstone County",4,42,2233,1122,1111
050,30,111,"Montana","Yellowstone County",4,43,2188,1118,1070
050,30,111,"Montana","Yellowstone County",4,44,2108,1081,1027
050,30,111,"Montana","Yellowstone County",4,45,1978,982,996
050,30,111,"Montana","Yellowstone County",4,46,1906,934,972
050,30,111,"Montana","Yellowstone County",4,47,1894,937,957
050,30,111,"Montana","Yellowstone County",4,48,1783,883,900
050,30,111,"Montana","Yellowstone County",4,49,1853,958,895
050,30,111,"Montana","Yellowstone County",4,50,1930,980,950
050,30,111,"Montana","Yellowstone County",4,51,2088,1093,995
050,30,111,"Montana","Yellowstone County",4,52,1982,1000,982
050,30,111,"Montana","Yellowstone County",4,53,1887,962,925
050,30,111,"Montana","Yellowstone County",4,54,1840,922,918
050,30,111,"Montana","Yellowstone County",4,55,1812,901,911
050,30,111,"Montana","Yellowstone County",4,56,1841,898,943
050,30,111,"Montana","Yellowstone County",4,57,1937,960,977
050,30,111,"Montana","Yellowstone County",4,58,2115,1047,1068
050,30,111,"Montana","Yellowstone County",4,59,2103,1028,1075
050,30,111,"Montana","Yellowstone County",4,60,2130,1048,1082
050,30,111,"Montana","Yellowstone County",4,61,2226,1086,1140
050,30,111,"Montana","Yellowstone County",4,62,2136,1024,1112
050,30,111,"Montana","Yellowstone County",4,63,2201,1079,1122
050,30,111,"Montana","Yellowstone County",4,64,2246,1100,1146
050,30,111,"Montana","Yellowstone County",4,65,2164,1039,1125
050,30,111,"Montana","Yellowstone County",4,66,2080,976,1104
050,30,111,"Montana","Yellowstone County",4,67,2005,946,1059
050,30,111,"Montana","Yellowstone County",4,68,1922,938,984
050,30,111,"Montana","Yellowstone County",4,69,1830,884,946
050,30,111,"Montana","Yellowstone County",4,70,1830,874,956
050,30,111,"Montana","Yellowstone County",4,71,1738,851,887
050,30,111,"Montana","Yellowstone County",4,72,1653,776,877
050,30,111,"Montana","Yellowstone County",4,73,1507,709,798
050,30,111,"Montana","Yellowstone County",4,74,1503,705,798
050,30,111,"Montana","Yellowstone County",4,75,1555,727,828
050,30,111,"Montana","Yellowstone County",4,76,1073,486,587
050,30,111,"Montana","Yellowstone County",4,77,1040,468,572
050,30,111,"Montana","Yellowstone County",4,78,986,435,551
050,30,111,"Montana","Yellowstone County",4,79,1035,488,547
050,30,111,"Montana","Yellowstone County",4,80,836,393,443
050,30,111,"Montana","Yellowstone County",4,81,750,315,435
050,30,111,"Montana","Yellowstone County",4,82,662,299,363
050,30,111,"Montana","Yellowstone County",4,83,569,258,311
050,30,111,"Montana","Yellowstone County",4,84,514,207,307
050,30,111,"Montana","Yellowstone County",4,85,3380,1175,2205
050,30,111,"Montana","Yellowstone County",5,0,1816,926,890
050,30,111,"Montana","Yellowstone County",5,1,1784,908,876
050,30,111,"Montana","Yellowstone County",5,2,1900,943,957
050,30,111,"Montana","Yellowstone County",5,3,1901,959,942
050,30,111,"Montana","Yellowstone County",5,4,1951,992,959
050,30,111,"Montana","Yellowstone County",5,5,2008,1044,964
050,30,111,"Montana","Yellowstone County",5,6,2103,1095,1008
050,30,111,"Montana","Yellowstone County",5,7,2169,1103,1066
050,30,111,"Montana","Yellowstone County",5,8,2214,1146,1068
050,30,111,"Montana","Yellowstone County",5,9,2225,1156,1069
050,30,111,"Montana","Yellowstone County",5,10,2231,1124,1107
050,30,111,"Montana","Yellowstone County",5,11,2263,1161,1102
050,30,111,"Montana","Yellowstone County",5,12,2257,1155,1102
050,30,111,"Montana","Yellowstone County",5,13,2242,1162,1080
050,30,111,"Montana","Yellowstone County",5,14,2356,1216,1140
050,30,111,"Montana","Yellowstone County",5,15,2530,1299,1231
050,30,111,"Montana","Yellowstone County",5,16,2520,1279,1241
050,30,111,"Montana","Yellowstone County",5,17,2370,1148,1222
050,30,111,"Montana","Yellowstone County",5,18,1971,990,981
050,30,111,"Montana","Yellowstone County",5,19,1763,894,869
050,30,111,"Montana","Yellowstone County",5,20,1792,894,898
050,30,111,"Montana","Yellowstone County",5,21,1861,962,899
050,30,111,"Montana","Yellowstone County",5,22,2009,1013,996
050,30,111,"Montana","Yellowstone County",5,23,2076,1075,1001
050,30,111,"Montana","Yellowstone County",5,24,2107,1081,1026
050,30,111,"Montana","Yellowstone County",5,25,2239,1135,1104
050,30,111,"Montana","Yellowstone County",5,26,2256,1137,1119
050,30,111,"Montana","Yellowstone County",5,27,2301,1191,1110
050,30,111,"Montana","Yellowstone County",5,28,2285,1154,1131
050,30,111,"Montana","Yellowstone County",5,29,2387,1176,1211
050,30,111,"Montana","Yellowstone County",5,30,2374,1218,1156
050,30,111,"Montana","Yellowstone County",5,31,2513,1278,1235
050,30,111,"Montana","Yellowstone County",5,32,2467,1233,1234
050,30,111,"Montana","Yellowstone County",5,33,2398,1174,1224
050,30,111,"Montana","Yellowstone County",5,34,2347,1178,1169
050,30,111,"Montana","Yellowstone County",5,35,2415,1195,1220
050,30,111,"Montana","Yellowstone County",5,36,2448,1215,1233
050,30,111,"Montana","Yellowstone County",5,37,2387,1203,1184
050,30,111,"Montana","Yellowstone County",5,38,2393,1213,1180
050,30,111,"Montana","Yellowstone County",5,39,2337,1202,1135
050,30,111,"Montana","Yellowstone County",5,40,2391,1213,1178
050,30,111,"Montana","Yellowstone County",5,41,2341,1168,1173
050,30,111,"Montana","Yellowstone County",5,42,2312,1206,1106
050,30,111,"Montana","Yellowstone County",5,43,2233,1115,1118
050,30,111,"Montana","Yellowstone County",5,44,2216,1147,1069
050,30,111,"Montana","Yellowstone County",5,45,2093,1074,1019
050,30,111,"Montana","Yellowstone County",5,46,1990,988,1002
050,30,111,"Montana","Yellowstone County",5,47,1932,945,987
050,30,111,"Montana","Yellowstone County",5,48,1901,924,977
050,30,111,"Montana","Yellowstone County",5,49,1795,893,902
050,30,111,"Montana","Yellowstone County",5,50,1869,966,903
050,30,111,"Montana","Yellowstone County",5,51,1930,982,948
050,30,111,"Montana","Yellowstone County",5,52,2099,1081,1018
050,30,111,"Montana","Yellowstone County",5,53,1937,994,943
050,30,111,"Montana","Yellowstone County",5,54,1891,967,924
050,30,111,"Montana","Yellowstone County",5,55,1829,919,910
050,30,111,"Montana","Yellowstone County",5,56,1777,879,898
050,30,111,"Montana","Yellowstone County",5,57,1819,882,937
050,30,111,"Montana","Yellowstone County",5,58,1910,943,967
050,30,111,"Montana","Yellowstone County",5,59,2083,1036,1047
050,30,111,"Montana","Yellowstone County",5,60,2093,1030,1063
050,30,111,"Montana","Yellowstone County",5,61,2138,1048,1090
050,30,111,"Montana","Yellowstone County",5,62,2191,1077,1114
050,30,111,"Montana","Yellowstone County",5,63,2136,1018,1118
050,30,111,"Montana","Yellowstone County",5,64,2176,1071,1105
050,30,111,"Montana","Yellowstone County",5,65,2221,1084,1137
050,30,111,"Montana","Yellowstone County",5,66,2179,1032,1147
050,30,111,"Montana","Yellowstone County",5,67,2065,995,1070
050,30,111,"Montana","Yellowstone County",5,68,1960,921,1039
050,30,111,"Montana","Yellowstone County",5,69,1900,920,980
050,30,111,"Montana","Yellowstone County",5,70,1812,864,948
050,30,111,"Montana","Yellowstone County",5,71,1849,885,964
050,30,111,"Montana","Yellowstone County",5,72,1723,843,880
050,30,111,"Montana","Yellowstone County",5,73,1602,752,850
050,30,111,"Montana","Yellowstone County",5,74,1469,694,775
050,30,111,"Montana","Yellowstone County",5,75,1455,683,772
050,30,111,"Montana","Yellowstone County",5,76,1497,695,802
050,30,111,"Montana","Yellowstone County",5,77,1039,470,569
050,30,111,"Montana","Yellowstone County",5,78,994,449,545
050,30,111,"Montana","Yellowstone County",5,79,970,431,539
050,30,111,"Montana","Yellowstone County",5,80,992,454,538
050,30,111,"Montana","Yellowstone County",5,81,797,361,436
050,30,111,"Montana","Yellowstone County",5,82,709,309,400
050,30,111,"Montana","Yellowstone County",5,83,612,274,338
050,30,111,"Montana","Yellowstone County",5,84,556,242,314
050,30,111,"Montana","Yellowstone County",5,85,3394,1173,2221

