"SUMLEV","STATE","COUNTY","STNAME","CTYNAME","YEAR","AGE","TOT_POP","TOT_MALE","TOT_FEMALE"
050,19,001,"Iowa","Adair County",1,0,104,54,50
050,19,001,"Iowa","Adair County",1,1,107,52,55
050,19,001,"Iowa","Adair County",1,2,92,53,39
050,19,001,"Iowa","Adair County",1,3,86,45,41
050,19,001,"Iowa","Adair County",1,4,85,39,46
050,19,001,"Iowa","Adair County",1,5,76,43,33
050,19,001,"Iowa","Adair County",1,6,99,55,44
050,19,001,"Iowa","Adair County",1,7,83,39,44
050,19,001,"Iowa","Adair County",1,8,98,56,42
050,19,001,"Iowa","Adair County",1,9,96,50,46
050,19,001,"Iowa","Adair County",1,10,86,48,38
050,19,001,"Iowa","Adair County",1,11,98,48,50
050,19,001,"Iowa","Adair County",1,12,100,54,46
050,19,001,"Iowa","Adair County",1,13,112,53,59
050,19,001,"Iowa","Adair County",1,14,112,50,62
050,19,001,"Iowa","Adair County",1,15,70,35,35
050,19,001,"Iowa","Adair County",1,16,92,40,52
050,19,001,"Iowa","Adair County",1,17,89,41,48
050,19,001,"Iowa","Adair County",1,18,91,52,39
050,19,001,"Iowa","Adair County",1,19,72,37,35
050,19,001,"Iowa","Adair County",1,20,59,31,28
050,19,001,"Iowa","Adair County",1,21,58,32,26
050,19,001,"Iowa","Adair County",1,22,65,33,32
050,19,001,"Iowa","Adair County",1,23,61,35,26
050,19,001,"Iowa","Adair County",1,24,63,30,33
050,19,001,"Iowa","Adair County",1,25,90,50,40
050,19,001,"Iowa","Adair County",1,26,91,49,42
050,19,001,"Iowa","Adair County",1,27,76,38,38
050,19,001,"Iowa","Adair County",1,28,86,47,39
050,19,001,"Iowa","Adair County",1,29,81,44,37
050,19,001,"Iowa","Adair County",1,30,81,40,41
050,19,001,"Iowa","Adair County",1,31,95,51,44
050,19,001,"Iowa","Adair County",1,32,79,39,40
050,19,001,"Iowa","Adair County",1,33,100,55,45
050,19,001,"Iowa","Adair County",1,34,96,47,49
050,19,001,"Iowa","Adair County",1,35,85,37,48
050,19,001,"Iowa","Adair County",1,36,70,39,31
050,19,001,"Iowa","Adair County",1,37,85,45,40
050,19,001,"Iowa","Adair County",1,38,94,43,51
050,19,001,"Iowa","Adair County",1,39,85,42,43
050,19,001,"Iowa","Adair County",1,40,89,52,37
050,19,001,"Iowa","Adair County",1,41,89,51,38
050,19,001,"Iowa","Adair County",1,42,76,41,35
050,19,001,"Iowa","Adair County",1,43,70,28,42
050,19,001,"Iowa","Adair County",1,44,73,29,44
050,19,001,"Iowa","Adair County",1,45,73,38,35
050,19,001,"Iowa","Adair County",1,46,65,32,33
050,19,001,"Iowa","Adair County",1,47,66,34,32
050,19,001,"Iowa","Adair County",1,48,87,47,40
050,19,001,"Iowa","Adair County",1,49,89,42,47
050,19,001,"Iowa","Adair County",1,50,76,41,35
050,19,001,"Iowa","Adair County",1,51,86,42,44
050,19,001,"Iowa","Adair County",1,52,76,43,33
050,19,001,"Iowa","Adair County",1,53,90,45,45
050,19,001,"Iowa","Adair County",1,54,107,48,59
050,19,001,"Iowa","Adair County",1,55,99,53,46
050,19,001,"Iowa","Adair County",1,56,100,49,51
050,19,001,"Iowa","Adair County",1,57,118,61,57
050,19,001,"Iowa","Adair County",1,58,136,70,66
050,19,001,"Iowa","Adair County",1,59,126,64,62
050,19,001,"Iowa","Adair County",1,60,116,60,56
050,19,001,"Iowa","Adair County",1,61,120,60,60
050,19,001,"Iowa","Adair County",1,62,117,59,58
050,19,001,"Iowa","Adair County",1,63,129,73,56
050,19,001,"Iowa","Adair County",1,64,113,68,45
050,19,001,"Iowa","Adair County",1,65,105,63,42
050,19,001,"Iowa","Adair County",1,66,100,58,42
050,19,001,"Iowa","Adair County",1,67,110,59,51
050,19,001,"Iowa","Adair County",1,68,107,52,55
050,19,001,"Iowa","Adair County",1,69,86,44,42
050,19,001,"Iowa","Adair County",1,70,86,37,49
050,19,001,"Iowa","Adair County",1,71,82,39,43
050,19,001,"Iowa","Adair County",1,72,71,37,34
050,19,001,"Iowa","Adair County",1,73,77,41,36
050,19,001,"Iowa","Adair County",1,74,60,29,31
050,19,001,"Iowa","Adair County",1,75,63,29,34
050,19,001,"Iowa","Adair County",1,76,55,29,26
050,19,001,"Iowa","Adair County",1,77,53,25,28
050,19,001,"Iowa","Adair County",1,78,47,16,31
050,19,001,"Iowa","Adair County",1,79,47,15,32
050,19,001,"Iowa","Adair County",1,80,44,17,27
050,19,001,"Iowa","Adair County",1,81,53,26,27
050,19,001,"Iowa","Adair County",1,82,48,21,27
050,19,001,"Iowa","Adair County",1,83,36,15,21
050,19,001,"Iowa","Adair County",1,84,45,17,28
050,19,001,"Iowa","Adair County",1,85,288,100,188
050,19,001,"Iowa","Adair County",2,0,104,51,53
050,19,001,"Iowa","Adair County",2,1,104,51,53
050,19,001,"Iowa","Adair County",2,2,96,52,44
050,19,001,"Iowa","Adair County",2,3,87,46,41
050,19,001,"Iowa","Adair County",2,4,86,41,45
050,19,001,"Iowa","Adair County",2,5,78,42,36
050,19,001,"Iowa","Adair County",2,6,92,51,41
050,19,001,"Iowa","Adair County",2,7,86,43,43
050,19,001,"Iowa","Adair County",2,8,94,51,43
050,19,001,"Iowa","Adair County",2,9,95,51,44
050,19,001,"Iowa","Adair County",2,10,88,49,39
050,19,001,"Iowa","Adair County",2,11,95,48,47
050,19,001,"Iowa","Adair County",2,12,101,54,47
050,19,001,"Iowa","Adair County",2,13,111,55,56
050,19,001,"Iowa","Adair County",2,14,110,50,60
050,19,001,"Iowa","Adair County",2,15,79,38,41
050,19,001,"Iowa","Adair County",2,16,87,40,47
050,19,001,"Iowa","Adair County",2,17,90,41,49
050,19,001,"Iowa","Adair County",2,18,86,47,39
050,19,001,"Iowa","Adair County",2,19,73,38,35
050,19,001,"Iowa","Adair County",2,20,63,33,30
050,19,001,"Iowa","Adair County",2,21,58,32,26
050,19,001,"Iowa","Adair County",2,22,64,34,30
050,19,001,"Iowa","Adair County",2,23,62,34,28
050,19,001,"Iowa","Adair County",2,24,63,32,31
050,19,001,"Iowa","Adair County",2,25,84,45,39
050,19,001,"Iowa","Adair County",2,26,91,50,41
050,19,001,"Iowa","Adair County",2,27,80,42,38
050,19,001,"Iowa","Adair County",2,28,84,45,39
050,19,001,"Iowa","Adair County",2,29,80,43,37
050,19,001,"Iowa","Adair County",2,30,82,42,40
050,19,001,"Iowa","Adair County",2,31,91,47,44
050,19,001,"Iowa","Adair County",2,32,82,42,40
050,19,001,"Iowa","Adair County",2,33,94,51,43
050,19,001,"Iowa","Adair County",2,34,97,49,48
050,19,001,"Iowa","Adair County",2,35,87,39,48
050,19,001,"Iowa","Adair County",2,36,72,38,34
050,19,001,"Iowa","Adair County",2,37,81,43,38
050,19,001,"Iowa","Adair County",2,38,93,44,49
050,19,001,"Iowa","Adair County",2,39,87,43,44
050,19,001,"Iowa","Adair County",2,40,89,50,39
050,19,001,"Iowa","Adair County",2,41,88,51,37
050,19,001,"Iowa","Adair County",2,42,79,43,36
050,19,001,"Iowa","Adair County",2,43,73,31,42
050,19,001,"Iowa","Adair County",2,44,71,28,43
050,19,001,"Iowa","Adair County",2,45,73,36,37
050,19,001,"Iowa","Adair County",2,46,66,33,33
050,19,001,"Iowa","Adair County",2,47,67,34,33
050,19,001,"Iowa","Adair County",2,48,84,45,39
050,19,001,"Iowa","Adair County",2,49,89,44,45
050,19,001,"Iowa","Adair County",2,50,80,42,38
050,19,001,"Iowa","Adair County",2,51,83,42,41
050,19,001,"Iowa","Adair County",2,52,77,42,35
050,19,001,"Iowa","Adair County",2,53,86,44,42
050,19,001,"Iowa","Adair County",2,54,103,48,55
050,19,001,"Iowa","Adair County",2,55,100,51,49
050,19,001,"Iowa","Adair County",2,56,100,51,49
050,19,001,"Iowa","Adair County",2,57,115,59,56
050,19,001,"Iowa","Adair County",2,58,130,67,63
050,19,001,"Iowa","Adair County",2,59,126,65,61
050,19,001,"Iowa","Adair County",2,60,118,60,58
050,19,001,"Iowa","Adair County",2,61,119,60,59
050,19,001,"Iowa","Adair County",2,62,118,59,59
050,19,001,"Iowa","Adair County",2,63,126,69,57
050,19,001,"Iowa","Adair County",2,64,116,69,47
050,19,001,"Iowa","Adair County",2,65,108,65,43
050,19,001,"Iowa","Adair County",2,66,101,59,42
050,19,001,"Iowa","Adair County",2,67,108,59,49
050,19,001,"Iowa","Adair County",2,68,106,53,53
050,19,001,"Iowa","Adair County",2,69,90,45,45
050,19,001,"Iowa","Adair County",2,70,86,39,47
050,19,001,"Iowa","Adair County",2,71,83,39,44
050,19,001,"Iowa","Adair County",2,72,73,37,36
050,19,001,"Iowa","Adair County",2,73,78,41,37
050,19,001,"Iowa","Adair County",2,74,61,30,31
050,19,001,"Iowa","Adair County",2,75,63,29,34
050,19,001,"Iowa","Adair County",2,76,57,29,28
050,19,001,"Iowa","Adair County",2,77,53,25,28
050,19,001,"Iowa","Adair County",2,78,48,18,30
050,19,001,"Iowa","Adair County",2,79,47,15,32
050,19,001,"Iowa","Adair County",2,80,44,17,27
050,19,001,"Iowa","Adair County",2,81,52,25,27
050,19,001,"Iowa","Adair County",2,82,50,23,27
050,19,001,"Iowa","Adair County",2,83,38,16,22
050,19,001,"Iowa","Adair County",2,84,43,17,26
050,19,001,"Iowa","Adair County",2,85,291,101,190
050,19,001,"Iowa","Adair County",3,0,84,39,45
050,19,001,"Iowa","Adair County",3,1,100,44,56
050,19,001,"Iowa","Adair County",3,2,104,51,53
050,19,001,"Iowa","Adair County",3,3,93,52,41
050,19,001,"Iowa","Adair County",3,4,96,53,43
050,19,001,"Iowa","Adair County",3,5,93,43,50
050,19,001,"Iowa","Adair County",3,6,82,46,36
050,19,001,"Iowa","Adair County",3,7,89,48,41
050,19,001,"Iowa","Adair County",3,8,88,44,44
050,19,001,"Iowa","Adair County",3,9,97,54,43
050,19,001,"Iowa","Adair County",3,10,96,55,41
050,19,001,"Iowa","Adair County",3,11,85,49,36
050,19,001,"Iowa","Adair County",3,12,90,46,44
050,19,001,"Iowa","Adair County",3,13,108,59,49
050,19,001,"Iowa","Adair County",3,14,115,61,54
050,19,001,"Iowa","Adair County",3,15,112,52,60
050,19,001,"Iowa","Adair County",3,16,78,36,42
050,19,001,"Iowa","Adair County",3,17,94,43,51
050,19,001,"Iowa","Adair County",3,18,78,36,42
050,19,001,"Iowa","Adair County",3,19,67,37,30
050,19,001,"Iowa","Adair County",3,20,79,41,38
050,19,001,"Iowa","Adair County",3,21,70,37,33
050,19,001,"Iowa","Adair County",3,22,67,35,32
050,19,001,"Iowa","Adair County",3,23,73,40,33
050,19,001,"Iowa","Adair County",3,24,61,36,25
050,19,001,"Iowa","Adair County",3,25,63,31,32
050,19,001,"Iowa","Adair County",3,26,78,39,39
050,19,001,"Iowa","Adair County",3,27,108,57,51
050,19,001,"Iowa","Adair County",3,28,88,48,40
050,19,001,"Iowa","Adair County",3,29,87,47,40
050,19,001,"Iowa","Adair County",3,30,78,42,36
050,19,001,"Iowa","Adair County",3,31,80,39,41
050,19,001,"Iowa","Adair County",3,32,91,49,42
050,19,001,"Iowa","Adair County",3,33,81,43,38
050,19,001,"Iowa","Adair County",3,34,97,51,46
050,19,001,"Iowa","Adair County",3,35,95,45,50
050,19,001,"Iowa","Adair County",3,36,88,37,51
050,19,001,"Iowa","Adair County",3,37,73,40,33
050,19,001,"Iowa","Adair County",3,38,84,44,40
050,19,001,"Iowa","Adair County",3,39,97,46,51
050,19,001,"Iowa","Adair County",3,40,92,42,50
050,19,001,"Iowa","Adair County",3,41,89,51,38
050,19,001,"Iowa","Adair County",3,42,88,51,37
050,19,001,"Iowa","Adair County",3,43,78,43,35
050,19,001,"Iowa","Adair County",3,44,72,28,44
050,19,001,"Iowa","Adair County",3,45,73,34,39
050,19,001,"Iowa","Adair County",3,46,72,35,37
050,19,001,"Iowa","Adair County",3,47,66,31,35
050,19,001,"Iowa","Adair County",3,48,69,33,36
050,19,001,"Iowa","Adair County",3,49,87,48,39
050,19,001,"Iowa","Adair County",3,50,92,43,49
050,19,001,"Iowa","Adair County",3,51,84,42,42
050,19,001,"Iowa","Adair County",3,52,83,41,42
050,19,001,"Iowa","Adair County",3,53,76,44,32
050,19,001,"Iowa","Adair County",3,54,86,44,42
050,19,001,"Iowa","Adair County",3,55,105,49,56
050,19,001,"Iowa","Adair County",3,56,98,53,45
050,19,001,"Iowa","Adair County",3,57,98,50,48
050,19,001,"Iowa","Adair County",3,58,115,60,55
050,19,001,"Iowa","Adair County",3,59,127,67,60
050,19,001,"Iowa","Adair County",3,60,129,65,64
050,19,001,"Iowa","Adair County",3,61,121,61,60
050,19,001,"Iowa","Adair County",3,62,120,60,60
050,19,001,"Iowa","Adair County",3,63,119,60,59
050,19,001,"Iowa","Adair County",3,64,128,69,59
050,19,001,"Iowa","Adair County",3,65,115,69,46
050,19,001,"Iowa","Adair County",3,66,102,62,40
050,19,001,"Iowa","Adair County",3,67,101,57,44
050,19,001,"Iowa","Adair County",3,68,102,55,47
050,19,001,"Iowa","Adair County",3,69,98,50,48
050,19,001,"Iowa","Adair County",3,70,84,44,40
050,19,001,"Iowa","Adair County",3,71,82,37,45
050,19,001,"Iowa","Adair County",3,72,80,37,43
050,19,001,"Iowa","Adair County",3,73,70,34,36
050,19,001,"Iowa","Adair County",3,74,70,36,34
050,19,001,"Iowa","Adair County",3,75,57,29,28
050,19,001,"Iowa","Adair County",3,76,59,28,31
050,19,001,"Iowa","Adair County",3,77,52,26,26
050,19,001,"Iowa","Adair County",3,78,50,24,26
050,19,001,"Iowa","Adair County",3,79,47,18,29
050,19,001,"Iowa","Adair County",3,80,43,14,29
050,19,001,"Iowa","Adair County",3,81,43,16,27
050,19,001,"Iowa","Adair County",3,82,51,23,28
050,19,001,"Iowa","Adair County",3,83,44,20,24
050,19,001,"Iowa","Adair County",3,84,43,18,25
050,19,001,"Iowa","Adair County",3,85,277,99,178
050,19,001,"Iowa","Adair County",4,0,83,43,40
050,19,001,"Iowa","Adair County",4,1,76,36,40
050,19,001,"Iowa","Adair County",4,2,107,49,58
050,19,001,"Iowa","Adair County",4,3,107,52,55
050,19,001,"Iowa","Adair County",4,4,90,49,41
050,19,001,"Iowa","Adair County",4,5,96,51,45
050,19,001,"Iowa","Adair County",4,6,89,42,47
050,19,001,"Iowa","Adair County",4,7,75,41,34
050,19,001,"Iowa","Adair County",4,8,99,54,45
050,19,001,"Iowa","Adair County",4,9,90,40,50
050,19,001,"Iowa","Adair County",4,10,90,48,42
050,19,001,"Iowa","Adair County",4,11,97,53,44
050,19,001,"Iowa","Adair County",4,12,84,44,40
050,19,001,"Iowa","Adair County",4,13,91,44,47
050,19,001,"Iowa","Adair County",4,14,100,54,46
050,19,001,"Iowa","Adair County",4,15,117,63,54
050,19,001,"Iowa","Adair County",4,16,111,57,54
050,19,001,"Iowa","Adair County",4,17,75,33,42
050,19,001,"Iowa","Adair County",4,18,80,40,40
050,19,001,"Iowa","Adair County",4,19,58,28,30
050,19,001,"Iowa","Adair County",4,20,71,39,32
050,19,001,"Iowa","Adair County",4,21,84,40,44
050,19,001,"Iowa","Adair County",4,22,69,38,31
050,19,001,"Iowa","Adair County",4,23,72,43,29
050,19,001,"Iowa","Adair County",4,24,65,34,31
050,19,001,"Iowa","Adair County",4,25,61,37,24
050,19,001,"Iowa","Adair County",4,26,69,31,38
050,19,001,"Iowa","Adair County",4,27,86,44,42
050,19,001,"Iowa","Adair County",4,28,112,57,55
050,19,001,"Iowa","Adair County",4,29,96,55,41
050,19,001,"Iowa","Adair County",4,30,88,47,41
050,19,001,"Iowa","Adair County",4,31,77,42,35
050,19,001,"Iowa","Adair County",4,32,78,35,43
050,19,001,"Iowa","Adair County",4,33,91,50,41
050,19,001,"Iowa","Adair County",4,34,81,44,37
050,19,001,"Iowa","Adair County",4,35,92,50,42
050,19,001,"Iowa","Adair County",4,36,90,44,46
050,19,001,"Iowa","Adair County",4,37,84,35,49
050,19,001,"Iowa","Adair County",4,38,64,37,27
050,19,001,"Iowa","Adair County",4,39,71,37,34
050,19,001,"Iowa","Adair County",4,40,97,47,50
050,19,001,"Iowa","Adair County",4,41,96,41,55
050,19,001,"Iowa","Adair County",4,42,93,50,43
050,19,001,"Iowa","Adair County",4,43,93,55,38
050,19,001,"Iowa","Adair County",4,44,79,43,36
050,19,001,"Iowa","Adair County",4,45,71,27,44
050,19,001,"Iowa","Adair County",4,46,68,31,37
050,19,001,"Iowa","Adair County",4,47,77,35,42
050,19,001,"Iowa","Adair County",4,48,69,32,37
050,19,001,"Iowa","Adair County",4,49,70,37,33
050,19,001,"Iowa","Adair County",4,50,86,49,37
050,19,001,"Iowa","Adair County",4,51,86,41,45
050,19,001,"Iowa","Adair County",4,52,83,41,42
050,19,001,"Iowa","Adair County",4,53,83,41,42
050,19,001,"Iowa","Adair County",4,54,78,46,32
050,19,001,"Iowa","Adair County",4,55,90,47,43
050,19,001,"Iowa","Adair County",4,56,117,55,62
050,19,001,"Iowa","Adair County",4,57,101,54,47
050,19,001,"Iowa","Adair County",4,58,94,47,47
050,19,001,"Iowa","Adair County",4,59,117,59,58
050,19,001,"Iowa","Adair County",4,60,127,65,62
050,19,001,"Iowa","Adair County",4,61,126,63,63
050,19,001,"Iowa","Adair County",4,62,124,61,63
050,19,001,"Iowa","Adair County",4,63,116,59,57
050,19,001,"Iowa","Adair County",4,64,118,58,60
050,19,001,"Iowa","Adair County",4,65,131,70,61
050,19,001,"Iowa","Adair County",4,66,111,67,44
050,19,001,"Iowa","Adair County",4,67,104,62,42
050,19,001,"Iowa","Adair County",4,68,97,53,44
050,19,001,"Iowa","Adair County",4,69,94,52,42
050,19,001,"Iowa","Adair County",4,70,94,51,43
050,19,001,"Iowa","Adair County",4,71,85,46,39
050,19,001,"Iowa","Adair County",4,72,74,31,43
050,19,001,"Iowa","Adair County",4,73,76,33,43
050,19,001,"Iowa","Adair County",4,74,70,34,36
050,19,001,"Iowa","Adair County",4,75,64,35,29
050,19,001,"Iowa","Adair County",4,76,55,27,28
050,19,001,"Iowa","Adair County",4,77,53,23,30
050,19,001,"Iowa","Adair County",4,78,47,25,22
050,19,001,"Iowa","Adair County",4,79,47,22,25
050,19,001,"Iowa","Adair County",4,80,40,16,24
050,19,001,"Iowa","Adair County",4,81,43,15,28
050,19,001,"Iowa","Adair County",4,82,41,13,28
050,19,001,"Iowa","Adair County",4,83,43,19,24
050,19,001,"Iowa","Adair County",4,84,47,19,28
050,19,001,"Iowa","Adair County",4,85,266,98,168
050,19,001,"Iowa","Adair County",5,0,84,43,41
050,19,001,"Iowa","Adair County",5,1,78,41,37
050,19,001,"Iowa","Adair County",5,2,84,39,45
050,19,001,"Iowa","Adair County",5,3,109,50,59
050,19,001,"Iowa","Adair County",5,4,106,50,56
050,19,001,"Iowa","Adair County",5,5,87,50,37
050,19,001,"Iowa","Adair County",5,6,96,54,42
050,19,001,"Iowa","Adair County",5,7,88,41,47
050,19,001,"Iowa","Adair County",5,8,79,42,37
050,19,001,"Iowa","Adair County",5,9,93,51,42
050,19,001,"Iowa","Adair County",5,10,89,39,50
050,19,001,"Iowa","Adair County",5,11,95,53,42
050,19,001,"Iowa","Adair County",5,12,96,57,39
050,19,001,"Iowa","Adair County",5,13,87,47,40
050,19,001,"Iowa","Adair County",5,14,91,42,49
050,19,001,"Iowa","Adair County",5,15,101,56,45
050,19,001,"Iowa","Adair County",5,16,116,61,55
050,19,001,"Iowa","Adair County",5,17,110,54,56
050,19,001,"Iowa","Adair County",5,18,62,30,32
050,19,001,"Iowa","Adair County",5,19,62,30,32
050,19,001,"Iowa","Adair County",5,20,61,32,29
050,19,001,"Iowa","Adair County",5,21,81,42,39
050,19,001,"Iowa","Adair County",5,22,80,39,41
050,19,001,"Iowa","Adair County",5,23,80,40,40
050,19,001,"Iowa","Adair County",5,24,77,44,33
050,19,001,"Iowa","Adair County",5,25,69,35,34
050,19,001,"Iowa","Adair County",5,26,61,34,27
050,19,001,"Iowa","Adair County",5,27,78,39,39
050,19,001,"Iowa","Adair County",5,28,87,44,43
050,19,001,"Iowa","Adair County",5,29,104,57,47
050,19,001,"Iowa","Adair County",5,30,95,51,44
050,19,001,"Iowa","Adair County",5,31,84,46,38
050,19,001,"Iowa","Adair County",5,32,74,41,33
050,19,001,"Iowa","Adair County",5,33,81,37,44
050,19,001,"Iowa","Adair County",5,34,86,48,38
050,19,001,"Iowa","Adair County",5,35,80,42,38
050,19,001,"Iowa","Adair County",5,36,90,47,43
050,19,001,"Iowa","Adair County",5,37,88,46,42
050,19,001,"Iowa","Adair County",5,38,86,35,51
050,19,001,"Iowa","Adair County",5,39,60,37,23
050,19,001,"Iowa","Adair County",5,40,67,31,36
050,19,001,"Iowa","Adair County",5,41,94,44,50
050,19,001,"Iowa","Adair County",5,42,91,35,56
050,19,001,"Iowa","Adair County",5,43,94,50,44
050,19,001,"Iowa","Adair County",5,44,93,56,37
050,19,001,"Iowa","Adair County",5,45,77,44,33
050,19,001,"Iowa","Adair County",5,46,69,28,41
050,19,001,"Iowa","Adair County",5,47,73,32,41
050,19,001,"Iowa","Adair County",5,48,75,41,34
050,19,001,"Iowa","Adair County",5,49,74,34,40
050,19,001,"Iowa","Adair County",5,50,64,32,32
050,19,001,"Iowa","Adair County",5,51,79,49,30
050,19,001,"Iowa","Adair County",5,52,87,41,46
050,19,001,"Iowa","Adair County",5,53,79,37,42
050,19,001,"Iowa","Adair County",5,54,81,41,40
050,19,001,"Iowa","Adair County",5,55,76,42,34
050,19,001,"Iowa","Adair County",5,56,91,49,42
050,19,001,"Iowa","Adair County",5,57,113,52,61
050,19,001,"Iowa","Adair County",5,58,98,53,45
050,19,001,"Iowa","Adair County",5,59,98,47,51
050,19,001,"Iowa","Adair County",5,60,117,59,58
050,19,001,"Iowa","Adair County",5,61,125,63,62
050,19,001,"Iowa","Adair County",5,62,129,64,65
050,19,001,"Iowa","Adair County",5,63,118,58,60
050,19,001,"Iowa","Adair County",5,64,114,59,55
050,19,001,"Iowa","Adair County",5,65,118,58,60
050,19,001,"Iowa","Adair County",5,66,131,68,63
050,19,001,"Iowa","Adair County",5,67,111,65,46
050,19,001,"Iowa","Adair County",5,68,96,56,40
050,19,001,"Iowa","Adair County",5,69,88,50,38
050,19,001,"Iowa","Adair County",5,70,87,50,37
050,19,001,"Iowa","Adair County",5,71,92,50,42
050,19,001,"Iowa","Adair County",5,72,80,42,38
050,19,001,"Iowa","Adair County",5,73,71,28,43
050,19,001,"Iowa","Adair County",5,74,72,31,41
050,19,001,"Iowa","Adair County",5,75,68,35,33
050,19,001,"Iowa","Adair County",5,76,61,33,28
050,19,001,"Iowa","Adair County",5,77,47,22,25
050,19,001,"Iowa","Adair County",5,78,49,22,27
050,19,001,"Iowa","Adair County",5,79,44,22,22
050,19,001,"Iowa","Adair County",5,80,42,20,22
050,19,001,"Iowa","Adair County",5,81,42,16,26
050,19,001,"Iowa","Adair County",5,82,40,12,28
050,19,001,"Iowa","Adair County",5,83,36,12,24
050,19,001,"Iowa","Adair County",5,84,50,20,30
050,19,001,"Iowa","Adair County",5,85,273,105,168
050,19,003,"Iowa","Adams County",1,0,36,18,18
050,19,003,"Iowa","Adams County",1,1,31,17,14
050,19,003,"Iowa","Adams County",1,2,42,18,24
050,19,003,"Iowa","Adams County",1,3,49,23,26
050,19,003,"Iowa","Adams County",1,4,41,21,20
050,19,003,"Iowa","Adams County",1,5,47,25,22
050,19,003,"Iowa","Adams County",1,6,45,24,21
050,19,003,"Iowa","Adams County",1,7,51,24,27
050,19,003,"Iowa","Adams County",1,8,41,21,20
050,19,003,"Iowa","Adams County",1,9,33,21,12
050,19,003,"Iowa","Adams County",1,10,50,30,20
050,19,003,"Iowa","Adams County",1,11,58,31,27
050,19,003,"Iowa","Adams County",1,12,48,19,29
050,19,003,"Iowa","Adams County",1,13,54,26,28
050,19,003,"Iowa","Adams County",1,14,50,24,26
050,19,003,"Iowa","Adams County",1,15,43,20,23
050,19,003,"Iowa","Adams County",1,16,44,24,20
050,19,003,"Iowa","Adams County",1,17,41,20,21
050,19,003,"Iowa","Adams County",1,18,40,22,18
050,19,003,"Iowa","Adams County",1,19,28,19,9
050,19,003,"Iowa","Adams County",1,20,30,16,14
050,19,003,"Iowa","Adams County",1,21,36,19,17
050,19,003,"Iowa","Adams County",1,22,25,10,15
050,19,003,"Iowa","Adams County",1,23,34,21,13
050,19,003,"Iowa","Adams County",1,24,34,18,16
050,19,003,"Iowa","Adams County",1,25,37,18,19
050,19,003,"Iowa","Adams County",1,26,32,20,12
050,19,003,"Iowa","Adams County",1,27,28,14,14
050,19,003,"Iowa","Adams County",1,28,39,17,22
050,19,003,"Iowa","Adams County",1,29,40,23,17
050,19,003,"Iowa","Adams County",1,30,41,21,20
050,19,003,"Iowa","Adams County",1,31,47,25,22
050,19,003,"Iowa","Adams County",1,32,36,15,21
050,19,003,"Iowa","Adams County",1,33,35,18,17
050,19,003,"Iowa","Adams County",1,34,42,24,18
050,19,003,"Iowa","Adams County",1,35,45,28,17
050,19,003,"Iowa","Adams County",1,36,38,17,21
050,19,003,"Iowa","Adams County",1,37,38,19,19
050,19,003,"Iowa","Adams County",1,38,44,27,17
050,19,003,"Iowa","Adams County",1,39,40,21,19
050,19,003,"Iowa","Adams County",1,40,44,19,25
050,19,003,"Iowa","Adams County",1,41,40,18,22
050,19,003,"Iowa","Adams County",1,42,34,15,19
050,19,003,"Iowa","Adams County",1,43,40,17,23
050,19,003,"Iowa","Adams County",1,44,28,14,14
050,19,003,"Iowa","Adams County",1,45,30,13,17
050,19,003,"Iowa","Adams County",1,46,34,19,15
050,19,003,"Iowa","Adams County",1,47,37,23,14
050,19,003,"Iowa","Adams County",1,48,42,27,15
050,19,003,"Iowa","Adams County",1,49,44,27,17
050,19,003,"Iowa","Adams County",1,50,39,18,21
050,19,003,"Iowa","Adams County",1,51,36,18,18
050,19,003,"Iowa","Adams County",1,52,30,15,15
050,19,003,"Iowa","Adams County",1,53,43,20,23
050,19,003,"Iowa","Adams County",1,54,44,17,27
050,19,003,"Iowa","Adams County",1,55,54,21,33
050,19,003,"Iowa","Adams County",1,56,56,23,33
050,19,003,"Iowa","Adams County",1,57,65,36,29
050,19,003,"Iowa","Adams County",1,58,59,34,25
050,19,003,"Iowa","Adams County",1,59,84,45,39
050,19,003,"Iowa","Adams County",1,60,75,41,34
050,19,003,"Iowa","Adams County",1,61,75,40,35
050,19,003,"Iowa","Adams County",1,62,70,35,35
050,19,003,"Iowa","Adams County",1,63,60,30,30
050,19,003,"Iowa","Adams County",1,64,56,30,26
050,19,003,"Iowa","Adams County",1,65,49,26,23
050,19,003,"Iowa","Adams County",1,66,52,27,25
050,19,003,"Iowa","Adams County",1,67,58,26,32
050,19,003,"Iowa","Adams County",1,68,39,25,14
050,19,003,"Iowa","Adams County",1,69,43,27,16
050,19,003,"Iowa","Adams County",1,70,42,19,23
050,19,003,"Iowa","Adams County",1,71,53,25,28
050,19,003,"Iowa","Adams County",1,72,49,24,25
050,19,003,"Iowa","Adams County",1,73,45,21,24
050,19,003,"Iowa","Adams County",1,74,34,17,17
050,19,003,"Iowa","Adams County",1,75,30,15,15
050,19,003,"Iowa","Adams County",1,76,31,15,16
050,19,003,"Iowa","Adams County",1,77,35,15,20
050,19,003,"Iowa","Adams County",1,78,38,21,17
050,19,003,"Iowa","Adams County",1,79,37,17,20
050,19,003,"Iowa","Adams County",1,80,29,14,15
050,19,003,"Iowa","Adams County",1,81,25,12,13
050,19,003,"Iowa","Adams County",1,82,22,11,11
050,19,003,"Iowa","Adams County",1,83,24,11,13
050,19,003,"Iowa","Adams County",1,84,21,6,15
050,19,003,"Iowa","Adams County",1,85,119,34,85
050,19,003,"Iowa","Adams County",2,0,39,20,19
050,19,003,"Iowa","Adams County",2,1,33,17,16
050,19,003,"Iowa","Adams County",2,2,39,17,22
050,19,003,"Iowa","Adams County",2,3,46,21,25
050,19,003,"Iowa","Adams County",2,4,43,21,22
050,19,003,"Iowa","Adams County",2,5,45,24,21
050,19,003,"Iowa","Adams County",2,6,45,23,22
050,19,003,"Iowa","Adams County",2,7,51,25,26
050,19,003,"Iowa","Adams County",2,8,43,22,21
050,19,003,"Iowa","Adams County",2,9,36,22,14
050,19,003,"Iowa","Adams County",2,10,48,29,19
050,19,003,"Iowa","Adams County",2,11,54,29,25
050,19,003,"Iowa","Adams County",2,12,51,23,28
050,19,003,"Iowa","Adams County",2,13,52,25,27
050,19,003,"Iowa","Adams County",2,14,51,25,26
050,19,003,"Iowa","Adams County",2,15,46,22,24
050,19,003,"Iowa","Adams County",2,16,44,23,21
050,19,003,"Iowa","Adams County",2,17,43,22,21
050,19,003,"Iowa","Adams County",2,18,39,21,18
050,19,003,"Iowa","Adams County",2,19,30,19,11
050,19,003,"Iowa","Adams County",2,20,30,16,14
050,19,003,"Iowa","Adams County",2,21,35,18,17
050,19,003,"Iowa","Adams County",2,22,27,12,15
050,19,003,"Iowa","Adams County",2,23,34,20,14
050,19,003,"Iowa","Adams County",2,24,35,19,16
050,19,003,"Iowa","Adams County",2,25,35,18,17
050,19,003,"Iowa","Adams County",2,26,33,19,14
050,19,003,"Iowa","Adams County",2,27,29,15,14
050,19,003,"Iowa","Adams County",2,28,37,17,20
050,19,003,"Iowa","Adams County",2,29,40,22,18
050,19,003,"Iowa","Adams County",2,30,42,22,20
050,19,003,"Iowa","Adams County",2,31,45,24,21
050,19,003,"Iowa","Adams County",2,32,37,17,20
050,19,003,"Iowa","Adams County",2,33,35,17,18
050,19,003,"Iowa","Adams County",2,34,41,23,18
050,19,003,"Iowa","Adams County",2,35,44,27,17
050,19,003,"Iowa","Adams County",2,36,39,19,20
050,19,003,"Iowa","Adams County",2,37,38,19,19
050,19,003,"Iowa","Adams County",2,38,43,25,18
050,19,003,"Iowa","Adams County",2,39,42,23,19
050,19,003,"Iowa","Adams County",2,40,44,20,24
050,19,003,"Iowa","Adams County",2,41,41,18,23
050,19,003,"Iowa","Adams County",2,42,35,16,19
050,19,003,"Iowa","Adams County",2,43,40,17,23
050,19,003,"Iowa","Adams County",2,44,30,14,16
050,19,003,"Iowa","Adams County",2,45,29,13,16
050,19,003,"Iowa","Adams County",2,46,33,18,15
050,19,003,"Iowa","Adams County",2,47,37,23,14
050,19,003,"Iowa","Adams County",2,48,40,26,14
050,19,003,"Iowa","Adams County",2,49,44,28,16
050,19,003,"Iowa","Adams County",2,50,40,20,20
050,19,003,"Iowa","Adams County",2,51,37,18,19
050,19,003,"Iowa","Adams County",2,52,32,16,16
050,19,003,"Iowa","Adams County",2,53,40,19,21
050,19,003,"Iowa","Adams County",2,54,43,18,25
050,19,003,"Iowa","Adams County",2,55,51,20,31
050,19,003,"Iowa","Adams County",2,56,56,23,33
050,19,003,"Iowa","Adams County",2,57,62,33,29
050,19,003,"Iowa","Adams County",2,58,60,34,26
050,19,003,"Iowa","Adams County",2,59,78,42,36
050,19,003,"Iowa","Adams County",2,60,77,42,35
050,19,003,"Iowa","Adams County",2,61,74,40,34
050,19,003,"Iowa","Adams County",2,62,72,37,35
050,19,003,"Iowa","Adams County",2,63,63,32,31
050,19,003,"Iowa","Adams County",2,64,56,30,26
050,19,003,"Iowa","Adams County",2,65,51,27,24
050,19,003,"Iowa","Adams County",2,66,52,27,25
050,19,003,"Iowa","Adams County",2,67,54,25,29
050,19,003,"Iowa","Adams County",2,68,42,25,17
050,19,003,"Iowa","Adams County",2,69,42,26,16
050,19,003,"Iowa","Adams County",2,70,42,21,21
050,19,003,"Iowa","Adams County",2,71,51,24,27
050,19,003,"Iowa","Adams County",2,72,48,23,25
050,19,003,"Iowa","Adams County",2,73,48,23,25
050,19,003,"Iowa","Adams County",2,74,35,17,18
050,19,003,"Iowa","Adams County",2,75,32,16,16
050,19,003,"Iowa","Adams County",2,76,30,15,15
050,19,003,"Iowa","Adams County",2,77,36,16,20
050,19,003,"Iowa","Adams County",2,78,36,19,17
050,19,003,"Iowa","Adams County",2,79,37,18,19
050,19,003,"Iowa","Adams County",2,80,31,15,16
050,19,003,"Iowa","Adams County",2,81,26,13,13
050,19,003,"Iowa","Adams County",2,82,22,11,11
050,19,003,"Iowa","Adams County",2,83,22,10,12
050,19,003,"Iowa","Adams County",2,84,21,7,14
050,19,003,"Iowa","Adams County",2,85,118,32,86
050,19,003,"Iowa","Adams County",3,0,43,22,21
050,19,003,"Iowa","Adams County",3,1,38,20,18
050,19,003,"Iowa","Adams County",3,2,32,17,15
050,19,003,"Iowa","Adams County",3,3,36,17,19
050,19,003,"Iowa","Adams County",3,4,40,18,22
050,19,003,"Iowa","Adams County",3,5,41,20,21
050,19,003,"Iowa","Adams County",3,6,43,23,20
050,19,003,"Iowa","Adams County",3,7,45,24,21
050,19,003,"Iowa","Adams County",3,8,51,26,25
050,19,003,"Iowa","Adams County",3,9,45,22,23
050,19,003,"Iowa","Adams County",3,10,40,23,17
050,19,003,"Iowa","Adams County",3,11,49,27,22
050,19,003,"Iowa","Adams County",3,12,53,27,26
050,19,003,"Iowa","Adams County",3,13,56,29,27
050,19,003,"Iowa","Adams County",3,14,49,25,24
050,19,003,"Iowa","Adams County",3,15,52,24,28
050,19,003,"Iowa","Adams County",3,16,43,19,24
050,19,003,"Iowa","Adams County",3,17,43,19,24
050,19,003,"Iowa","Adams County",3,18,35,19,16
050,19,003,"Iowa","Adams County",3,19,31,16,15
050,19,003,"Iowa","Adams County",3,20,28,18,10
050,19,003,"Iowa","Adams County",3,21,28,14,14
050,19,003,"Iowa","Adams County",3,22,38,21,17
050,19,003,"Iowa","Adams County",3,23,23,10,13
050,19,003,"Iowa","Adams County",3,24,27,17,10
050,19,003,"Iowa","Adams County",3,25,36,19,17
050,19,003,"Iowa","Adams County",3,26,33,13,20
050,19,003,"Iowa","Adams County",3,27,30,18,12
050,19,003,"Iowa","Adams County",3,28,25,13,12
050,19,003,"Iowa","Adams County",3,29,39,19,20
050,19,003,"Iowa","Adams County",3,30,36,16,20
050,19,003,"Iowa","Adams County",3,31,41,19,22
050,19,003,"Iowa","Adams County",3,32,50,28,22
050,19,003,"Iowa","Adams County",3,33,37,16,21
050,19,003,"Iowa","Adams County",3,34,36,17,19
050,19,003,"Iowa","Adams County",3,35,39,21,18
050,19,003,"Iowa","Adams County",3,36,43,24,19
050,19,003,"Iowa","Adams County",3,37,35,16,19
050,19,003,"Iowa","Adams County",3,38,36,16,20
050,19,003,"Iowa","Adams County",3,39,44,26,18
050,19,003,"Iowa","Adams County",3,40,40,23,17
050,19,003,"Iowa","Adams County",3,41,46,20,26
050,19,003,"Iowa","Adams County",3,42,42,20,22
050,19,003,"Iowa","Adams County",3,43,34,16,18
050,19,003,"Iowa","Adams County",3,44,45,20,25
050,19,003,"Iowa","Adams County",3,45,26,12,14
050,19,003,"Iowa","Adams County",3,46,30,14,16
050,19,003,"Iowa","Adams County",3,47,33,18,15
050,19,003,"Iowa","Adams County",3,48,37,24,13
050,19,003,"Iowa","Adams County",3,49,41,27,14
050,19,003,"Iowa","Adams County",3,50,38,24,14
050,19,003,"Iowa","Adams County",3,51,39,20,19
050,19,003,"Iowa","Adams County",3,52,37,18,19
050,19,003,"Iowa","Adams County",3,53,31,16,15
050,19,003,"Iowa","Adams County",3,54,40,18,22
050,19,003,"Iowa","Adams County",3,55,42,18,24
050,19,003,"Iowa","Adams County",3,56,51,20,31
050,19,003,"Iowa","Adams County",3,57,62,24,38
050,19,003,"Iowa","Adams County",3,58,63,33,30
050,19,003,"Iowa","Adams County",3,59,58,32,26
050,19,003,"Iowa","Adams County",3,60,76,42,34
050,19,003,"Iowa","Adams County",3,61,74,39,35
050,19,003,"Iowa","Adams County",3,62,76,41,35
050,19,003,"Iowa","Adams County",3,63,71,38,33
050,19,003,"Iowa","Adams County",3,64,59,29,30
050,19,003,"Iowa","Adams County",3,65,59,32,27
050,19,003,"Iowa","Adams County",3,66,49,26,23
050,19,003,"Iowa","Adams County",3,67,52,26,26
050,19,003,"Iowa","Adams County",3,68,51,24,27
050,19,003,"Iowa","Adams County",3,69,41,24,17
050,19,003,"Iowa","Adams County",3,70,37,21,16
050,19,003,"Iowa","Adams County",3,71,41,22,19
050,19,003,"Iowa","Adams County",3,72,48,23,25
050,19,003,"Iowa","Adams County",3,73,46,22,24
050,19,003,"Iowa","Adams County",3,74,48,22,26
050,19,003,"Iowa","Adams County",3,75,33,17,16
050,19,003,"Iowa","Adams County",3,76,32,16,16
050,19,003,"Iowa","Adams County",3,77,31,15,16
050,19,003,"Iowa","Adams County",3,78,34,15,19
050,19,003,"Iowa","Adams County",3,79,36,19,17
050,19,003,"Iowa","Adams County",3,80,36,18,18
050,19,003,"Iowa","Adams County",3,81,31,15,16
050,19,003,"Iowa","Adams County",3,82,26,13,13
050,19,003,"Iowa","Adams County",3,83,18,9,9
050,19,003,"Iowa","Adams County",3,84,21,10,11
050,19,003,"Iowa","Adams County",3,85,108,29,79
050,19,003,"Iowa","Adams County",4,0,41,21,20
050,19,003,"Iowa","Adams County",4,1,45,24,21
050,19,003,"Iowa","Adams County",4,2,38,19,19
050,19,003,"Iowa","Adams County",4,3,34,20,14
050,19,003,"Iowa","Adams County",4,4,34,14,20
050,19,003,"Iowa","Adams County",4,5,38,17,21
050,19,003,"Iowa","Adams County",4,6,43,23,20
050,19,003,"Iowa","Adams County",4,7,43,22,21
050,19,003,"Iowa","Adams County",4,8,47,24,23
050,19,003,"Iowa","Adams County",4,9,59,31,28
050,19,003,"Iowa","Adams County",4,10,47,22,25
050,19,003,"Iowa","Adams County",4,11,36,19,17
050,19,003,"Iowa","Adams County",4,12,49,28,21
050,19,003,"Iowa","Adams County",4,13,49,27,22
050,19,003,"Iowa","Adams County",4,14,49,24,25
050,19,003,"Iowa","Adams County",4,15,53,28,25
050,19,003,"Iowa","Adams County",4,16,50,25,25
050,19,003,"Iowa","Adams County",4,17,43,21,22
050,19,003,"Iowa","Adams County",4,18,39,21,18
050,19,003,"Iowa","Adams County",4,19,27,14,13
050,19,003,"Iowa","Adams County",4,20,24,12,12
050,19,003,"Iowa","Adams County",4,21,33,22,11
050,19,003,"Iowa","Adams County",4,22,29,19,10
050,19,003,"Iowa","Adams County",4,23,37,16,21
050,19,003,"Iowa","Adams County",4,24,24,9,15
050,19,003,"Iowa","Adams County",4,25,29,17,12
050,19,003,"Iowa","Adams County",4,26,31,15,16
050,19,003,"Iowa","Adams County",4,27,31,12,19
050,19,003,"Iowa","Adams County",4,28,29,18,11
050,19,003,"Iowa","Adams County",4,29,28,16,12
050,19,003,"Iowa","Adams County",4,30,34,14,20
050,19,003,"Iowa","Adams County",4,31,31,15,16
050,19,003,"Iowa","Adams County",4,32,42,18,24
050,19,003,"Iowa","Adams County",4,33,52,26,26
050,19,003,"Iowa","Adams County",4,34,36,17,19
050,19,003,"Iowa","Adams County",4,35,38,19,19
050,19,003,"Iowa","Adams County",4,36,38,21,17
050,19,003,"Iowa","Adams County",4,37,40,23,17
050,19,003,"Iowa","Adams County",4,38,40,18,22
050,19,003,"Iowa","Adams County",4,39,33,17,16
050,19,003,"Iowa","Adams County",4,40,42,25,17
050,19,003,"Iowa","Adams County",4,41,41,23,18
050,19,003,"Iowa","Adams County",4,42,46,22,24
050,19,003,"Iowa","Adams County",4,43,39,20,19
050,19,003,"Iowa","Adams County",4,44,34,15,19
050,19,003,"Iowa","Adams County",4,45,41,16,25
050,19,003,"Iowa","Adams County",4,46,28,13,15
050,19,003,"Iowa","Adams County",4,47,29,13,16
050,19,003,"Iowa","Adams County",4,48,34,20,14
050,19,003,"Iowa","Adams County",4,49,39,25,14
050,19,003,"Iowa","Adams County",4,50,40,26,14
050,19,003,"Iowa","Adams County",4,51,37,24,13
050,19,003,"Iowa","Adams County",4,52,40,21,19
050,19,003,"Iowa","Adams County",4,53,37,18,19
050,19,003,"Iowa","Adams County",4,54,33,17,16
050,19,003,"Iowa","Adams County",4,55,38,18,20
050,19,003,"Iowa","Adams County",4,56,42,18,24
050,19,003,"Iowa","Adams County",4,57,53,21,32
050,19,003,"Iowa","Adams County",4,58,66,25,41
050,19,003,"Iowa","Adams County",4,59,61,31,30
050,19,003,"Iowa","Adams County",4,60,61,34,27
050,19,003,"Iowa","Adams County",4,61,73,42,31
050,19,003,"Iowa","Adams County",4,62,79,42,37
050,19,003,"Iowa","Adams County",4,63,76,43,33
050,19,003,"Iowa","Adams County",4,64,63,33,30
050,19,003,"Iowa","Adams County",4,65,59,29,30
050,19,003,"Iowa","Adams County",4,66,59,32,27
050,19,003,"Iowa","Adams County",4,67,53,25,28
050,19,003,"Iowa","Adams County",4,68,50,25,25
050,19,003,"Iowa","Adams County",4,69,50,23,27
050,19,003,"Iowa","Adams County",4,70,39,24,15
050,19,003,"Iowa","Adams County",4,71,37,21,16
050,19,003,"Iowa","Adams County",4,72,37,20,17
050,19,003,"Iowa","Adams County",4,73,50,24,26
050,19,003,"Iowa","Adams County",4,74,43,20,23
050,19,003,"Iowa","Adams County",4,75,46,21,25
050,19,003,"Iowa","Adams County",4,76,33,16,17
050,19,003,"Iowa","Adams County",4,77,29,14,15
050,19,003,"Iowa","Adams County",4,78,28,15,13
050,19,003,"Iowa","Adams County",4,79,31,14,17
050,19,003,"Iowa","Adams County",4,80,33,17,16
050,19,003,"Iowa","Adams County",4,81,34,17,17
050,19,003,"Iowa","Adams County",4,82,30,14,16
050,19,003,"Iowa","Adams County",4,83,23,11,12
050,19,003,"Iowa","Adams County",4,84,15,8,7
050,19,003,"Iowa","Adams County",4,85,107,29,78
050,19,003,"Iowa","Adams County",5,0,39,19,20
050,19,003,"Iowa","Adams County",5,1,41,23,18
050,19,003,"Iowa","Adams County",5,2,40,20,20
050,19,003,"Iowa","Adams County",5,3,38,19,19
050,19,003,"Iowa","Adams County",5,4,32,18,14
050,19,003,"Iowa","Adams County",5,5,32,11,21
050,19,003,"Iowa","Adams County",5,6,37,18,19
050,19,003,"Iowa","Adams County",5,7,45,25,20
050,19,003,"Iowa","Adams County",5,8,42,23,19
050,19,003,"Iowa","Adams County",5,9,47,26,21
050,19,003,"Iowa","Adams County",5,10,50,26,24
050,19,003,"Iowa","Adams County",5,11,46,20,26
050,19,003,"Iowa","Adams County",5,12,34,19,15
050,19,003,"Iowa","Adams County",5,13,48,25,23
050,19,003,"Iowa","Adams County",5,14,50,29,21
050,19,003,"Iowa","Adams County",5,15,51,25,26
050,19,003,"Iowa","Adams County",5,16,47,24,23
050,19,003,"Iowa","Adams County",5,17,47,25,22
050,19,003,"Iowa","Adams County",5,18,33,18,15
050,19,003,"Iowa","Adams County",5,19,32,15,17
050,19,003,"Iowa","Adams County",5,20,29,15,14
050,19,003,"Iowa","Adams County",5,21,27,14,13
050,19,003,"Iowa","Adams County",5,22,33,21,12
050,19,003,"Iowa","Adams County",5,23,36,22,14
050,19,003,"Iowa","Adams County",5,24,39,18,21
050,19,003,"Iowa","Adams County",5,25,22,10,12
050,19,003,"Iowa","Adams County",5,26,26,16,10
050,19,003,"Iowa","Adams County",5,27,37,18,19
050,19,003,"Iowa","Adams County",5,28,29,12,17
050,19,003,"Iowa","Adams County",5,29,39,22,17
050,19,003,"Iowa","Adams County",5,30,21,11,10
050,19,003,"Iowa","Adams County",5,31,35,15,20
050,19,003,"Iowa","Adams County",5,32,29,14,15
050,19,003,"Iowa","Adams County",5,33,38,16,22
050,19,003,"Iowa","Adams County",5,34,56,27,29
050,19,003,"Iowa","Adams County",5,35,34,15,19
050,19,003,"Iowa","Adams County",5,36,35,18,17
050,19,003,"Iowa","Adams County",5,37,32,15,17
050,19,003,"Iowa","Adams County",5,38,40,26,14
050,19,003,"Iowa","Adams County",5,39,41,19,22
050,19,003,"Iowa","Adams County",5,40,32,15,17
050,19,003,"Iowa","Adams County",5,41,44,26,18
050,19,003,"Iowa","Adams County",5,42,39,24,15
050,19,003,"Iowa","Adams County",5,43,46,22,24
050,19,003,"Iowa","Adams County",5,44,38,20,18
050,19,003,"Iowa","Adams County",5,45,32,14,18
050,19,003,"Iowa","Adams County",5,46,40,15,25
050,19,003,"Iowa","Adams County",5,47,27,12,15
050,19,003,"Iowa","Adams County",5,48,30,14,16
050,19,003,"Iowa","Adams County",5,49,40,25,15
050,19,003,"Iowa","Adams County",5,50,41,23,18
050,19,003,"Iowa","Adams County",5,51,40,27,13
050,19,003,"Iowa","Adams County",5,52,39,25,14
050,19,003,"Iowa","Adams County",5,53,41,23,18
050,19,003,"Iowa","Adams County",5,54,39,18,21
050,19,003,"Iowa","Adams County",5,55,31,17,14
050,19,003,"Iowa","Adams County",5,56,40,17,23
050,19,003,"Iowa","Adams County",5,57,48,21,27
050,19,003,"Iowa","Adams County",5,58,53,22,31
050,19,003,"Iowa","Adams County",5,59,62,23,39
050,19,003,"Iowa","Adams County",5,60,61,32,29
050,19,003,"Iowa","Adams County",5,61,59,32,27
050,19,003,"Iowa","Adams County",5,62,77,45,32
050,19,003,"Iowa","Adams County",5,63,76,40,36
050,19,003,"Iowa","Adams County",5,64,74,41,33
050,19,003,"Iowa","Adams County",5,65,63,33,30
050,19,003,"Iowa","Adams County",5,66,60,29,31
050,19,003,"Iowa","Adams County",5,67,58,30,28
050,19,003,"Iowa","Adams County",5,68,53,25,28
050,19,003,"Iowa","Adams County",5,69,49,24,25
050,19,003,"Iowa","Adams County",5,70,46,23,23
050,19,003,"Iowa","Adams County",5,71,38,23,15
050,19,003,"Iowa","Adams County",5,72,32,18,14
050,19,003,"Iowa","Adams County",5,73,39,21,18
050,19,003,"Iowa","Adams County",5,74,46,22,24
050,19,003,"Iowa","Adams County",5,75,43,19,24
050,19,003,"Iowa","Adams County",5,76,42,18,24
050,19,003,"Iowa","Adams County",5,77,32,15,17
050,19,003,"Iowa","Adams County",5,78,28,14,14
050,19,003,"Iowa","Adams County",5,79,27,16,11
050,19,003,"Iowa","Adams County",5,80,28,13,15
050,19,003,"Iowa","Adams County",5,81,30,17,13
050,19,003,"Iowa","Adams County",5,82,32,16,16
050,19,003,"Iowa","Adams County",5,83,27,12,15
050,19,003,"Iowa","Adams County",5,84,21,11,10
050,19,003,"Iowa","Adams County",5,85,92,22,70
050,19,005,"Iowa","Allamakee County",1,0,184,94,90
050,19,005,"Iowa","Allamakee County",1,1,205,110,95
050,19,005,"Iowa","Allamakee County",1,2,200,117,83
050,19,005,"Iowa","Allamakee County",1,3,206,114,92
050,19,005,"Iowa","Allamakee County",1,4,185,102,83
050,19,005,"Iowa","Allamakee County",1,5,187,94,93
050,19,005,"Iowa","Allamakee County",1,6,174,92,82
050,19,005,"Iowa","Allamakee County",1,7,186,91,95
050,19,005,"Iowa","Allamakee County",1,8,158,83,75
050,19,005,"Iowa","Allamakee County",1,9,176,80,96
050,19,005,"Iowa","Allamakee County",1,10,189,91,98
050,19,005,"Iowa","Allamakee County",1,11,193,100,93
050,19,005,"Iowa","Allamakee County",1,12,192,100,92
050,19,005,"Iowa","Allamakee County",1,13,205,114,91
050,19,005,"Iowa","Allamakee County",1,14,181,99,82
050,19,005,"Iowa","Allamakee County",1,15,185,95,90
050,19,005,"Iowa","Allamakee County",1,16,193,101,92
050,19,005,"Iowa","Allamakee County",1,17,170,85,85
050,19,005,"Iowa","Allamakee County",1,18,153,81,72
050,19,005,"Iowa","Allamakee County",1,19,115,59,56
050,19,005,"Iowa","Allamakee County",1,20,126,67,59
050,19,005,"Iowa","Allamakee County",1,21,132,69,63
050,19,005,"Iowa","Allamakee County",1,22,129,76,53
050,19,005,"Iowa","Allamakee County",1,23,142,81,61
050,19,005,"Iowa","Allamakee County",1,24,153,83,70
050,19,005,"Iowa","Allamakee County",1,25,144,76,68
050,19,005,"Iowa","Allamakee County",1,26,161,78,83
050,19,005,"Iowa","Allamakee County",1,27,147,72,75
050,19,005,"Iowa","Allamakee County",1,28,146,84,62
050,19,005,"Iowa","Allamakee County",1,29,133,69,64
050,19,005,"Iowa","Allamakee County",1,30,145,77,68
050,19,005,"Iowa","Allamakee County",1,31,139,75,64
050,19,005,"Iowa","Allamakee County",1,32,127,71,56
050,19,005,"Iowa","Allamakee County",1,33,142,73,69
050,19,005,"Iowa","Allamakee County",1,34,155,84,71
050,19,005,"Iowa","Allamakee County",1,35,150,77,73
050,19,005,"Iowa","Allamakee County",1,36,150,76,74
050,19,005,"Iowa","Allamakee County",1,37,157,84,73
050,19,005,"Iowa","Allamakee County",1,38,154,78,76
050,19,005,"Iowa","Allamakee County",1,39,163,82,81
050,19,005,"Iowa","Allamakee County",1,40,158,88,70
050,19,005,"Iowa","Allamakee County",1,41,145,74,71
050,19,005,"Iowa","Allamakee County",1,42,125,60,65
050,19,005,"Iowa","Allamakee County",1,43,133,68,65
050,19,005,"Iowa","Allamakee County",1,44,132,64,68
050,19,005,"Iowa","Allamakee County",1,45,148,86,62
050,19,005,"Iowa","Allamakee County",1,46,122,74,48
050,19,005,"Iowa","Allamakee County",1,47,126,62,64
050,19,005,"Iowa","Allamakee County",1,48,155,75,80
050,19,005,"Iowa","Allamakee County",1,49,161,87,74
050,19,005,"Iowa","Allamakee County",1,50,144,75,69
050,19,005,"Iowa","Allamakee County",1,51,167,82,85
050,19,005,"Iowa","Allamakee County",1,52,166,85,81
050,19,005,"Iowa","Allamakee County",1,53,171,87,84
050,19,005,"Iowa","Allamakee County",1,54,169,86,83
050,19,005,"Iowa","Allamakee County",1,55,177,90,87
050,19,005,"Iowa","Allamakee County",1,56,204,105,99
050,19,005,"Iowa","Allamakee County",1,57,214,105,109
050,19,005,"Iowa","Allamakee County",1,58,234,116,118
050,19,005,"Iowa","Allamakee County",1,59,218,125,93
050,19,005,"Iowa","Allamakee County",1,60,218,112,106
050,19,005,"Iowa","Allamakee County",1,61,230,114,116
050,19,005,"Iowa","Allamakee County",1,62,214,117,97
050,19,005,"Iowa","Allamakee County",1,63,208,114,94
050,19,005,"Iowa","Allamakee County",1,64,219,109,110
050,19,005,"Iowa","Allamakee County",1,65,217,113,104
050,19,005,"Iowa","Allamakee County",1,66,217,110,107
050,19,005,"Iowa","Allamakee County",1,67,215,104,111
050,19,005,"Iowa","Allamakee County",1,68,201,105,96
050,19,005,"Iowa","Allamakee County",1,69,180,93,87
050,19,005,"Iowa","Allamakee County",1,70,180,100,80
050,19,005,"Iowa","Allamakee County",1,71,186,95,91
050,19,005,"Iowa","Allamakee County",1,72,182,92,90
050,19,005,"Iowa","Allamakee County",1,73,159,78,81
050,19,005,"Iowa","Allamakee County",1,74,110,49,61
050,19,005,"Iowa","Allamakee County",1,75,125,58,67
050,19,005,"Iowa","Allamakee County",1,76,123,63,60
050,19,005,"Iowa","Allamakee County",1,77,119,59,60
050,19,005,"Iowa","Allamakee County",1,78,108,56,52
050,19,005,"Iowa","Allamakee County",1,79,101,49,52
050,19,005,"Iowa","Allamakee County",1,80,82,42,40
050,19,005,"Iowa","Allamakee County",1,81,90,47,43
050,19,005,"Iowa","Allamakee County",1,82,84,37,47
050,19,005,"Iowa","Allamakee County",1,83,74,34,40
050,19,005,"Iowa","Allamakee County",1,84,68,26,42
050,19,005,"Iowa","Allamakee County",1,85,353,133,220
050,19,005,"Iowa","Allamakee County",2,0,205,108,97
050,19,005,"Iowa","Allamakee County",2,1,197,105,92
050,19,005,"Iowa","Allamakee County",2,2,200,114,86
050,19,005,"Iowa","Allamakee County",2,3,204,115,89
050,19,005,"Iowa","Allamakee County",2,4,190,104,86
050,19,005,"Iowa","Allamakee County",2,5,187,95,92
050,19,005,"Iowa","Allamakee County",2,6,178,92,86
050,19,005,"Iowa","Allamakee County",2,7,182,93,89
050,19,005,"Iowa","Allamakee County",2,8,164,84,80
050,19,005,"Iowa","Allamakee County",2,9,173,80,93
050,19,005,"Iowa","Allamakee County",2,10,182,86,96
050,19,005,"Iowa","Allamakee County",2,11,190,98,92
050,19,005,"Iowa","Allamakee County",2,12,193,100,93
050,19,005,"Iowa","Allamakee County",2,13,203,110,93
050,19,005,"Iowa","Allamakee County",2,14,186,102,84
050,19,005,"Iowa","Allamakee County",2,15,186,96,90
050,19,005,"Iowa","Allamakee County",2,16,188,98,90
050,19,005,"Iowa","Allamakee County",2,17,178,90,88
050,19,005,"Iowa","Allamakee County",2,18,150,79,71
050,19,005,"Iowa","Allamakee County",2,19,119,62,57
050,19,005,"Iowa","Allamakee County",2,20,127,67,60
050,19,005,"Iowa","Allamakee County",2,21,130,67,63
050,19,005,"Iowa","Allamakee County",2,22,130,74,56
050,19,005,"Iowa","Allamakee County",2,23,139,79,60
050,19,005,"Iowa","Allamakee County",2,24,151,82,69
050,19,005,"Iowa","Allamakee County",2,25,147,79,68
050,19,005,"Iowa","Allamakee County",2,26,159,78,81
050,19,005,"Iowa","Allamakee County",2,27,149,73,76
050,19,005,"Iowa","Allamakee County",2,28,147,82,65
050,19,005,"Iowa","Allamakee County",2,29,137,73,64
050,19,005,"Iowa","Allamakee County",2,30,145,76,69
050,19,005,"Iowa","Allamakee County",2,31,140,76,64
050,19,005,"Iowa","Allamakee County",2,32,129,72,57
050,19,005,"Iowa","Allamakee County",2,33,138,72,66
050,19,005,"Iowa","Allamakee County",2,34,151,81,70
050,19,005,"Iowa","Allamakee County",2,35,153,80,73
050,19,005,"Iowa","Allamakee County",2,36,148,76,72
050,19,005,"Iowa","Allamakee County",2,37,157,83,74
050,19,005,"Iowa","Allamakee County",2,38,156,80,76
050,19,005,"Iowa","Allamakee County",2,39,161,82,79
050,19,005,"Iowa","Allamakee County",2,40,159,85,74
050,19,005,"Iowa","Allamakee County",2,41,147,76,71
050,19,005,"Iowa","Allamakee County",2,42,130,63,67
050,19,005,"Iowa","Allamakee County",2,43,133,67,66
050,19,005,"Iowa","Allamakee County",2,44,131,64,67
050,19,005,"Iowa","Allamakee County",2,45,145,82,63
050,19,005,"Iowa","Allamakee County",2,46,127,76,51
050,19,005,"Iowa","Allamakee County",2,47,126,64,62
050,19,005,"Iowa","Allamakee County",2,48,148,72,76
050,19,005,"Iowa","Allamakee County",2,49,162,86,76
050,19,005,"Iowa","Allamakee County",2,50,149,78,71
050,19,005,"Iowa","Allamakee County",2,51,160,80,80
050,19,005,"Iowa","Allamakee County",2,52,165,84,81
050,19,005,"Iowa","Allamakee County",2,53,170,87,83
050,19,005,"Iowa","Allamakee County",2,54,170,87,83
050,19,005,"Iowa","Allamakee County",2,55,176,90,86
050,19,005,"Iowa","Allamakee County",2,56,198,101,97
050,19,005,"Iowa","Allamakee County",2,57,213,106,107
050,19,005,"Iowa","Allamakee County",2,58,228,113,115
050,19,005,"Iowa","Allamakee County",2,59,223,123,100
050,19,005,"Iowa","Allamakee County",2,60,217,114,103
050,19,005,"Iowa","Allamakee County",2,61,226,113,113
050,19,005,"Iowa","Allamakee County",2,62,217,115,102
050,19,005,"Iowa","Allamakee County",2,63,214,117,97
050,19,005,"Iowa","Allamakee County",2,64,212,108,104
050,19,005,"Iowa","Allamakee County",2,65,213,109,104
050,19,005,"Iowa","Allamakee County",2,66,219,112,107
050,19,005,"Iowa","Allamakee County",2,67,216,106,110
050,19,005,"Iowa","Allamakee County",2,68,201,103,98
050,19,005,"Iowa","Allamakee County",2,69,183,94,89
050,19,005,"Iowa","Allamakee County",2,70,179,98,81
050,19,005,"Iowa","Allamakee County",2,71,186,96,90
050,19,005,"Iowa","Allamakee County",2,72,180,91,89
050,19,005,"Iowa","Allamakee County",2,73,172,85,87
050,19,005,"Iowa","Allamakee County",2,74,109,50,59
050,19,005,"Iowa","Allamakee County",2,75,123,57,66
050,19,005,"Iowa","Allamakee County",2,76,121,61,60
050,19,005,"Iowa","Allamakee County",2,77,121,60,61
050,19,005,"Iowa","Allamakee County",2,78,107,56,51
050,19,005,"Iowa","Allamakee County",2,79,101,50,51
050,19,005,"Iowa","Allamakee County",2,80,85,43,42
050,19,005,"Iowa","Allamakee County",2,81,87,45,42
050,19,005,"Iowa","Allamakee County",2,82,84,39,45
050,19,005,"Iowa","Allamakee County",2,83,76,35,41
050,19,005,"Iowa","Allamakee County",2,84,68,26,42
050,19,005,"Iowa","Allamakee County",2,85,345,132,213
050,19,005,"Iowa","Allamakee County",3,0,189,101,88
050,19,005,"Iowa","Allamakee County",3,1,204,111,93
050,19,005,"Iowa","Allamakee County",3,2,196,100,96
050,19,005,"Iowa","Allamakee County",3,3,192,107,85
050,19,005,"Iowa","Allamakee County",3,4,208,113,95
050,19,005,"Iowa","Allamakee County",3,5,187,97,90
050,19,005,"Iowa","Allamakee County",3,6,191,99,92
050,19,005,"Iowa","Allamakee County",3,7,180,93,87
050,19,005,"Iowa","Allamakee County",3,8,175,89,86
050,19,005,"Iowa","Allamakee County",3,9,169,86,83
050,19,005,"Iowa","Allamakee County",3,10,172,81,91
050,19,005,"Iowa","Allamakee County",3,11,173,80,93
050,19,005,"Iowa","Allamakee County",3,12,191,98,93
050,19,005,"Iowa","Allamakee County",3,13,199,103,96
050,19,005,"Iowa","Allamakee County",3,14,196,107,89
050,19,005,"Iowa","Allamakee County",3,15,180,101,79
050,19,005,"Iowa","Allamakee County",3,16,183,98,85
050,19,005,"Iowa","Allamakee County",3,17,190,101,89
050,19,005,"Iowa","Allamakee County",3,18,156,83,73
050,19,005,"Iowa","Allamakee County",3,19,115,58,57
050,19,005,"Iowa","Allamakee County",3,20,122,61,61
050,19,005,"Iowa","Allamakee County",3,21,131,72,59
050,19,005,"Iowa","Allamakee County",3,22,132,70,62
050,19,005,"Iowa","Allamakee County",3,23,125,74,51
050,19,005,"Iowa","Allamakee County",3,24,139,76,63
050,19,005,"Iowa","Allamakee County",3,25,142,79,63
050,19,005,"Iowa","Allamakee County",3,26,147,78,69
050,19,005,"Iowa","Allamakee County",3,27,156,76,80
050,19,005,"Iowa","Allamakee County",3,28,156,81,75
050,19,005,"Iowa","Allamakee County",3,29,146,81,65
050,19,005,"Iowa","Allamakee County",3,30,140,71,69
050,19,005,"Iowa","Allamakee County",3,31,140,74,66
050,19,005,"Iowa","Allamakee County",3,32,136,65,71
050,19,005,"Iowa","Allamakee County",3,33,126,70,56
050,19,005,"Iowa","Allamakee County",3,34,140,73,67
050,19,005,"Iowa","Allamakee County",3,35,148,78,70
050,19,005,"Iowa","Allamakee County",3,36,149,77,72
050,19,005,"Iowa","Allamakee County",3,37,148,79,69
050,19,005,"Iowa","Allamakee County",3,38,153,78,75
050,19,005,"Iowa","Allamakee County",3,39,158,83,75
050,19,005,"Iowa","Allamakee County",3,40,160,79,81
050,19,005,"Iowa","Allamakee County",3,41,158,86,72
050,19,005,"Iowa","Allamakee County",3,42,141,72,69
050,19,005,"Iowa","Allamakee County",3,43,137,69,68
050,19,005,"Iowa","Allamakee County",3,44,132,66,66
050,19,005,"Iowa","Allamakee County",3,45,136,64,72
050,19,005,"Iowa","Allamakee County",3,46,142,79,63
050,19,005,"Iowa","Allamakee County",3,47,127,75,52
050,19,005,"Iowa","Allamakee County",3,48,137,73,64
050,19,005,"Iowa","Allamakee County",3,49,149,74,75
050,19,005,"Iowa","Allamakee County",3,50,164,84,80
050,19,005,"Iowa","Allamakee County",3,51,147,75,72
050,19,005,"Iowa","Allamakee County",3,52,158,79,79
050,19,005,"Iowa","Allamakee County",3,53,168,86,82
050,19,005,"Iowa","Allamakee County",3,54,160,82,78
050,19,005,"Iowa","Allamakee County",3,55,172,90,82
050,19,005,"Iowa","Allamakee County",3,56,175,90,85
050,19,005,"Iowa","Allamakee County",3,57,202,106,96
050,19,005,"Iowa","Allamakee County",3,58,202,100,102
050,19,005,"Iowa","Allamakee County",3,59,227,113,114
050,19,005,"Iowa","Allamakee County",3,60,219,120,99
050,19,005,"Iowa","Allamakee County",3,61,220,116,104
050,19,005,"Iowa","Allamakee County",3,62,217,107,110
050,19,005,"Iowa","Allamakee County",3,63,222,115,107
050,19,005,"Iowa","Allamakee County",3,64,217,119,98
050,19,005,"Iowa","Allamakee County",3,65,209,110,99
050,19,005,"Iowa","Allamakee County",3,66,207,103,104
050,19,005,"Iowa","Allamakee County",3,67,219,114,105
050,19,005,"Iowa","Allamakee County",3,68,204,99,105
050,19,005,"Iowa","Allamakee County",3,69,194,97,97
050,19,005,"Iowa","Allamakee County",3,70,176,91,85
050,19,005,"Iowa","Allamakee County",3,71,170,90,80
050,19,005,"Iowa","Allamakee County",3,72,187,95,92
050,19,005,"Iowa","Allamakee County",3,73,167,86,81
050,19,005,"Iowa","Allamakee County",3,74,162,78,84
050,19,005,"Iowa","Allamakee County",3,75,114,52,62
050,19,005,"Iowa","Allamakee County",3,76,117,54,63
050,19,005,"Iowa","Allamakee County",3,77,121,59,62
050,19,005,"Iowa","Allamakee County",3,78,114,57,57
050,19,005,"Iowa","Allamakee County",3,79,100,54,46
050,19,005,"Iowa","Allamakee County",3,80,94,48,46
050,19,005,"Iowa","Allamakee County",3,81,81,41,40
050,19,005,"Iowa","Allamakee County",3,82,79,37,42
050,19,005,"Iowa","Allamakee County",3,83,81,40,41
050,19,005,"Iowa","Allamakee County",3,84,68,25,43
050,19,005,"Iowa","Allamakee County",3,85,335,127,208
050,19,005,"Iowa","Allamakee County",4,0,198,108,90
050,19,005,"Iowa","Allamakee County",4,1,192,98,94
050,19,005,"Iowa","Allamakee County",4,2,205,108,97
050,19,005,"Iowa","Allamakee County",4,3,198,101,97
050,19,005,"Iowa","Allamakee County",4,4,193,109,84
050,19,005,"Iowa","Allamakee County",4,5,206,118,88
050,19,005,"Iowa","Allamakee County",4,6,195,101,94
050,19,005,"Iowa","Allamakee County",4,7,196,99,97
050,19,005,"Iowa","Allamakee County",4,8,184,97,87
050,19,005,"Iowa","Allamakee County",4,9,185,95,90
050,19,005,"Iowa","Allamakee County",4,10,161,85,76
050,19,005,"Iowa","Allamakee County",4,11,169,82,87
050,19,005,"Iowa","Allamakee County",4,12,174,80,94
050,19,005,"Iowa","Allamakee County",4,13,190,98,92
050,19,005,"Iowa","Allamakee County",4,14,197,104,93
050,19,005,"Iowa","Allamakee County",4,15,197,109,88
050,19,005,"Iowa","Allamakee County",4,16,180,97,83
050,19,005,"Iowa","Allamakee County",4,17,189,98,91
050,19,005,"Iowa","Allamakee County",4,18,161,84,77
050,19,005,"Iowa","Allamakee County",4,19,116,66,50
050,19,005,"Iowa","Allamakee County",4,20,114,55,59
050,19,005,"Iowa","Allamakee County",4,21,114,57,57
050,19,005,"Iowa","Allamakee County",4,22,135,70,65
050,19,005,"Iowa","Allamakee County",4,23,129,67,62
050,19,005,"Iowa","Allamakee County",4,24,132,74,58
050,19,005,"Iowa","Allamakee County",4,25,141,74,67
050,19,005,"Iowa","Allamakee County",4,26,145,82,63
050,19,005,"Iowa","Allamakee County",4,27,150,79,71
050,19,005,"Iowa","Allamakee County",4,28,158,77,81
050,19,005,"Iowa","Allamakee County",4,29,143,76,67
050,19,005,"Iowa","Allamakee County",4,30,141,79,62
050,19,005,"Iowa","Allamakee County",4,31,135,68,67
050,19,005,"Iowa","Allamakee County",4,32,152,79,73
050,19,005,"Iowa","Allamakee County",4,33,135,65,70
050,19,005,"Iowa","Allamakee County",4,34,133,76,57
050,19,005,"Iowa","Allamakee County",4,35,140,70,70
050,19,005,"Iowa","Allamakee County",4,36,159,79,80
050,19,005,"Iowa","Allamakee County",4,37,148,79,69
050,19,005,"Iowa","Allamakee County",4,38,148,81,67
050,19,005,"Iowa","Allamakee County",4,39,152,81,71
050,19,005,"Iowa","Allamakee County",4,40,170,92,78
050,19,005,"Iowa","Allamakee County",4,41,166,81,85
050,19,005,"Iowa","Allamakee County",4,42,151,81,70
050,19,005,"Iowa","Allamakee County",4,43,139,70,69
050,19,005,"Iowa","Allamakee County",4,44,139,69,70
050,19,005,"Iowa","Allamakee County",4,45,129,63,66
050,19,005,"Iowa","Allamakee County",4,46,137,64,73
050,19,005,"Iowa","Allamakee County",4,47,140,80,60
050,19,005,"Iowa","Allamakee County",4,48,127,74,53
050,19,005,"Iowa","Allamakee County",4,49,146,78,68
050,19,005,"Iowa","Allamakee County",4,50,143,74,69
050,19,005,"Iowa","Allamakee County",4,51,171,89,82
050,19,005,"Iowa","Allamakee County",4,52,149,75,74
050,19,005,"Iowa","Allamakee County",4,53,153,82,71
050,19,005,"Iowa","Allamakee County",4,54,173,88,85
050,19,005,"Iowa","Allamakee County",4,55,161,81,80
050,19,005,"Iowa","Allamakee County",4,56,172,92,80
050,19,005,"Iowa","Allamakee County",4,57,173,90,83
050,19,005,"Iowa","Allamakee County",4,58,201,106,95
050,19,005,"Iowa","Allamakee County",4,59,202,102,100
050,19,005,"Iowa","Allamakee County",4,60,222,105,117
050,19,005,"Iowa","Allamakee County",4,61,221,122,99
050,19,005,"Iowa","Allamakee County",4,62,225,119,106
050,19,005,"Iowa","Allamakee County",4,63,225,114,111
050,19,005,"Iowa","Allamakee County",4,64,219,111,108
050,19,005,"Iowa","Allamakee County",4,65,218,121,97
050,19,005,"Iowa","Allamakee County",4,66,201,103,98
050,19,005,"Iowa","Allamakee County",4,67,206,103,103
050,19,005,"Iowa","Allamakee County",4,68,217,117,100
050,19,005,"Iowa","Allamakee County",4,69,197,93,104
050,19,005,"Iowa","Allamakee County",4,70,186,95,91
050,19,005,"Iowa","Allamakee County",4,71,175,89,86
050,19,005,"Iowa","Allamakee County",4,72,172,88,84
050,19,005,"Iowa","Allamakee County",4,73,172,90,82
050,19,005,"Iowa","Allamakee County",4,74,162,81,81
050,19,005,"Iowa","Allamakee County",4,75,161,77,84
050,19,005,"Iowa","Allamakee County",4,76,108,49,59
050,19,005,"Iowa","Allamakee County",4,77,119,55,64
050,19,005,"Iowa","Allamakee County",4,78,119,60,59
050,19,005,"Iowa","Allamakee County",4,79,105,49,56
050,19,005,"Iowa","Allamakee County",4,80,95,51,44
050,19,005,"Iowa","Allamakee County",4,81,93,48,45
050,19,005,"Iowa","Allamakee County",4,82,74,34,40
050,19,005,"Iowa","Allamakee County",4,83,72,38,34
050,19,005,"Iowa","Allamakee County",4,84,72,30,42
050,19,005,"Iowa","Allamakee County",4,85,350,132,218
050,19,005,"Iowa","Allamakee County",5,0,183,100,83
050,19,005,"Iowa","Allamakee County",5,1,188,103,85
050,19,005,"Iowa","Allamakee County",5,2,196,101,95
050,19,005,"Iowa","Allamakee County",5,3,213,107,106
050,19,005,"Iowa","Allamakee County",5,4,196,100,96
050,19,005,"Iowa","Allamakee County",5,5,198,113,85
050,19,005,"Iowa","Allamakee County",5,6,210,119,91
050,19,005,"Iowa","Allamakee County",5,7,198,101,97
050,19,005,"Iowa","Allamakee County",5,8,199,96,103
050,19,005,"Iowa","Allamakee County",5,9,188,99,89
050,19,005,"Iowa","Allamakee County",5,10,176,90,86
050,19,005,"Iowa","Allamakee County",5,11,170,89,81
050,19,005,"Iowa","Allamakee County",5,12,175,83,92
050,19,005,"Iowa","Allamakee County",5,13,177,81,96
050,19,005,"Iowa","Allamakee County",5,14,196,98,98
050,19,005,"Iowa","Allamakee County",5,15,204,107,97
050,19,005,"Iowa","Allamakee County",5,16,201,108,93
050,19,005,"Iowa","Allamakee County",5,17,183,97,86
050,19,005,"Iowa","Allamakee County",5,18,163,83,80
050,19,005,"Iowa","Allamakee County",5,19,123,64,59
050,19,005,"Iowa","Allamakee County",5,20,126,69,57
050,19,005,"Iowa","Allamakee County",5,21,115,57,58
050,19,005,"Iowa","Allamakee County",5,22,119,57,62
050,19,005,"Iowa","Allamakee County",5,23,138,70,68
050,19,005,"Iowa","Allamakee County",5,24,128,65,63
050,19,005,"Iowa","Allamakee County",5,25,127,69,58
050,19,005,"Iowa","Allamakee County",5,26,145,75,70
050,19,005,"Iowa","Allamakee County",5,27,140,69,71
050,19,005,"Iowa","Allamakee County",5,28,158,86,72
050,19,005,"Iowa","Allamakee County",5,29,162,82,80
050,19,005,"Iowa","Allamakee County",5,30,142,72,70
050,19,005,"Iowa","Allamakee County",5,31,141,78,63
050,19,005,"Iowa","Allamakee County",5,32,135,67,68
050,19,005,"Iowa","Allamakee County",5,33,153,77,76
050,19,005,"Iowa","Allamakee County",5,34,133,62,71
050,19,005,"Iowa","Allamakee County",5,35,135,74,61
050,19,005,"Iowa","Allamakee County",5,36,145,74,71
050,19,005,"Iowa","Allamakee County",5,37,153,74,79
050,19,005,"Iowa","Allamakee County",5,38,156,86,70
050,19,005,"Iowa","Allamakee County",5,39,156,86,70
050,19,005,"Iowa","Allamakee County",5,40,150,84,66
050,19,005,"Iowa","Allamakee County",5,41,169,94,75
050,19,005,"Iowa","Allamakee County",5,42,172,85,87
050,19,005,"Iowa","Allamakee County",5,43,150,81,69
050,19,005,"Iowa","Allamakee County",5,44,144,73,71
050,19,005,"Iowa","Allamakee County",5,45,136,65,71
050,19,005,"Iowa","Allamakee County",5,46,132,65,67
050,19,005,"Iowa","Allamakee County",5,47,138,64,74
050,19,005,"Iowa","Allamakee County",5,48,138,78,60
050,19,005,"Iowa","Allamakee County",5,49,126,71,55
050,19,005,"Iowa","Allamakee County",5,50,151,81,70
050,19,005,"Iowa","Allamakee County",5,51,142,72,70
050,19,005,"Iowa","Allamakee County",5,52,166,90,76
050,19,005,"Iowa","Allamakee County",5,53,152,78,74
050,19,005,"Iowa","Allamakee County",5,54,156,82,74
050,19,005,"Iowa","Allamakee County",5,55,174,87,87
050,19,005,"Iowa","Allamakee County",5,56,168,82,86
050,19,005,"Iowa","Allamakee County",5,57,171,93,78
050,19,005,"Iowa","Allamakee County",5,58,170,89,81
050,19,005,"Iowa","Allamakee County",5,59,199,108,91
050,19,005,"Iowa","Allamakee County",5,60,200,99,101
050,19,005,"Iowa","Allamakee County",5,61,223,110,113
050,19,005,"Iowa","Allamakee County",5,62,219,119,100
050,19,005,"Iowa","Allamakee County",5,63,224,120,104
050,19,005,"Iowa","Allamakee County",5,64,224,112,112
050,19,005,"Iowa","Allamakee County",5,65,222,111,111
050,19,005,"Iowa","Allamakee County",5,66,213,114,99
050,19,005,"Iowa","Allamakee County",5,67,203,103,100
050,19,005,"Iowa","Allamakee County",5,68,202,103,99
050,19,005,"Iowa","Allamakee County",5,69,215,112,103
050,19,005,"Iowa","Allamakee County",5,70,188,91,97
050,19,005,"Iowa","Allamakee County",5,71,184,93,91
050,19,005,"Iowa","Allamakee County",5,72,174,88,86
050,19,005,"Iowa","Allamakee County",5,73,164,85,79
050,19,005,"Iowa","Allamakee County",5,74,167,86,81
050,19,005,"Iowa","Allamakee County",5,75,162,79,83
050,19,005,"Iowa","Allamakee County",5,76,153,72,81
050,19,005,"Iowa","Allamakee County",5,77,107,48,59
050,19,005,"Iowa","Allamakee County",5,78,117,55,62
050,19,005,"Iowa","Allamakee County",5,79,110,54,56
050,19,005,"Iowa","Allamakee County",5,80,97,46,51
050,19,005,"Iowa","Allamakee County",5,81,95,51,44
050,19,005,"Iowa","Allamakee County",5,82,86,42,44
050,19,005,"Iowa","Allamakee County",5,83,69,36,33
050,19,005,"Iowa","Allamakee County",5,84,64,28,36
050,19,005,"Iowa","Allamakee County",5,85,344,138,206
050,19,007,"Iowa","Appanoose County",1,0,138,70,68
050,19,007,"Iowa","Appanoose County",1,1,128,66,62
050,19,007,"Iowa","Appanoose County",1,2,135,66,69
050,19,007,"Iowa","Appanoose County",1,3,135,69,66
050,19,007,"Iowa","Appanoose County",1,4,144,71,73
050,19,007,"Iowa","Appanoose County",1,5,141,80,61
050,19,007,"Iowa","Appanoose County",1,6,156,84,72
050,19,007,"Iowa","Appanoose County",1,7,153,74,79
050,19,007,"Iowa","Appanoose County",1,8,166,85,81
050,19,007,"Iowa","Appanoose County",1,9,142,77,65
050,19,007,"Iowa","Appanoose County",1,10,147,79,68
050,19,007,"Iowa","Appanoose County",1,11,173,92,81
050,19,007,"Iowa","Appanoose County",1,12,177,98,79
050,19,007,"Iowa","Appanoose County",1,13,169,95,74
050,19,007,"Iowa","Appanoose County",1,14,166,88,78
050,19,007,"Iowa","Appanoose County",1,15,167,80,87
050,19,007,"Iowa","Appanoose County",1,16,169,88,81
050,19,007,"Iowa","Appanoose County",1,17,165,87,78
050,19,007,"Iowa","Appanoose County",1,18,142,80,62
050,19,007,"Iowa","Appanoose County",1,19,116,65,51
050,19,007,"Iowa","Appanoose County",1,20,120,60,60
050,19,007,"Iowa","Appanoose County",1,21,115,60,55
050,19,007,"Iowa","Appanoose County",1,22,116,59,57
050,19,007,"Iowa","Appanoose County",1,23,112,60,52
050,19,007,"Iowa","Appanoose County",1,24,127,66,61
050,19,007,"Iowa","Appanoose County",1,25,115,60,55
050,19,007,"Iowa","Appanoose County",1,26,109,56,53
050,19,007,"Iowa","Appanoose County",1,27,123,59,64
050,19,007,"Iowa","Appanoose County",1,28,133,69,64
050,19,007,"Iowa","Appanoose County",1,29,144,65,79
050,19,007,"Iowa","Appanoose County",1,30,113,47,66
050,19,007,"Iowa","Appanoose County",1,31,110,54,56
050,19,007,"Iowa","Appanoose County",1,32,104,51,53
050,19,007,"Iowa","Appanoose County",1,33,126,64,62
050,19,007,"Iowa","Appanoose County",1,34,128,53,75
050,19,007,"Iowa","Appanoose County",1,35,135,64,71
050,19,007,"Iowa","Appanoose County",1,36,137,74,63
050,19,007,"Iowa","Appanoose County",1,37,140,69,71
050,19,007,"Iowa","Appanoose County",1,38,141,74,67
050,19,007,"Iowa","Appanoose County",1,39,142,72,70
050,19,007,"Iowa","Appanoose County",1,40,140,69,71
050,19,007,"Iowa","Appanoose County",1,41,131,70,61
050,19,007,"Iowa","Appanoose County",1,42,130,65,65
050,19,007,"Iowa","Appanoose County",1,43,122,64,58
050,19,007,"Iowa","Appanoose County",1,44,120,60,60
050,19,007,"Iowa","Appanoose County",1,45,123,54,69
050,19,007,"Iowa","Appanoose County",1,46,137,68,69
050,19,007,"Iowa","Appanoose County",1,47,136,68,68
050,19,007,"Iowa","Appanoose County",1,48,137,76,61
050,19,007,"Iowa","Appanoose County",1,49,148,72,76
050,19,007,"Iowa","Appanoose County",1,50,152,73,79
050,19,007,"Iowa","Appanoose County",1,51,143,69,74
050,19,007,"Iowa","Appanoose County",1,52,145,83,62
050,19,007,"Iowa","Appanoose County",1,53,132,70,62
050,19,007,"Iowa","Appanoose County",1,54,164,87,77
050,19,007,"Iowa","Appanoose County",1,55,184,95,89
050,19,007,"Iowa","Appanoose County",1,56,191,104,87
050,19,007,"Iowa","Appanoose County",1,57,174,88,86
050,19,007,"Iowa","Appanoose County",1,58,189,88,101
050,19,007,"Iowa","Appanoose County",1,59,180,86,94
050,19,007,"Iowa","Appanoose County",1,60,176,87,89
050,19,007,"Iowa","Appanoose County",1,61,167,81,86
050,19,007,"Iowa","Appanoose County",1,62,185,95,90
050,19,007,"Iowa","Appanoose County",1,63,200,103,97
050,19,007,"Iowa","Appanoose County",1,64,208,109,99
050,19,007,"Iowa","Appanoose County",1,65,190,107,83
050,19,007,"Iowa","Appanoose County",1,66,180,97,83
050,19,007,"Iowa","Appanoose County",1,67,186,89,97
050,19,007,"Iowa","Appanoose County",1,68,170,85,85
050,19,007,"Iowa","Appanoose County",1,69,153,76,77
050,19,007,"Iowa","Appanoose County",1,70,147,73,74
050,19,007,"Iowa","Appanoose County",1,71,164,72,92
050,19,007,"Iowa","Appanoose County",1,72,166,74,92
050,19,007,"Iowa","Appanoose County",1,73,164,78,86
050,19,007,"Iowa","Appanoose County",1,74,115,52,63
050,19,007,"Iowa","Appanoose County",1,75,107,46,61
050,19,007,"Iowa","Appanoose County",1,76,120,67,53
050,19,007,"Iowa","Appanoose County",1,77,109,56,53
050,19,007,"Iowa","Appanoose County",1,78,102,48,54
050,19,007,"Iowa","Appanoose County",1,79,81,37,44
050,19,007,"Iowa","Appanoose County",1,80,85,43,42
050,19,007,"Iowa","Appanoose County",1,81,76,33,43
050,19,007,"Iowa","Appanoose County",1,82,71,29,42
050,19,007,"Iowa","Appanoose County",1,83,62,30,32
050,19,007,"Iowa","Appanoose County",1,84,55,25,30
050,19,007,"Iowa","Appanoose County",1,85,380,137,243
050,19,007,"Iowa","Appanoose County",2,0,128,64,64
050,19,007,"Iowa","Appanoose County",2,1,129,66,63
050,19,007,"Iowa","Appanoose County",2,2,132,65,67
050,19,007,"Iowa","Appanoose County",2,3,134,68,66
050,19,007,"Iowa","Appanoose County",2,4,141,70,71
050,19,007,"Iowa","Appanoose County",2,5,143,78,65
050,19,007,"Iowa","Appanoose County",2,6,154,83,71
050,19,007,"Iowa","Appanoose County",2,7,153,75,78
050,19,007,"Iowa","Appanoose County",2,8,163,82,81
050,19,007,"Iowa","Appanoose County",2,9,147,79,68
050,19,007,"Iowa","Appanoose County",2,10,143,77,66
050,19,007,"Iowa","Appanoose County",2,11,166,89,77
050,19,007,"Iowa","Appanoose County",2,12,175,97,78
050,19,007,"Iowa","Appanoose County",2,13,168,95,73
050,19,007,"Iowa","Appanoose County",2,14,166,90,76
050,19,007,"Iowa","Appanoose County",2,15,166,81,85
050,19,007,"Iowa","Appanoose County",2,16,170,87,83
050,19,007,"Iowa","Appanoose County",2,17,166,88,78
050,19,007,"Iowa","Appanoose County",2,18,139,78,61
050,19,007,"Iowa","Appanoose County",2,19,119,67,52
050,19,007,"Iowa","Appanoose County",2,20,121,62,59
050,19,007,"Iowa","Appanoose County",2,21,118,61,57
050,19,007,"Iowa","Appanoose County",2,22,114,58,56
050,19,007,"Iowa","Appanoose County",2,23,114,60,54
050,19,007,"Iowa","Appanoose County",2,24,120,63,57
050,19,007,"Iowa","Appanoose County",2,25,117,61,56
050,19,007,"Iowa","Appanoose County",2,26,111,57,54
050,19,007,"Iowa","Appanoose County",2,27,118,58,60
050,19,007,"Iowa","Appanoose County",2,28,134,69,65
050,19,007,"Iowa","Appanoose County",2,29,141,65,76
050,19,007,"Iowa","Appanoose County",2,30,118,50,68
050,19,007,"Iowa","Appanoose County",2,31,110,52,58
050,19,007,"Iowa","Appanoose County",2,32,104,52,52
050,19,007,"Iowa","Appanoose County",2,33,122,62,60
050,19,007,"Iowa","Appanoose County",2,34,129,56,73
050,19,007,"Iowa","Appanoose County",2,35,135,63,72
050,19,007,"Iowa","Appanoose County",2,36,134,70,64
050,19,007,"Iowa","Appanoose County",2,37,141,71,70
050,19,007,"Iowa","Appanoose County",2,38,139,72,67
050,19,007,"Iowa","Appanoose County",2,39,141,73,68
050,19,007,"Iowa","Appanoose County",2,40,139,69,70
050,19,007,"Iowa","Appanoose County",2,41,133,70,63
050,19,007,"Iowa","Appanoose County",2,42,130,66,64
050,19,007,"Iowa","Appanoose County",2,43,125,66,59
050,19,007,"Iowa","Appanoose County",2,44,119,59,60
050,19,007,"Iowa","Appanoose County",2,45,124,56,68
050,19,007,"Iowa","Appanoose County",2,46,132,63,69
050,19,007,"Iowa","Appanoose County",2,47,135,68,67
050,19,007,"Iowa","Appanoose County",2,48,138,75,63
050,19,007,"Iowa","Appanoose County",2,49,147,74,73
050,19,007,"Iowa","Appanoose County",2,50,153,74,79
050,19,007,"Iowa","Appanoose County",2,51,147,71,76
050,19,007,"Iowa","Appanoose County",2,52,145,80,65
050,19,007,"Iowa","Appanoose County",2,53,136,73,63
050,19,007,"Iowa","Appanoose County",2,54,155,82,73
050,19,007,"Iowa","Appanoose County",2,55,180,94,86
050,19,007,"Iowa","Appanoose County",2,56,190,102,88
050,19,007,"Iowa","Appanoose County",2,57,176,90,86
050,19,007,"Iowa","Appanoose County",2,58,186,88,98
050,19,007,"Iowa","Appanoose County",2,59,183,85,98
050,19,007,"Iowa","Appanoose County",2,60,176,87,89
050,19,007,"Iowa","Appanoose County",2,61,167,81,86
050,19,007,"Iowa","Appanoose County",2,62,180,90,90
050,19,007,"Iowa","Appanoose County",2,63,196,101,95
050,19,007,"Iowa","Appanoose County",2,64,205,106,99
050,19,007,"Iowa","Appanoose County",2,65,192,106,86
050,19,007,"Iowa","Appanoose County",2,66,182,99,83
050,19,007,"Iowa","Appanoose County",2,67,186,91,95
050,19,007,"Iowa","Appanoose County",2,68,171,86,85
050,19,007,"Iowa","Appanoose County",2,69,157,77,80
050,19,007,"Iowa","Appanoose County",2,70,145,70,75
050,19,007,"Iowa","Appanoose County",2,71,160,73,87
050,19,007,"Iowa","Appanoose County",2,72,162,72,90
050,19,007,"Iowa","Appanoose County",2,73,172,80,92
050,19,007,"Iowa","Appanoose County",2,74,119,54,65
050,19,007,"Iowa","Appanoose County",2,75,111,49,62
050,19,007,"Iowa","Appanoose County",2,76,115,61,54
050,19,007,"Iowa","Appanoose County",2,77,114,60,54
050,19,007,"Iowa","Appanoose County",2,78,103,50,53
050,19,007,"Iowa","Appanoose County",2,79,84,39,45
050,19,007,"Iowa","Appanoose County",2,80,85,43,42
050,19,007,"Iowa","Appanoose County",2,81,76,35,41
050,19,007,"Iowa","Appanoose County",2,82,72,29,43
050,19,007,"Iowa","Appanoose County",2,83,63,28,35
050,19,007,"Iowa","Appanoose County",2,84,55,25,30
050,19,007,"Iowa","Appanoose County",2,85,383,137,246
050,19,007,"Iowa","Appanoose County",3,0,129,71,58
050,19,007,"Iowa","Appanoose County",3,1,129,65,64
050,19,007,"Iowa","Appanoose County",3,2,129,64,65
050,19,007,"Iowa","Appanoose County",3,3,135,64,71
050,19,007,"Iowa","Appanoose County",3,4,143,77,66
050,19,007,"Iowa","Appanoose County",3,5,147,73,74
050,19,007,"Iowa","Appanoose County",3,6,145,78,67
050,19,007,"Iowa","Appanoose County",3,7,149,82,67
050,19,007,"Iowa","Appanoose County",3,8,149,74,75
050,19,007,"Iowa","Appanoose County",3,9,162,82,80
050,19,007,"Iowa","Appanoose County",3,10,150,81,69
050,19,007,"Iowa","Appanoose County",3,11,156,85,71
050,19,007,"Iowa","Appanoose County",3,12,170,90,80
050,19,007,"Iowa","Appanoose County",3,13,169,95,74
050,19,007,"Iowa","Appanoose County",3,14,168,93,75
050,19,007,"Iowa","Appanoose County",3,15,167,88,79
050,19,007,"Iowa","Appanoose County",3,16,166,79,87
050,19,007,"Iowa","Appanoose County",3,17,170,84,86
050,19,007,"Iowa","Appanoose County",3,18,151,81,70
050,19,007,"Iowa","Appanoose County",3,19,118,64,54
050,19,007,"Iowa","Appanoose County",3,20,129,69,60
050,19,007,"Iowa","Appanoose County",3,21,122,66,56
050,19,007,"Iowa","Appanoose County",3,22,119,62,57
050,19,007,"Iowa","Appanoose County",3,23,104,56,48
050,19,007,"Iowa","Appanoose County",3,24,112,57,55
050,19,007,"Iowa","Appanoose County",3,25,111,58,53
050,19,007,"Iowa","Appanoose County",3,26,123,60,63
050,19,007,"Iowa","Appanoose County",3,27,106,55,51
050,19,007,"Iowa","Appanoose County",3,28,121,59,62
050,19,007,"Iowa","Appanoose County",3,29,145,73,72
050,19,007,"Iowa","Appanoose County",3,30,142,67,75
050,19,007,"Iowa","Appanoose County",3,31,125,54,71
050,19,007,"Iowa","Appanoose County",3,32,119,59,60
050,19,007,"Iowa","Appanoose County",3,33,109,59,50
050,19,007,"Iowa","Appanoose County",3,34,118,62,56
050,19,007,"Iowa","Appanoose County",3,35,136,61,75
050,19,007,"Iowa","Appanoose County",3,36,125,57,68
050,19,007,"Iowa","Appanoose County",3,37,142,73,69
050,19,007,"Iowa","Appanoose County",3,38,136,68,68
050,19,007,"Iowa","Appanoose County",3,39,139,70,69
050,19,007,"Iowa","Appanoose County",3,40,150,78,72
050,19,007,"Iowa","Appanoose County",3,41,139,69,70
050,19,007,"Iowa","Appanoose County",3,42,135,69,66
050,19,007,"Iowa","Appanoose County",3,43,127,64,63
050,19,007,"Iowa","Appanoose County",3,44,131,68,63
050,19,007,"Iowa","Appanoose County",3,45,120,62,58
050,19,007,"Iowa","Appanoose County",3,46,129,57,72
050,19,007,"Iowa","Appanoose County",3,47,134,66,68
050,19,007,"Iowa","Appanoose County",3,48,136,68,68
050,19,007,"Iowa","Appanoose County",3,49,148,78,70
050,19,007,"Iowa","Appanoose County",3,50,149,77,72
050,19,007,"Iowa","Appanoose County",3,51,153,72,81
050,19,007,"Iowa","Appanoose County",3,52,157,79,78
050,19,007,"Iowa","Appanoose County",3,53,146,78,68
050,19,007,"Iowa","Appanoose County",3,54,137,74,63
050,19,007,"Iowa","Appanoose County",3,55,167,89,78
050,19,007,"Iowa","Appanoose County",3,56,183,92,91
050,19,007,"Iowa","Appanoose County",3,57,187,102,85
050,19,007,"Iowa","Appanoose County",3,58,172,92,80
050,19,007,"Iowa","Appanoose County",3,59,180,85,95
050,19,007,"Iowa","Appanoose County",3,60,182,87,95
050,19,007,"Iowa","Appanoose County",3,61,174,84,90
050,19,007,"Iowa","Appanoose County",3,62,170,82,88
050,19,007,"Iowa","Appanoose County",3,63,179,92,87
050,19,007,"Iowa","Appanoose County",3,64,198,103,95
050,19,007,"Iowa","Appanoose County",3,65,204,107,97
050,19,007,"Iowa","Appanoose County",3,66,187,103,84
050,19,007,"Iowa","Appanoose County",3,67,182,98,84
050,19,007,"Iowa","Appanoose County",3,68,182,88,94
050,19,007,"Iowa","Appanoose County",3,69,164,80,84
050,19,007,"Iowa","Appanoose County",3,70,154,78,76
050,19,007,"Iowa","Appanoose County",3,71,132,60,72
050,19,007,"Iowa","Appanoose County",3,72,151,67,84
050,19,007,"Iowa","Appanoose County",3,73,157,73,84
050,19,007,"Iowa","Appanoose County",3,74,169,76,93
050,19,007,"Iowa","Appanoose County",3,75,117,52,65
050,19,007,"Iowa","Appanoose County",3,76,102,44,58
050,19,007,"Iowa","Appanoose County",3,77,103,54,49
050,19,007,"Iowa","Appanoose County",3,78,104,58,46
050,19,007,"Iowa","Appanoose County",3,79,96,46,50
050,19,007,"Iowa","Appanoose County",3,80,75,34,41
050,19,007,"Iowa","Appanoose County",3,81,75,38,37
050,19,007,"Iowa","Appanoose County",3,82,71,33,38
050,19,007,"Iowa","Appanoose County",3,83,61,21,40
050,19,007,"Iowa","Appanoose County",3,84,60,27,33
050,19,007,"Iowa","Appanoose County",3,85,355,124,231
050,19,007,"Iowa","Appanoose County",4,0,124,63,61
050,19,007,"Iowa","Appanoose County",4,1,123,61,62
050,19,007,"Iowa","Appanoose County",4,2,128,64,64
050,19,007,"Iowa","Appanoose County",4,3,127,61,66
050,19,007,"Iowa","Appanoose County",4,4,126,62,64
050,19,007,"Iowa","Appanoose County",4,5,133,68,65
050,19,007,"Iowa","Appanoose County",4,6,149,74,75
050,19,007,"Iowa","Appanoose County",4,7,138,75,63
050,19,007,"Iowa","Appanoose County",4,8,152,84,68
050,19,007,"Iowa","Appanoose County",4,9,151,77,74
050,19,007,"Iowa","Appanoose County",4,10,161,81,80
050,19,007,"Iowa","Appanoose County",4,11,145,81,64
050,19,007,"Iowa","Appanoose County",4,12,150,80,70
050,19,007,"Iowa","Appanoose County",4,13,171,91,80
050,19,007,"Iowa","Appanoose County",4,14,172,95,77
050,19,007,"Iowa","Appanoose County",4,15,172,94,78
050,19,007,"Iowa","Appanoose County",4,16,167,87,80
050,19,007,"Iowa","Appanoose County",4,17,161,75,86
050,19,007,"Iowa","Appanoose County",4,18,159,82,77
050,19,007,"Iowa","Appanoose County",4,19,140,77,63
050,19,007,"Iowa","Appanoose County",4,20,129,71,58
050,19,007,"Iowa","Appanoose County",4,21,127,67,60
050,19,007,"Iowa","Appanoose County",4,22,125,63,62
050,19,007,"Iowa","Appanoose County",4,23,114,64,50
050,19,007,"Iowa","Appanoose County",4,24,105,51,54
050,19,007,"Iowa","Appanoose County",4,25,101,50,51
050,19,007,"Iowa","Appanoose County",4,26,112,58,54
050,19,007,"Iowa","Appanoose County",4,27,125,64,61
050,19,007,"Iowa","Appanoose County",4,28,113,57,56
050,19,007,"Iowa","Appanoose County",4,29,121,62,59
050,19,007,"Iowa","Appanoose County",4,30,140,74,66
050,19,007,"Iowa","Appanoose County",4,31,140,66,74
050,19,007,"Iowa","Appanoose County",4,32,125,53,72
050,19,007,"Iowa","Appanoose County",4,33,111,54,57
050,19,007,"Iowa","Appanoose County",4,34,112,62,50
050,19,007,"Iowa","Appanoose County",4,35,123,67,56
050,19,007,"Iowa","Appanoose County",4,36,134,58,76
050,19,007,"Iowa","Appanoose County",4,37,120,57,63
050,19,007,"Iowa","Appanoose County",4,38,136,65,71
050,19,007,"Iowa","Appanoose County",4,39,129,67,62
050,19,007,"Iowa","Appanoose County",4,40,139,69,70
050,19,007,"Iowa","Appanoose County",4,41,153,78,75
050,19,007,"Iowa","Appanoose County",4,42,137,66,71
050,19,007,"Iowa","Appanoose County",4,43,131,67,64
050,19,007,"Iowa","Appanoose County",4,44,130,64,66
050,19,007,"Iowa","Appanoose County",4,45,127,66,61
050,19,007,"Iowa","Appanoose County",4,46,128,65,63
050,19,007,"Iowa","Appanoose County",4,47,126,55,71
050,19,007,"Iowa","Appanoose County",4,48,133,64,69
050,19,007,"Iowa","Appanoose County",4,49,136,68,68
050,19,007,"Iowa","Appanoose County",4,50,156,84,72
050,19,007,"Iowa","Appanoose County",4,51,143,73,70
050,19,007,"Iowa","Appanoose County",4,52,151,76,75
050,19,007,"Iowa","Appanoose County",4,53,157,74,83
050,19,007,"Iowa","Appanoose County",4,54,154,78,76
050,19,007,"Iowa","Appanoose County",4,55,139,74,65
050,19,007,"Iowa","Appanoose County",4,56,159,86,73
050,19,007,"Iowa","Appanoose County",4,57,190,96,94
050,19,007,"Iowa","Appanoose County",4,58,183,101,82
050,19,007,"Iowa","Appanoose County",4,59,173,93,80
050,19,007,"Iowa","Appanoose County",4,60,182,85,97
050,19,007,"Iowa","Appanoose County",4,61,179,85,94
050,19,007,"Iowa","Appanoose County",4,62,175,84,91
050,19,007,"Iowa","Appanoose County",4,63,174,88,86
050,19,007,"Iowa","Appanoose County",4,64,178,86,92
050,19,007,"Iowa","Appanoose County",4,65,189,103,86
050,19,007,"Iowa","Appanoose County",4,66,191,98,93
050,19,007,"Iowa","Appanoose County",4,67,190,101,89
050,19,007,"Iowa","Appanoose County",4,68,183,100,83
050,19,007,"Iowa","Appanoose County",4,69,182,88,94
050,19,007,"Iowa","Appanoose County",4,70,156,78,78
050,19,007,"Iowa","Appanoose County",4,71,148,78,70
050,19,007,"Iowa","Appanoose County",4,72,125,53,72
050,19,007,"Iowa","Appanoose County",4,73,143,66,77
050,19,007,"Iowa","Appanoose County",4,74,155,71,84
050,19,007,"Iowa","Appanoose County",4,75,165,74,91
050,19,007,"Iowa","Appanoose County",4,76,111,47,64
050,19,007,"Iowa","Appanoose County",4,77,94,40,54
050,19,007,"Iowa","Appanoose County",4,78,97,55,42
050,19,007,"Iowa","Appanoose County",4,79,98,52,46
050,19,007,"Iowa","Appanoose County",4,80,89,43,46
050,19,007,"Iowa","Appanoose County",4,81,64,25,39
050,19,007,"Iowa","Appanoose County",4,82,67,33,34
050,19,007,"Iowa","Appanoose County",4,83,63,27,36
050,19,007,"Iowa","Appanoose County",4,84,57,20,37
050,19,007,"Iowa","Appanoose County",4,85,350,125,225
050,19,007,"Iowa","Appanoose County",5,0,125,65,60
050,19,007,"Iowa","Appanoose County",5,1,117,57,60
050,19,007,"Iowa","Appanoose County",5,2,117,62,55
050,19,007,"Iowa","Appanoose County",5,3,124,60,64
050,19,007,"Iowa","Appanoose County",5,4,122,60,62
050,19,007,"Iowa","Appanoose County",5,5,129,61,68
050,19,007,"Iowa","Appanoose County",5,6,140,75,65
050,19,007,"Iowa","Appanoose County",5,7,149,74,75
050,19,007,"Iowa","Appanoose County",5,8,139,77,62
050,19,007,"Iowa","Appanoose County",5,9,156,82,74
050,19,007,"Iowa","Appanoose County",5,10,148,80,68
050,19,007,"Iowa","Appanoose County",5,11,166,83,83
050,19,007,"Iowa","Appanoose County",5,12,151,82,69
050,19,007,"Iowa","Appanoose County",5,13,163,87,76
050,19,007,"Iowa","Appanoose County",5,14,167,90,77
050,19,007,"Iowa","Appanoose County",5,15,188,108,80
050,19,007,"Iowa","Appanoose County",5,16,180,98,82
050,19,007,"Iowa","Appanoose County",5,17,171,91,80
050,19,007,"Iowa","Appanoose County",5,18,151,75,76
050,19,007,"Iowa","Appanoose County",5,19,138,73,65
050,19,007,"Iowa","Appanoose County",5,20,134,73,61
050,19,007,"Iowa","Appanoose County",5,21,120,67,53
050,19,007,"Iowa","Appanoose County",5,22,123,67,56
050,19,007,"Iowa","Appanoose County",5,23,119,63,56
050,19,007,"Iowa","Appanoose County",5,24,105,59,46
050,19,007,"Iowa","Appanoose County",5,25,100,50,50
050,19,007,"Iowa","Appanoose County",5,26,93,50,43
050,19,007,"Iowa","Appanoose County",5,27,110,59,51
050,19,007,"Iowa","Appanoose County",5,28,129,67,62
050,19,007,"Iowa","Appanoose County",5,29,118,56,62
050,19,007,"Iowa","Appanoose County",5,30,114,59,55
050,19,007,"Iowa","Appanoose County",5,31,147,80,67
050,19,007,"Iowa","Appanoose County",5,32,143,67,76
050,19,007,"Iowa","Appanoose County",5,33,130,54,76
050,19,007,"Iowa","Appanoose County",5,34,112,54,58
050,19,007,"Iowa","Appanoose County",5,35,104,61,43
050,19,007,"Iowa","Appanoose County",5,36,122,65,57
050,19,007,"Iowa","Appanoose County",5,37,135,57,78
050,19,007,"Iowa","Appanoose County",5,38,121,59,62
050,19,007,"Iowa","Appanoose County",5,39,137,65,72
050,19,007,"Iowa","Appanoose County",5,40,139,76,63
050,19,007,"Iowa","Appanoose County",5,41,141,66,75
050,19,007,"Iowa","Appanoose County",5,42,156,82,74
050,19,007,"Iowa","Appanoose County",5,43,136,65,71
050,19,007,"Iowa","Appanoose County",5,44,131,66,65
050,19,007,"Iowa","Appanoose County",5,45,129,63,66
050,19,007,"Iowa","Appanoose County",5,46,126,67,59
050,19,007,"Iowa","Appanoose County",5,47,137,68,69
050,19,007,"Iowa","Appanoose County",5,48,125,53,72
050,19,007,"Iowa","Appanoose County",5,49,136,69,67
050,19,007,"Iowa","Appanoose County",5,50,133,67,66
050,19,007,"Iowa","Appanoose County",5,51,148,79,69
050,19,007,"Iowa","Appanoose County",5,52,149,71,78
050,19,007,"Iowa","Appanoose County",5,53,145,73,72
050,19,007,"Iowa","Appanoose County",5,54,157,74,83
050,19,007,"Iowa","Appanoose County",5,55,157,82,75
050,19,007,"Iowa","Appanoose County",5,56,131,70,61
050,19,007,"Iowa","Appanoose County",5,57,162,87,75
050,19,007,"Iowa","Appanoose County",5,58,190,99,91
050,19,007,"Iowa","Appanoose County",5,59,187,100,87
050,19,007,"Iowa","Appanoose County",5,60,178,93,85
050,19,007,"Iowa","Appanoose County",5,61,185,86,99
050,19,007,"Iowa","Appanoose County",5,62,179,82,97
050,19,007,"Iowa","Appanoose County",5,63,174,85,89
050,19,007,"Iowa","Appanoose County",5,64,178,90,88
050,19,007,"Iowa","Appanoose County",5,65,176,90,86
050,19,007,"Iowa","Appanoose County",5,66,184,99,85
050,19,007,"Iowa","Appanoose County",5,67,195,99,96
050,19,007,"Iowa","Appanoose County",5,68,188,102,86
050,19,007,"Iowa","Appanoose County",5,69,180,98,82
050,19,007,"Iowa","Appanoose County",5,70,180,87,93
050,19,007,"Iowa","Appanoose County",5,71,153,77,76
050,19,007,"Iowa","Appanoose County",5,72,142,74,68
050,19,007,"Iowa","Appanoose County",5,73,120,53,67
050,19,007,"Iowa","Appanoose County",5,74,142,64,78
050,19,007,"Iowa","Appanoose County",5,75,154,73,81
050,19,007,"Iowa","Appanoose County",5,76,155,71,84
050,19,007,"Iowa","Appanoose County",5,77,104,43,61
050,19,007,"Iowa","Appanoose County",5,78,90,41,49
050,19,007,"Iowa","Appanoose County",5,79,92,51,41
050,19,007,"Iowa","Appanoose County",5,80,90,48,42
050,19,007,"Iowa","Appanoose County",5,81,80,38,42
050,19,007,"Iowa","Appanoose County",5,82,55,22,33
050,19,007,"Iowa","Appanoose County",5,83,61,28,33
050,19,007,"Iowa","Appanoose County",5,84,63,27,36
050,19,007,"Iowa","Appanoose County",5,85,349,119,230
050,19,009,"Iowa","Audubon County",1,0,58,28,30
050,19,009,"Iowa","Audubon County",1,1,61,28,33
050,19,009,"Iowa","Audubon County",1,2,79,41,38
050,19,009,"Iowa","Audubon County",1,3,67,38,29
050,19,009,"Iowa","Audubon County",1,4,73,41,32
050,19,009,"Iowa","Audubon County",1,5,71,36,35
050,19,009,"Iowa","Audubon County",1,6,67,38,29
050,19,009,"Iowa","Audubon County",1,7,59,30,29
050,19,009,"Iowa","Audubon County",1,8,55,30,25
050,19,009,"Iowa","Audubon County",1,9,69,39,30
050,19,009,"Iowa","Audubon County",1,10,70,40,30
050,19,009,"Iowa","Audubon County",1,11,73,37,36
050,19,009,"Iowa","Audubon County",1,12,76,31,45
050,19,009,"Iowa","Audubon County",1,13,69,33,36
050,19,009,"Iowa","Audubon County",1,14,67,32,35
050,19,009,"Iowa","Audubon County",1,15,64,33,31
050,19,009,"Iowa","Audubon County",1,16,66,34,32
050,19,009,"Iowa","Audubon County",1,17,70,35,35
050,19,009,"Iowa","Audubon County",1,18,63,32,31
050,19,009,"Iowa","Audubon County",1,19,36,17,19
050,19,009,"Iowa","Audubon County",1,20,47,22,25
050,19,009,"Iowa","Audubon County",1,21,59,26,33
050,19,009,"Iowa","Audubon County",1,22,54,26,28
050,19,009,"Iowa","Audubon County",1,23,58,30,28
050,19,009,"Iowa","Audubon County",1,24,48,25,23
050,19,009,"Iowa","Audubon County",1,25,67,33,34
050,19,009,"Iowa","Audubon County",1,26,64,31,33
050,19,009,"Iowa","Audubon County",1,27,60,29,31
050,19,009,"Iowa","Audubon County",1,28,56,27,29
050,19,009,"Iowa","Audubon County",1,29,56,27,29
050,19,009,"Iowa","Audubon County",1,30,69,35,34
050,19,009,"Iowa","Audubon County",1,31,50,22,28
050,19,009,"Iowa","Audubon County",1,32,48,23,25
050,19,009,"Iowa","Audubon County",1,33,52,28,24
050,19,009,"Iowa","Audubon County",1,34,46,20,26
050,19,009,"Iowa","Audubon County",1,35,55,28,27
050,19,009,"Iowa","Audubon County",1,36,63,27,36
050,19,009,"Iowa","Audubon County",1,37,63,30,33
050,19,009,"Iowa","Audubon County",1,38,52,28,24
050,19,009,"Iowa","Audubon County",1,39,62,34,28
050,19,009,"Iowa","Audubon County",1,40,66,36,30
050,19,009,"Iowa","Audubon County",1,41,58,30,28
050,19,009,"Iowa","Audubon County",1,42,58,31,27
050,19,009,"Iowa","Audubon County",1,43,52,29,23
050,19,009,"Iowa","Audubon County",1,44,63,35,28
050,19,009,"Iowa","Audubon County",1,45,56,30,26
050,19,009,"Iowa","Audubon County",1,46,47,18,29
050,19,009,"Iowa","Audubon County",1,47,54,22,32
050,19,009,"Iowa","Audubon County",1,48,61,31,30
050,19,009,"Iowa","Audubon County",1,49,53,27,26
050,19,009,"Iowa","Audubon County",1,50,66,31,35
050,19,009,"Iowa","Audubon County",1,51,69,36,33
050,19,009,"Iowa","Audubon County",1,52,58,34,24
050,19,009,"Iowa","Audubon County",1,53,77,43,34
050,19,009,"Iowa","Audubon County",1,54,73,30,43
050,19,009,"Iowa","Audubon County",1,55,76,38,38
050,19,009,"Iowa","Audubon County",1,56,92,45,47
050,19,009,"Iowa","Audubon County",1,57,94,49,45
050,19,009,"Iowa","Audubon County",1,58,103,50,53
050,19,009,"Iowa","Audubon County",1,59,102,52,50
050,19,009,"Iowa","Audubon County",1,60,106,57,49
050,19,009,"Iowa","Audubon County",1,61,100,53,47
050,19,009,"Iowa","Audubon County",1,62,88,50,38
050,19,009,"Iowa","Audubon County",1,63,88,43,45
050,19,009,"Iowa","Audubon County",1,64,92,46,46
050,19,009,"Iowa","Audubon County",1,65,90,47,43
050,19,009,"Iowa","Audubon County",1,66,89,41,48
050,19,009,"Iowa","Audubon County",1,67,71,31,40
050,19,009,"Iowa","Audubon County",1,68,71,38,33
050,19,009,"Iowa","Audubon County",1,69,76,39,37
050,19,009,"Iowa","Audubon County",1,70,73,39,34
050,19,009,"Iowa","Audubon County",1,71,70,31,39
050,19,009,"Iowa","Audubon County",1,72,72,36,36
050,19,009,"Iowa","Audubon County",1,73,71,32,39
050,19,009,"Iowa","Audubon County",1,74,39,17,22
050,19,009,"Iowa","Audubon County",1,75,57,25,32
050,19,009,"Iowa","Audubon County",1,76,55,28,27
050,19,009,"Iowa","Audubon County",1,77,53,27,26
050,19,009,"Iowa","Audubon County",1,78,40,17,23
050,19,009,"Iowa","Audubon County",1,79,41,17,24
050,19,009,"Iowa","Audubon County",1,80,50,26,24
050,19,009,"Iowa","Audubon County",1,81,46,20,26
050,19,009,"Iowa","Audubon County",1,82,41,16,25
050,19,009,"Iowa","Audubon County",1,83,33,16,17
050,19,009,"Iowa","Audubon County",1,84,31,14,17
050,19,009,"Iowa","Audubon County",1,85,213,60,153
050,19,009,"Iowa","Audubon County",2,0,62,29,33
050,19,009,"Iowa","Audubon County",2,1,60,28,32
050,19,009,"Iowa","Audubon County",2,2,75,37,38
050,19,009,"Iowa","Audubon County",2,3,71,39,32
050,19,009,"Iowa","Audubon County",2,4,72,41,31
050,19,009,"Iowa","Audubon County",2,5,72,37,35
050,19,009,"Iowa","Audubon County",2,6,70,38,32
050,19,009,"Iowa","Audubon County",2,7,61,32,29
050,19,009,"Iowa","Audubon County",2,8,55,30,25
050,19,009,"Iowa","Audubon County",2,9,65,36,29
050,19,009,"Iowa","Audubon County",2,10,69,38,31
050,19,009,"Iowa","Audubon County",2,11,73,38,35
050,19,009,"Iowa","Audubon County",2,12,76,33,43
050,19,009,"Iowa","Audubon County",2,13,71,33,38
050,19,009,"Iowa","Audubon County",2,14,67,33,34
050,19,009,"Iowa","Audubon County",2,15,63,32,31
050,19,009,"Iowa","Audubon County",2,16,66,34,32
050,19,009,"Iowa","Audubon County",2,17,70,35,35
050,19,009,"Iowa","Audubon County",2,18,59,30,29
050,19,009,"Iowa","Audubon County",2,19,39,19,20
050,19,009,"Iowa","Audubon County",2,20,47,22,25
050,19,009,"Iowa","Audubon County",2,21,57,25,32
050,19,009,"Iowa","Audubon County",2,22,55,26,29
050,19,009,"Iowa","Audubon County",2,23,58,30,28
050,19,009,"Iowa","Audubon County",2,24,49,26,23
050,19,009,"Iowa","Audubon County",2,25,62,31,31
050,19,009,"Iowa","Audubon County",2,26,65,31,34
050,19,009,"Iowa","Audubon County",2,27,61,30,31
050,19,009,"Iowa","Audubon County",2,28,57,28,29
050,19,009,"Iowa","Audubon County",2,29,56,27,29
050,19,009,"Iowa","Audubon County",2,30,66,33,33
050,19,009,"Iowa","Audubon County",2,31,54,24,30
050,19,009,"Iowa","Audubon County",2,32,48,23,25
050,19,009,"Iowa","Audubon County",2,33,51,27,24
050,19,009,"Iowa","Audubon County",2,34,47,22,25
050,19,009,"Iowa","Audubon County",2,35,54,27,27
050,19,009,"Iowa","Audubon County",2,36,61,27,34
050,19,009,"Iowa","Audubon County",2,37,63,30,33
050,19,009,"Iowa","Audubon County",2,38,55,28,27
050,19,009,"Iowa","Audubon County",2,39,60,33,27
050,19,009,"Iowa","Audubon County",2,40,67,37,30
050,19,009,"Iowa","Audubon County",2,41,61,32,29
050,19,009,"Iowa","Audubon County",2,42,59,31,28
050,19,009,"Iowa","Audubon County",2,43,54,29,25
050,19,009,"Iowa","Audubon County",2,44,59,32,27
050,19,009,"Iowa","Audubon County",2,45,59,32,27
050,19,009,"Iowa","Audubon County",2,46,50,21,29
050,19,009,"Iowa","Audubon County",2,47,53,21,32
050,19,009,"Iowa","Audubon County",2,48,61,30,31
050,19,009,"Iowa","Audubon County",2,49,54,27,27
050,19,009,"Iowa","Audubon County",2,50,64,30,34
050,19,009,"Iowa","Audubon County",2,51,67,34,33
050,19,009,"Iowa","Audubon County",2,52,62,35,27
050,19,009,"Iowa","Audubon County",2,53,71,40,31
050,19,009,"Iowa","Audubon County",2,54,74,34,40
050,19,009,"Iowa","Audubon County",2,55,75,36,39
050,19,009,"Iowa","Audubon County",2,56,88,43,45
050,19,009,"Iowa","Audubon County",2,57,93,48,45
050,19,009,"Iowa","Audubon County",2,58,100,49,51
050,19,009,"Iowa","Audubon County",2,59,103,52,51
050,19,009,"Iowa","Audubon County",2,60,105,56,49
050,19,009,"Iowa","Audubon County",2,61,101,54,47
050,19,009,"Iowa","Audubon County",2,62,91,51,40
050,19,009,"Iowa","Audubon County",2,63,89,45,44
050,19,009,"Iowa","Audubon County",2,64,90,45,45
050,19,009,"Iowa","Audubon County",2,65,91,47,44
050,19,009,"Iowa","Audubon County",2,66,89,42,47
050,19,009,"Iowa","Audubon County",2,67,76,34,42
050,19,009,"Iowa","Audubon County",2,68,71,37,34
050,19,009,"Iowa","Audubon County",2,69,75,39,36
050,19,009,"Iowa","Audubon County",2,70,73,39,34
050,19,009,"Iowa","Audubon County",2,71,70,33,37
050,19,009,"Iowa","Audubon County",2,72,71,36,35
050,19,009,"Iowa","Audubon County",2,73,72,33,39
050,19,009,"Iowa","Audubon County",2,74,43,18,25
050,19,009,"Iowa","Audubon County",2,75,54,24,30
050,19,009,"Iowa","Audubon County",2,76,54,27,27
050,19,009,"Iowa","Audubon County",2,77,54,27,27
050,19,009,"Iowa","Audubon County",2,78,43,19,24
050,19,009,"Iowa","Audubon County",2,79,40,17,23
050,19,009,"Iowa","Audubon County",2,80,47,24,23
050,19,009,"Iowa","Audubon County",2,81,47,21,26
050,19,009,"Iowa","Audubon County",2,82,42,17,25
050,19,009,"Iowa","Audubon County",2,83,34,15,19
050,19,009,"Iowa","Audubon County",2,84,32,15,17
050,19,009,"Iowa","Audubon County",2,85,213,61,152
050,19,009,"Iowa","Audubon County",3,0,53,22,31
050,19,009,"Iowa","Audubon County",3,1,61,30,31
050,19,009,"Iowa","Audubon County",3,2,56,22,34
050,19,009,"Iowa","Audubon County",3,3,80,38,42
050,19,009,"Iowa","Audubon County",3,4,69,40,29
050,19,009,"Iowa","Audubon County",3,5,72,42,30
050,19,009,"Iowa","Audubon County",3,6,66,33,33
050,19,009,"Iowa","Audubon County",3,7,69,39,30
050,19,009,"Iowa","Audubon County",3,8,58,30,28
050,19,009,"Iowa","Audubon County",3,9,59,30,29
050,19,009,"Iowa","Audubon County",3,10,67,37,30
050,19,009,"Iowa","Audubon County",3,11,71,38,33
050,19,009,"Iowa","Audubon County",3,12,72,40,32
050,19,009,"Iowa","Audubon County",3,13,80,34,46
050,19,009,"Iowa","Audubon County",3,14,72,33,39
050,19,009,"Iowa","Audubon County",3,15,67,33,34
050,19,009,"Iowa","Audubon County",3,16,63,32,31
050,19,009,"Iowa","Audubon County",3,17,69,38,31
050,19,009,"Iowa","Audubon County",3,18,58,30,28
050,19,009,"Iowa","Audubon County",3,19,45,24,21
050,19,009,"Iowa","Audubon County",3,20,41,22,19
050,19,009,"Iowa","Audubon County",3,21,48,21,27
050,19,009,"Iowa","Audubon County",3,22,59,25,34
050,19,009,"Iowa","Audubon County",3,23,54,29,25
050,19,009,"Iowa","Audubon County",3,24,57,31,26
050,19,009,"Iowa","Audubon County",3,25,55,30,25
050,19,009,"Iowa","Audubon County",3,26,63,31,32
050,19,009,"Iowa","Audubon County",3,27,72,37,35
050,19,009,"Iowa","Audubon County",3,28,64,31,33
050,19,009,"Iowa","Audubon County",3,29,58,25,33
050,19,009,"Iowa","Audubon County",3,30,52,23,29
050,19,009,"Iowa","Audubon County",3,31,65,31,34
050,19,009,"Iowa","Audubon County",3,32,57,26,31
050,19,009,"Iowa","Audubon County",3,33,47,23,24
050,19,009,"Iowa","Audubon County",3,34,49,25,24
050,19,009,"Iowa","Audubon County",3,35,46,22,24
050,19,009,"Iowa","Audubon County",3,36,60,30,30
050,19,009,"Iowa","Audubon County",3,37,59,26,33
050,19,009,"Iowa","Audubon County",3,38,57,29,28
050,19,009,"Iowa","Audubon County",3,39,56,29,27
050,19,009,"Iowa","Audubon County",3,40,59,32,27
050,19,009,"Iowa","Audubon County",3,41,69,38,31
050,19,009,"Iowa","Audubon County",3,42,65,35,30
050,19,009,"Iowa","Audubon County",3,43,60,29,31
050,19,009,"Iowa","Audubon County",3,44,59,31,28
050,19,009,"Iowa","Audubon County",3,45,63,31,32
050,19,009,"Iowa","Audubon County",3,46,56,29,27
050,19,009,"Iowa","Audubon County",3,47,46,17,29
050,19,009,"Iowa","Audubon County",3,48,55,22,33
050,19,009,"Iowa","Audubon County",3,49,62,31,31
050,19,009,"Iowa","Audubon County",3,50,57,28,29
050,19,009,"Iowa","Audubon County",3,51,62,30,32
050,19,009,"Iowa","Audubon County",3,52,70,37,33
050,19,009,"Iowa","Audubon County",3,53,61,35,26
050,19,009,"Iowa","Audubon County",3,54,74,44,30
050,19,009,"Iowa","Audubon County",3,55,73,32,41
050,19,009,"Iowa","Audubon County",3,56,76,37,39
050,19,009,"Iowa","Audubon County",3,57,84,43,41
050,19,009,"Iowa","Audubon County",3,58,91,47,44
050,19,009,"Iowa","Audubon County",3,59,102,47,55
050,19,009,"Iowa","Audubon County",3,60,101,50,51
050,19,009,"Iowa","Audubon County",3,61,106,57,49
050,19,009,"Iowa","Audubon County",3,62,101,55,46
050,19,009,"Iowa","Audubon County",3,63,87,49,38
050,19,009,"Iowa","Audubon County",3,64,87,43,44
050,19,009,"Iowa","Audubon County",3,65,90,45,45
050,19,009,"Iowa","Audubon County",3,66,89,49,40
050,19,009,"Iowa","Audubon County",3,67,86,40,46
050,19,009,"Iowa","Audubon County",3,68,75,34,41
050,19,009,"Iowa","Audubon County",3,69,69,37,32
050,19,009,"Iowa","Audubon County",3,70,72,38,34
050,19,009,"Iowa","Audubon County",3,71,73,37,36
050,19,009,"Iowa","Audubon County",3,72,66,36,30
050,19,009,"Iowa","Audubon County",3,73,66,31,35
050,19,009,"Iowa","Audubon County",3,74,67,30,37
050,19,009,"Iowa","Audubon County",3,75,44,18,26
050,19,009,"Iowa","Audubon County",3,76,49,24,25
050,19,009,"Iowa","Audubon County",3,77,49,25,24
050,19,009,"Iowa","Audubon County",3,78,52,26,26
050,19,009,"Iowa","Audubon County",3,79,46,21,25
050,19,009,"Iowa","Audubon County",3,80,33,13,20
050,19,009,"Iowa","Audubon County",3,81,41,19,22
050,19,009,"Iowa","Audubon County",3,82,45,19,26
050,19,009,"Iowa","Audubon County",3,83,37,16,21
050,19,009,"Iowa","Audubon County",3,84,33,16,17
050,19,009,"Iowa","Audubon County",3,85,211,62,149
050,19,009,"Iowa","Audubon County",4,0,62,28,34
050,19,009,"Iowa","Audubon County",4,1,55,22,33
050,19,009,"Iowa","Audubon County",4,2,63,31,32
050,19,009,"Iowa","Audubon County",4,3,61,24,37
050,19,009,"Iowa","Audubon County",4,4,74,32,42
050,19,009,"Iowa","Audubon County",4,5,70,38,32
050,19,009,"Iowa","Audubon County",4,6,70,43,27
050,19,009,"Iowa","Audubon County",4,7,63,31,32
050,19,009,"Iowa","Audubon County",4,8,68,41,27
050,19,009,"Iowa","Audubon County",4,9,59,30,29
050,19,009,"Iowa","Audubon County",4,10,56,23,33
050,19,009,"Iowa","Audubon County",4,11,68,38,30
050,19,009,"Iowa","Audubon County",4,12,74,38,36
050,19,009,"Iowa","Audubon County",4,13,72,39,33
050,19,009,"Iowa","Audubon County",4,14,84,39,45
050,19,009,"Iowa","Audubon County",4,15,72,31,41
050,19,009,"Iowa","Audubon County",4,16,69,35,34
050,19,009,"Iowa","Audubon County",4,17,64,31,33
050,19,009,"Iowa","Audubon County",4,18,56,31,25
050,19,009,"Iowa","Audubon County",4,19,41,20,21
050,19,009,"Iowa","Audubon County",4,20,42,22,20
050,19,009,"Iowa","Audubon County",4,21,41,22,19
050,19,009,"Iowa","Audubon County",4,22,49,18,31
050,19,009,"Iowa","Audubon County",4,23,57,23,34
050,19,009,"Iowa","Audubon County",4,24,52,27,25
050,19,009,"Iowa","Audubon County",4,25,49,29,20
050,19,009,"Iowa","Audubon County",4,26,53,27,26
050,19,009,"Iowa","Audubon County",4,27,63,34,29
050,19,009,"Iowa","Audubon County",4,28,71,35,36
050,19,009,"Iowa","Audubon County",4,29,65,27,38
050,19,009,"Iowa","Audubon County",4,30,60,24,36
050,19,009,"Iowa","Audubon County",4,31,51,25,26
050,19,009,"Iowa","Audubon County",4,32,64,31,33
050,19,009,"Iowa","Audubon County",4,33,55,25,30
050,19,009,"Iowa","Audubon County",4,34,51,26,25
050,19,009,"Iowa","Audubon County",4,35,52,25,27
050,19,009,"Iowa","Audubon County",4,36,51,25,26
050,19,009,"Iowa","Audubon County",4,37,62,30,32
050,19,009,"Iowa","Audubon County",4,38,57,24,33
050,19,009,"Iowa","Audubon County",4,39,59,29,30
050,19,009,"Iowa","Audubon County",4,40,57,32,25
050,19,009,"Iowa","Audubon County",4,41,61,35,26
050,19,009,"Iowa","Audubon County",4,42,71,39,32
050,19,009,"Iowa","Audubon County",4,43,64,34,30
050,19,009,"Iowa","Audubon County",4,44,62,29,33
050,19,009,"Iowa","Audubon County",4,45,54,30,24
050,19,009,"Iowa","Audubon County",4,46,61,32,29
050,19,009,"Iowa","Audubon County",4,47,57,29,28
050,19,009,"Iowa","Audubon County",4,48,45,18,27
050,19,009,"Iowa","Audubon County",4,49,55,22,33
050,19,009,"Iowa","Audubon County",4,50,64,30,34
050,19,009,"Iowa","Audubon County",4,51,57,29,28
050,19,009,"Iowa","Audubon County",4,52,62,30,32
050,19,009,"Iowa","Audubon County",4,53,69,37,32
050,19,009,"Iowa","Audubon County",4,54,60,34,26
050,19,009,"Iowa","Audubon County",4,55,73,44,29
050,19,009,"Iowa","Audubon County",4,56,74,32,42
050,19,009,"Iowa","Audubon County",4,57,74,39,35
050,19,009,"Iowa","Audubon County",4,58,83,42,41
050,19,009,"Iowa","Audubon County",4,59,88,45,43
050,19,009,"Iowa","Audubon County",4,60,101,48,53
050,19,009,"Iowa","Audubon County",4,61,98,48,50
050,19,009,"Iowa","Audubon County",4,62,100,54,46
050,19,009,"Iowa","Audubon County",4,63,99,57,42
050,19,009,"Iowa","Audubon County",4,64,89,47,42
050,19,009,"Iowa","Audubon County",4,65,85,43,42
050,19,009,"Iowa","Audubon County",4,66,87,45,42
050,19,009,"Iowa","Audubon County",4,67,82,45,37
050,19,009,"Iowa","Audubon County",4,68,84,40,44
050,19,009,"Iowa","Audubon County",4,69,78,34,44
050,19,009,"Iowa","Audubon County",4,70,63,34,29
050,19,009,"Iowa","Audubon County",4,71,74,38,36
050,19,009,"Iowa","Audubon County",4,72,70,38,32
050,19,009,"Iowa","Audubon County",4,73,61,32,29
050,19,009,"Iowa","Audubon County",4,74,64,29,35
050,19,009,"Iowa","Audubon County",4,75,64,28,36
050,19,009,"Iowa","Audubon County",4,76,40,17,23
050,19,009,"Iowa","Audubon County",4,77,42,20,22
050,19,009,"Iowa","Audubon County",4,78,43,22,21
050,19,009,"Iowa","Audubon County",4,79,52,26,26
050,19,009,"Iowa","Audubon County",4,80,39,18,21
050,19,009,"Iowa","Audubon County",4,81,30,10,20
050,19,009,"Iowa","Audubon County",4,82,33,14,19
050,19,009,"Iowa","Audubon County",4,83,44,19,25
050,19,009,"Iowa","Audubon County",4,84,37,18,19
050,19,009,"Iowa","Audubon County",4,85,220,69,151
050,19,009,"Iowa","Audubon County",5,0,61,27,34
050,19,009,"Iowa","Audubon County",5,1,70,34,36
050,19,009,"Iowa","Audubon County",5,2,55,20,35
050,19,009,"Iowa","Audubon County",5,3,67,38,29
050,19,009,"Iowa","Audubon County",5,4,62,23,39
050,19,009,"Iowa","Audubon County",5,5,71,31,40
050,19,009,"Iowa","Audubon County",5,6,70,39,31
050,19,009,"Iowa","Audubon County",5,7,65,40,25
050,19,009,"Iowa","Audubon County",5,8,64,32,32
050,19,009,"Iowa","Audubon County",5,9,63,39,24
050,19,009,"Iowa","Audubon County",5,10,54,28,26
050,19,009,"Iowa","Audubon County",5,11,55,23,32
050,19,009,"Iowa","Audubon County",5,12,61,35,26
050,19,009,"Iowa","Audubon County",5,13,74,39,35
050,19,009,"Iowa","Audubon County",5,14,74,40,34
050,19,009,"Iowa","Audubon County",5,15,90,42,48
050,19,009,"Iowa","Audubon County",5,16,76,36,40
050,19,009,"Iowa","Audubon County",5,17,69,36,33
050,19,009,"Iowa","Audubon County",5,18,55,28,27
050,19,009,"Iowa","Audubon County",5,19,39,21,18
050,19,009,"Iowa","Audubon County",5,20,40,20,20
050,19,009,"Iowa","Audubon County",5,21,46,27,19
050,19,009,"Iowa","Audubon County",5,22,40,18,22
050,19,009,"Iowa","Audubon County",5,23,49,22,27
050,19,009,"Iowa","Audubon County",5,24,58,25,33
050,19,009,"Iowa","Audubon County",5,25,48,28,20
050,19,009,"Iowa","Audubon County",5,26,49,27,22
050,19,009,"Iowa","Audubon County",5,27,52,29,23
050,19,009,"Iowa","Audubon County",5,28,62,29,33
050,19,009,"Iowa","Audubon County",5,29,64,29,35
050,19,009,"Iowa","Audubon County",5,30,59,24,35
050,19,009,"Iowa","Audubon County",5,31,60,23,37
050,19,009,"Iowa","Audubon County",5,32,53,28,25
050,19,009,"Iowa","Audubon County",5,33,69,36,33
050,19,009,"Iowa","Audubon County",5,34,59,26,33
050,19,009,"Iowa","Audubon County",5,35,48,24,24
050,19,009,"Iowa","Audubon County",5,36,52,25,27
050,19,009,"Iowa","Audubon County",5,37,47,24,23
050,19,009,"Iowa","Audubon County",5,38,58,27,31
050,19,009,"Iowa","Audubon County",5,39,57,27,30
050,19,009,"Iowa","Audubon County",5,40,62,31,31
050,19,009,"Iowa","Audubon County",5,41,58,33,25
050,19,009,"Iowa","Audubon County",5,42,61,34,27
050,19,009,"Iowa","Audubon County",5,43,70,38,32
050,19,009,"Iowa","Audubon County",5,44,67,34,33
050,19,009,"Iowa","Audubon County",5,45,59,26,33
050,19,009,"Iowa","Audubon County",5,46,57,30,27
050,19,009,"Iowa","Audubon County",5,47,61,31,30
050,19,009,"Iowa","Audubon County",5,48,57,29,28
050,19,009,"Iowa","Audubon County",5,49,45,18,27
050,19,009,"Iowa","Audubon County",5,50,61,23,38
050,19,009,"Iowa","Audubon County",5,51,61,29,32
050,19,009,"Iowa","Audubon County",5,52,57,29,28
050,19,009,"Iowa","Audubon County",5,53,67,33,34
050,19,009,"Iowa","Audubon County",5,54,71,36,35
050,19,009,"Iowa","Audubon County",5,55,62,35,27
050,19,009,"Iowa","Audubon County",5,56,74,44,30
050,19,009,"Iowa","Audubon County",5,57,75,33,42
050,19,009,"Iowa","Audubon County",5,58,72,38,34
050,19,009,"Iowa","Audubon County",5,59,84,43,41
050,19,009,"Iowa","Audubon County",5,60,90,43,47
050,19,009,"Iowa","Audubon County",5,61,99,46,53
050,19,009,"Iowa","Audubon County",5,62,94,47,47
050,19,009,"Iowa","Audubon County",5,63,103,57,46
050,19,009,"Iowa","Audubon County",5,64,101,60,41
050,19,009,"Iowa","Audubon County",5,65,96,51,45
050,19,009,"Iowa","Audubon County",5,66,85,44,41
050,19,009,"Iowa","Audubon County",5,67,86,42,44
050,19,009,"Iowa","Audubon County",5,68,78,43,35
050,19,009,"Iowa","Audubon County",5,69,84,39,45
050,19,009,"Iowa","Audubon County",5,70,75,33,42
050,19,009,"Iowa","Audubon County",5,71,62,32,30
050,19,009,"Iowa","Audubon County",5,72,73,41,32
050,19,009,"Iowa","Audubon County",5,73,66,32,34
050,19,009,"Iowa","Audubon County",5,74,60,31,29
050,19,009,"Iowa","Audubon County",5,75,62,27,35
050,19,009,"Iowa","Audubon County",5,76,57,27,30
050,19,009,"Iowa","Audubon County",5,77,33,12,21
050,19,009,"Iowa","Audubon County",5,78,36,16,20
050,19,009,"Iowa","Audubon County",5,79,41,23,18
050,19,009,"Iowa","Audubon County",5,80,48,24,24
050,19,009,"Iowa","Audubon County",5,81,34,14,20
050,19,009,"Iowa","Audubon County",5,82,22,5,17
050,19,009,"Iowa","Audubon County",5,83,32,14,18
050,19,009,"Iowa","Audubon County",5,84,43,18,25
050,19,009,"Iowa","Audubon County",5,85,228,78,150
050,19,011,"Iowa","Benton County",1,0,280,145,135
050,19,011,"Iowa","Benton County",1,1,295,156,139
050,19,011,"Iowa","Benton County",1,2,315,174,141
050,19,011,"Iowa","Benton County",1,3,330,165,165
050,19,011,"Iowa","Benton County",1,4,332,173,159
050,19,011,"Iowa","Benton County",1,5,336,179,157
050,19,011,"Iowa","Benton County",1,6,294,146,148
050,19,011,"Iowa","Benton County",1,7,310,161,149
050,19,011,"Iowa","Benton County",1,8,306,150,156
050,19,011,"Iowa","Benton County",1,9,331,161,170
050,19,011,"Iowa","Benton County",1,10,340,164,176
050,19,011,"Iowa","Benton County",1,11,360,177,183
050,19,011,"Iowa","Benton County",1,12,332,170,162
050,19,011,"Iowa","Benton County",1,13,368,199,169
050,19,011,"Iowa","Benton County",1,14,366,186,180
050,19,011,"Iowa","Benton County",1,15,372,182,190
050,19,011,"Iowa","Benton County",1,16,374,182,192
050,19,011,"Iowa","Benton County",1,17,361,172,189
050,19,011,"Iowa","Benton County",1,18,298,152,146
050,19,011,"Iowa","Benton County",1,19,224,118,106
050,19,011,"Iowa","Benton County",1,20,238,119,119
050,19,011,"Iowa","Benton County",1,21,244,139,105
050,19,011,"Iowa","Benton County",1,22,237,120,117
050,19,011,"Iowa","Benton County",1,23,238,120,118
050,19,011,"Iowa","Benton County",1,24,249,134,115
050,19,011,"Iowa","Benton County",1,25,248,129,119
050,19,011,"Iowa","Benton County",1,26,265,146,119
050,19,011,"Iowa","Benton County",1,27,265,139,126
050,19,011,"Iowa","Benton County",1,28,292,152,140
050,19,011,"Iowa","Benton County",1,29,280,150,130
050,19,011,"Iowa","Benton County",1,30,263,133,130
050,19,011,"Iowa","Benton County",1,31,260,130,130
050,19,011,"Iowa","Benton County",1,32,277,146,131
050,19,011,"Iowa","Benton County",1,33,286,151,135
050,19,011,"Iowa","Benton County",1,34,280,145,135
050,19,011,"Iowa","Benton County",1,35,291,154,137
050,19,011,"Iowa","Benton County",1,36,293,144,149
050,19,011,"Iowa","Benton County",1,37,299,143,156
050,19,011,"Iowa","Benton County",1,38,314,156,158
050,19,011,"Iowa","Benton County",1,39,336,174,162
050,19,011,"Iowa","Benton County",1,40,328,177,151
050,19,011,"Iowa","Benton County",1,41,294,144,150
050,19,011,"Iowa","Benton County",1,42,286,133,153
050,19,011,"Iowa","Benton County",1,43,309,153,156
050,19,011,"Iowa","Benton County",1,44,302,149,153
050,19,011,"Iowa","Benton County",1,45,304,167,137
050,19,011,"Iowa","Benton County",1,46,290,149,141
050,19,011,"Iowa","Benton County",1,47,274,136,138
050,19,011,"Iowa","Benton County",1,48,323,162,161
050,19,011,"Iowa","Benton County",1,49,331,166,165
050,19,011,"Iowa","Benton County",1,50,320,165,155
050,19,011,"Iowa","Benton County",1,51,337,157,180
050,19,011,"Iowa","Benton County",1,52,344,164,180
050,19,011,"Iowa","Benton County",1,53,373,190,183
050,19,011,"Iowa","Benton County",1,54,397,202,195
050,19,011,"Iowa","Benton County",1,55,410,212,198
050,19,011,"Iowa","Benton County",1,56,391,193,198
050,19,011,"Iowa","Benton County",1,57,430,223,207
050,19,011,"Iowa","Benton County",1,58,419,206,213
050,19,011,"Iowa","Benton County",1,59,413,201,212
050,19,011,"Iowa","Benton County",1,60,418,212,206
050,19,011,"Iowa","Benton County",1,61,403,207,196
050,19,011,"Iowa","Benton County",1,62,405,217,188
050,19,011,"Iowa","Benton County",1,63,377,205,172
050,19,011,"Iowa","Benton County",1,64,356,186,170
050,19,011,"Iowa","Benton County",1,65,330,180,150
050,19,011,"Iowa","Benton County",1,66,309,165,144
050,19,011,"Iowa","Benton County",1,67,289,157,132
050,19,011,"Iowa","Benton County",1,68,296,155,141
050,19,011,"Iowa","Benton County",1,69,268,131,137
050,19,011,"Iowa","Benton County",1,70,242,122,120
050,19,011,"Iowa","Benton County",1,71,239,115,124
050,19,011,"Iowa","Benton County",1,72,232,118,114
050,19,011,"Iowa","Benton County",1,73,245,123,122
050,19,011,"Iowa","Benton County",1,74,190,91,99
050,19,011,"Iowa","Benton County",1,75,189,79,110
050,19,011,"Iowa","Benton County",1,76,181,83,98
050,19,011,"Iowa","Benton County",1,77,185,80,105
050,19,011,"Iowa","Benton County",1,78,167,78,89
050,19,011,"Iowa","Benton County",1,79,151,66,85
050,19,011,"Iowa","Benton County",1,80,127,74,53
050,19,011,"Iowa","Benton County",1,81,133,71,62
050,19,011,"Iowa","Benton County",1,82,105,48,57
050,19,011,"Iowa","Benton County",1,83,121,47,74
050,19,011,"Iowa","Benton County",1,84,103,47,56
050,19,011,"Iowa","Benton County",1,85,669,246,423
050,19,011,"Iowa","Benton County",2,0,262,137,125
050,19,011,"Iowa","Benton County",2,1,291,154,137
050,19,011,"Iowa","Benton County",2,2,312,170,142
050,19,011,"Iowa","Benton County",2,3,323,166,157
050,19,011,"Iowa","Benton County",2,4,333,171,162
050,19,011,"Iowa","Benton County",2,5,333,177,156
050,19,011,"Iowa","Benton County",2,6,301,152,149
050,19,011,"Iowa","Benton County",2,7,306,157,149
050,19,011,"Iowa","Benton County",2,8,308,153,155
050,19,011,"Iowa","Benton County",2,9,324,159,165
050,19,011,"Iowa","Benton County",2,10,338,164,174
050,19,011,"Iowa","Benton County",2,11,352,174,178
050,19,011,"Iowa","Benton County",2,12,340,174,166
050,19,011,"Iowa","Benton County",2,13,360,194,166
050,19,011,"Iowa","Benton County",2,14,366,188,178
050,19,011,"Iowa","Benton County",2,15,366,181,185
050,19,011,"Iowa","Benton County",2,16,377,185,192
050,19,011,"Iowa","Benton County",2,17,365,176,189
050,19,011,"Iowa","Benton County",2,18,295,149,146
050,19,011,"Iowa","Benton County",2,19,228,119,109
050,19,011,"Iowa","Benton County",2,20,243,123,120
050,19,011,"Iowa","Benton County",2,21,245,134,111
050,19,011,"Iowa","Benton County",2,22,237,121,116
050,19,011,"Iowa","Benton County",2,23,238,120,118
050,19,011,"Iowa","Benton County",2,24,243,131,112
050,19,011,"Iowa","Benton County",2,25,247,131,116
050,19,011,"Iowa","Benton County",2,26,264,146,118
050,19,011,"Iowa","Benton County",2,27,269,143,126
050,19,011,"Iowa","Benton County",2,28,288,150,138
050,19,011,"Iowa","Benton County",2,29,285,151,134
050,19,011,"Iowa","Benton County",2,30,272,140,132
050,19,011,"Iowa","Benton County",2,31,261,132,129
050,19,011,"Iowa","Benton County",2,32,275,144,131
050,19,011,"Iowa","Benton County",2,33,285,151,134
050,19,011,"Iowa","Benton County",2,34,279,145,134
050,19,011,"Iowa","Benton County",2,35,291,152,139
050,19,011,"Iowa","Benton County",2,36,291,145,146
050,19,011,"Iowa","Benton County",2,37,299,145,154
050,19,011,"Iowa","Benton County",2,38,311,153,158
050,19,011,"Iowa","Benton County",2,39,331,169,162
050,19,011,"Iowa","Benton County",2,40,332,177,155
050,19,011,"Iowa","Benton County",2,41,299,151,148
050,19,011,"Iowa","Benton County",2,42,285,134,151
050,19,011,"Iowa","Benton County",2,43,304,149,155
050,19,011,"Iowa","Benton County",2,44,301,150,151
050,19,011,"Iowa","Benton County",2,45,307,164,143
050,19,011,"Iowa","Benton County",2,46,291,151,140
050,19,011,"Iowa","Benton County",2,47,276,138,138
050,19,011,"Iowa","Benton County",2,48,309,155,154
050,19,011,"Iowa","Benton County",2,49,330,168,162
050,19,011,"Iowa","Benton County",2,50,324,165,159
050,19,011,"Iowa","Benton County",2,51,332,158,174
050,19,011,"Iowa","Benton County",2,52,343,164,179
050,19,011,"Iowa","Benton County",2,53,367,184,183
050,19,011,"Iowa","Benton County",2,54,390,199,191
050,19,011,"Iowa","Benton County",2,55,405,207,198
050,19,011,"Iowa","Benton County",2,56,395,199,196
050,19,011,"Iowa","Benton County",2,57,421,217,204
050,19,011,"Iowa","Benton County",2,58,421,208,213
050,19,011,"Iowa","Benton County",2,59,417,204,213
050,19,011,"Iowa","Benton County",2,60,411,205,206
050,19,011,"Iowa","Benton County",2,61,405,208,197
050,19,011,"Iowa","Benton County",2,62,401,214,187
050,19,011,"Iowa","Benton County",2,63,387,210,177
050,19,011,"Iowa","Benton County",2,64,358,189,169
050,19,011,"Iowa","Benton County",2,65,336,182,154
050,19,011,"Iowa","Benton County",2,66,313,168,145
050,19,011,"Iowa","Benton County",2,67,292,156,136
050,19,011,"Iowa","Benton County",2,68,289,154,135
050,19,011,"Iowa","Benton County",2,69,276,137,139
050,19,011,"Iowa","Benton County",2,70,247,124,123
050,19,011,"Iowa","Benton County",2,71,240,117,123
050,19,011,"Iowa","Benton County",2,72,229,115,114
050,19,011,"Iowa","Benton County",2,73,251,126,125
050,19,011,"Iowa","Benton County",2,74,190,92,98
050,19,011,"Iowa","Benton County",2,75,186,81,105
050,19,011,"Iowa","Benton County",2,76,179,80,99
050,19,011,"Iowa","Benton County",2,77,188,81,107
050,19,011,"Iowa","Benton County",2,78,168,78,90
050,19,011,"Iowa","Benton County",2,79,152,67,85
050,19,011,"Iowa","Benton County",2,80,130,72,58
050,19,011,"Iowa","Benton County",2,81,132,71,61
050,19,011,"Iowa","Benton County",2,82,110,52,58
050,19,011,"Iowa","Benton County",2,83,116,46,70
050,19,011,"Iowa","Benton County",2,84,101,45,56
050,19,011,"Iowa","Benton County",2,85,679,249,430
050,19,011,"Iowa","Benton County",3,0,267,135,132
050,19,011,"Iowa","Benton County",3,1,276,147,129
050,19,011,"Iowa","Benton County",3,2,309,166,143
050,19,011,"Iowa","Benton County",3,3,323,174,149
050,19,011,"Iowa","Benton County",3,4,336,171,165
050,19,011,"Iowa","Benton County",3,5,345,176,169
050,19,011,"Iowa","Benton County",3,6,335,171,164
050,19,011,"Iowa","Benton County",3,7,310,165,145
050,19,011,"Iowa","Benton County",3,8,324,168,156
050,19,011,"Iowa","Benton County",3,9,317,158,159
050,19,011,"Iowa","Benton County",3,10,324,166,158
050,19,011,"Iowa","Benton County",3,11,332,156,176
050,19,011,"Iowa","Benton County",3,12,350,170,180
050,19,011,"Iowa","Benton County",3,13,348,176,172
050,19,011,"Iowa","Benton County",3,14,355,192,163
050,19,011,"Iowa","Benton County",3,15,359,188,171
050,19,011,"Iowa","Benton County",3,16,366,180,186
050,19,011,"Iowa","Benton County",3,17,382,192,190
050,19,011,"Iowa","Benton County",3,18,305,153,152
050,19,011,"Iowa","Benton County",3,19,243,125,118
050,19,011,"Iowa","Benton County",3,20,239,128,111
050,19,011,"Iowa","Benton County",3,21,260,134,126
050,19,011,"Iowa","Benton County",3,22,268,144,124
050,19,011,"Iowa","Benton County",3,23,250,122,128
050,19,011,"Iowa","Benton County",3,24,243,126,117
050,19,011,"Iowa","Benton County",3,25,249,133,116
050,19,011,"Iowa","Benton County",3,26,265,137,128
050,19,011,"Iowa","Benton County",3,27,288,157,131
050,19,011,"Iowa","Benton County",3,28,266,140,126
050,19,011,"Iowa","Benton County",3,29,288,153,135
050,19,011,"Iowa","Benton County",3,30,305,164,141
050,19,011,"Iowa","Benton County",3,31,286,150,136
050,19,011,"Iowa","Benton County",3,32,276,140,136
050,19,011,"Iowa","Benton County",3,33,275,140,135
050,19,011,"Iowa","Benton County",3,34,283,155,128
050,19,011,"Iowa","Benton County",3,35,290,153,137
050,19,011,"Iowa","Benton County",3,36,282,142,140
050,19,011,"Iowa","Benton County",3,37,288,145,143
050,19,011,"Iowa","Benton County",3,38,291,139,152
050,19,011,"Iowa","Benton County",3,39,316,153,163
050,19,011,"Iowa","Benton County",3,40,336,175,161
050,19,011,"Iowa","Benton County",3,41,338,180,158
050,19,011,"Iowa","Benton County",3,42,319,156,163
050,19,011,"Iowa","Benton County",3,43,291,133,158
050,19,011,"Iowa","Benton County",3,44,312,150,162
050,19,011,"Iowa","Benton County",3,45,304,155,149
050,19,011,"Iowa","Benton County",3,46,304,164,140
050,19,011,"Iowa","Benton County",3,47,296,156,140
050,19,011,"Iowa","Benton County",3,48,278,140,138
050,19,011,"Iowa","Benton County",3,49,306,152,154
050,19,011,"Iowa","Benton County",3,50,334,167,167
050,19,011,"Iowa","Benton County",3,51,321,160,161
050,19,011,"Iowa","Benton County",3,52,324,151,173
050,19,011,"Iowa","Benton County",3,53,350,169,181
050,19,011,"Iowa","Benton County",3,54,363,182,181
050,19,011,"Iowa","Benton County",3,55,394,200,194
050,19,011,"Iowa","Benton County",3,56,405,209,196
050,19,011,"Iowa","Benton County",3,57,399,201,198
050,19,011,"Iowa","Benton County",3,58,418,212,206
050,19,011,"Iowa","Benton County",3,59,430,215,215
050,19,011,"Iowa","Benton County",3,60,413,205,208
050,19,011,"Iowa","Benton County",3,61,407,201,206
050,19,011,"Iowa","Benton County",3,62,395,203,192
050,19,011,"Iowa","Benton County",3,63,399,212,187
050,19,011,"Iowa","Benton County",3,64,380,208,172
050,19,011,"Iowa","Benton County",3,65,355,186,169
050,19,011,"Iowa","Benton County",3,66,329,174,155
050,19,011,"Iowa","Benton County",3,67,315,167,148
050,19,011,"Iowa","Benton County",3,68,276,150,126
050,19,011,"Iowa","Benton County",3,69,282,151,131
050,19,011,"Iowa","Benton County",3,70,264,132,132
050,19,011,"Iowa","Benton County",3,71,236,118,118
050,19,011,"Iowa","Benton County",3,72,242,116,126
050,19,011,"Iowa","Benton County",3,73,217,105,112
050,19,011,"Iowa","Benton County",3,74,245,125,120
050,19,011,"Iowa","Benton County",3,75,178,84,94
050,19,011,"Iowa","Benton County",3,76,177,81,96
050,19,011,"Iowa","Benton County",3,77,181,79,102
050,19,011,"Iowa","Benton County",3,78,179,81,98
050,19,011,"Iowa","Benton County",3,79,159,69,90
050,19,011,"Iowa","Benton County",3,80,139,67,72
050,19,011,"Iowa","Benton County",3,81,124,67,57
050,19,011,"Iowa","Benton County",3,82,111,59,52
050,19,011,"Iowa","Benton County",3,83,122,52,70
050,19,011,"Iowa","Benton County",3,84,97,41,56
050,19,011,"Iowa","Benton County",3,85,680,250,430
050,19,011,"Iowa","Benton County",4,0,262,145,117
050,19,011,"Iowa","Benton County",4,1,265,135,130
050,19,011,"Iowa","Benton County",4,2,293,160,133
050,19,011,"Iowa","Benton County",4,3,327,172,155
050,19,011,"Iowa","Benton County",4,4,321,176,145
050,19,011,"Iowa","Benton County",4,5,341,173,168
050,19,011,"Iowa","Benton County",4,6,360,186,174
050,19,011,"Iowa","Benton County",4,7,346,172,174
050,19,011,"Iowa","Benton County",4,8,316,166,150
050,19,011,"Iowa","Benton County",4,9,327,170,157
050,19,011,"Iowa","Benton County",4,10,331,167,164
050,19,011,"Iowa","Benton County",4,11,318,159,159
050,19,011,"Iowa","Benton County",4,12,341,160,181
050,19,011,"Iowa","Benton County",4,13,345,168,177
050,19,011,"Iowa","Benton County",4,14,340,171,169
050,19,011,"Iowa","Benton County",4,15,356,190,166
050,19,011,"Iowa","Benton County",4,16,354,181,173
050,19,011,"Iowa","Benton County",4,17,360,177,183
050,19,011,"Iowa","Benton County",4,18,323,175,148
050,19,011,"Iowa","Benton County",4,19,232,117,115
050,19,011,"Iowa","Benton County",4,20,242,123,119
050,19,011,"Iowa","Benton County",4,21,245,136,109
050,19,011,"Iowa","Benton County",4,22,276,129,147
050,19,011,"Iowa","Benton County",4,23,283,147,136
050,19,011,"Iowa","Benton County",4,24,245,117,128
050,19,011,"Iowa","Benton County",4,25,232,129,103
050,19,011,"Iowa","Benton County",4,26,256,140,116
050,19,011,"Iowa","Benton County",4,27,258,139,119
050,19,011,"Iowa","Benton County",4,28,287,153,134
050,19,011,"Iowa","Benton County",4,29,268,140,128
050,19,011,"Iowa","Benton County",4,30,306,159,147
050,19,011,"Iowa","Benton County",4,31,302,163,139
050,19,011,"Iowa","Benton County",4,32,301,155,146
050,19,011,"Iowa","Benton County",4,33,284,146,138
050,19,011,"Iowa","Benton County",4,34,282,144,138
050,19,011,"Iowa","Benton County",4,35,304,159,145
050,19,011,"Iowa","Benton County",4,36,306,157,149
050,19,011,"Iowa","Benton County",4,37,280,140,140
050,19,011,"Iowa","Benton County",4,38,306,158,148
050,19,011,"Iowa","Benton County",4,39,303,144,159
050,19,011,"Iowa","Benton County",4,40,322,157,165
050,19,011,"Iowa","Benton County",4,41,343,183,160
050,19,011,"Iowa","Benton County",4,42,331,170,161
050,19,011,"Iowa","Benton County",4,43,317,155,162
050,19,011,"Iowa","Benton County",4,44,297,138,159
050,19,011,"Iowa","Benton County",4,45,317,152,165
050,19,011,"Iowa","Benton County",4,46,296,154,142
050,19,011,"Iowa","Benton County",4,47,300,158,142
050,19,011,"Iowa","Benton County",4,48,289,154,135
050,19,011,"Iowa","Benton County",4,49,273,142,131
050,19,011,"Iowa","Benton County",4,50,308,152,156
050,19,011,"Iowa","Benton County",4,51,330,168,162
050,19,011,"Iowa","Benton County",4,52,320,158,162
050,19,011,"Iowa","Benton County",4,53,318,151,167
050,19,011,"Iowa","Benton County",4,54,337,163,174
050,19,011,"Iowa","Benton County",4,55,350,174,176
050,19,011,"Iowa","Benton County",4,56,388,201,187
050,19,011,"Iowa","Benton County",4,57,409,210,199
050,19,011,"Iowa","Benton County",4,58,390,197,193
050,19,011,"Iowa","Benton County",4,59,421,212,209
050,19,011,"Iowa","Benton County",4,60,425,210,215
050,19,011,"Iowa","Benton County",4,61,403,197,206
050,19,011,"Iowa","Benton County",4,62,402,197,205
050,19,011,"Iowa","Benton County",4,63,388,202,186
050,19,011,"Iowa","Benton County",4,64,396,205,191
050,19,011,"Iowa","Benton County",4,65,372,205,167
050,19,011,"Iowa","Benton County",4,66,351,185,166
050,19,011,"Iowa","Benton County",4,67,330,171,159
050,19,011,"Iowa","Benton County",4,68,299,162,137
050,19,011,"Iowa","Benton County",4,69,268,143,125
050,19,011,"Iowa","Benton County",4,70,273,148,125
050,19,011,"Iowa","Benton County",4,71,255,132,123
050,19,011,"Iowa","Benton County",4,72,235,116,119
050,19,011,"Iowa","Benton County",4,73,223,103,120
050,19,011,"Iowa","Benton County",4,74,213,106,107
050,19,011,"Iowa","Benton County",4,75,237,118,119
050,19,011,"Iowa","Benton County",4,76,163,77,86
050,19,011,"Iowa","Benton County",4,77,175,77,98
050,19,011,"Iowa","Benton County",4,78,173,79,94
050,19,011,"Iowa","Benton County",4,79,175,74,101
050,19,011,"Iowa","Benton County",4,80,147,67,80
050,19,011,"Iowa","Benton County",4,81,141,67,74
050,19,011,"Iowa","Benton County",4,82,112,64,48
050,19,011,"Iowa","Benton County",4,83,118,55,63
050,19,011,"Iowa","Benton County",4,84,100,45,55
050,19,011,"Iowa","Benton County",4,85,688,251,437
050,19,011,"Iowa","Benton County",5,0,263,142,121
050,19,011,"Iowa","Benton County",5,1,255,143,112
050,19,011,"Iowa","Benton County",5,2,272,134,138
050,19,011,"Iowa","Benton County",5,3,300,170,130
050,19,011,"Iowa","Benton County",5,4,315,167,148
050,19,011,"Iowa","Benton County",5,5,328,174,154
050,19,011,"Iowa","Benton County",5,6,345,182,163
050,19,011,"Iowa","Benton County",5,7,353,185,168
050,19,011,"Iowa","Benton County",5,8,342,168,174
050,19,011,"Iowa","Benton County",5,9,329,175,154
050,19,011,"Iowa","Benton County",5,10,331,169,162
050,19,011,"Iowa","Benton County",5,11,333,167,166
050,19,011,"Iowa","Benton County",5,12,328,171,157
050,19,011,"Iowa","Benton County",5,13,346,166,180
050,19,011,"Iowa","Benton County",5,14,351,170,181
050,19,011,"Iowa","Benton County",5,15,344,173,171
050,19,011,"Iowa","Benton County",5,16,358,187,171
050,19,011,"Iowa","Benton County",5,17,370,191,179
050,19,011,"Iowa","Benton County",5,18,308,155,153
050,19,011,"Iowa","Benton County",5,19,247,133,114
050,19,011,"Iowa","Benton County",5,20,243,120,123
050,19,011,"Iowa","Benton County",5,21,250,130,120
050,19,011,"Iowa","Benton County",5,22,256,132,124
050,19,011,"Iowa","Benton County",5,23,275,130,145
050,19,011,"Iowa","Benton County",5,24,268,137,131
050,19,011,"Iowa","Benton County",5,25,230,110,120
050,19,011,"Iowa","Benton County",5,26,240,132,108
050,19,011,"Iowa","Benton County",5,27,261,134,127
050,19,011,"Iowa","Benton County",5,28,268,138,130
050,19,011,"Iowa","Benton County",5,29,291,157,134
050,19,011,"Iowa","Benton County",5,30,268,139,129
050,19,011,"Iowa","Benton County",5,31,301,153,148
050,19,011,"Iowa","Benton County",5,32,315,169,146
050,19,011,"Iowa","Benton County",5,33,301,165,136
050,19,011,"Iowa","Benton County",5,34,286,147,139
050,19,011,"Iowa","Benton County",5,35,293,148,145
050,19,011,"Iowa","Benton County",5,36,300,159,141
050,19,011,"Iowa","Benton County",5,37,312,163,149
050,19,011,"Iowa","Benton County",5,38,290,139,151
050,19,011,"Iowa","Benton County",5,39,313,159,154
050,19,011,"Iowa","Benton County",5,40,304,144,160
050,19,011,"Iowa","Benton County",5,41,324,158,166
050,19,011,"Iowa","Benton County",5,42,344,181,163
050,19,011,"Iowa","Benton County",5,43,327,174,153
050,19,011,"Iowa","Benton County",5,44,314,153,161
050,19,011,"Iowa","Benton County",5,45,308,144,164
050,19,011,"Iowa","Benton County",5,46,312,147,165
050,19,011,"Iowa","Benton County",5,47,289,147,142
050,19,011,"Iowa","Benton County",5,48,300,161,139
050,19,011,"Iowa","Benton County",5,49,296,157,139
050,19,011,"Iowa","Benton County",5,50,266,138,128
050,19,011,"Iowa","Benton County",5,51,314,158,156
050,19,011,"Iowa","Benton County",5,52,342,169,173
050,19,011,"Iowa","Benton County",5,53,341,171,170
050,19,011,"Iowa","Benton County",5,54,313,147,166
050,19,011,"Iowa","Benton County",5,55,333,161,172
050,19,011,"Iowa","Benton County",5,56,345,175,170
050,19,011,"Iowa","Benton County",5,57,384,202,182
050,19,011,"Iowa","Benton County",5,58,409,211,198
050,19,011,"Iowa","Benton County",5,59,387,193,194
050,19,011,"Iowa","Benton County",5,60,409,204,205
050,19,011,"Iowa","Benton County",5,61,423,209,214
050,19,011,"Iowa","Benton County",5,62,397,196,201
050,19,011,"Iowa","Benton County",5,63,387,192,195
050,19,011,"Iowa","Benton County",5,64,389,198,191
050,19,011,"Iowa","Benton County",5,65,387,198,189
050,19,011,"Iowa","Benton County",5,66,366,202,164
050,19,011,"Iowa","Benton County",5,67,354,181,173
050,19,011,"Iowa","Benton County",5,68,319,169,150
050,19,011,"Iowa","Benton County",5,69,293,160,133
050,19,011,"Iowa","Benton County",5,70,268,145,123
050,19,011,"Iowa","Benton County",5,71,266,146,120
050,19,011,"Iowa","Benton County",5,72,253,133,120
050,19,011,"Iowa","Benton County",5,73,226,107,119
050,19,011,"Iowa","Benton County",5,74,226,104,122
050,19,011,"Iowa","Benton County",5,75,204,95,109
050,19,011,"Iowa","Benton County",5,76,223,111,112
050,19,011,"Iowa","Benton County",5,77,167,77,90
050,19,011,"Iowa","Benton County",5,78,168,77,91
050,19,011,"Iowa","Benton County",5,79,175,74,101
050,19,011,"Iowa","Benton County",5,80,156,71,85
050,19,011,"Iowa","Benton County",5,81,154,71,83
050,19,011,"Iowa","Benton County",5,82,124,60,64
050,19,011,"Iowa","Benton County",5,83,119,61,58
050,19,011,"Iowa","Benton County",5,84,97,46,51
050,19,011,"Iowa","Benton County",5,85,715,265,450
050,19,013,"Iowa","Black Hawk County",1,0,1589,819,770
050,19,013,"Iowa","Black Hawk County",1,1,1601,839,762
050,19,013,"Iowa","Black Hawk County",1,2,1652,840,812
050,19,013,"Iowa","Black Hawk County",1,3,1588,815,773
050,19,013,"Iowa","Black Hawk County",1,4,1642,848,794
050,19,013,"Iowa","Black Hawk County",1,5,1657,851,806
050,19,013,"Iowa","Black Hawk County",1,6,1589,789,800
050,19,013,"Iowa","Black Hawk County",1,7,1609,829,780
050,19,013,"Iowa","Black Hawk County",1,8,1569,808,761
050,19,013,"Iowa","Black Hawk County",1,9,1549,773,776
050,19,013,"Iowa","Black Hawk County",1,10,1611,834,777
050,19,013,"Iowa","Black Hawk County",1,11,1621,827,794
050,19,013,"Iowa","Black Hawk County",1,12,1671,837,834
050,19,013,"Iowa","Black Hawk County",1,13,1644,852,792
050,19,013,"Iowa","Black Hawk County",1,14,1593,829,764
050,19,013,"Iowa","Black Hawk County",1,15,1551,794,757
050,19,013,"Iowa","Black Hawk County",1,16,1572,799,773
050,19,013,"Iowa","Black Hawk County",1,17,1517,754,763
050,19,013,"Iowa","Black Hawk County",1,18,1775,809,966
050,19,013,"Iowa","Black Hawk County",1,19,2553,1119,1434
050,19,013,"Iowa","Black Hawk County",1,20,3026,1356,1670
050,19,013,"Iowa","Black Hawk County",1,21,3425,1553,1872
050,19,013,"Iowa","Black Hawk County",1,22,3359,1693,1666
050,19,013,"Iowa","Black Hawk County",1,23,2522,1320,1202
050,19,013,"Iowa","Black Hawk County",1,24,2045,1089,956
050,19,013,"Iowa","Black Hawk County",1,25,1854,952,902
050,19,013,"Iowa","Black Hawk County",1,26,1888,988,900
050,19,013,"Iowa","Black Hawk County",1,27,1856,977,879
050,19,013,"Iowa","Black Hawk County",1,28,1736,893,843
050,19,013,"Iowa","Black Hawk County",1,29,1742,920,822
050,19,013,"Iowa","Black Hawk County",1,30,1610,823,787
050,19,013,"Iowa","Black Hawk County",1,31,1589,827,762
050,19,013,"Iowa","Black Hawk County",1,32,1541,792,749
050,19,013,"Iowa","Black Hawk County",1,33,1543,798,745
050,19,013,"Iowa","Black Hawk County",1,34,1621,863,758
050,19,013,"Iowa","Black Hawk County",1,35,1611,837,774
050,19,013,"Iowa","Black Hawk County",1,36,1600,805,795
050,19,013,"Iowa","Black Hawk County",1,37,1686,830,856
050,19,013,"Iowa","Black Hawk County",1,38,1644,836,808
050,19,013,"Iowa","Black Hawk County",1,39,1540,807,733
050,19,013,"Iowa","Black Hawk County",1,40,1560,792,768
050,19,013,"Iowa","Black Hawk County",1,41,1533,762,771
050,19,013,"Iowa","Black Hawk County",1,42,1495,775,720
050,19,013,"Iowa","Black Hawk County",1,43,1410,736,674
050,19,013,"Iowa","Black Hawk County",1,44,1344,693,651
050,19,013,"Iowa","Black Hawk County",1,45,1311,661,650
050,19,013,"Iowa","Black Hawk County",1,46,1290,646,644
050,19,013,"Iowa","Black Hawk County",1,47,1238,615,623
050,19,013,"Iowa","Black Hawk County",1,48,1305,672,633
050,19,013,"Iowa","Black Hawk County",1,49,1376,693,683
050,19,013,"Iowa","Black Hawk County",1,50,1450,742,708
050,19,013,"Iowa","Black Hawk County",1,51,1369,700,669
050,19,013,"Iowa","Black Hawk County",1,52,1336,679,657
050,19,013,"Iowa","Black Hawk County",1,53,1351,690,661
050,19,013,"Iowa","Black Hawk County",1,54,1397,687,710
050,19,013,"Iowa","Black Hawk County",1,55,1469,740,729
050,19,013,"Iowa","Black Hawk County",1,56,1474,729,745
050,19,013,"Iowa","Black Hawk County",1,57,1529,739,790
050,19,013,"Iowa","Black Hawk County",1,58,1553,772,781
050,19,013,"Iowa","Black Hawk County",1,59,1537,776,761
050,19,013,"Iowa","Black Hawk County",1,60,1580,752,828
050,19,013,"Iowa","Black Hawk County",1,61,1602,776,826
050,19,013,"Iowa","Black Hawk County",1,62,1631,781,850
050,19,013,"Iowa","Black Hawk County",1,63,1597,748,849
050,19,013,"Iowa","Black Hawk County",1,64,1609,768,841
050,19,013,"Iowa","Black Hawk County",1,65,1619,805,814
050,19,013,"Iowa","Black Hawk County",1,66,1574,788,786
050,19,013,"Iowa","Black Hawk County",1,67,1517,747,770
050,19,013,"Iowa","Black Hawk County",1,68,1475,719,756
050,19,013,"Iowa","Black Hawk County",1,69,1342,622,720
050,19,013,"Iowa","Black Hawk County",1,70,1292,618,674
050,19,013,"Iowa","Black Hawk County",1,71,1213,591,622
050,19,013,"Iowa","Black Hawk County",1,72,1203,567,636
050,19,013,"Iowa","Black Hawk County",1,73,1191,564,627
050,19,013,"Iowa","Black Hawk County",1,74,817,372,445
050,19,013,"Iowa","Black Hawk County",1,75,779,371,408
050,19,013,"Iowa","Black Hawk County",1,76,761,364,397
050,19,013,"Iowa","Black Hawk County",1,77,774,367,407
050,19,013,"Iowa","Black Hawk County",1,78,700,331,369
050,19,013,"Iowa","Black Hawk County",1,79,618,281,337
050,19,013,"Iowa","Black Hawk County",1,80,575,257,318
050,19,013,"Iowa","Black Hawk County",1,81,555,230,325
050,19,013,"Iowa","Black Hawk County",1,82,518,208,310
050,19,013,"Iowa","Black Hawk County",1,83,468,171,297
050,19,013,"Iowa","Black Hawk County",1,84,440,180,260
050,19,013,"Iowa","Black Hawk County",1,85,2775,915,1860
050,19,013,"Iowa","Black Hawk County",2,0,1607,832,775
050,19,013,"Iowa","Black Hawk County",2,1,1594,828,766
050,19,013,"Iowa","Black Hawk County",2,2,1638,837,801
050,19,013,"Iowa","Black Hawk County",2,3,1593,817,776
050,19,013,"Iowa","Black Hawk County",2,4,1627,838,789
050,19,013,"Iowa","Black Hawk County",2,5,1647,843,804
050,19,013,"Iowa","Black Hawk County",2,6,1602,800,802
050,19,013,"Iowa","Black Hawk County",2,7,1597,815,782
050,19,013,"Iowa","Black Hawk County",2,8,1571,808,763
050,19,013,"Iowa","Black Hawk County",2,9,1552,784,768
050,19,013,"Iowa","Black Hawk County",2,10,1588,813,775
050,19,013,"Iowa","Black Hawk County",2,11,1615,825,790
050,19,013,"Iowa","Black Hawk County",2,12,1664,837,827
050,19,013,"Iowa","Black Hawk County",2,13,1649,848,801
050,19,013,"Iowa","Black Hawk County",2,14,1603,832,771
050,19,013,"Iowa","Black Hawk County",2,15,1564,805,759
050,19,013,"Iowa","Black Hawk County",2,16,1567,797,770
050,19,013,"Iowa","Black Hawk County",2,17,1533,766,767
050,19,013,"Iowa","Black Hawk County",2,18,1780,813,967
050,19,013,"Iowa","Black Hawk County",2,19,2578,1131,1447
050,19,013,"Iowa","Black Hawk County",2,20,3040,1360,1680
050,19,013,"Iowa","Black Hawk County",2,21,3428,1558,1870
050,19,013,"Iowa","Black Hawk County",2,22,3336,1685,1651
050,19,013,"Iowa","Black Hawk County",2,23,2518,1319,1199
050,19,013,"Iowa","Black Hawk County",2,24,2034,1074,960
050,19,013,"Iowa","Black Hawk County",2,25,1840,949,891
050,19,013,"Iowa","Black Hawk County",2,26,1857,964,893
050,19,013,"Iowa","Black Hawk County",2,27,1832,962,870
050,19,013,"Iowa","Black Hawk County",2,28,1759,911,848
050,19,013,"Iowa","Black Hawk County",2,29,1732,908,824
050,19,013,"Iowa","Black Hawk County",2,30,1641,845,796
050,19,013,"Iowa","Black Hawk County",2,31,1583,815,768
050,19,013,"Iowa","Black Hawk County",2,32,1542,793,749
050,19,013,"Iowa","Black Hawk County",2,33,1539,794,745
050,19,013,"Iowa","Black Hawk County",2,34,1597,844,753
050,19,013,"Iowa","Black Hawk County",2,35,1616,847,769
050,19,013,"Iowa","Black Hawk County",2,36,1588,806,782
050,19,013,"Iowa","Black Hawk County",2,37,1665,819,846
050,19,013,"Iowa","Black Hawk County",2,38,1656,837,819
050,19,013,"Iowa","Black Hawk County",2,39,1560,812,748
050,19,013,"Iowa","Black Hawk County",2,40,1565,803,762
050,19,013,"Iowa","Black Hawk County",2,41,1535,767,768
050,19,013,"Iowa","Black Hawk County",2,42,1492,768,724
050,19,013,"Iowa","Black Hawk County",2,43,1433,743,690
050,19,013,"Iowa","Black Hawk County",2,44,1335,690,645
050,19,013,"Iowa","Black Hawk County",2,45,1322,672,650
050,19,013,"Iowa","Black Hawk County",2,46,1286,645,641
050,19,013,"Iowa","Black Hawk County",2,47,1247,624,623
050,19,013,"Iowa","Black Hawk County",2,48,1286,658,628
050,19,013,"Iowa","Black Hawk County",2,49,1359,688,671
050,19,013,"Iowa","Black Hawk County",2,50,1432,728,704
050,19,013,"Iowa","Black Hawk County",2,51,1379,706,673
050,19,013,"Iowa","Black Hawk County",2,52,1336,681,655
050,19,013,"Iowa","Black Hawk County",2,53,1351,688,663
050,19,013,"Iowa","Black Hawk County",2,54,1377,682,695
050,19,013,"Iowa","Black Hawk County",2,55,1449,725,724
050,19,013,"Iowa","Black Hawk County",2,56,1470,731,739
050,19,013,"Iowa","Black Hawk County",2,57,1515,733,782
050,19,013,"Iowa","Black Hawk County",2,58,1543,762,781
050,19,013,"Iowa","Black Hawk County",2,59,1544,780,764
050,19,013,"Iowa","Black Hawk County",2,60,1560,752,808
050,19,013,"Iowa","Black Hawk County",2,61,1586,762,824
050,19,013,"Iowa","Black Hawk County",2,62,1617,780,837
050,19,013,"Iowa","Black Hawk County",2,63,1607,755,852
050,19,013,"Iowa","Black Hawk County",2,64,1600,760,840
050,19,013,"Iowa","Black Hawk County",2,65,1607,786,821
050,19,013,"Iowa","Black Hawk County",2,66,1577,791,786
050,19,013,"Iowa","Black Hawk County",2,67,1514,748,766
050,19,013,"Iowa","Black Hawk County",2,68,1468,716,752
050,19,013,"Iowa","Black Hawk County",2,69,1383,650,733
050,19,013,"Iowa","Black Hawk County",2,70,1287,612,675
050,19,013,"Iowa","Black Hawk County",2,71,1232,598,634
050,19,013,"Iowa","Black Hawk County",2,72,1180,560,620
050,19,013,"Iowa","Black Hawk County",2,73,1237,584,653
050,19,013,"Iowa","Black Hawk County",2,74,844,391,453
050,19,013,"Iowa","Black Hawk County",2,75,781,365,416
050,19,013,"Iowa","Black Hawk County",2,76,748,356,392
050,19,013,"Iowa","Black Hawk County",2,77,783,370,413
050,19,013,"Iowa","Black Hawk County",2,78,699,330,369
050,19,013,"Iowa","Black Hawk County",2,79,630,291,339
050,19,013,"Iowa","Black Hawk County",2,80,581,259,322
050,19,013,"Iowa","Black Hawk County",2,81,549,232,317
050,19,013,"Iowa","Black Hawk County",2,82,516,206,310
050,19,013,"Iowa","Black Hawk County",2,83,475,176,299
050,19,013,"Iowa","Black Hawk County",2,84,433,171,262
050,19,013,"Iowa","Black Hawk County",2,85,2762,911,1851
050,19,013,"Iowa","Black Hawk County",3,0,1601,796,805
050,19,013,"Iowa","Black Hawk County",3,1,1589,806,783
050,19,013,"Iowa","Black Hawk County",3,2,1579,824,755
050,19,013,"Iowa","Black Hawk County",3,3,1617,824,793
050,19,013,"Iowa","Black Hawk County",3,4,1582,813,769
050,19,013,"Iowa","Black Hawk County",3,5,1630,848,782
050,19,013,"Iowa","Black Hawk County",3,6,1637,835,802
050,19,013,"Iowa","Black Hawk County",3,7,1612,801,811
050,19,013,"Iowa","Black Hawk County",3,8,1571,809,762
050,19,013,"Iowa","Black Hawk County",3,9,1540,796,744
050,19,013,"Iowa","Black Hawk County",3,10,1528,778,750
050,19,013,"Iowa","Black Hawk County",3,11,1571,821,750
050,19,013,"Iowa","Black Hawk County",3,12,1625,835,790
050,19,013,"Iowa","Black Hawk County",3,13,1638,800,838
050,19,013,"Iowa","Black Hawk County",3,14,1612,831,781
050,19,013,"Iowa","Black Hawk County",3,15,1587,813,774
050,19,013,"Iowa","Black Hawk County",3,16,1573,812,761
050,19,013,"Iowa","Black Hawk County",3,17,1559,790,769
050,19,013,"Iowa","Black Hawk County",3,18,1796,835,961
050,19,013,"Iowa","Black Hawk County",3,19,2634,1151,1483
050,19,013,"Iowa","Black Hawk County",3,20,3005,1322,1683
050,19,013,"Iowa","Black Hawk County",3,21,3498,1588,1910
050,19,013,"Iowa","Black Hawk County",3,22,3309,1663,1646
050,19,013,"Iowa","Black Hawk County",3,23,2556,1335,1221
050,19,013,"Iowa","Black Hawk County",3,24,2076,1074,1002
050,19,013,"Iowa","Black Hawk County",3,25,1815,935,880
050,19,013,"Iowa","Black Hawk County",3,26,1726,903,823
050,19,013,"Iowa","Black Hawk County",3,27,1742,886,856
050,19,013,"Iowa","Black Hawk County",3,28,1789,922,867
050,19,013,"Iowa","Black Hawk County",3,29,1706,871,835
050,19,013,"Iowa","Black Hawk County",3,30,1663,882,781
050,19,013,"Iowa","Black Hawk County",3,31,1626,827,799
050,19,013,"Iowa","Black Hawk County",3,32,1561,826,735
050,19,013,"Iowa","Black Hawk County",3,33,1523,784,739
050,19,013,"Iowa","Black Hawk County",3,34,1533,780,753
050,19,013,"Iowa","Black Hawk County",3,35,1576,827,749
050,19,013,"Iowa","Black Hawk County",3,36,1574,817,757
050,19,013,"Iowa","Black Hawk County",3,37,1526,766,760
050,19,013,"Iowa","Black Hawk County",3,38,1648,826,822
050,19,013,"Iowa","Black Hawk County",3,39,1619,813,806
050,19,013,"Iowa","Black Hawk County",3,40,1541,802,739
050,19,013,"Iowa","Black Hawk County",3,41,1534,774,760
050,19,013,"Iowa","Black Hawk County",3,42,1510,753,757
050,19,013,"Iowa","Black Hawk County",3,43,1479,752,727
050,19,013,"Iowa","Black Hawk County",3,44,1405,736,669
050,19,013,"Iowa","Black Hawk County",3,45,1328,691,637
050,19,013,"Iowa","Black Hawk County",3,46,1330,668,662
050,19,013,"Iowa","Black Hawk County",3,47,1274,641,633
050,19,013,"Iowa","Black Hawk County",3,48,1253,631,622
050,19,013,"Iowa","Black Hawk County",3,49,1261,652,609
050,19,013,"Iowa","Black Hawk County",3,50,1345,671,674
050,19,013,"Iowa","Black Hawk County",3,51,1412,716,696
050,19,013,"Iowa","Black Hawk County",3,52,1375,699,676
050,19,013,"Iowa","Black Hawk County",3,53,1326,685,641
050,19,013,"Iowa","Black Hawk County",3,54,1329,676,653
050,19,013,"Iowa","Black Hawk County",3,55,1355,670,685
050,19,013,"Iowa","Black Hawk County",3,56,1409,707,702
050,19,013,"Iowa","Black Hawk County",3,57,1437,712,725
050,19,013,"Iowa","Black Hawk County",3,58,1500,719,781
050,19,013,"Iowa","Black Hawk County",3,59,1516,747,769
050,19,013,"Iowa","Black Hawk County",3,60,1539,769,770
050,19,013,"Iowa","Black Hawk County",3,61,1538,742,796
050,19,013,"Iowa","Black Hawk County",3,62,1569,753,816
050,19,013,"Iowa","Black Hawk County",3,63,1566,750,816
050,19,013,"Iowa","Black Hawk County",3,64,1586,739,847
050,19,013,"Iowa","Black Hawk County",3,65,1575,731,844
050,19,013,"Iowa","Black Hawk County",3,66,1566,767,799
050,19,013,"Iowa","Black Hawk County",3,67,1527,750,777
050,19,013,"Iowa","Black Hawk County",3,68,1484,729,755
050,19,013,"Iowa","Black Hawk County",3,69,1443,699,744
050,19,013,"Iowa","Black Hawk County",3,70,1336,620,716
050,19,013,"Iowa","Black Hawk County",3,71,1257,594,663
050,19,013,"Iowa","Black Hawk County",3,72,1193,577,616
050,19,013,"Iowa","Black Hawk County",3,73,1147,548,599
050,19,013,"Iowa","Black Hawk County",3,74,1201,561,640
050,19,013,"Iowa","Black Hawk County",3,75,801,363,438
050,19,013,"Iowa","Black Hawk County",3,76,747,343,404
050,19,013,"Iowa","Black Hawk County",3,77,709,334,375
050,19,013,"Iowa","Black Hawk County",3,78,750,357,393
050,19,013,"Iowa","Black Hawk County",3,79,653,299,354
050,19,013,"Iowa","Black Hawk County",3,80,594,272,322
050,19,013,"Iowa","Black Hawk County",3,81,559,244,315
050,19,013,"Iowa","Black Hawk County",3,82,521,219,302
050,19,013,"Iowa","Black Hawk County",3,83,480,185,295
050,19,013,"Iowa","Black Hawk County",3,84,442,166,276
050,19,013,"Iowa","Black Hawk County",3,85,2722,897,1825
050,19,013,"Iowa","Black Hawk County",4,0,1644,811,833
050,19,013,"Iowa","Black Hawk County",4,1,1561,787,774
050,19,013,"Iowa","Black Hawk County",4,2,1590,807,783
050,19,013,"Iowa","Black Hawk County",4,3,1559,810,749
050,19,013,"Iowa","Black Hawk County",4,4,1601,821,780
050,19,013,"Iowa","Black Hawk County",4,5,1572,800,772
050,19,013,"Iowa","Black Hawk County",4,6,1597,824,773
050,19,013,"Iowa","Black Hawk County",4,7,1621,846,775
050,19,013,"Iowa","Black Hawk County",4,8,1565,779,786
050,19,013,"Iowa","Black Hawk County",4,9,1561,799,762
050,19,013,"Iowa","Black Hawk County",4,10,1523,788,735
050,19,013,"Iowa","Black Hawk County",4,11,1512,773,739
050,19,013,"Iowa","Black Hawk County",4,12,1584,827,757
050,19,013,"Iowa","Black Hawk County",4,13,1626,828,798
050,19,013,"Iowa","Black Hawk County",4,14,1621,804,817
050,19,013,"Iowa","Black Hawk County",4,15,1617,836,781
050,19,013,"Iowa","Black Hawk County",4,16,1573,806,767
050,19,013,"Iowa","Black Hawk County",4,17,1583,815,768
050,19,013,"Iowa","Black Hawk County",4,18,1830,871,959
050,19,013,"Iowa","Black Hawk County",4,19,2602,1150,1452
050,19,013,"Iowa","Black Hawk County",4,20,2981,1304,1677
050,19,013,"Iowa","Black Hawk County",4,21,3439,1555,1884
050,19,013,"Iowa","Black Hawk County",4,22,3376,1715,1661
050,19,013,"Iowa","Black Hawk County",4,23,2552,1309,1243
050,19,013,"Iowa","Black Hawk County",4,24,2040,1043,997
050,19,013,"Iowa","Black Hawk County",4,25,1847,933,914
050,19,013,"Iowa","Black Hawk County",4,26,1647,853,794
050,19,013,"Iowa","Black Hawk County",4,27,1600,831,769
050,19,013,"Iowa","Black Hawk County",4,28,1701,850,851
050,19,013,"Iowa","Black Hawk County",4,29,1764,915,849
050,19,013,"Iowa","Black Hawk County",4,30,1672,856,816
050,19,013,"Iowa","Black Hawk County",4,31,1652,856,796
050,19,013,"Iowa","Black Hawk County",4,32,1603,840,763
050,19,013,"Iowa","Black Hawk County",4,33,1556,820,736
050,19,013,"Iowa","Black Hawk County",4,34,1484,760,724
050,19,013,"Iowa","Black Hawk County",4,35,1492,769,723
050,19,013,"Iowa","Black Hawk County",4,36,1523,802,721
050,19,013,"Iowa","Black Hawk County",4,37,1558,802,756
050,19,013,"Iowa","Black Hawk County",4,38,1538,773,765
050,19,013,"Iowa","Black Hawk County",4,39,1653,829,824
050,19,013,"Iowa","Black Hawk County",4,40,1610,822,788
050,19,013,"Iowa","Black Hawk County",4,41,1525,788,737
050,19,013,"Iowa","Black Hawk County",4,42,1517,760,757
050,19,013,"Iowa","Black Hawk County",4,43,1512,750,762
050,19,013,"Iowa","Black Hawk County",4,44,1464,750,714
050,19,013,"Iowa","Black Hawk County",4,45,1387,721,666
050,19,013,"Iowa","Black Hawk County",4,46,1314,682,632
050,19,013,"Iowa","Black Hawk County",4,47,1309,665,644
050,19,013,"Iowa","Black Hawk County",4,48,1255,627,628
050,19,013,"Iowa","Black Hawk County",4,49,1229,618,611
050,19,013,"Iowa","Black Hawk County",4,50,1293,664,629
050,19,013,"Iowa","Black Hawk County",4,51,1333,670,663
050,19,013,"Iowa","Black Hawk County",4,52,1403,709,694
050,19,013,"Iowa","Black Hawk County",4,53,1330,674,656
050,19,013,"Iowa","Black Hawk County",4,54,1314,663,651
050,19,013,"Iowa","Black Hawk County",4,55,1335,678,657
050,19,013,"Iowa","Black Hawk County",4,56,1321,661,660
050,19,013,"Iowa","Black Hawk County",4,57,1399,697,702
050,19,013,"Iowa","Black Hawk County",4,58,1435,709,726
050,19,013,"Iowa","Black Hawk County",4,59,1481,722,759
050,19,013,"Iowa","Black Hawk County",4,60,1508,738,770
050,19,013,"Iowa","Black Hawk County",4,61,1507,748,759
050,19,013,"Iowa","Black Hawk County",4,62,1512,717,795
050,19,013,"Iowa","Black Hawk County",4,63,1511,717,794
050,19,013,"Iowa","Black Hawk County",4,64,1535,741,794
050,19,013,"Iowa","Black Hawk County",4,65,1559,716,843
050,19,013,"Iowa","Black Hawk County",4,66,1539,709,830
050,19,013,"Iowa","Black Hawk County",4,67,1518,736,782
050,19,013,"Iowa","Black Hawk County",4,68,1500,731,769
050,19,013,"Iowa","Black Hawk County",4,69,1457,704,753
050,19,013,"Iowa","Black Hawk County",4,70,1399,670,729
050,19,013,"Iowa","Black Hawk County",4,71,1299,597,702
050,19,013,"Iowa","Black Hawk County",4,72,1219,574,645
050,19,013,"Iowa","Black Hawk County",4,73,1155,564,591
050,19,013,"Iowa","Black Hawk County",4,74,1118,532,586
050,19,013,"Iowa","Black Hawk County",4,75,1154,529,625
050,19,013,"Iowa","Black Hawk County",4,76,789,352,437
050,19,013,"Iowa","Black Hawk County",4,77,715,323,392
050,19,013,"Iowa","Black Hawk County",4,78,685,319,366
050,19,013,"Iowa","Black Hawk County",4,79,700,327,373
050,19,013,"Iowa","Black Hawk County",4,80,605,274,331
050,19,013,"Iowa","Black Hawk County",4,81,562,261,301
050,19,013,"Iowa","Black Hawk County",4,82,530,231,299
050,19,013,"Iowa","Black Hawk County",4,83,476,194,282
050,19,013,"Iowa","Black Hawk County",4,84,424,161,263
050,19,013,"Iowa","Black Hawk County",4,85,2690,879,1811
050,19,013,"Iowa","Black Hawk County",5,0,1650,821,829
050,19,013,"Iowa","Black Hawk County",5,1,1565,783,782
050,19,013,"Iowa","Black Hawk County",5,2,1540,793,747
050,19,013,"Iowa","Black Hawk County",5,3,1608,816,792
050,19,013,"Iowa","Black Hawk County",5,4,1554,805,749
050,19,013,"Iowa","Black Hawk County",5,5,1622,849,773
050,19,013,"Iowa","Black Hawk County",5,6,1544,799,745
050,19,013,"Iowa","Black Hawk County",5,7,1590,813,777
050,19,013,"Iowa","Black Hawk County",5,8,1600,826,774
050,19,013,"Iowa","Black Hawk County",5,9,1575,775,800
050,19,013,"Iowa","Black Hawk County",5,10,1550,805,745
050,19,013,"Iowa","Black Hawk County",5,11,1533,797,736
050,19,013,"Iowa","Black Hawk County",5,12,1515,774,741
050,19,013,"Iowa","Black Hawk County",5,13,1574,807,767
050,19,013,"Iowa","Black Hawk County",5,14,1638,829,809
050,19,013,"Iowa","Black Hawk County",5,15,1620,811,809
050,19,013,"Iowa","Black Hawk County",5,16,1638,842,796
050,19,013,"Iowa","Black Hawk County",5,17,1606,821,785
050,19,013,"Iowa","Black Hawk County",5,18,1840,883,957
050,19,013,"Iowa","Black Hawk County",5,19,2598,1172,1426
050,19,013,"Iowa","Black Hawk County",5,20,3042,1352,1690
050,19,013,"Iowa","Black Hawk County",5,21,3407,1539,1868
050,19,013,"Iowa","Black Hawk County",5,22,3358,1685,1673
050,19,013,"Iowa","Black Hawk County",5,23,2598,1360,1238
050,19,013,"Iowa","Black Hawk County",5,24,2101,1108,993
050,19,013,"Iowa","Black Hawk County",5,25,1848,916,932
050,19,013,"Iowa","Black Hawk County",5,26,1753,889,864
050,19,013,"Iowa","Black Hawk County",5,27,1559,808,751
050,19,013,"Iowa","Black Hawk County",5,28,1564,808,756
050,19,013,"Iowa","Black Hawk County",5,29,1695,847,848
050,19,013,"Iowa","Black Hawk County",5,30,1730,892,838
050,19,013,"Iowa","Black Hawk County",5,31,1680,846,834
050,19,013,"Iowa","Black Hawk County",5,32,1629,855,774
050,19,013,"Iowa","Black Hawk County",5,33,1599,856,743
050,19,013,"Iowa","Black Hawk County",5,34,1565,816,749
050,19,013,"Iowa","Black Hawk County",5,35,1469,755,714
050,19,013,"Iowa","Black Hawk County",5,36,1483,758,725
050,19,013,"Iowa","Black Hawk County",5,37,1517,785,732
050,19,013,"Iowa","Black Hawk County",5,38,1563,817,746
050,19,013,"Iowa","Black Hawk County",5,39,1507,744,763
050,19,013,"Iowa","Black Hawk County",5,40,1634,820,814
050,19,013,"Iowa","Black Hawk County",5,41,1609,813,796
050,19,013,"Iowa","Black Hawk County",5,42,1519,793,726
050,19,013,"Iowa","Black Hawk County",5,43,1525,753,772
050,19,013,"Iowa","Black Hawk County",5,44,1483,759,724
050,19,013,"Iowa","Black Hawk County",5,45,1459,751,708
050,19,013,"Iowa","Black Hawk County",5,46,1394,715,679
050,19,013,"Iowa","Black Hawk County",5,47,1306,680,626
050,19,013,"Iowa","Black Hawk County",5,48,1309,666,643
050,19,013,"Iowa","Black Hawk County",5,49,1228,621,607
050,19,013,"Iowa","Black Hawk County",5,50,1257,642,615
050,19,013,"Iowa","Black Hawk County",5,51,1289,661,628
050,19,013,"Iowa","Black Hawk County",5,52,1324,662,662
050,19,013,"Iowa","Black Hawk County",5,53,1372,693,679
050,19,013,"Iowa","Black Hawk County",5,54,1337,672,665
050,19,013,"Iowa","Black Hawk County",5,55,1321,665,656
050,19,013,"Iowa","Black Hawk County",5,56,1318,661,657
050,19,013,"Iowa","Black Hawk County",5,57,1336,673,663
050,19,013,"Iowa","Black Hawk County",5,58,1408,695,713
050,19,013,"Iowa","Black Hawk County",5,59,1424,696,728
050,19,013,"Iowa","Black Hawk County",5,60,1474,717,757
050,19,013,"Iowa","Black Hawk County",5,61,1474,716,758
050,19,013,"Iowa","Black Hawk County",5,62,1504,747,757
050,19,013,"Iowa","Black Hawk County",5,63,1484,700,784
050,19,013,"Iowa","Black Hawk County",5,64,1507,712,795
050,19,013,"Iowa","Black Hawk County",5,65,1513,724,789
050,19,013,"Iowa","Black Hawk County",5,66,1518,705,813
050,19,013,"Iowa","Black Hawk County",5,67,1498,683,815
050,19,013,"Iowa","Black Hawk County",5,68,1499,723,776
050,19,013,"Iowa","Black Hawk County",5,69,1462,700,762
050,19,013,"Iowa","Black Hawk County",5,70,1408,687,721
050,19,013,"Iowa","Black Hawk County",5,71,1374,651,723
050,19,013,"Iowa","Black Hawk County",5,72,1261,570,691
050,19,013,"Iowa","Black Hawk County",5,73,1190,560,630
050,19,013,"Iowa","Black Hawk County",5,74,1128,549,579
050,19,013,"Iowa","Black Hawk County",5,75,1083,508,575
050,19,013,"Iowa","Black Hawk County",5,76,1126,514,612
050,19,013,"Iowa","Black Hawk County",5,77,759,332,427
050,19,013,"Iowa","Black Hawk County",5,78,699,311,388
050,19,013,"Iowa","Black Hawk County",5,79,647,295,352
050,19,013,"Iowa","Black Hawk County",5,80,665,314,351
050,19,013,"Iowa","Black Hawk County",5,81,586,269,317
050,19,013,"Iowa","Black Hawk County",5,82,542,251,291
050,19,013,"Iowa","Black Hawk County",5,83,494,212,282
050,19,013,"Iowa","Black Hawk County",5,84,429,172,257
050,19,013,"Iowa","Black Hawk County",5,85,2668,859,1809
050,19,015,"Iowa","Boone County",1,0,261,132,129
050,19,015,"Iowa","Boone County",1,1,287,144,143
050,19,015,"Iowa","Boone County",1,2,295,161,134
050,19,015,"Iowa","Boone County",1,3,270,139,131
050,19,015,"Iowa","Boone County",1,4,289,129,160
050,19,015,"Iowa","Boone County",1,5,285,146,139
050,19,015,"Iowa","Boone County",1,6,296,163,133
050,19,015,"Iowa","Boone County",1,7,314,170,144
050,19,015,"Iowa","Boone County",1,8,293,143,150
050,19,015,"Iowa","Boone County",1,9,297,135,162
050,19,015,"Iowa","Boone County",1,10,293,151,142
050,19,015,"Iowa","Boone County",1,11,324,175,149
050,19,015,"Iowa","Boone County",1,12,352,200,152
050,19,015,"Iowa","Boone County",1,13,365,194,171
050,19,015,"Iowa","Boone County",1,14,354,190,164
050,19,015,"Iowa","Boone County",1,15,337,199,138
050,19,015,"Iowa","Boone County",1,16,374,234,140
050,19,015,"Iowa","Boone County",1,17,364,219,145
050,19,015,"Iowa","Boone County",1,18,275,152,123
050,19,015,"Iowa","Boone County",1,19,215,116,99
050,19,015,"Iowa","Boone County",1,20,256,143,113
050,19,015,"Iowa","Boone County",1,21,256,137,119
050,19,015,"Iowa","Boone County",1,22,284,149,135
050,19,015,"Iowa","Boone County",1,23,305,154,151
050,19,015,"Iowa","Boone County",1,24,296,145,151
050,19,015,"Iowa","Boone County",1,25,313,169,144
050,19,015,"Iowa","Boone County",1,26,310,165,145
050,19,015,"Iowa","Boone County",1,27,318,173,145
050,19,015,"Iowa","Boone County",1,28,313,151,162
050,19,015,"Iowa","Boone County",1,29,343,164,179
050,19,015,"Iowa","Boone County",1,30,332,171,161
050,19,015,"Iowa","Boone County",1,31,311,153,158
050,19,015,"Iowa","Boone County",1,32,318,169,149
050,19,015,"Iowa","Boone County",1,33,328,165,163
050,19,015,"Iowa","Boone County",1,34,344,175,169
050,19,015,"Iowa","Boone County",1,35,354,182,172
050,19,015,"Iowa","Boone County",1,36,367,190,177
050,19,015,"Iowa","Boone County",1,37,371,199,172
050,19,015,"Iowa","Boone County",1,38,360,200,160
050,19,015,"Iowa","Boone County",1,39,353,185,168
050,19,015,"Iowa","Boone County",1,40,367,185,182
050,19,015,"Iowa","Boone County",1,41,347,180,167
050,19,015,"Iowa","Boone County",1,42,362,185,177
050,19,015,"Iowa","Boone County",1,43,309,160,149
050,19,015,"Iowa","Boone County",1,44,308,152,156
050,19,015,"Iowa","Boone County",1,45,331,170,161
050,19,015,"Iowa","Boone County",1,46,298,145,153
050,19,015,"Iowa","Boone County",1,47,320,172,148
050,19,015,"Iowa","Boone County",1,48,336,189,147
050,19,015,"Iowa","Boone County",1,49,340,185,155
050,19,015,"Iowa","Boone County",1,50,321,162,159
050,19,015,"Iowa","Boone County",1,51,323,169,154
050,19,015,"Iowa","Boone County",1,52,339,181,158
050,19,015,"Iowa","Boone County",1,53,327,171,156
050,19,015,"Iowa","Boone County",1,54,337,172,165
050,19,015,"Iowa","Boone County",1,55,378,196,182
050,19,015,"Iowa","Boone County",1,56,382,188,194
050,19,015,"Iowa","Boone County",1,57,385,188,197
050,19,015,"Iowa","Boone County",1,58,423,201,222
050,19,015,"Iowa","Boone County",1,59,409,202,207
050,19,015,"Iowa","Boone County",1,60,434,219,215
050,19,015,"Iowa","Boone County",1,61,440,228,212
050,19,015,"Iowa","Boone County",1,62,440,223,217
050,19,015,"Iowa","Boone County",1,63,400,199,201
050,19,015,"Iowa","Boone County",1,64,382,190,192
050,19,015,"Iowa","Boone County",1,65,391,189,202
050,19,015,"Iowa","Boone County",1,66,392,192,200
050,19,015,"Iowa","Boone County",1,67,370,186,184
050,19,015,"Iowa","Boone County",1,68,362,195,167
050,19,015,"Iowa","Boone County",1,69,303,155,148
050,19,015,"Iowa","Boone County",1,70,290,149,141
050,19,015,"Iowa","Boone County",1,71,266,134,132
050,19,015,"Iowa","Boone County",1,72,267,126,141
050,19,015,"Iowa","Boone County",1,73,267,132,135
050,19,015,"Iowa","Boone County",1,74,187,87,100
050,19,015,"Iowa","Boone County",1,75,173,84,89
050,19,015,"Iowa","Boone County",1,76,185,86,99
050,19,015,"Iowa","Boone County",1,77,184,83,101
050,19,015,"Iowa","Boone County",1,78,140,61,79
050,19,015,"Iowa","Boone County",1,79,127,62,65
050,19,015,"Iowa","Boone County",1,80,127,50,77
050,19,015,"Iowa","Boone County",1,81,123,53,70
050,19,015,"Iowa","Boone County",1,82,120,53,67
050,19,015,"Iowa","Boone County",1,83,96,36,60
050,19,015,"Iowa","Boone County",1,84,101,44,57
050,19,015,"Iowa","Boone County",1,85,628,198,430
050,19,015,"Iowa","Boone County",2,0,258,130,128
050,19,015,"Iowa","Boone County",2,1,280,141,139
050,19,015,"Iowa","Boone County",2,2,293,157,136
050,19,015,"Iowa","Boone County",2,3,277,143,134
050,19,015,"Iowa","Boone County",2,4,282,132,150
050,19,015,"Iowa","Boone County",2,5,286,143,143
050,19,015,"Iowa","Boone County",2,6,294,159,135
050,19,015,"Iowa","Boone County",2,7,309,167,142
050,19,015,"Iowa","Boone County",2,8,299,149,150
050,19,015,"Iowa","Boone County",2,9,297,138,159
050,19,015,"Iowa","Boone County",2,10,296,148,148
050,19,015,"Iowa","Boone County",2,11,313,167,146
050,19,015,"Iowa","Boone County",2,12,347,194,153
050,19,015,"Iowa","Boone County",2,13,362,196,166
050,19,015,"Iowa","Boone County",2,14,356,193,163
050,19,015,"Iowa","Boone County",2,15,345,200,145
050,19,015,"Iowa","Boone County",2,16,369,230,139
050,19,015,"Iowa","Boone County",2,17,363,220,143
050,19,015,"Iowa","Boone County",2,18,272,152,120
050,19,015,"Iowa","Boone County",2,19,215,117,98
050,19,015,"Iowa","Boone County",2,20,252,137,115
050,19,015,"Iowa","Boone County",2,21,260,140,120
050,19,015,"Iowa","Boone County",2,22,282,149,133
050,19,015,"Iowa","Boone County",2,23,304,154,150
050,19,015,"Iowa","Boone County",2,24,301,150,151
050,19,015,"Iowa","Boone County",2,25,313,165,148
050,19,015,"Iowa","Boone County",2,26,315,169,146
050,19,015,"Iowa","Boone County",2,27,315,169,146
050,19,015,"Iowa","Boone County",2,28,314,157,157
050,19,015,"Iowa","Boone County",2,29,336,161,175
050,19,015,"Iowa","Boone County",2,30,338,171,167
050,19,015,"Iowa","Boone County",2,31,316,159,157
050,19,015,"Iowa","Boone County",2,32,315,164,151
050,19,015,"Iowa","Boone County",2,33,324,165,159
050,19,015,"Iowa","Boone County",2,34,343,174,169
050,19,015,"Iowa","Boone County",2,35,356,182,174
050,19,015,"Iowa","Boone County",2,36,365,188,177
050,19,015,"Iowa","Boone County",2,37,374,201,173
050,19,015,"Iowa","Boone County",2,38,364,203,161
050,19,015,"Iowa","Boone County",2,39,354,188,166
050,19,015,"Iowa","Boone County",2,40,364,186,178
050,19,015,"Iowa","Boone County",2,41,354,182,172
050,19,015,"Iowa","Boone County",2,42,355,183,172
050,19,015,"Iowa","Boone County",2,43,321,164,157
050,19,015,"Iowa","Boone County",2,44,309,154,155
050,19,015,"Iowa","Boone County",2,45,328,167,161
050,19,015,"Iowa","Boone County",2,46,308,152,156
050,19,015,"Iowa","Boone County",2,47,314,166,148
050,19,015,"Iowa","Boone County",2,48,332,185,147
050,19,015,"Iowa","Boone County",2,49,339,187,152
050,19,015,"Iowa","Boone County",2,50,325,168,157
050,19,015,"Iowa","Boone County",2,51,321,166,155
050,19,015,"Iowa","Boone County",2,52,333,176,157
050,19,015,"Iowa","Boone County",2,53,331,173,158
050,19,015,"Iowa","Boone County",2,54,337,173,164
050,19,015,"Iowa","Boone County",2,55,366,188,178
050,19,015,"Iowa","Boone County",2,56,382,190,192
050,19,015,"Iowa","Boone County",2,57,386,189,197
050,19,015,"Iowa","Boone County",2,58,410,197,213
050,19,015,"Iowa","Boone County",2,59,413,202,211
050,19,015,"Iowa","Boone County",2,60,425,214,211
050,19,015,"Iowa","Boone County",2,61,435,224,211
050,19,015,"Iowa","Boone County",2,62,442,224,218
050,19,015,"Iowa","Boone County",2,63,411,207,204
050,19,015,"Iowa","Boone County",2,64,380,190,190
050,19,015,"Iowa","Boone County",2,65,384,186,198
050,19,015,"Iowa","Boone County",2,66,390,190,200
050,19,015,"Iowa","Boone County",2,67,373,186,187
050,19,015,"Iowa","Boone County",2,68,359,191,168
050,19,015,"Iowa","Boone County",2,69,319,165,154
050,19,015,"Iowa","Boone County",2,70,289,147,142
050,19,015,"Iowa","Boone County",2,71,270,136,134
050,19,015,"Iowa","Boone County",2,72,264,127,137
050,19,015,"Iowa","Boone County",2,73,277,134,143
050,19,015,"Iowa","Boone County",2,74,193,91,102
050,19,015,"Iowa","Boone County",2,75,175,85,90
050,19,015,"Iowa","Boone County",2,76,179,82,97
050,19,015,"Iowa","Boone County",2,77,188,87,101
050,19,015,"Iowa","Boone County",2,78,147,64,83
050,19,015,"Iowa","Boone County",2,79,127,61,66
050,19,015,"Iowa","Boone County",2,80,128,53,75
050,19,015,"Iowa","Boone County",2,81,124,53,71
050,19,015,"Iowa","Boone County",2,82,115,49,66
050,19,015,"Iowa","Boone County",2,83,101,40,61
050,19,015,"Iowa","Boone County",2,84,98,42,56
050,19,015,"Iowa","Boone County",2,85,623,196,427
050,19,015,"Iowa","Boone County",3,0,258,129,129
050,19,015,"Iowa","Boone County",3,1,271,137,134
050,19,015,"Iowa","Boone County",3,2,292,150,142
050,19,015,"Iowa","Boone County",3,3,306,156,150
050,19,015,"Iowa","Boone County",3,4,279,144,135
050,19,015,"Iowa","Boone County",3,5,274,126,148
050,19,015,"Iowa","Boone County",3,6,279,136,143
050,19,015,"Iowa","Boone County",3,7,294,156,138
050,19,015,"Iowa","Boone County",3,8,300,164,136
050,19,015,"Iowa","Boone County",3,9,304,151,153
050,19,015,"Iowa","Boone County",3,10,303,148,155
050,19,015,"Iowa","Boone County",3,11,288,146,142
050,19,015,"Iowa","Boone County",3,12,321,168,153
050,19,015,"Iowa","Boone County",3,13,353,197,156
050,19,015,"Iowa","Boone County",3,14,364,205,159
050,19,015,"Iowa","Boone County",3,15,370,211,159
050,19,015,"Iowa","Boone County",3,16,381,233,148
050,19,015,"Iowa","Boone County",3,17,349,217,132
050,19,015,"Iowa","Boone County",3,18,294,171,123
050,19,015,"Iowa","Boone County",3,19,225,118,107
050,19,015,"Iowa","Boone County",3,20,242,134,108
050,19,015,"Iowa","Boone County",3,21,272,150,122
050,19,015,"Iowa","Boone County",3,22,263,144,119
050,19,015,"Iowa","Boone County",3,23,280,154,126
050,19,015,"Iowa","Boone County",3,24,288,155,133
050,19,015,"Iowa","Boone County",3,25,324,161,163
050,19,015,"Iowa","Boone County",3,26,321,174,147
050,19,015,"Iowa","Boone County",3,27,315,176,139
050,19,015,"Iowa","Boone County",3,28,322,169,153
050,19,015,"Iowa","Boone County",3,29,335,170,165
050,19,015,"Iowa","Boone County",3,30,340,164,176
050,19,015,"Iowa","Boone County",3,31,354,178,176
050,19,015,"Iowa","Boone County",3,32,333,166,167
050,19,015,"Iowa","Boone County",3,33,349,186,163
050,19,015,"Iowa","Boone County",3,34,326,168,158
050,19,015,"Iowa","Boone County",3,35,352,176,176
050,19,015,"Iowa","Boone County",3,36,356,180,176
050,19,015,"Iowa","Boone County",3,37,371,191,180
050,19,015,"Iowa","Boone County",3,38,368,196,172
050,19,015,"Iowa","Boone County",3,39,358,190,168
050,19,015,"Iowa","Boone County",3,40,353,184,169
050,19,015,"Iowa","Boone County",3,41,369,191,178
050,19,015,"Iowa","Boone County",3,42,360,190,170
050,19,015,"Iowa","Boone County",3,43,360,184,176
050,19,015,"Iowa","Boone County",3,44,327,169,158
050,19,015,"Iowa","Boone County",3,45,311,148,163
050,19,015,"Iowa","Boone County",3,46,332,173,159
050,19,015,"Iowa","Boone County",3,47,306,151,155
050,19,015,"Iowa","Boone County",3,48,313,166,147
050,19,015,"Iowa","Boone County",3,49,328,184,144
050,19,015,"Iowa","Boone County",3,50,348,193,155
050,19,015,"Iowa","Boone County",3,51,315,164,151
050,19,015,"Iowa","Boone County",3,52,323,167,156
050,19,015,"Iowa","Boone County",3,53,330,174,156
050,19,015,"Iowa","Boone County",3,54,334,173,161
050,19,015,"Iowa","Boone County",3,55,329,166,163
050,19,015,"Iowa","Boone County",3,56,363,187,176
050,19,015,"Iowa","Boone County",3,57,390,198,192
050,19,015,"Iowa","Boone County",3,58,379,188,191
050,19,015,"Iowa","Boone County",3,59,416,204,212
050,19,015,"Iowa","Boone County",3,60,416,204,212
050,19,015,"Iowa","Boone County",3,61,414,204,210
050,19,015,"Iowa","Boone County",3,62,443,231,212
050,19,015,"Iowa","Boone County",3,63,435,224,211
050,19,015,"Iowa","Boone County",3,64,405,207,198
050,19,015,"Iowa","Boone County",3,65,371,183,188
050,19,015,"Iowa","Boone County",3,66,372,180,192
050,19,015,"Iowa","Boone County",3,67,383,187,196
050,19,015,"Iowa","Boone County",3,68,367,187,180
050,19,015,"Iowa","Boone County",3,69,351,186,165
050,19,015,"Iowa","Boone County",3,70,308,155,153
050,19,015,"Iowa","Boone County",3,71,278,144,134
050,19,015,"Iowa","Boone County",3,72,267,135,132
050,19,015,"Iowa","Boone County",3,73,249,120,129
050,19,015,"Iowa","Boone County",3,74,264,125,139
050,19,015,"Iowa","Boone County",3,75,178,88,90
050,19,015,"Iowa","Boone County",3,76,164,79,85
050,19,015,"Iowa","Boone County",3,77,174,83,91
050,19,015,"Iowa","Boone County",3,78,175,78,97
050,19,015,"Iowa","Boone County",3,79,139,64,75
050,19,015,"Iowa","Boone County",3,80,117,50,67
050,19,015,"Iowa","Boone County",3,81,120,54,66
050,19,015,"Iowa","Boone County",3,82,106,43,63
050,19,015,"Iowa","Boone County",3,83,115,48,67
050,19,015,"Iowa","Boone County",3,84,95,37,58
050,19,015,"Iowa","Boone County",3,85,595,170,425
050,19,015,"Iowa","Boone County",4,0,274,144,130
050,19,015,"Iowa","Boone County",4,1,266,124,142
050,19,015,"Iowa","Boone County",4,2,267,135,132
050,19,015,"Iowa","Boone County",4,3,287,143,144
050,19,015,"Iowa","Boone County",4,4,289,150,139
050,19,015,"Iowa","Boone County",4,5,275,137,138
050,19,015,"Iowa","Boone County",4,6,271,130,141
050,19,015,"Iowa","Boone County",4,7,271,133,138
050,19,015,"Iowa","Boone County",4,8,289,157,132
050,19,015,"Iowa","Boone County",4,9,298,162,136
050,19,015,"Iowa","Boone County",4,10,290,147,143
050,19,015,"Iowa","Boone County",4,11,294,136,158
050,19,015,"Iowa","Boone County",4,12,286,147,139
050,19,015,"Iowa","Boone County",4,13,336,181,155
050,19,015,"Iowa","Boone County",4,14,362,207,155
050,19,015,"Iowa","Boone County",4,15,386,226,160
050,19,015,"Iowa","Boone County",4,16,397,232,165
050,19,015,"Iowa","Boone County",4,17,369,215,154
050,19,015,"Iowa","Boone County",4,18,254,149,105
050,19,015,"Iowa","Boone County",4,19,210,117,93
050,19,015,"Iowa","Boone County",4,20,238,128,110
050,19,015,"Iowa","Boone County",4,21,242,130,112
050,19,015,"Iowa","Boone County",4,22,277,149,128
050,19,015,"Iowa","Boone County",4,23,272,150,122
050,19,015,"Iowa","Boone County",4,24,290,163,127
050,19,015,"Iowa","Boone County",4,25,292,152,140
050,19,015,"Iowa","Boone County",4,26,322,159,163
050,19,015,"Iowa","Boone County",4,27,319,173,146
050,19,015,"Iowa","Boone County",4,28,317,174,143
050,19,015,"Iowa","Boone County",4,29,314,160,154
050,19,015,"Iowa","Boone County",4,30,325,167,158
050,19,015,"Iowa","Boone County",4,31,341,161,180
050,19,015,"Iowa","Boone County",4,32,355,181,174
050,19,015,"Iowa","Boone County",4,33,359,186,173
050,19,015,"Iowa","Boone County",4,34,355,184,171
050,19,015,"Iowa","Boone County",4,35,323,167,156
050,19,015,"Iowa","Boone County",4,36,366,183,183
050,19,015,"Iowa","Boone County",4,37,361,190,171
050,19,015,"Iowa","Boone County",4,38,382,198,184
050,19,015,"Iowa","Boone County",4,39,370,197,173
050,19,015,"Iowa","Boone County",4,40,355,191,164
050,19,015,"Iowa","Boone County",4,41,358,188,170
050,19,015,"Iowa","Boone County",4,42,363,189,174
050,19,015,"Iowa","Boone County",4,43,359,185,174
050,19,015,"Iowa","Boone County",4,44,352,175,177
050,19,015,"Iowa","Boone County",4,45,323,165,158
050,19,015,"Iowa","Boone County",4,46,304,143,161
050,19,015,"Iowa","Boone County",4,47,352,187,165
050,19,015,"Iowa","Boone County",4,48,297,146,151
050,19,015,"Iowa","Boone County",4,49,305,155,150
050,19,015,"Iowa","Boone County",4,50,334,184,150
050,19,015,"Iowa","Boone County",4,51,346,193,153
050,19,015,"Iowa","Boone County",4,52,315,163,152
050,19,015,"Iowa","Boone County",4,53,319,162,157
050,19,015,"Iowa","Boone County",4,54,332,181,151
050,19,015,"Iowa","Boone County",4,55,334,174,160
050,19,015,"Iowa","Boone County",4,56,320,161,159
050,19,015,"Iowa","Boone County",4,57,362,187,175
050,19,015,"Iowa","Boone County",4,58,377,196,181
050,19,015,"Iowa","Boone County",4,59,388,193,195
050,19,015,"Iowa","Boone County",4,60,413,200,213
050,19,015,"Iowa","Boone County",4,61,408,201,207
050,19,015,"Iowa","Boone County",4,62,411,198,213
050,19,015,"Iowa","Boone County",4,63,428,224,204
050,19,015,"Iowa","Boone County",4,64,427,214,213
050,19,015,"Iowa","Boone County",4,65,397,199,198
050,19,015,"Iowa","Boone County",4,66,372,179,193
050,19,015,"Iowa","Boone County",4,67,354,175,179
050,19,015,"Iowa","Boone County",4,68,368,184,184
050,19,015,"Iowa","Boone County",4,69,357,180,177
050,19,015,"Iowa","Boone County",4,70,344,182,162
050,19,015,"Iowa","Boone County",4,71,301,153,148
050,19,015,"Iowa","Boone County",4,72,279,145,134
050,19,015,"Iowa","Boone County",4,73,250,127,123
050,19,015,"Iowa","Boone County",4,74,246,115,131
050,19,015,"Iowa","Boone County",4,75,252,121,131
050,19,015,"Iowa","Boone County",4,76,166,82,84
050,19,015,"Iowa","Boone County",4,77,155,71,84
050,19,015,"Iowa","Boone County",4,78,171,78,93
050,19,015,"Iowa","Boone County",4,79,166,74,92
050,19,015,"Iowa","Boone County",4,80,138,56,82
050,19,015,"Iowa","Boone County",4,81,101,48,53
050,19,015,"Iowa","Boone County",4,82,105,44,61
050,19,015,"Iowa","Boone County",4,83,107,42,65
050,19,015,"Iowa","Boone County",4,84,104,44,60
050,19,015,"Iowa","Boone County",4,85,573,155,418
050,19,015,"Iowa","Boone County",5,0,276,146,130
050,19,015,"Iowa","Boone County",5,1,267,141,126
050,19,015,"Iowa","Boone County",5,2,272,124,148
050,19,015,"Iowa","Boone County",5,3,271,132,139
050,19,015,"Iowa","Boone County",5,4,285,144,141
050,19,015,"Iowa","Boone County",5,5,287,152,135
050,19,015,"Iowa","Boone County",5,6,283,140,143
050,19,015,"Iowa","Boone County",5,7,277,129,148
050,19,015,"Iowa","Boone County",5,8,275,141,134
050,19,015,"Iowa","Boone County",5,9,294,159,135
050,19,015,"Iowa","Boone County",5,10,296,157,139
050,19,015,"Iowa","Boone County",5,11,297,150,147
050,19,015,"Iowa","Boone County",5,12,296,137,159
050,19,015,"Iowa","Boone County",5,13,292,151,141
050,19,015,"Iowa","Boone County",5,14,348,197,151
050,19,015,"Iowa","Boone County",5,15,375,227,148
050,19,015,"Iowa","Boone County",5,16,409,251,158
050,19,015,"Iowa","Boone County",5,17,386,221,165
050,19,015,"Iowa","Boone County",5,18,279,158,121
050,19,015,"Iowa","Boone County",5,19,184,102,82
050,19,015,"Iowa","Boone County",5,20,232,125,107
050,19,015,"Iowa","Boone County",5,21,244,130,114
050,19,015,"Iowa","Boone County",5,22,248,136,112
050,19,015,"Iowa","Boone County",5,23,294,157,137
050,19,015,"Iowa","Boone County",5,24,278,153,125
050,19,015,"Iowa","Boone County",5,25,297,165,132
050,19,015,"Iowa","Boone County",5,26,293,148,145
050,19,015,"Iowa","Boone County",5,27,296,150,146
050,19,015,"Iowa","Boone County",5,28,324,174,150
050,19,015,"Iowa","Boone County",5,29,332,182,150
050,19,015,"Iowa","Boone County",5,30,308,162,146
050,19,015,"Iowa","Boone County",5,31,337,171,166
050,19,015,"Iowa","Boone County",5,32,361,180,181
050,19,015,"Iowa","Boone County",5,33,363,184,179
050,19,015,"Iowa","Boone County",5,34,351,175,176
050,19,015,"Iowa","Boone County",5,35,355,189,166
050,19,015,"Iowa","Boone County",5,36,310,156,154
050,19,015,"Iowa","Boone County",5,37,372,188,184
050,19,015,"Iowa","Boone County",5,38,369,194,175
050,19,015,"Iowa","Boone County",5,39,385,193,192
050,19,015,"Iowa","Boone County",5,40,373,201,172
050,19,015,"Iowa","Boone County",5,41,361,202,159
050,19,015,"Iowa","Boone County",5,42,367,200,167
050,19,015,"Iowa","Boone County",5,43,357,185,172
050,19,015,"Iowa","Boone County",5,44,368,188,180
050,19,015,"Iowa","Boone County",5,45,347,172,175
050,19,015,"Iowa","Boone County",5,46,322,162,160
050,19,015,"Iowa","Boone County",5,47,301,145,156
050,19,015,"Iowa","Boone County",5,48,350,185,165
050,19,015,"Iowa","Boone County",5,49,307,153,154
050,19,015,"Iowa","Boone County",5,50,300,156,144
050,19,015,"Iowa","Boone County",5,51,327,183,144
050,19,015,"Iowa","Boone County",5,52,335,186,149
050,19,015,"Iowa","Boone County",5,53,321,160,161
050,19,015,"Iowa","Boone County",5,54,330,171,159
050,19,015,"Iowa","Boone County",5,55,328,174,154
050,19,015,"Iowa","Boone County",5,56,331,172,159
050,19,015,"Iowa","Boone County",5,57,329,163,166
050,19,015,"Iowa","Boone County",5,58,356,187,169
050,19,015,"Iowa","Boone County",5,59,378,196,182
050,19,015,"Iowa","Boone County",5,60,394,197,197
050,19,015,"Iowa","Boone County",5,61,404,196,208
050,19,015,"Iowa","Boone County",5,62,398,194,204
050,19,015,"Iowa","Boone County",5,63,400,196,204
050,19,015,"Iowa","Boone County",5,64,433,225,208
050,19,015,"Iowa","Boone County",5,65,418,207,211
050,19,015,"Iowa","Boone County",5,66,391,194,197
050,19,015,"Iowa","Boone County",5,67,356,173,183
050,19,015,"Iowa","Boone County",5,68,344,170,174
050,19,015,"Iowa","Boone County",5,69,369,184,185
050,19,015,"Iowa","Boone County",5,70,340,169,171
050,19,015,"Iowa","Boone County",5,71,332,178,154
050,19,015,"Iowa","Boone County",5,72,309,156,153
050,19,015,"Iowa","Boone County",5,73,268,137,131
050,19,015,"Iowa","Boone County",5,74,241,118,123
050,19,015,"Iowa","Boone County",5,75,228,110,118
050,19,015,"Iowa","Boone County",5,76,236,113,123
050,19,015,"Iowa","Boone County",5,77,162,76,86
050,19,015,"Iowa","Boone County",5,78,149,66,83
050,19,015,"Iowa","Boone County",5,79,167,79,88
050,19,015,"Iowa","Boone County",5,80,160,65,95
050,19,015,"Iowa","Boone County",5,81,122,50,72
050,19,015,"Iowa","Boone County",5,82,86,38,48
050,19,015,"Iowa","Boone County",5,83,105,42,63
050,19,015,"Iowa","Boone County",5,84,102,37,65
050,19,015,"Iowa","Boone County",5,85,590,156,434
050,19,017,"Iowa","Bremer County",1,0,252,130,122
050,19,017,"Iowa","Bremer County",1,1,264,144,120
050,19,017,"Iowa","Bremer County",1,2,290,143,147
050,19,017,"Iowa","Bremer County",1,3,290,146,144
050,19,017,"Iowa","Bremer County",1,4,317,163,154
050,19,017,"Iowa","Bremer County",1,5,316,170,146
050,19,017,"Iowa","Bremer County",1,6,303,160,143
050,19,017,"Iowa","Bremer County",1,7,317,159,158
050,19,017,"Iowa","Bremer County",1,8,296,158,138
050,19,017,"Iowa","Bremer County",1,9,277,150,127
050,19,017,"Iowa","Bremer County",1,10,313,167,146
050,19,017,"Iowa","Bremer County",1,11,341,182,159
050,19,017,"Iowa","Bremer County",1,12,370,193,177
050,19,017,"Iowa","Bremer County",1,13,383,201,182
050,19,017,"Iowa","Bremer County",1,14,350,184,166
050,19,017,"Iowa","Bremer County",1,15,345,179,166
050,19,017,"Iowa","Bremer County",1,16,352,175,177
050,19,017,"Iowa","Bremer County",1,17,335,166,169
050,19,017,"Iowa","Bremer County",1,18,410,208,202
050,19,017,"Iowa","Bremer County",1,19,593,288,305
050,19,017,"Iowa","Bremer County",1,20,562,283,279
050,19,017,"Iowa","Bremer County",1,21,461,221,240
050,19,017,"Iowa","Bremer County",1,22,363,181,182
050,19,017,"Iowa","Bremer County",1,23,250,125,125
050,19,017,"Iowa","Bremer County",1,24,260,134,126
050,19,017,"Iowa","Bremer County",1,25,238,127,111
050,19,017,"Iowa","Bremer County",1,26,256,140,116
050,19,017,"Iowa","Bremer County",1,27,243,120,123
050,19,017,"Iowa","Bremer County",1,28,232,114,118
050,19,017,"Iowa","Bremer County",1,29,242,122,120
050,19,017,"Iowa","Bremer County",1,30,255,132,123
050,19,017,"Iowa","Bremer County",1,31,281,143,138
050,19,017,"Iowa","Bremer County",1,32,283,139,144
050,19,017,"Iowa","Bremer County",1,33,257,127,130
050,19,017,"Iowa","Bremer County",1,34,264,127,137
050,19,017,"Iowa","Bremer County",1,35,285,140,145
050,19,017,"Iowa","Bremer County",1,36,302,150,152
050,19,017,"Iowa","Bremer County",1,37,339,176,163
050,19,017,"Iowa","Bremer County",1,38,342,175,167
050,19,017,"Iowa","Bremer County",1,39,318,155,163
050,19,017,"Iowa","Bremer County",1,40,340,179,161
050,19,017,"Iowa","Bremer County",1,41,322,160,162
050,19,017,"Iowa","Bremer County",1,42,300,158,142
050,19,017,"Iowa","Bremer County",1,43,287,164,123
050,19,017,"Iowa","Bremer County",1,44,288,149,139
050,19,017,"Iowa","Bremer County",1,45,272,131,141
050,19,017,"Iowa","Bremer County",1,46,275,127,148
050,19,017,"Iowa","Bremer County",1,47,277,149,128
050,19,017,"Iowa","Bremer County",1,48,272,146,126
050,19,017,"Iowa","Bremer County",1,49,285,148,137
050,19,017,"Iowa","Bremer County",1,50,268,140,128
050,19,017,"Iowa","Bremer County",1,51,305,162,143
050,19,017,"Iowa","Bremer County",1,52,275,145,130
050,19,017,"Iowa","Bremer County",1,53,281,141,140
050,19,017,"Iowa","Bremer County",1,54,269,133,136
050,19,017,"Iowa","Bremer County",1,55,280,136,144
050,19,017,"Iowa","Bremer County",1,56,323,154,169
050,19,017,"Iowa","Bremer County",1,57,313,157,156
050,19,017,"Iowa","Bremer County",1,58,307,158,149
050,19,017,"Iowa","Bremer County",1,59,315,159,156
050,19,017,"Iowa","Bremer County",1,60,329,174,155
050,19,017,"Iowa","Bremer County",1,61,318,155,163
050,19,017,"Iowa","Bremer County",1,62,300,158,142
050,19,017,"Iowa","Bremer County",1,63,312,155,157
050,19,017,"Iowa","Bremer County",1,64,289,142,147
050,19,017,"Iowa","Bremer County",1,65,295,148,147
050,19,017,"Iowa","Bremer County",1,66,296,138,158
050,19,017,"Iowa","Bremer County",1,67,300,150,150
050,19,017,"Iowa","Bremer County",1,68,293,144,149
050,19,017,"Iowa","Bremer County",1,69,239,124,115
050,19,017,"Iowa","Bremer County",1,70,246,122,124
050,19,017,"Iowa","Bremer County",1,71,251,123,128
050,19,017,"Iowa","Bremer County",1,72,260,125,135
050,19,017,"Iowa","Bremer County",1,73,262,123,139
050,19,017,"Iowa","Bremer County",1,74,177,77,100
050,19,017,"Iowa","Bremer County",1,75,188,91,97
050,19,017,"Iowa","Bremer County",1,76,187,85,102
050,19,017,"Iowa","Bremer County",1,77,187,83,104
050,19,017,"Iowa","Bremer County",1,78,177,83,94
050,19,017,"Iowa","Bremer County",1,79,158,73,85
050,19,017,"Iowa","Bremer County",1,80,154,64,90
050,19,017,"Iowa","Bremer County",1,81,135,59,76
050,19,017,"Iowa","Bremer County",1,82,117,54,63
050,19,017,"Iowa","Bremer County",1,83,117,50,67
050,19,017,"Iowa","Bremer County",1,84,112,55,57
050,19,017,"Iowa","Bremer County",1,85,690,239,451
050,19,017,"Iowa","Bremer County",2,0,256,135,121
050,19,017,"Iowa","Bremer County",2,1,260,140,120
050,19,017,"Iowa","Bremer County",2,2,285,144,141
050,19,017,"Iowa","Bremer County",2,3,288,143,145
050,19,017,"Iowa","Bremer County",2,4,313,159,154
050,19,017,"Iowa","Bremer County",2,5,319,170,149
050,19,017,"Iowa","Bremer County",2,6,307,164,143
050,19,017,"Iowa","Bremer County",2,7,312,159,153
050,19,017,"Iowa","Bremer County",2,8,300,157,143
050,19,017,"Iowa","Bremer County",2,9,282,153,129
050,19,017,"Iowa","Bremer County",2,10,307,165,142
050,19,017,"Iowa","Bremer County",2,11,335,179,156
050,19,017,"Iowa","Bremer County",2,12,371,194,177
050,19,017,"Iowa","Bremer County",2,13,382,201,181
050,19,017,"Iowa","Bremer County",2,14,359,190,169
050,19,017,"Iowa","Bremer County",2,15,348,180,168
050,19,017,"Iowa","Bremer County",2,16,354,177,177
050,19,017,"Iowa","Bremer County",2,17,342,168,174
050,19,017,"Iowa","Bremer County",2,18,410,207,203
050,19,017,"Iowa","Bremer County",2,19,588,283,305
050,19,017,"Iowa","Bremer County",2,20,566,285,281
050,19,017,"Iowa","Bremer County",2,21,461,221,240
050,19,017,"Iowa","Bremer County",2,22,360,180,180
050,19,017,"Iowa","Bremer County",2,23,253,126,127
050,19,017,"Iowa","Bremer County",2,24,255,131,124
050,19,017,"Iowa","Bremer County",2,25,248,131,117
050,19,017,"Iowa","Bremer County",2,26,249,134,115
050,19,017,"Iowa","Bremer County",2,27,246,125,121
050,19,017,"Iowa","Bremer County",2,28,238,119,119
050,19,017,"Iowa","Bremer County",2,29,242,123,119
050,19,017,"Iowa","Bremer County",2,30,256,132,124
050,19,017,"Iowa","Bremer County",2,31,278,142,136
050,19,017,"Iowa","Bremer County",2,32,286,142,144
050,19,017,"Iowa","Bremer County",2,33,263,130,133
050,19,017,"Iowa","Bremer County",2,34,267,130,137
050,19,017,"Iowa","Bremer County",2,35,281,137,144
050,19,017,"Iowa","Bremer County",2,36,298,147,151
050,19,017,"Iowa","Bremer County",2,37,333,172,161
050,19,017,"Iowa","Bremer County",2,38,344,175,169
050,19,017,"Iowa","Bremer County",2,39,325,160,165
050,19,017,"Iowa","Bremer County",2,40,339,176,163
050,19,017,"Iowa","Bremer County",2,41,325,165,160
050,19,017,"Iowa","Bremer County",2,42,303,157,146
050,19,017,"Iowa","Bremer County",2,43,296,165,131
050,19,017,"Iowa","Bremer County",2,44,287,153,134
050,19,017,"Iowa","Bremer County",2,45,276,135,141
050,19,017,"Iowa","Bremer County",2,46,273,128,145
050,19,017,"Iowa","Bremer County",2,47,274,143,131
050,19,017,"Iowa","Bremer County",2,48,274,148,126
050,19,017,"Iowa","Bremer County",2,49,284,150,134
050,19,017,"Iowa","Bremer County",2,50,271,142,129
050,19,017,"Iowa","Bremer County",2,51,294,155,139
050,19,017,"Iowa","Bremer County",2,52,282,148,134
050,19,017,"Iowa","Bremer County",2,53,280,142,138
050,19,017,"Iowa","Bremer County",2,54,270,134,136
050,19,017,"Iowa","Bremer County",2,55,277,135,142
050,19,017,"Iowa","Bremer County",2,56,312,149,163
050,19,017,"Iowa","Bremer County",2,57,314,156,158
050,19,017,"Iowa","Bremer County",2,58,307,156,151
050,19,017,"Iowa","Bremer County",2,59,316,160,156
050,19,017,"Iowa","Bremer County",2,60,325,170,155
050,19,017,"Iowa","Bremer County",2,61,317,159,158
050,19,017,"Iowa","Bremer County",2,62,304,157,147
050,19,017,"Iowa","Bremer County",2,63,308,154,154
050,19,017,"Iowa","Bremer County",2,64,292,145,147
050,19,017,"Iowa","Bremer County",2,65,290,145,145
050,19,017,"Iowa","Bremer County",2,66,296,140,156
050,19,017,"Iowa","Bremer County",2,67,300,147,153
050,19,017,"Iowa","Bremer County",2,68,292,144,148
050,19,017,"Iowa","Bremer County",2,69,251,128,123
050,19,017,"Iowa","Bremer County",2,70,245,123,122
050,19,017,"Iowa","Bremer County",2,71,247,122,125
050,19,017,"Iowa","Bremer County",2,72,253,121,132
050,19,017,"Iowa","Bremer County",2,73,273,129,144
050,19,017,"Iowa","Bremer County",2,74,183,83,100
050,19,017,"Iowa","Bremer County",2,75,186,88,98
050,19,017,"Iowa","Bremer County",2,76,184,86,98
050,19,017,"Iowa","Bremer County",2,77,189,85,104
050,19,017,"Iowa","Bremer County",2,78,175,81,94
050,19,017,"Iowa","Bremer County",2,79,159,72,87
050,19,017,"Iowa","Bremer County",2,80,155,67,88
050,19,017,"Iowa","Bremer County",2,81,137,59,78
050,19,017,"Iowa","Bremer County",2,82,122,55,67
050,19,017,"Iowa","Bremer County",2,83,116,51,65
050,19,017,"Iowa","Bremer County",2,84,113,55,58
050,19,017,"Iowa","Bremer County",2,85,678,237,441
050,19,017,"Iowa","Bremer County",3,0,233,123,110
050,19,017,"Iowa","Bremer County",3,1,274,139,135
050,19,017,"Iowa","Bremer County",3,2,265,137,128
050,19,017,"Iowa","Bremer County",3,3,282,142,140
050,19,017,"Iowa","Bremer County",3,4,283,139,144
050,19,017,"Iowa","Bremer County",3,5,328,167,161
050,19,017,"Iowa","Bremer County",3,6,308,164,144
050,19,017,"Iowa","Bremer County",3,7,305,154,151
050,19,017,"Iowa","Bremer County",3,8,327,162,165
050,19,017,"Iowa","Bremer County",3,9,300,151,149
050,19,017,"Iowa","Bremer County",3,10,295,157,138
050,19,017,"Iowa","Bremer County",3,11,315,164,151
050,19,017,"Iowa","Bremer County",3,12,334,177,157
050,19,017,"Iowa","Bremer County",3,13,379,194,185
050,19,017,"Iowa","Bremer County",3,14,374,200,174
050,19,017,"Iowa","Bremer County",3,15,372,188,184
050,19,017,"Iowa","Bremer County",3,16,350,185,165
050,19,017,"Iowa","Bremer County",3,17,350,167,183
050,19,017,"Iowa","Bremer County",3,18,419,213,206
050,19,017,"Iowa","Bremer County",3,19,586,281,305
050,19,017,"Iowa","Bremer County",3,20,575,295,280
050,19,017,"Iowa","Bremer County",3,21,472,235,237
050,19,017,"Iowa","Bremer County",3,22,375,198,177
050,19,017,"Iowa","Bremer County",3,23,280,134,146
050,19,017,"Iowa","Bremer County",3,24,234,120,114
050,19,017,"Iowa","Bremer County",3,25,248,134,114
050,19,017,"Iowa","Bremer County",3,26,258,137,121
050,19,017,"Iowa","Bremer County",3,27,256,133,123
050,19,017,"Iowa","Bremer County",3,28,260,140,120
050,19,017,"Iowa","Bremer County",3,29,235,121,114
050,19,017,"Iowa","Bremer County",3,30,260,131,129
050,19,017,"Iowa","Bremer County",3,31,273,139,134
050,19,017,"Iowa","Bremer County",3,32,290,148,142
050,19,017,"Iowa","Bremer County",3,33,276,131,145
050,19,017,"Iowa","Bremer County",3,34,283,145,138
050,19,017,"Iowa","Bremer County",3,35,269,135,134
050,19,017,"Iowa","Bremer County",3,36,294,148,146
050,19,017,"Iowa","Bremer County",3,37,308,147,161
050,19,017,"Iowa","Bremer County",3,38,342,172,170
050,19,017,"Iowa","Bremer County",3,39,328,164,164
050,19,017,"Iowa","Bremer County",3,40,321,160,161
050,19,017,"Iowa","Bremer County",3,41,340,173,167
050,19,017,"Iowa","Bremer County",3,42,325,166,159
050,19,017,"Iowa","Bremer County",3,43,308,159,149
050,19,017,"Iowa","Bremer County",3,44,308,170,138
050,19,017,"Iowa","Bremer County",3,45,288,150,138
050,19,017,"Iowa","Bremer County",3,46,272,133,139
050,19,017,"Iowa","Bremer County",3,47,277,125,152
050,19,017,"Iowa","Bremer County",3,48,270,143,127
050,19,017,"Iowa","Bremer County",3,49,266,145,121
050,19,017,"Iowa","Bremer County",3,50,293,153,140
050,19,017,"Iowa","Bremer County",3,51,265,141,124
050,19,017,"Iowa","Bremer County",3,52,297,159,138
050,19,017,"Iowa","Bremer County",3,53,279,147,132
050,19,017,"Iowa","Bremer County",3,54,279,139,140
050,19,017,"Iowa","Bremer County",3,55,275,136,139
050,19,017,"Iowa","Bremer County",3,56,275,135,140
050,19,017,"Iowa","Bremer County",3,57,306,150,156
050,19,017,"Iowa","Bremer County",3,58,314,155,159
050,19,017,"Iowa","Bremer County",3,59,307,155,152
050,19,017,"Iowa","Bremer County",3,60,313,158,155
050,19,017,"Iowa","Bremer County",3,61,327,169,158
050,19,017,"Iowa","Bremer County",3,62,320,159,161
050,19,017,"Iowa","Bremer County",3,63,291,148,143
050,19,017,"Iowa","Bremer County",3,64,304,152,152
050,19,017,"Iowa","Bremer County",3,65,289,145,144
050,19,017,"Iowa","Bremer County",3,66,289,142,147
050,19,017,"Iowa","Bremer County",3,67,296,143,153
050,19,017,"Iowa","Bremer County",3,68,300,146,154
050,19,017,"Iowa","Bremer County",3,69,282,138,144
050,19,017,"Iowa","Bremer County",3,70,250,131,119
050,19,017,"Iowa","Bremer County",3,71,232,113,119
050,19,017,"Iowa","Bremer County",3,72,244,122,122
050,19,017,"Iowa","Bremer County",3,73,245,119,126
050,19,017,"Iowa","Bremer County",3,74,264,125,139
050,19,017,"Iowa","Bremer County",3,75,187,84,103
050,19,017,"Iowa","Bremer County",3,76,179,87,92
050,19,017,"Iowa","Bremer County",3,77,182,84,98
050,19,017,"Iowa","Bremer County",3,78,179,81,98
050,19,017,"Iowa","Bremer County",3,79,169,77,92
050,19,017,"Iowa","Bremer County",3,80,150,67,83
050,19,017,"Iowa","Bremer County",3,81,139,59,80
050,19,017,"Iowa","Bremer County",3,82,133,55,78
050,19,017,"Iowa","Bremer County",3,83,109,49,60
050,19,017,"Iowa","Bremer County",3,84,108,49,59
050,19,017,"Iowa","Bremer County",3,85,677,238,439
050,19,017,"Iowa","Bremer County",4,0,244,139,105
050,19,017,"Iowa","Bremer County",4,1,239,124,115
050,19,017,"Iowa","Bremer County",4,2,275,139,136
050,19,017,"Iowa","Bremer County",4,3,279,150,129
050,19,017,"Iowa","Bremer County",4,4,283,137,146
050,19,017,"Iowa","Bremer County",4,5,297,148,149
050,19,017,"Iowa","Bremer County",4,6,332,173,159
050,19,017,"Iowa","Bremer County",4,7,320,172,148
050,19,017,"Iowa","Bremer County",4,8,330,170,160
050,19,017,"Iowa","Bremer County",4,9,341,168,173
050,19,017,"Iowa","Bremer County",4,10,308,158,150
050,19,017,"Iowa","Bremer County",4,11,301,162,139
050,19,017,"Iowa","Bremer County",4,12,322,173,149
050,19,017,"Iowa","Bremer County",4,13,357,186,171
050,19,017,"Iowa","Bremer County",4,14,377,196,181
050,19,017,"Iowa","Bremer County",4,15,391,209,182
050,19,017,"Iowa","Bremer County",4,16,365,187,178
050,19,017,"Iowa","Bremer County",4,17,354,184,170
050,19,017,"Iowa","Bremer County",4,18,420,202,218
050,19,017,"Iowa","Bremer County",4,19,584,284,300
050,19,017,"Iowa","Bremer County",4,20,568,283,285
050,19,017,"Iowa","Bremer County",4,21,478,239,239
050,19,017,"Iowa","Bremer County",4,22,361,192,169
050,19,017,"Iowa","Bremer County",4,23,259,137,122
050,19,017,"Iowa","Bremer County",4,24,255,129,126
050,19,017,"Iowa","Bremer County",4,25,240,118,122
050,19,017,"Iowa","Bremer County",4,26,264,133,131
050,19,017,"Iowa","Bremer County",4,27,255,135,120
050,19,017,"Iowa","Bremer County",4,28,267,147,120
050,19,017,"Iowa","Bremer County",4,29,251,137,114
050,19,017,"Iowa","Bremer County",4,30,243,116,127
050,19,017,"Iowa","Bremer County",4,31,252,131,121
050,19,017,"Iowa","Bremer County",4,32,277,139,138
050,19,017,"Iowa","Bremer County",4,33,289,148,141
050,19,017,"Iowa","Bremer County",4,34,302,146,156
050,19,017,"Iowa","Bremer County",4,35,301,152,149
050,19,017,"Iowa","Bremer County",4,36,281,142,139
050,19,017,"Iowa","Bremer County",4,37,297,151,146
050,19,017,"Iowa","Bremer County",4,38,315,150,165
050,19,017,"Iowa","Bremer County",4,39,346,171,175
050,19,017,"Iowa","Bremer County",4,40,336,172,164
050,19,017,"Iowa","Bremer County",4,41,329,160,169
050,19,017,"Iowa","Bremer County",4,42,346,181,165
050,19,017,"Iowa","Bremer County",4,43,337,166,171
050,19,017,"Iowa","Bremer County",4,44,308,161,147
050,19,017,"Iowa","Bremer County",4,45,325,179,146
050,19,017,"Iowa","Bremer County",4,46,291,159,132
050,19,017,"Iowa","Bremer County",4,47,267,130,137
050,19,017,"Iowa","Bremer County",4,48,280,126,154
050,19,017,"Iowa","Bremer County",4,49,269,143,126
050,19,017,"Iowa","Bremer County",4,50,263,143,120
050,19,017,"Iowa","Bremer County",4,51,289,147,142
050,19,017,"Iowa","Bremer County",4,52,256,137,119
050,19,017,"Iowa","Bremer County",4,53,293,156,137
050,19,017,"Iowa","Bremer County",4,54,281,151,130
050,19,017,"Iowa","Bremer County",4,55,269,133,136
050,19,017,"Iowa","Bremer County",4,56,277,136,141
050,19,017,"Iowa","Bremer County",4,57,275,137,138
050,19,017,"Iowa","Bremer County",4,58,302,146,156
050,19,017,"Iowa","Bremer County",4,59,318,155,163
050,19,017,"Iowa","Bremer County",4,60,304,152,152
050,19,017,"Iowa","Bremer County",4,61,308,156,152
050,19,017,"Iowa","Bremer County",4,62,332,174,158
050,19,017,"Iowa","Bremer County",4,63,312,159,153
050,19,017,"Iowa","Bremer County",4,64,295,145,150
050,19,017,"Iowa","Bremer County",4,65,296,146,150
050,19,017,"Iowa","Bremer County",4,66,281,141,140
050,19,017,"Iowa","Bremer County",4,67,287,139,148
050,19,017,"Iowa","Bremer County",4,68,297,144,153
050,19,017,"Iowa","Bremer County",4,69,293,141,152
050,19,017,"Iowa","Bremer County",4,70,287,141,146
050,19,017,"Iowa","Bremer County",4,71,239,122,117
050,19,017,"Iowa","Bremer County",4,72,233,113,120
050,19,017,"Iowa","Bremer County",4,73,240,118,122
050,19,017,"Iowa","Bremer County",4,74,240,116,124
050,19,017,"Iowa","Bremer County",4,75,261,122,139
050,19,017,"Iowa","Bremer County",4,76,185,83,102
050,19,017,"Iowa","Bremer County",4,77,176,85,91
050,19,017,"Iowa","Bremer County",4,78,172,78,94
050,19,017,"Iowa","Bremer County",4,79,177,75,102
050,19,017,"Iowa","Bremer County",4,80,164,78,86
050,19,017,"Iowa","Bremer County",4,81,132,56,76
050,19,017,"Iowa","Bremer County",4,82,137,58,79
050,19,017,"Iowa","Bremer County",4,83,116,47,69
050,19,017,"Iowa","Bremer County",4,84,103,48,55
050,19,017,"Iowa","Bremer County",4,85,656,231,425
050,19,017,"Iowa","Bremer County",5,0,248,140,108
050,19,017,"Iowa","Bremer County",5,1,240,140,100
050,19,017,"Iowa","Bremer County",5,2,252,134,118
050,19,017,"Iowa","Bremer County",5,3,279,137,142
050,19,017,"Iowa","Bremer County",5,4,276,148,128
050,19,017,"Iowa","Bremer County",5,5,293,144,149
050,19,017,"Iowa","Bremer County",5,6,298,147,151
050,19,017,"Iowa","Bremer County",5,7,351,188,163
050,19,017,"Iowa","Bremer County",5,8,337,179,158
050,19,017,"Iowa","Bremer County",5,9,338,170,168
050,19,017,"Iowa","Bremer County",5,10,342,166,176
050,19,017,"Iowa","Bremer County",5,11,314,163,151
050,19,017,"Iowa","Bremer County",5,12,307,157,150
050,19,017,"Iowa","Bremer County",5,13,328,178,150
050,19,017,"Iowa","Bremer County",5,14,360,189,171
050,19,017,"Iowa","Bremer County",5,15,383,197,186
050,19,017,"Iowa","Bremer County",5,16,388,200,188
050,19,017,"Iowa","Bremer County",5,17,356,173,183
050,19,017,"Iowa","Bremer County",5,18,421,217,204
050,19,017,"Iowa","Bremer County",5,19,592,274,318
050,19,017,"Iowa","Bremer County",5,20,569,291,278
050,19,017,"Iowa","Bremer County",5,21,474,225,249
050,19,017,"Iowa","Bremer County",5,22,378,204,174
050,19,017,"Iowa","Bremer County",5,23,262,146,116
050,19,017,"Iowa","Bremer County",5,24,250,131,119
050,19,017,"Iowa","Bremer County",5,25,251,136,115
050,19,017,"Iowa","Bremer County",5,26,215,105,110
050,19,017,"Iowa","Bremer County",5,27,280,144,136
050,19,017,"Iowa","Bremer County",5,28,245,125,120
050,19,017,"Iowa","Bremer County",5,29,284,152,132
050,19,017,"Iowa","Bremer County",5,30,261,133,128
050,19,017,"Iowa","Bremer County",5,31,248,123,125
050,19,017,"Iowa","Bremer County",5,32,262,131,131
050,19,017,"Iowa","Bremer County",5,33,278,136,142
050,19,017,"Iowa","Bremer County",5,34,286,143,143
050,19,017,"Iowa","Bremer County",5,35,299,145,154
050,19,017,"Iowa","Bremer County",5,36,305,159,146
050,19,017,"Iowa","Bremer County",5,37,286,148,138
050,19,017,"Iowa","Bremer County",5,38,299,153,146
050,19,017,"Iowa","Bremer County",5,39,322,155,167
050,19,017,"Iowa","Bremer County",5,40,349,176,173
050,19,017,"Iowa","Bremer County",5,41,346,171,175
050,19,017,"Iowa","Bremer County",5,42,329,161,168
050,19,017,"Iowa","Bremer County",5,43,345,185,160
050,19,017,"Iowa","Bremer County",5,44,333,163,170
050,19,017,"Iowa","Bremer County",5,45,312,159,153
050,19,017,"Iowa","Bremer County",5,46,319,178,141
050,19,017,"Iowa","Bremer County",5,47,280,154,126
050,19,017,"Iowa","Bremer County",5,48,264,132,132
050,19,017,"Iowa","Bremer County",5,49,284,126,158
050,19,017,"Iowa","Bremer County",5,50,267,139,128
050,19,017,"Iowa","Bremer County",5,51,261,140,121
050,19,017,"Iowa","Bremer County",5,52,287,145,142
050,19,017,"Iowa","Bremer County",5,53,251,136,115
050,19,017,"Iowa","Bremer County",5,54,292,161,131
050,19,017,"Iowa","Bremer County",5,55,280,151,129
050,19,017,"Iowa","Bremer County",5,56,265,135,130
050,19,017,"Iowa","Bremer County",5,57,279,136,143
050,19,017,"Iowa","Bremer County",5,58,272,136,136
050,19,017,"Iowa","Bremer County",5,59,300,143,157
050,19,017,"Iowa","Bremer County",5,60,317,153,164
050,19,017,"Iowa","Bremer County",5,61,311,151,160
050,19,017,"Iowa","Bremer County",5,62,301,157,144
050,19,017,"Iowa","Bremer County",5,63,326,169,157
050,19,017,"Iowa","Bremer County",5,64,313,158,155
050,19,017,"Iowa","Bremer County",5,65,290,144,146
050,19,017,"Iowa","Bremer County",5,66,289,143,146
050,19,017,"Iowa","Bremer County",5,67,279,143,136
050,19,017,"Iowa","Bremer County",5,68,285,139,146
050,19,017,"Iowa","Bremer County",5,69,296,140,156
050,19,017,"Iowa","Bremer County",5,70,304,145,159
050,19,017,"Iowa","Bremer County",5,71,273,132,141
050,19,017,"Iowa","Bremer County",5,72,230,120,110
050,19,017,"Iowa","Bremer County",5,73,232,111,121
050,19,017,"Iowa","Bremer County",5,74,236,117,119
050,19,017,"Iowa","Bremer County",5,75,233,113,120
050,19,017,"Iowa","Bremer County",5,76,256,116,140
050,19,017,"Iowa","Bremer County",5,77,182,81,101
050,19,017,"Iowa","Bremer County",5,78,166,80,86
050,19,017,"Iowa","Bremer County",5,79,167,73,94
050,19,017,"Iowa","Bremer County",5,80,172,73,99
050,19,017,"Iowa","Bremer County",5,81,148,69,79
050,19,017,"Iowa","Bremer County",5,82,128,53,75
050,19,017,"Iowa","Bremer County",5,83,123,51,72
050,19,017,"Iowa","Bremer County",5,84,112,48,64
050,19,017,"Iowa","Bremer County",5,85,666,241,425
050,19,019,"Iowa","Buchanan County",1,0,265,136,129
050,19,019,"Iowa","Buchanan County",1,1,281,142,139
050,19,019,"Iowa","Buchanan County",1,2,271,127,144
050,19,019,"Iowa","Buchanan County",1,3,271,143,128
050,19,019,"Iowa","Buchanan County",1,4,266,139,127
050,19,019,"Iowa","Buchanan County",1,5,276,136,140
050,19,019,"Iowa","Buchanan County",1,6,260,127,133
050,19,019,"Iowa","Buchanan County",1,7,281,139,142
050,19,019,"Iowa","Buchanan County",1,8,303,152,151
050,19,019,"Iowa","Buchanan County",1,9,284,140,144
050,19,019,"Iowa","Buchanan County",1,10,298,144,154
050,19,019,"Iowa","Buchanan County",1,11,325,165,160
050,19,019,"Iowa","Buchanan County",1,12,342,170,172
050,19,019,"Iowa","Buchanan County",1,13,337,161,176
050,19,019,"Iowa","Buchanan County",1,14,329,159,170
050,19,019,"Iowa","Buchanan County",1,15,305,157,148
050,19,019,"Iowa","Buchanan County",1,16,328,178,150
050,19,019,"Iowa","Buchanan County",1,17,310,164,146
050,19,019,"Iowa","Buchanan County",1,18,272,152,120
050,19,019,"Iowa","Buchanan County",1,19,197,114,83
050,19,019,"Iowa","Buchanan County",1,20,204,109,95
050,19,019,"Iowa","Buchanan County",1,21,190,101,89
050,19,019,"Iowa","Buchanan County",1,22,200,106,94
050,19,019,"Iowa","Buchanan County",1,23,213,118,95
050,19,019,"Iowa","Buchanan County",1,24,208,107,101
050,19,019,"Iowa","Buchanan County",1,25,202,101,101
050,19,019,"Iowa","Buchanan County",1,26,195,101,94
050,19,019,"Iowa","Buchanan County",1,27,219,104,115
050,19,019,"Iowa","Buchanan County",1,28,231,112,119
050,19,019,"Iowa","Buchanan County",1,29,216,115,101
050,19,019,"Iowa","Buchanan County",1,30,239,117,122
050,19,019,"Iowa","Buchanan County",1,31,227,119,108
050,19,019,"Iowa","Buchanan County",1,32,227,123,104
050,19,019,"Iowa","Buchanan County",1,33,232,115,117
050,19,019,"Iowa","Buchanan County",1,34,242,120,122
050,19,019,"Iowa","Buchanan County",1,35,283,148,135
050,19,019,"Iowa","Buchanan County",1,36,260,134,126
050,19,019,"Iowa","Buchanan County",1,37,258,135,123
050,19,019,"Iowa","Buchanan County",1,38,295,160,135
050,19,019,"Iowa","Buchanan County",1,39,269,128,141
050,19,019,"Iowa","Buchanan County",1,40,264,139,125
050,19,019,"Iowa","Buchanan County",1,41,268,143,125
050,19,019,"Iowa","Buchanan County",1,42,243,124,119
050,19,019,"Iowa","Buchanan County",1,43,233,117,116
050,19,019,"Iowa","Buchanan County",1,44,234,123,111
050,19,019,"Iowa","Buchanan County",1,45,239,140,99
050,19,019,"Iowa","Buchanan County",1,46,219,126,93
050,19,019,"Iowa","Buchanan County",1,47,230,115,115
050,19,019,"Iowa","Buchanan County",1,48,231,115,116
050,19,019,"Iowa","Buchanan County",1,49,229,114,115
050,19,019,"Iowa","Buchanan County",1,50,237,122,115
050,19,019,"Iowa","Buchanan County",1,51,227,115,112
050,19,019,"Iowa","Buchanan County",1,52,229,113,116
050,19,019,"Iowa","Buchanan County",1,53,240,111,129
050,19,019,"Iowa","Buchanan County",1,54,254,123,131
050,19,019,"Iowa","Buchanan County",1,55,288,136,152
050,19,019,"Iowa","Buchanan County",1,56,289,138,151
050,19,019,"Iowa","Buchanan County",1,57,287,143,144
050,19,019,"Iowa","Buchanan County",1,58,316,168,148
050,19,019,"Iowa","Buchanan County",1,59,309,156,153
050,19,019,"Iowa","Buchanan County",1,60,312,160,152
050,19,019,"Iowa","Buchanan County",1,61,295,148,147
050,19,019,"Iowa","Buchanan County",1,62,278,136,142
050,19,019,"Iowa","Buchanan County",1,63,258,127,131
050,19,019,"Iowa","Buchanan County",1,64,270,124,146
050,19,019,"Iowa","Buchanan County",1,65,271,123,148
050,19,019,"Iowa","Buchanan County",1,66,235,125,110
050,19,019,"Iowa","Buchanan County",1,67,221,111,110
050,19,019,"Iowa","Buchanan County",1,68,242,124,118
050,19,019,"Iowa","Buchanan County",1,69,225,118,107
050,19,019,"Iowa","Buchanan County",1,70,228,119,109
050,19,019,"Iowa","Buchanan County",1,71,199,104,95
050,19,019,"Iowa","Buchanan County",1,72,207,103,104
050,19,019,"Iowa","Buchanan County",1,73,200,91,109
050,19,019,"Iowa","Buchanan County",1,74,152,62,90
050,19,019,"Iowa","Buchanan County",1,75,130,54,76
050,19,019,"Iowa","Buchanan County",1,76,123,57,66
050,19,019,"Iowa","Buchanan County",1,77,133,65,68
050,19,019,"Iowa","Buchanan County",1,78,128,61,67
050,19,019,"Iowa","Buchanan County",1,79,110,47,63
050,19,019,"Iowa","Buchanan County",1,80,106,48,58
050,19,019,"Iowa","Buchanan County",1,81,91,42,49
050,19,019,"Iowa","Buchanan County",1,82,94,42,52
050,19,019,"Iowa","Buchanan County",1,83,87,43,44
050,19,019,"Iowa","Buchanan County",1,84,72,31,41
050,19,019,"Iowa","Buchanan County",1,85,418,161,257
050,19,019,"Iowa","Buchanan County",2,0,270,134,136
050,19,019,"Iowa","Buchanan County",2,1,277,139,138
050,19,019,"Iowa","Buchanan County",2,2,275,132,143
050,19,019,"Iowa","Buchanan County",2,3,271,138,133
050,19,019,"Iowa","Buchanan County",2,4,269,141,128
050,19,019,"Iowa","Buchanan County",2,5,271,136,135
050,19,019,"Iowa","Buchanan County",2,6,266,130,136
050,19,019,"Iowa","Buchanan County",2,7,277,135,142
050,19,019,"Iowa","Buchanan County",2,8,298,150,148
050,19,019,"Iowa","Buchanan County",2,9,286,142,144
050,19,019,"Iowa","Buchanan County",2,10,294,143,151
050,19,019,"Iowa","Buchanan County",2,11,320,161,159
050,19,019,"Iowa","Buchanan County",2,12,343,172,171
050,19,019,"Iowa","Buchanan County",2,13,337,163,174
050,19,019,"Iowa","Buchanan County",2,14,328,160,168
050,19,019,"Iowa","Buchanan County",2,15,312,158,154
050,19,019,"Iowa","Buchanan County",2,16,322,172,150
050,19,019,"Iowa","Buchanan County",2,17,315,169,146
050,19,019,"Iowa","Buchanan County",2,18,264,148,116
050,19,019,"Iowa","Buchanan County",2,19,202,115,87
050,19,019,"Iowa","Buchanan County",2,20,209,114,95
050,19,019,"Iowa","Buchanan County",2,21,196,104,92
050,19,019,"Iowa","Buchanan County",2,22,201,107,94
050,19,019,"Iowa","Buchanan County",2,23,214,116,98
050,19,019,"Iowa","Buchanan County",2,24,211,109,102
050,19,019,"Iowa","Buchanan County",2,25,203,102,101
050,19,019,"Iowa","Buchanan County",2,26,199,101,98
050,19,019,"Iowa","Buchanan County",2,27,215,104,111
050,19,019,"Iowa","Buchanan County",2,28,230,113,117
050,19,019,"Iowa","Buchanan County",2,29,221,116,105
050,19,019,"Iowa","Buchanan County",2,30,235,118,117
050,19,019,"Iowa","Buchanan County",2,31,231,119,112
050,19,019,"Iowa","Buchanan County",2,32,225,121,104
050,19,019,"Iowa","Buchanan County",2,33,229,116,113
050,19,019,"Iowa","Buchanan County",2,34,242,120,122
050,19,019,"Iowa","Buchanan County",2,35,277,144,133
050,19,019,"Iowa","Buchanan County",2,36,264,136,128
050,19,019,"Iowa","Buchanan County",2,37,259,135,124
050,19,019,"Iowa","Buchanan County",2,38,286,153,133
050,19,019,"Iowa","Buchanan County",2,39,272,134,138
050,19,019,"Iowa","Buchanan County",2,40,267,137,130
050,19,019,"Iowa","Buchanan County",2,41,266,141,125
050,19,019,"Iowa","Buchanan County",2,42,248,128,120
050,19,019,"Iowa","Buchanan County",2,43,236,119,117
050,19,019,"Iowa","Buchanan County",2,44,235,124,111
050,19,019,"Iowa","Buchanan County",2,45,242,139,103
050,19,019,"Iowa","Buchanan County",2,46,224,129,95
050,19,019,"Iowa","Buchanan County",2,47,227,116,111
050,19,019,"Iowa","Buchanan County",2,48,231,115,116
050,19,019,"Iowa","Buchanan County",2,49,233,116,117
050,19,019,"Iowa","Buchanan County",2,50,235,120,115
050,19,019,"Iowa","Buchanan County",2,51,228,116,112
050,19,019,"Iowa","Buchanan County",2,52,229,113,116
050,19,019,"Iowa","Buchanan County",2,53,237,111,126
050,19,019,"Iowa","Buchanan County",2,54,249,119,130
050,19,019,"Iowa","Buchanan County",2,55,281,133,148
050,19,019,"Iowa","Buchanan County",2,56,290,138,152
050,19,019,"Iowa","Buchanan County",2,57,288,142,146
050,19,019,"Iowa","Buchanan County",2,58,307,161,146
050,19,019,"Iowa","Buchanan County",2,59,314,161,153
050,19,019,"Iowa","Buchanan County",2,60,311,159,152
050,19,019,"Iowa","Buchanan County",2,61,296,150,146
050,19,019,"Iowa","Buchanan County",2,62,283,140,143
050,19,019,"Iowa","Buchanan County",2,63,266,131,135
050,19,019,"Iowa","Buchanan County",2,64,264,123,141
050,19,019,"Iowa","Buchanan County",2,65,272,124,148
050,19,019,"Iowa","Buchanan County",2,66,242,123,119
050,19,019,"Iowa","Buchanan County",2,67,225,115,110
050,19,019,"Iowa","Buchanan County",2,68,235,120,115
050,19,019,"Iowa","Buchanan County",2,69,232,121,111
050,19,019,"Iowa","Buchanan County",2,70,226,119,107
050,19,019,"Iowa","Buchanan County",2,71,207,107,100
050,19,019,"Iowa","Buchanan County",2,72,201,102,99
050,19,019,"Iowa","Buchanan County",2,73,211,98,113
050,19,019,"Iowa","Buchanan County",2,74,151,63,88
050,19,019,"Iowa","Buchanan County",2,75,135,56,79
050,19,019,"Iowa","Buchanan County",2,76,123,55,68
050,19,019,"Iowa","Buchanan County",2,77,134,64,70
050,19,019,"Iowa","Buchanan County",2,78,128,61,67
050,19,019,"Iowa","Buchanan County",2,79,112,49,63
050,19,019,"Iowa","Buchanan County",2,80,108,49,59
050,19,019,"Iowa","Buchanan County",2,81,94,43,51
050,19,019,"Iowa","Buchanan County",2,82,92,40,52
050,19,019,"Iowa","Buchanan County",2,83,88,42,46
050,19,019,"Iowa","Buchanan County",2,84,73,34,39
050,19,019,"Iowa","Buchanan County",2,85,413,157,256
050,19,019,"Iowa","Buchanan County",3,0,274,151,123
050,19,019,"Iowa","Buchanan County",3,1,266,131,135
050,19,019,"Iowa","Buchanan County",3,2,269,132,137
050,19,019,"Iowa","Buchanan County",3,3,271,130,141
050,19,019,"Iowa","Buchanan County",3,4,271,139,132
050,19,019,"Iowa","Buchanan County",3,5,274,145,129
050,19,019,"Iowa","Buchanan County",3,6,288,144,144
050,19,019,"Iowa","Buchanan County",3,7,273,133,140
050,19,019,"Iowa","Buchanan County",3,8,274,131,143
050,19,019,"Iowa","Buchanan County",3,9,291,146,145
050,19,019,"Iowa","Buchanan County",3,10,284,133,151
050,19,019,"Iowa","Buchanan County",3,11,304,148,156
050,19,019,"Iowa","Buchanan County",3,12,325,170,155
050,19,019,"Iowa","Buchanan County",3,13,344,177,167
050,19,019,"Iowa","Buchanan County",3,14,339,167,172
050,19,019,"Iowa","Buchanan County",3,15,339,176,163
050,19,019,"Iowa","Buchanan County",3,16,317,160,157
050,19,019,"Iowa","Buchanan County",3,17,325,172,153
050,19,019,"Iowa","Buchanan County",3,18,271,150,121
050,19,019,"Iowa","Buchanan County",3,19,209,120,89
050,19,019,"Iowa","Buchanan County",3,20,218,121,97
050,19,019,"Iowa","Buchanan County",3,21,216,121,95
050,19,019,"Iowa","Buchanan County",3,22,218,113,105
050,19,019,"Iowa","Buchanan County",3,23,196,97,99
050,19,019,"Iowa","Buchanan County",3,24,212,119,93
050,19,019,"Iowa","Buchanan County",3,25,196,98,98
050,19,019,"Iowa","Buchanan County",3,26,218,113,105
050,19,019,"Iowa","Buchanan County",3,27,217,111,106
050,19,019,"Iowa","Buchanan County",3,28,216,105,111
050,19,019,"Iowa","Buchanan County",3,29,230,113,117
050,19,019,"Iowa","Buchanan County",3,30,229,122,107
050,19,019,"Iowa","Buchanan County",3,31,235,116,119
050,19,019,"Iowa","Buchanan County",3,32,236,124,112
050,19,019,"Iowa","Buchanan County",3,33,221,113,108
050,19,019,"Iowa","Buchanan County",3,34,231,118,113
050,19,019,"Iowa","Buchanan County",3,35,239,122,117
050,19,019,"Iowa","Buchanan County",3,36,279,145,134
050,19,019,"Iowa","Buchanan County",3,37,254,131,123
050,19,019,"Iowa","Buchanan County",3,38,257,132,125
050,19,019,"Iowa","Buchanan County",3,39,281,150,131
050,19,019,"Iowa","Buchanan County",3,40,282,142,140
050,19,019,"Iowa","Buchanan County",3,41,279,143,136
050,19,019,"Iowa","Buchanan County",3,42,268,143,125
050,19,019,"Iowa","Buchanan County",3,43,262,130,132
050,19,019,"Iowa","Buchanan County",3,44,236,121,115
050,19,019,"Iowa","Buchanan County",3,45,239,125,114
050,19,019,"Iowa","Buchanan County",3,46,249,140,109
050,19,019,"Iowa","Buchanan County",3,47,223,126,97
050,19,019,"Iowa","Buchanan County",3,48,226,113,113
050,19,019,"Iowa","Buchanan County",3,49,235,117,118
050,19,019,"Iowa","Buchanan County",3,50,236,113,123
050,19,019,"Iowa","Buchanan County",3,51,229,118,111
050,19,019,"Iowa","Buchanan County",3,52,229,117,112
050,19,019,"Iowa","Buchanan County",3,53,233,114,119
050,19,019,"Iowa","Buchanan County",3,54,233,108,125
050,19,019,"Iowa","Buchanan County",3,55,252,121,131
050,19,019,"Iowa","Buchanan County",3,56,277,133,144
050,19,019,"Iowa","Buchanan County",3,57,285,138,147
050,19,019,"Iowa","Buchanan County",3,58,285,140,145
050,19,019,"Iowa","Buchanan County",3,59,303,156,147
050,19,019,"Iowa","Buchanan County",3,60,311,160,151
050,19,019,"Iowa","Buchanan County",3,61,303,154,149
050,19,019,"Iowa","Buchanan County",3,62,296,149,147
050,19,019,"Iowa","Buchanan County",3,63,284,142,142
050,19,019,"Iowa","Buchanan County",3,64,257,126,131
050,19,019,"Iowa","Buchanan County",3,65,258,122,136
050,19,019,"Iowa","Buchanan County",3,66,260,120,140
050,19,019,"Iowa","Buchanan County",3,67,242,124,118
050,19,019,"Iowa","Buchanan County",3,68,223,115,108
050,19,019,"Iowa","Buchanan County",3,69,228,118,110
050,19,019,"Iowa","Buchanan County",3,70,233,122,111
050,19,019,"Iowa","Buchanan County",3,71,224,115,109
050,19,019,"Iowa","Buchanan County",3,72,199,101,98
050,19,019,"Iowa","Buchanan County",3,73,194,97,97
050,19,019,"Iowa","Buchanan County",3,74,207,97,110
050,19,019,"Iowa","Buchanan County",3,75,148,63,85
050,19,019,"Iowa","Buchanan County",3,76,130,51,79
050,19,019,"Iowa","Buchanan County",3,77,117,52,65
050,19,019,"Iowa","Buchanan County",3,78,130,62,68
050,19,019,"Iowa","Buchanan County",3,79,121,59,62
050,19,019,"Iowa","Buchanan County",3,80,108,46,62
050,19,019,"Iowa","Buchanan County",3,81,98,45,53
050,19,019,"Iowa","Buchanan County",3,82,88,39,49
050,19,019,"Iowa","Buchanan County",3,83,89,34,55
050,19,019,"Iowa","Buchanan County",3,84,80,39,41
050,19,019,"Iowa","Buchanan County",3,85,407,157,250
050,19,019,"Iowa","Buchanan County",4,0,250,135,115
050,19,019,"Iowa","Buchanan County",4,1,275,150,125
050,19,019,"Iowa","Buchanan County",4,2,270,133,137
050,19,019,"Iowa","Buchanan County",4,3,269,131,138
050,19,019,"Iowa","Buchanan County",4,4,290,132,158
050,19,019,"Iowa","Buchanan County",4,5,264,136,128
050,19,019,"Iowa","Buchanan County",4,6,270,144,126
050,19,019,"Iowa","Buchanan County",4,7,280,139,141
050,19,019,"Iowa","Buchanan County",4,8,255,128,127
050,19,019,"Iowa","Buchanan County",4,9,286,136,150
050,19,019,"Iowa","Buchanan County",4,10,305,150,155
050,19,019,"Iowa","Buchanan County",4,11,280,134,146
050,19,019,"Iowa","Buchanan County",4,12,312,158,154
050,19,019,"Iowa","Buchanan County",4,13,322,172,150
050,19,019,"Iowa","Buchanan County",4,14,350,172,178
050,19,019,"Iowa","Buchanan County",4,15,341,168,173
050,19,019,"Iowa","Buchanan County",4,16,338,172,166
050,19,019,"Iowa","Buchanan County",4,17,329,164,165
050,19,019,"Iowa","Buchanan County",4,18,268,147,121
050,19,019,"Iowa","Buchanan County",4,19,198,111,87
050,19,019,"Iowa","Buchanan County",4,20,213,118,95
050,19,019,"Iowa","Buchanan County",4,21,221,125,96
050,19,019,"Iowa","Buchanan County",4,22,228,125,103
050,19,019,"Iowa","Buchanan County",4,23,199,111,88
050,19,019,"Iowa","Buchanan County",4,24,212,111,101
050,19,019,"Iowa","Buchanan County",4,25,212,119,93
050,19,019,"Iowa","Buchanan County",4,26,208,102,106
050,19,019,"Iowa","Buchanan County",4,27,204,100,104
050,19,019,"Iowa","Buchanan County",4,28,234,120,114
050,19,019,"Iowa","Buchanan County",4,29,212,103,109
050,19,019,"Iowa","Buchanan County",4,30,234,115,119
050,19,019,"Iowa","Buchanan County",4,31,236,121,115
050,19,019,"Iowa","Buchanan County",4,32,226,106,120
050,19,019,"Iowa","Buchanan County",4,33,236,124,112
050,19,019,"Iowa","Buchanan County",4,34,224,117,107
050,19,019,"Iowa","Buchanan County",4,35,240,117,123
050,19,019,"Iowa","Buchanan County",4,36,244,124,120
050,19,019,"Iowa","Buchanan County",4,37,274,143,131
050,19,019,"Iowa","Buchanan County",4,38,256,136,120
050,19,019,"Iowa","Buchanan County",4,39,255,132,123
050,19,019,"Iowa","Buchanan County",4,40,279,150,129
050,19,019,"Iowa","Buchanan County",4,41,287,144,143
050,19,019,"Iowa","Buchanan County",4,42,281,140,141
050,19,019,"Iowa","Buchanan County",4,43,265,142,123
050,19,019,"Iowa","Buchanan County",4,44,262,131,131
050,19,019,"Iowa","Buchanan County",4,45,235,123,112
050,19,019,"Iowa","Buchanan County",4,46,245,130,115
050,19,019,"Iowa","Buchanan County",4,47,241,141,100
050,19,019,"Iowa","Buchanan County",4,48,221,124,97
050,19,019,"Iowa","Buchanan County",4,49,225,113,112
050,19,019,"Iowa","Buchanan County",4,50,234,116,118
050,19,019,"Iowa","Buchanan County",4,51,231,114,117
050,19,019,"Iowa","Buchanan County",4,52,236,122,114
050,19,019,"Iowa","Buchanan County",4,53,230,118,112
050,19,019,"Iowa","Buchanan County",4,54,238,116,122
050,19,019,"Iowa","Buchanan County",4,55,236,108,128
050,19,019,"Iowa","Buchanan County",4,56,253,121,132
050,19,019,"Iowa","Buchanan County",4,57,278,133,145
050,19,019,"Iowa","Buchanan County",4,58,281,139,142
050,19,019,"Iowa","Buchanan County",4,59,276,134,142
050,19,019,"Iowa","Buchanan County",4,60,301,156,145
050,19,019,"Iowa","Buchanan County",4,61,306,158,148
050,19,019,"Iowa","Buchanan County",4,62,296,150,146
050,19,019,"Iowa","Buchanan County",4,63,292,147,145
050,19,019,"Iowa","Buchanan County",4,64,276,138,138
050,19,019,"Iowa","Buchanan County",4,65,257,124,133
050,19,019,"Iowa","Buchanan County",4,66,259,121,138
050,19,019,"Iowa","Buchanan County",4,67,263,124,139
050,19,019,"Iowa","Buchanan County",4,68,241,123,118
050,19,019,"Iowa","Buchanan County",4,69,219,110,109
050,19,019,"Iowa","Buchanan County",4,70,221,111,110
050,19,019,"Iowa","Buchanan County",4,71,222,114,108
050,19,019,"Iowa","Buchanan County",4,72,219,114,105
050,19,019,"Iowa","Buchanan County",4,73,193,93,100
050,19,019,"Iowa","Buchanan County",4,74,190,95,95
050,19,019,"Iowa","Buchanan County",4,75,194,89,105
050,19,019,"Iowa","Buchanan County",4,76,142,59,83
050,19,019,"Iowa","Buchanan County",4,77,123,46,77
050,19,019,"Iowa","Buchanan County",4,78,113,51,62
050,19,019,"Iowa","Buchanan County",4,79,120,57,63
050,19,019,"Iowa","Buchanan County",4,80,121,55,66
050,19,019,"Iowa","Buchanan County",4,81,99,43,56
050,19,019,"Iowa","Buchanan County",4,82,96,44,52
050,19,019,"Iowa","Buchanan County",4,83,80,34,46
050,19,019,"Iowa","Buchanan County",4,84,75,23,52
050,19,019,"Iowa","Buchanan County",4,85,417,170,247
050,19,019,"Iowa","Buchanan County",5,0,252,138,114
050,19,019,"Iowa","Buchanan County",5,1,251,135,116
050,19,019,"Iowa","Buchanan County",5,2,287,158,129
050,19,019,"Iowa","Buchanan County",5,3,269,132,137
050,19,019,"Iowa","Buchanan County",5,4,269,128,141
050,19,019,"Iowa","Buchanan County",5,5,282,128,154
050,19,019,"Iowa","Buchanan County",5,6,258,133,125
050,19,019,"Iowa","Buchanan County",5,7,275,149,126
050,19,019,"Iowa","Buchanan County",5,8,286,150,136
050,19,019,"Iowa","Buchanan County",5,9,254,123,131
050,19,019,"Iowa","Buchanan County",5,10,288,137,151
050,19,019,"Iowa","Buchanan County",5,11,307,151,156
050,19,019,"Iowa","Buchanan County",5,12,293,144,149
050,19,019,"Iowa","Buchanan County",5,13,312,152,160
050,19,019,"Iowa","Buchanan County",5,14,325,175,150
050,19,019,"Iowa","Buchanan County",5,15,350,174,176
050,19,019,"Iowa","Buchanan County",5,16,335,161,174
050,19,019,"Iowa","Buchanan County",5,17,339,174,165
050,19,019,"Iowa","Buchanan County",5,18,253,128,125
050,19,019,"Iowa","Buchanan County",5,19,201,108,93
050,19,019,"Iowa","Buchanan County",5,20,214,117,97
050,19,019,"Iowa","Buchanan County",5,21,213,116,97
050,19,019,"Iowa","Buchanan County",5,22,226,122,104
050,19,019,"Iowa","Buchanan County",5,23,236,135,101
050,19,019,"Iowa","Buchanan County",5,24,186,106,80
050,19,019,"Iowa","Buchanan County",5,25,206,105,101
050,19,019,"Iowa","Buchanan County",5,26,204,108,96
050,19,019,"Iowa","Buchanan County",5,27,216,109,107
050,19,019,"Iowa","Buchanan County",5,28,220,107,113
050,19,019,"Iowa","Buchanan County",5,29,221,110,111
050,19,019,"Iowa","Buchanan County",5,30,211,103,108
050,19,019,"Iowa","Buchanan County",5,31,255,126,129
050,19,019,"Iowa","Buchanan County",5,32,243,123,120
050,19,019,"Iowa","Buchanan County",5,33,237,110,127
050,19,019,"Iowa","Buchanan County",5,34,237,127,110
050,19,019,"Iowa","Buchanan County",5,35,233,123,110
050,19,019,"Iowa","Buchanan County",5,36,237,116,121
050,19,019,"Iowa","Buchanan County",5,37,249,128,121
050,19,019,"Iowa","Buchanan County",5,38,271,145,126
050,19,019,"Iowa","Buchanan County",5,39,256,137,119
050,19,019,"Iowa","Buchanan County",5,40,252,127,125
050,19,019,"Iowa","Buchanan County",5,41,285,153,132
050,19,019,"Iowa","Buchanan County",5,42,283,146,137
050,19,019,"Iowa","Buchanan County",5,43,284,143,141
050,19,019,"Iowa","Buchanan County",5,44,268,143,125
050,19,019,"Iowa","Buchanan County",5,45,260,129,131
050,19,019,"Iowa","Buchanan County",5,46,237,124,113
050,19,019,"Iowa","Buchanan County",5,47,235,123,112
050,19,019,"Iowa","Buchanan County",5,48,240,137,103
050,19,019,"Iowa","Buchanan County",5,49,221,124,97
050,19,019,"Iowa","Buchanan County",5,50,229,116,113
050,19,019,"Iowa","Buchanan County",5,51,224,111,113
050,19,019,"Iowa","Buchanan County",5,52,234,115,119
050,19,019,"Iowa","Buchanan County",5,53,239,123,116
050,19,019,"Iowa","Buchanan County",5,54,235,125,110
050,19,019,"Iowa","Buchanan County",5,55,242,117,125
050,19,019,"Iowa","Buchanan County",5,56,237,110,127
050,19,019,"Iowa","Buchanan County",5,57,251,120,131
050,19,019,"Iowa","Buchanan County",5,58,279,134,145
050,19,019,"Iowa","Buchanan County",5,59,290,141,149
050,19,019,"Iowa","Buchanan County",5,60,270,130,140
050,19,019,"Iowa","Buchanan County",5,61,301,154,147
050,19,019,"Iowa","Buchanan County",5,62,313,162,151
050,19,019,"Iowa","Buchanan County",5,63,296,151,145
050,19,019,"Iowa","Buchanan County",5,64,294,147,147
050,19,019,"Iowa","Buchanan County",5,65,271,135,136
050,19,019,"Iowa","Buchanan County",5,66,258,123,135
050,19,019,"Iowa","Buchanan County",5,67,255,119,136
050,19,019,"Iowa","Buchanan County",5,68,258,120,138
050,19,019,"Iowa","Buchanan County",5,69,235,120,115
050,19,019,"Iowa","Buchanan County",5,70,215,106,109
050,19,019,"Iowa","Buchanan County",5,71,212,103,109
050,19,019,"Iowa","Buchanan County",5,72,221,116,105
050,19,019,"Iowa","Buchanan County",5,73,211,108,103
050,19,019,"Iowa","Buchanan County",5,74,188,90,98
050,19,019,"Iowa","Buchanan County",5,75,177,90,87
050,19,019,"Iowa","Buchanan County",5,76,186,82,104
050,19,019,"Iowa","Buchanan County",5,77,135,57,78
050,19,019,"Iowa","Buchanan County",5,78,115,45,70
050,19,019,"Iowa","Buchanan County",5,79,109,49,60
050,19,019,"Iowa","Buchanan County",5,80,114,51,63
050,19,019,"Iowa","Buchanan County",5,81,112,50,62
050,19,019,"Iowa","Buchanan County",5,82,96,40,56
050,19,019,"Iowa","Buchanan County",5,83,91,40,51
050,19,019,"Iowa","Buchanan County",5,84,66,26,40
050,19,019,"Iowa","Buchanan County",5,85,410,164,246
050,19,021,"Iowa","Buena Vista County",1,0,304,161,143
050,19,021,"Iowa","Buena Vista County",1,1,316,165,151
050,19,021,"Iowa","Buena Vista County",1,2,304,165,139
050,19,021,"Iowa","Buena Vista County",1,3,314,172,142
050,19,021,"Iowa","Buena Vista County",1,4,308,157,151
050,19,021,"Iowa","Buena Vista County",1,5,314,164,150
050,19,021,"Iowa","Buena Vista County",1,6,335,169,166
050,19,021,"Iowa","Buena Vista County",1,7,328,151,177
050,19,021,"Iowa","Buena Vista County",1,8,284,141,143
050,19,021,"Iowa","Buena Vista County",1,9,303,156,147
050,19,021,"Iowa","Buena Vista County",1,10,310,162,148
050,19,021,"Iowa","Buena Vista County",1,11,302,155,147
050,19,021,"Iowa","Buena Vista County",1,12,315,160,155
050,19,021,"Iowa","Buena Vista County",1,13,301,153,148
050,19,021,"Iowa","Buena Vista County",1,14,303,155,148
050,19,021,"Iowa","Buena Vista County",1,15,331,186,145
050,19,021,"Iowa","Buena Vista County",1,16,336,195,141
050,19,021,"Iowa","Buena Vista County",1,17,319,178,141
050,19,021,"Iowa","Buena Vista County",1,18,310,167,143
050,19,021,"Iowa","Buena Vista County",1,19,341,187,154
050,19,021,"Iowa","Buena Vista County",1,20,326,173,153
050,19,021,"Iowa","Buena Vista County",1,21,301,134,167
050,19,021,"Iowa","Buena Vista County",1,22,298,155,143
050,19,021,"Iowa","Buena Vista County",1,23,246,111,135
050,19,021,"Iowa","Buena Vista County",1,24,235,102,133
050,19,021,"Iowa","Buena Vista County",1,25,235,107,128
050,19,021,"Iowa","Buena Vista County",1,26,259,132,127
050,19,021,"Iowa","Buena Vista County",1,27,292,152,140
050,19,021,"Iowa","Buena Vista County",1,28,253,123,130
050,19,021,"Iowa","Buena Vista County",1,29,233,126,107
050,19,021,"Iowa","Buena Vista County",1,30,241,127,114
050,19,021,"Iowa","Buena Vista County",1,31,242,135,107
050,19,021,"Iowa","Buena Vista County",1,32,258,137,121
050,19,021,"Iowa","Buena Vista County",1,33,279,136,143
050,19,021,"Iowa","Buena Vista County",1,34,275,151,124
050,19,021,"Iowa","Buena Vista County",1,35,260,145,115
050,19,021,"Iowa","Buena Vista County",1,36,285,167,118
050,19,021,"Iowa","Buena Vista County",1,37,309,163,146
050,19,021,"Iowa","Buena Vista County",1,38,280,145,135
050,19,021,"Iowa","Buena Vista County",1,39,233,121,112
050,19,021,"Iowa","Buena Vista County",1,40,235,132,103
050,19,021,"Iowa","Buena Vista County",1,41,232,128,104
050,19,021,"Iowa","Buena Vista County",1,42,223,120,103
050,19,021,"Iowa","Buena Vista County",1,43,219,117,102
050,19,021,"Iowa","Buena Vista County",1,44,208,114,94
050,19,021,"Iowa","Buena Vista County",1,45,198,99,99
050,19,021,"Iowa","Buena Vista County",1,46,199,98,101
050,19,021,"Iowa","Buena Vista County",1,47,195,100,95
050,19,021,"Iowa","Buena Vista County",1,48,207,103,104
050,19,021,"Iowa","Buena Vista County",1,49,225,111,114
050,19,021,"Iowa","Buena Vista County",1,50,196,106,90
050,19,021,"Iowa","Buena Vista County",1,51,217,111,106
050,19,021,"Iowa","Buena Vista County",1,52,234,120,114
050,19,021,"Iowa","Buena Vista County",1,53,215,107,108
050,19,021,"Iowa","Buena Vista County",1,54,218,108,110
050,19,021,"Iowa","Buena Vista County",1,55,243,122,121
050,19,021,"Iowa","Buena Vista County",1,56,247,132,115
050,19,021,"Iowa","Buena Vista County",1,57,248,125,123
050,19,021,"Iowa","Buena Vista County",1,58,263,129,134
050,19,021,"Iowa","Buena Vista County",1,59,261,136,125
050,19,021,"Iowa","Buena Vista County",1,60,287,138,149
050,19,021,"Iowa","Buena Vista County",1,61,303,154,149
050,19,021,"Iowa","Buena Vista County",1,62,293,150,143
050,19,021,"Iowa","Buena Vista County",1,63,255,129,126
050,19,021,"Iowa","Buena Vista County",1,64,234,120,114
050,19,021,"Iowa","Buena Vista County",1,65,230,132,98
050,19,021,"Iowa","Buena Vista County",1,66,245,131,114
050,19,021,"Iowa","Buena Vista County",1,67,228,127,101
050,19,021,"Iowa","Buena Vista County",1,68,227,118,109
050,19,021,"Iowa","Buena Vista County",1,69,206,97,109
050,19,021,"Iowa","Buena Vista County",1,70,178,87,91
050,19,021,"Iowa","Buena Vista County",1,71,156,81,75
050,19,021,"Iowa","Buena Vista County",1,72,167,88,79
050,19,021,"Iowa","Buena Vista County",1,73,162,79,83
050,19,021,"Iowa","Buena Vista County",1,74,113,56,57
050,19,021,"Iowa","Buena Vista County",1,75,105,52,53
050,19,021,"Iowa","Buena Vista County",1,76,103,43,60
050,19,021,"Iowa","Buena Vista County",1,77,116,56,60
050,19,021,"Iowa","Buena Vista County",1,78,96,48,48
050,19,021,"Iowa","Buena Vista County",1,79,89,42,47
050,19,021,"Iowa","Buena Vista County",1,80,85,36,49
050,19,021,"Iowa","Buena Vista County",1,81,80,33,47
050,19,021,"Iowa","Buena Vista County",1,82,79,37,42
050,19,021,"Iowa","Buena Vista County",1,83,75,34,41
050,19,021,"Iowa","Buena Vista County",1,84,72,33,39
050,19,021,"Iowa","Buena Vista County",1,85,540,182,358
050,19,021,"Iowa","Buena Vista County",2,0,289,155,134
050,19,021,"Iowa","Buena Vista County",2,1,313,165,148
050,19,021,"Iowa","Buena Vista County",2,2,311,168,143
050,19,021,"Iowa","Buena Vista County",2,3,315,171,144
050,19,021,"Iowa","Buena Vista County",2,4,313,162,151
050,19,021,"Iowa","Buena Vista County",2,5,317,165,152
050,19,021,"Iowa","Buena Vista County",2,6,336,170,166
050,19,021,"Iowa","Buena Vista County",2,7,329,154,175
050,19,021,"Iowa","Buena Vista County",2,8,296,145,151
050,19,021,"Iowa","Buena Vista County",2,9,298,152,146
050,19,021,"Iowa","Buena Vista County",2,10,307,160,147
050,19,021,"Iowa","Buena Vista County",2,11,302,156,146
050,19,021,"Iowa","Buena Vista County",2,12,314,161,153
050,19,021,"Iowa","Buena Vista County",2,13,303,155,148
050,19,021,"Iowa","Buena Vista County",2,14,302,154,148
050,19,021,"Iowa","Buena Vista County",2,15,325,178,147
050,19,021,"Iowa","Buena Vista County",2,16,334,192,142
050,19,021,"Iowa","Buena Vista County",2,17,323,182,141
050,19,021,"Iowa","Buena Vista County",2,18,311,169,142
050,19,021,"Iowa","Buena Vista County",2,19,347,189,158
050,19,021,"Iowa","Buena Vista County",2,20,328,176,152
050,19,021,"Iowa","Buena Vista County",2,21,302,138,164
050,19,021,"Iowa","Buena Vista County",2,22,290,148,142
050,19,021,"Iowa","Buena Vista County",2,23,243,113,130
050,19,021,"Iowa","Buena Vista County",2,24,237,104,133
050,19,021,"Iowa","Buena Vista County",2,25,234,106,128
050,19,021,"Iowa","Buena Vista County",2,26,259,131,128
050,19,021,"Iowa","Buena Vista County",2,27,282,146,136
050,19,021,"Iowa","Buena Vista County",2,28,261,130,131
050,19,021,"Iowa","Buena Vista County",2,29,237,124,113
050,19,021,"Iowa","Buena Vista County",2,30,243,130,113
050,19,021,"Iowa","Buena Vista County",2,31,240,132,108
050,19,021,"Iowa","Buena Vista County",2,32,255,136,119
050,19,021,"Iowa","Buena Vista County",2,33,276,138,138
050,19,021,"Iowa","Buena Vista County",2,34,275,146,129
050,19,021,"Iowa","Buena Vista County",2,35,264,147,117
050,19,021,"Iowa","Buena Vista County",2,36,276,159,117
050,19,021,"Iowa","Buena Vista County",2,37,305,166,139
050,19,021,"Iowa","Buena Vista County",2,38,287,150,137
050,19,021,"Iowa","Buena Vista County",2,39,243,126,117
050,19,021,"Iowa","Buena Vista County",2,40,237,133,104
050,19,021,"Iowa","Buena Vista County",2,41,232,130,102
050,19,021,"Iowa","Buena Vista County",2,42,224,123,101
050,19,021,"Iowa","Buena Vista County",2,43,222,119,103
050,19,021,"Iowa","Buena Vista County",2,44,210,115,95
050,19,021,"Iowa","Buena Vista County",2,45,201,103,98
050,19,021,"Iowa","Buena Vista County",2,46,196,97,99
050,19,021,"Iowa","Buena Vista County",2,47,193,97,96
050,19,021,"Iowa","Buena Vista County",2,48,205,102,103
050,19,021,"Iowa","Buena Vista County",2,49,220,108,112
050,19,021,"Iowa","Buena Vista County",2,50,202,106,96
050,19,021,"Iowa","Buena Vista County",2,51,212,110,102
050,19,021,"Iowa","Buena Vista County",2,52,230,118,112
050,19,021,"Iowa","Buena Vista County",2,53,220,112,108
050,19,021,"Iowa","Buena Vista County",2,54,216,108,108
050,19,021,"Iowa","Buena Vista County",2,55,236,118,118
050,19,021,"Iowa","Buena Vista County",2,56,242,129,113
050,19,021,"Iowa","Buena Vista County",2,57,247,126,121
050,19,021,"Iowa","Buena Vista County",2,58,259,129,130
050,19,021,"Iowa","Buena Vista County",2,59,263,135,128
050,19,021,"Iowa","Buena Vista County",2,60,276,134,142
050,19,021,"Iowa","Buena Vista County",2,61,296,148,148
050,19,021,"Iowa","Buena Vista County",2,62,294,149,145
050,19,021,"Iowa","Buena Vista County",2,63,267,135,132
050,19,021,"Iowa","Buena Vista County",2,64,234,120,114
050,19,021,"Iowa","Buena Vista County",2,65,229,128,101
050,19,021,"Iowa","Buena Vista County",2,66,239,130,109
050,19,021,"Iowa","Buena Vista County",2,67,227,125,102
050,19,021,"Iowa","Buena Vista County",2,68,222,117,105
050,19,021,"Iowa","Buena Vista County",2,69,212,103,109
050,19,021,"Iowa","Buena Vista County",2,70,182,87,95
050,19,021,"Iowa","Buena Vista County",2,71,161,83,78
050,19,021,"Iowa","Buena Vista County",2,72,161,84,77
050,19,021,"Iowa","Buena Vista County",2,73,168,84,84
050,19,021,"Iowa","Buena Vista County",2,74,116,58,58
050,19,021,"Iowa","Buena Vista County",2,75,105,51,54
050,19,021,"Iowa","Buena Vista County",2,76,101,44,57
050,19,021,"Iowa","Buena Vista County",2,77,117,55,62
050,19,021,"Iowa","Buena Vista County",2,78,99,49,50
050,19,021,"Iowa","Buena Vista County",2,79,90,43,47
050,19,021,"Iowa","Buena Vista County",2,80,85,35,50
050,19,021,"Iowa","Buena Vista County",2,81,81,34,47
050,19,021,"Iowa","Buena Vista County",2,82,81,37,44
050,19,021,"Iowa","Buena Vista County",2,83,73,33,40
050,19,021,"Iowa","Buena Vista County",2,84,71,32,39
050,19,021,"Iowa","Buena Vista County",2,85,530,180,350
050,19,021,"Iowa","Buena Vista County",3,0,307,176,131
050,19,021,"Iowa","Buena Vista County",3,1,280,145,135
050,19,021,"Iowa","Buena Vista County",3,2,315,168,147
050,19,021,"Iowa","Buena Vista County",3,3,306,165,141
050,19,021,"Iowa","Buena Vista County",3,4,294,166,128
050,19,021,"Iowa","Buena Vista County",3,5,318,166,152
050,19,021,"Iowa","Buena Vista County",3,6,299,156,143
050,19,021,"Iowa","Buena Vista County",3,7,348,169,179
050,19,021,"Iowa","Buena Vista County",3,8,309,152,157
050,19,021,"Iowa","Buena Vista County",3,9,302,150,152
050,19,021,"Iowa","Buena Vista County",3,10,297,154,143
050,19,021,"Iowa","Buena Vista County",3,11,310,163,147
050,19,021,"Iowa","Buena Vista County",3,12,303,153,150
050,19,021,"Iowa","Buena Vista County",3,13,318,161,157
050,19,021,"Iowa","Buena Vista County",3,14,307,161,146
050,19,021,"Iowa","Buena Vista County",3,15,314,159,155
050,19,021,"Iowa","Buena Vista County",3,16,338,192,146
050,19,021,"Iowa","Buena Vista County",3,17,336,185,151
050,19,021,"Iowa","Buena Vista County",3,18,328,182,146
050,19,021,"Iowa","Buena Vista County",3,19,364,202,162
050,19,021,"Iowa","Buena Vista County",3,20,323,178,145
050,19,021,"Iowa","Buena Vista County",3,21,327,160,167
050,19,021,"Iowa","Buena Vista County",3,22,275,142,133
050,19,021,"Iowa","Buena Vista County",3,23,229,104,125
050,19,021,"Iowa","Buena Vista County",3,24,233,100,133
050,19,021,"Iowa","Buena Vista County",3,25,234,110,124
050,19,021,"Iowa","Buena Vista County",3,26,249,120,129
050,19,021,"Iowa","Buena Vista County",3,27,236,116,120
050,19,021,"Iowa","Buena Vista County",3,28,279,149,130
050,19,021,"Iowa","Buena Vista County",3,29,247,125,122
050,19,021,"Iowa","Buena Vista County",3,30,225,114,111
050,19,021,"Iowa","Buena Vista County",3,31,239,133,106
050,19,021,"Iowa","Buena Vista County",3,32,250,137,113
050,19,021,"Iowa","Buena Vista County",3,33,254,137,117
050,19,021,"Iowa","Buena Vista County",3,34,269,132,137
050,19,021,"Iowa","Buena Vista County",3,35,273,144,129
050,19,021,"Iowa","Buena Vista County",3,36,268,148,120
050,19,021,"Iowa","Buena Vista County",3,37,283,162,121
050,19,021,"Iowa","Buena Vista County",3,38,307,169,138
050,19,021,"Iowa","Buena Vista County",3,39,296,160,136
050,19,021,"Iowa","Buena Vista County",3,40,251,132,119
050,19,021,"Iowa","Buena Vista County",3,41,239,135,104
050,19,021,"Iowa","Buena Vista County",3,42,232,130,102
050,19,021,"Iowa","Buena Vista County",3,43,229,129,100
050,19,021,"Iowa","Buena Vista County",3,44,230,122,108
050,19,021,"Iowa","Buena Vista County",3,45,206,110,96
050,19,021,"Iowa","Buena Vista County",3,46,193,95,98
050,19,021,"Iowa","Buena Vista County",3,47,200,99,101
050,19,021,"Iowa","Buena Vista County",3,48,199,104,95
050,19,021,"Iowa","Buena Vista County",3,49,203,99,104
050,19,021,"Iowa","Buena Vista County",3,50,219,111,108
050,19,021,"Iowa","Buena Vista County",3,51,195,104,91
050,19,021,"Iowa","Buena Vista County",3,52,209,109,100
050,19,021,"Iowa","Buena Vista County",3,53,228,115,113
050,19,021,"Iowa","Buena Vista County",3,54,225,114,111
050,19,021,"Iowa","Buena Vista County",3,55,219,110,109
050,19,021,"Iowa","Buena Vista County",3,56,232,117,115
050,19,021,"Iowa","Buena Vista County",3,57,243,130,113
050,19,021,"Iowa","Buena Vista County",3,58,243,124,119
050,19,021,"Iowa","Buena Vista County",3,59,255,129,126
050,19,021,"Iowa","Buena Vista County",3,60,254,126,128
050,19,021,"Iowa","Buena Vista County",3,61,273,131,142
050,19,021,"Iowa","Buena Vista County",3,62,286,145,141
050,19,021,"Iowa","Buena Vista County",3,63,292,151,141
050,19,021,"Iowa","Buena Vista County",3,64,265,134,131
050,19,021,"Iowa","Buena Vista County",3,65,234,124,110
050,19,021,"Iowa","Buena Vista County",3,66,224,124,100
050,19,021,"Iowa","Buena Vista County",3,67,234,123,111
050,19,021,"Iowa","Buena Vista County",3,68,218,123,95
050,19,021,"Iowa","Buena Vista County",3,69,215,111,104
050,19,021,"Iowa","Buena Vista County",3,70,203,99,104
050,19,021,"Iowa","Buena Vista County",3,71,175,85,90
050,19,021,"Iowa","Buena Vista County",3,72,161,82,79
050,19,021,"Iowa","Buena Vista County",3,73,153,80,73
050,19,021,"Iowa","Buena Vista County",3,74,155,78,77
050,19,021,"Iowa","Buena Vista County",3,75,114,59,55
050,19,021,"Iowa","Buena Vista County",3,76,102,50,52
050,19,021,"Iowa","Buena Vista County",3,77,95,40,55
050,19,021,"Iowa","Buena Vista County",3,78,109,53,56
050,19,021,"Iowa","Buena Vista County",3,79,98,47,51
050,19,021,"Iowa","Buena Vista County",3,80,82,37,45
050,19,021,"Iowa","Buena Vista County",3,81,82,36,46
050,19,021,"Iowa","Buena Vista County",3,82,80,35,45
050,19,021,"Iowa","Buena Vista County",3,83,78,33,45
050,19,021,"Iowa","Buena Vista County",3,84,70,29,41
050,19,021,"Iowa","Buena Vista County",3,85,499,169,330
050,19,021,"Iowa","Buena Vista County",4,0,293,144,149
050,19,021,"Iowa","Buena Vista County",4,1,296,169,127
050,19,021,"Iowa","Buena Vista County",4,2,279,149,130
050,19,021,"Iowa","Buena Vista County",4,3,312,164,148
050,19,021,"Iowa","Buena Vista County",4,4,307,162,145
050,19,021,"Iowa","Buena Vista County",4,5,299,162,137
050,19,021,"Iowa","Buena Vista County",4,6,307,160,147
050,19,021,"Iowa","Buena Vista County",4,7,297,153,144
050,19,021,"Iowa","Buena Vista County",4,8,333,164,169
050,19,021,"Iowa","Buena Vista County",4,9,311,148,163
050,19,021,"Iowa","Buena Vista County",4,10,303,150,153
050,19,021,"Iowa","Buena Vista County",4,11,295,153,142
050,19,021,"Iowa","Buena Vista County",4,12,313,166,147
050,19,021,"Iowa","Buena Vista County",4,13,290,147,143
050,19,021,"Iowa","Buena Vista County",4,14,313,160,153
050,19,021,"Iowa","Buena Vista County",4,15,316,166,150
050,19,021,"Iowa","Buena Vista County",4,16,302,154,148
050,19,021,"Iowa","Buena Vista County",4,17,334,189,145
050,19,021,"Iowa","Buena Vista County",4,18,353,197,156
050,19,021,"Iowa","Buena Vista County",4,19,384,216,168
050,19,021,"Iowa","Buena Vista County",4,20,357,203,154
050,19,021,"Iowa","Buena Vista County",4,21,323,160,163
050,19,021,"Iowa","Buena Vista County",4,22,300,158,142
050,19,021,"Iowa","Buena Vista County",4,23,227,112,115
050,19,021,"Iowa","Buena Vista County",4,24,198,94,104
050,19,021,"Iowa","Buena Vista County",4,25,234,105,129
050,19,021,"Iowa","Buena Vista County",4,26,260,134,126
050,19,021,"Iowa","Buena Vista County",4,27,237,114,123
050,19,021,"Iowa","Buena Vista County",4,28,225,113,112
050,19,021,"Iowa","Buena Vista County",4,29,282,148,134
050,19,021,"Iowa","Buena Vista County",4,30,257,130,127
050,19,021,"Iowa","Buena Vista County",4,31,210,108,102
050,19,021,"Iowa","Buena Vista County",4,32,226,128,98
050,19,021,"Iowa","Buena Vista County",4,33,253,136,117
050,19,021,"Iowa","Buena Vista County",4,34,252,132,120
050,19,021,"Iowa","Buena Vista County",4,35,263,129,134
050,19,021,"Iowa","Buena Vista County",4,36,266,139,127
050,19,021,"Iowa","Buena Vista County",4,37,262,141,121
050,19,021,"Iowa","Buena Vista County",4,38,277,154,123
050,19,021,"Iowa","Buena Vista County",4,39,296,160,136
050,19,021,"Iowa","Buena Vista County",4,40,290,156,134
050,19,021,"Iowa","Buena Vista County",4,41,229,120,109
050,19,021,"Iowa","Buena Vista County",4,42,230,125,105
050,19,021,"Iowa","Buena Vista County",4,43,229,127,102
050,19,021,"Iowa","Buena Vista County",4,44,226,128,98
050,19,021,"Iowa","Buena Vista County",4,45,225,116,109
050,19,021,"Iowa","Buena Vista County",4,46,208,107,101
050,19,021,"Iowa","Buena Vista County",4,47,201,104,97
050,19,021,"Iowa","Buena Vista County",4,48,196,101,95
050,19,021,"Iowa","Buena Vista County",4,49,191,100,91
050,19,021,"Iowa","Buena Vista County",4,50,201,99,102
050,19,021,"Iowa","Buena Vista County",4,51,222,111,111
050,19,021,"Iowa","Buena Vista County",4,52,208,113,95
050,19,021,"Iowa","Buena Vista County",4,53,203,108,95
050,19,021,"Iowa","Buena Vista County",4,54,227,111,116
050,19,021,"Iowa","Buena Vista County",4,55,229,116,113
050,19,021,"Iowa","Buena Vista County",4,56,208,102,106
050,19,021,"Iowa","Buena Vista County",4,57,225,113,112
050,19,021,"Iowa","Buena Vista County",4,58,244,125,119
050,19,021,"Iowa","Buena Vista County",4,59,227,117,110
050,19,021,"Iowa","Buena Vista County",4,60,243,122,121
050,19,021,"Iowa","Buena Vista County",4,61,250,123,127
050,19,021,"Iowa","Buena Vista County",4,62,266,130,136
050,19,021,"Iowa","Buena Vista County",4,63,282,138,144
050,19,021,"Iowa","Buena Vista County",4,64,280,141,139
050,19,021,"Iowa","Buena Vista County",4,65,259,138,121
050,19,021,"Iowa","Buena Vista County",4,66,237,125,112
050,19,021,"Iowa","Buena Vista County",4,67,222,116,106
050,19,021,"Iowa","Buena Vista County",4,68,229,123,106
050,19,021,"Iowa","Buena Vista County",4,69,216,121,95
050,19,021,"Iowa","Buena Vista County",4,70,209,106,103
050,19,021,"Iowa","Buena Vista County",4,71,201,99,102
050,19,021,"Iowa","Buena Vista County",4,72,172,81,91
050,19,021,"Iowa","Buena Vista County",4,73,159,79,80
050,19,021,"Iowa","Buena Vista County",4,74,152,79,73
050,19,021,"Iowa","Buena Vista County",4,75,141,72,69
050,19,021,"Iowa","Buena Vista County",4,76,108,56,52
050,19,021,"Iowa","Buena Vista County",4,77,100,50,50
050,19,021,"Iowa","Buena Vista County",4,78,81,34,47
050,19,021,"Iowa","Buena Vista County",4,79,107,51,56
050,19,021,"Iowa","Buena Vista County",4,80,93,44,49
050,19,021,"Iowa","Buena Vista County",4,81,77,34,43
050,19,021,"Iowa","Buena Vista County",4,82,84,39,45
050,19,021,"Iowa","Buena Vista County",4,83,72,30,42
050,19,021,"Iowa","Buena Vista County",4,84,74,29,45
050,19,021,"Iowa","Buena Vista County",4,85,469,159,310
050,19,021,"Iowa","Buena Vista County",5,0,299,148,151
050,19,021,"Iowa","Buena Vista County",5,1,271,128,143
050,19,021,"Iowa","Buena Vista County",5,2,293,170,123
050,19,021,"Iowa","Buena Vista County",5,3,275,148,127
050,19,021,"Iowa","Buena Vista County",5,4,314,164,150
050,19,021,"Iowa","Buena Vista County",5,5,298,152,146
050,19,021,"Iowa","Buena Vista County",5,6,291,160,131
050,19,021,"Iowa","Buena Vista County",5,7,307,160,147
050,19,021,"Iowa","Buena Vista County",5,8,301,159,142
050,19,021,"Iowa","Buena Vista County",5,9,333,162,171
050,19,021,"Iowa","Buena Vista County",5,10,310,152,158
050,19,021,"Iowa","Buena Vista County",5,11,307,149,158
050,19,021,"Iowa","Buena Vista County",5,12,294,153,141
050,19,021,"Iowa","Buena Vista County",5,13,320,174,146
050,19,021,"Iowa","Buena Vista County",5,14,296,153,143
050,19,021,"Iowa","Buena Vista County",5,15,325,163,162
050,19,021,"Iowa","Buena Vista County",5,16,319,170,149
050,19,021,"Iowa","Buena Vista County",5,17,299,150,149
050,19,021,"Iowa","Buena Vista County",5,18,358,198,160
050,19,021,"Iowa","Buena Vista County",5,19,399,222,177
050,19,021,"Iowa","Buena Vista County",5,20,376,214,162
050,19,021,"Iowa","Buena Vista County",5,21,337,167,170
050,19,021,"Iowa","Buena Vista County",5,22,307,166,141
050,19,021,"Iowa","Buena Vista County",5,23,245,110,135
050,19,021,"Iowa","Buena Vista County",5,24,216,106,110
050,19,021,"Iowa","Buena Vista County",5,25,191,90,101
050,19,021,"Iowa","Buena Vista County",5,26,239,116,123
050,19,021,"Iowa","Buena Vista County",5,27,241,119,122
050,19,021,"Iowa","Buena Vista County",5,28,218,107,111
050,19,021,"Iowa","Buena Vista County",5,29,222,115,107
050,19,021,"Iowa","Buena Vista County",5,30,292,157,135
050,19,021,"Iowa","Buena Vista County",5,31,250,125,125
050,19,021,"Iowa","Buena Vista County",5,32,217,110,107
050,19,021,"Iowa","Buena Vista County",5,33,226,125,101
050,19,021,"Iowa","Buena Vista County",5,34,247,133,114
050,19,021,"Iowa","Buena Vista County",5,35,257,130,127
050,19,021,"Iowa","Buena Vista County",5,36,255,129,126
050,19,021,"Iowa","Buena Vista County",5,37,259,135,124
050,19,021,"Iowa","Buena Vista County",5,38,257,143,114
050,19,021,"Iowa","Buena Vista County",5,39,276,153,123
050,19,021,"Iowa","Buena Vista County",5,40,290,159,131
050,19,021,"Iowa","Buena Vista County",5,41,291,155,136
050,19,021,"Iowa","Buena Vista County",5,42,231,121,110
050,19,021,"Iowa","Buena Vista County",5,43,226,121,105
050,19,021,"Iowa","Buena Vista County",5,44,229,125,104
050,19,021,"Iowa","Buena Vista County",5,45,219,121,98
050,19,021,"Iowa","Buena Vista County",5,46,230,119,111
050,19,021,"Iowa","Buena Vista County",5,47,209,110,99
050,19,021,"Iowa","Buena Vista County",5,48,191,99,92
050,19,021,"Iowa","Buena Vista County",5,49,193,100,93
050,19,021,"Iowa","Buena Vista County",5,50,191,100,91
050,19,021,"Iowa","Buena Vista County",5,51,196,92,104
050,19,021,"Iowa","Buena Vista County",5,52,222,109,113
050,19,021,"Iowa","Buena Vista County",5,53,202,109,93
050,19,021,"Iowa","Buena Vista County",5,54,198,107,91
050,19,021,"Iowa","Buena Vista County",5,55,228,109,119
050,19,021,"Iowa","Buena Vista County",5,56,223,115,108
050,19,021,"Iowa","Buena Vista County",5,57,197,97,100
050,19,021,"Iowa","Buena Vista County",5,58,227,115,112
050,19,021,"Iowa","Buena Vista County",5,59,236,125,111
050,19,021,"Iowa","Buena Vista County",5,60,223,118,105
050,19,021,"Iowa","Buena Vista County",5,61,246,122,124
050,19,021,"Iowa","Buena Vista County",5,62,242,122,120
050,19,021,"Iowa","Buena Vista County",5,63,259,127,132
050,19,021,"Iowa","Buena Vista County",5,64,265,128,137
050,19,021,"Iowa","Buena Vista County",5,65,273,140,133
050,19,021,"Iowa","Buena Vista County",5,66,261,139,122
050,19,021,"Iowa","Buena Vista County",5,67,240,119,121
050,19,021,"Iowa","Buena Vista County",5,68,213,110,103
050,19,021,"Iowa","Buena Vista County",5,69,225,119,106
050,19,021,"Iowa","Buena Vista County",5,70,209,118,91
050,19,021,"Iowa","Buena Vista County",5,71,204,102,102
050,19,021,"Iowa","Buena Vista County",5,72,200,96,104
050,19,021,"Iowa","Buena Vista County",5,73,170,81,89
050,19,021,"Iowa","Buena Vista County",5,74,159,79,80
050,19,021,"Iowa","Buena Vista County",5,75,141,75,66
050,19,021,"Iowa","Buena Vista County",5,76,135,70,65
050,19,021,"Iowa","Buena Vista County",5,77,102,52,50
050,19,021,"Iowa","Buena Vista County",5,78,90,46,44
050,19,021,"Iowa","Buena Vista County",5,79,80,32,48
050,19,021,"Iowa","Buena Vista County",5,80,101,47,54
050,19,021,"Iowa","Buena Vista County",5,81,84,42,42
050,19,021,"Iowa","Buena Vista County",5,82,77,36,41
050,19,021,"Iowa","Buena Vista County",5,83,81,35,46
050,19,021,"Iowa","Buena Vista County",5,84,65,24,41
050,19,021,"Iowa","Buena Vista County",5,85,456,155,301
050,19,023,"Iowa","Butler County",1,0,150,76,74
050,19,023,"Iowa","Butler County",1,1,145,76,69
050,19,023,"Iowa","Butler County",1,2,138,68,70
050,19,023,"Iowa","Butler County",1,3,135,66,69
050,19,023,"Iowa","Butler County",1,4,146,77,69
050,19,023,"Iowa","Butler County",1,5,173,83,90
050,19,023,"Iowa","Butler County",1,6,168,91,77
050,19,023,"Iowa","Butler County",1,7,173,99,74
050,19,023,"Iowa","Butler County",1,8,183,97,86
050,19,023,"Iowa","Butler County",1,9,182,88,94
050,19,023,"Iowa","Butler County",1,10,201,104,97
050,19,023,"Iowa","Butler County",1,11,215,115,100
050,19,023,"Iowa","Butler County",1,12,225,117,108
050,19,023,"Iowa","Butler County",1,13,216,113,103
050,19,023,"Iowa","Butler County",1,14,211,104,107
050,19,023,"Iowa","Butler County",1,15,205,111,94
050,19,023,"Iowa","Butler County",1,16,205,109,96
050,19,023,"Iowa","Butler County",1,17,185,91,94
050,19,023,"Iowa","Butler County",1,18,160,81,79
050,19,023,"Iowa","Butler County",1,19,119,65,54
050,19,023,"Iowa","Butler County",1,20,123,67,56
050,19,023,"Iowa","Butler County",1,21,143,69,74
050,19,023,"Iowa","Butler County",1,22,148,78,70
050,19,023,"Iowa","Butler County",1,23,145,85,60
050,19,023,"Iowa","Butler County",1,24,163,93,70
050,19,023,"Iowa","Butler County",1,25,154,78,76
050,19,023,"Iowa","Butler County",1,26,141,64,77
050,19,023,"Iowa","Butler County",1,27,126,69,57
050,19,023,"Iowa","Butler County",1,28,158,85,73
050,19,023,"Iowa","Butler County",1,29,142,66,76
050,19,023,"Iowa","Butler County",1,30,132,75,57
050,19,023,"Iowa","Butler County",1,31,132,69,63
050,19,023,"Iowa","Butler County",1,32,119,58,61
050,19,023,"Iowa","Butler County",1,33,141,66,75
050,19,023,"Iowa","Butler County",1,34,165,76,89
050,19,023,"Iowa","Butler County",1,35,163,80,83
050,19,023,"Iowa","Butler County",1,36,175,97,78
050,19,023,"Iowa","Butler County",1,37,180,86,94
050,19,023,"Iowa","Butler County",1,38,187,93,94
050,19,023,"Iowa","Butler County",1,39,185,89,96
050,19,023,"Iowa","Butler County",1,40,187,95,92
050,19,023,"Iowa","Butler County",1,41,179,87,92
050,19,023,"Iowa","Butler County",1,42,170,85,85
050,19,023,"Iowa","Butler County",1,43,162,87,75
050,19,023,"Iowa","Butler County",1,44,139,73,66
050,19,023,"Iowa","Butler County",1,45,156,78,78
050,19,023,"Iowa","Butler County",1,46,157,75,82
050,19,023,"Iowa","Butler County",1,47,156,79,77
050,19,023,"Iowa","Butler County",1,48,168,87,81
050,19,023,"Iowa","Butler County",1,49,180,92,88
050,19,023,"Iowa","Butler County",1,50,151,77,74
050,19,023,"Iowa","Butler County",1,51,170,87,83
050,19,023,"Iowa","Butler County",1,52,174,82,92
050,19,023,"Iowa","Butler County",1,53,186,83,103
050,19,023,"Iowa","Butler County",1,54,186,88,98
050,19,023,"Iowa","Butler County",1,55,178,87,91
050,19,023,"Iowa","Butler County",1,56,203,103,100
050,19,023,"Iowa","Butler County",1,57,193,100,93
050,19,023,"Iowa","Butler County",1,58,191,98,93
050,19,023,"Iowa","Butler County",1,59,196,96,100
050,19,023,"Iowa","Butler County",1,60,197,96,101
050,19,023,"Iowa","Butler County",1,61,216,108,108
050,19,023,"Iowa","Butler County",1,62,223,115,108
050,19,023,"Iowa","Butler County",1,63,215,112,103
050,19,023,"Iowa","Butler County",1,64,231,119,112
050,19,023,"Iowa","Butler County",1,65,219,109,110
050,19,023,"Iowa","Butler County",1,66,199,105,94
050,19,023,"Iowa","Butler County",1,67,195,87,108
050,19,023,"Iowa","Butler County",1,68,186,96,90
050,19,023,"Iowa","Butler County",1,69,167,87,80
050,19,023,"Iowa","Butler County",1,70,190,99,91
050,19,023,"Iowa","Butler County",1,71,168,85,83
050,19,023,"Iowa","Butler County",1,72,159,81,78
050,19,023,"Iowa","Butler County",1,73,169,88,81
050,19,023,"Iowa","Butler County",1,74,131,66,65
050,19,023,"Iowa","Butler County",1,75,112,55,57
050,19,023,"Iowa","Butler County",1,76,127,58,69
050,19,023,"Iowa","Butler County",1,77,122,54,68
050,19,023,"Iowa","Butler County",1,78,98,46,52
050,19,023,"Iowa","Butler County",1,79,94,51,43
050,19,023,"Iowa","Butler County",1,80,78,31,47
050,19,023,"Iowa","Butler County",1,81,87,40,47
050,19,023,"Iowa","Butler County",1,82,79,35,44
050,19,023,"Iowa","Butler County",1,83,70,39,31
050,19,023,"Iowa","Butler County",1,84,76,31,45
050,19,023,"Iowa","Butler County",1,85,488,168,320
050,19,023,"Iowa","Butler County",2,0,152,81,71
050,19,023,"Iowa","Butler County",2,1,145,76,69
050,19,023,"Iowa","Butler County",2,2,139,69,70
050,19,023,"Iowa","Butler County",2,3,135,65,70
050,19,023,"Iowa","Butler County",2,4,144,75,69
050,19,023,"Iowa","Butler County",2,5,168,82,86
050,19,023,"Iowa","Butler County",2,6,170,90,80
050,19,023,"Iowa","Butler County",2,7,173,98,75
050,19,023,"Iowa","Butler County",2,8,181,97,84
050,19,023,"Iowa","Butler County",2,9,182,90,92
050,19,023,"Iowa","Butler County",2,10,196,99,97
050,19,023,"Iowa","Butler County",2,11,211,111,100
050,19,023,"Iowa","Butler County",2,12,224,117,107
050,19,023,"Iowa","Butler County",2,13,218,112,106
050,19,023,"Iowa","Butler County",2,14,212,106,106
050,19,023,"Iowa","Butler County",2,15,208,110,98
050,19,023,"Iowa","Butler County",2,16,202,108,94
050,19,023,"Iowa","Butler County",2,17,190,95,95
050,19,023,"Iowa","Butler County",2,18,156,79,77
050,19,023,"Iowa","Butler County",2,19,119,64,55
050,19,023,"Iowa","Butler County",2,20,124,66,58
050,19,023,"Iowa","Butler County",2,21,140,69,71
050,19,023,"Iowa","Butler County",2,22,148,76,72
050,19,023,"Iowa","Butler County",2,23,147,85,62
050,19,023,"Iowa","Butler County",2,24,160,92,68
050,19,023,"Iowa","Butler County",2,25,158,81,77
050,19,023,"Iowa","Butler County",2,26,145,68,77
050,19,023,"Iowa","Butler County",2,27,131,68,63
050,19,023,"Iowa","Butler County",2,28,153,82,71
050,19,023,"Iowa","Butler County",2,29,144,69,75
050,19,023,"Iowa","Butler County",2,30,136,73,63
050,19,023,"Iowa","Butler County",2,31,130,69,61
050,19,023,"Iowa","Butler County",2,32,124,62,62
050,19,023,"Iowa","Butler County",2,33,138,66,72
050,19,023,"Iowa","Butler County",2,34,159,73,86
050,19,023,"Iowa","Butler County",2,35,166,80,86
050,19,023,"Iowa","Butler County",2,36,170,91,79
050,19,023,"Iowa","Butler County",2,37,180,89,91
050,19,023,"Iowa","Butler County",2,38,186,91,95
050,19,023,"Iowa","Butler County",2,39,186,92,94
050,19,023,"Iowa","Butler County",2,40,189,94,95
050,19,023,"Iowa","Butler County",2,41,178,87,91
050,19,023,"Iowa","Butler County",2,42,170,84,86
050,19,023,"Iowa","Butler County",2,43,167,88,79
050,19,023,"Iowa","Butler County",2,44,140,75,65
050,19,023,"Iowa","Butler County",2,45,153,77,76
050,19,023,"Iowa","Butler County",2,46,155,75,80
050,19,023,"Iowa","Butler County",2,47,154,77,77
050,19,023,"Iowa","Butler County",2,48,166,86,80
050,19,023,"Iowa","Butler County",2,49,178,91,87
050,19,023,"Iowa","Butler County",2,50,157,80,77
050,19,023,"Iowa","Butler County",2,51,166,85,81
050,19,023,"Iowa","Butler County",2,52,171,82,89
050,19,023,"Iowa","Butler County",2,53,182,82,100
050,19,023,"Iowa","Butler County",2,54,187,88,99
050,19,023,"Iowa","Butler County",2,55,177,86,91
050,19,023,"Iowa","Butler County",2,56,198,101,97
050,19,023,"Iowa","Butler County",2,57,195,100,95
050,19,023,"Iowa","Butler County",2,58,192,98,94
050,19,023,"Iowa","Butler County",2,59,195,97,98
050,19,023,"Iowa","Butler County",2,60,195,95,100
050,19,023,"Iowa","Butler County",2,61,210,104,106
050,19,023,"Iowa","Butler County",2,62,221,112,109
050,19,023,"Iowa","Butler County",2,63,217,114,103
050,19,023,"Iowa","Butler County",2,64,226,116,110
050,19,023,"Iowa","Butler County",2,65,223,112,111
050,19,023,"Iowa","Butler County",2,66,202,106,96
050,19,023,"Iowa","Butler County",2,67,197,92,105
050,19,023,"Iowa","Butler County",2,68,187,94,93
050,19,023,"Iowa","Butler County",2,69,171,88,83
050,19,023,"Iowa","Butler County",2,70,185,96,89
050,19,023,"Iowa","Butler County",2,71,174,89,85
050,19,023,"Iowa","Butler County",2,72,158,81,77
050,19,023,"Iowa","Butler County",2,73,174,90,84
050,19,023,"Iowa","Butler County",2,74,130,67,63
050,19,023,"Iowa","Butler County",2,75,117,57,60
050,19,023,"Iowa","Butler County",2,76,121,56,65
050,19,023,"Iowa","Butler County",2,77,124,55,69
050,19,023,"Iowa","Butler County",2,78,101,47,54
050,19,023,"Iowa","Butler County",2,79,97,51,46
050,19,023,"Iowa","Butler County",2,80,81,35,46
050,19,023,"Iowa","Butler County",2,81,84,37,47
050,19,023,"Iowa","Butler County",2,82,80,36,44
050,19,023,"Iowa","Butler County",2,83,70,36,34
050,19,023,"Iowa","Butler County",2,84,75,32,43
050,19,023,"Iowa","Butler County",2,85,493,167,326
050,19,023,"Iowa","Butler County",3,0,130,67,63
050,19,023,"Iowa","Butler County",3,1,163,85,78
050,19,023,"Iowa","Butler County",3,2,151,82,69
050,19,023,"Iowa","Butler County",3,3,144,70,74
050,19,023,"Iowa","Butler County",3,4,149,73,76
050,19,023,"Iowa","Butler County",3,5,152,81,71
050,19,023,"Iowa","Butler County",3,6,174,90,84
050,19,023,"Iowa","Butler County",3,7,172,86,86
050,19,023,"Iowa","Butler County",3,8,178,98,80
050,19,023,"Iowa","Butler County",3,9,183,99,84
050,19,023,"Iowa","Butler County",3,10,179,89,90
050,19,023,"Iowa","Butler County",3,11,199,100,99
050,19,023,"Iowa","Butler County",3,12,213,116,97
050,19,023,"Iowa","Butler County",3,13,225,126,99
050,19,023,"Iowa","Butler County",3,14,217,113,104
050,19,023,"Iowa","Butler County",3,15,201,104,97
050,19,023,"Iowa","Butler County",3,16,211,110,101
050,19,023,"Iowa","Butler County",3,17,200,108,92
050,19,023,"Iowa","Butler County",3,18,160,83,77
050,19,023,"Iowa","Butler County",3,19,116,57,59
050,19,023,"Iowa","Butler County",3,20,128,67,61
050,19,023,"Iowa","Butler County",3,21,130,69,61
050,19,023,"Iowa","Butler County",3,22,138,67,71
050,19,023,"Iowa","Butler County",3,23,154,79,75
050,19,023,"Iowa","Butler County",3,24,149,86,63
050,19,023,"Iowa","Butler County",3,25,155,93,62
050,19,023,"Iowa","Butler County",3,26,166,80,86
050,19,023,"Iowa","Butler County",3,27,156,74,82
050,19,023,"Iowa","Butler County",3,28,125,64,61
050,19,023,"Iowa","Butler County",3,29,157,86,71
050,19,023,"Iowa","Butler County",3,30,148,73,75
050,19,023,"Iowa","Butler County",3,31,145,76,69
050,19,023,"Iowa","Butler County",3,32,138,74,64
050,19,023,"Iowa","Butler County",3,33,129,67,62
050,19,023,"Iowa","Butler County",3,34,146,70,76
050,19,023,"Iowa","Butler County",3,35,159,67,92
050,19,023,"Iowa","Butler County",3,36,165,79,86
050,19,023,"Iowa","Butler County",3,37,174,92,82
050,19,023,"Iowa","Butler County",3,38,173,87,86
050,19,023,"Iowa","Butler County",3,39,190,94,96
050,19,023,"Iowa","Butler County",3,40,187,92,95
050,19,023,"Iowa","Butler County",3,41,185,93,92
050,19,023,"Iowa","Butler County",3,42,179,89,90
050,19,023,"Iowa","Butler County",3,43,165,80,85
050,19,023,"Iowa","Butler County",3,44,170,93,77
050,19,023,"Iowa","Butler County",3,45,144,77,67
050,19,023,"Iowa","Butler County",3,46,160,79,81
050,19,023,"Iowa","Butler County",3,47,160,78,82
050,19,023,"Iowa","Butler County",3,48,148,74,74
050,19,023,"Iowa","Butler County",3,49,164,83,81
050,19,023,"Iowa","Butler County",3,50,180,95,85
050,19,023,"Iowa","Butler County",3,51,161,84,77
050,19,023,"Iowa","Butler County",3,52,175,82,93
050,19,023,"Iowa","Butler County",3,53,172,80,92
050,19,023,"Iowa","Butler County",3,54,181,81,100
050,19,023,"Iowa","Butler County",3,55,190,88,102
050,19,023,"Iowa","Butler County",3,56,182,89,93
050,19,023,"Iowa","Butler County",3,57,196,102,94
050,19,023,"Iowa","Butler County",3,58,196,99,97
050,19,023,"Iowa","Butler County",3,59,188,96,92
050,19,023,"Iowa","Butler County",3,60,194,97,97
050,19,023,"Iowa","Butler County",3,61,193,93,100
050,19,023,"Iowa","Butler County",3,62,213,101,112
050,19,023,"Iowa","Butler County",3,63,211,106,105
050,19,023,"Iowa","Butler County",3,64,212,112,100
050,19,023,"Iowa","Butler County",3,65,225,112,113
050,19,023,"Iowa","Butler County",3,66,219,110,109
050,19,023,"Iowa","Butler County",3,67,203,105,98
050,19,023,"Iowa","Butler County",3,68,190,89,101
050,19,023,"Iowa","Butler County",3,69,181,91,90
050,19,023,"Iowa","Butler County",3,70,173,88,85
050,19,023,"Iowa","Butler County",3,71,183,95,88
050,19,023,"Iowa","Butler County",3,72,174,90,84
050,19,023,"Iowa","Butler County",3,73,151,76,75
050,19,023,"Iowa","Butler County",3,74,163,85,78
050,19,023,"Iowa","Butler County",3,75,125,63,62
050,19,023,"Iowa","Butler County",3,76,112,57,55
050,19,023,"Iowa","Butler County",3,77,116,52,64
050,19,023,"Iowa","Butler County",3,78,118,54,64
050,19,023,"Iowa","Butler County",3,79,102,48,54
050,19,023,"Iowa","Butler County",3,80,85,43,42
050,19,023,"Iowa","Butler County",3,81,78,36,42
050,19,023,"Iowa","Butler County",3,82,78,33,45
050,19,023,"Iowa","Butler County",3,83,76,34,42
050,19,023,"Iowa","Butler County",3,84,60,28,32
050,19,023,"Iowa","Butler County",3,85,488,166,322
050,19,023,"Iowa","Butler County",4,0,150,80,70
050,19,023,"Iowa","Butler County",4,1,127,65,62
050,19,023,"Iowa","Butler County",4,2,161,85,76
050,19,023,"Iowa","Butler County",4,3,151,87,64
050,19,023,"Iowa","Butler County",4,4,141,74,67
050,19,023,"Iowa","Butler County",4,5,142,68,74
050,19,023,"Iowa","Butler County",4,6,153,80,73
050,19,023,"Iowa","Butler County",4,7,170,89,81
050,19,023,"Iowa","Butler County",4,8,181,91,90
050,19,023,"Iowa","Butler County",4,9,180,101,79
050,19,023,"Iowa","Butler County",4,10,186,101,85
050,19,023,"Iowa","Butler County",4,11,184,87,97
050,19,023,"Iowa","Butler County",4,12,191,94,97
050,19,023,"Iowa","Butler County",4,13,217,118,99
050,19,023,"Iowa","Butler County",4,14,224,125,99
050,19,023,"Iowa","Butler County",4,15,210,109,101
050,19,023,"Iowa","Butler County",4,16,208,108,100
050,19,023,"Iowa","Butler County",4,17,220,113,107
050,19,023,"Iowa","Butler County",4,18,162,88,74
050,19,023,"Iowa","Butler County",4,19,118,61,57
050,19,023,"Iowa","Butler County",4,20,116,60,56
050,19,023,"Iowa","Butler County",4,21,129,69,60
050,19,023,"Iowa","Butler County",4,22,131,71,60
050,19,023,"Iowa","Butler County",4,23,145,71,74
050,19,023,"Iowa","Butler County",4,24,172,94,78
050,19,023,"Iowa","Butler County",4,25,142,89,53
050,19,023,"Iowa","Butler County",4,26,153,100,53
050,19,023,"Iowa","Butler County",4,27,150,79,71
050,19,023,"Iowa","Butler County",4,28,147,69,78
050,19,023,"Iowa","Butler County",4,29,127,66,61
050,19,023,"Iowa","Butler County",4,30,153,87,66
050,19,023,"Iowa","Butler County",4,31,149,75,74
050,19,023,"Iowa","Butler County",4,32,150,78,72
050,19,023,"Iowa","Butler County",4,33,141,77,64
050,19,023,"Iowa","Butler County",4,34,133,70,63
050,19,023,"Iowa","Butler County",4,35,146,70,76
050,19,023,"Iowa","Butler County",4,36,167,68,99
050,19,023,"Iowa","Butler County",4,37,167,77,90
050,19,023,"Iowa","Butler County",4,38,172,94,78
050,19,023,"Iowa","Butler County",4,39,177,91,86
050,19,023,"Iowa","Butler County",4,40,186,90,96
050,19,023,"Iowa","Butler County",4,41,180,90,90
050,19,023,"Iowa","Butler County",4,42,182,89,93
050,19,023,"Iowa","Butler County",4,43,174,86,88
050,19,023,"Iowa","Butler County",4,44,170,83,87
050,19,023,"Iowa","Butler County",4,45,167,90,77
050,19,023,"Iowa","Butler County",4,46,148,78,70
050,19,023,"Iowa","Butler County",4,47,152,77,75
050,19,023,"Iowa","Butler County",4,48,167,80,87
050,19,023,"Iowa","Butler County",4,49,146,74,72
050,19,023,"Iowa","Butler County",4,50,159,79,80
050,19,023,"Iowa","Butler County",4,51,182,97,85
050,19,023,"Iowa","Butler County",4,52,160,79,81
050,19,023,"Iowa","Butler County",4,53,177,84,93
050,19,023,"Iowa","Butler County",4,54,174,83,91
050,19,023,"Iowa","Butler County",4,55,183,81,102
050,19,023,"Iowa","Butler County",4,56,190,90,100
050,19,023,"Iowa","Butler County",4,57,179,87,92
050,19,023,"Iowa","Butler County",4,58,197,103,94
050,19,023,"Iowa","Butler County",4,59,195,99,96
050,19,023,"Iowa","Butler County",4,60,186,97,89
050,19,023,"Iowa","Butler County",4,61,195,95,100
050,19,023,"Iowa","Butler County",4,62,195,90,105
050,19,023,"Iowa","Butler County",4,63,205,99,106
050,19,023,"Iowa","Butler County",4,64,212,107,105
050,19,023,"Iowa","Butler County",4,65,211,109,102
050,19,023,"Iowa","Butler County",4,66,224,112,112
050,19,023,"Iowa","Butler County",4,67,217,107,110
050,19,023,"Iowa","Butler County",4,68,200,105,95
050,19,023,"Iowa","Butler County",4,69,184,87,97
050,19,023,"Iowa","Butler County",4,70,183,91,92
050,19,023,"Iowa","Butler County",4,71,172,87,85
050,19,023,"Iowa","Butler County",4,72,174,90,84
050,19,023,"Iowa","Butler County",4,73,164,84,80
050,19,023,"Iowa","Butler County",4,74,145,75,70
050,19,023,"Iowa","Butler County",4,75,158,81,77
050,19,023,"Iowa","Butler County",4,76,120,61,59
050,19,023,"Iowa","Butler County",4,77,109,54,55
050,19,023,"Iowa","Butler County",4,78,113,51,62
050,19,023,"Iowa","Butler County",4,79,116,53,63
050,19,023,"Iowa","Butler County",4,80,85,37,48
050,19,023,"Iowa","Butler County",4,81,81,39,42
050,19,023,"Iowa","Butler County",4,82,74,33,41
050,19,023,"Iowa","Butler County",4,83,80,36,44
050,19,023,"Iowa","Butler County",4,84,63,23,40
050,19,023,"Iowa","Butler County",4,85,469,160,309
050,19,023,"Iowa","Butler County",5,0,152,80,72
050,19,023,"Iowa","Butler County",5,1,154,80,74
050,19,023,"Iowa","Butler County",5,2,130,67,63
050,19,023,"Iowa","Butler County",5,3,171,90,81
050,19,023,"Iowa","Butler County",5,4,152,89,63
050,19,023,"Iowa","Butler County",5,5,144,77,67
050,19,023,"Iowa","Butler County",5,6,146,72,74
050,19,023,"Iowa","Butler County",5,7,149,76,73
050,19,023,"Iowa","Butler County",5,8,170,88,82
050,19,023,"Iowa","Butler County",5,9,176,88,88
050,19,023,"Iowa","Butler County",5,10,187,104,83
050,19,023,"Iowa","Butler County",5,11,181,100,81
050,19,023,"Iowa","Butler County",5,12,181,88,93
050,19,023,"Iowa","Butler County",5,13,185,87,98
050,19,023,"Iowa","Butler County",5,14,216,120,96
050,19,023,"Iowa","Butler County",5,15,213,121,92
050,19,023,"Iowa","Butler County",5,16,211,113,98
050,19,023,"Iowa","Butler County",5,17,197,108,89
050,19,023,"Iowa","Butler County",5,18,177,92,85
050,19,023,"Iowa","Butler County",5,19,117,70,47
050,19,023,"Iowa","Butler County",5,20,130,68,62
050,19,023,"Iowa","Butler County",5,21,117,57,60
050,19,023,"Iowa","Butler County",5,22,144,81,63
050,19,023,"Iowa","Butler County",5,23,140,72,68
050,19,023,"Iowa","Butler County",5,24,157,87,70
050,19,023,"Iowa","Butler County",5,25,175,94,81
050,19,023,"Iowa","Butler County",5,26,149,93,56
050,19,023,"Iowa","Butler County",5,27,148,92,56
050,19,023,"Iowa","Butler County",5,28,169,94,75
050,19,023,"Iowa","Butler County",5,29,143,69,74
050,19,023,"Iowa","Butler County",5,30,132,72,60
050,19,023,"Iowa","Butler County",5,31,155,87,68
050,19,023,"Iowa","Butler County",5,32,152,80,72
050,19,023,"Iowa","Butler County",5,33,144,73,71
050,19,023,"Iowa","Butler County",5,34,135,73,62
050,19,023,"Iowa","Butler County",5,35,131,62,69
050,19,023,"Iowa","Butler County",5,36,153,76,77
050,19,023,"Iowa","Butler County",5,37,163,67,96
050,19,023,"Iowa","Butler County",5,38,166,78,88
050,19,023,"Iowa","Butler County",5,39,168,94,74
050,19,023,"Iowa","Butler County",5,40,181,92,89
050,19,023,"Iowa","Butler County",5,41,175,86,89
050,19,023,"Iowa","Butler County",5,42,179,92,87
050,19,023,"Iowa","Butler County",5,43,181,86,95
050,19,023,"Iowa","Butler County",5,44,172,85,87
050,19,023,"Iowa","Butler County",5,45,171,84,87
050,19,023,"Iowa","Butler County",5,46,168,91,77
050,19,023,"Iowa","Butler County",5,47,143,76,67
050,19,023,"Iowa","Butler County",5,48,150,79,71
050,19,023,"Iowa","Butler County",5,49,168,80,88
050,19,023,"Iowa","Butler County",5,50,148,74,74
050,19,023,"Iowa","Butler County",5,51,164,82,82
050,19,023,"Iowa","Butler County",5,52,178,96,82
050,19,023,"Iowa","Butler County",5,53,163,83,80
050,19,023,"Iowa","Butler County",5,54,190,91,99
050,19,023,"Iowa","Butler County",5,55,168,81,87
050,19,023,"Iowa","Butler County",5,56,187,84,103
050,19,023,"Iowa","Butler County",5,57,189,90,99
050,19,023,"Iowa","Butler County",5,58,181,85,96
050,19,023,"Iowa","Butler County",5,59,194,104,90
050,19,023,"Iowa","Butler County",5,60,194,95,99
050,19,023,"Iowa","Butler County",5,61,182,93,89
050,19,023,"Iowa","Butler County",5,62,191,90,101
050,19,023,"Iowa","Butler County",5,63,191,88,103
050,19,023,"Iowa","Butler County",5,64,202,98,104
050,19,023,"Iowa","Butler County",5,65,207,104,103
050,19,023,"Iowa","Butler County",5,66,207,105,102
050,19,023,"Iowa","Butler County",5,67,222,111,111
050,19,023,"Iowa","Butler County",5,68,210,106,104
050,19,023,"Iowa","Butler County",5,69,193,101,92
050,19,023,"Iowa","Butler County",5,70,186,87,99
050,19,023,"Iowa","Butler County",5,71,177,87,90
050,19,023,"Iowa","Butler County",5,72,166,84,82
050,19,023,"Iowa","Butler County",5,73,167,87,80
050,19,023,"Iowa","Butler County",5,74,159,83,76
050,19,023,"Iowa","Butler County",5,75,143,73,70
050,19,023,"Iowa","Butler County",5,76,152,79,73
050,19,023,"Iowa","Butler County",5,77,117,57,60
050,19,023,"Iowa","Butler County",5,78,105,55,50
050,19,023,"Iowa","Butler County",5,79,111,50,61
050,19,023,"Iowa","Butler County",5,80,104,45,59
050,19,023,"Iowa","Butler County",5,81,83,34,49
050,19,023,"Iowa","Butler County",5,82,75,36,39
050,19,023,"Iowa","Butler County",5,83,71,32,39
050,19,023,"Iowa","Butler County",5,84,67,26,41
050,19,023,"Iowa","Butler County",5,85,460,156,304
050,19,025,"Iowa","Calhoun County",1,0,108,54,54
050,19,025,"Iowa","Calhoun County",1,1,99,47,52
050,19,025,"Iowa","Calhoun County",1,2,110,56,54
050,19,025,"Iowa","Calhoun County",1,3,107,57,50
050,19,025,"Iowa","Calhoun County",1,4,118,63,55
050,19,025,"Iowa","Calhoun County",1,5,128,61,67
050,19,025,"Iowa","Calhoun County",1,6,130,66,64
050,19,025,"Iowa","Calhoun County",1,7,137,73,64
050,19,025,"Iowa","Calhoun County",1,8,133,72,61
050,19,025,"Iowa","Calhoun County",1,9,114,61,53
050,19,025,"Iowa","Calhoun County",1,10,130,69,61
050,19,025,"Iowa","Calhoun County",1,11,136,74,62
050,19,025,"Iowa","Calhoun County",1,12,105,49,56
050,19,025,"Iowa","Calhoun County",1,13,117,55,62
050,19,025,"Iowa","Calhoun County",1,14,130,69,61
050,19,025,"Iowa","Calhoun County",1,15,128,67,61
050,19,025,"Iowa","Calhoun County",1,16,120,63,57
050,19,025,"Iowa","Calhoun County",1,17,114,63,51
050,19,025,"Iowa","Calhoun County",1,18,111,67,44
050,19,025,"Iowa","Calhoun County",1,19,98,59,39
050,19,025,"Iowa","Calhoun County",1,20,102,68,34
050,19,025,"Iowa","Calhoun County",1,21,96,62,34
050,19,025,"Iowa","Calhoun County",1,22,110,68,42
050,19,025,"Iowa","Calhoun County",1,23,110,71,39
050,19,025,"Iowa","Calhoun County",1,24,109,65,44
050,19,025,"Iowa","Calhoun County",1,25,106,64,42
050,19,025,"Iowa","Calhoun County",1,26,105,64,41
050,19,025,"Iowa","Calhoun County",1,27,122,65,57
050,19,025,"Iowa","Calhoun County",1,28,128,67,61
050,19,025,"Iowa","Calhoun County",1,29,117,59,58
050,19,025,"Iowa","Calhoun County",1,30,113,60,53
050,19,025,"Iowa","Calhoun County",1,31,115,63,52
050,19,025,"Iowa","Calhoun County",1,32,137,81,56
050,19,025,"Iowa","Calhoun County",1,33,128,73,55
050,19,025,"Iowa","Calhoun County",1,34,114,68,46
050,19,025,"Iowa","Calhoun County",1,35,100,63,37
050,19,025,"Iowa","Calhoun County",1,36,109,53,56
050,19,025,"Iowa","Calhoun County",1,37,112,62,50
050,19,025,"Iowa","Calhoun County",1,38,124,66,58
050,19,025,"Iowa","Calhoun County",1,39,120,59,61
050,19,025,"Iowa","Calhoun County",1,40,117,66,51
050,19,025,"Iowa","Calhoun County",1,41,106,60,46
050,19,025,"Iowa","Calhoun County",1,42,109,61,48
050,19,025,"Iowa","Calhoun County",1,43,111,69,42
050,19,025,"Iowa","Calhoun County",1,44,105,63,42
050,19,025,"Iowa","Calhoun County",1,45,102,62,40
050,19,025,"Iowa","Calhoun County",1,46,99,63,36
050,19,025,"Iowa","Calhoun County",1,47,85,49,36
050,19,025,"Iowa","Calhoun County",1,48,91,45,46
050,19,025,"Iowa","Calhoun County",1,49,108,51,57
050,19,025,"Iowa","Calhoun County",1,50,108,54,54
050,19,025,"Iowa","Calhoun County",1,51,109,56,53
050,19,025,"Iowa","Calhoun County",1,52,105,55,50
050,19,025,"Iowa","Calhoun County",1,53,119,59,60
050,19,025,"Iowa","Calhoun County",1,54,121,64,57
050,19,025,"Iowa","Calhoun County",1,55,113,58,55
050,19,025,"Iowa","Calhoun County",1,56,106,59,47
050,19,025,"Iowa","Calhoun County",1,57,134,74,60
050,19,025,"Iowa","Calhoun County",1,58,144,71,73
050,19,025,"Iowa","Calhoun County",1,59,157,82,75
050,19,025,"Iowa","Calhoun County",1,60,147,72,75
050,19,025,"Iowa","Calhoun County",1,61,155,77,78
050,19,025,"Iowa","Calhoun County",1,62,162,88,74
050,19,025,"Iowa","Calhoun County",1,63,146,78,68
050,19,025,"Iowa","Calhoun County",1,64,165,79,86
050,19,025,"Iowa","Calhoun County",1,65,165,81,84
050,19,025,"Iowa","Calhoun County",1,66,148,79,69
050,19,025,"Iowa","Calhoun County",1,67,140,73,67
050,19,025,"Iowa","Calhoun County",1,68,154,79,75
050,19,025,"Iowa","Calhoun County",1,69,132,66,66
050,19,025,"Iowa","Calhoun County",1,70,108,58,50
050,19,025,"Iowa","Calhoun County",1,71,91,44,47
050,19,025,"Iowa","Calhoun County",1,72,98,50,48
050,19,025,"Iowa","Calhoun County",1,73,98,48,50
050,19,025,"Iowa","Calhoun County",1,74,80,34,46
050,19,025,"Iowa","Calhoun County",1,75,93,40,53
050,19,025,"Iowa","Calhoun County",1,76,87,37,50
050,19,025,"Iowa","Calhoun County",1,77,76,36,40
050,19,025,"Iowa","Calhoun County",1,78,68,38,30
050,19,025,"Iowa","Calhoun County",1,79,60,28,32
050,19,025,"Iowa","Calhoun County",1,80,48,18,30
050,19,025,"Iowa","Calhoun County",1,81,65,26,39
050,19,025,"Iowa","Calhoun County",1,82,65,31,34
050,19,025,"Iowa","Calhoun County",1,83,71,31,40
050,19,025,"Iowa","Calhoun County",1,84,61,30,31
050,19,025,"Iowa","Calhoun County",1,85,349,108,241
050,19,025,"Iowa","Calhoun County",2,0,100,51,49
050,19,025,"Iowa","Calhoun County",2,1,100,48,52
050,19,025,"Iowa","Calhoun County",2,2,108,55,53
050,19,025,"Iowa","Calhoun County",2,3,106,55,51
050,19,025,"Iowa","Calhoun County",2,4,114,60,54
050,19,025,"Iowa","Calhoun County",2,5,129,63,66
050,19,025,"Iowa","Calhoun County",2,6,130,65,65
050,19,025,"Iowa","Calhoun County",2,7,136,72,64
050,19,025,"Iowa","Calhoun County",2,8,130,70,60
050,19,025,"Iowa","Calhoun County",2,9,118,63,55
050,19,025,"Iowa","Calhoun County",2,10,125,67,58
050,19,025,"Iowa","Calhoun County",2,11,134,73,61
050,19,025,"Iowa","Calhoun County",2,12,112,55,57
050,19,025,"Iowa","Calhoun County",2,13,114,53,61
050,19,025,"Iowa","Calhoun County",2,14,127,66,61
050,19,025,"Iowa","Calhoun County",2,15,127,67,60
050,19,025,"Iowa","Calhoun County",2,16,122,65,57
050,19,025,"Iowa","Calhoun County",2,17,115,63,52
050,19,025,"Iowa","Calhoun County",2,18,108,64,44
050,19,025,"Iowa","Calhoun County",2,19,99,61,38
050,19,025,"Iowa","Calhoun County",2,20,104,68,36
050,19,025,"Iowa","Calhoun County",2,21,95,61,34
050,19,025,"Iowa","Calhoun County",2,22,112,71,41
050,19,025,"Iowa","Calhoun County",2,23,108,69,39
050,19,025,"Iowa","Calhoun County",2,24,109,66,43
050,19,025,"Iowa","Calhoun County",2,25,108,67,41
050,19,025,"Iowa","Calhoun County",2,26,102,62,40
050,19,025,"Iowa","Calhoun County",2,27,118,64,54
050,19,025,"Iowa","Calhoun County",2,28,127,67,60
050,19,025,"Iowa","Calhoun County",2,29,121,61,60
050,19,025,"Iowa","Calhoun County",2,30,114,59,55
050,19,025,"Iowa","Calhoun County",2,31,115,63,52
050,19,025,"Iowa","Calhoun County",2,32,134,79,55
050,19,025,"Iowa","Calhoun County",2,33,128,74,54
050,19,025,"Iowa","Calhoun County",2,34,116,69,47
050,19,025,"Iowa","Calhoun County",2,35,104,64,40
050,19,025,"Iowa","Calhoun County",2,36,109,57,52
050,19,025,"Iowa","Calhoun County",2,37,112,60,52
050,19,025,"Iowa","Calhoun County",2,38,125,68,57
050,19,025,"Iowa","Calhoun County",2,39,119,59,60
050,19,025,"Iowa","Calhoun County",2,40,118,65,53
050,19,025,"Iowa","Calhoun County",2,41,108,61,47
050,19,025,"Iowa","Calhoun County",2,42,109,62,47
050,19,025,"Iowa","Calhoun County",2,43,109,67,42
050,19,025,"Iowa","Calhoun County",2,44,105,64,41
050,19,025,"Iowa","Calhoun County",2,45,104,63,41
050,19,025,"Iowa","Calhoun County",2,46,99,62,37
050,19,025,"Iowa","Calhoun County",2,47,87,51,36
050,19,025,"Iowa","Calhoun County",2,48,89,46,43
050,19,025,"Iowa","Calhoun County",2,49,103,49,54
050,19,025,"Iowa","Calhoun County",2,50,105,51,54
050,19,025,"Iowa","Calhoun County",2,51,111,57,54
050,19,025,"Iowa","Calhoun County",2,52,103,53,50
050,19,025,"Iowa","Calhoun County",2,53,116,58,58
050,19,025,"Iowa","Calhoun County",2,54,119,62,57
050,19,025,"Iowa","Calhoun County",2,55,114,58,56
050,19,025,"Iowa","Calhoun County",2,56,108,58,50
050,19,025,"Iowa","Calhoun County",2,57,129,72,57
050,19,025,"Iowa","Calhoun County",2,58,140,70,70
050,19,025,"Iowa","Calhoun County",2,59,155,80,75
050,19,025,"Iowa","Calhoun County",2,60,148,73,75
050,19,025,"Iowa","Calhoun County",2,61,154,77,77
050,19,025,"Iowa","Calhoun County",2,62,156,82,74
050,19,025,"Iowa","Calhoun County",2,63,149,80,69
050,19,025,"Iowa","Calhoun County",2,64,158,77,81
050,19,025,"Iowa","Calhoun County",2,65,163,79,84
050,19,025,"Iowa","Calhoun County",2,66,152,79,73
050,19,025,"Iowa","Calhoun County",2,67,143,75,68
050,19,025,"Iowa","Calhoun County",2,68,149,77,72
050,19,025,"Iowa","Calhoun County",2,69,135,68,67
050,19,025,"Iowa","Calhoun County",2,70,113,60,53
050,19,025,"Iowa","Calhoun County",2,71,95,48,47
050,19,025,"Iowa","Calhoun County",2,72,93,46,47
050,19,025,"Iowa","Calhoun County",2,73,103,52,51
050,19,025,"Iowa","Calhoun County",2,74,79,35,44
050,19,025,"Iowa","Calhoun County",2,75,89,38,51
050,19,025,"Iowa","Calhoun County",2,76,88,38,50
050,19,025,"Iowa","Calhoun County",2,77,80,36,44
050,19,025,"Iowa","Calhoun County",2,78,68,36,32
050,19,025,"Iowa","Calhoun County",2,79,60,30,30
050,19,025,"Iowa","Calhoun County",2,80,49,19,30
050,19,025,"Iowa","Calhoun County",2,81,59,24,35
050,19,025,"Iowa","Calhoun County",2,82,65,30,35
050,19,025,"Iowa","Calhoun County",2,83,69,30,39
050,19,025,"Iowa","Calhoun County",2,84,62,30,32
050,19,025,"Iowa","Calhoun County",2,85,356,113,243
050,19,025,"Iowa","Calhoun County",3,0,75,44,31
050,19,025,"Iowa","Calhoun County",3,1,99,50,49
050,19,025,"Iowa","Calhoun County",3,2,102,50,52
050,19,025,"Iowa","Calhoun County",3,3,108,53,55
050,19,025,"Iowa","Calhoun County",3,4,107,55,52
050,19,025,"Iowa","Calhoun County",3,5,118,64,54
050,19,025,"Iowa","Calhoun County",3,6,128,63,65
050,19,025,"Iowa","Calhoun County",3,7,131,65,66
050,19,025,"Iowa","Calhoun County",3,8,136,75,61
050,19,025,"Iowa","Calhoun County",3,9,130,69,61
050,19,025,"Iowa","Calhoun County",3,10,116,63,53
050,19,025,"Iowa","Calhoun County",3,11,121,65,56
050,19,025,"Iowa","Calhoun County",3,12,133,71,62
050,19,025,"Iowa","Calhoun County",3,13,117,56,61
050,19,025,"Iowa","Calhoun County",3,14,125,61,64
050,19,025,"Iowa","Calhoun County",3,15,125,66,59
050,19,025,"Iowa","Calhoun County",3,16,134,71,63
050,19,025,"Iowa","Calhoun County",3,17,124,69,55
050,19,025,"Iowa","Calhoun County",3,18,102,60,42
050,19,025,"Iowa","Calhoun County",3,19,101,64,37
050,19,025,"Iowa","Calhoun County",3,20,112,69,43
050,19,025,"Iowa","Calhoun County",3,21,87,57,30
050,19,025,"Iowa","Calhoun County",3,22,110,71,39
050,19,025,"Iowa","Calhoun County",3,23,110,63,47
050,19,025,"Iowa","Calhoun County",3,24,108,68,40
050,19,025,"Iowa","Calhoun County",3,25,111,73,38
050,19,025,"Iowa","Calhoun County",3,26,108,64,44
050,19,025,"Iowa","Calhoun County",3,27,103,64,39
050,19,025,"Iowa","Calhoun County",3,28,121,67,54
050,19,025,"Iowa","Calhoun County",3,29,123,62,61
050,19,025,"Iowa","Calhoun County",3,30,120,61,59
050,19,025,"Iowa","Calhoun County",3,31,124,64,60
050,19,025,"Iowa","Calhoun County",3,32,118,66,52
050,19,025,"Iowa","Calhoun County",3,33,140,81,59
050,19,025,"Iowa","Calhoun County",3,34,129,76,53
050,19,025,"Iowa","Calhoun County",3,35,119,70,49
050,19,025,"Iowa","Calhoun County",3,36,108,63,45
050,19,025,"Iowa","Calhoun County",3,37,104,54,50
050,19,025,"Iowa","Calhoun County",3,38,123,73,50
050,19,025,"Iowa","Calhoun County",3,39,112,55,57
050,19,025,"Iowa","Calhoun County",3,40,119,58,61
050,19,025,"Iowa","Calhoun County",3,41,119,68,51
050,19,025,"Iowa","Calhoun County",3,42,123,73,50
050,19,025,"Iowa","Calhoun County",3,43,104,62,42
050,19,025,"Iowa","Calhoun County",3,44,108,67,41
050,19,025,"Iowa","Calhoun County",3,45,106,64,42
050,19,025,"Iowa","Calhoun County",3,46,104,64,40
050,19,025,"Iowa","Calhoun County",3,47,88,54,34
050,19,025,"Iowa","Calhoun County",3,48,94,55,39
050,19,025,"Iowa","Calhoun County",3,49,94,47,47
050,19,025,"Iowa","Calhoun County",3,50,102,48,54
050,19,025,"Iowa","Calhoun County",3,51,112,58,54
050,19,025,"Iowa","Calhoun County",3,52,110,54,56
050,19,025,"Iowa","Calhoun County",3,53,105,56,49
050,19,025,"Iowa","Calhoun County",3,54,120,58,62
050,19,025,"Iowa","Calhoun County",3,55,116,60,56
050,19,025,"Iowa","Calhoun County",3,56,115,58,57
050,19,025,"Iowa","Calhoun County",3,57,114,63,51
050,19,025,"Iowa","Calhoun County",3,58,125,67,58
050,19,025,"Iowa","Calhoun County",3,59,138,70,68
050,19,025,"Iowa","Calhoun County",3,60,152,79,73
050,19,025,"Iowa","Calhoun County",3,61,154,79,75
050,19,025,"Iowa","Calhoun County",3,62,146,74,72
050,19,025,"Iowa","Calhoun County",3,63,154,78,76
050,19,025,"Iowa","Calhoun County",3,64,146,75,71
050,19,025,"Iowa","Calhoun County",3,65,151,76,75
050,19,025,"Iowa","Calhoun County",3,66,159,77,82
050,19,025,"Iowa","Calhoun County",3,67,145,76,69
050,19,025,"Iowa","Calhoun County",3,68,141,74,67
050,19,025,"Iowa","Calhoun County",3,69,145,74,71
050,19,025,"Iowa","Calhoun County",3,70,135,67,68
050,19,025,"Iowa","Calhoun County",3,71,111,59,52
050,19,025,"Iowa","Calhoun County",3,72,92,46,46
050,19,025,"Iowa","Calhoun County",3,73,91,45,46
050,19,025,"Iowa","Calhoun County",3,74,101,51,50
050,19,025,"Iowa","Calhoun County",3,75,73,34,39
050,19,025,"Iowa","Calhoun County",3,76,87,37,50
050,19,025,"Iowa","Calhoun County",3,77,90,38,52
050,19,025,"Iowa","Calhoun County",3,78,75,35,40
050,19,025,"Iowa","Calhoun County",3,79,67,35,32
050,19,025,"Iowa","Calhoun County",3,80,56,26,30
050,19,025,"Iowa","Calhoun County",3,81,48,17,31
050,19,025,"Iowa","Calhoun County",3,82,53,20,33
050,19,025,"Iowa","Calhoun County",3,83,65,27,38
050,19,025,"Iowa","Calhoun County",3,84,55,22,33
050,19,025,"Iowa","Calhoun County",3,85,365,124,241
050,19,025,"Iowa","Calhoun County",4,0,90,42,48
050,19,025,"Iowa","Calhoun County",4,1,81,41,40
050,19,025,"Iowa","Calhoun County",4,2,100,50,50
050,19,025,"Iowa","Calhoun County",4,3,99,51,48
050,19,025,"Iowa","Calhoun County",4,4,102,48,54
050,19,025,"Iowa","Calhoun County",4,5,110,57,53
050,19,025,"Iowa","Calhoun County",4,6,115,62,53
050,19,025,"Iowa","Calhoun County",4,7,125,61,64
050,19,025,"Iowa","Calhoun County",4,8,133,63,70
050,19,025,"Iowa","Calhoun County",4,9,142,76,66
050,19,025,"Iowa","Calhoun County",4,10,130,72,58
050,19,025,"Iowa","Calhoun County",4,11,116,63,53
050,19,025,"Iowa","Calhoun County",4,12,120,65,55
050,19,025,"Iowa","Calhoun County",4,13,134,72,62
050,19,025,"Iowa","Calhoun County",4,14,116,59,57
050,19,025,"Iowa","Calhoun County",4,15,122,59,63
050,19,025,"Iowa","Calhoun County",4,16,125,67,58
050,19,025,"Iowa","Calhoun County",4,17,123,62,61
050,19,025,"Iowa","Calhoun County",4,18,113,66,47
050,19,025,"Iowa","Calhoun County",4,19,92,58,34
050,19,025,"Iowa","Calhoun County",4,20,112,75,37
050,19,025,"Iowa","Calhoun County",4,21,103,62,41
050,19,025,"Iowa","Calhoun County",4,22,109,74,35
050,19,025,"Iowa","Calhoun County",4,23,102,59,43
050,19,025,"Iowa","Calhoun County",4,24,87,44,43
050,19,025,"Iowa","Calhoun County",4,25,110,69,41
050,19,025,"Iowa","Calhoun County",4,26,108,68,40
050,19,025,"Iowa","Calhoun County",4,27,113,69,44
050,19,025,"Iowa","Calhoun County",4,28,112,68,44
050,19,025,"Iowa","Calhoun County",4,29,121,65,56
050,19,025,"Iowa","Calhoun County",4,30,122,59,63
050,19,025,"Iowa","Calhoun County",4,31,109,56,53
050,19,025,"Iowa","Calhoun County",4,32,125,62,63
050,19,025,"Iowa","Calhoun County",4,33,113,61,52
050,19,025,"Iowa","Calhoun County",4,34,122,68,54
050,19,025,"Iowa","Calhoun County",4,35,130,76,54
050,19,025,"Iowa","Calhoun County",4,36,110,60,50
050,19,025,"Iowa","Calhoun County",4,37,100,59,41
050,19,025,"Iowa","Calhoun County",4,38,117,65,52
050,19,025,"Iowa","Calhoun County",4,39,107,59,48
050,19,025,"Iowa","Calhoun County",4,40,118,59,59
050,19,025,"Iowa","Calhoun County",4,41,116,56,60
050,19,025,"Iowa","Calhoun County",4,42,123,72,51
050,19,025,"Iowa","Calhoun County",4,43,114,69,45
050,19,025,"Iowa","Calhoun County",4,44,94,52,42
050,19,025,"Iowa","Calhoun County",4,45,110,66,44
050,19,025,"Iowa","Calhoun County",4,46,106,64,42
050,19,025,"Iowa","Calhoun County",4,47,101,62,39
050,19,025,"Iowa","Calhoun County",4,48,90,56,34
050,19,025,"Iowa","Calhoun County",4,49,95,57,38
050,19,025,"Iowa","Calhoun County",4,50,90,45,45
050,19,025,"Iowa","Calhoun County",4,51,110,58,52
050,19,025,"Iowa","Calhoun County",4,52,105,53,52
050,19,025,"Iowa","Calhoun County",4,53,111,55,56
050,19,025,"Iowa","Calhoun County",4,54,99,53,46
050,19,025,"Iowa","Calhoun County",4,55,119,54,65
050,19,025,"Iowa","Calhoun County",4,56,118,56,62
050,19,025,"Iowa","Calhoun County",4,57,118,62,56
050,19,025,"Iowa","Calhoun County",4,58,112,59,53
050,19,025,"Iowa","Calhoun County",4,59,123,68,55
050,19,025,"Iowa","Calhoun County",4,60,136,67,69
050,19,025,"Iowa","Calhoun County",4,61,154,80,74
050,19,025,"Iowa","Calhoun County",4,62,151,76,75
050,19,025,"Iowa","Calhoun County",4,63,142,69,73
050,19,025,"Iowa","Calhoun County",4,64,153,74,79
050,19,025,"Iowa","Calhoun County",4,65,146,77,69
050,19,025,"Iowa","Calhoun County",4,66,150,76,74
050,19,025,"Iowa","Calhoun County",4,67,156,71,85
050,19,025,"Iowa","Calhoun County",4,68,142,75,67
050,19,025,"Iowa","Calhoun County",4,69,134,70,64
050,19,025,"Iowa","Calhoun County",4,70,139,72,67
050,19,025,"Iowa","Calhoun County",4,71,128,61,67
050,19,025,"Iowa","Calhoun County",4,72,109,55,54
050,19,025,"Iowa","Calhoun County",4,73,83,41,42
050,19,025,"Iowa","Calhoun County",4,74,89,43,46
050,19,025,"Iowa","Calhoun County",4,75,94,48,46
050,19,025,"Iowa","Calhoun County",4,76,71,33,38
050,19,025,"Iowa","Calhoun County",4,77,84,35,49
050,19,025,"Iowa","Calhoun County",4,78,83,37,46
050,19,025,"Iowa","Calhoun County",4,79,73,33,40
050,19,025,"Iowa","Calhoun County",4,80,63,32,31
050,19,025,"Iowa","Calhoun County",4,81,52,23,29
050,19,025,"Iowa","Calhoun County",4,82,44,16,28
050,19,025,"Iowa","Calhoun County",4,83,54,20,34
050,19,025,"Iowa","Calhoun County",4,84,52,19,33
050,19,025,"Iowa","Calhoun County",4,85,351,125,226
050,19,025,"Iowa","Calhoun County",5,0,93,43,50
050,19,025,"Iowa","Calhoun County",5,1,96,41,55
050,19,025,"Iowa","Calhoun County",5,2,86,44,42
050,19,025,"Iowa","Calhoun County",5,3,101,51,50
050,19,025,"Iowa","Calhoun County",5,4,99,45,54
050,19,025,"Iowa","Calhoun County",5,5,114,56,58
050,19,025,"Iowa","Calhoun County",5,6,114,57,57
050,19,025,"Iowa","Calhoun County",5,7,117,63,54
050,19,025,"Iowa","Calhoun County",5,8,135,63,72
050,19,025,"Iowa","Calhoun County",5,9,139,62,77
050,19,025,"Iowa","Calhoun County",5,10,144,78,66
050,19,025,"Iowa","Calhoun County",5,11,140,76,64
050,19,025,"Iowa","Calhoun County",5,12,121,64,57
050,19,025,"Iowa","Calhoun County",5,13,126,70,56
050,19,025,"Iowa","Calhoun County",5,14,139,76,63
050,19,025,"Iowa","Calhoun County",5,15,113,57,56
050,19,025,"Iowa","Calhoun County",5,16,121,60,61
050,19,025,"Iowa","Calhoun County",5,17,128,67,61
050,19,025,"Iowa","Calhoun County",5,18,107,59,48
050,19,025,"Iowa","Calhoun County",5,19,102,63,39
050,19,025,"Iowa","Calhoun County",5,20,99,64,35
050,19,025,"Iowa","Calhoun County",5,21,101,64,37
050,19,025,"Iowa","Calhoun County",5,22,113,73,40
050,19,025,"Iowa","Calhoun County",5,23,102,62,40
050,19,025,"Iowa","Calhoun County",5,24,104,60,44
050,19,025,"Iowa","Calhoun County",5,25,97,52,45
050,19,025,"Iowa","Calhoun County",5,26,110,65,45
050,19,025,"Iowa","Calhoun County",5,27,114,72,42
050,19,025,"Iowa","Calhoun County",5,28,121,72,49
050,19,025,"Iowa","Calhoun County",5,29,106,58,48
050,19,025,"Iowa","Calhoun County",5,30,116,62,54
050,19,025,"Iowa","Calhoun County",5,31,127,62,65
050,19,025,"Iowa","Calhoun County",5,32,117,64,53
050,19,025,"Iowa","Calhoun County",5,33,122,64,58
050,19,025,"Iowa","Calhoun County",5,34,104,54,50
050,19,025,"Iowa","Calhoun County",5,35,121,64,57
050,19,025,"Iowa","Calhoun County",5,36,141,81,60
050,19,025,"Iowa","Calhoun County",5,37,109,58,51
050,19,025,"Iowa","Calhoun County",5,38,113,69,44
050,19,025,"Iowa","Calhoun County",5,39,121,66,55
050,19,025,"Iowa","Calhoun County",5,40,117,66,51
050,19,025,"Iowa","Calhoun County",5,41,122,61,61
050,19,025,"Iowa","Calhoun County",5,42,123,62,61
050,19,025,"Iowa","Calhoun County",5,43,113,64,49
050,19,025,"Iowa","Calhoun County",5,44,107,66,41
050,19,025,"Iowa","Calhoun County",5,45,94,52,42
050,19,025,"Iowa","Calhoun County",5,46,105,63,42
050,19,025,"Iowa","Calhoun County",5,47,95,56,39
050,19,025,"Iowa","Calhoun County",5,48,105,65,40
050,19,025,"Iowa","Calhoun County",5,49,91,55,36
050,19,025,"Iowa","Calhoun County",5,50,86,49,37
050,19,025,"Iowa","Calhoun County",5,51,98,55,43
050,19,025,"Iowa","Calhoun County",5,52,109,57,52
050,19,025,"Iowa","Calhoun County",5,53,112,59,53
050,19,025,"Iowa","Calhoun County",5,54,107,54,53
050,19,025,"Iowa","Calhoun County",5,55,94,49,45
050,19,025,"Iowa","Calhoun County",5,56,117,52,65
050,19,025,"Iowa","Calhoun County",5,57,119,60,59
050,19,025,"Iowa","Calhoun County",5,58,121,61,60
050,19,025,"Iowa","Calhoun County",5,59,113,61,52
050,19,025,"Iowa","Calhoun County",5,60,118,65,53
050,19,025,"Iowa","Calhoun County",5,61,142,71,71
050,19,025,"Iowa","Calhoun County",5,62,148,76,72
050,19,025,"Iowa","Calhoun County",5,63,150,75,75
050,19,025,"Iowa","Calhoun County",5,64,141,65,76
050,19,025,"Iowa","Calhoun County",5,65,150,72,78
050,19,025,"Iowa","Calhoun County",5,66,142,74,68
050,19,025,"Iowa","Calhoun County",5,67,151,74,77
050,19,025,"Iowa","Calhoun County",5,68,152,72,80
050,19,025,"Iowa","Calhoun County",5,69,137,73,64
050,19,025,"Iowa","Calhoun County",5,70,134,71,63
050,19,025,"Iowa","Calhoun County",5,71,135,69,66
050,19,025,"Iowa","Calhoun County",5,72,128,59,69
050,19,025,"Iowa","Calhoun County",5,73,103,53,50
050,19,025,"Iowa","Calhoun County",5,74,83,41,42
050,19,025,"Iowa","Calhoun County",5,75,85,43,42
050,19,025,"Iowa","Calhoun County",5,76,92,47,45
050,19,025,"Iowa","Calhoun County",5,77,71,32,39
050,19,025,"Iowa","Calhoun County",5,78,81,33,48
050,19,025,"Iowa","Calhoun County",5,79,80,34,46
050,19,025,"Iowa","Calhoun County",5,80,70,31,39
050,19,025,"Iowa","Calhoun County",5,81,60,29,31
050,19,025,"Iowa","Calhoun County",5,82,51,23,28
050,19,025,"Iowa","Calhoun County",5,83,44,15,29
050,19,025,"Iowa","Calhoun County",5,84,41,11,30
050,19,025,"Iowa","Calhoun County",5,85,333,116,217
050,19,027,"Iowa","Carroll County",1,0,230,117,113
050,19,027,"Iowa","Carroll County",1,1,236,129,107
050,19,027,"Iowa","Carroll County",1,2,260,149,111
050,19,027,"Iowa","Carroll County",1,3,273,152,121
050,19,027,"Iowa","Carroll County",1,4,264,138,126
050,19,027,"Iowa","Carroll County",1,5,297,150,147
050,19,027,"Iowa","Carroll County",1,6,277,153,124
050,19,027,"Iowa","Carroll County",1,7,281,158,123
050,19,027,"Iowa","Carroll County",1,8,312,151,161
050,19,027,"Iowa","Carroll County",1,9,272,138,134
050,19,027,"Iowa","Carroll County",1,10,284,142,142
050,19,027,"Iowa","Carroll County",1,11,312,169,143
050,19,027,"Iowa","Carroll County",1,12,313,177,136
050,19,027,"Iowa","Carroll County",1,13,316,163,153
050,19,027,"Iowa","Carroll County",1,14,300,157,143
050,19,027,"Iowa","Carroll County",1,15,287,147,140
050,19,027,"Iowa","Carroll County",1,16,293,145,148
050,19,027,"Iowa","Carroll County",1,17,286,145,141
050,19,027,"Iowa","Carroll County",1,18,241,122,119
050,19,027,"Iowa","Carroll County",1,19,195,96,99
050,19,027,"Iowa","Carroll County",1,20,200,104,96
050,19,027,"Iowa","Carroll County",1,21,215,117,98
050,19,027,"Iowa","Carroll County",1,22,228,123,105
050,19,027,"Iowa","Carroll County",1,23,208,100,108
050,19,027,"Iowa","Carroll County",1,24,191,101,90
050,19,027,"Iowa","Carroll County",1,25,222,104,118
050,19,027,"Iowa","Carroll County",1,26,239,116,123
050,19,027,"Iowa","Carroll County",1,27,219,111,108
050,19,027,"Iowa","Carroll County",1,28,229,111,118
050,19,027,"Iowa","Carroll County",1,29,224,113,111
050,19,027,"Iowa","Carroll County",1,30,211,104,107
050,19,027,"Iowa","Carroll County",1,31,191,97,94
050,19,027,"Iowa","Carroll County",1,32,213,110,103
050,19,027,"Iowa","Carroll County",1,33,218,108,110
050,19,027,"Iowa","Carroll County",1,34,249,125,124
050,19,027,"Iowa","Carroll County",1,35,237,123,114
050,19,027,"Iowa","Carroll County",1,36,226,122,104
050,19,027,"Iowa","Carroll County",1,37,235,124,111
050,19,027,"Iowa","Carroll County",1,38,250,137,113
050,19,027,"Iowa","Carroll County",1,39,232,120,112
050,19,027,"Iowa","Carroll County",1,40,223,115,108
050,19,027,"Iowa","Carroll County",1,41,221,112,109
050,19,027,"Iowa","Carroll County",1,42,242,115,127
050,19,027,"Iowa","Carroll County",1,43,246,125,121
050,19,027,"Iowa","Carroll County",1,44,222,116,106
050,19,027,"Iowa","Carroll County",1,45,213,110,103
050,19,027,"Iowa","Carroll County",1,46,198,101,97
050,19,027,"Iowa","Carroll County",1,47,205,100,105
050,19,027,"Iowa","Carroll County",1,48,198,101,97
050,19,027,"Iowa","Carroll County",1,49,225,116,109
050,19,027,"Iowa","Carroll County",1,50,228,118,110
050,19,027,"Iowa","Carroll County",1,51,242,123,119
050,19,027,"Iowa","Carroll County",1,52,240,126,114
050,19,027,"Iowa","Carroll County",1,53,268,145,123
050,19,027,"Iowa","Carroll County",1,54,267,134,133
050,19,027,"Iowa","Carroll County",1,55,286,156,130
050,19,027,"Iowa","Carroll County",1,56,296,147,149
050,19,027,"Iowa","Carroll County",1,57,296,140,156
050,19,027,"Iowa","Carroll County",1,58,325,157,168
050,19,027,"Iowa","Carroll County",1,59,314,164,150
050,19,027,"Iowa","Carroll County",1,60,315,168,147
050,19,027,"Iowa","Carroll County",1,61,318,172,146
050,19,027,"Iowa","Carroll County",1,62,315,160,155
050,19,027,"Iowa","Carroll County",1,63,306,146,160
050,19,027,"Iowa","Carroll County",1,64,299,142,157
050,19,027,"Iowa","Carroll County",1,65,294,144,150
050,19,027,"Iowa","Carroll County",1,66,253,128,125
050,19,027,"Iowa","Carroll County",1,67,274,139,135
050,19,027,"Iowa","Carroll County",1,68,270,125,145
050,19,027,"Iowa","Carroll County",1,69,250,123,127
050,19,027,"Iowa","Carroll County",1,70,217,114,103
050,19,027,"Iowa","Carroll County",1,71,198,101,97
050,19,027,"Iowa","Carroll County",1,72,187,88,99
050,19,027,"Iowa","Carroll County",1,73,174,85,89
050,19,027,"Iowa","Carroll County",1,74,125,59,66
050,19,027,"Iowa","Carroll County",1,75,148,66,82
050,19,027,"Iowa","Carroll County",1,76,158,73,85
050,19,027,"Iowa","Carroll County",1,77,150,64,86
050,19,027,"Iowa","Carroll County",1,78,135,54,81
050,19,027,"Iowa","Carroll County",1,79,128,55,73
050,19,027,"Iowa","Carroll County",1,80,130,52,78
050,19,027,"Iowa","Carroll County",1,81,134,54,80
050,19,027,"Iowa","Carroll County",1,82,124,53,71
050,19,027,"Iowa","Carroll County",1,83,114,45,69
050,19,027,"Iowa","Carroll County",1,84,108,44,64
050,19,027,"Iowa","Carroll County",1,85,714,236,478
050,19,027,"Iowa","Carroll County",2,0,243,133,110
050,19,027,"Iowa","Carroll County",2,1,235,128,107
050,19,027,"Iowa","Carroll County",2,2,256,145,111
050,19,027,"Iowa","Carroll County",2,3,268,151,117
050,19,027,"Iowa","Carroll County",2,4,266,141,125
050,19,027,"Iowa","Carroll County",2,5,289,148,141
050,19,027,"Iowa","Carroll County",2,6,279,151,128
050,19,027,"Iowa","Carroll County",2,7,281,158,123
050,19,027,"Iowa","Carroll County",2,8,302,151,151
050,19,027,"Iowa","Carroll County",2,9,277,140,137
050,19,027,"Iowa","Carroll County",2,10,281,141,140
050,19,027,"Iowa","Carroll County",2,11,304,163,141
050,19,027,"Iowa","Carroll County",2,12,314,175,139
050,19,027,"Iowa","Carroll County",2,13,312,166,146
050,19,027,"Iowa","Carroll County",2,14,304,160,144
050,19,027,"Iowa","Carroll County",2,15,290,149,141
050,19,027,"Iowa","Carroll County",2,16,293,147,146
050,19,027,"Iowa","Carroll County",2,17,288,144,144
050,19,027,"Iowa","Carroll County",2,18,240,122,118
050,19,027,"Iowa","Carroll County",2,19,196,98,98
050,19,027,"Iowa","Carroll County",2,20,202,104,98
050,19,027,"Iowa","Carroll County",2,21,213,114,99
050,19,027,"Iowa","Carroll County",2,22,224,120,104
050,19,027,"Iowa","Carroll County",2,23,209,103,106
050,19,027,"Iowa","Carroll County",2,24,194,101,93
050,19,027,"Iowa","Carroll County",2,25,216,103,113
050,19,027,"Iowa","Carroll County",2,26,235,114,121
050,19,027,"Iowa","Carroll County",2,27,223,113,110
050,19,027,"Iowa","Carroll County",2,28,227,112,115
050,19,027,"Iowa","Carroll County",2,29,224,112,112
050,19,027,"Iowa","Carroll County",2,30,216,107,109
050,19,027,"Iowa","Carroll County",2,31,195,97,98
050,19,027,"Iowa","Carroll County",2,32,208,108,100
050,19,027,"Iowa","Carroll County",2,33,216,107,109
050,19,027,"Iowa","Carroll County",2,34,241,121,120
050,19,027,"Iowa","Carroll County",2,35,237,123,114
050,19,027,"Iowa","Carroll County",2,36,223,119,104
050,19,027,"Iowa","Carroll County",2,37,235,124,111
050,19,027,"Iowa","Carroll County",2,38,248,134,114
050,19,027,"Iowa","Carroll County",2,39,234,123,111
050,19,027,"Iowa","Carroll County",2,40,229,118,111
050,19,027,"Iowa","Carroll County",2,41,222,113,109
050,19,027,"Iowa","Carroll County",2,42,235,113,122
050,19,027,"Iowa","Carroll County",2,43,243,122,121
050,19,027,"Iowa","Carroll County",2,44,225,116,109
050,19,027,"Iowa","Carroll County",2,45,215,112,103
050,19,027,"Iowa","Carroll County",2,46,200,102,98
050,19,027,"Iowa","Carroll County",2,47,201,99,102
050,19,027,"Iowa","Carroll County",2,48,198,100,98
050,19,027,"Iowa","Carroll County",2,49,220,114,106
050,19,027,"Iowa","Carroll County",2,50,227,116,111
050,19,027,"Iowa","Carroll County",2,51,240,124,116
050,19,027,"Iowa","Carroll County",2,52,241,127,114
050,19,027,"Iowa","Carroll County",2,53,261,140,121
050,19,027,"Iowa","Carroll County",2,54,264,136,128
050,19,027,"Iowa","Carroll County",2,55,281,150,131
050,19,027,"Iowa","Carroll County",2,56,294,150,144
050,19,027,"Iowa","Carroll County",2,57,295,141,154
050,19,027,"Iowa","Carroll County",2,58,319,153,166
050,19,027,"Iowa","Carroll County",2,59,319,164,155
050,19,027,"Iowa","Carroll County",2,60,311,165,146
050,19,027,"Iowa","Carroll County",2,61,317,170,147
050,19,027,"Iowa","Carroll County",2,62,316,161,155
050,19,027,"Iowa","Carroll County",2,63,311,150,161
050,19,027,"Iowa","Carroll County",2,64,297,141,156
050,19,027,"Iowa","Carroll County",2,65,295,144,151
050,19,027,"Iowa","Carroll County",2,66,262,132,130
050,19,027,"Iowa","Carroll County",2,67,270,136,134
050,19,027,"Iowa","Carroll County",2,68,267,127,140
050,19,027,"Iowa","Carroll County",2,69,257,124,133
050,19,027,"Iowa","Carroll County",2,70,223,114,109
050,19,027,"Iowa","Carroll County",2,71,203,105,98
050,19,027,"Iowa","Carroll County",2,72,186,90,96
050,19,027,"Iowa","Carroll County",2,73,185,89,96
050,19,027,"Iowa","Carroll County",2,74,127,60,67
050,19,027,"Iowa","Carroll County",2,75,144,66,78
050,19,027,"Iowa","Carroll County",2,76,154,71,83
050,19,027,"Iowa","Carroll County",2,77,157,68,89
050,19,027,"Iowa","Carroll County",2,78,132,53,79
050,19,027,"Iowa","Carroll County",2,79,127,54,73
050,19,027,"Iowa","Carroll County",2,80,128,51,77
050,19,027,"Iowa","Carroll County",2,81,129,51,78
050,19,027,"Iowa","Carroll County",2,82,125,52,73
050,19,027,"Iowa","Carroll County",2,83,117,48,69
050,19,027,"Iowa","Carroll County",2,84,106,42,64
050,19,027,"Iowa","Carroll County",2,85,713,239,474
050,19,027,"Iowa","Carroll County",3,0,224,118,106
050,19,027,"Iowa","Carroll County",3,1,259,148,111
050,19,027,"Iowa","Carroll County",3,2,230,125,105
050,19,027,"Iowa","Carroll County",3,3,257,142,115
050,19,027,"Iowa","Carroll County",3,4,276,148,128
050,19,027,"Iowa","Carroll County",3,5,263,144,119
050,19,027,"Iowa","Carroll County",3,6,294,153,141
050,19,027,"Iowa","Carroll County",3,7,296,163,133
050,19,027,"Iowa","Carroll County",3,8,286,156,130
050,19,027,"Iowa","Carroll County",3,9,300,150,150
050,19,027,"Iowa","Carroll County",3,10,281,137,144
050,19,027,"Iowa","Carroll County",3,11,290,147,143
050,19,027,"Iowa","Carroll County",3,12,305,159,146
050,19,027,"Iowa","Carroll County",3,13,312,173,139
050,19,027,"Iowa","Carroll County",3,14,313,165,148
050,19,027,"Iowa","Carroll County",3,15,320,173,147
050,19,027,"Iowa","Carroll County",3,16,289,145,144
050,19,027,"Iowa","Carroll County",3,17,299,150,149
050,19,027,"Iowa","Carroll County",3,18,241,124,117
050,19,027,"Iowa","Carroll County",3,19,188,96,92
050,19,027,"Iowa","Carroll County",3,20,203,100,103
050,19,027,"Iowa","Carroll County",3,21,220,112,108
050,19,027,"Iowa","Carroll County",3,22,224,118,106
050,19,027,"Iowa","Carroll County",3,23,226,116,110
050,19,027,"Iowa","Carroll County",3,24,195,103,92
050,19,027,"Iowa","Carroll County",3,25,192,94,98
050,19,027,"Iowa","Carroll County",3,26,218,106,112
050,19,027,"Iowa","Carroll County",3,27,231,115,116
050,19,027,"Iowa","Carroll County",3,28,232,117,115
050,19,027,"Iowa","Carroll County",3,29,223,111,112
050,19,027,"Iowa","Carroll County",3,30,238,116,122
050,19,027,"Iowa","Carroll County",3,31,218,110,108
050,19,027,"Iowa","Carroll County",3,32,188,93,95
050,19,027,"Iowa","Carroll County",3,33,227,112,115
050,19,027,"Iowa","Carroll County",3,34,236,124,112
050,19,027,"Iowa","Carroll County",3,35,236,124,112
050,19,027,"Iowa","Carroll County",3,36,235,124,111
050,19,027,"Iowa","Carroll County",3,37,224,119,105
050,19,027,"Iowa","Carroll County",3,38,242,130,112
050,19,027,"Iowa","Carroll County",3,39,245,131,114
050,19,027,"Iowa","Carroll County",3,40,238,126,112
050,19,027,"Iowa","Carroll County",3,41,231,115,116
050,19,027,"Iowa","Carroll County",3,42,224,112,112
050,19,027,"Iowa","Carroll County",3,43,229,114,115
050,19,027,"Iowa","Carroll County",3,44,244,121,123
050,19,027,"Iowa","Carroll County",3,45,232,115,117
050,19,027,"Iowa","Carroll County",3,46,201,107,94
050,19,027,"Iowa","Carroll County",3,47,202,105,97
050,19,027,"Iowa","Carroll County",3,48,203,98,105
050,19,027,"Iowa","Carroll County",3,49,194,100,94
050,19,027,"Iowa","Carroll County",3,50,221,112,109
050,19,027,"Iowa","Carroll County",3,51,232,120,112
050,19,027,"Iowa","Carroll County",3,52,241,124,117
050,19,027,"Iowa","Carroll County",3,53,240,127,113
050,19,027,"Iowa","Carroll County",3,54,250,134,116
050,19,027,"Iowa","Carroll County",3,55,264,134,130
050,19,027,"Iowa","Carroll County",3,56,288,153,135
050,19,027,"Iowa","Carroll County",3,57,289,148,141
050,19,027,"Iowa","Carroll County",3,58,292,143,149
050,19,027,"Iowa","Carroll County",3,59,315,152,163
050,19,027,"Iowa","Carroll County",3,60,318,164,154
050,19,027,"Iowa","Carroll County",3,61,316,168,148
050,19,027,"Iowa","Carroll County",3,62,314,161,153
050,19,027,"Iowa","Carroll County",3,63,314,158,156
050,19,027,"Iowa","Carroll County",3,64,307,148,159
050,19,027,"Iowa","Carroll County",3,65,295,137,158
050,19,027,"Iowa","Carroll County",3,66,290,141,149
050,19,027,"Iowa","Carroll County",3,67,263,133,130
050,19,027,"Iowa","Carroll County",3,68,261,133,128
050,19,027,"Iowa","Carroll County",3,69,262,122,140
050,19,027,"Iowa","Carroll County",3,70,248,121,127
050,19,027,"Iowa","Carroll County",3,71,213,107,106
050,19,027,"Iowa","Carroll County",3,72,202,102,100
050,19,027,"Iowa","Carroll County",3,73,178,85,93
050,19,027,"Iowa","Carroll County",3,74,178,82,96
050,19,027,"Iowa","Carroll County",3,75,132,63,69
050,19,027,"Iowa","Carroll County",3,76,137,61,76
050,19,027,"Iowa","Carroll County",3,77,146,65,81
050,19,027,"Iowa","Carroll County",3,78,144,62,82
050,19,027,"Iowa","Carroll County",3,79,127,51,76
050,19,027,"Iowa","Carroll County",3,80,124,55,69
050,19,027,"Iowa","Carroll County",3,81,117,41,76
050,19,027,"Iowa","Carroll County",3,82,124,49,75
050,19,027,"Iowa","Carroll County",3,83,122,53,69
050,19,027,"Iowa","Carroll County",3,84,103,39,64
050,19,027,"Iowa","Carroll County",3,85,699,240,459
050,19,027,"Iowa","Carroll County",4,0,248,135,113
050,19,027,"Iowa","Carroll County",4,1,211,115,96
050,19,027,"Iowa","Carroll County",4,2,261,150,111
050,19,027,"Iowa","Carroll County",4,3,228,118,110
050,19,027,"Iowa","Carroll County",4,4,265,149,116
050,19,027,"Iowa","Carroll County",4,5,271,146,125
050,19,027,"Iowa","Carroll County",4,6,266,141,125
050,19,027,"Iowa","Carroll County",4,7,288,150,138
050,19,027,"Iowa","Carroll County",4,8,295,157,138
050,19,027,"Iowa","Carroll County",4,9,279,154,125
050,19,027,"Iowa","Carroll County",4,10,304,151,153
050,19,027,"Iowa","Carroll County",4,11,278,135,143
050,19,027,"Iowa","Carroll County",4,12,271,138,133
050,19,027,"Iowa","Carroll County",4,13,300,162,138
050,19,027,"Iowa","Carroll County",4,14,300,168,132
050,19,027,"Iowa","Carroll County",4,15,309,168,141
050,19,027,"Iowa","Carroll County",4,16,324,172,152
050,19,027,"Iowa","Carroll County",4,17,295,147,148
050,19,027,"Iowa","Carroll County",4,18,254,134,120
050,19,027,"Iowa","Carroll County",4,19,185,98,87
050,19,027,"Iowa","Carroll County",4,20,190,96,94
050,19,027,"Iowa","Carroll County",4,21,221,107,114
050,19,027,"Iowa","Carroll County",4,22,243,118,125
050,19,027,"Iowa","Carroll County",4,23,224,119,105
050,19,027,"Iowa","Carroll County",4,24,226,120,106
050,19,027,"Iowa","Carroll County",4,25,188,99,89
050,19,027,"Iowa","Carroll County",4,26,198,110,88
050,19,027,"Iowa","Carroll County",4,27,210,102,108
050,19,027,"Iowa","Carroll County",4,28,233,115,118
050,19,027,"Iowa","Carroll County",4,29,235,116,119
050,19,027,"Iowa","Carroll County",4,30,222,116,106
050,19,027,"Iowa","Carroll County",4,31,241,114,127
050,19,027,"Iowa","Carroll County",4,32,229,119,110
050,19,027,"Iowa","Carroll County",4,33,197,95,102
050,19,027,"Iowa","Carroll County",4,34,231,116,115
050,19,027,"Iowa","Carroll County",4,35,233,123,110
050,19,027,"Iowa","Carroll County",4,36,232,122,110
050,19,027,"Iowa","Carroll County",4,37,226,116,110
050,19,027,"Iowa","Carroll County",4,38,218,116,102
050,19,027,"Iowa","Carroll County",4,39,228,121,107
050,19,027,"Iowa","Carroll County",4,40,237,124,113
050,19,027,"Iowa","Carroll County",4,41,247,131,116
050,19,027,"Iowa","Carroll County",4,42,229,113,116
050,19,027,"Iowa","Carroll County",4,43,224,114,110
050,19,027,"Iowa","Carroll County",4,44,236,113,123
050,19,027,"Iowa","Carroll County",4,45,242,120,122
050,19,027,"Iowa","Carroll County",4,46,231,116,115
050,19,027,"Iowa","Carroll County",4,47,203,109,94
050,19,027,"Iowa","Carroll County",4,48,200,101,99
050,19,027,"Iowa","Carroll County",4,49,203,101,102
050,19,027,"Iowa","Carroll County",4,50,192,103,89
050,19,027,"Iowa","Carroll County",4,51,230,119,111
050,19,027,"Iowa","Carroll County",4,52,234,121,113
050,19,027,"Iowa","Carroll County",4,53,234,121,113
050,19,027,"Iowa","Carroll County",4,54,236,120,116
050,19,027,"Iowa","Carroll County",4,55,247,130,117
050,19,027,"Iowa","Carroll County",4,56,257,132,125
050,19,027,"Iowa","Carroll County",4,57,281,144,137
050,19,027,"Iowa","Carroll County",4,58,278,144,134
050,19,027,"Iowa","Carroll County",4,59,286,140,146
050,19,027,"Iowa","Carroll County",4,60,315,150,165
050,19,027,"Iowa","Carroll County",4,61,313,163,150
050,19,027,"Iowa","Carroll County",4,62,314,154,160
050,19,027,"Iowa","Carroll County",4,63,305,158,147
050,19,027,"Iowa","Carroll County",4,64,304,153,151
050,19,027,"Iowa","Carroll County",4,65,299,147,152
050,19,027,"Iowa","Carroll County",4,66,297,134,163
050,19,027,"Iowa","Carroll County",4,67,291,140,151
050,19,027,"Iowa","Carroll County",4,68,260,132,128
050,19,027,"Iowa","Carroll County",4,69,260,132,128
050,19,027,"Iowa","Carroll County",4,70,257,120,137
050,19,027,"Iowa","Carroll County",4,71,237,115,122
050,19,027,"Iowa","Carroll County",4,72,203,103,100
050,19,027,"Iowa","Carroll County",4,73,195,101,94
050,19,027,"Iowa","Carroll County",4,74,170,77,93
050,19,027,"Iowa","Carroll County",4,75,179,83,96
050,19,027,"Iowa","Carroll County",4,76,130,61,69
050,19,027,"Iowa","Carroll County",4,77,126,58,68
050,19,027,"Iowa","Carroll County",4,78,131,55,76
050,19,027,"Iowa","Carroll County",4,79,137,54,83
050,19,027,"Iowa","Carroll County",4,80,125,51,74
050,19,027,"Iowa","Carroll County",4,81,114,46,68
050,19,027,"Iowa","Carroll County",4,82,112,38,74
050,19,027,"Iowa","Carroll County",4,83,121,52,69
050,19,027,"Iowa","Carroll County",4,84,110,42,68
050,19,027,"Iowa","Carroll County",4,85,652,217,435
050,19,027,"Iowa","Carroll County",5,0,248,136,112
050,19,027,"Iowa","Carroll County",5,1,234,125,109
050,19,027,"Iowa","Carroll County",5,2,224,116,108
050,19,027,"Iowa","Carroll County",5,3,270,158,112
050,19,027,"Iowa","Carroll County",5,4,227,115,112
050,19,027,"Iowa","Carroll County",5,5,272,151,121
050,19,027,"Iowa","Carroll County",5,6,263,147,116
050,19,027,"Iowa","Carroll County",5,7,279,142,137
050,19,027,"Iowa","Carroll County",5,8,291,148,143
050,19,027,"Iowa","Carroll County",5,9,292,154,138
050,19,027,"Iowa","Carroll County",5,10,284,159,125
050,19,027,"Iowa","Carroll County",5,11,302,152,150
050,19,027,"Iowa","Carroll County",5,12,279,135,144
050,19,027,"Iowa","Carroll County",5,13,274,138,136
050,19,027,"Iowa","Carroll County",5,14,299,157,142
050,19,027,"Iowa","Carroll County",5,15,312,172,140
050,19,027,"Iowa","Carroll County",5,16,322,171,151
050,19,027,"Iowa","Carroll County",5,17,331,171,160
050,19,027,"Iowa","Carroll County",5,18,247,129,118
050,19,027,"Iowa","Carroll County",5,19,191,102,89
050,19,027,"Iowa","Carroll County",5,20,203,109,94
050,19,027,"Iowa","Carroll County",5,21,201,111,90
050,19,027,"Iowa","Carroll County",5,22,235,113,122
050,19,027,"Iowa","Carroll County",5,23,240,115,125
050,19,027,"Iowa","Carroll County",5,24,212,117,95
050,19,027,"Iowa","Carroll County",5,25,209,103,106
050,19,027,"Iowa","Carroll County",5,26,184,97,87
050,19,027,"Iowa","Carroll County",5,27,203,109,94
050,19,027,"Iowa","Carroll County",5,28,235,113,122
050,19,027,"Iowa","Carroll County",5,29,220,111,109
050,19,027,"Iowa","Carroll County",5,30,237,121,116
050,19,027,"Iowa","Carroll County",5,31,223,117,106
050,19,027,"Iowa","Carroll County",5,32,243,117,126
050,19,027,"Iowa","Carroll County",5,33,232,117,115
050,19,027,"Iowa","Carroll County",5,34,213,99,114
050,19,027,"Iowa","Carroll County",5,35,231,122,109
050,19,027,"Iowa","Carroll County",5,36,227,119,108
050,19,027,"Iowa","Carroll County",5,37,229,119,110
050,19,027,"Iowa","Carroll County",5,38,228,112,116
050,19,027,"Iowa","Carroll County",5,39,211,116,95
050,19,027,"Iowa","Carroll County",5,40,236,127,109
050,19,027,"Iowa","Carroll County",5,41,248,131,117
050,19,027,"Iowa","Carroll County",5,42,253,134,119
050,19,027,"Iowa","Carroll County",5,43,238,119,119
050,19,027,"Iowa","Carroll County",5,44,222,108,114
050,19,027,"Iowa","Carroll County",5,45,243,117,126
050,19,027,"Iowa","Carroll County",5,46,234,118,116
050,19,027,"Iowa","Carroll County",5,47,226,116,110
050,19,027,"Iowa","Carroll County",5,48,207,109,98
050,19,027,"Iowa","Carroll County",5,49,202,103,99
050,19,027,"Iowa","Carroll County",5,50,200,99,101
050,19,027,"Iowa","Carroll County",5,51,200,110,90
050,19,027,"Iowa","Carroll County",5,52,236,123,113
050,19,027,"Iowa","Carroll County",5,53,228,116,112
050,19,027,"Iowa","Carroll County",5,54,226,117,109
050,19,027,"Iowa","Carroll County",5,55,229,119,110
050,19,027,"Iowa","Carroll County",5,56,248,131,117
050,19,027,"Iowa","Carroll County",5,57,260,133,127
050,19,027,"Iowa","Carroll County",5,58,266,141,125
050,19,027,"Iowa","Carroll County",5,59,278,142,136
050,19,027,"Iowa","Carroll County",5,60,294,143,151
050,19,027,"Iowa","Carroll County",5,61,322,154,168
050,19,027,"Iowa","Carroll County",5,62,307,153,154
050,19,027,"Iowa","Carroll County",5,63,301,149,152
050,19,027,"Iowa","Carroll County",5,64,296,150,146
050,19,027,"Iowa","Carroll County",5,65,303,151,152
050,19,027,"Iowa","Carroll County",5,66,289,145,144
050,19,027,"Iowa","Carroll County",5,67,301,136,165
050,19,027,"Iowa","Carroll County",5,68,288,137,151
050,19,027,"Iowa","Carroll County",5,69,256,130,126
050,19,027,"Iowa","Carroll County",5,70,257,132,125
050,19,027,"Iowa","Carroll County",5,71,246,114,132
050,19,027,"Iowa","Carroll County",5,72,230,109,121
050,19,027,"Iowa","Carroll County",5,73,200,103,97
050,19,027,"Iowa","Carroll County",5,74,188,93,95
050,19,027,"Iowa","Carroll County",5,75,170,78,92
050,19,027,"Iowa","Carroll County",5,76,170,77,93
050,19,027,"Iowa","Carroll County",5,77,120,60,60
050,19,027,"Iowa","Carroll County",5,78,119,54,65
050,19,027,"Iowa","Carroll County",5,79,123,48,75
050,19,027,"Iowa","Carroll County",5,80,133,53,80
050,19,027,"Iowa","Carroll County",5,81,113,41,72
050,19,027,"Iowa","Carroll County",5,82,111,43,68
050,19,027,"Iowa","Carroll County",5,83,109,42,67
050,19,027,"Iowa","Carroll County",5,84,107,42,65
050,19,027,"Iowa","Carroll County",5,85,632,208,424
050,19,029,"Iowa","Cass County",1,0,139,70,69
050,19,029,"Iowa","Cass County",1,1,138,68,70
050,19,029,"Iowa","Cass County",1,2,129,69,60
050,19,029,"Iowa","Cass County",1,3,137,68,69
050,19,029,"Iowa","Cass County",1,4,162,78,84
050,19,029,"Iowa","Cass County",1,5,142,71,71
050,19,029,"Iowa","Cass County",1,6,152,73,79
050,19,029,"Iowa","Cass County",1,7,164,85,79
050,19,029,"Iowa","Cass County",1,8,158,77,81
050,19,029,"Iowa","Cass County",1,9,156,77,79
050,19,029,"Iowa","Cass County",1,10,171,89,82
050,19,029,"Iowa","Cass County",1,11,185,91,94
050,19,029,"Iowa","Cass County",1,12,207,114,93
050,19,029,"Iowa","Cass County",1,13,203,103,100
050,19,029,"Iowa","Cass County",1,14,197,106,91
050,19,029,"Iowa","Cass County",1,15,183,98,85
050,19,029,"Iowa","Cass County",1,16,187,102,85
050,19,029,"Iowa","Cass County",1,17,180,93,87
050,19,029,"Iowa","Cass County",1,18,139,76,63
050,19,029,"Iowa","Cass County",1,19,117,62,55
050,19,029,"Iowa","Cass County",1,20,113,61,52
050,19,029,"Iowa","Cass County",1,21,116,58,58
050,19,029,"Iowa","Cass County",1,22,112,63,49
050,19,029,"Iowa","Cass County",1,23,118,68,50
050,19,029,"Iowa","Cass County",1,24,125,59,66
050,19,029,"Iowa","Cass County",1,25,125,63,62
050,19,029,"Iowa","Cass County",1,26,147,69,78
050,19,029,"Iowa","Cass County",1,27,135,72,63
050,19,029,"Iowa","Cass County",1,28,144,77,67
050,19,029,"Iowa","Cass County",1,29,136,68,68
050,19,029,"Iowa","Cass County",1,30,151,74,77
050,19,029,"Iowa","Cass County",1,31,135,63,72
050,19,029,"Iowa","Cass County",1,32,124,62,62
050,19,029,"Iowa","Cass County",1,33,116,65,51
050,19,029,"Iowa","Cass County",1,34,124,66,58
050,19,029,"Iowa","Cass County",1,35,134,61,73
050,19,029,"Iowa","Cass County",1,36,152,80,72
050,19,029,"Iowa","Cass County",1,37,148,78,70
050,19,029,"Iowa","Cass County",1,38,156,80,76
050,19,029,"Iowa","Cass County",1,39,167,91,76
050,19,029,"Iowa","Cass County",1,40,171,90,81
050,19,029,"Iowa","Cass County",1,41,154,86,68
050,19,029,"Iowa","Cass County",1,42,148,77,71
050,19,029,"Iowa","Cass County",1,43,134,64,70
050,19,029,"Iowa","Cass County",1,44,138,59,79
050,19,029,"Iowa","Cass County",1,45,141,77,64
050,19,029,"Iowa","Cass County",1,46,141,76,65
050,19,029,"Iowa","Cass County",1,47,132,68,64
050,19,029,"Iowa","Cass County",1,48,155,85,70
050,19,029,"Iowa","Cass County",1,49,146,81,65
050,19,029,"Iowa","Cass County",1,50,142,77,65
050,19,029,"Iowa","Cass County",1,51,124,63,61
050,19,029,"Iowa","Cass County",1,52,133,68,65
050,19,029,"Iowa","Cass County",1,53,150,75,75
050,19,029,"Iowa","Cass County",1,54,156,79,77
050,19,029,"Iowa","Cass County",1,55,188,95,93
050,19,029,"Iowa","Cass County",1,56,184,87,97
050,19,029,"Iowa","Cass County",1,57,193,88,105
050,19,029,"Iowa","Cass County",1,58,223,106,117
050,19,029,"Iowa","Cass County",1,59,209,99,110
050,19,029,"Iowa","Cass County",1,60,203,103,100
050,19,029,"Iowa","Cass County",1,61,211,94,117
050,19,029,"Iowa","Cass County",1,62,210,106,104
050,19,029,"Iowa","Cass County",1,63,198,102,96
050,19,029,"Iowa","Cass County",1,64,209,108,101
050,19,029,"Iowa","Cass County",1,65,202,105,97
050,19,029,"Iowa","Cass County",1,66,181,91,90
050,19,029,"Iowa","Cass County",1,67,184,85,99
050,19,029,"Iowa","Cass County",1,68,181,88,93
050,19,029,"Iowa","Cass County",1,69,167,80,87
050,19,029,"Iowa","Cass County",1,70,163,75,88
050,19,029,"Iowa","Cass County",1,71,155,76,79
050,19,029,"Iowa","Cass County",1,72,165,85,80
050,19,029,"Iowa","Cass County",1,73,155,76,79
050,19,029,"Iowa","Cass County",1,74,114,51,63
050,19,029,"Iowa","Cass County",1,75,119,56,63
050,19,029,"Iowa","Cass County",1,76,114,52,62
050,19,029,"Iowa","Cass County",1,77,114,52,62
050,19,029,"Iowa","Cass County",1,78,104,48,56
050,19,029,"Iowa","Cass County",1,79,93,38,55
050,19,029,"Iowa","Cass County",1,80,84,33,51
050,19,029,"Iowa","Cass County",1,81,89,38,51
050,19,029,"Iowa","Cass County",1,82,81,40,41
050,19,029,"Iowa","Cass County",1,83,73,33,40
050,19,029,"Iowa","Cass County",1,84,70,27,43
050,19,029,"Iowa","Cass County",1,85,409,129,280
050,19,029,"Iowa","Cass County",2,0,134,66,68
050,19,029,"Iowa","Cass County",2,1,136,67,69
050,19,029,"Iowa","Cass County",2,2,132,70,62
050,19,029,"Iowa","Cass County",2,3,136,69,67
050,19,029,"Iowa","Cass County",2,4,156,76,80
050,19,029,"Iowa","Cass County",2,5,150,74,76
050,19,029,"Iowa","Cass County",2,6,151,74,77
050,19,029,"Iowa","Cass County",2,7,160,82,78
050,19,029,"Iowa","Cass County",2,8,158,78,80
050,19,029,"Iowa","Cass County",2,9,155,76,79
050,19,029,"Iowa","Cass County",2,10,168,87,81
050,19,029,"Iowa","Cass County",2,11,181,90,91
050,19,029,"Iowa","Cass County",2,12,202,108,94
050,19,029,"Iowa","Cass County",2,13,205,105,100
050,19,029,"Iowa","Cass County",2,14,200,106,94
050,19,029,"Iowa","Cass County",2,15,188,100,88
050,19,029,"Iowa","Cass County",2,16,187,101,86
050,19,029,"Iowa","Cass County",2,17,182,94,88
050,19,029,"Iowa","Cass County",2,18,140,76,64
050,19,029,"Iowa","Cass County",2,19,116,62,54
050,19,029,"Iowa","Cass County",2,20,115,61,54
050,19,029,"Iowa","Cass County",2,21,115,59,56
050,19,029,"Iowa","Cass County",2,22,115,63,52
050,19,029,"Iowa","Cass County",2,23,117,66,51
050,19,029,"Iowa","Cass County",2,24,120,60,60
050,19,029,"Iowa","Cass County",2,25,127,63,64
050,19,029,"Iowa","Cass County",2,26,142,67,75
050,19,029,"Iowa","Cass County",2,27,140,73,67
050,19,029,"Iowa","Cass County",2,28,144,78,66
050,19,029,"Iowa","Cass County",2,29,139,71,68
050,19,029,"Iowa","Cass County",2,30,146,71,75
050,19,029,"Iowa","Cass County",2,31,141,67,74
050,19,029,"Iowa","Cass County",2,32,126,62,64
050,19,029,"Iowa","Cass County",2,33,117,64,53
050,19,029,"Iowa","Cass County",2,34,121,65,56
050,19,029,"Iowa","Cass County",2,35,134,64,70
050,19,029,"Iowa","Cass County",2,36,147,76,71
050,19,029,"Iowa","Cass County",2,37,150,80,70
050,19,029,"Iowa","Cass County",2,38,156,80,76
050,19,029,"Iowa","Cass County",2,39,166,89,77
050,19,029,"Iowa","Cass County",2,40,173,93,80
050,19,029,"Iowa","Cass County",2,41,155,85,70
050,19,029,"Iowa","Cass County",2,42,146,77,69
050,19,029,"Iowa","Cass County",2,43,137,67,70
050,19,029,"Iowa","Cass County",2,44,137,61,76
050,19,029,"Iowa","Cass County",2,45,142,73,69
050,19,029,"Iowa","Cass County",2,46,140,75,65
050,19,029,"Iowa","Cass County",2,47,135,70,65
050,19,029,"Iowa","Cass County",2,48,149,81,68
050,19,029,"Iowa","Cass County",2,49,149,82,67
050,19,029,"Iowa","Cass County",2,50,142,77,65
050,19,029,"Iowa","Cass County",2,51,128,66,62
050,19,029,"Iowa","Cass County",2,52,130,67,63
050,19,029,"Iowa","Cass County",2,53,147,74,73
050,19,029,"Iowa","Cass County",2,54,155,79,76
050,19,029,"Iowa","Cass County",2,55,179,91,88
050,19,029,"Iowa","Cass County",2,56,185,88,97
050,19,029,"Iowa","Cass County",2,57,190,88,102
050,19,029,"Iowa","Cass County",2,58,215,101,114
050,19,029,"Iowa","Cass County",2,59,212,100,112
050,19,029,"Iowa","Cass County",2,60,206,102,104
050,19,029,"Iowa","Cass County",2,61,207,95,112
050,19,029,"Iowa","Cass County",2,62,209,102,107
050,19,029,"Iowa","Cass County",2,63,204,104,100
050,19,029,"Iowa","Cass County",2,64,206,107,99
050,19,029,"Iowa","Cass County",2,65,201,105,96
050,19,029,"Iowa","Cass County",2,66,186,95,91
050,19,029,"Iowa","Cass County",2,67,184,86,98
050,19,029,"Iowa","Cass County",2,68,180,87,93
050,19,029,"Iowa","Cass County",2,69,173,82,91
050,19,029,"Iowa","Cass County",2,70,163,74,89
050,19,029,"Iowa","Cass County",2,71,155,73,82
050,19,029,"Iowa","Cass County",2,72,158,81,77
050,19,029,"Iowa","Cass County",2,73,166,82,84
050,19,029,"Iowa","Cass County",2,74,114,52,62
050,19,029,"Iowa","Cass County",2,75,119,56,63
050,19,029,"Iowa","Cass County",2,76,114,52,62
050,19,029,"Iowa","Cass County",2,77,117,53,64
050,19,029,"Iowa","Cass County",2,78,101,46,55
050,19,029,"Iowa","Cass County",2,79,95,40,55
050,19,029,"Iowa","Cass County",2,80,84,33,51
050,19,029,"Iowa","Cass County",2,81,85,35,50
050,19,029,"Iowa","Cass County",2,82,81,38,43
050,19,029,"Iowa","Cass County",2,83,75,35,40
050,19,029,"Iowa","Cass County",2,84,70,28,42
050,19,029,"Iowa","Cass County",2,85,409,129,280
050,19,029,"Iowa","Cass County",3,0,127,69,58
050,19,029,"Iowa","Cass County",3,1,139,72,67
050,19,029,"Iowa","Cass County",3,2,144,75,69
050,19,029,"Iowa","Cass County",3,3,140,76,64
050,19,029,"Iowa","Cass County",3,4,152,73,79
050,19,029,"Iowa","Cass County",3,5,153,75,78
050,19,029,"Iowa","Cass County",3,6,156,76,80
050,19,029,"Iowa","Cass County",3,7,149,73,76
050,19,029,"Iowa","Cass County",3,8,174,87,87
050,19,029,"Iowa","Cass County",3,9,164,83,81
050,19,029,"Iowa","Cass County",3,10,158,76,82
050,19,029,"Iowa","Cass County",3,11,166,86,80
050,19,029,"Iowa","Cass County",3,12,189,99,90
050,19,029,"Iowa","Cass County",3,13,201,106,95
050,19,029,"Iowa","Cass County",3,14,208,107,101
050,19,029,"Iowa","Cass County",3,15,190,101,89
050,19,029,"Iowa","Cass County",3,16,193,101,92
050,19,029,"Iowa","Cass County",3,17,185,103,82
050,19,029,"Iowa","Cass County",3,18,158,83,75
050,19,029,"Iowa","Cass County",3,19,112,60,52
050,19,029,"Iowa","Cass County",3,20,109,59,50
050,19,029,"Iowa","Cass County",3,21,123,66,57
050,19,029,"Iowa","Cass County",3,22,117,61,56
050,19,029,"Iowa","Cass County",3,23,116,61,55
050,19,029,"Iowa","Cass County",3,24,106,64,42
050,19,029,"Iowa","Cass County",3,25,125,66,59
050,19,029,"Iowa","Cass County",3,26,127,60,67
050,19,029,"Iowa","Cass County",3,27,139,62,77
050,19,029,"Iowa","Cass County",3,28,151,77,74
050,19,029,"Iowa","Cass County",3,29,146,77,69
050,19,029,"Iowa","Cass County",3,30,147,76,71
050,19,029,"Iowa","Cass County",3,31,146,72,74
050,19,029,"Iowa","Cass County",3,32,141,62,79
050,19,029,"Iowa","Cass County",3,33,127,64,63
050,19,029,"Iowa","Cass County",3,34,124,68,56
050,19,029,"Iowa","Cass County",3,35,127,70,57
050,19,029,"Iowa","Cass County",3,36,131,62,69
050,19,029,"Iowa","Cass County",3,37,145,75,70
050,19,029,"Iowa","Cass County",3,38,154,80,74
050,19,029,"Iowa","Cass County",3,39,158,82,76
050,19,029,"Iowa","Cass County",3,40,168,88,80
050,19,029,"Iowa","Cass County",3,41,170,93,77
050,19,029,"Iowa","Cass County",3,42,155,85,70
050,19,029,"Iowa","Cass County",3,43,150,78,72
050,19,029,"Iowa","Cass County",3,44,139,68,71
050,19,029,"Iowa","Cass County",3,45,132,56,76
050,19,029,"Iowa","Cass County",3,46,141,72,69
050,19,029,"Iowa","Cass County",3,47,140,79,61
050,19,029,"Iowa","Cass County",3,48,134,72,62
050,19,029,"Iowa","Cass County",3,49,148,83,65
050,19,029,"Iowa","Cass County",3,50,153,80,73
050,19,029,"Iowa","Cass County",3,51,148,81,67
050,19,029,"Iowa","Cass County",3,52,127,68,59
050,19,029,"Iowa","Cass County",3,53,128,64,64
050,19,029,"Iowa","Cass County",3,54,147,74,73
050,19,029,"Iowa","Cass County",3,55,147,73,74
050,19,029,"Iowa","Cass County",3,56,178,88,90
050,19,029,"Iowa","Cass County",3,57,186,92,94
050,19,029,"Iowa","Cass County",3,58,197,90,107
050,19,029,"Iowa","Cass County",3,59,213,102,111
050,19,029,"Iowa","Cass County",3,60,206,96,110
050,19,029,"Iowa","Cass County",3,61,205,99,106
050,19,029,"Iowa","Cass County",3,62,205,97,108
050,19,029,"Iowa","Cass County",3,63,201,96,105
050,19,029,"Iowa","Cass County",3,64,205,105,100
050,19,029,"Iowa","Cass County",3,65,203,105,98
050,19,029,"Iowa","Cass County",3,66,201,104,97
050,19,029,"Iowa","Cass County",3,67,185,92,93
050,19,029,"Iowa","Cass County",3,68,174,82,92
050,19,029,"Iowa","Cass County",3,69,175,84,91
050,19,029,"Iowa","Cass County",3,70,171,81,90
050,19,029,"Iowa","Cass County",3,71,155,68,87
050,19,029,"Iowa","Cass County",3,72,148,69,79
050,19,029,"Iowa","Cass County",3,73,155,77,78
050,19,029,"Iowa","Cass County",3,74,157,79,78
050,19,029,"Iowa","Cass County",3,75,113,55,58
050,19,029,"Iowa","Cass County",3,76,109,51,58
050,19,029,"Iowa","Cass County",3,77,112,51,61
050,19,029,"Iowa","Cass County",3,78,103,45,58
050,19,029,"Iowa","Cass County",3,79,97,45,52
050,19,029,"Iowa","Cass County",3,80,90,39,51
050,19,029,"Iowa","Cass County",3,81,73,28,45
050,19,029,"Iowa","Cass County",3,82,77,33,44
050,19,029,"Iowa","Cass County",3,83,77,38,39
050,19,029,"Iowa","Cass County",3,84,75,31,44
050,19,029,"Iowa","Cass County",3,85,399,130,269
050,19,029,"Iowa","Cass County",4,0,130,69,61
050,19,029,"Iowa","Cass County",4,1,141,74,67
050,19,029,"Iowa","Cass County",4,2,143,69,74
050,19,029,"Iowa","Cass County",4,3,154,78,76
050,19,029,"Iowa","Cass County",4,4,142,78,64
050,19,029,"Iowa","Cass County",4,5,146,69,77
050,19,029,"Iowa","Cass County",4,6,163,80,83
050,19,029,"Iowa","Cass County",4,7,166,80,86
050,19,029,"Iowa","Cass County",4,8,148,72,76
050,19,029,"Iowa","Cass County",4,9,175,89,86
050,19,029,"Iowa","Cass County",4,10,171,90,81
050,19,029,"Iowa","Cass County",4,11,165,75,90
050,19,029,"Iowa","Cass County",4,12,175,90,85
050,19,029,"Iowa","Cass County",4,13,196,102,94
050,19,029,"Iowa","Cass County",4,14,198,106,92
050,19,029,"Iowa","Cass County",4,15,214,110,104
050,19,029,"Iowa","Cass County",4,16,192,96,96
050,19,029,"Iowa","Cass County",4,17,192,102,90
050,19,029,"Iowa","Cass County",4,18,166,93,73
050,19,029,"Iowa","Cass County",4,19,123,66,57
050,19,029,"Iowa","Cass County",4,20,118,62,56
050,19,029,"Iowa","Cass County",4,21,114,60,54
050,19,029,"Iowa","Cass County",4,22,122,64,58
050,19,029,"Iowa","Cass County",4,23,123,66,57
050,19,029,"Iowa","Cass County",4,24,110,60,50
050,19,029,"Iowa","Cass County",4,25,115,69,46
050,19,029,"Iowa","Cass County",4,26,119,64,55
050,19,029,"Iowa","Cass County",4,27,130,59,71
050,19,029,"Iowa","Cass County",4,28,145,64,81
050,19,029,"Iowa","Cass County",4,29,146,76,70
050,19,029,"Iowa","Cass County",4,30,149,77,72
050,19,029,"Iowa","Cass County",4,31,155,78,77
050,19,029,"Iowa","Cass County",4,32,154,76,78
050,19,029,"Iowa","Cass County",4,33,137,61,76
050,19,029,"Iowa","Cass County",4,34,124,59,65
050,19,029,"Iowa","Cass County",4,35,125,70,55
050,19,029,"Iowa","Cass County",4,36,126,69,57
050,19,029,"Iowa","Cass County",4,37,142,67,75
050,19,029,"Iowa","Cass County",4,38,141,73,68
050,19,029,"Iowa","Cass County",4,39,163,87,76
050,19,029,"Iowa","Cass County",4,40,167,84,83
050,19,029,"Iowa","Cass County",4,41,168,90,78
050,19,029,"Iowa","Cass County",4,42,179,96,83
050,19,029,"Iowa","Cass County",4,43,146,69,77
050,19,029,"Iowa","Cass County",4,44,148,80,68
050,19,029,"Iowa","Cass County",4,45,139,72,67
050,19,029,"Iowa","Cass County",4,46,137,57,80
050,19,029,"Iowa","Cass County",4,47,142,73,69
050,19,029,"Iowa","Cass County",4,48,141,76,65
050,19,029,"Iowa","Cass County",4,49,131,71,60
050,19,029,"Iowa","Cass County",4,50,149,82,67
050,19,029,"Iowa","Cass County",4,51,153,80,73
050,19,029,"Iowa","Cass County",4,52,141,76,65
050,19,029,"Iowa","Cass County",4,53,133,66,67
050,19,029,"Iowa","Cass County",4,54,132,66,66
050,19,029,"Iowa","Cass County",4,55,146,74,72
050,19,029,"Iowa","Cass County",4,56,146,70,76
050,19,029,"Iowa","Cass County",4,57,168,84,84
050,19,029,"Iowa","Cass County",4,58,187,91,96
050,19,029,"Iowa","Cass County",4,59,201,91,110
050,19,029,"Iowa","Cass County",4,60,211,100,111
050,19,029,"Iowa","Cass County",4,61,207,97,110
050,19,029,"Iowa","Cass County",4,62,205,97,108
050,19,029,"Iowa","Cass County",4,63,209,99,110
050,19,029,"Iowa","Cass County",4,64,207,98,109
050,19,029,"Iowa","Cass County",4,65,202,101,101
050,19,029,"Iowa","Cass County",4,66,198,101,97
050,19,029,"Iowa","Cass County",4,67,202,104,98
050,19,029,"Iowa","Cass County",4,68,180,89,91
050,19,029,"Iowa","Cass County",4,69,170,81,89
050,19,029,"Iowa","Cass County",4,70,169,82,87
050,19,029,"Iowa","Cass County",4,71,165,79,86
050,19,029,"Iowa","Cass County",4,72,153,69,84
050,19,029,"Iowa","Cass County",4,73,144,64,80
050,19,029,"Iowa","Cass County",4,74,142,68,74
050,19,029,"Iowa","Cass County",4,75,155,78,77
050,19,029,"Iowa","Cass County",4,76,101,48,53
050,19,029,"Iowa","Cass County",4,77,110,53,57
050,19,029,"Iowa","Cass County",4,78,101,43,58
050,19,029,"Iowa","Cass County",4,79,101,42,59
050,19,029,"Iowa","Cass County",4,80,87,41,46
050,19,029,"Iowa","Cass County",4,81,88,36,52
050,19,029,"Iowa","Cass County",4,82,62,25,37
050,19,029,"Iowa","Cass County",4,83,74,34,40
050,19,029,"Iowa","Cass County",4,84,78,37,41
050,19,029,"Iowa","Cass County",4,85,404,135,269
050,19,029,"Iowa","Cass County",5,0,129,69,60
050,19,029,"Iowa","Cass County",5,1,134,67,67
050,19,029,"Iowa","Cass County",5,2,141,75,66
050,19,029,"Iowa","Cass County",5,3,147,69,78
050,19,029,"Iowa","Cass County",5,4,152,77,75
050,19,029,"Iowa","Cass County",5,5,152,90,62
050,19,029,"Iowa","Cass County",5,6,150,70,80
050,19,029,"Iowa","Cass County",5,7,169,83,86
050,19,029,"Iowa","Cass County",5,8,169,80,89
050,19,029,"Iowa","Cass County",5,9,155,73,82
050,19,029,"Iowa","Cass County",5,10,178,92,86
050,19,029,"Iowa","Cass County",5,11,175,91,84
050,19,029,"Iowa","Cass County",5,12,170,76,94
050,19,029,"Iowa","Cass County",5,13,181,95,86
050,19,029,"Iowa","Cass County",5,14,201,104,97
050,19,029,"Iowa","Cass County",5,15,198,102,96
050,19,029,"Iowa","Cass County",5,16,213,109,104
050,19,029,"Iowa","Cass County",5,17,190,99,91
050,19,029,"Iowa","Cass County",5,18,158,86,72
050,19,029,"Iowa","Cass County",5,19,137,74,63
050,19,029,"Iowa","Cass County",5,20,126,72,54
050,19,029,"Iowa","Cass County",5,21,126,65,61
050,19,029,"Iowa","Cass County",5,22,123,64,59
050,19,029,"Iowa","Cass County",5,23,119,63,56
050,19,029,"Iowa","Cass County",5,24,118,60,58
050,19,029,"Iowa","Cass County",5,25,115,61,54
050,19,029,"Iowa","Cass County",5,26,111,69,42
050,19,029,"Iowa","Cass County",5,27,128,72,56
050,19,029,"Iowa","Cass County",5,28,126,58,68
050,19,029,"Iowa","Cass County",5,29,151,71,80
050,19,029,"Iowa","Cass County",5,30,147,76,71
050,19,029,"Iowa","Cass County",5,31,148,78,70
050,19,029,"Iowa","Cass County",5,32,157,76,81
050,19,029,"Iowa","Cass County",5,33,157,80,77
050,19,029,"Iowa","Cass County",5,34,137,60,77
050,19,029,"Iowa","Cass County",5,35,131,65,66
050,19,029,"Iowa","Cass County",5,36,124,68,56
050,19,029,"Iowa","Cass County",5,37,141,79,62
050,19,029,"Iowa","Cass County",5,38,146,71,75
050,19,029,"Iowa","Cass County",5,39,136,70,66
050,19,029,"Iowa","Cass County",5,40,163,88,75
050,19,029,"Iowa","Cass County",5,41,174,88,86
050,19,029,"Iowa","Cass County",5,42,170,89,81
050,19,029,"Iowa","Cass County",5,43,164,81,83
050,19,029,"Iowa","Cass County",5,44,148,72,76
050,19,029,"Iowa","Cass County",5,45,149,85,64
050,19,029,"Iowa","Cass County",5,46,133,70,63
050,19,029,"Iowa","Cass County",5,47,130,55,75
050,19,029,"Iowa","Cass County",5,48,143,70,73
050,19,029,"Iowa","Cass County",5,49,144,77,67
050,19,029,"Iowa","Cass County",5,50,130,68,62
050,19,029,"Iowa","Cass County",5,51,143,78,65
050,19,029,"Iowa","Cass County",5,52,158,85,73
050,19,029,"Iowa","Cass County",5,53,143,77,66
050,19,029,"Iowa","Cass County",5,54,135,68,67
050,19,029,"Iowa","Cass County",5,55,138,70,68
050,19,029,"Iowa","Cass County",5,56,149,70,79
050,19,029,"Iowa","Cass County",5,57,148,72,76
050,19,029,"Iowa","Cass County",5,58,169,82,87
050,19,029,"Iowa","Cass County",5,59,179,90,89
050,19,029,"Iowa","Cass County",5,60,198,87,111
050,19,029,"Iowa","Cass County",5,61,213,98,115
050,19,029,"Iowa","Cass County",5,62,214,97,117
050,19,029,"Iowa","Cass County",5,63,202,96,106
050,19,029,"Iowa","Cass County",5,64,208,98,110
050,19,029,"Iowa","Cass County",5,65,206,96,110
050,19,029,"Iowa","Cass County",5,66,205,102,103
050,19,029,"Iowa","Cass County",5,67,196,98,98
050,19,029,"Iowa","Cass County",5,68,190,102,88
050,19,029,"Iowa","Cass County",5,69,176,85,91
050,19,029,"Iowa","Cass County",5,70,164,80,84
050,19,029,"Iowa","Cass County",5,71,164,78,86
050,19,029,"Iowa","Cass County",5,72,158,78,80
050,19,029,"Iowa","Cass County",5,73,154,69,85
050,19,029,"Iowa","Cass County",5,74,134,58,76
050,19,029,"Iowa","Cass County",5,75,135,66,69
050,19,029,"Iowa","Cass County",5,76,144,68,76
050,19,029,"Iowa","Cass County",5,77,103,51,52
050,19,029,"Iowa","Cass County",5,78,100,47,53
050,19,029,"Iowa","Cass County",5,79,96,41,55
050,19,029,"Iowa","Cass County",5,80,90,37,53
050,19,029,"Iowa","Cass County",5,81,81,36,45
050,19,029,"Iowa","Cass County",5,82,75,32,43
050,19,029,"Iowa","Cass County",5,83,60,26,34
050,19,029,"Iowa","Cass County",5,84,76,31,45
050,19,029,"Iowa","Cass County",5,85,412,150,262
050,19,031,"Iowa","Cedar County",1,0,172,91,81
050,19,031,"Iowa","Cedar County",1,1,180,104,76
050,19,031,"Iowa","Cedar County",1,2,178,89,89
050,19,031,"Iowa","Cedar County",1,3,185,88,97
050,19,031,"Iowa","Cedar County",1,4,213,110,103
050,19,031,"Iowa","Cedar County",1,5,218,106,112
050,19,031,"Iowa","Cedar County",1,6,215,112,103
050,19,031,"Iowa","Cedar County",1,7,192,100,92
050,19,031,"Iowa","Cedar County",1,8,225,120,105
050,19,031,"Iowa","Cedar County",1,9,225,109,116
050,19,031,"Iowa","Cedar County",1,10,222,115,107
050,19,031,"Iowa","Cedar County",1,11,264,137,127
050,19,031,"Iowa","Cedar County",1,12,267,137,130
050,19,031,"Iowa","Cedar County",1,13,263,139,124
050,19,031,"Iowa","Cedar County",1,14,254,133,121
050,19,031,"Iowa","Cedar County",1,15,263,133,130
050,19,031,"Iowa","Cedar County",1,16,246,125,121
050,19,031,"Iowa","Cedar County",1,17,251,118,133
050,19,031,"Iowa","Cedar County",1,18,226,123,103
050,19,031,"Iowa","Cedar County",1,19,166,91,75
050,19,031,"Iowa","Cedar County",1,20,163,80,83
050,19,031,"Iowa","Cedar County",1,21,166,78,88
050,19,031,"Iowa","Cedar County",1,22,168,81,87
050,19,031,"Iowa","Cedar County",1,23,169,85,84
050,19,031,"Iowa","Cedar County",1,24,194,101,93
050,19,031,"Iowa","Cedar County",1,25,175,95,80
050,19,031,"Iowa","Cedar County",1,26,177,91,86
050,19,031,"Iowa","Cedar County",1,27,187,97,90
050,19,031,"Iowa","Cedar County",1,28,202,104,98
050,19,031,"Iowa","Cedar County",1,29,193,100,93
050,19,031,"Iowa","Cedar County",1,30,212,94,118
050,19,031,"Iowa","Cedar County",1,31,212,103,109
050,19,031,"Iowa","Cedar County",1,32,177,88,89
050,19,031,"Iowa","Cedar County",1,33,192,97,95
050,19,031,"Iowa","Cedar County",1,34,206,113,93
050,19,031,"Iowa","Cedar County",1,35,231,123,108
050,19,031,"Iowa","Cedar County",1,36,216,108,108
050,19,031,"Iowa","Cedar County",1,37,232,116,116
050,19,031,"Iowa","Cedar County",1,38,224,115,109
050,19,031,"Iowa","Cedar County",1,39,232,117,115
050,19,031,"Iowa","Cedar County",1,40,256,123,133
050,19,031,"Iowa","Cedar County",1,41,256,135,121
050,19,031,"Iowa","Cedar County",1,42,235,119,116
050,19,031,"Iowa","Cedar County",1,43,239,127,112
050,19,031,"Iowa","Cedar County",1,44,229,123,106
050,19,031,"Iowa","Cedar County",1,45,228,113,115
050,19,031,"Iowa","Cedar County",1,46,207,110,97
050,19,031,"Iowa","Cedar County",1,47,208,118,90
050,19,031,"Iowa","Cedar County",1,48,234,119,115
050,19,031,"Iowa","Cedar County",1,49,238,126,112
050,19,031,"Iowa","Cedar County",1,50,226,119,107
050,19,031,"Iowa","Cedar County",1,51,239,119,120
050,19,031,"Iowa","Cedar County",1,52,242,122,120
050,19,031,"Iowa","Cedar County",1,53,239,116,123
050,19,031,"Iowa","Cedar County",1,54,240,118,122
050,19,031,"Iowa","Cedar County",1,55,276,137,139
050,19,031,"Iowa","Cedar County",1,56,287,136,151
050,19,031,"Iowa","Cedar County",1,57,297,143,154
050,19,031,"Iowa","Cedar County",1,58,301,144,157
050,19,031,"Iowa","Cedar County",1,59,311,153,158
050,19,031,"Iowa","Cedar County",1,60,292,154,138
050,19,031,"Iowa","Cedar County",1,61,309,165,144
050,19,031,"Iowa","Cedar County",1,62,297,156,141
050,19,031,"Iowa","Cedar County",1,63,273,140,133
050,19,031,"Iowa","Cedar County",1,64,258,128,130
050,19,031,"Iowa","Cedar County",1,65,262,131,131
050,19,031,"Iowa","Cedar County",1,66,245,132,113
050,19,031,"Iowa","Cedar County",1,67,257,132,125
050,19,031,"Iowa","Cedar County",1,68,252,132,120
050,19,031,"Iowa","Cedar County",1,69,216,109,107
050,19,031,"Iowa","Cedar County",1,70,211,106,105
050,19,031,"Iowa","Cedar County",1,71,186,99,87
050,19,031,"Iowa","Cedar County",1,72,187,100,87
050,19,031,"Iowa","Cedar County",1,73,188,89,99
050,19,031,"Iowa","Cedar County",1,74,119,55,64
050,19,031,"Iowa","Cedar County",1,75,136,66,70
050,19,031,"Iowa","Cedar County",1,76,130,58,72
050,19,031,"Iowa","Cedar County",1,77,129,56,73
050,19,031,"Iowa","Cedar County",1,78,118,53,65
050,19,031,"Iowa","Cedar County",1,79,104,48,56
050,19,031,"Iowa","Cedar County",1,80,96,51,45
050,19,031,"Iowa","Cedar County",1,81,93,40,53
050,19,031,"Iowa","Cedar County",1,82,89,37,52
050,19,031,"Iowa","Cedar County",1,83,83,30,53
050,19,031,"Iowa","Cedar County",1,84,83,34,49
050,19,031,"Iowa","Cedar County",1,85,546,187,359
050,19,031,"Iowa","Cedar County",2,0,175,91,84
050,19,031,"Iowa","Cedar County",2,1,176,101,75
050,19,031,"Iowa","Cedar County",2,2,177,91,86
050,19,031,"Iowa","Cedar County",2,3,184,88,96
050,19,031,"Iowa","Cedar County",2,4,208,105,103
050,19,031,"Iowa","Cedar County",2,5,217,107,110
050,19,031,"Iowa","Cedar County",2,6,212,109,103
050,19,031,"Iowa","Cedar County",2,7,197,102,95
050,19,031,"Iowa","Cedar County",2,8,218,115,103
050,19,031,"Iowa","Cedar County",2,9,221,110,111
050,19,031,"Iowa","Cedar County",2,10,222,113,109
050,19,031,"Iowa","Cedar County",2,11,255,133,122
050,19,031,"Iowa","Cedar County",2,12,269,139,130
050,19,031,"Iowa","Cedar County",2,13,265,139,126
050,19,031,"Iowa","Cedar County",2,14,256,135,121
050,19,031,"Iowa","Cedar County",2,15,262,134,128
050,19,031,"Iowa","Cedar County",2,16,251,127,124
050,19,031,"Iowa","Cedar County",2,17,252,122,130
050,19,031,"Iowa","Cedar County",2,18,218,115,103
050,19,031,"Iowa","Cedar County",2,19,168,91,77
050,19,031,"Iowa","Cedar County",2,20,164,83,81
050,19,031,"Iowa","Cedar County",2,21,164,78,86
050,19,031,"Iowa","Cedar County",2,22,166,79,87
050,19,031,"Iowa","Cedar County",2,23,168,83,85
050,19,031,"Iowa","Cedar County",2,24,186,97,89
050,19,031,"Iowa","Cedar County",2,25,182,96,86
050,19,031,"Iowa","Cedar County",2,26,179,94,85
050,19,031,"Iowa","Cedar County",2,27,187,97,90
050,19,031,"Iowa","Cedar County",2,28,198,104,94
050,19,031,"Iowa","Cedar County",2,29,198,100,98
050,19,031,"Iowa","Cedar County",2,30,211,97,114
050,19,031,"Iowa","Cedar County",2,31,211,101,110
050,19,031,"Iowa","Cedar County",2,32,186,91,95
050,19,031,"Iowa","Cedar County",2,33,190,97,93
050,19,031,"Iowa","Cedar County",2,34,206,111,95
050,19,031,"Iowa","Cedar County",2,35,227,121,106
050,19,031,"Iowa","Cedar County",2,36,218,111,107
050,19,031,"Iowa","Cedar County",2,37,228,114,114
050,19,031,"Iowa","Cedar County",2,38,224,114,110
050,19,031,"Iowa","Cedar County",2,39,229,115,114
050,19,031,"Iowa","Cedar County",2,40,253,124,129
050,19,031,"Iowa","Cedar County",2,41,255,132,123
050,19,031,"Iowa","Cedar County",2,42,240,124,116
050,19,031,"Iowa","Cedar County",2,43,243,127,116
050,19,031,"Iowa","Cedar County",2,44,229,123,106
050,19,031,"Iowa","Cedar County",2,45,229,116,113
050,19,031,"Iowa","Cedar County",2,46,211,111,100
050,19,031,"Iowa","Cedar County",2,47,207,115,92
050,19,031,"Iowa","Cedar County",2,48,228,119,109
050,19,031,"Iowa","Cedar County",2,49,238,126,112
050,19,031,"Iowa","Cedar County",2,50,231,121,110
050,19,031,"Iowa","Cedar County",2,51,236,119,117
050,19,031,"Iowa","Cedar County",2,52,241,121,120
050,19,031,"Iowa","Cedar County",2,53,240,118,122
050,19,031,"Iowa","Cedar County",2,54,240,117,123
050,19,031,"Iowa","Cedar County",2,55,267,131,136
050,19,031,"Iowa","Cedar County",2,56,285,136,149
050,19,031,"Iowa","Cedar County",2,57,292,139,153
050,19,031,"Iowa","Cedar County",2,58,303,145,158
050,19,031,"Iowa","Cedar County",2,59,309,152,157
050,19,031,"Iowa","Cedar County",2,60,296,154,142
050,19,031,"Iowa","Cedar County",2,61,304,163,141
050,19,031,"Iowa","Cedar County",2,62,300,158,142
050,19,031,"Iowa","Cedar County",2,63,280,143,137
050,19,031,"Iowa","Cedar County",2,64,261,130,131
050,19,031,"Iowa","Cedar County",2,65,260,129,131
050,19,031,"Iowa","Cedar County",2,66,249,131,118
050,19,031,"Iowa","Cedar County",2,67,256,133,123
050,19,031,"Iowa","Cedar County",2,68,248,129,119
050,19,031,"Iowa","Cedar County",2,69,226,116,110
050,19,031,"Iowa","Cedar County",2,70,212,106,106
050,19,031,"Iowa","Cedar County",2,71,191,101,90
050,19,031,"Iowa","Cedar County",2,72,181,97,84
050,19,031,"Iowa","Cedar County",2,73,196,95,101
050,19,031,"Iowa","Cedar County",2,74,126,60,66
050,19,031,"Iowa","Cedar County",2,75,132,62,70
050,19,031,"Iowa","Cedar County",2,76,131,59,72
050,19,031,"Iowa","Cedar County",2,77,130,56,74
050,19,031,"Iowa","Cedar County",2,78,118,53,65
050,19,031,"Iowa","Cedar County",2,79,105,48,57
050,19,031,"Iowa","Cedar County",2,80,98,49,49
050,19,031,"Iowa","Cedar County",2,81,94,43,51
050,19,031,"Iowa","Cedar County",2,82,90,37,53
050,19,031,"Iowa","Cedar County",2,83,83,31,52
050,19,031,"Iowa","Cedar County",2,84,82,33,49
050,19,031,"Iowa","Cedar County",2,85,544,185,359
050,19,031,"Iowa","Cedar County",3,0,166,82,84
050,19,031,"Iowa","Cedar County",3,1,164,83,81
050,19,031,"Iowa","Cedar County",3,2,187,104,83
050,19,031,"Iowa","Cedar County",3,3,180,93,87
050,19,031,"Iowa","Cedar County",3,4,191,91,100
050,19,031,"Iowa","Cedar County",3,5,218,112,106
050,19,031,"Iowa","Cedar County",3,6,212,107,105
050,19,031,"Iowa","Cedar County",3,7,213,109,104
050,19,031,"Iowa","Cedar County",3,8,200,101,99
050,19,031,"Iowa","Cedar County",3,9,225,121,104
050,19,031,"Iowa","Cedar County",3,10,232,120,112
050,19,031,"Iowa","Cedar County",3,11,232,112,120
050,19,031,"Iowa","Cedar County",3,12,261,135,126
050,19,031,"Iowa","Cedar County",3,13,272,140,132
050,19,031,"Iowa","Cedar County",3,14,265,139,126
050,19,031,"Iowa","Cedar County",3,15,258,134,124
050,19,031,"Iowa","Cedar County",3,16,262,131,131
050,19,031,"Iowa","Cedar County",3,17,255,130,125
050,19,031,"Iowa","Cedar County",3,18,222,114,108
050,19,031,"Iowa","Cedar County",3,19,163,87,76
050,19,031,"Iowa","Cedar County",3,20,172,93,79
050,19,031,"Iowa","Cedar County",3,21,168,87,81
050,19,031,"Iowa","Cedar County",3,22,166,83,83
050,19,031,"Iowa","Cedar County",3,23,189,91,98
050,19,031,"Iowa","Cedar County",3,24,178,96,82
050,19,031,"Iowa","Cedar County",3,25,188,97,91
050,19,031,"Iowa","Cedar County",3,26,177,89,88
050,19,031,"Iowa","Cedar County",3,27,177,85,92
050,19,031,"Iowa","Cedar County",3,28,176,91,85
050,19,031,"Iowa","Cedar County",3,29,187,99,88
050,19,031,"Iowa","Cedar County",3,30,197,106,91
050,19,031,"Iowa","Cedar County",3,31,224,109,115
050,19,031,"Iowa","Cedar County",3,32,199,94,105
050,19,031,"Iowa","Cedar County",3,33,188,94,94
050,19,031,"Iowa","Cedar County",3,34,207,105,102
050,19,031,"Iowa","Cedar County",3,35,206,104,102
050,19,031,"Iowa","Cedar County",3,36,234,126,108
050,19,031,"Iowa","Cedar County",3,37,230,118,112
050,19,031,"Iowa","Cedar County",3,38,234,117,117
050,19,031,"Iowa","Cedar County",3,39,225,115,110
050,19,031,"Iowa","Cedar County",3,40,228,118,110
050,19,031,"Iowa","Cedar County",3,41,252,125,127
050,19,031,"Iowa","Cedar County",3,42,250,131,119
050,19,031,"Iowa","Cedar County",3,43,241,125,116
050,19,031,"Iowa","Cedar County",3,44,242,123,119
050,19,031,"Iowa","Cedar County",3,45,232,126,106
050,19,031,"Iowa","Cedar County",3,46,223,111,112
050,19,031,"Iowa","Cedar County",3,47,205,108,97
050,19,031,"Iowa","Cedar County",3,48,207,115,92
050,19,031,"Iowa","Cedar County",3,49,230,121,109
050,19,031,"Iowa","Cedar County",3,50,235,123,112
050,19,031,"Iowa","Cedar County",3,51,220,111,109
050,19,031,"Iowa","Cedar County",3,52,232,115,117
050,19,031,"Iowa","Cedar County",3,53,226,110,116
050,19,031,"Iowa","Cedar County",3,54,238,117,121
050,19,031,"Iowa","Cedar County",3,55,234,114,120
050,19,031,"Iowa","Cedar County",3,56,259,127,132
050,19,031,"Iowa","Cedar County",3,57,280,137,143
050,19,031,"Iowa","Cedar County",3,58,281,135,146
050,19,031,"Iowa","Cedar County",3,59,302,150,152
050,19,031,"Iowa","Cedar County",3,60,310,151,159
050,19,031,"Iowa","Cedar County",3,61,295,150,145
050,19,031,"Iowa","Cedar County",3,62,302,160,142
050,19,031,"Iowa","Cedar County",3,63,300,159,141
050,19,031,"Iowa","Cedar County",3,64,280,146,134
050,19,031,"Iowa","Cedar County",3,65,261,127,134
050,19,031,"Iowa","Cedar County",3,66,251,127,124
050,19,031,"Iowa","Cedar County",3,67,251,131,120
050,19,031,"Iowa","Cedar County",3,68,251,135,116
050,19,031,"Iowa","Cedar County",3,69,243,126,117
050,19,031,"Iowa","Cedar County",3,70,223,113,110
050,19,031,"Iowa","Cedar County",3,71,207,103,104
050,19,031,"Iowa","Cedar County",3,72,187,99,88
050,19,031,"Iowa","Cedar County",3,73,180,95,85
050,19,031,"Iowa","Cedar County",3,74,191,94,97
050,19,031,"Iowa","Cedar County",3,75,124,57,67
050,19,031,"Iowa","Cedar County",3,76,123,56,67
050,19,031,"Iowa","Cedar County",3,77,123,56,67
050,19,031,"Iowa","Cedar County",3,78,127,55,72
050,19,031,"Iowa","Cedar County",3,79,115,50,65
050,19,031,"Iowa","Cedar County",3,80,98,41,57
050,19,031,"Iowa","Cedar County",3,81,94,48,46
050,19,031,"Iowa","Cedar County",3,82,84,37,47
050,19,031,"Iowa","Cedar County",3,83,82,30,52
050,19,031,"Iowa","Cedar County",3,84,76,29,47
050,19,031,"Iowa","Cedar County",3,85,541,186,355
050,19,031,"Iowa","Cedar County",4,0,158,86,72
050,19,031,"Iowa","Cedar County",4,1,176,81,95
050,19,031,"Iowa","Cedar County",4,2,177,90,87
050,19,031,"Iowa","Cedar County",4,3,185,103,82
050,19,031,"Iowa","Cedar County",4,4,177,89,88
050,19,031,"Iowa","Cedar County",4,5,194,96,98
050,19,031,"Iowa","Cedar County",4,6,223,115,108
050,19,031,"Iowa","Cedar County",4,7,215,109,106
050,19,031,"Iowa","Cedar County",4,8,218,111,107
050,19,031,"Iowa","Cedar County",4,9,203,102,101
050,19,031,"Iowa","Cedar County",4,10,229,125,104
050,19,031,"Iowa","Cedar County",4,11,218,114,104
050,19,031,"Iowa","Cedar County",4,12,240,117,123
050,19,031,"Iowa","Cedar County",4,13,263,139,124
050,19,031,"Iowa","Cedar County",4,14,273,139,134
050,19,031,"Iowa","Cedar County",4,15,256,136,120
050,19,031,"Iowa","Cedar County",4,16,253,135,118
050,19,031,"Iowa","Cedar County",4,17,262,127,135
050,19,031,"Iowa","Cedar County",4,18,214,112,102
050,19,031,"Iowa","Cedar County",4,19,168,88,80
050,19,031,"Iowa","Cedar County",4,20,160,84,76
050,19,031,"Iowa","Cedar County",4,21,166,90,76
050,19,031,"Iowa","Cedar County",4,22,173,81,92
050,19,031,"Iowa","Cedar County",4,23,160,80,80
050,19,031,"Iowa","Cedar County",4,24,185,89,96
050,19,031,"Iowa","Cedar County",4,25,200,112,88
050,19,031,"Iowa","Cedar County",4,26,194,100,94
050,19,031,"Iowa","Cedar County",4,27,186,91,95
050,19,031,"Iowa","Cedar County",4,28,183,85,98
050,19,031,"Iowa","Cedar County",4,29,188,97,91
050,19,031,"Iowa","Cedar County",4,30,193,104,89
050,19,031,"Iowa","Cedar County",4,31,189,99,90
050,19,031,"Iowa","Cedar County",4,32,237,114,123
050,19,031,"Iowa","Cedar County",4,33,216,109,107
050,19,031,"Iowa","Cedar County",4,34,192,93,99
050,19,031,"Iowa","Cedar County",4,35,215,108,107
050,19,031,"Iowa","Cedar County",4,36,201,98,103
050,19,031,"Iowa","Cedar County",4,37,233,125,108
050,19,031,"Iowa","Cedar County",4,38,226,116,110
050,19,031,"Iowa","Cedar County",4,39,236,114,122
050,19,031,"Iowa","Cedar County",4,40,231,120,111
050,19,031,"Iowa","Cedar County",4,41,224,116,108
050,19,031,"Iowa","Cedar County",4,42,251,123,128
050,19,031,"Iowa","Cedar County",4,43,256,133,123
050,19,031,"Iowa","Cedar County",4,44,240,128,112
050,19,031,"Iowa","Cedar County",4,45,246,123,123
050,19,031,"Iowa","Cedar County",4,46,231,122,109
050,19,031,"Iowa","Cedar County",4,47,214,106,108
050,19,031,"Iowa","Cedar County",4,48,200,107,93
050,19,031,"Iowa","Cedar County",4,49,213,113,100
050,19,031,"Iowa","Cedar County",4,50,232,124,108
050,19,031,"Iowa","Cedar County",4,51,234,119,115
050,19,031,"Iowa","Cedar County",4,52,220,111,109
050,19,031,"Iowa","Cedar County",4,53,228,114,114
050,19,031,"Iowa","Cedar County",4,54,222,110,112
050,19,031,"Iowa","Cedar County",4,55,239,115,124
050,19,031,"Iowa","Cedar County",4,56,220,105,115
050,19,031,"Iowa","Cedar County",4,57,263,129,134
050,19,031,"Iowa","Cedar County",4,58,277,139,138
050,19,031,"Iowa","Cedar County",4,59,287,145,142
050,19,031,"Iowa","Cedar County",4,60,304,149,155
050,19,031,"Iowa","Cedar County",4,61,305,150,155
050,19,031,"Iowa","Cedar County",4,62,295,148,147
050,19,031,"Iowa","Cedar County",4,63,287,153,134
050,19,031,"Iowa","Cedar County",4,64,291,152,139
050,19,031,"Iowa","Cedar County",4,65,268,138,130
050,19,031,"Iowa","Cedar County",4,66,255,126,129
050,19,031,"Iowa","Cedar County",4,67,247,119,128
050,19,031,"Iowa","Cedar County",4,68,242,131,111
050,19,031,"Iowa","Cedar County",4,69,244,129,115
050,19,031,"Iowa","Cedar County",4,70,237,127,110
050,19,031,"Iowa","Cedar County",4,71,218,110,108
050,19,031,"Iowa","Cedar County",4,72,198,97,101
050,19,031,"Iowa","Cedar County",4,73,178,93,85
050,19,031,"Iowa","Cedar County",4,74,179,92,87
050,19,031,"Iowa","Cedar County",4,75,188,93,95
050,19,031,"Iowa","Cedar County",4,76,122,57,65
050,19,031,"Iowa","Cedar County",4,77,116,53,63
050,19,031,"Iowa","Cedar County",4,78,121,56,65
050,19,031,"Iowa","Cedar County",4,79,127,54,73
050,19,031,"Iowa","Cedar County",4,80,108,42,66
050,19,031,"Iowa","Cedar County",4,81,97,41,56
050,19,031,"Iowa","Cedar County",4,82,92,46,46
050,19,031,"Iowa","Cedar County",4,83,79,34,45
050,19,031,"Iowa","Cedar County",4,84,67,28,39
050,19,031,"Iowa","Cedar County",4,85,525,180,345
050,19,031,"Iowa","Cedar County",5,0,158,85,73
050,19,031,"Iowa","Cedar County",5,1,168,87,81
050,19,031,"Iowa","Cedar County",5,2,175,82,93
050,19,031,"Iowa","Cedar County",5,3,178,88,90
050,19,031,"Iowa","Cedar County",5,4,178,97,81
050,19,031,"Iowa","Cedar County",5,5,185,94,91
050,19,031,"Iowa","Cedar County",5,6,196,100,96
050,19,031,"Iowa","Cedar County",5,7,222,115,107
050,19,031,"Iowa","Cedar County",5,8,210,106,104
050,19,031,"Iowa","Cedar County",5,9,223,115,108
050,19,031,"Iowa","Cedar County",5,10,202,105,97
050,19,031,"Iowa","Cedar County",5,11,225,123,102
050,19,031,"Iowa","Cedar County",5,12,222,116,106
050,19,031,"Iowa","Cedar County",5,13,236,114,122
050,19,031,"Iowa","Cedar County",5,14,265,141,124
050,19,031,"Iowa","Cedar County",5,15,267,137,130
050,19,031,"Iowa","Cedar County",5,16,263,138,125
050,19,031,"Iowa","Cedar County",5,17,250,132,118
050,19,031,"Iowa","Cedar County",5,18,215,105,110
050,19,031,"Iowa","Cedar County",5,19,154,87,67
050,19,031,"Iowa","Cedar County",5,20,187,101,86
050,19,031,"Iowa","Cedar County",5,21,165,89,76
050,19,031,"Iowa","Cedar County",5,22,173,91,82
050,19,031,"Iowa","Cedar County",5,23,173,82,91
050,19,031,"Iowa","Cedar County",5,24,150,71,79
050,19,031,"Iowa","Cedar County",5,25,185,84,101
050,19,031,"Iowa","Cedar County",5,26,199,104,95
050,19,031,"Iowa","Cedar County",5,27,194,96,98
050,19,031,"Iowa","Cedar County",5,28,192,89,103
050,19,031,"Iowa","Cedar County",5,29,182,80,102
050,19,031,"Iowa","Cedar County",5,30,193,102,91
050,19,031,"Iowa","Cedar County",5,31,206,114,92
050,19,031,"Iowa","Cedar County",5,32,203,104,99
050,19,031,"Iowa","Cedar County",5,33,237,118,119
050,19,031,"Iowa","Cedar County",5,34,219,115,104
050,19,031,"Iowa","Cedar County",5,35,187,91,96
050,19,031,"Iowa","Cedar County",5,36,213,107,106
050,19,031,"Iowa","Cedar County",5,37,206,97,109
050,19,031,"Iowa","Cedar County",5,38,230,120,110
050,19,031,"Iowa","Cedar County",5,39,229,114,115
050,19,031,"Iowa","Cedar County",5,40,245,122,123
050,19,031,"Iowa","Cedar County",5,41,239,127,112
050,19,031,"Iowa","Cedar County",5,42,242,130,112
050,19,031,"Iowa","Cedar County",5,43,248,125,123
050,19,031,"Iowa","Cedar County",5,44,254,134,120
050,19,031,"Iowa","Cedar County",5,45,244,132,112
050,19,031,"Iowa","Cedar County",5,46,256,125,131
050,19,031,"Iowa","Cedar County",5,47,233,126,107
050,19,031,"Iowa","Cedar County",5,48,213,102,111
050,19,031,"Iowa","Cedar County",5,49,205,105,100
050,19,031,"Iowa","Cedar County",5,50,211,114,97
050,19,031,"Iowa","Cedar County",5,51,221,120,101
050,19,031,"Iowa","Cedar County",5,52,239,119,120
050,19,031,"Iowa","Cedar County",5,53,221,111,110
050,19,031,"Iowa","Cedar County",5,54,221,107,114
050,19,031,"Iowa","Cedar County",5,55,217,106,111
050,19,031,"Iowa","Cedar County",5,56,237,112,125
050,19,031,"Iowa","Cedar County",5,57,222,107,115
050,19,031,"Iowa","Cedar County",5,58,251,125,126
050,19,031,"Iowa","Cedar County",5,59,276,140,136
050,19,031,"Iowa","Cedar County",5,60,292,143,149
050,19,031,"Iowa","Cedar County",5,61,303,147,156
050,19,031,"Iowa","Cedar County",5,62,301,147,154
050,19,031,"Iowa","Cedar County",5,63,302,153,149
050,19,031,"Iowa","Cedar County",5,64,274,143,131
050,19,031,"Iowa","Cedar County",5,65,279,147,132
050,19,031,"Iowa","Cedar County",5,66,258,130,128
050,19,031,"Iowa","Cedar County",5,67,257,126,131
050,19,031,"Iowa","Cedar County",5,68,251,122,129
050,19,031,"Iowa","Cedar County",5,69,236,125,111
050,19,031,"Iowa","Cedar County",5,70,245,130,115
050,19,031,"Iowa","Cedar County",5,71,238,130,108
050,19,031,"Iowa","Cedar County",5,72,208,103,105
050,19,031,"Iowa","Cedar County",5,73,192,91,101
050,19,031,"Iowa","Cedar County",5,74,176,92,84
050,19,031,"Iowa","Cedar County",5,75,172,87,85
050,19,031,"Iowa","Cedar County",5,76,185,95,90
050,19,031,"Iowa","Cedar County",5,77,118,55,63
050,19,031,"Iowa","Cedar County",5,78,115,53,62
050,19,031,"Iowa","Cedar County",5,79,115,53,62
050,19,031,"Iowa","Cedar County",5,80,116,47,69
050,19,031,"Iowa","Cedar County",5,81,101,40,61
050,19,031,"Iowa","Cedar County",5,82,93,39,54
050,19,031,"Iowa","Cedar County",5,83,82,42,40
050,19,031,"Iowa","Cedar County",5,84,71,35,36
050,19,031,"Iowa","Cedar County",5,85,512,168,344
050,19,033,"Iowa","Cerro Gordo County",1,0,471,243,228
050,19,033,"Iowa","Cerro Gordo County",1,1,464,237,227
050,19,033,"Iowa","Cerro Gordo County",1,2,459,228,231
050,19,033,"Iowa","Cerro Gordo County",1,3,475,241,234
050,19,033,"Iowa","Cerro Gordo County",1,4,483,224,259
050,19,033,"Iowa","Cerro Gordo County",1,5,505,253,252
050,19,033,"Iowa","Cerro Gordo County",1,6,500,262,238
050,19,033,"Iowa","Cerro Gordo County",1,7,509,276,233
050,19,033,"Iowa","Cerro Gordo County",1,8,513,273,240
050,19,033,"Iowa","Cerro Gordo County",1,9,486,240,246
050,19,033,"Iowa","Cerro Gordo County",1,10,521,256,265
050,19,033,"Iowa","Cerro Gordo County",1,11,552,289,263
050,19,033,"Iowa","Cerro Gordo County",1,12,558,290,268
050,19,033,"Iowa","Cerro Gordo County",1,13,555,275,280
050,19,033,"Iowa","Cerro Gordo County",1,14,555,274,281
050,19,033,"Iowa","Cerro Gordo County",1,15,500,267,233
050,19,033,"Iowa","Cerro Gordo County",1,16,507,266,241
050,19,033,"Iowa","Cerro Gordo County",1,17,493,256,237
050,19,033,"Iowa","Cerro Gordo County",1,18,485,267,218
050,19,033,"Iowa","Cerro Gordo County",1,19,483,287,196
050,19,033,"Iowa","Cerro Gordo County",1,20,474,262,212
050,19,033,"Iowa","Cerro Gordo County",1,21,442,218,224
050,19,033,"Iowa","Cerro Gordo County",1,22,455,219,236
050,19,033,"Iowa","Cerro Gordo County",1,23,462,228,234
050,19,033,"Iowa","Cerro Gordo County",1,24,479,232,247
050,19,033,"Iowa","Cerro Gordo County",1,25,452,234,218
050,19,033,"Iowa","Cerro Gordo County",1,26,472,237,235
050,19,033,"Iowa","Cerro Gordo County",1,27,483,248,235
050,19,033,"Iowa","Cerro Gordo County",1,28,500,241,259
050,19,033,"Iowa","Cerro Gordo County",1,29,529,266,263
050,19,033,"Iowa","Cerro Gordo County",1,30,497,242,255
050,19,033,"Iowa","Cerro Gordo County",1,31,459,226,233
050,19,033,"Iowa","Cerro Gordo County",1,32,432,205,227
050,19,033,"Iowa","Cerro Gordo County",1,33,458,227,231
050,19,033,"Iowa","Cerro Gordo County",1,34,493,254,239
050,19,033,"Iowa","Cerro Gordo County",1,35,464,233,231
050,19,033,"Iowa","Cerro Gordo County",1,36,509,260,249
050,19,033,"Iowa","Cerro Gordo County",1,37,505,259,246
050,19,033,"Iowa","Cerro Gordo County",1,38,493,260,233
050,19,033,"Iowa","Cerro Gordo County",1,39,528,284,244
050,19,033,"Iowa","Cerro Gordo County",1,40,496,261,235
050,19,033,"Iowa","Cerro Gordo County",1,41,507,265,242
050,19,033,"Iowa","Cerro Gordo County",1,42,497,251,246
050,19,033,"Iowa","Cerro Gordo County",1,43,469,231,238
050,19,033,"Iowa","Cerro Gordo County",1,44,428,209,219
050,19,033,"Iowa","Cerro Gordo County",1,45,433,222,211
050,19,033,"Iowa","Cerro Gordo County",1,46,412,209,203
050,19,033,"Iowa","Cerro Gordo County",1,47,443,210,233
050,19,033,"Iowa","Cerro Gordo County",1,48,444,207,237
050,19,033,"Iowa","Cerro Gordo County",1,49,521,265,256
050,19,033,"Iowa","Cerro Gordo County",1,50,498,259,239
050,19,033,"Iowa","Cerro Gordo County",1,51,508,250,258
050,19,033,"Iowa","Cerro Gordo County",1,52,504,253,251
050,19,033,"Iowa","Cerro Gordo County",1,53,494,259,235
050,19,033,"Iowa","Cerro Gordo County",1,54,512,260,252
050,19,033,"Iowa","Cerro Gordo County",1,55,574,276,298
050,19,033,"Iowa","Cerro Gordo County",1,56,634,300,334
050,19,033,"Iowa","Cerro Gordo County",1,57,630,313,317
050,19,033,"Iowa","Cerro Gordo County",1,58,701,340,361
050,19,033,"Iowa","Cerro Gordo County",1,59,724,360,364
050,19,033,"Iowa","Cerro Gordo County",1,60,707,342,365
050,19,033,"Iowa","Cerro Gordo County",1,61,701,344,357
050,19,033,"Iowa","Cerro Gordo County",1,62,674,335,339
050,19,033,"Iowa","Cerro Gordo County",1,63,649,302,347
050,19,033,"Iowa","Cerro Gordo County",1,64,676,317,359
050,19,033,"Iowa","Cerro Gordo County",1,65,667,338,329
050,19,033,"Iowa","Cerro Gordo County",1,66,604,305,299
050,19,033,"Iowa","Cerro Gordo County",1,67,583,295,288
050,19,033,"Iowa","Cerro Gordo County",1,68,653,320,333
050,19,033,"Iowa","Cerro Gordo County",1,69,605,309,296
050,19,033,"Iowa","Cerro Gordo County",1,70,521,251,270
050,19,033,"Iowa","Cerro Gordo County",1,71,522,247,275
050,19,033,"Iowa","Cerro Gordo County",1,72,508,229,279
050,19,033,"Iowa","Cerro Gordo County",1,73,490,223,267
050,19,033,"Iowa","Cerro Gordo County",1,74,328,142,186
050,19,033,"Iowa","Cerro Gordo County",1,75,326,147,179
050,19,033,"Iowa","Cerro Gordo County",1,76,320,146,174
050,19,033,"Iowa","Cerro Gordo County",1,77,323,147,176
050,19,033,"Iowa","Cerro Gordo County",1,78,290,129,161
050,19,033,"Iowa","Cerro Gordo County",1,79,280,117,163
050,19,033,"Iowa","Cerro Gordo County",1,80,276,116,160
050,19,033,"Iowa","Cerro Gordo County",1,81,256,112,144
050,19,033,"Iowa","Cerro Gordo County",1,82,247,95,152
050,19,033,"Iowa","Cerro Gordo County",1,83,229,91,138
050,19,033,"Iowa","Cerro Gordo County",1,84,216,90,126
050,19,033,"Iowa","Cerro Gordo County",1,85,1389,456,933
050,19,033,"Iowa","Cerro Gordo County",2,0,464,238,226
050,19,033,"Iowa","Cerro Gordo County",2,1,464,237,227
050,19,033,"Iowa","Cerro Gordo County",2,2,459,231,228
050,19,033,"Iowa","Cerro Gordo County",2,3,468,234,234
050,19,033,"Iowa","Cerro Gordo County",2,4,482,228,254
050,19,033,"Iowa","Cerro Gordo County",2,5,495,245,250
050,19,033,"Iowa","Cerro Gordo County",2,6,501,260,241
050,19,033,"Iowa","Cerro Gordo County",2,7,505,271,234
050,19,033,"Iowa","Cerro Gordo County",2,8,506,271,235
050,19,033,"Iowa","Cerro Gordo County",2,9,494,249,245
050,19,033,"Iowa","Cerro Gordo County",2,10,509,249,260
050,19,033,"Iowa","Cerro Gordo County",2,11,541,281,260
050,19,033,"Iowa","Cerro Gordo County",2,12,560,291,269
050,19,033,"Iowa","Cerro Gordo County",2,13,556,279,277
050,19,033,"Iowa","Cerro Gordo County",2,14,555,274,281
050,19,033,"Iowa","Cerro Gordo County",2,15,514,267,247
050,19,033,"Iowa","Cerro Gordo County",2,16,509,267,242
050,19,033,"Iowa","Cerro Gordo County",2,17,497,259,238
050,19,033,"Iowa","Cerro Gordo County",2,18,483,263,220
050,19,033,"Iowa","Cerro Gordo County",2,19,483,285,198
050,19,033,"Iowa","Cerro Gordo County",2,20,474,263,211
050,19,033,"Iowa","Cerro Gordo County",2,21,439,218,221
050,19,033,"Iowa","Cerro Gordo County",2,22,452,217,235
050,19,033,"Iowa","Cerro Gordo County",2,23,465,228,237
050,19,033,"Iowa","Cerro Gordo County",2,24,469,229,240
050,19,033,"Iowa","Cerro Gordo County",2,25,453,231,222
050,19,033,"Iowa","Cerro Gordo County",2,26,468,238,230
050,19,033,"Iowa","Cerro Gordo County",2,27,473,241,232
050,19,033,"Iowa","Cerro Gordo County",2,28,494,241,253
050,19,033,"Iowa","Cerro Gordo County",2,29,524,260,264
050,19,033,"Iowa","Cerro Gordo County",2,30,503,247,256
050,19,033,"Iowa","Cerro Gordo County",2,31,463,229,234
050,19,033,"Iowa","Cerro Gordo County",2,32,437,209,228
050,19,033,"Iowa","Cerro Gordo County",2,33,452,224,228
050,19,033,"Iowa","Cerro Gordo County",2,34,481,245,236
050,19,033,"Iowa","Cerro Gordo County",2,35,473,239,234
050,19,033,"Iowa","Cerro Gordo County",2,36,497,255,242
050,19,033,"Iowa","Cerro Gordo County",2,37,506,260,246
050,19,033,"Iowa","Cerro Gordo County",2,38,497,259,238
050,19,033,"Iowa","Cerro Gordo County",2,39,518,278,240
050,19,033,"Iowa","Cerro Gordo County",2,40,508,270,238
050,19,033,"Iowa","Cerro Gordo County",2,41,503,263,240
050,19,033,"Iowa","Cerro Gordo County",2,42,501,256,245
050,19,033,"Iowa","Cerro Gordo County",2,43,479,237,242
050,19,033,"Iowa","Cerro Gordo County",2,44,432,211,221
050,19,033,"Iowa","Cerro Gordo County",2,45,434,221,213
050,19,033,"Iowa","Cerro Gordo County",2,46,417,213,204
050,19,033,"Iowa","Cerro Gordo County",2,47,435,210,225
050,19,033,"Iowa","Cerro Gordo County",2,48,442,207,235
050,19,033,"Iowa","Cerro Gordo County",2,49,505,254,251
050,19,033,"Iowa","Cerro Gordo County",2,50,507,261,246
050,19,033,"Iowa","Cerro Gordo County",2,51,504,250,254
050,19,033,"Iowa","Cerro Gordo County",2,52,500,250,250
050,19,033,"Iowa","Cerro Gordo County",2,53,491,253,238
050,19,033,"Iowa","Cerro Gordo County",2,54,506,258,248
050,19,033,"Iowa","Cerro Gordo County",2,55,558,271,287
050,19,033,"Iowa","Cerro Gordo County",2,56,620,293,327
050,19,033,"Iowa","Cerro Gordo County",2,57,632,311,321
050,19,033,"Iowa","Cerro Gordo County",2,58,684,334,350
050,19,033,"Iowa","Cerro Gordo County",2,59,720,357,363
050,19,033,"Iowa","Cerro Gordo County",2,60,709,343,366
050,19,033,"Iowa","Cerro Gordo County",2,61,692,338,354
050,19,033,"Iowa","Cerro Gordo County",2,62,674,335,339
050,19,033,"Iowa","Cerro Gordo County",2,63,657,311,346
050,19,033,"Iowa","Cerro Gordo County",2,64,664,310,354
050,19,033,"Iowa","Cerro Gordo County",2,65,664,331,333
050,19,033,"Iowa","Cerro Gordo County",2,66,617,313,304
050,19,033,"Iowa","Cerro Gordo County",2,67,587,296,291
050,19,033,"Iowa","Cerro Gordo County",2,68,629,309,320
050,19,033,"Iowa","Cerro Gordo County",2,69,619,315,304
050,19,033,"Iowa","Cerro Gordo County",2,70,535,265,270
050,19,033,"Iowa","Cerro Gordo County",2,71,519,247,272
050,19,033,"Iowa","Cerro Gordo County",2,72,501,228,273
050,19,033,"Iowa","Cerro Gordo County",2,73,513,233,280
050,19,033,"Iowa","Cerro Gordo County",2,74,339,149,190
050,19,033,"Iowa","Cerro Gordo County",2,75,322,143,179
050,19,033,"Iowa","Cerro Gordo County",2,76,313,139,174
050,19,033,"Iowa","Cerro Gordo County",2,77,331,152,179
050,19,033,"Iowa","Cerro Gordo County",2,78,289,131,158
050,19,033,"Iowa","Cerro Gordo County",2,79,282,118,164
050,19,033,"Iowa","Cerro Gordo County",2,80,271,114,157
050,19,033,"Iowa","Cerro Gordo County",2,81,254,113,141
050,19,033,"Iowa","Cerro Gordo County",2,82,250,99,151
050,19,033,"Iowa","Cerro Gordo County",2,83,229,90,139
050,19,033,"Iowa","Cerro Gordo County",2,84,215,89,126
050,19,033,"Iowa","Cerro Gordo County",2,85,1386,458,928
050,19,033,"Iowa","Cerro Gordo County",3,0,419,213,206
050,19,033,"Iowa","Cerro Gordo County",3,1,460,235,225
050,19,033,"Iowa","Cerro Gordo County",3,2,447,230,217
050,19,033,"Iowa","Cerro Gordo County",3,3,454,231,223
050,19,033,"Iowa","Cerro Gordo County",3,4,465,238,227
050,19,033,"Iowa","Cerro Gordo County",3,5,487,235,252
050,19,033,"Iowa","Cerro Gordo County",3,6,484,238,246
050,19,033,"Iowa","Cerro Gordo County",3,7,512,264,248
050,19,033,"Iowa","Cerro Gordo County",3,8,504,267,237
050,19,033,"Iowa","Cerro Gordo County",3,9,510,273,237
050,19,033,"Iowa","Cerro Gordo County",3,10,485,241,244
050,19,033,"Iowa","Cerro Gordo County",3,11,503,257,246
050,19,033,"Iowa","Cerro Gordo County",3,12,532,272,260
050,19,033,"Iowa","Cerro Gordo County",3,13,574,302,272
050,19,033,"Iowa","Cerro Gordo County",3,14,536,265,271
050,19,033,"Iowa","Cerro Gordo County",3,15,555,275,280
050,19,033,"Iowa","Cerro Gordo County",3,16,504,252,252
050,19,033,"Iowa","Cerro Gordo County",3,17,502,269,233
050,19,033,"Iowa","Cerro Gordo County",3,18,483,254,229
050,19,033,"Iowa","Cerro Gordo County",3,19,476,269,207
050,19,033,"Iowa","Cerro Gordo County",3,20,474,275,199
050,19,033,"Iowa","Cerro Gordo County",3,21,447,241,206
050,19,033,"Iowa","Cerro Gordo County",3,22,456,223,233
050,19,033,"Iowa","Cerro Gordo County",3,23,491,232,259
050,19,033,"Iowa","Cerro Gordo County",3,24,449,220,229
050,19,033,"Iowa","Cerro Gordo County",3,25,470,234,236
050,19,033,"Iowa","Cerro Gordo County",3,26,466,226,240
050,19,033,"Iowa","Cerro Gordo County",3,27,469,248,221
050,19,033,"Iowa","Cerro Gordo County",3,28,482,241,241
050,19,033,"Iowa","Cerro Gordo County",3,29,512,259,253
050,19,033,"Iowa","Cerro Gordo County",3,30,521,263,258
050,19,033,"Iowa","Cerro Gordo County",3,31,499,246,253
050,19,033,"Iowa","Cerro Gordo County",3,32,454,232,222
050,19,033,"Iowa","Cerro Gordo County",3,33,455,219,236
050,19,033,"Iowa","Cerro Gordo County",3,34,435,215,220
050,19,033,"Iowa","Cerro Gordo County",3,35,470,228,242
050,19,033,"Iowa","Cerro Gordo County",3,36,484,251,233
050,19,033,"Iowa","Cerro Gordo County",3,37,496,255,241
050,19,033,"Iowa","Cerro Gordo County",3,38,502,264,238
050,19,033,"Iowa","Cerro Gordo County",3,39,494,258,236
050,19,033,"Iowa","Cerro Gordo County",3,40,492,257,235
050,19,033,"Iowa","Cerro Gordo County",3,41,488,256,232
050,19,033,"Iowa","Cerro Gordo County",3,42,501,268,233
050,19,033,"Iowa","Cerro Gordo County",3,43,496,255,241
050,19,033,"Iowa","Cerro Gordo County",3,44,471,233,238
050,19,033,"Iowa","Cerro Gordo County",3,45,426,205,221
050,19,033,"Iowa","Cerro Gordo County",3,46,429,222,207
050,19,033,"Iowa","Cerro Gordo County",3,47,420,218,202
050,19,033,"Iowa","Cerro Gordo County",3,48,422,204,218
050,19,033,"Iowa","Cerro Gordo County",3,49,445,206,239
050,19,033,"Iowa","Cerro Gordo County",3,50,504,246,258
050,19,033,"Iowa","Cerro Gordo County",3,51,501,254,247
050,19,033,"Iowa","Cerro Gordo County",3,52,501,245,256
050,19,033,"Iowa","Cerro Gordo County",3,53,500,248,252
050,19,033,"Iowa","Cerro Gordo County",3,54,495,259,236
050,19,033,"Iowa","Cerro Gordo County",3,55,499,254,245
050,19,033,"Iowa","Cerro Gordo County",3,56,556,267,289
050,19,033,"Iowa","Cerro Gordo County",3,57,600,285,315
050,19,033,"Iowa","Cerro Gordo County",3,58,621,303,318
050,19,033,"Iowa","Cerro Gordo County",3,59,671,330,341
050,19,033,"Iowa","Cerro Gordo County",3,60,726,356,370
050,19,033,"Iowa","Cerro Gordo County",3,61,699,341,358
050,19,033,"Iowa","Cerro Gordo County",3,62,676,337,339
050,19,033,"Iowa","Cerro Gordo County",3,63,669,335,334
050,19,033,"Iowa","Cerro Gordo County",3,64,663,311,352
050,19,033,"Iowa","Cerro Gordo County",3,65,657,307,350
050,19,033,"Iowa","Cerro Gordo County",3,66,664,329,335
050,19,033,"Iowa","Cerro Gordo County",3,67,611,309,302
050,19,033,"Iowa","Cerro Gordo County",3,68,571,278,293
050,19,033,"Iowa","Cerro Gordo County",3,69,613,303,310
050,19,033,"Iowa","Cerro Gordo County",3,70,606,311,295
050,19,033,"Iowa","Cerro Gordo County",3,71,526,263,263
050,19,033,"Iowa","Cerro Gordo County",3,72,513,239,274
050,19,033,"Iowa","Cerro Gordo County",3,73,489,222,267
050,19,033,"Iowa","Cerro Gordo County",3,74,506,230,276
050,19,033,"Iowa","Cerro Gordo County",3,75,327,140,187
050,19,033,"Iowa","Cerro Gordo County",3,76,313,139,174
050,19,033,"Iowa","Cerro Gordo County",3,77,307,142,165
050,19,033,"Iowa","Cerro Gordo County",3,78,316,142,174
050,19,033,"Iowa","Cerro Gordo County",3,79,281,120,161
050,19,033,"Iowa","Cerro Gordo County",3,80,268,106,162
050,19,033,"Iowa","Cerro Gordo County",3,81,256,117,139
050,19,033,"Iowa","Cerro Gordo County",3,82,240,98,142
050,19,033,"Iowa","Cerro Gordo County",3,83,231,89,142
050,19,033,"Iowa","Cerro Gordo County",3,84,202,72,130
050,19,033,"Iowa","Cerro Gordo County",3,85,1375,456,919
050,19,033,"Iowa","Cerro Gordo County",4,0,444,231,213
050,19,033,"Iowa","Cerro Gordo County",4,1,414,201,213
050,19,033,"Iowa","Cerro Gordo County",4,2,447,226,221
050,19,033,"Iowa","Cerro Gordo County",4,3,456,225,231
050,19,033,"Iowa","Cerro Gordo County",4,4,446,233,213
050,19,033,"Iowa","Cerro Gordo County",4,5,463,247,216
050,19,033,"Iowa","Cerro Gordo County",4,6,469,220,249
050,19,033,"Iowa","Cerro Gordo County",4,7,478,238,240
050,19,033,"Iowa","Cerro Gordo County",4,8,501,266,235
050,19,033,"Iowa","Cerro Gordo County",4,9,506,270,236
050,19,033,"Iowa","Cerro Gordo County",4,10,510,265,245
050,19,033,"Iowa","Cerro Gordo County",4,11,493,251,242
050,19,033,"Iowa","Cerro Gordo County",4,12,517,258,259
050,19,033,"Iowa","Cerro Gordo County",4,13,533,280,253
050,19,033,"Iowa","Cerro Gordo County",4,14,569,296,273
050,19,033,"Iowa","Cerro Gordo County",4,15,537,271,266
050,19,033,"Iowa","Cerro Gordo County",4,16,570,282,288
050,19,033,"Iowa","Cerro Gordo County",4,17,498,252,246
050,19,033,"Iowa","Cerro Gordo County",4,18,485,262,223
050,19,033,"Iowa","Cerro Gordo County",4,19,466,265,201
050,19,033,"Iowa","Cerro Gordo County",4,20,449,254,195
050,19,033,"Iowa","Cerro Gordo County",4,21,429,238,191
050,19,033,"Iowa","Cerro Gordo County",4,22,444,232,212
050,19,033,"Iowa","Cerro Gordo County",4,23,481,235,246
050,19,033,"Iowa","Cerro Gordo County",4,24,471,230,241
050,19,033,"Iowa","Cerro Gordo County",4,25,462,223,239
050,19,033,"Iowa","Cerro Gordo County",4,26,444,232,212
050,19,033,"Iowa","Cerro Gordo County",4,27,451,209,242
050,19,033,"Iowa","Cerro Gordo County",4,28,453,242,211
050,19,033,"Iowa","Cerro Gordo County",4,29,471,239,232
050,19,033,"Iowa","Cerro Gordo County",4,30,492,240,252
050,19,033,"Iowa","Cerro Gordo County",4,31,512,250,262
050,19,033,"Iowa","Cerro Gordo County",4,32,496,247,249
050,19,033,"Iowa","Cerro Gordo County",4,33,459,235,224
050,19,033,"Iowa","Cerro Gordo County",4,34,444,216,228
050,19,033,"Iowa","Cerro Gordo County",4,35,425,210,215
050,19,033,"Iowa","Cerro Gordo County",4,36,458,222,236
050,19,033,"Iowa","Cerro Gordo County",4,37,459,239,220
050,19,033,"Iowa","Cerro Gordo County",4,38,503,258,245
050,19,033,"Iowa","Cerro Gordo County",4,39,511,264,247
050,19,033,"Iowa","Cerro Gordo County",4,40,500,267,233
050,19,033,"Iowa","Cerro Gordo County",4,41,478,254,224
050,19,033,"Iowa","Cerro Gordo County",4,42,502,256,246
050,19,033,"Iowa","Cerro Gordo County",4,43,506,272,234
050,19,033,"Iowa","Cerro Gordo County",4,44,490,247,243
050,19,033,"Iowa","Cerro Gordo County",4,45,461,229,232
050,19,033,"Iowa","Cerro Gordo County",4,46,431,206,225
050,19,033,"Iowa","Cerro Gordo County",4,47,443,230,213
050,19,033,"Iowa","Cerro Gordo County",4,48,414,214,200
050,19,033,"Iowa","Cerro Gordo County",4,49,426,204,222
050,19,033,"Iowa","Cerro Gordo County",4,50,446,201,245
050,19,033,"Iowa","Cerro Gordo County",4,51,494,244,250
050,19,033,"Iowa","Cerro Gordo County",4,52,481,248,233
050,19,033,"Iowa","Cerro Gordo County",4,53,485,236,249
050,19,033,"Iowa","Cerro Gordo County",4,54,496,247,249
050,19,033,"Iowa","Cerro Gordo County",4,55,494,255,239
050,19,033,"Iowa","Cerro Gordo County",4,56,517,257,260
050,19,033,"Iowa","Cerro Gordo County",4,57,542,267,275
050,19,033,"Iowa","Cerro Gordo County",4,58,601,281,320
050,19,033,"Iowa","Cerro Gordo County",4,59,620,300,320
050,19,033,"Iowa","Cerro Gordo County",4,60,681,330,351
050,19,033,"Iowa","Cerro Gordo County",4,61,720,358,362
050,19,033,"Iowa","Cerro Gordo County",4,62,687,335,352
050,19,033,"Iowa","Cerro Gordo County",4,63,681,337,344
050,19,033,"Iowa","Cerro Gordo County",4,64,656,324,332
050,19,033,"Iowa","Cerro Gordo County",4,65,652,303,349
050,19,033,"Iowa","Cerro Gordo County",4,66,656,313,343
050,19,033,"Iowa","Cerro Gordo County",4,67,665,331,334
050,19,033,"Iowa","Cerro Gordo County",4,68,596,295,301
050,19,033,"Iowa","Cerro Gordo County",4,69,559,272,287
050,19,033,"Iowa","Cerro Gordo County",4,70,603,292,311
050,19,033,"Iowa","Cerro Gordo County",4,71,602,309,293
050,19,033,"Iowa","Cerro Gordo County",4,72,520,251,269
050,19,033,"Iowa","Cerro Gordo County",4,73,492,227,265
050,19,033,"Iowa","Cerro Gordo County",4,74,483,213,270
050,19,033,"Iowa","Cerro Gordo County",4,75,499,226,273
050,19,033,"Iowa","Cerro Gordo County",4,76,321,135,186
050,19,033,"Iowa","Cerro Gordo County",4,77,307,138,169
050,19,033,"Iowa","Cerro Gordo County",4,78,298,139,159
050,19,033,"Iowa","Cerro Gordo County",4,79,308,134,174
050,19,033,"Iowa","Cerro Gordo County",4,80,262,112,150
050,19,033,"Iowa","Cerro Gordo County",4,81,243,108,135
050,19,033,"Iowa","Cerro Gordo County",4,82,238,100,138
050,19,033,"Iowa","Cerro Gordo County",4,83,212,77,135
050,19,033,"Iowa","Cerro Gordo County",4,84,214,79,135
050,19,033,"Iowa","Cerro Gordo County",4,85,1328,437,891
050,19,033,"Iowa","Cerro Gordo County",5,0,445,233,212
050,19,033,"Iowa","Cerro Gordo County",5,1,444,228,216
050,19,033,"Iowa","Cerro Gordo County",5,2,419,211,208
050,19,033,"Iowa","Cerro Gordo County",5,3,443,221,222
050,19,033,"Iowa","Cerro Gordo County",5,4,474,225,249
050,19,033,"Iowa","Cerro Gordo County",5,5,460,233,227
050,19,033,"Iowa","Cerro Gordo County",5,6,449,235,214
050,19,033,"Iowa","Cerro Gordo County",5,7,465,215,250
050,19,033,"Iowa","Cerro Gordo County",5,8,488,240,248
050,19,033,"Iowa","Cerro Gordo County",5,9,501,261,240
050,19,033,"Iowa","Cerro Gordo County",5,10,518,277,241
050,19,033,"Iowa","Cerro Gordo County",5,11,506,267,239
050,19,033,"Iowa","Cerro Gordo County",5,12,489,250,239
050,19,033,"Iowa","Cerro Gordo County",5,13,524,266,258
050,19,033,"Iowa","Cerro Gordo County",5,14,527,265,262
050,19,033,"Iowa","Cerro Gordo County",5,15,587,308,279
050,19,033,"Iowa","Cerro Gordo County",5,16,547,270,277
050,19,033,"Iowa","Cerro Gordo County",5,17,575,283,292
050,19,033,"Iowa","Cerro Gordo County",5,18,466,239,227
050,19,033,"Iowa","Cerro Gordo County",5,19,472,275,197
050,19,033,"Iowa","Cerro Gordo County",5,20,456,260,196
050,19,033,"Iowa","Cerro Gordo County",5,21,443,237,206
050,19,033,"Iowa","Cerro Gordo County",5,22,445,236,209
050,19,033,"Iowa","Cerro Gordo County",5,23,448,238,210
050,19,033,"Iowa","Cerro Gordo County",5,24,472,235,237
050,19,033,"Iowa","Cerro Gordo County",5,25,453,226,227
050,19,033,"Iowa","Cerro Gordo County",5,26,458,224,234
050,19,033,"Iowa","Cerro Gordo County",5,27,454,240,214
050,19,033,"Iowa","Cerro Gordo County",5,28,468,221,247
050,19,033,"Iowa","Cerro Gordo County",5,29,459,244,215
050,19,033,"Iowa","Cerro Gordo County",5,30,447,229,218
050,19,033,"Iowa","Cerro Gordo County",5,31,482,229,253
050,19,033,"Iowa","Cerro Gordo County",5,32,514,257,257
050,19,033,"Iowa","Cerro Gordo County",5,33,501,252,249
050,19,033,"Iowa","Cerro Gordo County",5,34,457,243,214
050,19,033,"Iowa","Cerro Gordo County",5,35,429,205,224
050,19,033,"Iowa","Cerro Gordo County",5,36,433,219,214
050,19,033,"Iowa","Cerro Gordo County",5,37,453,225,228
050,19,033,"Iowa","Cerro Gordo County",5,38,460,233,227
050,19,033,"Iowa","Cerro Gordo County",5,39,492,251,241
050,19,033,"Iowa","Cerro Gordo County",5,40,507,261,246
050,19,033,"Iowa","Cerro Gordo County",5,41,498,260,238
050,19,033,"Iowa","Cerro Gordo County",5,42,489,253,236
050,19,033,"Iowa","Cerro Gordo County",5,43,508,260,248
050,19,033,"Iowa","Cerro Gordo County",5,44,518,279,239
050,19,033,"Iowa","Cerro Gordo County",5,45,477,241,236
050,19,033,"Iowa","Cerro Gordo County",5,46,462,233,229
050,19,033,"Iowa","Cerro Gordo County",5,47,432,209,223
050,19,033,"Iowa","Cerro Gordo County",5,48,426,223,203
050,19,033,"Iowa","Cerro Gordo County",5,49,413,211,202
050,19,033,"Iowa","Cerro Gordo County",5,50,421,196,225
050,19,033,"Iowa","Cerro Gordo County",5,51,453,203,250
050,19,033,"Iowa","Cerro Gordo County",5,52,480,238,242
050,19,033,"Iowa","Cerro Gordo County",5,53,479,246,233
050,19,033,"Iowa","Cerro Gordo County",5,54,481,237,244
050,19,033,"Iowa","Cerro Gordo County",5,55,494,248,246
050,19,033,"Iowa","Cerro Gordo County",5,56,508,258,250
050,19,033,"Iowa","Cerro Gordo County",5,57,511,262,249
050,19,033,"Iowa","Cerro Gordo County",5,58,555,268,287
050,19,033,"Iowa","Cerro Gordo County",5,59,598,284,314
050,19,033,"Iowa","Cerro Gordo County",5,60,625,308,317
050,19,033,"Iowa","Cerro Gordo County",5,61,676,336,340
050,19,033,"Iowa","Cerro Gordo County",5,62,695,343,352
050,19,033,"Iowa","Cerro Gordo County",5,63,688,335,353
050,19,033,"Iowa","Cerro Gordo County",5,64,665,323,342
050,19,033,"Iowa","Cerro Gordo County",5,65,634,312,322
050,19,033,"Iowa","Cerro Gordo County",5,66,652,302,350
050,19,033,"Iowa","Cerro Gordo County",5,67,660,314,346
050,19,033,"Iowa","Cerro Gordo County",5,68,663,321,342
050,19,033,"Iowa","Cerro Gordo County",5,69,584,290,294
050,19,033,"Iowa","Cerro Gordo County",5,70,550,264,286
050,19,033,"Iowa","Cerro Gordo County",5,71,603,293,310
050,19,033,"Iowa","Cerro Gordo County",5,72,598,302,296
050,19,033,"Iowa","Cerro Gordo County",5,73,518,250,268
050,19,033,"Iowa","Cerro Gordo County",5,74,482,224,258
050,19,033,"Iowa","Cerro Gordo County",5,75,475,212,263
050,19,033,"Iowa","Cerro Gordo County",5,76,489,216,273
050,19,033,"Iowa","Cerro Gordo County",5,77,311,136,175
050,19,033,"Iowa","Cerro Gordo County",5,78,305,136,169
050,19,033,"Iowa","Cerro Gordo County",5,79,282,126,156
050,19,033,"Iowa","Cerro Gordo County",5,80,286,121,165
050,19,033,"Iowa","Cerro Gordo County",5,81,247,113,134
050,19,033,"Iowa","Cerro Gordo County",5,82,231,95,136
050,19,033,"Iowa","Cerro Gordo County",5,83,214,85,129
050,19,033,"Iowa","Cerro Gordo County",5,84,198,66,132
050,19,033,"Iowa","Cerro Gordo County",5,85,1342,448,894
050,19,035,"Iowa","Cherokee County",1,0,117,59,58
050,19,035,"Iowa","Cherokee County",1,1,112,55,57
050,19,035,"Iowa","Cherokee County",1,2,135,68,67
050,19,035,"Iowa","Cherokee County",1,3,140,68,72
050,19,035,"Iowa","Cherokee County",1,4,136,70,66
050,19,035,"Iowa","Cherokee County",1,5,140,80,60
050,19,035,"Iowa","Cherokee County",1,6,157,87,70
050,19,035,"Iowa","Cherokee County",1,7,160,82,78
050,19,035,"Iowa","Cherokee County",1,8,132,77,55
050,19,035,"Iowa","Cherokee County",1,9,120,57,63
050,19,035,"Iowa","Cherokee County",1,10,157,70,87
050,19,035,"Iowa","Cherokee County",1,11,171,88,83
050,19,035,"Iowa","Cherokee County",1,12,150,80,70
050,19,035,"Iowa","Cherokee County",1,13,166,78,88
050,19,035,"Iowa","Cherokee County",1,14,147,71,76
050,19,035,"Iowa","Cherokee County",1,15,141,68,73
050,19,035,"Iowa","Cherokee County",1,16,146,80,66
050,19,035,"Iowa","Cherokee County",1,17,128,65,63
050,19,035,"Iowa","Cherokee County",1,18,115,61,54
050,19,035,"Iowa","Cherokee County",1,19,90,45,45
050,19,035,"Iowa","Cherokee County",1,20,97,48,49
050,19,035,"Iowa","Cherokee County",1,21,111,57,54
050,19,035,"Iowa","Cherokee County",1,22,114,54,60
050,19,035,"Iowa","Cherokee County",1,23,104,48,56
050,19,035,"Iowa","Cherokee County",1,24,103,51,52
050,19,035,"Iowa","Cherokee County",1,25,118,61,57
050,19,035,"Iowa","Cherokee County",1,26,122,63,59
050,19,035,"Iowa","Cherokee County",1,27,119,59,60
050,19,035,"Iowa","Cherokee County",1,28,124,61,63
050,19,035,"Iowa","Cherokee County",1,29,126,63,63
050,19,035,"Iowa","Cherokee County",1,30,139,69,70
050,19,035,"Iowa","Cherokee County",1,31,129,66,63
050,19,035,"Iowa","Cherokee County",1,32,124,63,61
050,19,035,"Iowa","Cherokee County",1,33,115,54,61
050,19,035,"Iowa","Cherokee County",1,34,124,67,57
050,19,035,"Iowa","Cherokee County",1,35,146,82,64
050,19,035,"Iowa","Cherokee County",1,36,124,68,56
050,19,035,"Iowa","Cherokee County",1,37,129,77,52
050,19,035,"Iowa","Cherokee County",1,38,134,74,60
050,19,035,"Iowa","Cherokee County",1,39,144,67,77
050,19,035,"Iowa","Cherokee County",1,40,124,64,60
050,19,035,"Iowa","Cherokee County",1,41,134,74,60
050,19,035,"Iowa","Cherokee County",1,42,122,67,55
050,19,035,"Iowa","Cherokee County",1,43,119,63,56
050,19,035,"Iowa","Cherokee County",1,44,110,58,52
050,19,035,"Iowa","Cherokee County",1,45,106,50,56
050,19,035,"Iowa","Cherokee County",1,46,88,39,49
050,19,035,"Iowa","Cherokee County",1,47,116,65,51
050,19,035,"Iowa","Cherokee County",1,48,130,74,56
050,19,035,"Iowa","Cherokee County",1,49,124,67,57
050,19,035,"Iowa","Cherokee County",1,50,118,62,56
050,19,035,"Iowa","Cherokee County",1,51,126,66,60
050,19,035,"Iowa","Cherokee County",1,52,134,66,68
050,19,035,"Iowa","Cherokee County",1,53,127,60,67
050,19,035,"Iowa","Cherokee County",1,54,133,70,63
050,19,035,"Iowa","Cherokee County",1,55,149,76,73
050,19,035,"Iowa","Cherokee County",1,56,159,83,76
050,19,035,"Iowa","Cherokee County",1,57,182,88,94
050,19,035,"Iowa","Cherokee County",1,58,206,102,104
050,19,035,"Iowa","Cherokee County",1,59,196,105,91
050,19,035,"Iowa","Cherokee County",1,60,180,97,83
050,19,035,"Iowa","Cherokee County",1,61,181,91,90
050,19,035,"Iowa","Cherokee County",1,62,198,101,97
050,19,035,"Iowa","Cherokee County",1,63,192,95,97
050,19,035,"Iowa","Cherokee County",1,64,187,89,98
050,19,035,"Iowa","Cherokee County",1,65,199,95,104
050,19,035,"Iowa","Cherokee County",1,66,186,98,88
050,19,035,"Iowa","Cherokee County",1,67,176,85,91
050,19,035,"Iowa","Cherokee County",1,68,164,89,75
050,19,035,"Iowa","Cherokee County",1,69,149,79,70
050,19,035,"Iowa","Cherokee County",1,70,141,76,65
050,19,035,"Iowa","Cherokee County",1,71,134,70,64
050,19,035,"Iowa","Cherokee County",1,72,112,54,58
050,19,035,"Iowa","Cherokee County",1,73,131,68,63
050,19,035,"Iowa","Cherokee County",1,74,99,48,51
050,19,035,"Iowa","Cherokee County",1,75,98,45,53
050,19,035,"Iowa","Cherokee County",1,76,99,40,59
050,19,035,"Iowa","Cherokee County",1,77,95,40,55
050,19,035,"Iowa","Cherokee County",1,78,98,46,52
050,19,035,"Iowa","Cherokee County",1,79,90,43,47
050,19,035,"Iowa","Cherokee County",1,80,69,32,37
050,19,035,"Iowa","Cherokee County",1,81,71,25,46
050,19,035,"Iowa","Cherokee County",1,82,69,29,40
050,19,035,"Iowa","Cherokee County",1,83,61,29,32
050,19,035,"Iowa","Cherokee County",1,84,63,23,40
050,19,035,"Iowa","Cherokee County",1,85,506,179,327
050,19,035,"Iowa","Cherokee County",2,0,120,60,60
050,19,035,"Iowa","Cherokee County",2,1,111,55,56
050,19,035,"Iowa","Cherokee County",2,2,129,64,65
050,19,035,"Iowa","Cherokee County",2,3,139,69,70
050,19,035,"Iowa","Cherokee County",2,4,137,68,69
050,19,035,"Iowa","Cherokee County",2,5,139,77,62
050,19,035,"Iowa","Cherokee County",2,6,154,86,68
050,19,035,"Iowa","Cherokee County",2,7,161,84,77
050,19,035,"Iowa","Cherokee County",2,8,138,77,61
050,19,035,"Iowa","Cherokee County",2,9,124,62,62
050,19,035,"Iowa","Cherokee County",2,10,149,66,83
050,19,035,"Iowa","Cherokee County",2,11,166,83,83
050,19,035,"Iowa","Cherokee County",2,12,154,81,73
050,19,035,"Iowa","Cherokee County",2,13,162,79,83
050,19,035,"Iowa","Cherokee County",2,14,153,73,80
050,19,035,"Iowa","Cherokee County",2,15,143,70,73
050,19,035,"Iowa","Cherokee County",2,16,145,78,67
050,19,035,"Iowa","Cherokee County",2,17,131,68,63
050,19,035,"Iowa","Cherokee County",2,18,111,59,52
050,19,035,"Iowa","Cherokee County",2,19,90,47,43
050,19,035,"Iowa","Cherokee County",2,20,100,49,51
050,19,035,"Iowa","Cherokee County",2,21,111,57,54
050,19,035,"Iowa","Cherokee County",2,22,114,54,60
050,19,035,"Iowa","Cherokee County",2,23,107,50,57
050,19,035,"Iowa","Cherokee County",2,24,104,51,53
050,19,035,"Iowa","Cherokee County",2,25,116,59,57
050,19,035,"Iowa","Cherokee County",2,26,120,61,59
050,19,035,"Iowa","Cherokee County",2,27,119,60,59
050,19,035,"Iowa","Cherokee County",2,28,124,62,62
050,19,035,"Iowa","Cherokee County",2,29,125,62,63
050,19,035,"Iowa","Cherokee County",2,30,138,68,70
050,19,035,"Iowa","Cherokee County",2,31,132,68,64
050,19,035,"Iowa","Cherokee County",2,32,122,61,61
050,19,035,"Iowa","Cherokee County",2,33,118,57,61
050,19,035,"Iowa","Cherokee County",2,34,124,65,59
050,19,035,"Iowa","Cherokee County",2,35,142,79,63
050,19,035,"Iowa","Cherokee County",2,36,128,71,57
050,19,035,"Iowa","Cherokee County",2,37,130,76,54
050,19,035,"Iowa","Cherokee County",2,38,135,77,58
050,19,035,"Iowa","Cherokee County",2,39,141,68,73
050,19,035,"Iowa","Cherokee County",2,40,129,66,63
050,19,035,"Iowa","Cherokee County",2,41,131,71,60
050,19,035,"Iowa","Cherokee County",2,42,123,68,55
050,19,035,"Iowa","Cherokee County",2,43,119,63,56
050,19,035,"Iowa","Cherokee County",2,44,113,60,53
050,19,035,"Iowa","Cherokee County",2,45,107,51,56
050,19,035,"Iowa","Cherokee County",2,46,91,41,50
050,19,035,"Iowa","Cherokee County",2,47,110,59,51
050,19,035,"Iowa","Cherokee County",2,48,129,73,56
050,19,035,"Iowa","Cherokee County",2,49,128,70,58
050,19,035,"Iowa","Cherokee County",2,50,118,62,56
050,19,035,"Iowa","Cherokee County",2,51,126,66,60
050,19,035,"Iowa","Cherokee County",2,52,132,65,67
050,19,035,"Iowa","Cherokee County",2,53,129,62,67
050,19,035,"Iowa","Cherokee County",2,54,130,66,64
050,19,035,"Iowa","Cherokee County",2,55,146,75,71
050,19,035,"Iowa","Cherokee County",2,56,158,82,76
050,19,035,"Iowa","Cherokee County",2,57,176,86,90
050,19,035,"Iowa","Cherokee County",2,58,196,95,101
050,19,035,"Iowa","Cherokee County",2,59,199,106,93
050,19,035,"Iowa","Cherokee County",2,60,182,97,85
050,19,035,"Iowa","Cherokee County",2,61,178,92,86
050,19,035,"Iowa","Cherokee County",2,62,191,96,95
050,19,035,"Iowa","Cherokee County",2,63,195,97,98
050,19,035,"Iowa","Cherokee County",2,64,187,90,97
050,19,035,"Iowa","Cherokee County",2,65,195,94,101
050,19,035,"Iowa","Cherokee County",2,66,188,97,91
050,19,035,"Iowa","Cherokee County",2,67,176,87,89
050,19,035,"Iowa","Cherokee County",2,68,166,88,78
050,19,035,"Iowa","Cherokee County",2,69,154,82,72
050,19,035,"Iowa","Cherokee County",2,70,143,77,66
050,19,035,"Iowa","Cherokee County",2,71,135,71,64
050,19,035,"Iowa","Cherokee County",2,72,115,57,58
050,19,035,"Iowa","Cherokee County",2,73,131,66,65
050,19,035,"Iowa","Cherokee County",2,74,100,49,51
050,19,035,"Iowa","Cherokee County",2,75,97,46,51
050,19,035,"Iowa","Cherokee County",2,76,99,41,58
050,19,035,"Iowa","Cherokee County",2,77,94,39,55
050,19,035,"Iowa","Cherokee County",2,78,94,43,51
050,19,035,"Iowa","Cherokee County",2,79,90,42,48
050,19,035,"Iowa","Cherokee County",2,80,73,35,38
050,19,035,"Iowa","Cherokee County",2,81,71,26,45
050,19,035,"Iowa","Cherokee County",2,82,71,29,42
050,19,035,"Iowa","Cherokee County",2,83,62,28,34
050,19,035,"Iowa","Cherokee County",2,84,62,25,37
050,19,035,"Iowa","Cherokee County",2,85,511,178,333
050,19,035,"Iowa","Cherokee County",3,0,131,67,64
050,19,035,"Iowa","Cherokee County",3,1,114,56,58
050,19,035,"Iowa","Cherokee County",3,2,104,50,54
050,19,035,"Iowa","Cherokee County",3,3,137,65,72
050,19,035,"Iowa","Cherokee County",3,4,131,63,68
050,19,035,"Iowa","Cherokee County",3,5,141,73,68
050,19,035,"Iowa","Cherokee County",3,6,139,76,63
050,19,035,"Iowa","Cherokee County",3,7,150,83,67
050,19,035,"Iowa","Cherokee County",3,8,163,83,80
050,19,035,"Iowa","Cherokee County",3,9,142,80,62
050,19,035,"Iowa","Cherokee County",3,10,128,64,64
050,19,035,"Iowa","Cherokee County",3,11,153,67,86
050,19,035,"Iowa","Cherokee County",3,12,169,82,87
050,19,035,"Iowa","Cherokee County",3,13,156,84,72
050,19,035,"Iowa","Cherokee County",3,14,166,83,83
050,19,035,"Iowa","Cherokee County",3,15,151,66,85
050,19,035,"Iowa","Cherokee County",3,16,139,68,71
050,19,035,"Iowa","Cherokee County",3,17,148,76,72
050,19,035,"Iowa","Cherokee County",3,18,112,62,50
050,19,035,"Iowa","Cherokee County",3,19,93,51,42
050,19,035,"Iowa","Cherokee County",3,20,89,47,42
050,19,035,"Iowa","Cherokee County",3,21,95,47,48
050,19,035,"Iowa","Cherokee County",3,22,117,61,56
050,19,035,"Iowa","Cherokee County",3,23,107,51,56
050,19,035,"Iowa","Cherokee County",3,24,104,48,56
050,19,035,"Iowa","Cherokee County",3,25,102,49,53
050,19,035,"Iowa","Cherokee County",3,26,113,57,56
050,19,035,"Iowa","Cherokee County",3,27,128,67,61
050,19,035,"Iowa","Cherokee County",3,28,113,55,58
050,19,035,"Iowa","Cherokee County",3,29,118,62,56
050,19,035,"Iowa","Cherokee County",3,30,112,54,58
050,19,035,"Iowa","Cherokee County",3,31,139,71,68
050,19,035,"Iowa","Cherokee County",3,32,137,73,64
050,19,035,"Iowa","Cherokee County",3,33,128,67,61
050,19,035,"Iowa","Cherokee County",3,34,124,62,62
050,19,035,"Iowa","Cherokee County",3,35,121,65,56
050,19,035,"Iowa","Cherokee County",3,36,145,80,65
050,19,035,"Iowa","Cherokee County",3,37,120,67,53
050,19,035,"Iowa","Cherokee County",3,38,134,78,56
050,19,035,"Iowa","Cherokee County",3,39,137,78,59
050,19,035,"Iowa","Cherokee County",3,40,136,67,69
050,19,035,"Iowa","Cherokee County",3,41,122,64,58
050,19,035,"Iowa","Cherokee County",3,42,132,71,61
050,19,035,"Iowa","Cherokee County",3,43,127,70,57
050,19,035,"Iowa","Cherokee County",3,44,115,61,54
050,19,035,"Iowa","Cherokee County",3,45,116,61,55
050,19,035,"Iowa","Cherokee County",3,46,103,49,54
050,19,035,"Iowa","Cherokee County",3,47,90,42,48
050,19,035,"Iowa","Cherokee County",3,48,118,65,53
050,19,035,"Iowa","Cherokee County",3,49,119,67,52
050,19,035,"Iowa","Cherokee County",3,50,122,65,57
050,19,035,"Iowa","Cherokee County",3,51,123,65,58
050,19,035,"Iowa","Cherokee County",3,52,125,67,58
050,19,035,"Iowa","Cherokee County",3,53,132,63,69
050,19,035,"Iowa","Cherokee County",3,54,123,60,63
050,19,035,"Iowa","Cherokee County",3,55,134,67,67
050,19,035,"Iowa","Cherokee County",3,56,142,73,69
050,19,035,"Iowa","Cherokee County",3,57,159,83,76
050,19,035,"Iowa","Cherokee County",3,58,176,85,91
050,19,035,"Iowa","Cherokee County",3,59,194,95,99
050,19,035,"Iowa","Cherokee County",3,60,200,106,94
050,19,035,"Iowa","Cherokee County",3,61,178,97,81
050,19,035,"Iowa","Cherokee County",3,62,170,85,85
050,19,035,"Iowa","Cherokee County",3,63,185,94,91
050,19,035,"Iowa","Cherokee County",3,64,194,96,98
050,19,035,"Iowa","Cherokee County",3,65,178,85,93
050,19,035,"Iowa","Cherokee County",3,66,185,91,94
050,19,035,"Iowa","Cherokee County",3,67,182,92,90
050,19,035,"Iowa","Cherokee County",3,68,177,88,89
050,19,035,"Iowa","Cherokee County",3,69,158,87,71
050,19,035,"Iowa","Cherokee County",3,70,152,80,72
050,19,035,"Iowa","Cherokee County",3,71,133,71,62
050,19,035,"Iowa","Cherokee County",3,72,131,67,64
050,19,035,"Iowa","Cherokee County",3,73,118,57,61
050,19,035,"Iowa","Cherokee County",3,74,127,67,60
050,19,035,"Iowa","Cherokee County",3,75,97,44,53
050,19,035,"Iowa","Cherokee County",3,76,92,43,49
050,19,035,"Iowa","Cherokee County",3,77,96,40,56
050,19,035,"Iowa","Cherokee County",3,78,93,40,53
050,19,035,"Iowa","Cherokee County",3,79,90,39,51
050,19,035,"Iowa","Cherokee County",3,80,83,40,43
050,19,035,"Iowa","Cherokee County",3,81,72,32,40
050,19,035,"Iowa","Cherokee County",3,82,71,26,45
050,19,035,"Iowa","Cherokee County",3,83,65,26,39
050,19,035,"Iowa","Cherokee County",3,84,55,26,29
050,19,035,"Iowa","Cherokee County",3,85,495,172,323
050,19,035,"Iowa","Cherokee County",4,0,124,60,64
050,19,035,"Iowa","Cherokee County",4,1,130,67,63
050,19,035,"Iowa","Cherokee County",4,2,120,64,56
050,19,035,"Iowa","Cherokee County",4,3,113,55,58
050,19,035,"Iowa","Cherokee County",4,4,134,65,69
050,19,035,"Iowa","Cherokee County",4,5,136,68,68
050,19,035,"Iowa","Cherokee County",4,6,145,77,68
050,19,035,"Iowa","Cherokee County",4,7,139,73,66
050,19,035,"Iowa","Cherokee County",4,8,167,96,71
050,19,035,"Iowa","Cherokee County",4,9,150,77,73
050,19,035,"Iowa","Cherokee County",4,10,145,81,64
050,19,035,"Iowa","Cherokee County",4,11,128,65,63
050,19,035,"Iowa","Cherokee County",4,12,162,70,92
050,19,035,"Iowa","Cherokee County",4,13,165,77,88
050,19,035,"Iowa","Cherokee County",4,14,158,82,76
050,19,035,"Iowa","Cherokee County",4,15,161,79,82
050,19,035,"Iowa","Cherokee County",4,16,157,70,87
050,19,035,"Iowa","Cherokee County",4,17,139,69,70
050,19,035,"Iowa","Cherokee County",4,18,128,73,55
050,19,035,"Iowa","Cherokee County",4,19,84,46,38
050,19,035,"Iowa","Cherokee County",4,20,91,44,47
050,19,035,"Iowa","Cherokee County",4,21,94,48,46
050,19,035,"Iowa","Cherokee County",4,22,97,49,48
050,19,035,"Iowa","Cherokee County",4,23,116,59,57
050,19,035,"Iowa","Cherokee County",4,24,105,51,54
050,19,035,"Iowa","Cherokee County",4,25,107,52,55
050,19,035,"Iowa","Cherokee County",4,26,111,53,58
050,19,035,"Iowa","Cherokee County",4,27,120,68,52
050,19,035,"Iowa","Cherokee County",4,28,125,63,62
050,19,035,"Iowa","Cherokee County",4,29,118,59,59
050,19,035,"Iowa","Cherokee County",4,30,122,67,55
050,19,035,"Iowa","Cherokee County",4,31,113,56,57
050,19,035,"Iowa","Cherokee County",4,32,146,73,73
050,19,035,"Iowa","Cherokee County",4,33,131,71,60
050,19,035,"Iowa","Cherokee County",4,34,129,64,65
050,19,035,"Iowa","Cherokee County",4,35,122,60,62
050,19,035,"Iowa","Cherokee County",4,36,123,63,60
050,19,035,"Iowa","Cherokee County",4,37,141,79,62
050,19,035,"Iowa","Cherokee County",4,38,125,68,57
050,19,035,"Iowa","Cherokee County",4,39,137,81,56
050,19,035,"Iowa","Cherokee County",4,40,134,80,54
050,19,035,"Iowa","Cherokee County",4,41,136,68,68
050,19,035,"Iowa","Cherokee County",4,42,121,64,57
050,19,035,"Iowa","Cherokee County",4,43,129,71,58
050,19,035,"Iowa","Cherokee County",4,44,135,76,59
050,19,035,"Iowa","Cherokee County",4,45,116,62,54
050,19,035,"Iowa","Cherokee County",4,46,115,60,55
050,19,035,"Iowa","Cherokee County",4,47,106,50,56
050,19,035,"Iowa","Cherokee County",4,48,100,52,48
050,19,035,"Iowa","Cherokee County",4,49,115,60,55
050,19,035,"Iowa","Cherokee County",4,50,112,61,51
050,19,035,"Iowa","Cherokee County",4,51,125,67,58
050,19,035,"Iowa","Cherokee County",4,52,119,65,54
050,19,035,"Iowa","Cherokee County",4,53,121,63,58
050,19,035,"Iowa","Cherokee County",4,54,135,67,68
050,19,035,"Iowa","Cherokee County",4,55,121,56,65
050,19,035,"Iowa","Cherokee County",4,56,128,62,66
050,19,035,"Iowa","Cherokee County",4,57,146,76,70
050,19,035,"Iowa","Cherokee County",4,58,154,78,76
050,19,035,"Iowa","Cherokee County",4,59,176,83,93
050,19,035,"Iowa","Cherokee County",4,60,194,96,98
050,19,035,"Iowa","Cherokee County",4,61,194,103,91
050,19,035,"Iowa","Cherokee County",4,62,174,91,83
050,19,035,"Iowa","Cherokee County",4,63,165,84,81
050,19,035,"Iowa","Cherokee County",4,64,178,91,87
050,19,035,"Iowa","Cherokee County",4,65,189,94,95
050,19,035,"Iowa","Cherokee County",4,66,174,81,93
050,19,035,"Iowa","Cherokee County",4,67,184,88,96
050,19,035,"Iowa","Cherokee County",4,68,179,91,88
050,19,035,"Iowa","Cherokee County",4,69,170,86,84
050,19,035,"Iowa","Cherokee County",4,70,157,88,69
050,19,035,"Iowa","Cherokee County",4,71,144,73,71
050,19,035,"Iowa","Cherokee County",4,72,132,68,64
050,19,035,"Iowa","Cherokee County",4,73,133,67,66
050,19,035,"Iowa","Cherokee County",4,74,115,57,58
050,19,035,"Iowa","Cherokee County",4,75,120,60,60
050,19,035,"Iowa","Cherokee County",4,76,92,42,50
050,19,035,"Iowa","Cherokee County",4,77,93,43,50
050,19,035,"Iowa","Cherokee County",4,78,95,39,56
050,19,035,"Iowa","Cherokee County",4,79,91,40,51
050,19,035,"Iowa","Cherokee County",4,80,82,36,46
050,19,035,"Iowa","Cherokee County",4,81,84,39,45
050,19,035,"Iowa","Cherokee County",4,82,70,32,38
050,19,035,"Iowa","Cherokee County",4,83,61,21,40
050,19,035,"Iowa","Cherokee County",4,84,56,25,31
050,19,035,"Iowa","Cherokee County",4,85,462,163,299
050,19,035,"Iowa","Cherokee County",5,0,124,61,63
050,19,035,"Iowa","Cherokee County",5,1,141,68,73
050,19,035,"Iowa","Cherokee County",5,2,132,66,66
050,19,035,"Iowa","Cherokee County",5,3,135,77,58
050,19,035,"Iowa","Cherokee County",5,4,119,55,64
050,19,035,"Iowa","Cherokee County",5,5,134,67,67
050,19,035,"Iowa","Cherokee County",5,6,139,72,67
050,19,035,"Iowa","Cherokee County",5,7,149,79,70
050,19,035,"Iowa","Cherokee County",5,8,137,76,61
050,19,035,"Iowa","Cherokee County",5,9,176,101,75
050,19,035,"Iowa","Cherokee County",5,10,164,86,78
050,19,035,"Iowa","Cherokee County",5,11,144,83,61
050,19,035,"Iowa","Cherokee County",5,12,136,69,67
050,19,035,"Iowa","Cherokee County",5,13,166,69,97
050,19,035,"Iowa","Cherokee County",5,14,170,80,90
050,19,035,"Iowa","Cherokee County",5,15,160,86,74
050,19,035,"Iowa","Cherokee County",5,16,165,82,83
050,19,035,"Iowa","Cherokee County",5,17,161,68,93
050,19,035,"Iowa","Cherokee County",5,18,113,59,54
050,19,035,"Iowa","Cherokee County",5,19,95,51,44
050,19,035,"Iowa","Cherokee County",5,20,88,49,39
050,19,035,"Iowa","Cherokee County",5,21,101,51,50
050,19,035,"Iowa","Cherokee County",5,22,98,49,49
050,19,035,"Iowa","Cherokee County",5,23,105,55,50
050,19,035,"Iowa","Cherokee County",5,24,118,61,57
050,19,035,"Iowa","Cherokee County",5,25,107,58,49
050,19,035,"Iowa","Cherokee County",5,26,112,57,55
050,19,035,"Iowa","Cherokee County",5,27,109,53,56
050,19,035,"Iowa","Cherokee County",5,28,115,62,53
050,19,035,"Iowa","Cherokee County",5,29,132,66,66
050,19,035,"Iowa","Cherokee County",5,30,127,61,66
050,19,035,"Iowa","Cherokee County",5,31,131,76,55
050,19,035,"Iowa","Cherokee County",5,32,116,58,58
050,19,035,"Iowa","Cherokee County",5,33,143,66,77
050,19,035,"Iowa","Cherokee County",5,34,130,72,58
050,19,035,"Iowa","Cherokee County",5,35,133,65,68
050,19,035,"Iowa","Cherokee County",5,36,125,59,66
050,19,035,"Iowa","Cherokee County",5,37,130,73,57
050,19,035,"Iowa","Cherokee County",5,38,144,80,64
050,19,035,"Iowa","Cherokee County",5,39,136,77,59
050,19,035,"Iowa","Cherokee County",5,40,141,85,56
050,19,035,"Iowa","Cherokee County",5,41,132,77,55
050,19,035,"Iowa","Cherokee County",5,42,138,69,69
050,19,035,"Iowa","Cherokee County",5,43,125,64,61
050,19,035,"Iowa","Cherokee County",5,44,135,79,56
050,19,035,"Iowa","Cherokee County",5,45,136,78,58
050,19,035,"Iowa","Cherokee County",5,46,118,64,54
050,19,035,"Iowa","Cherokee County",5,47,123,67,56
050,19,035,"Iowa","Cherokee County",5,48,112,55,57
050,19,035,"Iowa","Cherokee County",5,49,94,46,48
050,19,035,"Iowa","Cherokee County",5,50,108,56,52
050,19,035,"Iowa","Cherokee County",5,51,112,60,52
050,19,035,"Iowa","Cherokee County",5,52,125,67,58
050,19,035,"Iowa","Cherokee County",5,53,123,65,58
050,19,035,"Iowa","Cherokee County",5,54,119,62,57
050,19,035,"Iowa","Cherokee County",5,55,133,63,70
050,19,035,"Iowa","Cherokee County",5,56,116,53,63
050,19,035,"Iowa","Cherokee County",5,57,127,64,63
050,19,035,"Iowa","Cherokee County",5,58,144,74,70
050,19,035,"Iowa","Cherokee County",5,59,151,75,76
050,19,035,"Iowa","Cherokee County",5,60,179,82,97
050,19,035,"Iowa","Cherokee County",5,61,195,99,96
050,19,035,"Iowa","Cherokee County",5,62,184,96,88
050,19,035,"Iowa","Cherokee County",5,63,173,91,82
050,19,035,"Iowa","Cherokee County",5,64,163,83,80
050,19,035,"Iowa","Cherokee County",5,65,172,89,83
050,19,035,"Iowa","Cherokee County",5,66,189,95,94
050,19,035,"Iowa","Cherokee County",5,67,170,76,94
050,19,035,"Iowa","Cherokee County",5,68,182,89,93
050,19,035,"Iowa","Cherokee County",5,69,176,89,87
050,19,035,"Iowa","Cherokee County",5,70,167,83,84
050,19,035,"Iowa","Cherokee County",5,71,156,86,70
050,19,035,"Iowa","Cherokee County",5,72,143,72,71
050,19,035,"Iowa","Cherokee County",5,73,131,66,65
050,19,035,"Iowa","Cherokee County",5,74,127,67,60
050,19,035,"Iowa","Cherokee County",5,75,111,52,59
050,19,035,"Iowa","Cherokee County",5,76,113,55,58
050,19,035,"Iowa","Cherokee County",5,77,92,42,50
050,19,035,"Iowa","Cherokee County",5,78,93,42,51
050,19,035,"Iowa","Cherokee County",5,79,92,36,56
050,19,035,"Iowa","Cherokee County",5,80,83,38,45
050,19,035,"Iowa","Cherokee County",5,81,83,34,49
050,19,035,"Iowa","Cherokee County",5,82,81,38,43
050,19,035,"Iowa","Cherokee County",5,83,63,27,36
050,19,035,"Iowa","Cherokee County",5,84,58,20,38
050,19,035,"Iowa","Cherokee County",5,85,457,160,297
050,19,037,"Iowa","Chickasaw County",1,0,138,70,68
050,19,037,"Iowa","Chickasaw County",1,1,135,73,62
050,19,037,"Iowa","Chickasaw County",1,2,160,78,82
050,19,037,"Iowa","Chickasaw County",1,3,146,73,73
050,19,037,"Iowa","Chickasaw County",1,4,136,75,61
050,19,037,"Iowa","Chickasaw County",1,5,153,77,76
050,19,037,"Iowa","Chickasaw County",1,6,159,86,73
050,19,037,"Iowa","Chickasaw County",1,7,152,74,78
050,19,037,"Iowa","Chickasaw County",1,8,159,70,89
050,19,037,"Iowa","Chickasaw County",1,9,143,71,72
050,19,037,"Iowa","Chickasaw County",1,10,168,85,83
050,19,037,"Iowa","Chickasaw County",1,11,157,81,76
050,19,037,"Iowa","Chickasaw County",1,12,179,96,83
050,19,037,"Iowa","Chickasaw County",1,13,176,92,84
050,19,037,"Iowa","Chickasaw County",1,14,183,90,93
050,19,037,"Iowa","Chickasaw County",1,15,159,76,83
050,19,037,"Iowa","Chickasaw County",1,16,167,88,79
050,19,037,"Iowa","Chickasaw County",1,17,160,86,74
050,19,037,"Iowa","Chickasaw County",1,18,138,68,70
050,19,037,"Iowa","Chickasaw County",1,19,119,64,55
050,19,037,"Iowa","Chickasaw County",1,20,109,57,52
050,19,037,"Iowa","Chickasaw County",1,21,110,64,46
050,19,037,"Iowa","Chickasaw County",1,22,144,87,57
050,19,037,"Iowa","Chickasaw County",1,23,133,77,56
050,19,037,"Iowa","Chickasaw County",1,24,117,66,51
050,19,037,"Iowa","Chickasaw County",1,25,129,75,54
050,19,037,"Iowa","Chickasaw County",1,26,138,73,65
050,19,037,"Iowa","Chickasaw County",1,27,123,68,55
050,19,037,"Iowa","Chickasaw County",1,28,125,64,61
050,19,037,"Iowa","Chickasaw County",1,29,119,64,55
050,19,037,"Iowa","Chickasaw County",1,30,129,59,70
050,19,037,"Iowa","Chickasaw County",1,31,111,46,65
050,19,037,"Iowa","Chickasaw County",1,32,114,52,62
050,19,037,"Iowa","Chickasaw County",1,33,117,54,63
050,19,037,"Iowa","Chickasaw County",1,34,109,57,52
050,19,037,"Iowa","Chickasaw County",1,35,114,61,53
050,19,037,"Iowa","Chickasaw County",1,36,123,70,53
050,19,037,"Iowa","Chickasaw County",1,37,137,72,65
050,19,037,"Iowa","Chickasaw County",1,38,149,75,74
050,19,037,"Iowa","Chickasaw County",1,39,152,85,67
050,19,037,"Iowa","Chickasaw County",1,40,138,69,69
050,19,037,"Iowa","Chickasaw County",1,41,128,63,65
050,19,037,"Iowa","Chickasaw County",1,42,137,69,68
050,19,037,"Iowa","Chickasaw County",1,43,135,65,70
050,19,037,"Iowa","Chickasaw County",1,44,110,57,53
050,19,037,"Iowa","Chickasaw County",1,45,115,64,51
050,19,037,"Iowa","Chickasaw County",1,46,117,63,54
050,19,037,"Iowa","Chickasaw County",1,47,115,65,50
050,19,037,"Iowa","Chickasaw County",1,48,128,69,59
050,19,037,"Iowa","Chickasaw County",1,49,139,72,67
050,19,037,"Iowa","Chickasaw County",1,50,135,72,63
050,19,037,"Iowa","Chickasaw County",1,51,138,73,65
050,19,037,"Iowa","Chickasaw County",1,52,141,74,67
050,19,037,"Iowa","Chickasaw County",1,53,158,82,76
050,19,037,"Iowa","Chickasaw County",1,54,157,81,76
050,19,037,"Iowa","Chickasaw County",1,55,170,83,87
050,19,037,"Iowa","Chickasaw County",1,56,180,98,82
050,19,037,"Iowa","Chickasaw County",1,57,167,91,76
050,19,037,"Iowa","Chickasaw County",1,58,175,101,74
050,19,037,"Iowa","Chickasaw County",1,59,190,96,94
050,19,037,"Iowa","Chickasaw County",1,60,200,96,104
050,19,037,"Iowa","Chickasaw County",1,61,198,98,100
050,19,037,"Iowa","Chickasaw County",1,62,198,106,92
050,19,037,"Iowa","Chickasaw County",1,63,204,116,88
050,19,037,"Iowa","Chickasaw County",1,64,168,99,69
050,19,037,"Iowa","Chickasaw County",1,65,169,90,79
050,19,037,"Iowa","Chickasaw County",1,66,171,82,89
050,19,037,"Iowa","Chickasaw County",1,67,158,82,76
050,19,037,"Iowa","Chickasaw County",1,68,162,80,82
050,19,037,"Iowa","Chickasaw County",1,69,141,72,69
050,19,037,"Iowa","Chickasaw County",1,70,128,59,69
050,19,037,"Iowa","Chickasaw County",1,71,130,69,61
050,19,037,"Iowa","Chickasaw County",1,72,129,66,63
050,19,037,"Iowa","Chickasaw County",1,73,115,57,58
050,19,037,"Iowa","Chickasaw County",1,74,85,43,42
050,19,037,"Iowa","Chickasaw County",1,75,106,49,57
050,19,037,"Iowa","Chickasaw County",1,76,91,36,55
050,19,037,"Iowa","Chickasaw County",1,77,95,44,51
050,19,037,"Iowa","Chickasaw County",1,78,95,41,54
050,19,037,"Iowa","Chickasaw County",1,79,72,35,37
050,19,037,"Iowa","Chickasaw County",1,80,74,35,39
050,19,037,"Iowa","Chickasaw County",1,81,69,28,41
050,19,037,"Iowa","Chickasaw County",1,82,71,28,43
050,19,037,"Iowa","Chickasaw County",1,83,62,29,33
050,19,037,"Iowa","Chickasaw County",1,84,65,33,32
050,19,037,"Iowa","Chickasaw County",1,85,393,136,257
050,19,037,"Iowa","Chickasaw County",2,0,145,74,71
050,19,037,"Iowa","Chickasaw County",2,1,134,72,62
050,19,037,"Iowa","Chickasaw County",2,2,154,77,77
050,19,037,"Iowa","Chickasaw County",2,3,148,74,74
050,19,037,"Iowa","Chickasaw County",2,4,138,74,64
050,19,037,"Iowa","Chickasaw County",2,5,150,78,72
050,19,037,"Iowa","Chickasaw County",2,6,157,84,73
050,19,037,"Iowa","Chickasaw County",2,7,152,75,77
050,19,037,"Iowa","Chickasaw County",2,8,156,71,85
050,19,037,"Iowa","Chickasaw County",2,9,149,72,77
050,19,037,"Iowa","Chickasaw County",2,10,161,82,79
050,19,037,"Iowa","Chickasaw County",2,11,159,82,77
050,19,037,"Iowa","Chickasaw County",2,12,175,94,81
050,19,037,"Iowa","Chickasaw County",2,13,176,93,83
050,19,037,"Iowa","Chickasaw County",2,14,180,90,90
050,19,037,"Iowa","Chickasaw County",2,15,165,80,85
050,19,037,"Iowa","Chickasaw County",2,16,165,86,79
050,19,037,"Iowa","Chickasaw County",2,17,163,87,76
050,19,037,"Iowa","Chickasaw County",2,18,136,69,67
050,19,037,"Iowa","Chickasaw County",2,19,116,61,55
050,19,037,"Iowa","Chickasaw County",2,20,113,60,53
050,19,037,"Iowa","Chickasaw County",2,21,113,64,49
050,19,037,"Iowa","Chickasaw County",2,22,133,79,54
050,19,037,"Iowa","Chickasaw County",2,23,135,79,56
050,19,037,"Iowa","Chickasaw County",2,24,119,68,51
050,19,037,"Iowa","Chickasaw County",2,25,127,72,55
050,19,037,"Iowa","Chickasaw County",2,26,134,73,61
050,19,037,"Iowa","Chickasaw County",2,27,127,69,58
050,19,037,"Iowa","Chickasaw County",2,28,126,67,59
050,19,037,"Iowa","Chickasaw County",2,29,121,64,57
050,19,037,"Iowa","Chickasaw County",2,30,127,61,66
050,19,037,"Iowa","Chickasaw County",2,31,114,48,66
050,19,037,"Iowa","Chickasaw County",2,32,111,50,61
050,19,037,"Iowa","Chickasaw County",2,33,115,53,62
050,19,037,"Iowa","Chickasaw County",2,34,113,57,56
050,19,037,"Iowa","Chickasaw County",2,35,114,61,53
050,19,037,"Iowa","Chickasaw County",2,36,120,68,52
050,19,037,"Iowa","Chickasaw County",2,37,135,72,63
050,19,037,"Iowa","Chickasaw County",2,38,147,75,72
050,19,037,"Iowa","Chickasaw County",2,39,152,82,70
050,19,037,"Iowa","Chickasaw County",2,40,143,74,69
050,19,037,"Iowa","Chickasaw County",2,41,129,64,65
050,19,037,"Iowa","Chickasaw County",2,42,133,67,66
050,19,037,"Iowa","Chickasaw County",2,43,134,66,68
050,19,037,"Iowa","Chickasaw County",2,44,114,58,56
050,19,037,"Iowa","Chickasaw County",2,45,113,61,52
050,19,037,"Iowa","Chickasaw County",2,46,116,64,52
050,19,037,"Iowa","Chickasaw County",2,47,115,64,51
050,19,037,"Iowa","Chickasaw County",2,48,127,69,58
050,19,037,"Iowa","Chickasaw County",2,49,138,72,66
050,19,037,"Iowa","Chickasaw County",2,50,136,72,64
050,19,037,"Iowa","Chickasaw County",2,51,137,73,64
050,19,037,"Iowa","Chickasaw County",2,52,139,74,65
050,19,037,"Iowa","Chickasaw County",2,53,152,79,73
050,19,037,"Iowa","Chickasaw County",2,54,157,81,76
050,19,037,"Iowa","Chickasaw County",2,55,168,83,85
050,19,037,"Iowa","Chickasaw County",2,56,177,95,82
050,19,037,"Iowa","Chickasaw County",2,57,169,92,77
050,19,037,"Iowa","Chickasaw County",2,58,173,98,75
050,19,037,"Iowa","Chickasaw County",2,59,186,97,89
050,19,037,"Iowa","Chickasaw County",2,60,198,96,102
050,19,037,"Iowa","Chickasaw County",2,61,197,96,101
050,19,037,"Iowa","Chickasaw County",2,62,198,104,94
050,19,037,"Iowa","Chickasaw County",2,63,203,115,88
050,19,037,"Iowa","Chickasaw County",2,64,175,102,73
050,19,037,"Iowa","Chickasaw County",2,65,168,91,77
050,19,037,"Iowa","Chickasaw County",2,66,167,81,86
050,19,037,"Iowa","Chickasaw County",2,67,161,82,79
050,19,037,"Iowa","Chickasaw County",2,68,158,79,79
050,19,037,"Iowa","Chickasaw County",2,69,145,73,72
050,19,037,"Iowa","Chickasaw County",2,70,129,60,69
050,19,037,"Iowa","Chickasaw County",2,71,129,67,62
050,19,037,"Iowa","Chickasaw County",2,72,125,64,61
050,19,037,"Iowa","Chickasaw County",2,73,124,62,62
050,19,037,"Iowa","Chickasaw County",2,74,86,43,43
050,19,037,"Iowa","Chickasaw County",2,75,99,46,53
050,19,037,"Iowa","Chickasaw County",2,76,94,39,55
050,19,037,"Iowa","Chickasaw County",2,77,96,42,54
050,19,037,"Iowa","Chickasaw County",2,78,93,39,54
050,19,037,"Iowa","Chickasaw County",2,79,76,36,40
050,19,037,"Iowa","Chickasaw County",2,80,74,36,38
050,19,037,"Iowa","Chickasaw County",2,81,66,27,39
050,19,037,"Iowa","Chickasaw County",2,82,71,28,43
050,19,037,"Iowa","Chickasaw County",2,83,62,28,34
050,19,037,"Iowa","Chickasaw County",2,84,66,32,34
050,19,037,"Iowa","Chickasaw County",2,85,397,139,258
050,19,037,"Iowa","Chickasaw County",3,0,125,66,59
050,19,037,"Iowa","Chickasaw County",3,1,136,79,57
050,19,037,"Iowa","Chickasaw County",3,2,133,68,65
050,19,037,"Iowa","Chickasaw County",3,3,158,75,83
050,19,037,"Iowa","Chickasaw County",3,4,152,73,79
050,19,037,"Iowa","Chickasaw County",3,5,135,75,60
050,19,037,"Iowa","Chickasaw County",3,6,153,83,70
050,19,037,"Iowa","Chickasaw County",3,7,159,86,73
050,19,037,"Iowa","Chickasaw County",3,8,153,78,75
050,19,037,"Iowa","Chickasaw County",3,9,162,76,86
050,19,037,"Iowa","Chickasaw County",3,10,151,72,79
050,19,037,"Iowa","Chickasaw County",3,11,156,81,75
050,19,037,"Iowa","Chickasaw County",3,12,153,77,76
050,19,037,"Iowa","Chickasaw County",3,13,178,95,83
050,19,037,"Iowa","Chickasaw County",3,14,182,96,86
050,19,037,"Iowa","Chickasaw County",3,15,178,87,91
050,19,037,"Iowa","Chickasaw County",3,16,167,80,87
050,19,037,"Iowa","Chickasaw County",3,17,166,85,81
050,19,037,"Iowa","Chickasaw County",3,18,144,79,65
050,19,037,"Iowa","Chickasaw County",3,19,105,52,53
050,19,037,"Iowa","Chickasaw County",3,20,114,56,58
050,19,037,"Iowa","Chickasaw County",3,21,111,53,58
050,19,037,"Iowa","Chickasaw County",3,22,127,68,59
050,19,037,"Iowa","Chickasaw County",3,23,137,81,56
050,19,037,"Iowa","Chickasaw County",3,24,115,64,51
050,19,037,"Iowa","Chickasaw County",3,25,119,68,51
050,19,037,"Iowa","Chickasaw County",3,26,121,70,51
050,19,037,"Iowa","Chickasaw County",3,27,135,74,61
050,19,037,"Iowa","Chickasaw County",3,28,120,66,54
050,19,037,"Iowa","Chickasaw County",3,29,129,68,61
050,19,037,"Iowa","Chickasaw County",3,30,118,60,58
050,19,037,"Iowa","Chickasaw County",3,31,131,64,67
050,19,037,"Iowa","Chickasaw County",3,32,119,52,67
050,19,037,"Iowa","Chickasaw County",3,33,111,53,58
050,19,037,"Iowa","Chickasaw County",3,34,116,55,61
050,19,037,"Iowa","Chickasaw County",3,35,121,63,58
050,19,037,"Iowa","Chickasaw County",3,36,119,65,54
050,19,037,"Iowa","Chickasaw County",3,37,122,66,56
050,19,037,"Iowa","Chickasaw County",3,38,137,75,62
050,19,037,"Iowa","Chickasaw County",3,39,148,72,76
050,19,037,"Iowa","Chickasaw County",3,40,149,80,69
050,19,037,"Iowa","Chickasaw County",3,41,142,73,69
050,19,037,"Iowa","Chickasaw County",3,42,128,64,64
050,19,037,"Iowa","Chickasaw County",3,43,133,68,65
050,19,037,"Iowa","Chickasaw County",3,44,133,67,66
050,19,037,"Iowa","Chickasaw County",3,45,108,58,50
050,19,037,"Iowa","Chickasaw County",3,46,108,56,52
050,19,037,"Iowa","Chickasaw County",3,47,113,62,51
050,19,037,"Iowa","Chickasaw County",3,48,118,63,55
050,19,037,"Iowa","Chickasaw County",3,49,122,67,55
050,19,037,"Iowa","Chickasaw County",3,50,140,75,65
050,19,037,"Iowa","Chickasaw County",3,51,136,72,64
050,19,037,"Iowa","Chickasaw County",3,52,135,74,61
050,19,037,"Iowa","Chickasaw County",3,53,138,72,66
050,19,037,"Iowa","Chickasaw County",3,54,147,77,70
050,19,037,"Iowa","Chickasaw County",3,55,155,81,74
050,19,037,"Iowa","Chickasaw County",3,56,163,82,81
050,19,037,"Iowa","Chickasaw County",3,57,172,89,83
050,19,037,"Iowa","Chickasaw County",3,58,167,92,75
050,19,037,"Iowa","Chickasaw County",3,59,169,94,75
050,19,037,"Iowa","Chickasaw County",3,60,186,102,84
050,19,037,"Iowa","Chickasaw County",3,61,200,95,105
050,19,037,"Iowa","Chickasaw County",3,62,191,92,99
050,19,037,"Iowa","Chickasaw County",3,63,203,104,99
050,19,037,"Iowa","Chickasaw County",3,64,202,115,87
050,19,037,"Iowa","Chickasaw County",3,65,176,102,74
050,19,037,"Iowa","Chickasaw County",3,66,163,91,72
050,19,037,"Iowa","Chickasaw County",3,67,166,81,85
050,19,037,"Iowa","Chickasaw County",3,68,157,81,76
050,19,037,"Iowa","Chickasaw County",3,69,154,76,78
050,19,037,"Iowa","Chickasaw County",3,70,141,69,72
050,19,037,"Iowa","Chickasaw County",3,71,122,61,61
050,19,037,"Iowa","Chickasaw County",3,72,127,66,61
050,19,037,"Iowa","Chickasaw County",3,73,125,64,61
050,19,037,"Iowa","Chickasaw County",3,74,121,60,61
050,19,037,"Iowa","Chickasaw County",3,75,85,41,44
050,19,037,"Iowa","Chickasaw County",3,76,98,45,53
050,19,037,"Iowa","Chickasaw County",3,77,85,35,50
050,19,037,"Iowa","Chickasaw County",3,78,95,35,60
050,19,037,"Iowa","Chickasaw County",3,79,80,34,46
050,19,037,"Iowa","Chickasaw County",3,80,79,40,39
050,19,037,"Iowa","Chickasaw County",3,81,63,31,32
050,19,037,"Iowa","Chickasaw County",3,82,63,24,39
050,19,037,"Iowa","Chickasaw County",3,83,61,25,36
050,19,037,"Iowa","Chickasaw County",3,84,59,19,40
050,19,037,"Iowa","Chickasaw County",3,85,389,142,247
050,19,037,"Iowa","Chickasaw County",4,0,134,63,71
050,19,037,"Iowa","Chickasaw County",4,1,124,58,66
050,19,037,"Iowa","Chickasaw County",4,2,136,77,59
050,19,037,"Iowa","Chickasaw County",4,3,130,66,64
050,19,037,"Iowa","Chickasaw County",4,4,146,71,75
050,19,037,"Iowa","Chickasaw County",4,5,148,68,80
050,19,037,"Iowa","Chickasaw County",4,6,143,78,65
050,19,037,"Iowa","Chickasaw County",4,7,146,81,65
050,19,037,"Iowa","Chickasaw County",4,8,153,83,70
050,19,037,"Iowa","Chickasaw County",4,9,142,70,72
050,19,037,"Iowa","Chickasaw County",4,10,162,72,90
050,19,037,"Iowa","Chickasaw County",4,11,147,68,79
050,19,037,"Iowa","Chickasaw County",4,12,152,74,78
050,19,037,"Iowa","Chickasaw County",4,13,152,77,75
050,19,037,"Iowa","Chickasaw County",4,14,170,90,80
050,19,037,"Iowa","Chickasaw County",4,15,177,93,84
050,19,037,"Iowa","Chickasaw County",4,16,181,88,93
050,19,037,"Iowa","Chickasaw County",4,17,168,84,84
050,19,037,"Iowa","Chickasaw County",4,18,138,75,63
050,19,037,"Iowa","Chickasaw County",4,19,97,52,45
050,19,037,"Iowa","Chickasaw County",4,20,105,52,53
050,19,037,"Iowa","Chickasaw County",4,21,125,63,62
050,19,037,"Iowa","Chickasaw County",4,22,113,52,61
050,19,037,"Iowa","Chickasaw County",4,23,113,63,50
050,19,037,"Iowa","Chickasaw County",4,24,113,69,44
050,19,037,"Iowa","Chickasaw County",4,25,108,59,49
050,19,037,"Iowa","Chickasaw County",4,26,117,72,45
050,19,037,"Iowa","Chickasaw County",4,27,132,76,56
050,19,037,"Iowa","Chickasaw County",4,28,139,72,67
050,19,037,"Iowa","Chickasaw County",4,29,130,70,60
050,19,037,"Iowa","Chickasaw County",4,30,136,72,64
050,19,037,"Iowa","Chickasaw County",4,31,127,68,59
050,19,037,"Iowa","Chickasaw County",4,32,127,61,66
050,19,037,"Iowa","Chickasaw County",4,33,115,52,63
050,19,037,"Iowa","Chickasaw County",4,34,118,58,60
050,19,037,"Iowa","Chickasaw County",4,35,113,51,62
050,19,037,"Iowa","Chickasaw County",4,36,114,64,50
050,19,037,"Iowa","Chickasaw County",4,37,113,59,54
050,19,037,"Iowa","Chickasaw County",4,38,128,70,58
050,19,037,"Iowa","Chickasaw County",4,39,133,70,63
050,19,037,"Iowa","Chickasaw County",4,40,150,79,71
050,19,037,"Iowa","Chickasaw County",4,41,147,79,68
050,19,037,"Iowa","Chickasaw County",4,42,136,69,67
050,19,037,"Iowa","Chickasaw County",4,43,129,65,64
050,19,037,"Iowa","Chickasaw County",4,44,135,69,66
050,19,037,"Iowa","Chickasaw County",4,45,131,66,65
050,19,037,"Iowa","Chickasaw County",4,46,107,58,49
050,19,037,"Iowa","Chickasaw County",4,47,108,58,50
050,19,037,"Iowa","Chickasaw County",4,48,117,62,55
050,19,037,"Iowa","Chickasaw County",4,49,113,60,53
050,19,037,"Iowa","Chickasaw County",4,50,127,67,60
050,19,037,"Iowa","Chickasaw County",4,51,138,74,64
050,19,037,"Iowa","Chickasaw County",4,52,136,74,62
050,19,037,"Iowa","Chickasaw County",4,53,137,75,62
050,19,037,"Iowa","Chickasaw County",4,54,133,67,66
050,19,037,"Iowa","Chickasaw County",4,55,149,79,70
050,19,037,"Iowa","Chickasaw County",4,56,154,80,74
050,19,037,"Iowa","Chickasaw County",4,57,165,82,83
050,19,037,"Iowa","Chickasaw County",4,58,168,87,81
050,19,037,"Iowa","Chickasaw County",4,59,161,90,71
050,19,037,"Iowa","Chickasaw County",4,60,175,100,75
050,19,037,"Iowa","Chickasaw County",4,61,182,99,83
050,19,037,"Iowa","Chickasaw County",4,62,196,93,103
050,19,037,"Iowa","Chickasaw County",4,63,193,92,101
050,19,037,"Iowa","Chickasaw County",4,64,200,103,97
050,19,037,"Iowa","Chickasaw County",4,65,199,110,89
050,19,037,"Iowa","Chickasaw County",4,66,170,98,72
050,19,037,"Iowa","Chickasaw County",4,67,162,91,71
050,19,037,"Iowa","Chickasaw County",4,68,166,82,84
050,19,037,"Iowa","Chickasaw County",4,69,153,80,73
050,19,037,"Iowa","Chickasaw County",4,70,152,71,81
050,19,037,"Iowa","Chickasaw County",4,71,132,67,65
050,19,037,"Iowa","Chickasaw County",4,72,120,60,60
050,19,037,"Iowa","Chickasaw County",4,73,124,64,60
050,19,037,"Iowa","Chickasaw County",4,74,125,62,63
050,19,037,"Iowa","Chickasaw County",4,75,119,58,61
050,19,037,"Iowa","Chickasaw County",4,76,82,40,42
050,19,037,"Iowa","Chickasaw County",4,77,93,41,52
050,19,037,"Iowa","Chickasaw County",4,78,90,34,56
050,19,037,"Iowa","Chickasaw County",4,79,80,33,47
050,19,037,"Iowa","Chickasaw County",4,80,80,37,43
050,19,037,"Iowa","Chickasaw County",4,81,65,33,32
050,19,037,"Iowa","Chickasaw County",4,82,59,27,32
050,19,037,"Iowa","Chickasaw County",4,83,52,21,31
050,19,037,"Iowa","Chickasaw County",4,84,59,18,41
050,19,037,"Iowa","Chickasaw County",4,85,394,131,263
050,19,037,"Iowa","Chickasaw County",5,0,132,63,69
050,19,037,"Iowa","Chickasaw County",5,1,128,60,68
050,19,037,"Iowa","Chickasaw County",5,2,123,62,61
050,19,037,"Iowa","Chickasaw County",5,3,139,77,62
050,19,037,"Iowa","Chickasaw County",5,4,132,67,65
050,19,037,"Iowa","Chickasaw County",5,5,149,67,82
050,19,037,"Iowa","Chickasaw County",5,6,147,68,79
050,19,037,"Iowa","Chickasaw County",5,7,139,76,63
050,19,037,"Iowa","Chickasaw County",5,8,139,78,61
050,19,037,"Iowa","Chickasaw County",5,9,158,87,71
050,19,037,"Iowa","Chickasaw County",5,10,146,71,75
050,19,037,"Iowa","Chickasaw County",5,11,164,73,91
050,19,037,"Iowa","Chickasaw County",5,12,143,65,78
050,19,037,"Iowa","Chickasaw County",5,13,158,80,78
050,19,037,"Iowa","Chickasaw County",5,14,153,79,74
050,19,037,"Iowa","Chickasaw County",5,15,175,92,83
050,19,037,"Iowa","Chickasaw County",5,16,180,97,83
050,19,037,"Iowa","Chickasaw County",5,17,175,87,88
050,19,037,"Iowa","Chickasaw County",5,18,146,73,73
050,19,037,"Iowa","Chickasaw County",5,19,104,59,45
050,19,037,"Iowa","Chickasaw County",5,20,103,53,50
050,19,037,"Iowa","Chickasaw County",5,21,114,55,59
050,19,037,"Iowa","Chickasaw County",5,22,130,62,68
050,19,037,"Iowa","Chickasaw County",5,23,106,51,55
050,19,037,"Iowa","Chickasaw County",5,24,100,58,42
050,19,037,"Iowa","Chickasaw County",5,25,113,69,44
050,19,037,"Iowa","Chickasaw County",5,26,116,62,54
050,19,037,"Iowa","Chickasaw County",5,27,120,74,46
050,19,037,"Iowa","Chickasaw County",5,28,126,72,54
050,19,037,"Iowa","Chickasaw County",5,29,127,68,59
050,19,037,"Iowa","Chickasaw County",5,30,124,67,57
050,19,037,"Iowa","Chickasaw County",5,31,146,78,68
050,19,037,"Iowa","Chickasaw County",5,32,126,73,53
050,19,037,"Iowa","Chickasaw County",5,33,120,58,62
050,19,037,"Iowa","Chickasaw County",5,34,121,60,61
050,19,037,"Iowa","Chickasaw County",5,35,115,59,56
050,19,037,"Iowa","Chickasaw County",5,36,119,56,63
050,19,037,"Iowa","Chickasaw County",5,37,113,64,49
050,19,037,"Iowa","Chickasaw County",5,38,113,63,50
050,19,037,"Iowa","Chickasaw County",5,39,128,70,58
050,19,037,"Iowa","Chickasaw County",5,40,137,75,62
050,19,037,"Iowa","Chickasaw County",5,41,148,79,69
050,19,037,"Iowa","Chickasaw County",5,42,148,79,69
050,19,037,"Iowa","Chickasaw County",5,43,142,75,67
050,19,037,"Iowa","Chickasaw County",5,44,123,63,60
050,19,037,"Iowa","Chickasaw County",5,45,134,70,64
050,19,037,"Iowa","Chickasaw County",5,46,132,66,66
050,19,037,"Iowa","Chickasaw County",5,47,110,59,51
050,19,037,"Iowa","Chickasaw County",5,48,112,61,51
050,19,037,"Iowa","Chickasaw County",5,49,110,59,51
050,19,037,"Iowa","Chickasaw County",5,50,112,61,51
050,19,037,"Iowa","Chickasaw County",5,51,128,70,58
050,19,037,"Iowa","Chickasaw County",5,52,138,74,64
050,19,037,"Iowa","Chickasaw County",5,53,130,70,60
050,19,037,"Iowa","Chickasaw County",5,54,138,76,62
050,19,037,"Iowa","Chickasaw County",5,55,140,73,67
050,19,037,"Iowa","Chickasaw County",5,56,145,80,65
050,19,037,"Iowa","Chickasaw County",5,57,153,78,75
050,19,037,"Iowa","Chickasaw County",5,58,163,83,80
050,19,037,"Iowa","Chickasaw County",5,59,172,84,88
050,19,037,"Iowa","Chickasaw County",5,60,169,97,72
050,19,037,"Iowa","Chickasaw County",5,61,173,97,76
050,19,037,"Iowa","Chickasaw County",5,62,179,98,81
050,19,037,"Iowa","Chickasaw County",5,63,193,92,101
050,19,037,"Iowa","Chickasaw County",5,64,190,88,102
050,19,037,"Iowa","Chickasaw County",5,65,195,100,95
050,19,037,"Iowa","Chickasaw County",5,66,196,107,89
050,19,037,"Iowa","Chickasaw County",5,67,166,95,71
050,19,037,"Iowa","Chickasaw County",5,68,159,89,70
050,19,037,"Iowa","Chickasaw County",5,69,163,80,83
050,19,037,"Iowa","Chickasaw County",5,70,153,78,75
050,19,037,"Iowa","Chickasaw County",5,71,138,68,70
050,19,037,"Iowa","Chickasaw County",5,72,127,65,62
050,19,037,"Iowa","Chickasaw County",5,73,115,56,59
050,19,037,"Iowa","Chickasaw County",5,74,119,63,56
050,19,037,"Iowa","Chickasaw County",5,75,122,62,60
050,19,037,"Iowa","Chickasaw County",5,76,115,56,59
050,19,037,"Iowa","Chickasaw County",5,77,79,38,41
050,19,037,"Iowa","Chickasaw County",5,78,96,39,57
050,19,037,"Iowa","Chickasaw County",5,79,77,31,46
050,19,037,"Iowa","Chickasaw County",5,80,84,36,48
050,19,037,"Iowa","Chickasaw County",5,81,68,31,37
050,19,037,"Iowa","Chickasaw County",5,82,62,31,31
050,19,037,"Iowa","Chickasaw County",5,83,50,24,26
050,19,037,"Iowa","Chickasaw County",5,84,52,16,36
050,19,037,"Iowa","Chickasaw County",5,85,393,123,270
050,19,039,"Iowa","Clarke County",1,0,125,63,62
050,19,039,"Iowa","Clarke County",1,1,122,57,65
050,19,039,"Iowa","Clarke County",1,2,118,53,65
050,19,039,"Iowa","Clarke County",1,3,116,57,59
050,19,039,"Iowa","Clarke County",1,4,139,68,71
050,19,039,"Iowa","Clarke County",1,5,140,74,66
050,19,039,"Iowa","Clarke County",1,6,131,73,58
050,19,039,"Iowa","Clarke County",1,7,133,68,65
050,19,039,"Iowa","Clarke County",1,8,123,68,55
050,19,039,"Iowa","Clarke County",1,9,132,77,55
050,19,039,"Iowa","Clarke County",1,10,148,83,65
050,19,039,"Iowa","Clarke County",1,11,166,92,74
050,19,039,"Iowa","Clarke County",1,12,170,93,77
050,19,039,"Iowa","Clarke County",1,13,162,92,70
050,19,039,"Iowa","Clarke County",1,14,165,93,72
050,19,039,"Iowa","Clarke County",1,15,158,90,68
050,19,039,"Iowa","Clarke County",1,16,145,81,64
050,19,039,"Iowa","Clarke County",1,17,140,78,62
050,19,039,"Iowa","Clarke County",1,18,120,62,58
050,19,039,"Iowa","Clarke County",1,19,101,48,53
050,19,039,"Iowa","Clarke County",1,20,106,59,47
050,19,039,"Iowa","Clarke County",1,21,111,53,58
050,19,039,"Iowa","Clarke County",1,22,99,51,48
050,19,039,"Iowa","Clarke County",1,23,99,51,48
050,19,039,"Iowa","Clarke County",1,24,81,46,35
050,19,039,"Iowa","Clarke County",1,25,97,51,46
050,19,039,"Iowa","Clarke County",1,26,99,53,46
050,19,039,"Iowa","Clarke County",1,27,108,59,49
050,19,039,"Iowa","Clarke County",1,28,90,48,42
050,19,039,"Iowa","Clarke County",1,29,101,51,50
050,19,039,"Iowa","Clarke County",1,30,104,59,45
050,19,039,"Iowa","Clarke County",1,31,108,62,46
050,19,039,"Iowa","Clarke County",1,32,112,56,56
050,19,039,"Iowa","Clarke County",1,33,111,59,52
050,19,039,"Iowa","Clarke County",1,34,108,62,46
050,19,039,"Iowa","Clarke County",1,35,116,64,52
050,19,039,"Iowa","Clarke County",1,36,108,56,52
050,19,039,"Iowa","Clarke County",1,37,112,59,53
050,19,039,"Iowa","Clarke County",1,38,117,67,50
050,19,039,"Iowa","Clarke County",1,39,118,63,55
050,19,039,"Iowa","Clarke County",1,40,110,55,55
050,19,039,"Iowa","Clarke County",1,41,101,53,48
050,19,039,"Iowa","Clarke County",1,42,112,61,51
050,19,039,"Iowa","Clarke County",1,43,117,60,57
050,19,039,"Iowa","Clarke County",1,44,123,54,69
050,19,039,"Iowa","Clarke County",1,45,112,47,65
050,19,039,"Iowa","Clarke County",1,46,116,57,59
050,19,039,"Iowa","Clarke County",1,47,106,51,55
050,19,039,"Iowa","Clarke County",1,48,110,47,63
050,19,039,"Iowa","Clarke County",1,49,116,56,60
050,19,039,"Iowa","Clarke County",1,50,118,66,52
050,19,039,"Iowa","Clarke County",1,51,122,67,55
050,19,039,"Iowa","Clarke County",1,52,117,65,52
050,19,039,"Iowa","Clarke County",1,53,121,66,55
050,19,039,"Iowa","Clarke County",1,54,129,72,57
050,19,039,"Iowa","Clarke County",1,55,116,60,56
050,19,039,"Iowa","Clarke County",1,56,127,66,61
050,19,039,"Iowa","Clarke County",1,57,134,62,72
050,19,039,"Iowa","Clarke County",1,58,141,65,76
050,19,039,"Iowa","Clarke County",1,59,137,74,63
050,19,039,"Iowa","Clarke County",1,60,142,78,64
050,19,039,"Iowa","Clarke County",1,61,142,74,68
050,19,039,"Iowa","Clarke County",1,62,126,68,58
050,19,039,"Iowa","Clarke County",1,63,132,72,60
050,19,039,"Iowa","Clarke County",1,64,132,70,62
050,19,039,"Iowa","Clarke County",1,65,136,71,65
050,19,039,"Iowa","Clarke County",1,66,140,69,71
050,19,039,"Iowa","Clarke County",1,67,114,54,60
050,19,039,"Iowa","Clarke County",1,68,104,55,49
050,19,039,"Iowa","Clarke County",1,69,118,60,58
050,19,039,"Iowa","Clarke County",1,70,109,54,55
050,19,039,"Iowa","Clarke County",1,71,103,52,51
050,19,039,"Iowa","Clarke County",1,72,92,50,42
050,19,039,"Iowa","Clarke County",1,73,98,48,50
050,19,039,"Iowa","Clarke County",1,74,58,26,32
050,19,039,"Iowa","Clarke County",1,75,59,24,35
050,19,039,"Iowa","Clarke County",1,76,72,34,38
050,19,039,"Iowa","Clarke County",1,77,56,27,29
050,19,039,"Iowa","Clarke County",1,78,54,21,33
050,19,039,"Iowa","Clarke County",1,79,50,19,31
050,19,039,"Iowa","Clarke County",1,80,47,22,25
050,19,039,"Iowa","Clarke County",1,81,47,16,31
050,19,039,"Iowa","Clarke County",1,82,46,19,27
050,19,039,"Iowa","Clarke County",1,83,41,20,21
050,19,039,"Iowa","Clarke County",1,84,43,17,26
050,19,039,"Iowa","Clarke County",1,85,249,84,165
050,19,039,"Iowa","Clarke County",2,0,123,65,58
050,19,039,"Iowa","Clarke County",2,1,121,58,63
050,19,039,"Iowa","Clarke County",2,2,118,53,65
050,19,039,"Iowa","Clarke County",2,3,116,55,61
050,19,039,"Iowa","Clarke County",2,4,132,65,67
050,19,039,"Iowa","Clarke County",2,5,140,72,68
050,19,039,"Iowa","Clarke County",2,6,133,73,60
050,19,039,"Iowa","Clarke County",2,7,130,67,63
050,19,039,"Iowa","Clarke County",2,8,122,67,55
050,19,039,"Iowa","Clarke County",2,9,129,76,53
050,19,039,"Iowa","Clarke County",2,10,145,82,63
050,19,039,"Iowa","Clarke County",2,11,159,88,71
050,19,039,"Iowa","Clarke County",2,12,170,93,77
050,19,039,"Iowa","Clarke County",2,13,164,93,71
050,19,039,"Iowa","Clarke County",2,14,163,92,71
050,19,039,"Iowa","Clarke County",2,15,159,89,70
050,19,039,"Iowa","Clarke County",2,16,149,84,65
050,19,039,"Iowa","Clarke County",2,17,143,79,64
050,19,039,"Iowa","Clarke County",2,18,119,63,56
050,19,039,"Iowa","Clarke County",2,19,101,49,52
050,19,039,"Iowa","Clarke County",2,20,107,57,50
050,19,039,"Iowa","Clarke County",2,21,112,56,56
050,19,039,"Iowa","Clarke County",2,22,102,51,51
050,19,039,"Iowa","Clarke County",2,23,99,52,47
050,19,039,"Iowa","Clarke County",2,24,83,46,37
050,19,039,"Iowa","Clarke County",2,25,94,51,43
050,19,039,"Iowa","Clarke County",2,26,100,54,46
050,19,039,"Iowa","Clarke County",2,27,103,55,48
050,19,039,"Iowa","Clarke County",2,28,95,50,45
050,19,039,"Iowa","Clarke County",2,29,97,49,48
050,19,039,"Iowa","Clarke County",2,30,103,58,45
050,19,039,"Iowa","Clarke County",2,31,107,60,47
050,19,039,"Iowa","Clarke County",2,32,111,57,54
050,19,039,"Iowa","Clarke County",2,33,109,58,51
050,19,039,"Iowa","Clarke County",2,34,107,61,46
050,19,039,"Iowa","Clarke County",2,35,113,63,50
050,19,039,"Iowa","Clarke County",2,36,107,55,52
050,19,039,"Iowa","Clarke County",2,37,113,59,54
050,19,039,"Iowa","Clarke County",2,38,117,66,51
050,19,039,"Iowa","Clarke County",2,39,117,63,54
050,19,039,"Iowa","Clarke County",2,40,112,57,55
050,19,039,"Iowa","Clarke County",2,41,103,53,50
050,19,039,"Iowa","Clarke County",2,42,109,59,50
050,19,039,"Iowa","Clarke County",2,43,115,59,56
050,19,039,"Iowa","Clarke County",2,44,121,55,66
050,19,039,"Iowa","Clarke County",2,45,114,48,66
050,19,039,"Iowa","Clarke County",2,46,113,54,59
050,19,039,"Iowa","Clarke County",2,47,111,53,58
050,19,039,"Iowa","Clarke County",2,48,107,47,60
050,19,039,"Iowa","Clarke County",2,49,117,57,60
050,19,039,"Iowa","Clarke County",2,50,120,65,55
050,19,039,"Iowa","Clarke County",2,51,122,66,56
050,19,039,"Iowa","Clarke County",2,52,120,67,53
050,19,039,"Iowa","Clarke County",2,53,120,65,55
050,19,039,"Iowa","Clarke County",2,54,127,71,56
050,19,039,"Iowa","Clarke County",2,55,120,63,57
050,19,039,"Iowa","Clarke County",2,56,129,67,62
050,19,039,"Iowa","Clarke County",2,57,132,62,70
050,19,039,"Iowa","Clarke County",2,58,138,64,74
050,19,039,"Iowa","Clarke County",2,59,138,72,66
050,19,039,"Iowa","Clarke County",2,60,141,77,64
050,19,039,"Iowa","Clarke County",2,61,141,75,66
050,19,039,"Iowa","Clarke County",2,62,127,68,59
050,19,039,"Iowa","Clarke County",2,63,132,72,60
050,19,039,"Iowa","Clarke County",2,64,130,70,60
050,19,039,"Iowa","Clarke County",2,65,134,70,64
050,19,039,"Iowa","Clarke County",2,66,140,70,70
050,19,039,"Iowa","Clarke County",2,67,119,57,62
050,19,039,"Iowa","Clarke County",2,68,106,54,52
050,19,039,"Iowa","Clarke County",2,69,116,60,56
050,19,039,"Iowa","Clarke County",2,70,108,54,54
050,19,039,"Iowa","Clarke County",2,71,103,51,52
050,19,039,"Iowa","Clarke County",2,72,92,49,43
050,19,039,"Iowa","Clarke County",2,73,104,52,52
050,19,039,"Iowa","Clarke County",2,74,61,28,33
050,19,039,"Iowa","Clarke County",2,75,59,25,34
050,19,039,"Iowa","Clarke County",2,76,68,31,37
050,19,039,"Iowa","Clarke County",2,77,59,28,31
050,19,039,"Iowa","Clarke County",2,78,54,22,32
050,19,039,"Iowa","Clarke County",2,79,50,20,30
050,19,039,"Iowa","Clarke County",2,80,47,21,26
050,19,039,"Iowa","Clarke County",2,81,45,16,29
050,19,039,"Iowa","Clarke County",2,82,47,19,28
050,19,039,"Iowa","Clarke County",2,83,41,18,23
050,19,039,"Iowa","Clarke County",2,84,44,18,26
050,19,039,"Iowa","Clarke County",2,85,249,84,165
050,19,039,"Iowa","Clarke County",3,0,120,56,64
050,19,039,"Iowa","Clarke County",3,1,127,67,60
050,19,039,"Iowa","Clarke County",3,2,135,67,68
050,19,039,"Iowa","Clarke County",3,3,122,56,66
050,19,039,"Iowa","Clarke County",3,4,129,62,67
050,19,039,"Iowa","Clarke County",3,5,129,60,69
050,19,039,"Iowa","Clarke County",3,6,138,74,64
050,19,039,"Iowa","Clarke County",3,7,134,74,60
050,19,039,"Iowa","Clarke County",3,8,128,59,69
050,19,039,"Iowa","Clarke County",3,9,129,76,53
050,19,039,"Iowa","Clarke County",3,10,128,78,50
050,19,039,"Iowa","Clarke County",3,11,139,74,65
050,19,039,"Iowa","Clarke County",3,12,170,90,80
050,19,039,"Iowa","Clarke County",3,13,169,93,76
050,19,039,"Iowa","Clarke County",3,14,170,94,76
050,19,039,"Iowa","Clarke County",3,15,169,98,71
050,19,039,"Iowa","Clarke County",3,16,157,85,72
050,19,039,"Iowa","Clarke County",3,17,149,83,66
050,19,039,"Iowa","Clarke County",3,18,124,71,53
050,19,039,"Iowa","Clarke County",3,19,91,45,46
050,19,039,"Iowa","Clarke County",3,20,105,51,54
050,19,039,"Iowa","Clarke County",3,21,103,52,51
050,19,039,"Iowa","Clarke County",3,22,116,52,64
050,19,039,"Iowa","Clarke County",3,23,114,58,56
050,19,039,"Iowa","Clarke County",3,24,95,51,44
050,19,039,"Iowa","Clarke County",3,25,84,47,37
050,19,039,"Iowa","Clarke County",3,26,94,54,40
050,19,039,"Iowa","Clarke County",3,27,106,51,55
050,19,039,"Iowa","Clarke County",3,28,109,60,49
050,19,039,"Iowa","Clarke County",3,29,101,50,51
050,19,039,"Iowa","Clarke County",3,30,91,47,44
050,19,039,"Iowa","Clarke County",3,31,113,62,51
050,19,039,"Iowa","Clarke County",3,32,108,62,46
050,19,039,"Iowa","Clarke County",3,33,109,59,50
050,19,039,"Iowa","Clarke County",3,34,116,61,55
050,19,039,"Iowa","Clarke County",3,35,107,62,45
050,19,039,"Iowa","Clarke County",3,36,114,62,52
050,19,039,"Iowa","Clarke County",3,37,101,54,47
050,19,039,"Iowa","Clarke County",3,38,113,61,52
050,19,039,"Iowa","Clarke County",3,39,120,66,54
050,19,039,"Iowa","Clarke County",3,40,122,62,60
050,19,039,"Iowa","Clarke County",3,41,108,53,55
050,19,039,"Iowa","Clarke County",3,42,106,57,49
050,19,039,"Iowa","Clarke County",3,43,113,60,53
050,19,039,"Iowa","Clarke County",3,44,119,62,57
050,19,039,"Iowa","Clarke County",3,45,124,52,72
050,19,039,"Iowa","Clarke County",3,46,123,54,69
050,19,039,"Iowa","Clarke County",3,47,107,54,53
050,19,039,"Iowa","Clarke County",3,48,108,50,58
050,19,039,"Iowa","Clarke County",3,49,105,43,62
050,19,039,"Iowa","Clarke County",3,50,116,58,58
050,19,039,"Iowa","Clarke County",3,51,116,64,52
050,19,039,"Iowa","Clarke County",3,52,120,64,56
050,19,039,"Iowa","Clarke County",3,53,117,63,54
050,19,039,"Iowa","Clarke County",3,54,117,68,49
050,19,039,"Iowa","Clarke County",3,55,132,77,55
050,19,039,"Iowa","Clarke County",3,56,134,76,58
050,19,039,"Iowa","Clarke County",3,57,123,62,61
050,19,039,"Iowa","Clarke County",3,58,128,59,69
050,19,039,"Iowa","Clarke County",3,59,134,63,71
050,19,039,"Iowa","Clarke County",3,60,131,67,64
050,19,039,"Iowa","Clarke County",3,61,143,77,66
050,19,039,"Iowa","Clarke County",3,62,137,71,66
050,19,039,"Iowa","Clarke County",3,63,128,71,57
050,19,039,"Iowa","Clarke County",3,64,120,66,54
050,19,039,"Iowa","Clarke County",3,65,119,62,57
050,19,039,"Iowa","Clarke County",3,66,131,66,65
050,19,039,"Iowa","Clarke County",3,67,139,71,68
050,19,039,"Iowa","Clarke County",3,68,110,50,60
050,19,039,"Iowa","Clarke County",3,69,104,53,51
050,19,039,"Iowa","Clarke County",3,70,107,57,50
050,19,039,"Iowa","Clarke County",3,71,107,54,53
050,19,039,"Iowa","Clarke County",3,72,99,49,50
050,19,039,"Iowa","Clarke County",3,73,95,50,45
050,19,039,"Iowa","Clarke County",3,74,90,45,45
050,19,039,"Iowa","Clarke County",3,75,64,29,35
050,19,039,"Iowa","Clarke County",3,76,58,24,34
050,19,039,"Iowa","Clarke County",3,77,59,27,32
050,19,039,"Iowa","Clarke County",3,78,53,23,30
050,19,039,"Iowa","Clarke County",3,79,48,20,28
050,19,039,"Iowa","Clarke County",3,80,48,18,30
050,19,039,"Iowa","Clarke County",3,81,46,21,25
050,19,039,"Iowa","Clarke County",3,82,39,17,22
050,19,039,"Iowa","Clarke County",3,83,44,15,29
050,19,039,"Iowa","Clarke County",3,84,40,15,25
050,19,039,"Iowa","Clarke County",3,85,249,90,159
050,19,039,"Iowa","Clarke County",4,0,125,60,65
050,19,039,"Iowa","Clarke County",4,1,123,53,70
050,19,039,"Iowa","Clarke County",4,2,115,57,58
050,19,039,"Iowa","Clarke County",4,3,138,74,64
050,19,039,"Iowa","Clarke County",4,4,123,52,71
050,19,039,"Iowa","Clarke County",4,5,131,59,72
050,19,039,"Iowa","Clarke County",4,6,125,59,66
050,19,039,"Iowa","Clarke County",4,7,138,72,66
050,19,039,"Iowa","Clarke County",4,8,127,69,58
050,19,039,"Iowa","Clarke County",4,9,128,65,63
050,19,039,"Iowa","Clarke County",4,10,123,67,56
050,19,039,"Iowa","Clarke County",4,11,136,83,53
050,19,039,"Iowa","Clarke County",4,12,142,77,65
050,19,039,"Iowa","Clarke County",4,13,163,89,74
050,19,039,"Iowa","Clarke County",4,14,174,94,80
050,19,039,"Iowa","Clarke County",4,15,171,89,82
050,19,039,"Iowa","Clarke County",4,16,167,95,72
050,19,039,"Iowa","Clarke County",4,17,159,87,72
050,19,039,"Iowa","Clarke County",4,18,122,69,53
050,19,039,"Iowa","Clarke County",4,19,99,58,41
050,19,039,"Iowa","Clarke County",4,20,95,46,49
050,19,039,"Iowa","Clarke County",4,21,114,53,61
050,19,039,"Iowa","Clarke County",4,22,95,50,45
050,19,039,"Iowa","Clarke County",4,23,122,52,70
050,19,039,"Iowa","Clarke County",4,24,104,53,51
050,19,039,"Iowa","Clarke County",4,25,101,59,42
050,19,039,"Iowa","Clarke County",4,26,79,48,31
050,19,039,"Iowa","Clarke County",4,27,98,57,41
050,19,039,"Iowa","Clarke County",4,28,99,50,49
050,19,039,"Iowa","Clarke County",4,29,106,61,45
050,19,039,"Iowa","Clarke County",4,30,98,50,48
050,19,039,"Iowa","Clarke County",4,31,101,50,51
050,19,039,"Iowa","Clarke County",4,32,119,67,52
050,19,039,"Iowa","Clarke County",4,33,106,64,42
050,19,039,"Iowa","Clarke County",4,34,108,65,43
050,19,039,"Iowa","Clarke County",4,35,114,56,58
050,19,039,"Iowa","Clarke County",4,36,97,53,44
050,19,039,"Iowa","Clarke County",4,37,109,58,51
050,19,039,"Iowa","Clarke County",4,38,107,61,46
050,19,039,"Iowa","Clarke County",4,39,116,60,56
050,19,039,"Iowa","Clarke County",4,40,121,67,54
050,19,039,"Iowa","Clarke County",4,41,119,60,59
050,19,039,"Iowa","Clarke County",4,42,107,54,53
050,19,039,"Iowa","Clarke County",4,43,106,56,50
050,19,039,"Iowa","Clarke County",4,44,112,58,54
050,19,039,"Iowa","Clarke County",4,45,122,65,57
050,19,039,"Iowa","Clarke County",4,46,125,54,71
050,19,039,"Iowa","Clarke County",4,47,122,55,67
050,19,039,"Iowa","Clarke County",4,48,108,56,52
050,19,039,"Iowa","Clarke County",4,49,103,50,53
050,19,039,"Iowa","Clarke County",4,50,100,40,60
050,19,039,"Iowa","Clarke County",4,51,114,59,55
050,19,039,"Iowa","Clarke County",4,52,117,66,51
050,19,039,"Iowa","Clarke County",4,53,119,63,56
050,19,039,"Iowa","Clarke County",4,54,122,68,54
050,19,039,"Iowa","Clarke County",4,55,105,60,45
050,19,039,"Iowa","Clarke County",4,56,122,72,50
050,19,039,"Iowa","Clarke County",4,57,128,72,56
050,19,039,"Iowa","Clarke County",4,58,115,58,57
050,19,039,"Iowa","Clarke County",4,59,130,61,69
050,19,039,"Iowa","Clarke County",4,60,133,63,70
050,19,039,"Iowa","Clarke County",4,61,132,67,65
050,19,039,"Iowa","Clarke County",4,62,137,73,64
050,19,039,"Iowa","Clarke County",4,63,134,71,63
050,19,039,"Iowa","Clarke County",4,64,122,68,54
050,19,039,"Iowa","Clarke County",4,65,117,62,55
050,19,039,"Iowa","Clarke County",4,66,115,61,54
050,19,039,"Iowa","Clarke County",4,67,132,68,64
050,19,039,"Iowa","Clarke County",4,68,130,63,67
050,19,039,"Iowa","Clarke County",4,69,104,49,55
050,19,039,"Iowa","Clarke County",4,70,102,53,49
050,19,039,"Iowa","Clarke County",4,71,113,59,54
050,19,039,"Iowa","Clarke County",4,72,100,51,49
050,19,039,"Iowa","Clarke County",4,73,103,50,53
050,19,039,"Iowa","Clarke County",4,74,83,42,41
050,19,039,"Iowa","Clarke County",4,75,87,44,43
050,19,039,"Iowa","Clarke County",4,76,64,29,35
050,19,039,"Iowa","Clarke County",4,77,54,24,30
050,19,039,"Iowa","Clarke County",4,78,54,27,27
050,19,039,"Iowa","Clarke County",4,79,49,23,26
050,19,039,"Iowa","Clarke County",4,80,44,17,27
050,19,039,"Iowa","Clarke County",4,81,46,17,29
050,19,039,"Iowa","Clarke County",4,82,40,19,21
050,19,039,"Iowa","Clarke County",4,83,37,12,25
050,19,039,"Iowa","Clarke County",4,84,45,13,32
050,19,039,"Iowa","Clarke County",4,85,232,88,144
050,19,039,"Iowa","Clarke County",5,0,126,60,66
050,19,039,"Iowa","Clarke County",5,1,124,63,61
050,19,039,"Iowa","Clarke County",5,2,122,52,70
050,19,039,"Iowa","Clarke County",5,3,120,56,64
050,19,039,"Iowa","Clarke County",5,4,142,73,69
050,19,039,"Iowa","Clarke County",5,5,125,53,72
050,19,039,"Iowa","Clarke County",5,6,130,61,69
050,19,039,"Iowa","Clarke County",5,7,132,61,71
050,19,039,"Iowa","Clarke County",5,8,138,69,69
050,19,039,"Iowa","Clarke County",5,9,124,64,60
050,19,039,"Iowa","Clarke County",5,10,125,63,62
050,19,039,"Iowa","Clarke County",5,11,130,74,56
050,19,039,"Iowa","Clarke County",5,12,136,84,52
050,19,039,"Iowa","Clarke County",5,13,136,72,64
050,19,039,"Iowa","Clarke County",5,14,171,87,84
050,19,039,"Iowa","Clarke County",5,15,161,86,75
050,19,039,"Iowa","Clarke County",5,16,163,86,77
050,19,039,"Iowa","Clarke County",5,17,163,89,74
050,19,039,"Iowa","Clarke County",5,18,133,73,60
050,19,039,"Iowa","Clarke County",5,19,98,56,42
050,19,039,"Iowa","Clarke County",5,20,107,64,43
050,19,039,"Iowa","Clarke County",5,21,98,45,53
050,19,039,"Iowa","Clarke County",5,22,110,50,60
050,19,039,"Iowa","Clarke County",5,23,107,62,45
050,19,039,"Iowa","Clarke County",5,24,118,50,68
050,19,039,"Iowa","Clarke County",5,25,92,48,44
050,19,039,"Iowa","Clarke County",5,26,101,59,42
050,19,039,"Iowa","Clarke County",5,27,82,47,35
050,19,039,"Iowa","Clarke County",5,28,105,60,45
050,19,039,"Iowa","Clarke County",5,29,100,54,46
050,19,039,"Iowa","Clarke County",5,30,101,57,44
050,19,039,"Iowa","Clarke County",5,31,106,54,52
050,19,039,"Iowa","Clarke County",5,32,102,52,50
050,19,039,"Iowa","Clarke County",5,33,123,71,52
050,19,039,"Iowa","Clarke County",5,34,106,65,41
050,19,039,"Iowa","Clarke County",5,35,112,64,48
050,19,039,"Iowa","Clarke County",5,36,116,56,60
050,19,039,"Iowa","Clarke County",5,37,99,55,44
050,19,039,"Iowa","Clarke County",5,38,104,58,46
050,19,039,"Iowa","Clarke County",5,39,107,60,47
050,19,039,"Iowa","Clarke County",5,40,109,55,54
050,19,039,"Iowa","Clarke County",5,41,120,64,56
050,19,039,"Iowa","Clarke County",5,42,113,57,56
050,19,039,"Iowa","Clarke County",5,43,108,56,52
050,19,039,"Iowa","Clarke County",5,44,106,56,50
050,19,039,"Iowa","Clarke County",5,45,112,58,54
050,19,039,"Iowa","Clarke County",5,46,122,65,57
050,19,039,"Iowa","Clarke County",5,47,130,57,73
050,19,039,"Iowa","Clarke County",5,48,123,52,71
050,19,039,"Iowa","Clarke County",5,49,104,53,51
050,19,039,"Iowa","Clarke County",5,50,106,51,55
050,19,039,"Iowa","Clarke County",5,51,98,40,58
050,19,039,"Iowa","Clarke County",5,52,111,57,54
050,19,039,"Iowa","Clarke County",5,53,120,66,54
050,19,039,"Iowa","Clarke County",5,54,113,62,51
050,19,039,"Iowa","Clarke County",5,55,119,66,53
050,19,039,"Iowa","Clarke County",5,56,113,70,43
050,19,039,"Iowa","Clarke County",5,57,117,66,51
050,19,039,"Iowa","Clarke County",5,58,124,67,57
050,19,039,"Iowa","Clarke County",5,59,113,57,56
050,19,039,"Iowa","Clarke County",5,60,131,61,70
050,19,039,"Iowa","Clarke County",5,61,129,61,68
050,19,039,"Iowa","Clarke County",5,62,132,66,66
050,19,039,"Iowa","Clarke County",5,63,140,75,65
050,19,039,"Iowa","Clarke County",5,64,131,67,64
050,19,039,"Iowa","Clarke County",5,65,121,66,55
050,19,039,"Iowa","Clarke County",5,66,115,61,54
050,19,039,"Iowa","Clarke County",5,67,111,59,52
050,19,039,"Iowa","Clarke County",5,68,128,62,66
050,19,039,"Iowa","Clarke County",5,69,131,65,66
050,19,039,"Iowa","Clarke County",5,70,95,45,50
050,19,039,"Iowa","Clarke County",5,71,94,48,46
050,19,039,"Iowa","Clarke County",5,72,111,57,54
050,19,039,"Iowa","Clarke County",5,73,101,53,48
050,19,039,"Iowa","Clarke County",5,74,92,45,47
050,19,039,"Iowa","Clarke County",5,75,80,43,37
050,19,039,"Iowa","Clarke County",5,76,90,44,46
050,19,039,"Iowa","Clarke County",5,77,56,26,30
050,19,039,"Iowa","Clarke County",5,78,45,18,27
050,19,039,"Iowa","Clarke County",5,79,45,24,21
050,19,039,"Iowa","Clarke County",5,80,42,20,22
050,19,039,"Iowa","Clarke County",5,81,42,17,25
050,19,039,"Iowa","Clarke County",5,82,41,18,23
050,19,039,"Iowa","Clarke County",5,83,38,15,23
050,19,039,"Iowa","Clarke County",5,84,40,12,28
050,19,039,"Iowa","Clarke County",5,85,231,84,147
050,19,041,"Iowa","Clay County",1,0,190,98,92
050,19,041,"Iowa","Clay County",1,1,185,99,86
050,19,041,"Iowa","Clay County",1,2,200,98,102
050,19,041,"Iowa","Clay County",1,3,206,87,119
050,19,041,"Iowa","Clay County",1,4,195,96,99
050,19,041,"Iowa","Clay County",1,5,231,126,105
050,19,041,"Iowa","Clay County",1,6,214,120,94
050,19,041,"Iowa","Clay County",1,7,211,107,104
050,19,041,"Iowa","Clay County",1,8,205,92,113
050,19,041,"Iowa","Clay County",1,9,191,96,95
050,19,041,"Iowa","Clay County",1,10,194,93,101
050,19,041,"Iowa","Clay County",1,11,224,123,101
050,19,041,"Iowa","Clay County",1,12,233,123,110
050,19,041,"Iowa","Clay County",1,13,223,115,108
050,19,041,"Iowa","Clay County",1,14,214,110,104
050,19,041,"Iowa","Clay County",1,15,224,108,116
050,19,041,"Iowa","Clay County",1,16,214,101,113
050,19,041,"Iowa","Clay County",1,17,199,108,91
050,19,041,"Iowa","Clay County",1,18,180,92,88
050,19,041,"Iowa","Clay County",1,19,149,78,71
050,19,041,"Iowa","Clay County",1,20,163,79,84
050,19,041,"Iowa","Clay County",1,21,162,79,83
050,19,041,"Iowa","Clay County",1,22,169,83,86
050,19,041,"Iowa","Clay County",1,23,172,87,85
050,19,041,"Iowa","Clay County",1,24,172,95,77
050,19,041,"Iowa","Clay County",1,25,154,75,79
050,19,041,"Iowa","Clay County",1,26,165,81,84
050,19,041,"Iowa","Clay County",1,27,173,91,82
050,19,041,"Iowa","Clay County",1,28,189,101,88
050,19,041,"Iowa","Clay County",1,29,186,104,82
050,19,041,"Iowa","Clay County",1,30,193,110,83
050,19,041,"Iowa","Clay County",1,31,190,109,81
050,19,041,"Iowa","Clay County",1,32,196,97,99
050,19,041,"Iowa","Clay County",1,33,197,93,104
050,19,041,"Iowa","Clay County",1,34,188,89,99
050,19,041,"Iowa","Clay County",1,35,195,93,102
050,19,041,"Iowa","Clay County",1,36,189,93,96
050,19,041,"Iowa","Clay County",1,37,213,111,102
050,19,041,"Iowa","Clay County",1,38,220,111,109
050,19,041,"Iowa","Clay County",1,39,198,99,99
050,19,041,"Iowa","Clay County",1,40,203,105,98
050,19,041,"Iowa","Clay County",1,41,212,111,101
050,19,041,"Iowa","Clay County",1,42,182,89,93
050,19,041,"Iowa","Clay County",1,43,185,93,92
050,19,041,"Iowa","Clay County",1,44,180,88,92
050,19,041,"Iowa","Clay County",1,45,173,83,90
050,19,041,"Iowa","Clay County",1,46,173,88,85
050,19,041,"Iowa","Clay County",1,47,173,96,77
050,19,041,"Iowa","Clay County",1,48,177,88,89
050,19,041,"Iowa","Clay County",1,49,199,102,97
050,19,041,"Iowa","Clay County",1,50,183,98,85
050,19,041,"Iowa","Clay County",1,51,163,78,85
050,19,041,"Iowa","Clay County",1,52,174,91,83
050,19,041,"Iowa","Clay County",1,53,185,102,83
050,19,041,"Iowa","Clay County",1,54,192,99,93
050,19,041,"Iowa","Clay County",1,55,207,104,103
050,19,041,"Iowa","Clay County",1,56,207,105,102
050,19,041,"Iowa","Clay County",1,57,207,109,98
050,19,041,"Iowa","Clay County",1,58,233,108,125
050,19,041,"Iowa","Clay County",1,59,253,120,133
050,19,041,"Iowa","Clay County",1,60,254,121,133
050,19,041,"Iowa","Clay County",1,61,243,124,119
050,19,041,"Iowa","Clay County",1,62,253,125,128
050,19,041,"Iowa","Clay County",1,63,256,132,124
050,19,041,"Iowa","Clay County",1,64,260,133,127
050,19,041,"Iowa","Clay County",1,65,237,118,119
050,19,041,"Iowa","Clay County",1,66,235,116,119
050,19,041,"Iowa","Clay County",1,67,227,115,112
050,19,041,"Iowa","Clay County",1,68,213,111,102
050,19,041,"Iowa","Clay County",1,69,186,82,104
050,19,041,"Iowa","Clay County",1,70,171,79,92
050,19,041,"Iowa","Clay County",1,71,185,89,96
050,19,041,"Iowa","Clay County",1,72,170,77,93
050,19,041,"Iowa","Clay County",1,73,160,64,96
050,19,041,"Iowa","Clay County",1,74,125,64,61
050,19,041,"Iowa","Clay County",1,75,114,59,55
050,19,041,"Iowa","Clay County",1,76,125,52,73
050,19,041,"Iowa","Clay County",1,77,118,58,60
050,19,041,"Iowa","Clay County",1,78,110,45,65
050,19,041,"Iowa","Clay County",1,79,112,55,57
050,19,041,"Iowa","Clay County",1,80,115,57,58
050,19,041,"Iowa","Clay County",1,81,105,52,53
050,19,041,"Iowa","Clay County",1,82,86,45,41
050,19,041,"Iowa","Clay County",1,83,85,38,47
050,19,041,"Iowa","Clay County",1,84,76,36,40
050,19,041,"Iowa","Clay County",1,85,532,185,347
050,19,041,"Iowa","Clay County",2,0,184,93,91
050,19,041,"Iowa","Clay County",2,1,184,98,86
050,19,041,"Iowa","Clay County",2,2,197,97,100
050,19,041,"Iowa","Clay County",2,3,203,90,113
050,19,041,"Iowa","Clay County",2,4,200,97,103
050,19,041,"Iowa","Clay County",2,5,221,118,103
050,19,041,"Iowa","Clay County",2,6,220,122,98
050,19,041,"Iowa","Clay County",2,7,215,113,102
050,19,041,"Iowa","Clay County",2,8,207,97,110
050,19,041,"Iowa","Clay County",2,9,193,94,99
050,19,041,"Iowa","Clay County",2,10,192,93,99
050,19,041,"Iowa","Clay County",2,11,215,115,100
050,19,041,"Iowa","Clay County",2,12,233,124,109
050,19,041,"Iowa","Clay County",2,13,225,117,108
050,19,041,"Iowa","Clay County",2,14,217,111,106
050,19,041,"Iowa","Clay County",2,15,220,107,113
050,19,041,"Iowa","Clay County",2,16,215,103,112
050,19,041,"Iowa","Clay County",2,17,200,106,94
050,19,041,"Iowa","Clay County",2,18,178,94,84
050,19,041,"Iowa","Clay County",2,19,151,79,72
050,19,041,"Iowa","Clay County",2,20,165,81,84
050,19,041,"Iowa","Clay County",2,21,162,79,83
050,19,041,"Iowa","Clay County",2,22,168,82,86
050,19,041,"Iowa","Clay County",2,23,174,89,85
050,19,041,"Iowa","Clay County",2,24,171,92,79
050,19,041,"Iowa","Clay County",2,25,160,80,80
050,19,041,"Iowa","Clay County",2,26,160,80,80
050,19,041,"Iowa","Clay County",2,27,171,90,81
050,19,041,"Iowa","Clay County",2,28,185,99,86
050,19,041,"Iowa","Clay County",2,29,187,103,84
050,19,041,"Iowa","Clay County",2,30,194,109,85
050,19,041,"Iowa","Clay County",2,31,189,108,81
050,19,041,"Iowa","Clay County",2,32,192,99,93
050,19,041,"Iowa","Clay County",2,33,197,94,103
050,19,041,"Iowa","Clay County",2,34,190,90,100
050,19,041,"Iowa","Clay County",2,35,192,91,101
050,19,041,"Iowa","Clay County",2,36,189,94,95
050,19,041,"Iowa","Clay County",2,37,206,106,100
050,19,041,"Iowa","Clay County",2,38,219,111,108
050,19,041,"Iowa","Clay County",2,39,202,100,102
050,19,041,"Iowa","Clay County",2,40,205,105,100
050,19,041,"Iowa","Clay County",2,41,208,108,100
050,19,041,"Iowa","Clay County",2,42,186,94,92
050,19,041,"Iowa","Clay County",2,43,186,92,94
050,19,041,"Iowa","Clay County",2,44,179,89,90
050,19,041,"Iowa","Clay County",2,45,176,86,90
050,19,041,"Iowa","Clay County",2,46,172,86,86
050,19,041,"Iowa","Clay County",2,47,173,95,78
050,19,041,"Iowa","Clay County",2,48,178,90,88
050,19,041,"Iowa","Clay County",2,49,195,100,95
050,19,041,"Iowa","Clay County",2,50,186,98,88
050,19,041,"Iowa","Clay County",2,51,167,82,85
050,19,041,"Iowa","Clay County",2,52,171,89,82
050,19,041,"Iowa","Clay County",2,53,181,99,82
050,19,041,"Iowa","Clay County",2,54,190,101,89
050,19,041,"Iowa","Clay County",2,55,205,104,101
050,19,041,"Iowa","Clay County",2,56,208,106,102
050,19,041,"Iowa","Clay County",2,57,206,107,99
050,19,041,"Iowa","Clay County",2,58,226,107,119
050,19,041,"Iowa","Clay County",2,59,246,117,129
050,19,041,"Iowa","Clay County",2,60,248,119,129
050,19,041,"Iowa","Clay County",2,61,245,123,122
050,19,041,"Iowa","Clay County",2,62,248,123,125
050,19,041,"Iowa","Clay County",2,63,255,131,124
050,19,041,"Iowa","Clay County",2,64,258,132,126
050,19,041,"Iowa","Clay County",2,65,241,121,120
050,19,041,"Iowa","Clay County",2,66,236,117,119
050,19,041,"Iowa","Clay County",2,67,226,114,112
050,19,041,"Iowa","Clay County",2,68,213,110,103
050,19,041,"Iowa","Clay County",2,69,193,89,104
050,19,041,"Iowa","Clay County",2,70,176,80,96
050,19,041,"Iowa","Clay County",2,71,181,86,95
050,19,041,"Iowa","Clay County",2,72,169,77,92
050,19,041,"Iowa","Clay County",2,73,173,72,101
050,19,041,"Iowa","Clay County",2,74,124,60,64
050,19,041,"Iowa","Clay County",2,75,115,60,55
050,19,041,"Iowa","Clay County",2,76,118,53,65
050,19,041,"Iowa","Clay County",2,77,121,58,63
050,19,041,"Iowa","Clay County",2,78,106,44,62
050,19,041,"Iowa","Clay County",2,79,111,52,59
050,19,041,"Iowa","Clay County",2,80,113,57,56
050,19,041,"Iowa","Clay County",2,81,106,53,53
050,19,041,"Iowa","Clay County",2,82,88,46,42
050,19,041,"Iowa","Clay County",2,83,85,39,46
050,19,041,"Iowa","Clay County",2,84,75,34,41
050,19,041,"Iowa","Clay County",2,85,525,184,341
050,19,041,"Iowa","Clay County",3,0,170,81,89
050,19,041,"Iowa","Clay County",3,1,186,104,82
050,19,041,"Iowa","Clay County",3,2,187,97,90
050,19,041,"Iowa","Clay County",3,3,208,105,103
050,19,041,"Iowa","Clay County",3,4,198,89,109
050,19,041,"Iowa","Clay County",3,5,200,99,101
050,19,041,"Iowa","Clay County",3,6,212,113,99
050,19,041,"Iowa","Clay County",3,7,233,129,104
050,19,041,"Iowa","Clay County",3,8,217,113,104
050,19,041,"Iowa","Clay County",3,9,205,95,110
050,19,041,"Iowa","Clay County",3,10,191,90,101
050,19,041,"Iowa","Clay County",3,11,195,94,101
050,19,041,"Iowa","Clay County",3,12,226,118,108
050,19,041,"Iowa","Clay County",3,13,251,131,120
050,19,041,"Iowa","Clay County",3,14,222,114,108
050,19,041,"Iowa","Clay County",3,15,219,106,113
050,19,041,"Iowa","Clay County",3,16,232,107,125
050,19,041,"Iowa","Clay County",3,17,227,106,121
050,19,041,"Iowa","Clay County",3,18,179,96,83
050,19,041,"Iowa","Clay County",3,19,167,87,80
050,19,041,"Iowa","Clay County",3,20,170,83,87
050,19,041,"Iowa","Clay County",3,21,164,78,86
050,19,041,"Iowa","Clay County",3,22,172,79,93
050,19,041,"Iowa","Clay County",3,23,165,79,86
050,19,041,"Iowa","Clay County",3,24,164,89,75
050,19,041,"Iowa","Clay County",3,25,161,84,77
050,19,041,"Iowa","Clay County",3,26,164,82,82
050,19,041,"Iowa","Clay County",3,27,174,88,86
050,19,041,"Iowa","Clay County",3,28,179,91,88
050,19,041,"Iowa","Clay County",3,29,188,98,90
050,19,041,"Iowa","Clay County",3,30,189,102,87
050,19,041,"Iowa","Clay County",3,31,191,97,94
050,19,041,"Iowa","Clay County",3,32,194,116,78
050,19,041,"Iowa","Clay County",3,33,185,94,91
050,19,041,"Iowa","Clay County",3,34,199,93,106
050,19,041,"Iowa","Clay County",3,35,199,91,108
050,19,041,"Iowa","Clay County",3,36,198,94,104
050,19,041,"Iowa","Clay County",3,37,185,95,90
050,19,041,"Iowa","Clay County",3,38,211,106,105
050,19,041,"Iowa","Clay County",3,39,225,116,109
050,19,041,"Iowa","Clay County",3,40,200,103,97
050,19,041,"Iowa","Clay County",3,41,204,105,99
050,19,041,"Iowa","Clay County",3,42,205,105,100
050,19,041,"Iowa","Clay County",3,43,183,91,92
050,19,041,"Iowa","Clay County",3,44,176,86,90
050,19,041,"Iowa","Clay County",3,45,182,93,89
050,19,041,"Iowa","Clay County",3,46,174,85,89
050,19,041,"Iowa","Clay County",3,47,173,86,87
050,19,041,"Iowa","Clay County",3,48,175,92,83
050,19,041,"Iowa","Clay County",3,49,177,92,85
050,19,041,"Iowa","Clay County",3,50,199,106,93
050,19,041,"Iowa","Clay County",3,51,187,96,91
050,19,041,"Iowa","Clay County",3,52,166,82,84
050,19,041,"Iowa","Clay County",3,53,171,87,84
050,19,041,"Iowa","Clay County",3,54,187,99,88
050,19,041,"Iowa","Clay County",3,55,185,96,89
050,19,041,"Iowa","Clay County",3,56,209,108,101
050,19,041,"Iowa","Clay County",3,57,198,100,98
050,19,041,"Iowa","Clay County",3,58,207,106,101
050,19,041,"Iowa","Clay County",3,59,234,116,118
050,19,041,"Iowa","Clay County",3,60,251,118,133
050,19,041,"Iowa","Clay County",3,61,259,127,132
050,19,041,"Iowa","Clay County",3,62,244,121,123
050,19,041,"Iowa","Clay County",3,63,246,127,119
050,19,041,"Iowa","Clay County",3,64,245,118,127
050,19,041,"Iowa","Clay County",3,65,253,130,123
050,19,041,"Iowa","Clay County",3,66,240,121,119
050,19,041,"Iowa","Clay County",3,67,232,116,116
050,19,041,"Iowa","Clay County",3,68,224,111,113
050,19,041,"Iowa","Clay County",3,69,209,106,103
050,19,041,"Iowa","Clay County",3,70,193,86,107
050,19,041,"Iowa","Clay County",3,71,174,82,92
050,19,041,"Iowa","Clay County",3,72,172,81,91
050,19,041,"Iowa","Clay County",3,73,171,74,97
050,19,041,"Iowa","Clay County",3,74,177,77,100
050,19,041,"Iowa","Clay County",3,75,121,59,62
050,19,041,"Iowa","Clay County",3,76,113,59,54
050,19,041,"Iowa","Clay County",3,77,118,54,64
050,19,041,"Iowa","Clay County",3,78,116,52,64
050,19,041,"Iowa","Clay County",3,79,105,45,60
050,19,041,"Iowa","Clay County",3,80,103,47,56
050,19,041,"Iowa","Clay County",3,81,108,57,51
050,19,041,"Iowa","Clay County",3,82,94,50,44
050,19,041,"Iowa","Clay County",3,83,86,44,42
050,19,041,"Iowa","Clay County",3,84,73,35,38
050,19,041,"Iowa","Clay County",3,85,533,190,343
050,19,041,"Iowa","Clay County",4,0,169,81,88
050,19,041,"Iowa","Clay County",4,1,170,79,91
050,19,041,"Iowa","Clay County",4,2,202,113,89
050,19,041,"Iowa","Clay County",4,3,189,103,86
050,19,041,"Iowa","Clay County",4,4,211,109,102
050,19,041,"Iowa","Clay County",4,5,206,98,108
050,19,041,"Iowa","Clay County",4,6,195,95,100
050,19,041,"Iowa","Clay County",4,7,217,117,100
050,19,041,"Iowa","Clay County",4,8,236,132,104
050,19,041,"Iowa","Clay County",4,9,225,118,107
050,19,041,"Iowa","Clay County",4,10,211,98,113
050,19,041,"Iowa","Clay County",4,11,195,96,99
050,19,041,"Iowa","Clay County",4,12,199,97,102
050,19,041,"Iowa","Clay County",4,13,216,116,100
050,19,041,"Iowa","Clay County",4,14,252,129,123
050,19,041,"Iowa","Clay County",4,15,232,124,108
050,19,041,"Iowa","Clay County",4,16,233,112,121
050,19,041,"Iowa","Clay County",4,17,230,108,122
050,19,041,"Iowa","Clay County",4,18,197,95,102
050,19,041,"Iowa","Clay County",4,19,153,82,71
050,19,041,"Iowa","Clay County",4,20,166,84,82
050,19,041,"Iowa","Clay County",4,21,173,87,86
050,19,041,"Iowa","Clay County",4,22,173,78,95
050,19,041,"Iowa","Clay County",4,23,163,77,86
050,19,041,"Iowa","Clay County",4,24,169,83,86
050,19,041,"Iowa","Clay County",4,25,156,86,70
050,19,041,"Iowa","Clay County",4,26,155,74,81
050,19,041,"Iowa","Clay County",4,27,163,78,85
050,19,041,"Iowa","Clay County",4,28,182,95,87
050,19,041,"Iowa","Clay County",4,29,183,88,95
050,19,041,"Iowa","Clay County",4,30,191,97,94
050,19,041,"Iowa","Clay County",4,31,195,103,92
050,19,041,"Iowa","Clay County",4,32,191,100,91
050,19,041,"Iowa","Clay County",4,33,196,115,81
050,19,041,"Iowa","Clay County",4,34,183,93,90
050,19,041,"Iowa","Clay County",4,35,209,100,109
050,19,041,"Iowa","Clay County",4,36,196,93,103
050,19,041,"Iowa","Clay County",4,37,198,96,102
050,19,041,"Iowa","Clay County",4,38,191,100,91
050,19,041,"Iowa","Clay County",4,39,221,118,103
050,19,041,"Iowa","Clay County",4,40,221,116,105
050,19,041,"Iowa","Clay County",4,41,201,105,96
050,19,041,"Iowa","Clay County",4,42,204,103,101
050,19,041,"Iowa","Clay County",4,43,206,105,101
050,19,041,"Iowa","Clay County",4,44,188,93,95
050,19,041,"Iowa","Clay County",4,45,174,84,90
050,19,041,"Iowa","Clay County",4,46,184,91,93
050,19,041,"Iowa","Clay County",4,47,177,84,93
050,19,041,"Iowa","Clay County",4,48,175,87,88
050,19,041,"Iowa","Clay County",4,49,179,92,87
050,19,041,"Iowa","Clay County",4,50,173,89,84
050,19,041,"Iowa","Clay County",4,51,199,106,93
050,19,041,"Iowa","Clay County",4,52,183,95,88
050,19,041,"Iowa","Clay County",4,53,172,85,87
050,19,041,"Iowa","Clay County",4,54,172,90,82
050,19,041,"Iowa","Clay County",4,55,189,101,88
050,19,041,"Iowa","Clay County",4,56,177,92,85
050,19,041,"Iowa","Clay County",4,57,201,103,98
050,19,041,"Iowa","Clay County",4,58,194,100,94
050,19,041,"Iowa","Clay County",4,59,214,107,107
050,19,041,"Iowa","Clay County",4,60,235,117,118
050,19,041,"Iowa","Clay County",4,61,252,117,135
050,19,041,"Iowa","Clay County",4,62,266,127,139
050,19,041,"Iowa","Clay County",4,63,236,120,116
050,19,041,"Iowa","Clay County",4,64,243,123,120
050,19,041,"Iowa","Clay County",4,65,250,122,128
050,19,041,"Iowa","Clay County",4,66,256,131,125
050,19,041,"Iowa","Clay County",4,67,236,122,114
050,19,041,"Iowa","Clay County",4,68,225,111,114
050,19,041,"Iowa","Clay County",4,69,217,105,112
050,19,041,"Iowa","Clay County",4,70,206,102,104
050,19,041,"Iowa","Clay County",4,71,184,84,100
050,19,041,"Iowa","Clay County",4,72,172,82,90
050,19,041,"Iowa","Clay County",4,73,168,79,89
050,19,041,"Iowa","Clay County",4,74,167,73,94
050,19,041,"Iowa","Clay County",4,75,174,72,102
050,19,041,"Iowa","Clay County",4,76,123,58,65
050,19,041,"Iowa","Clay County",4,77,110,57,53
050,19,041,"Iowa","Clay County",4,78,116,50,66
050,19,041,"Iowa","Clay County",4,79,120,54,66
050,19,041,"Iowa","Clay County",4,80,103,45,58
050,19,041,"Iowa","Clay County",4,81,99,49,50
050,19,041,"Iowa","Clay County",4,82,97,53,44
050,19,041,"Iowa","Clay County",4,83,88,45,43
050,19,041,"Iowa","Clay County",4,84,71,38,33
050,19,041,"Iowa","Clay County",4,85,518,182,336
050,19,041,"Iowa","Clay County",5,0,163,78,85
050,19,041,"Iowa","Clay County",5,1,172,83,89
050,19,041,"Iowa","Clay County",5,2,170,81,89
050,19,041,"Iowa","Clay County",5,3,201,113,88
050,19,041,"Iowa","Clay County",5,4,190,100,90
050,19,041,"Iowa","Clay County",5,5,212,110,102
050,19,041,"Iowa","Clay County",5,6,201,92,109
050,19,041,"Iowa","Clay County",5,7,191,92,99
050,19,041,"Iowa","Clay County",5,8,225,116,109
050,19,041,"Iowa","Clay County",5,9,235,135,100
050,19,041,"Iowa","Clay County",5,10,230,120,110
050,19,041,"Iowa","Clay County",5,11,209,100,109
050,19,041,"Iowa","Clay County",5,12,203,103,100
050,19,041,"Iowa","Clay County",5,13,208,100,108
050,19,041,"Iowa","Clay County",5,14,213,114,99
050,19,041,"Iowa","Clay County",5,15,246,128,118
050,19,041,"Iowa","Clay County",5,16,223,123,100
050,19,041,"Iowa","Clay County",5,17,228,106,122
050,19,041,"Iowa","Clay County",5,18,197,94,103
050,19,041,"Iowa","Clay County",5,19,169,84,85
050,19,041,"Iowa","Clay County",5,20,159,85,74
050,19,041,"Iowa","Clay County",5,21,183,93,90
050,19,041,"Iowa","Clay County",5,22,180,93,87
050,19,041,"Iowa","Clay County",5,23,160,71,89
050,19,041,"Iowa","Clay County",5,24,174,92,82
050,19,041,"Iowa","Clay County",5,25,161,76,85
050,19,041,"Iowa","Clay County",5,26,155,84,71
050,19,041,"Iowa","Clay County",5,27,161,78,83
050,19,041,"Iowa","Clay County",5,28,165,71,94
050,19,041,"Iowa","Clay County",5,29,185,94,91
050,19,041,"Iowa","Clay County",5,30,180,85,95
050,19,041,"Iowa","Clay County",5,31,187,94,93
050,19,041,"Iowa","Clay County",5,32,199,103,96
050,19,041,"Iowa","Clay County",5,33,197,108,89
050,19,041,"Iowa","Clay County",5,34,196,113,83
050,19,041,"Iowa","Clay County",5,35,188,96,92
050,19,041,"Iowa","Clay County",5,36,208,100,108
050,19,041,"Iowa","Clay County",5,37,192,92,100
050,19,041,"Iowa","Clay County",5,38,205,97,108
050,19,041,"Iowa","Clay County",5,39,194,100,94
050,19,041,"Iowa","Clay County",5,40,220,122,98
050,19,041,"Iowa","Clay County",5,41,224,119,105
050,19,041,"Iowa","Clay County",5,42,199,104,95
050,19,041,"Iowa","Clay County",5,43,216,107,109
050,19,041,"Iowa","Clay County",5,44,205,105,100
050,19,041,"Iowa","Clay County",5,45,179,90,89
050,19,041,"Iowa","Clay County",5,46,185,87,98
050,19,041,"Iowa","Clay County",5,47,186,94,92
050,19,041,"Iowa","Clay County",5,48,177,80,97
050,19,041,"Iowa","Clay County",5,49,176,89,87
050,19,041,"Iowa","Clay County",5,50,181,96,85
050,19,041,"Iowa","Clay County",5,51,172,85,87
050,19,041,"Iowa","Clay County",5,52,207,112,95
050,19,041,"Iowa","Clay County",5,53,183,97,86
050,19,041,"Iowa","Clay County",5,54,177,86,91
050,19,041,"Iowa","Clay County",5,55,180,97,83
050,19,041,"Iowa","Clay County",5,56,191,101,90
050,19,041,"Iowa","Clay County",5,57,172,88,84
050,19,041,"Iowa","Clay County",5,58,201,102,99
050,19,041,"Iowa","Clay County",5,59,192,99,93
050,19,041,"Iowa","Clay County",5,60,219,107,112
050,19,041,"Iowa","Clay County",5,61,231,112,119
050,19,041,"Iowa","Clay County",5,62,250,114,136
050,19,041,"Iowa","Clay County",5,63,264,129,135
050,19,041,"Iowa","Clay County",5,64,234,118,116
050,19,041,"Iowa","Clay County",5,65,246,127,119
050,19,041,"Iowa","Clay County",5,66,253,125,128
050,19,041,"Iowa","Clay County",5,67,248,127,121
050,19,041,"Iowa","Clay County",5,68,232,119,113
050,19,041,"Iowa","Clay County",5,69,225,112,113
050,19,041,"Iowa","Clay County",5,70,208,96,112
050,19,041,"Iowa","Clay County",5,71,203,101,102
050,19,041,"Iowa","Clay County",5,72,181,85,96
050,19,041,"Iowa","Clay County",5,73,162,73,89
050,19,041,"Iowa","Clay County",5,74,166,81,85
050,19,041,"Iowa","Clay County",5,75,157,67,90
050,19,041,"Iowa","Clay County",5,76,171,69,102
050,19,041,"Iowa","Clay County",5,77,120,57,63
050,19,041,"Iowa","Clay County",5,78,106,53,53
050,19,041,"Iowa","Clay County",5,79,115,51,64
050,19,041,"Iowa","Clay County",5,80,110,51,59
050,19,041,"Iowa","Clay County",5,81,103,47,56
050,19,041,"Iowa","Clay County",5,82,88,45,43
050,19,041,"Iowa","Clay County",5,83,94,49,45
050,19,041,"Iowa","Clay County",5,84,78,42,36
050,19,041,"Iowa","Clay County",5,85,509,187,322
050,19,043,"Iowa","Clayton County",1,0,172,88,84
050,19,043,"Iowa","Clayton County",1,1,167,93,74
050,19,043,"Iowa","Clayton County",1,2,187,101,86
050,19,043,"Iowa","Clayton County",1,3,193,92,101
050,19,043,"Iowa","Clayton County",1,4,184,91,93
050,19,043,"Iowa","Clayton County",1,5,198,101,97
050,19,043,"Iowa","Clayton County",1,6,201,103,98
050,19,043,"Iowa","Clayton County",1,7,196,101,95
050,19,043,"Iowa","Clayton County",1,8,182,87,95
050,19,043,"Iowa","Clayton County",1,9,188,94,94
050,19,043,"Iowa","Clayton County",1,10,213,118,95
050,19,043,"Iowa","Clayton County",1,11,227,131,96
050,19,043,"Iowa","Clayton County",1,12,232,129,103
050,19,043,"Iowa","Clayton County",1,13,225,119,106
050,19,043,"Iowa","Clayton County",1,14,216,107,109
050,19,043,"Iowa","Clayton County",1,15,227,112,115
050,19,043,"Iowa","Clayton County",1,16,217,106,111
050,19,043,"Iowa","Clayton County",1,17,203,105,98
050,19,043,"Iowa","Clayton County",1,18,180,95,85
050,19,043,"Iowa","Clayton County",1,19,141,69,72
050,19,043,"Iowa","Clayton County",1,20,143,72,71
050,19,043,"Iowa","Clayton County",1,21,166,93,73
050,19,043,"Iowa","Clayton County",1,22,154,72,82
050,19,043,"Iowa","Clayton County",1,23,158,79,79
050,19,043,"Iowa","Clayton County",1,24,151,75,76
050,19,043,"Iowa","Clayton County",1,25,167,85,82
050,19,043,"Iowa","Clayton County",1,26,160,84,76
050,19,043,"Iowa","Clayton County",1,27,175,94,81
050,19,043,"Iowa","Clayton County",1,28,193,98,95
050,19,043,"Iowa","Clayton County",1,29,178,90,88
050,19,043,"Iowa","Clayton County",1,30,161,86,75
050,19,043,"Iowa","Clayton County",1,31,146,74,72
050,19,043,"Iowa","Clayton County",1,32,165,88,77
050,19,043,"Iowa","Clayton County",1,33,171,83,88
050,19,043,"Iowa","Clayton County",1,34,171,96,75
050,19,043,"Iowa","Clayton County",1,35,181,88,93
050,19,043,"Iowa","Clayton County",1,36,192,94,98
050,19,043,"Iowa","Clayton County",1,37,180,96,84
050,19,043,"Iowa","Clayton County",1,38,189,100,89
050,19,043,"Iowa","Clayton County",1,39,177,100,77
050,19,043,"Iowa","Clayton County",1,40,174,91,83
050,19,043,"Iowa","Clayton County",1,41,182,98,84
050,19,043,"Iowa","Clayton County",1,42,162,83,79
050,19,043,"Iowa","Clayton County",1,43,162,82,80
050,19,043,"Iowa","Clayton County",1,44,179,92,87
050,19,043,"Iowa","Clayton County",1,45,171,96,75
050,19,043,"Iowa","Clayton County",1,46,167,93,74
050,19,043,"Iowa","Clayton County",1,47,175,103,72
050,19,043,"Iowa","Clayton County",1,48,191,111,80
050,19,043,"Iowa","Clayton County",1,49,216,111,105
050,19,043,"Iowa","Clayton County",1,50,199,100,99
050,19,043,"Iowa","Clayton County",1,51,199,97,102
050,19,043,"Iowa","Clayton County",1,52,203,103,100
050,19,043,"Iowa","Clayton County",1,53,199,105,94
050,19,043,"Iowa","Clayton County",1,54,207,112,95
050,19,043,"Iowa","Clayton County",1,55,227,126,101
050,19,043,"Iowa","Clayton County",1,56,237,126,111
050,19,043,"Iowa","Clayton County",1,57,270,134,136
050,19,043,"Iowa","Clayton County",1,58,287,132,155
050,19,043,"Iowa","Clayton County",1,59,301,152,149
050,19,043,"Iowa","Clayton County",1,60,300,162,138
050,19,043,"Iowa","Clayton County",1,61,301,148,153
050,19,043,"Iowa","Clayton County",1,62,321,171,150
050,19,043,"Iowa","Clayton County",1,63,314,163,151
050,19,043,"Iowa","Clayton County",1,64,291,146,145
050,19,043,"Iowa","Clayton County",1,65,276,143,133
050,19,043,"Iowa","Clayton County",1,66,271,145,126
050,19,043,"Iowa","Clayton County",1,67,284,142,142
050,19,043,"Iowa","Clayton County",1,68,235,120,115
050,19,043,"Iowa","Clayton County",1,69,235,126,109
050,19,043,"Iowa","Clayton County",1,70,222,114,108
050,19,043,"Iowa","Clayton County",1,71,215,113,102
050,19,043,"Iowa","Clayton County",1,72,203,105,98
050,19,043,"Iowa","Clayton County",1,73,215,109,106
050,19,043,"Iowa","Clayton County",1,74,150,78,72
050,19,043,"Iowa","Clayton County",1,75,137,76,61
050,19,043,"Iowa","Clayton County",1,76,141,73,68
050,19,043,"Iowa","Clayton County",1,77,142,68,74
050,19,043,"Iowa","Clayton County",1,78,127,62,65
050,19,043,"Iowa","Clayton County",1,79,125,60,65
050,19,043,"Iowa","Clayton County",1,80,113,49,64
050,19,043,"Iowa","Clayton County",1,81,117,49,68
050,19,043,"Iowa","Clayton County",1,82,96,43,53
050,19,043,"Iowa","Clayton County",1,83,89,39,50
050,19,043,"Iowa","Clayton County",1,84,81,32,49
050,19,043,"Iowa","Clayton County",1,85,611,222,389
050,19,043,"Iowa","Clayton County",2,0,190,95,95
050,19,043,"Iowa","Clayton County",2,1,167,92,75
050,19,043,"Iowa","Clayton County",2,2,181,98,83
050,19,043,"Iowa","Clayton County",2,3,190,94,96
050,19,043,"Iowa","Clayton County",2,4,187,92,95
050,19,043,"Iowa","Clayton County",2,5,195,99,96
050,19,043,"Iowa","Clayton County",2,6,201,102,99
050,19,043,"Iowa","Clayton County",2,7,197,100,97
050,19,043,"Iowa","Clayton County",2,8,184,89,95
050,19,043,"Iowa","Clayton County",2,9,185,92,93
050,19,043,"Iowa","Clayton County",2,10,207,114,93
050,19,043,"Iowa","Clayton County",2,11,222,127,95
050,19,043,"Iowa","Clayton County",2,12,229,129,100
050,19,043,"Iowa","Clayton County",2,13,228,122,106
050,19,043,"Iowa","Clayton County",2,14,217,108,109
050,19,043,"Iowa","Clayton County",2,15,223,110,113
050,19,043,"Iowa","Clayton County",2,16,219,108,111
050,19,043,"Iowa","Clayton County",2,17,205,104,101
050,19,043,"Iowa","Clayton County",2,18,177,93,84
050,19,043,"Iowa","Clayton County",2,19,140,69,71
050,19,043,"Iowa","Clayton County",2,20,144,70,74
050,19,043,"Iowa","Clayton County",2,21,160,86,74
050,19,043,"Iowa","Clayton County",2,22,156,76,80
050,19,043,"Iowa","Clayton County",2,23,161,80,81
050,19,043,"Iowa","Clayton County",2,24,153,77,76
050,19,043,"Iowa","Clayton County",2,25,163,83,80
050,19,043,"Iowa","Clayton County",2,26,160,84,76
050,19,043,"Iowa","Clayton County",2,27,173,91,82
050,19,043,"Iowa","Clayton County",2,28,187,96,91
050,19,043,"Iowa","Clayton County",2,29,182,92,90
050,19,043,"Iowa","Clayton County",2,30,167,87,80
050,19,043,"Iowa","Clayton County",2,31,151,78,73
050,19,043,"Iowa","Clayton County",2,32,160,84,76
050,19,043,"Iowa","Clayton County",2,33,170,84,86
050,19,043,"Iowa","Clayton County",2,34,170,93,77
050,19,043,"Iowa","Clayton County",2,35,180,90,90
050,19,043,"Iowa","Clayton County",2,36,187,91,96
050,19,043,"Iowa","Clayton County",2,37,185,97,88
050,19,043,"Iowa","Clayton County",2,38,186,99,87
050,19,043,"Iowa","Clayton County",2,39,178,98,80
050,19,043,"Iowa","Clayton County",2,40,176,94,82
050,19,043,"Iowa","Clayton County",2,41,183,99,84
050,19,043,"Iowa","Clayton County",2,42,164,85,79
050,19,043,"Iowa","Clayton County",2,43,164,83,81
050,19,043,"Iowa","Clayton County",2,44,176,89,87
050,19,043,"Iowa","Clayton County",2,45,173,96,77
050,19,043,"Iowa","Clayton County",2,46,167,93,74
050,19,043,"Iowa","Clayton County",2,47,171,99,72
050,19,043,"Iowa","Clayton County",2,48,188,110,78
050,19,043,"Iowa","Clayton County",2,49,210,111,99
050,19,043,"Iowa","Clayton County",2,50,205,104,101
050,19,043,"Iowa","Clayton County",2,51,197,97,100
050,19,043,"Iowa","Clayton County",2,52,200,102,98
050,19,043,"Iowa","Clayton County",2,53,202,105,97
050,19,043,"Iowa","Clayton County",2,54,203,111,92
050,19,043,"Iowa","Clayton County",2,55,222,122,100
050,19,043,"Iowa","Clayton County",2,56,236,128,108
050,19,043,"Iowa","Clayton County",2,57,263,133,130
050,19,043,"Iowa","Clayton County",2,58,280,131,149
050,19,043,"Iowa","Clayton County",2,59,299,147,152
050,19,043,"Iowa","Clayton County",2,60,297,157,140
050,19,043,"Iowa","Clayton County",2,61,298,150,148
050,19,043,"Iowa","Clayton County",2,62,317,166,151
050,19,043,"Iowa","Clayton County",2,63,317,165,152
050,19,043,"Iowa","Clayton County",2,64,294,148,146
050,19,043,"Iowa","Clayton County",2,65,279,143,136
050,19,043,"Iowa","Clayton County",2,66,272,144,128
050,19,043,"Iowa","Clayton County",2,67,280,142,138
050,19,043,"Iowa","Clayton County",2,68,246,125,121
050,19,043,"Iowa","Clayton County",2,69,236,125,111
050,19,043,"Iowa","Clayton County",2,70,224,116,108
050,19,043,"Iowa","Clayton County",2,71,217,113,104
050,19,043,"Iowa","Clayton County",2,72,201,104,97
050,19,043,"Iowa","Clayton County",2,73,224,114,110
050,19,043,"Iowa","Clayton County",2,74,154,79,75
050,19,043,"Iowa","Clayton County",2,75,138,76,62
050,19,043,"Iowa","Clayton County",2,76,137,72,65
050,19,043,"Iowa","Clayton County",2,77,144,70,74
050,19,043,"Iowa","Clayton County",2,78,125,60,65
050,19,043,"Iowa","Clayton County",2,79,121,58,63
050,19,043,"Iowa","Clayton County",2,80,117,52,65
050,19,043,"Iowa","Clayton County",2,81,115,48,67
050,19,043,"Iowa","Clayton County",2,82,101,45,56
050,19,043,"Iowa","Clayton County",2,83,89,39,50
050,19,043,"Iowa","Clayton County",2,84,82,32,50
050,19,043,"Iowa","Clayton County",2,85,612,221,391
050,19,043,"Iowa","Clayton County",3,0,193,93,100
050,19,043,"Iowa","Clayton County",3,1,185,91,94
050,19,043,"Iowa","Clayton County",3,2,176,97,79
050,19,043,"Iowa","Clayton County",3,3,200,111,89
050,19,043,"Iowa","Clayton County",3,4,196,102,94
050,19,043,"Iowa","Clayton County",3,5,190,91,99
050,19,043,"Iowa","Clayton County",3,6,201,106,95
050,19,043,"Iowa","Clayton County",3,7,203,108,95
050,19,043,"Iowa","Clayton County",3,8,195,102,93
050,19,043,"Iowa","Clayton County",3,9,180,85,95
050,19,043,"Iowa","Clayton County",3,10,187,91,96
050,19,043,"Iowa","Clayton County",3,11,211,111,100
050,19,043,"Iowa","Clayton County",3,12,216,118,98
050,19,043,"Iowa","Clayton County",3,13,223,128,95
050,19,043,"Iowa","Clayton County",3,14,241,124,117
050,19,043,"Iowa","Clayton County",3,15,228,111,117
050,19,043,"Iowa","Clayton County",3,16,221,110,111
050,19,043,"Iowa","Clayton County",3,17,216,108,108
050,19,043,"Iowa","Clayton County",3,18,168,85,83
050,19,043,"Iowa","Clayton County",3,19,144,78,66
050,19,043,"Iowa","Clayton County",3,20,153,72,81
050,19,043,"Iowa","Clayton County",3,21,158,82,76
050,19,043,"Iowa","Clayton County",3,22,174,96,78
050,19,043,"Iowa","Clayton County",3,23,161,77,84
050,19,043,"Iowa","Clayton County",3,24,159,87,72
050,19,043,"Iowa","Clayton County",3,25,162,78,84
050,19,043,"Iowa","Clayton County",3,26,155,78,77
050,19,043,"Iowa","Clayton County",3,27,174,85,89
050,19,043,"Iowa","Clayton County",3,28,181,98,83
050,19,043,"Iowa","Clayton County",3,29,190,98,92
050,19,043,"Iowa","Clayton County",3,30,186,97,89
050,19,043,"Iowa","Clayton County",3,31,174,90,84
050,19,043,"Iowa","Clayton County",3,32,151,77,74
050,19,043,"Iowa","Clayton County",3,33,171,85,86
050,19,043,"Iowa","Clayton County",3,34,171,84,87
050,19,043,"Iowa","Clayton County",3,35,166,87,79
050,19,043,"Iowa","Clayton County",3,36,185,94,91
050,19,043,"Iowa","Clayton County",3,37,194,92,102
050,19,043,"Iowa","Clayton County",3,38,186,94,92
050,19,043,"Iowa","Clayton County",3,39,186,103,83
050,19,043,"Iowa","Clayton County",3,40,179,100,79
050,19,043,"Iowa","Clayton County",3,41,194,103,91
050,19,043,"Iowa","Clayton County",3,42,177,97,80
050,19,043,"Iowa","Clayton County",3,43,165,80,85
050,19,043,"Iowa","Clayton County",3,44,175,87,88
050,19,043,"Iowa","Clayton County",3,45,160,87,73
050,19,043,"Iowa","Clayton County",3,46,170,97,73
050,19,043,"Iowa","Clayton County",3,47,164,93,71
050,19,043,"Iowa","Clayton County",3,48,174,99,75
050,19,043,"Iowa","Clayton County",3,49,186,108,78
050,19,043,"Iowa","Clayton County",3,50,213,114,99
050,19,043,"Iowa","Clayton County",3,51,204,102,102
050,19,043,"Iowa","Clayton County",3,52,196,99,97
050,19,043,"Iowa","Clayton County",3,53,203,105,98
050,19,043,"Iowa","Clayton County",3,54,196,103,93
050,19,043,"Iowa","Clayton County",3,55,200,109,91
050,19,043,"Iowa","Clayton County",3,56,223,123,100
050,19,043,"Iowa","Clayton County",3,57,239,130,109
050,19,043,"Iowa","Clayton County",3,58,267,131,136
050,19,043,"Iowa","Clayton County",3,59,277,132,145
050,19,043,"Iowa","Clayton County",3,60,290,142,148
050,19,043,"Iowa","Clayton County",3,61,290,156,134
050,19,043,"Iowa","Clayton County",3,62,300,152,148
050,19,043,"Iowa","Clayton County",3,63,311,156,155
050,19,043,"Iowa","Clayton County",3,64,316,162,154
050,19,043,"Iowa","Clayton County",3,65,284,141,143
050,19,043,"Iowa","Clayton County",3,66,276,141,135
050,19,043,"Iowa","Clayton County",3,67,267,141,126
050,19,043,"Iowa","Clayton County",3,68,267,131,136
050,19,043,"Iowa","Clayton County",3,69,246,127,119
050,19,043,"Iowa","Clayton County",3,70,233,122,111
050,19,043,"Iowa","Clayton County",3,71,213,112,101
050,19,043,"Iowa","Clayton County",3,72,198,100,98
050,19,043,"Iowa","Clayton County",3,73,201,102,99
050,19,043,"Iowa","Clayton County",3,74,213,106,107
050,19,043,"Iowa","Clayton County",3,75,148,79,69
050,19,043,"Iowa","Clayton County",3,76,136,72,64
050,19,043,"Iowa","Clayton County",3,77,124,62,62
050,19,043,"Iowa","Clayton County",3,78,136,68,68
050,19,043,"Iowa","Clayton County",3,79,119,59,60
050,19,043,"Iowa","Clayton County",3,80,119,57,62
050,19,043,"Iowa","Clayton County",3,81,112,47,65
050,19,043,"Iowa","Clayton County",3,82,106,47,59
050,19,043,"Iowa","Clayton County",3,83,101,43,58
050,19,043,"Iowa","Clayton County",3,84,82,33,49
050,19,043,"Iowa","Clayton County",3,85,592,210,382
050,19,043,"Iowa","Clayton County",4,0,198,106,92
050,19,043,"Iowa","Clayton County",4,1,190,95,95
050,19,043,"Iowa","Clayton County",4,2,194,94,100
050,19,043,"Iowa","Clayton County",4,3,175,96,79
050,19,043,"Iowa","Clayton County",4,4,196,109,87
050,19,043,"Iowa","Clayton County",4,5,195,97,98
050,19,043,"Iowa","Clayton County",4,6,199,95,104
050,19,043,"Iowa","Clayton County",4,7,199,105,94
050,19,043,"Iowa","Clayton County",4,8,216,108,108
050,19,043,"Iowa","Clayton County",4,9,195,105,90
050,19,043,"Iowa","Clayton County",4,10,190,86,104
050,19,043,"Iowa","Clayton County",4,11,194,90,104
050,19,043,"Iowa","Clayton County",4,12,216,117,99
050,19,043,"Iowa","Clayton County",4,13,224,125,99
050,19,043,"Iowa","Clayton County",4,14,222,127,95
050,19,043,"Iowa","Clayton County",4,15,250,128,122
050,19,043,"Iowa","Clayton County",4,16,218,103,115
050,19,043,"Iowa","Clayton County",4,17,224,111,113
050,19,043,"Iowa","Clayton County",4,18,184,95,89
050,19,043,"Iowa","Clayton County",4,19,122,66,56
050,19,043,"Iowa","Clayton County",4,20,145,74,71
050,19,043,"Iowa","Clayton County",4,21,157,84,73
050,19,043,"Iowa","Clayton County",4,22,159,88,71
050,19,043,"Iowa","Clayton County",4,23,176,100,76
050,19,043,"Iowa","Clayton County",4,24,156,74,82
050,19,043,"Iowa","Clayton County",4,25,159,85,74
050,19,043,"Iowa","Clayton County",4,26,171,82,89
050,19,043,"Iowa","Clayton County",4,27,152,81,71
050,19,043,"Iowa","Clayton County",4,28,172,85,87
050,19,043,"Iowa","Clayton County",4,29,184,98,86
050,19,043,"Iowa","Clayton County",4,30,194,101,93
050,19,043,"Iowa","Clayton County",4,31,180,94,86
050,19,043,"Iowa","Clayton County",4,32,174,86,88
050,19,043,"Iowa","Clayton County",4,33,163,86,77
050,19,043,"Iowa","Clayton County",4,34,181,88,93
050,19,043,"Iowa","Clayton County",4,35,179,85,94
050,19,043,"Iowa","Clayton County",4,36,163,80,83
050,19,043,"Iowa","Clayton County",4,37,194,98,96
050,19,043,"Iowa","Clayton County",4,38,183,84,99
050,19,043,"Iowa","Clayton County",4,39,193,100,93
050,19,043,"Iowa","Clayton County",4,40,191,109,82
050,19,043,"Iowa","Clayton County",4,41,194,108,86
050,19,043,"Iowa","Clayton County",4,42,187,99,88
050,19,043,"Iowa","Clayton County",4,43,183,97,86
050,19,043,"Iowa","Clayton County",4,44,175,84,91
050,19,043,"Iowa","Clayton County",4,45,170,88,82
050,19,043,"Iowa","Clayton County",4,46,165,90,75
050,19,043,"Iowa","Clayton County",4,47,169,94,75
050,19,043,"Iowa","Clayton County",4,48,165,95,70
050,19,043,"Iowa","Clayton County",4,49,164,94,70
050,19,043,"Iowa","Clayton County",4,50,191,113,78
050,19,043,"Iowa","Clayton County",4,51,207,106,101
050,19,043,"Iowa","Clayton County",4,52,194,97,97
050,19,043,"Iowa","Clayton County",4,53,205,107,98
050,19,043,"Iowa","Clayton County",4,54,197,103,94
050,19,043,"Iowa","Clayton County",4,55,197,104,93
050,19,043,"Iowa","Clayton County",4,56,199,105,94
050,19,043,"Iowa","Clayton County",4,57,235,131,104
050,19,043,"Iowa","Clayton County",4,58,237,131,106
050,19,043,"Iowa","Clayton County",4,59,268,131,137
050,19,043,"Iowa","Clayton County",4,60,267,127,140
050,19,043,"Iowa","Clayton County",4,61,289,138,151
050,19,043,"Iowa","Clayton County",4,62,294,158,136
050,19,043,"Iowa","Clayton County",4,63,296,150,146
050,19,043,"Iowa","Clayton County",4,64,312,155,157
050,19,043,"Iowa","Clayton County",4,65,314,160,154
050,19,043,"Iowa","Clayton County",4,66,288,144,144
050,19,043,"Iowa","Clayton County",4,67,271,137,134
050,19,043,"Iowa","Clayton County",4,68,261,137,124
050,19,043,"Iowa","Clayton County",4,69,260,127,133
050,19,043,"Iowa","Clayton County",4,70,239,122,117
050,19,043,"Iowa","Clayton County",4,71,230,121,109
050,19,043,"Iowa","Clayton County",4,72,205,112,93
050,19,043,"Iowa","Clayton County",4,73,194,97,97
050,19,043,"Iowa","Clayton County",4,74,194,97,97
050,19,043,"Iowa","Clayton County",4,75,208,104,104
050,19,043,"Iowa","Clayton County",4,76,139,71,68
050,19,043,"Iowa","Clayton County",4,77,128,68,60
050,19,043,"Iowa","Clayton County",4,78,117,60,57
050,19,043,"Iowa","Clayton County",4,79,131,66,65
050,19,043,"Iowa","Clayton County",4,80,113,58,55
050,19,043,"Iowa","Clayton County",4,81,116,54,62
050,19,043,"Iowa","Clayton County",4,82,98,43,55
050,19,043,"Iowa","Clayton County",4,83,101,42,59
050,19,043,"Iowa","Clayton County",4,84,96,38,58
050,19,043,"Iowa","Clayton County",4,85,567,197,370
050,19,043,"Iowa","Clayton County",5,0,168,87,81
050,19,043,"Iowa","Clayton County",5,1,197,98,99
050,19,043,"Iowa","Clayton County",5,2,195,99,96
050,19,043,"Iowa","Clayton County",5,3,193,96,97
050,19,043,"Iowa","Clayton County",5,4,182,101,81
050,19,043,"Iowa","Clayton County",5,5,194,105,89
050,19,043,"Iowa","Clayton County",5,6,196,102,94
050,19,043,"Iowa","Clayton County",5,7,206,97,109
050,19,043,"Iowa","Clayton County",5,8,204,106,98
050,19,043,"Iowa","Clayton County",5,9,212,104,108
050,19,043,"Iowa","Clayton County",5,10,193,101,92
050,19,043,"Iowa","Clayton County",5,11,188,85,103
050,19,043,"Iowa","Clayton County",5,12,197,90,107
050,19,043,"Iowa","Clayton County",5,13,218,119,99
050,19,043,"Iowa","Clayton County",5,14,217,120,97
050,19,043,"Iowa","Clayton County",5,15,223,128,95
050,19,043,"Iowa","Clayton County",5,16,256,131,125
050,19,043,"Iowa","Clayton County",5,17,215,101,114
050,19,043,"Iowa","Clayton County",5,18,186,97,89
050,19,043,"Iowa","Clayton County",5,19,139,72,67
050,19,043,"Iowa","Clayton County",5,20,130,67,63
050,19,043,"Iowa","Clayton County",5,21,148,76,72
050,19,043,"Iowa","Clayton County",5,22,166,88,78
050,19,043,"Iowa","Clayton County",5,23,165,94,71
050,19,043,"Iowa","Clayton County",5,24,171,94,77
050,19,043,"Iowa","Clayton County",5,25,147,67,80
050,19,043,"Iowa","Clayton County",5,26,146,84,62
050,19,043,"Iowa","Clayton County",5,27,176,87,89
050,19,043,"Iowa","Clayton County",5,28,143,77,66
050,19,043,"Iowa","Clayton County",5,29,170,84,86
050,19,043,"Iowa","Clayton County",5,30,182,97,85
050,19,043,"Iowa","Clayton County",5,31,194,103,91
050,19,043,"Iowa","Clayton County",5,32,184,98,86
050,19,043,"Iowa","Clayton County",5,33,178,88,90
050,19,043,"Iowa","Clayton County",5,34,166,89,77
050,19,043,"Iowa","Clayton County",5,35,173,82,91
050,19,043,"Iowa","Clayton County",5,36,177,82,95
050,19,043,"Iowa","Clayton County",5,37,167,84,83
050,19,043,"Iowa","Clayton County",5,38,188,93,95
050,19,043,"Iowa","Clayton County",5,39,180,81,99
050,19,043,"Iowa","Clayton County",5,40,188,97,91
050,19,043,"Iowa","Clayton County",5,41,199,111,88
050,19,043,"Iowa","Clayton County",5,42,183,101,82
050,19,043,"Iowa","Clayton County",5,43,187,101,86
050,19,043,"Iowa","Clayton County",5,44,193,100,93
050,19,043,"Iowa","Clayton County",5,45,178,91,87
050,19,043,"Iowa","Clayton County",5,46,172,89,83
050,19,043,"Iowa","Clayton County",5,47,158,82,76
050,19,043,"Iowa","Clayton County",5,48,175,101,74
050,19,043,"Iowa","Clayton County",5,49,157,89,68
050,19,043,"Iowa","Clayton County",5,50,164,94,70
050,19,043,"Iowa","Clayton County",5,51,180,105,75
050,19,043,"Iowa","Clayton County",5,52,213,110,103
050,19,043,"Iowa","Clayton County",5,53,189,91,98
050,19,043,"Iowa","Clayton County",5,54,201,105,96
050,19,043,"Iowa","Clayton County",5,55,199,106,93
050,19,043,"Iowa","Clayton County",5,56,199,105,94
050,19,043,"Iowa","Clayton County",5,57,206,108,98
050,19,043,"Iowa","Clayton County",5,58,228,122,106
050,19,043,"Iowa","Clayton County",5,59,239,129,110
050,19,043,"Iowa","Clayton County",5,60,274,134,140
050,19,043,"Iowa","Clayton County",5,61,262,124,138
050,19,043,"Iowa","Clayton County",5,62,302,149,153
050,19,043,"Iowa","Clayton County",5,63,291,154,137
050,19,043,"Iowa","Clayton County",5,64,302,151,151
050,19,043,"Iowa","Clayton County",5,65,314,152,162
050,19,043,"Iowa","Clayton County",5,66,313,163,150
050,19,043,"Iowa","Clayton County",5,67,279,141,138
050,19,043,"Iowa","Clayton County",5,68,265,134,131
050,19,043,"Iowa","Clayton County",5,69,258,137,121
050,19,043,"Iowa","Clayton County",5,70,253,123,130
050,19,043,"Iowa","Clayton County",5,71,237,119,118
050,19,043,"Iowa","Clayton County",5,72,220,116,104
050,19,043,"Iowa","Clayton County",5,73,202,112,90
050,19,043,"Iowa","Clayton County",5,74,185,91,94
050,19,043,"Iowa","Clayton County",5,75,189,93,96
050,19,043,"Iowa","Clayton County",5,76,199,96,103
050,19,043,"Iowa","Clayton County",5,77,136,70,66
050,19,043,"Iowa","Clayton County",5,78,120,65,55
050,19,043,"Iowa","Clayton County",5,79,113,59,54
050,19,043,"Iowa","Clayton County",5,80,127,64,63
050,19,043,"Iowa","Clayton County",5,81,106,54,52
050,19,043,"Iowa","Clayton County",5,82,111,56,55
050,19,043,"Iowa","Clayton County",5,83,97,41,56
050,19,043,"Iowa","Clayton County",5,84,98,39,59
050,19,043,"Iowa","Clayton County",5,85,578,201,377
050,19,045,"Iowa","Clinton County",1,0,520,264,256
050,19,045,"Iowa","Clinton County",1,1,518,266,252
050,19,045,"Iowa","Clinton County",1,2,558,281,277
050,19,045,"Iowa","Clinton County",1,3,575,273,302
050,19,045,"Iowa","Clinton County",1,4,602,286,316
050,19,045,"Iowa","Clinton County",1,5,598,306,292
050,19,045,"Iowa","Clinton County",1,6,558,288,270
050,19,045,"Iowa","Clinton County",1,7,583,306,277
050,19,045,"Iowa","Clinton County",1,8,590,311,279
050,19,045,"Iowa","Clinton County",1,9,604,297,307
050,19,045,"Iowa","Clinton County",1,10,630,318,312
050,19,045,"Iowa","Clinton County",1,11,624,331,293
050,19,045,"Iowa","Clinton County",1,12,647,344,303
050,19,045,"Iowa","Clinton County",1,13,650,344,306
050,19,045,"Iowa","Clinton County",1,14,615,316,299
050,19,045,"Iowa","Clinton County",1,15,591,296,295
050,19,045,"Iowa","Clinton County",1,16,584,296,288
050,19,045,"Iowa","Clinton County",1,17,617,313,304
050,19,045,"Iowa","Clinton County",1,18,535,281,254
050,19,045,"Iowa","Clinton County",1,19,457,232,225
050,19,045,"Iowa","Clinton County",1,20,467,232,235
050,19,045,"Iowa","Clinton County",1,21,492,244,248
050,19,045,"Iowa","Clinton County",1,22,485,240,245
050,19,045,"Iowa","Clinton County",1,23,516,254,262
050,19,045,"Iowa","Clinton County",1,24,539,262,277
050,19,045,"Iowa","Clinton County",1,25,520,260,260
050,19,045,"Iowa","Clinton County",1,26,497,230,267
050,19,045,"Iowa","Clinton County",1,27,546,277,269
050,19,045,"Iowa","Clinton County",1,28,529,272,257
050,19,045,"Iowa","Clinton County",1,29,556,299,257
050,19,045,"Iowa","Clinton County",1,30,510,241,269
050,19,045,"Iowa","Clinton County",1,31,493,233,260
050,19,045,"Iowa","Clinton County",1,32,497,235,262
050,19,045,"Iowa","Clinton County",1,33,511,256,255
050,19,045,"Iowa","Clinton County",1,34,538,267,271
050,19,045,"Iowa","Clinton County",1,35,549,277,272
050,19,045,"Iowa","Clinton County",1,36,526,272,254
050,19,045,"Iowa","Clinton County",1,37,531,264,267
050,19,045,"Iowa","Clinton County",1,38,554,275,279
050,19,045,"Iowa","Clinton County",1,39,569,291,278
050,19,045,"Iowa","Clinton County",1,40,561,278,283
050,19,045,"Iowa","Clinton County",1,41,564,291,273
050,19,045,"Iowa","Clinton County",1,42,549,282,267
050,19,045,"Iowa","Clinton County",1,43,524,276,248
050,19,045,"Iowa","Clinton County",1,44,506,257,249
050,19,045,"Iowa","Clinton County",1,45,504,237,267
050,19,045,"Iowa","Clinton County",1,46,486,238,248
050,19,045,"Iowa","Clinton County",1,47,497,250,247
050,19,045,"Iowa","Clinton County",1,48,513,269,244
050,19,045,"Iowa","Clinton County",1,49,626,318,308
050,19,045,"Iowa","Clinton County",1,50,602,302,300
050,19,045,"Iowa","Clinton County",1,51,550,271,279
050,19,045,"Iowa","Clinton County",1,52,549,291,258
050,19,045,"Iowa","Clinton County",1,53,598,299,299
050,19,045,"Iowa","Clinton County",1,54,598,299,299
050,19,045,"Iowa","Clinton County",1,55,647,336,311
050,19,045,"Iowa","Clinton County",1,56,725,358,367
050,19,045,"Iowa","Clinton County",1,57,707,340,367
050,19,045,"Iowa","Clinton County",1,58,698,340,358
050,19,045,"Iowa","Clinton County",1,59,754,390,364
050,19,045,"Iowa","Clinton County",1,60,761,383,378
050,19,045,"Iowa","Clinton County",1,61,720,348,372
050,19,045,"Iowa","Clinton County",1,62,721,364,357
050,19,045,"Iowa","Clinton County",1,63,671,334,337
050,19,045,"Iowa","Clinton County",1,64,644,314,330
050,19,045,"Iowa","Clinton County",1,65,625,313,312
050,19,045,"Iowa","Clinton County",1,66,589,298,291
050,19,045,"Iowa","Clinton County",1,67,570,286,284
050,19,045,"Iowa","Clinton County",1,68,570,299,271
050,19,045,"Iowa","Clinton County",1,69,521,260,261
050,19,045,"Iowa","Clinton County",1,70,509,251,258
050,19,045,"Iowa","Clinton County",1,71,510,234,276
050,19,045,"Iowa","Clinton County",1,72,496,234,262
050,19,045,"Iowa","Clinton County",1,73,487,239,248
050,19,045,"Iowa","Clinton County",1,74,311,146,165
050,19,045,"Iowa","Clinton County",1,75,355,161,194
050,19,045,"Iowa","Clinton County",1,76,369,166,203
050,19,045,"Iowa","Clinton County",1,77,362,167,195
050,19,045,"Iowa","Clinton County",1,78,296,133,163
050,19,045,"Iowa","Clinton County",1,79,264,124,140
050,19,045,"Iowa","Clinton County",1,80,253,111,142
050,19,045,"Iowa","Clinton County",1,81,266,124,142
050,19,045,"Iowa","Clinton County",1,82,250,114,136
050,19,045,"Iowa","Clinton County",1,83,206,91,115
050,19,045,"Iowa","Clinton County",1,84,208,89,119
050,19,045,"Iowa","Clinton County",1,85,1086,370,716
050,19,045,"Iowa","Clinton County",2,0,522,264,258
050,19,045,"Iowa","Clinton County",2,1,517,263,254
050,19,045,"Iowa","Clinton County",2,2,553,279,274
050,19,045,"Iowa","Clinton County",2,3,566,273,293
050,19,045,"Iowa","Clinton County",2,4,599,285,314
050,19,045,"Iowa","Clinton County",2,5,598,301,297
050,19,045,"Iowa","Clinton County",2,6,570,295,275
050,19,045,"Iowa","Clinton County",2,7,576,302,274
050,19,045,"Iowa","Clinton County",2,8,585,308,277
050,19,045,"Iowa","Clinton County",2,9,601,300,301
050,19,045,"Iowa","Clinton County",2,10,622,312,310
050,19,045,"Iowa","Clinton County",2,11,624,330,294
050,19,045,"Iowa","Clinton County",2,12,642,343,299
050,19,045,"Iowa","Clinton County",2,13,648,344,304
050,19,045,"Iowa","Clinton County",2,14,624,322,302
050,19,045,"Iowa","Clinton County",2,15,595,300,295
050,19,045,"Iowa","Clinton County",2,16,589,298,291
050,19,045,"Iowa","Clinton County",2,17,612,311,301
050,19,045,"Iowa","Clinton County",2,18,532,280,252
050,19,045,"Iowa","Clinton County",2,19,452,231,221
050,19,045,"Iowa","Clinton County",2,20,474,236,238
050,19,045,"Iowa","Clinton County",2,21,487,240,247
050,19,045,"Iowa","Clinton County",2,22,493,245,248
050,19,045,"Iowa","Clinton County",2,23,508,249,259
050,19,045,"Iowa","Clinton County",2,24,533,263,270
050,19,045,"Iowa","Clinton County",2,25,523,258,265
050,19,045,"Iowa","Clinton County",2,26,502,237,265
050,19,045,"Iowa","Clinton County",2,27,533,267,266
050,19,045,"Iowa","Clinton County",2,28,534,274,260
050,19,045,"Iowa","Clinton County",2,29,552,293,259
050,19,045,"Iowa","Clinton County",2,30,524,257,267
050,19,045,"Iowa","Clinton County",2,31,500,234,266
050,19,045,"Iowa","Clinton County",2,32,495,234,261
050,19,045,"Iowa","Clinton County",2,33,510,252,258
050,19,045,"Iowa","Clinton County",2,34,533,265,268
050,19,045,"Iowa","Clinton County",2,35,549,276,273
050,19,045,"Iowa","Clinton County",2,36,525,271,254
050,19,045,"Iowa","Clinton County",2,37,529,265,264
050,19,045,"Iowa","Clinton County",2,38,547,272,275
050,19,045,"Iowa","Clinton County",2,39,563,285,278
050,19,045,"Iowa","Clinton County",2,40,570,286,284
050,19,045,"Iowa","Clinton County",2,41,563,287,276
050,19,045,"Iowa","Clinton County",2,42,552,285,267
050,19,045,"Iowa","Clinton County",2,43,534,280,254
050,19,045,"Iowa","Clinton County",2,44,507,260,247
050,19,045,"Iowa","Clinton County",2,45,504,242,262
050,19,045,"Iowa","Clinton County",2,46,490,238,252
050,19,045,"Iowa","Clinton County",2,47,490,246,244
050,19,045,"Iowa","Clinton County",2,48,508,261,247
050,19,045,"Iowa","Clinton County",2,49,605,309,296
050,19,045,"Iowa","Clinton County",2,50,609,306,303
050,19,045,"Iowa","Clinton County",2,51,559,277,282
050,19,045,"Iowa","Clinton County",2,52,551,288,263
050,19,045,"Iowa","Clinton County",2,53,583,296,287
050,19,045,"Iowa","Clinton County",2,54,594,297,297
050,19,045,"Iowa","Clinton County",2,55,636,326,310
050,19,045,"Iowa","Clinton County",2,56,705,349,356
050,19,045,"Iowa","Clinton County",2,57,715,347,368
050,19,045,"Iowa","Clinton County",2,58,697,337,360
050,19,045,"Iowa","Clinton County",2,59,746,380,366
050,19,045,"Iowa","Clinton County",2,60,757,383,374
050,19,045,"Iowa","Clinton County",2,61,722,353,369
050,19,045,"Iowa","Clinton County",2,62,715,358,357
050,19,045,"Iowa","Clinton County",2,63,687,343,344
050,19,045,"Iowa","Clinton County",2,64,645,316,329
050,19,045,"Iowa","Clinton County",2,65,627,312,315
050,19,045,"Iowa","Clinton County",2,66,597,302,295
050,19,045,"Iowa","Clinton County",2,67,570,286,284
050,19,045,"Iowa","Clinton County",2,68,569,296,273
050,19,045,"Iowa","Clinton County",2,69,529,267,262
050,19,045,"Iowa","Clinton County",2,70,508,251,257
050,19,045,"Iowa","Clinton County",2,71,505,235,270
050,19,045,"Iowa","Clinton County",2,72,486,228,258
050,19,045,"Iowa","Clinton County",2,73,510,248,262
050,19,045,"Iowa","Clinton County",2,74,330,158,172
050,19,045,"Iowa","Clinton County",2,75,341,155,186
050,19,045,"Iowa","Clinton County",2,76,362,162,200
050,19,045,"Iowa","Clinton County",2,77,366,166,200
050,19,045,"Iowa","Clinton County",2,78,300,135,165
050,19,045,"Iowa","Clinton County",2,79,266,126,140
050,19,045,"Iowa","Clinton County",2,80,253,111,142
050,19,045,"Iowa","Clinton County",2,81,258,119,139
050,19,045,"Iowa","Clinton County",2,82,248,113,135
050,19,045,"Iowa","Clinton County",2,83,214,96,118
050,19,045,"Iowa","Clinton County",2,84,204,86,118
050,19,045,"Iowa","Clinton County",2,85,1099,379,720
050,19,045,"Iowa","Clinton County",3,0,496,254,242
050,19,045,"Iowa","Clinton County",3,1,500,264,236
050,19,045,"Iowa","Clinton County",3,2,529,271,258
050,19,045,"Iowa","Clinton County",3,3,543,272,271
050,19,045,"Iowa","Clinton County",3,4,569,270,299
050,19,045,"Iowa","Clinton County",3,5,603,291,312
050,19,045,"Iowa","Clinton County",3,6,604,300,304
050,19,045,"Iowa","Clinton County",3,7,571,296,275
050,19,045,"Iowa","Clinton County",3,8,595,309,286
050,19,045,"Iowa","Clinton County",3,9,589,314,275
050,19,045,"Iowa","Clinton County",3,10,605,301,304
050,19,045,"Iowa","Clinton County",3,11,648,326,322
050,19,045,"Iowa","Clinton County",3,12,625,327,298
050,19,045,"Iowa","Clinton County",3,13,664,348,316
050,19,045,"Iowa","Clinton County",3,14,658,351,307
050,19,045,"Iowa","Clinton County",3,15,637,323,314
050,19,045,"Iowa","Clinton County",3,16,606,303,303
050,19,045,"Iowa","Clinton County",3,17,585,296,289
050,19,045,"Iowa","Clinton County",3,18,527,278,249
050,19,045,"Iowa","Clinton County",3,19,432,229,203
050,19,045,"Iowa","Clinton County",3,20,480,242,238
050,19,045,"Iowa","Clinton County",3,21,485,235,250
050,19,045,"Iowa","Clinton County",3,22,521,257,264
050,19,045,"Iowa","Clinton County",3,23,488,239,249
050,19,045,"Iowa","Clinton County",3,24,506,252,254
050,19,045,"Iowa","Clinton County",3,25,544,270,274
050,19,045,"Iowa","Clinton County",3,26,538,266,272
050,19,045,"Iowa","Clinton County",3,27,508,237,271
050,19,045,"Iowa","Clinton County",3,28,544,268,276
050,19,045,"Iowa","Clinton County",3,29,544,274,270
050,19,045,"Iowa","Clinton County",3,30,540,283,257
050,19,045,"Iowa","Clinton County",3,31,537,260,277
050,19,045,"Iowa","Clinton County",3,32,495,240,255
050,19,045,"Iowa","Clinton County",3,33,525,251,274
050,19,045,"Iowa","Clinton County",3,34,508,252,256
050,19,045,"Iowa","Clinton County",3,35,534,268,266
050,19,045,"Iowa","Clinton County",3,36,548,280,268
050,19,045,"Iowa","Clinton County",3,37,535,278,257
050,19,045,"Iowa","Clinton County",3,38,532,265,267
050,19,045,"Iowa","Clinton County",3,39,541,268,273
050,19,045,"Iowa","Clinton County",3,40,569,284,285
050,19,045,"Iowa","Clinton County",3,41,577,286,291
050,19,045,"Iowa","Clinton County",3,42,577,297,280
050,19,045,"Iowa","Clinton County",3,43,558,284,274
050,19,045,"Iowa","Clinton County",3,44,529,278,251
050,19,045,"Iowa","Clinton County",3,45,503,250,253
050,19,045,"Iowa","Clinton County",3,46,504,240,264
050,19,045,"Iowa","Clinton County",3,47,490,238,252
050,19,045,"Iowa","Clinton County",3,48,485,242,243
050,19,045,"Iowa","Clinton County",3,49,516,269,247
050,19,045,"Iowa","Clinton County",3,50,595,309,286
050,19,045,"Iowa","Clinton County",3,51,617,305,312
050,19,045,"Iowa","Clinton County",3,52,560,282,278
050,19,045,"Iowa","Clinton County",3,53,545,281,264
050,19,045,"Iowa","Clinton County",3,54,567,287,280
050,19,045,"Iowa","Clinton County",3,55,595,300,295
050,19,045,"Iowa","Clinton County",3,56,629,321,308
050,19,045,"Iowa","Clinton County",3,57,722,362,360
050,19,045,"Iowa","Clinton County",3,58,715,341,374
050,19,045,"Iowa","Clinton County",3,59,691,332,359
050,19,045,"Iowa","Clinton County",3,60,746,379,367
050,19,045,"Iowa","Clinton County",3,61,754,380,374
050,19,045,"Iowa","Clinton County",3,62,703,347,356
050,19,045,"Iowa","Clinton County",3,63,707,356,351
050,19,045,"Iowa","Clinton County",3,64,679,337,342
050,19,045,"Iowa","Clinton County",3,65,627,307,320
050,19,045,"Iowa","Clinton County",3,66,618,308,310
050,19,045,"Iowa","Clinton County",3,67,590,300,290
050,19,045,"Iowa","Clinton County",3,68,568,286,282
050,19,045,"Iowa","Clinton County",3,69,558,287,271
050,19,045,"Iowa","Clinton County",3,70,521,261,260
050,19,045,"Iowa","Clinton County",3,71,490,243,247
050,19,045,"Iowa","Clinton County",3,72,487,222,265
050,19,045,"Iowa","Clinton County",3,73,478,222,256
050,19,045,"Iowa","Clinton County",3,74,490,239,251
050,19,045,"Iowa","Clinton County",3,75,316,151,165
050,19,045,"Iowa","Clinton County",3,76,330,149,181
050,19,045,"Iowa","Clinton County",3,77,338,151,187
050,19,045,"Iowa","Clinton County",3,78,350,154,196
050,19,045,"Iowa","Clinton County",3,79,280,123,157
050,19,045,"Iowa","Clinton County",3,80,264,121,143
050,19,045,"Iowa","Clinton County",3,81,241,106,135
050,19,045,"Iowa","Clinton County",3,82,241,108,133
050,19,045,"Iowa","Clinton County",3,83,231,98,133
050,19,045,"Iowa","Clinton County",3,84,198,85,113
050,19,045,"Iowa","Clinton County",3,85,1095,379,716
050,19,045,"Iowa","Clinton County",4,0,549,293,256
050,19,045,"Iowa","Clinton County",4,1,492,250,242
050,19,045,"Iowa","Clinton County",4,2,502,265,237
050,19,045,"Iowa","Clinton County",4,3,523,272,251
050,19,045,"Iowa","Clinton County",4,4,541,277,264
050,19,045,"Iowa","Clinton County",4,5,557,268,289
050,19,045,"Iowa","Clinton County",4,6,610,291,319
050,19,045,"Iowa","Clinton County",4,7,599,295,304
050,19,045,"Iowa","Clinton County",4,8,576,306,270
050,19,045,"Iowa","Clinton County",4,9,588,306,282
050,19,045,"Iowa","Clinton County",4,10,601,322,279
050,19,045,"Iowa","Clinton County",4,11,618,313,305
050,19,045,"Iowa","Clinton County",4,12,636,311,325
050,19,045,"Iowa","Clinton County",4,13,633,335,298
050,19,045,"Iowa","Clinton County",4,14,676,354,322
050,19,045,"Iowa","Clinton County",4,15,668,348,320
050,19,045,"Iowa","Clinton County",4,16,645,339,306
050,19,045,"Iowa","Clinton County",4,17,632,315,317
050,19,045,"Iowa","Clinton County",4,18,486,258,228
050,19,045,"Iowa","Clinton County",4,19,406,216,190
050,19,045,"Iowa","Clinton County",4,20,446,231,215
050,19,045,"Iowa","Clinton County",4,21,475,238,237
050,19,045,"Iowa","Clinton County",4,22,503,248,255
050,19,045,"Iowa","Clinton County",4,23,512,247,265
050,19,045,"Iowa","Clinton County",4,24,486,241,245
050,19,045,"Iowa","Clinton County",4,25,501,249,252
050,19,045,"Iowa","Clinton County",4,26,527,260,267
050,19,045,"Iowa","Clinton County",4,27,533,272,261
050,19,045,"Iowa","Clinton County",4,28,498,230,268
050,19,045,"Iowa","Clinton County",4,29,553,267,286
050,19,045,"Iowa","Clinton County",4,30,549,282,267
050,19,045,"Iowa","Clinton County",4,31,565,297,268
050,19,045,"Iowa","Clinton County",4,32,537,267,270
050,19,045,"Iowa","Clinton County",4,33,485,236,249
050,19,045,"Iowa","Clinton County",4,34,527,254,273
050,19,045,"Iowa","Clinton County",4,35,527,260,267
050,19,045,"Iowa","Clinton County",4,36,533,265,268
050,19,045,"Iowa","Clinton County",4,37,570,296,274
050,19,045,"Iowa","Clinton County",4,38,533,275,258
050,19,045,"Iowa","Clinton County",4,39,528,264,264
050,19,045,"Iowa","Clinton County",4,40,526,256,270
050,19,045,"Iowa","Clinton County",4,41,560,289,271
050,19,045,"Iowa","Clinton County",4,42,567,278,289
050,19,045,"Iowa","Clinton County",4,43,569,296,273
050,19,045,"Iowa","Clinton County",4,44,561,286,275
050,19,045,"Iowa","Clinton County",4,45,515,263,252
050,19,045,"Iowa","Clinton County",4,46,504,245,259
050,19,045,"Iowa","Clinton County",4,47,509,249,260
050,19,045,"Iowa","Clinton County",4,48,498,241,257
050,19,045,"Iowa","Clinton County",4,49,490,244,246
050,19,045,"Iowa","Clinton County",4,50,511,266,245
050,19,045,"Iowa","Clinton County",4,51,611,308,303
050,19,045,"Iowa","Clinton County",4,52,622,308,314
050,19,045,"Iowa","Clinton County",4,53,550,275,275
050,19,045,"Iowa","Clinton County",4,54,547,276,271
050,19,045,"Iowa","Clinton County",4,55,569,284,285
050,19,045,"Iowa","Clinton County",4,56,592,301,291
050,19,045,"Iowa","Clinton County",4,57,634,330,304
050,19,045,"Iowa","Clinton County",4,58,710,352,358
050,19,045,"Iowa","Clinton County",4,59,704,333,371
050,19,045,"Iowa","Clinton County",4,60,682,326,356
050,19,045,"Iowa","Clinton County",4,61,747,380,367
050,19,045,"Iowa","Clinton County",4,62,749,382,367
050,19,045,"Iowa","Clinton County",4,63,683,340,343
050,19,045,"Iowa","Clinton County",4,64,699,349,350
050,19,045,"Iowa","Clinton County",4,65,663,323,340
050,19,045,"Iowa","Clinton County",4,66,614,302,312
050,19,045,"Iowa","Clinton County",4,67,604,299,305
050,19,045,"Iowa","Clinton County",4,68,573,293,280
050,19,045,"Iowa","Clinton County",4,69,562,281,281
050,19,045,"Iowa","Clinton County",4,70,550,285,265
050,19,045,"Iowa","Clinton County",4,71,501,256,245
050,19,045,"Iowa","Clinton County",4,72,480,230,250
050,19,045,"Iowa","Clinton County",4,73,469,212,257
050,19,045,"Iowa","Clinton County",4,74,465,215,250
050,19,045,"Iowa","Clinton County",4,75,458,221,237
050,19,045,"Iowa","Clinton County",4,76,298,140,158
050,19,045,"Iowa","Clinton County",4,77,313,142,171
050,19,045,"Iowa","Clinton County",4,78,316,138,178
050,19,045,"Iowa","Clinton County",4,79,332,148,184
050,19,045,"Iowa","Clinton County",4,80,269,115,154
050,19,045,"Iowa","Clinton County",4,81,250,119,131
050,19,045,"Iowa","Clinton County",4,82,224,99,125
050,19,045,"Iowa","Clinton County",4,83,208,91,117
050,19,045,"Iowa","Clinton County",4,84,207,82,125
050,19,045,"Iowa","Clinton County",4,85,1064,369,695
050,19,045,"Iowa","Clinton County",5,0,549,292,257
050,19,045,"Iowa","Clinton County",5,1,538,287,251
050,19,045,"Iowa","Clinton County",5,2,483,245,238
050,19,045,"Iowa","Clinton County",5,3,514,264,250
050,19,045,"Iowa","Clinton County",5,4,531,277,254
050,19,045,"Iowa","Clinton County",5,5,545,281,264
050,19,045,"Iowa","Clinton County",5,6,547,265,282
050,19,045,"Iowa","Clinton County",5,7,597,289,308
050,19,045,"Iowa","Clinton County",5,8,610,308,302
050,19,045,"Iowa","Clinton County",5,9,581,301,280
050,19,045,"Iowa","Clinton County",5,10,601,315,286
050,19,045,"Iowa","Clinton County",5,11,595,313,282
050,19,045,"Iowa","Clinton County",5,12,604,296,308
050,19,045,"Iowa","Clinton County",5,13,628,310,318
050,19,045,"Iowa","Clinton County",5,14,615,323,292
050,19,045,"Iowa","Clinton County",5,15,674,356,318
050,19,045,"Iowa","Clinton County",5,16,663,342,321
050,19,045,"Iowa","Clinton County",5,17,634,332,302
050,19,045,"Iowa","Clinton County",5,18,529,269,260
050,19,045,"Iowa","Clinton County",5,19,392,208,184
050,19,045,"Iowa","Clinton County",5,20,435,233,202
050,19,045,"Iowa","Clinton County",5,21,464,245,219
050,19,045,"Iowa","Clinton County",5,22,506,259,247
050,19,045,"Iowa","Clinton County",5,23,498,236,262
050,19,045,"Iowa","Clinton County",5,24,513,250,263
050,19,045,"Iowa","Clinton County",5,25,502,248,254
050,19,045,"Iowa","Clinton County",5,26,507,249,258
050,19,045,"Iowa","Clinton County",5,27,537,266,271
050,19,045,"Iowa","Clinton County",5,28,522,263,259
050,19,045,"Iowa","Clinton County",5,29,519,244,275
050,19,045,"Iowa","Clinton County",5,30,540,265,275
050,19,045,"Iowa","Clinton County",5,31,539,282,257
050,19,045,"Iowa","Clinton County",5,32,552,292,260
050,19,045,"Iowa","Clinton County",5,33,537,268,269
050,19,045,"Iowa","Clinton County",5,34,490,240,250
050,19,045,"Iowa","Clinton County",5,35,518,252,266
050,19,045,"Iowa","Clinton County",5,36,539,258,281
050,19,045,"Iowa","Clinton County",5,37,548,278,270
050,19,045,"Iowa","Clinton County",5,38,578,301,277
050,19,045,"Iowa","Clinton County",5,39,529,275,254
050,19,045,"Iowa","Clinton County",5,40,525,261,264
050,19,045,"Iowa","Clinton County",5,41,536,269,267
050,19,045,"Iowa","Clinton County",5,42,554,288,266
050,19,045,"Iowa","Clinton County",5,43,591,285,306
050,19,045,"Iowa","Clinton County",5,44,568,292,276
050,19,045,"Iowa","Clinton County",5,45,546,276,270
050,19,045,"Iowa","Clinton County",5,46,518,263,255
050,19,045,"Iowa","Clinton County",5,47,497,243,254
050,19,045,"Iowa","Clinton County",5,48,508,245,263
050,19,045,"Iowa","Clinton County",5,49,497,241,256
050,19,045,"Iowa","Clinton County",5,50,480,234,246
050,19,045,"Iowa","Clinton County",5,51,531,274,257
050,19,045,"Iowa","Clinton County",5,52,618,313,305
050,19,045,"Iowa","Clinton County",5,53,612,305,307
050,19,045,"Iowa","Clinton County",5,54,548,280,268
050,19,045,"Iowa","Clinton County",5,55,543,269,274
050,19,045,"Iowa","Clinton County",5,56,574,284,290
050,19,045,"Iowa","Clinton County",5,57,595,308,287
050,19,045,"Iowa","Clinton County",5,58,631,323,308
050,19,045,"Iowa","Clinton County",5,59,717,358,359
050,19,045,"Iowa","Clinton County",5,60,698,327,371
050,19,045,"Iowa","Clinton County",5,61,669,321,348
050,19,045,"Iowa","Clinton County",5,62,740,374,366
050,19,045,"Iowa","Clinton County",5,63,742,385,357
050,19,045,"Iowa","Clinton County",5,64,695,349,346
050,19,045,"Iowa","Clinton County",5,65,685,343,342
050,19,045,"Iowa","Clinton County",5,66,653,319,334
050,19,045,"Iowa","Clinton County",5,67,607,293,314
050,19,045,"Iowa","Clinton County",5,68,593,296,297
050,19,045,"Iowa","Clinton County",5,69,559,287,272
050,19,045,"Iowa","Clinton County",5,70,556,280,276
050,19,045,"Iowa","Clinton County",5,71,540,282,258
050,19,045,"Iowa","Clinton County",5,72,478,240,238
050,19,045,"Iowa","Clinton County",5,73,467,221,246
050,19,045,"Iowa","Clinton County",5,74,454,207,247
050,19,045,"Iowa","Clinton County",5,75,442,212,230
050,19,045,"Iowa","Clinton County",5,76,444,211,233
050,19,045,"Iowa","Clinton County",5,77,281,133,148
050,19,045,"Iowa","Clinton County",5,78,300,131,169
050,19,045,"Iowa","Clinton County",5,79,300,133,167
050,19,045,"Iowa","Clinton County",5,80,316,139,177
050,19,045,"Iowa","Clinton County",5,81,258,113,145
050,19,045,"Iowa","Clinton County",5,82,236,115,121
050,19,045,"Iowa","Clinton County",5,83,205,87,118
050,19,045,"Iowa","Clinton County",5,84,195,78,117
050,19,045,"Iowa","Clinton County",5,85,1053,358,695
050,19,047,"Iowa","Crawford County",1,0,215,110,105
050,19,047,"Iowa","Crawford County",1,1,219,108,111
050,19,047,"Iowa","Crawford County",1,2,212,102,110
050,19,047,"Iowa","Crawford County",1,3,234,110,124
050,19,047,"Iowa","Crawford County",1,4,246,112,134
050,19,047,"Iowa","Crawford County",1,5,228,120,108
050,19,047,"Iowa","Crawford County",1,6,241,127,114
050,19,047,"Iowa","Crawford County",1,7,227,113,114
050,19,047,"Iowa","Crawford County",1,8,260,122,138
050,19,047,"Iowa","Crawford County",1,9,211,104,107
050,19,047,"Iowa","Crawford County",1,10,243,137,106
050,19,047,"Iowa","Crawford County",1,11,240,124,116
050,19,047,"Iowa","Crawford County",1,12,240,118,122
050,19,047,"Iowa","Crawford County",1,13,236,120,116
050,19,047,"Iowa","Crawford County",1,14,223,115,108
050,19,047,"Iowa","Crawford County",1,15,233,128,105
050,19,047,"Iowa","Crawford County",1,16,248,132,116
050,19,047,"Iowa","Crawford County",1,17,248,131,117
050,19,047,"Iowa","Crawford County",1,18,249,140,109
050,19,047,"Iowa","Crawford County",1,19,222,118,104
050,19,047,"Iowa","Crawford County",1,20,216,114,102
050,19,047,"Iowa","Crawford County",1,21,207,109,98
050,19,047,"Iowa","Crawford County",1,22,209,107,102
050,19,047,"Iowa","Crawford County",1,23,207,106,101
050,19,047,"Iowa","Crawford County",1,24,189,101,88
050,19,047,"Iowa","Crawford County",1,25,198,92,106
050,19,047,"Iowa","Crawford County",1,26,191,97,94
050,19,047,"Iowa","Crawford County",1,27,180,93,87
050,19,047,"Iowa","Crawford County",1,28,225,96,129
050,19,047,"Iowa","Crawford County",1,29,226,108,118
050,19,047,"Iowa","Crawford County",1,30,168,81,87
050,19,047,"Iowa","Crawford County",1,31,190,86,104
050,19,047,"Iowa","Crawford County",1,32,217,109,108
050,19,047,"Iowa","Crawford County",1,33,201,110,91
050,19,047,"Iowa","Crawford County",1,34,196,109,87
050,19,047,"Iowa","Crawford County",1,35,193,116,77
050,19,047,"Iowa","Crawford County",1,36,177,95,82
050,19,047,"Iowa","Crawford County",1,37,180,101,79
050,19,047,"Iowa","Crawford County",1,38,163,93,70
050,19,047,"Iowa","Crawford County",1,39,197,115,82
050,19,047,"Iowa","Crawford County",1,40,214,120,94
050,19,047,"Iowa","Crawford County",1,41,191,104,87
050,19,047,"Iowa","Crawford County",1,42,179,96,83
050,19,047,"Iowa","Crawford County",1,43,175,89,86
050,19,047,"Iowa","Crawford County",1,44,184,103,81
050,19,047,"Iowa","Crawford County",1,45,178,94,84
050,19,047,"Iowa","Crawford County",1,46,175,87,88
050,19,047,"Iowa","Crawford County",1,47,203,113,90
050,19,047,"Iowa","Crawford County",1,48,204,114,90
050,19,047,"Iowa","Crawford County",1,49,198,105,93
050,19,047,"Iowa","Crawford County",1,50,213,112,101
050,19,047,"Iowa","Crawford County",1,51,189,96,93
050,19,047,"Iowa","Crawford County",1,52,182,98,84
050,19,047,"Iowa","Crawford County",1,53,165,82,83
050,19,047,"Iowa","Crawford County",1,54,169,82,87
050,19,047,"Iowa","Crawford County",1,55,202,101,101
050,19,047,"Iowa","Crawford County",1,56,223,117,106
050,19,047,"Iowa","Crawford County",1,57,226,121,105
050,19,047,"Iowa","Crawford County",1,58,223,116,107
050,19,047,"Iowa","Crawford County",1,59,230,126,104
050,19,047,"Iowa","Crawford County",1,60,229,129,100
050,19,047,"Iowa","Crawford County",1,61,237,125,112
050,19,047,"Iowa","Crawford County",1,62,212,109,103
050,19,047,"Iowa","Crawford County",1,63,204,108,96
050,19,047,"Iowa","Crawford County",1,64,217,114,103
050,19,047,"Iowa","Crawford County",1,65,205,109,96
050,19,047,"Iowa","Crawford County",1,66,187,95,92
050,19,047,"Iowa","Crawford County",1,67,183,91,92
050,19,047,"Iowa","Crawford County",1,68,179,96,83
050,19,047,"Iowa","Crawford County",1,69,167,94,73
050,19,047,"Iowa","Crawford County",1,70,158,84,74
050,19,047,"Iowa","Crawford County",1,71,135,72,63
050,19,047,"Iowa","Crawford County",1,72,139,70,69
050,19,047,"Iowa","Crawford County",1,73,160,80,80
050,19,047,"Iowa","Crawford County",1,74,115,54,61
050,19,047,"Iowa","Crawford County",1,75,109,53,56
050,19,047,"Iowa","Crawford County",1,76,109,55,54
050,19,047,"Iowa","Crawford County",1,77,115,57,58
050,19,047,"Iowa","Crawford County",1,78,103,49,54
050,19,047,"Iowa","Crawford County",1,79,83,40,43
050,19,047,"Iowa","Crawford County",1,80,76,40,36
050,19,047,"Iowa","Crawford County",1,81,66,32,34
050,19,047,"Iowa","Crawford County",1,82,68,23,45
050,19,047,"Iowa","Crawford County",1,83,59,21,38
050,19,047,"Iowa","Crawford County",1,84,59,22,37
050,19,047,"Iowa","Crawford County",1,85,417,147,270
050,19,047,"Iowa","Crawford County",2,0,227,115,112
050,19,047,"Iowa","Crawford County",2,1,217,108,109
050,19,047,"Iowa","Crawford County",2,2,212,102,110
050,19,047,"Iowa","Crawford County",2,3,228,109,119
050,19,047,"Iowa","Crawford County",2,4,241,111,130
050,19,047,"Iowa","Crawford County",2,5,230,117,113
050,19,047,"Iowa","Crawford County",2,6,235,123,112
050,19,047,"Iowa","Crawford County",2,7,232,118,114
050,19,047,"Iowa","Crawford County",2,8,248,118,130
050,19,047,"Iowa","Crawford County",2,9,222,107,115
050,19,047,"Iowa","Crawford County",2,10,234,127,107
050,19,047,"Iowa","Crawford County",2,11,239,127,112
050,19,047,"Iowa","Crawford County",2,12,240,119,121
050,19,047,"Iowa","Crawford County",2,13,238,120,118
050,19,047,"Iowa","Crawford County",2,14,227,117,110
050,19,047,"Iowa","Crawford County",2,15,228,124,104
050,19,047,"Iowa","Crawford County",2,16,244,130,114
050,19,047,"Iowa","Crawford County",2,17,250,134,116
050,19,047,"Iowa","Crawford County",2,18,246,137,109
050,19,047,"Iowa","Crawford County",2,19,223,121,102
050,19,047,"Iowa","Crawford County",2,20,219,115,104
050,19,047,"Iowa","Crawford County",2,21,208,109,99
050,19,047,"Iowa","Crawford County",2,22,203,104,99
050,19,047,"Iowa","Crawford County",2,23,205,105,100
050,19,047,"Iowa","Crawford County",2,24,193,102,91
050,19,047,"Iowa","Crawford County",2,25,197,95,102
050,19,047,"Iowa","Crawford County",2,26,192,95,97
050,19,047,"Iowa","Crawford County",2,27,181,93,88
050,19,047,"Iowa","Crawford County",2,28,213,95,118
050,19,047,"Iowa","Crawford County",2,29,225,104,121
050,19,047,"Iowa","Crawford County",2,30,183,89,94
050,19,047,"Iowa","Crawford County",2,31,185,85,100
050,19,047,"Iowa","Crawford County",2,32,209,103,106
050,19,047,"Iowa","Crawford County",2,33,205,109,96
050,19,047,"Iowa","Crawford County",2,34,199,110,89
050,19,047,"Iowa","Crawford County",2,35,194,115,79
050,19,047,"Iowa","Crawford County",2,36,180,100,80
050,19,047,"Iowa","Crawford County",2,37,179,100,79
050,19,047,"Iowa","Crawford County",2,38,166,94,72
050,19,047,"Iowa","Crawford County",2,39,188,110,78
050,19,047,"Iowa","Crawford County",2,40,211,119,92
050,19,047,"Iowa","Crawford County",2,41,193,106,87
050,19,047,"Iowa","Crawford County",2,42,182,98,84
050,19,047,"Iowa","Crawford County",2,43,176,91,85
050,19,047,"Iowa","Crawford County",2,44,182,100,82
050,19,047,"Iowa","Crawford County",2,45,177,96,81
050,19,047,"Iowa","Crawford County",2,46,177,90,87
050,19,047,"Iowa","Crawford County",2,47,196,107,89
050,19,047,"Iowa","Crawford County",2,48,202,113,89
050,19,047,"Iowa","Crawford County",2,49,201,109,92
050,19,047,"Iowa","Crawford County",2,50,208,109,99
050,19,047,"Iowa","Crawford County",2,51,192,98,94
050,19,047,"Iowa","Crawford County",2,52,184,98,86
050,19,047,"Iowa","Crawford County",2,53,166,85,81
050,19,047,"Iowa","Crawford County",2,54,168,82,86
050,19,047,"Iowa","Crawford County",2,55,193,96,97
050,19,047,"Iowa","Crawford County",2,56,217,112,105
050,19,047,"Iowa","Crawford County",2,57,222,117,105
050,19,047,"Iowa","Crawford County",2,58,225,118,107
050,19,047,"Iowa","Crawford County",2,59,230,125,105
050,19,047,"Iowa","Crawford County",2,60,226,128,98
050,19,047,"Iowa","Crawford County",2,61,233,126,107
050,19,047,"Iowa","Crawford County",2,62,220,115,105
050,19,047,"Iowa","Crawford County",2,63,205,107,98
050,19,047,"Iowa","Crawford County",2,64,212,112,100
050,19,047,"Iowa","Crawford County",2,65,206,110,96
050,19,047,"Iowa","Crawford County",2,66,190,96,94
050,19,047,"Iowa","Crawford County",2,67,181,90,91
050,19,047,"Iowa","Crawford County",2,68,179,95,84
050,19,047,"Iowa","Crawford County",2,69,168,92,76
050,19,047,"Iowa","Crawford County",2,70,160,87,73
050,19,047,"Iowa","Crawford County",2,71,140,74,66
050,19,047,"Iowa","Crawford County",2,72,132,67,65
050,19,047,"Iowa","Crawford County",2,73,163,82,81
050,19,047,"Iowa","Crawford County",2,74,117,55,62
050,19,047,"Iowa","Crawford County",2,75,110,53,57
050,19,047,"Iowa","Crawford County",2,76,106,52,54
050,19,047,"Iowa","Crawford County",2,77,115,58,57
050,19,047,"Iowa","Crawford County",2,78,104,50,54
050,19,047,"Iowa","Crawford County",2,79,86,42,44
050,19,047,"Iowa","Crawford County",2,80,77,40,37
050,19,047,"Iowa","Crawford County",2,81,67,33,34
050,19,047,"Iowa","Crawford County",2,82,68,25,43
050,19,047,"Iowa","Crawford County",2,83,60,21,39
050,19,047,"Iowa","Crawford County",2,84,58,22,36
050,19,047,"Iowa","Crawford County",2,85,414,146,268
050,19,047,"Iowa","Crawford County",3,0,218,117,101
050,19,047,"Iowa","Crawford County",3,1,221,119,102
050,19,047,"Iowa","Crawford County",3,2,214,110,104
050,19,047,"Iowa","Crawford County",3,3,207,106,101
050,19,047,"Iowa","Crawford County",3,4,205,94,111
050,19,047,"Iowa","Crawford County",3,5,228,104,124
050,19,047,"Iowa","Crawford County",3,6,223,112,111
050,19,047,"Iowa","Crawford County",3,7,237,131,106
050,19,047,"Iowa","Crawford County",3,8,229,119,110
050,19,047,"Iowa","Crawford County",3,9,240,116,124
050,19,047,"Iowa","Crawford County",3,10,215,101,114
050,19,047,"Iowa","Crawford County",3,11,225,123,102
050,19,047,"Iowa","Crawford County",3,12,229,120,109
050,19,047,"Iowa","Crawford County",3,13,243,126,117
050,19,047,"Iowa","Crawford County",3,14,230,117,113
050,19,047,"Iowa","Crawford County",3,15,222,109,113
050,19,047,"Iowa","Crawford County",3,16,228,123,105
050,19,047,"Iowa","Crawford County",3,17,265,149,116
050,19,047,"Iowa","Crawford County",3,18,244,135,109
050,19,047,"Iowa","Crawford County",3,19,223,129,94
050,19,047,"Iowa","Crawford County",3,20,210,109,101
050,19,047,"Iowa","Crawford County",3,21,220,111,109
050,19,047,"Iowa","Crawford County",3,22,188,105,83
050,19,047,"Iowa","Crawford County",3,23,196,98,98
050,19,047,"Iowa","Crawford County",3,24,191,106,85
050,19,047,"Iowa","Crawford County",3,25,183,95,88
050,19,047,"Iowa","Crawford County",3,26,185,95,90
050,19,047,"Iowa","Crawford County",3,27,178,84,94
050,19,047,"Iowa","Crawford County",3,28,181,92,89
050,19,047,"Iowa","Crawford County",3,29,203,89,114
050,19,047,"Iowa","Crawford County",3,30,225,107,118
050,19,047,"Iowa","Crawford County",3,31,176,85,91
050,19,047,"Iowa","Crawford County",3,32,187,91,96
050,19,047,"Iowa","Crawford County",3,33,192,95,97
050,19,047,"Iowa","Crawford County",3,34,212,115,97
050,19,047,"Iowa","Crawford County",3,35,189,105,84
050,19,047,"Iowa","Crawford County",3,36,190,113,77
050,19,047,"Iowa","Crawford County",3,37,172,90,82
050,19,047,"Iowa","Crawford County",3,38,177,100,77
050,19,047,"Iowa","Crawford County",3,39,176,102,74
050,19,047,"Iowa","Crawford County",3,40,186,108,78
050,19,047,"Iowa","Crawford County",3,41,203,116,87
050,19,047,"Iowa","Crawford County",3,42,188,105,83
050,19,047,"Iowa","Crawford County",3,43,179,93,86
050,19,047,"Iowa","Crawford County",3,44,182,94,88
050,19,047,"Iowa","Crawford County",3,45,169,93,76
050,19,047,"Iowa","Crawford County",3,46,177,100,77
050,19,047,"Iowa","Crawford County",3,47,190,106,84
050,19,047,"Iowa","Crawford County",3,48,192,100,92
050,19,047,"Iowa","Crawford County",3,49,199,111,88
050,19,047,"Iowa","Crawford County",3,50,204,112,92
050,19,047,"Iowa","Crawford County",3,51,199,104,95
050,19,047,"Iowa","Crawford County",3,52,188,96,92
050,19,047,"Iowa","Crawford County",3,53,188,99,89
050,19,047,"Iowa","Crawford County",3,54,174,90,84
050,19,047,"Iowa","Crawford County",3,55,166,84,82
050,19,047,"Iowa","Crawford County",3,56,198,100,98
050,19,047,"Iowa","Crawford County",3,57,205,104,101
050,19,047,"Iowa","Crawford County",3,58,222,118,104
050,19,047,"Iowa","Crawford County",3,59,221,118,103
050,19,047,"Iowa","Crawford County",3,60,230,124,106
050,19,047,"Iowa","Crawford County",3,61,214,120,94
050,19,047,"Iowa","Crawford County",3,62,232,123,109
050,19,047,"Iowa","Crawford County",3,63,206,113,93
050,19,047,"Iowa","Crawford County",3,64,195,101,94
050,19,047,"Iowa","Crawford County",3,65,206,110,96
050,19,047,"Iowa","Crawford County",3,66,209,111,98
050,19,047,"Iowa","Crawford County",3,67,189,96,93
050,19,047,"Iowa","Crawford County",3,68,183,89,94
050,19,047,"Iowa","Crawford County",3,69,172,91,81
050,19,047,"Iowa","Crawford County",3,70,165,89,76
050,19,047,"Iowa","Crawford County",3,71,157,83,74
050,19,047,"Iowa","Crawford County",3,72,135,71,64
050,19,047,"Iowa","Crawford County",3,73,128,64,64
050,19,047,"Iowa","Crawford County",3,74,160,77,83
050,19,047,"Iowa","Crawford County",3,75,109,50,59
050,19,047,"Iowa","Crawford County",3,76,110,51,59
050,19,047,"Iowa","Crawford County",3,77,99,49,50
050,19,047,"Iowa","Crawford County",3,78,108,51,57
050,19,047,"Iowa","Crawford County",3,79,95,48,47
050,19,047,"Iowa","Crawford County",3,80,82,39,43
050,19,047,"Iowa","Crawford County",3,81,64,32,32
050,19,047,"Iowa","Crawford County",3,82,68,33,35
050,19,047,"Iowa","Crawford County",3,83,62,21,41
050,19,047,"Iowa","Crawford County",3,84,53,21,32
050,19,047,"Iowa","Crawford County",3,85,394,135,259
050,19,047,"Iowa","Crawford County",4,0,241,118,123
050,19,047,"Iowa","Crawford County",4,1,223,116,107
050,19,047,"Iowa","Crawford County",4,2,220,112,108
050,19,047,"Iowa","Crawford County",4,3,208,108,100
050,19,047,"Iowa","Crawford County",4,4,189,92,97
050,19,047,"Iowa","Crawford County",4,5,213,97,116
050,19,047,"Iowa","Crawford County",4,6,234,111,123
050,19,047,"Iowa","Crawford County",4,7,239,128,111
050,19,047,"Iowa","Crawford County",4,8,227,125,102
050,19,047,"Iowa","Crawford County",4,9,221,113,108
050,19,047,"Iowa","Crawford County",4,10,234,111,123
050,19,047,"Iowa","Crawford County",4,11,205,96,109
050,19,047,"Iowa","Crawford County",4,12,223,120,103
050,19,047,"Iowa","Crawford County",4,13,224,114,110
050,19,047,"Iowa","Crawford County",4,14,237,122,115
050,19,047,"Iowa","Crawford County",4,15,221,115,106
050,19,047,"Iowa","Crawford County",4,16,231,118,113
050,19,047,"Iowa","Crawford County",4,17,257,144,113
050,19,047,"Iowa","Crawford County",4,18,262,151,111
050,19,047,"Iowa","Crawford County",4,19,211,119,92
050,19,047,"Iowa","Crawford County",4,20,212,119,93
050,19,047,"Iowa","Crawford County",4,21,190,100,90
050,19,047,"Iowa","Crawford County",4,22,209,100,109
050,19,047,"Iowa","Crawford County",4,23,190,97,93
050,19,047,"Iowa","Crawford County",4,24,188,97,91
050,19,047,"Iowa","Crawford County",4,25,179,102,77
050,19,047,"Iowa","Crawford County",4,26,179,89,90
050,19,047,"Iowa","Crawford County",4,27,192,94,98
050,19,047,"Iowa","Crawford County",4,28,172,79,93
050,19,047,"Iowa","Crawford County",4,29,183,91,92
050,19,047,"Iowa","Crawford County",4,30,194,86,108
050,19,047,"Iowa","Crawford County",4,31,224,105,119
050,19,047,"Iowa","Crawford County",4,32,179,89,90
050,19,047,"Iowa","Crawford County",4,33,190,94,96
050,19,047,"Iowa","Crawford County",4,34,197,96,101
050,19,047,"Iowa","Crawford County",4,35,206,115,91
050,19,047,"Iowa","Crawford County",4,36,178,96,82
050,19,047,"Iowa","Crawford County",4,37,193,117,76
050,19,047,"Iowa","Crawford County",4,38,165,90,75
050,19,047,"Iowa","Crawford County",4,39,181,105,76
050,19,047,"Iowa","Crawford County",4,40,167,96,71
050,19,047,"Iowa","Crawford County",4,41,182,102,80
050,19,047,"Iowa","Crawford County",4,42,202,117,85
050,19,047,"Iowa","Crawford County",4,43,190,109,81
050,19,047,"Iowa","Crawford County",4,44,182,97,85
050,19,047,"Iowa","Crawford County",4,45,183,97,86
050,19,047,"Iowa","Crawford County",4,46,175,95,80
050,19,047,"Iowa","Crawford County",4,47,170,98,72
050,19,047,"Iowa","Crawford County",4,48,180,95,85
050,19,047,"Iowa","Crawford County",4,49,185,96,89
050,19,047,"Iowa","Crawford County",4,50,199,111,88
050,19,047,"Iowa","Crawford County",4,51,201,107,94
050,19,047,"Iowa","Crawford County",4,52,195,103,92
050,19,047,"Iowa","Crawford County",4,53,187,94,93
050,19,047,"Iowa","Crawford County",4,54,189,100,89
050,19,047,"Iowa","Crawford County",4,55,171,90,81
050,19,047,"Iowa","Crawford County",4,56,164,83,81
050,19,047,"Iowa","Crawford County",4,57,196,101,95
050,19,047,"Iowa","Crawford County",4,58,207,105,102
050,19,047,"Iowa","Crawford County",4,59,220,118,102
050,19,047,"Iowa","Crawford County",4,60,228,122,106
050,19,047,"Iowa","Crawford County",4,61,228,121,107
050,19,047,"Iowa","Crawford County",4,62,213,116,97
050,19,047,"Iowa","Crawford County",4,63,224,121,103
050,19,047,"Iowa","Crawford County",4,64,208,112,96
050,19,047,"Iowa","Crawford County",4,65,188,98,90
050,19,047,"Iowa","Crawford County",4,66,203,110,93
050,19,047,"Iowa","Crawford County",4,67,195,106,89
050,19,047,"Iowa","Crawford County",4,68,185,92,93
050,19,047,"Iowa","Crawford County",4,69,180,89,91
050,19,047,"Iowa","Crawford County",4,70,164,89,75
050,19,047,"Iowa","Crawford County",4,71,159,81,78
050,19,047,"Iowa","Crawford County",4,72,149,78,71
050,19,047,"Iowa","Crawford County",4,73,130,70,60
050,19,047,"Iowa","Crawford County",4,74,124,60,64
050,19,047,"Iowa","Crawford County",4,75,154,75,79
050,19,047,"Iowa","Crawford County",4,76,108,47,61
050,19,047,"Iowa","Crawford County",4,77,103,47,56
050,19,047,"Iowa","Crawford County",4,78,94,43,51
050,19,047,"Iowa","Crawford County",4,79,100,47,53
050,19,047,"Iowa","Crawford County",4,80,90,49,41
050,19,047,"Iowa","Crawford County",4,81,70,33,37
050,19,047,"Iowa","Crawford County",4,82,66,31,35
050,19,047,"Iowa","Crawford County",4,83,61,30,31
050,19,047,"Iowa","Crawford County",4,84,53,20,33
050,19,047,"Iowa","Crawford County",4,85,386,136,250
050,19,047,"Iowa","Crawford County",5,0,234,113,121
050,19,047,"Iowa","Crawford County",5,1,235,111,124
050,19,047,"Iowa","Crawford County",5,2,214,107,107
050,19,047,"Iowa","Crawford County",5,3,219,113,106
050,19,047,"Iowa","Crawford County",5,4,190,98,92
050,19,047,"Iowa","Crawford County",5,5,182,88,94
050,19,047,"Iowa","Crawford County",5,6,209,97,112
050,19,047,"Iowa","Crawford County",5,7,232,121,111
050,19,047,"Iowa","Crawford County",5,8,234,123,111
050,19,047,"Iowa","Crawford County",5,9,221,124,97
050,19,047,"Iowa","Crawford County",5,10,222,115,107
050,19,047,"Iowa","Crawford County",5,11,224,104,120
050,19,047,"Iowa","Crawford County",5,12,204,97,107
050,19,047,"Iowa","Crawford County",5,13,226,117,109
050,19,047,"Iowa","Crawford County",5,14,215,113,102
050,19,047,"Iowa","Crawford County",5,15,224,115,109
050,19,047,"Iowa","Crawford County",5,16,226,118,108
050,19,047,"Iowa","Crawford County",5,17,252,136,116
050,19,047,"Iowa","Crawford County",5,18,257,148,109
050,19,047,"Iowa","Crawford County",5,19,230,137,93
050,19,047,"Iowa","Crawford County",5,20,199,110,89
050,19,047,"Iowa","Crawford County",5,21,195,104,91
050,19,047,"Iowa","Crawford County",5,22,188,99,89
050,19,047,"Iowa","Crawford County",5,23,204,91,113
050,19,047,"Iowa","Crawford County",5,24,186,93,93
050,19,047,"Iowa","Crawford County",5,25,181,89,92
050,19,047,"Iowa","Crawford County",5,26,166,97,69
050,19,047,"Iowa","Crawford County",5,27,175,88,87
050,19,047,"Iowa","Crawford County",5,28,186,91,95
050,19,047,"Iowa","Crawford County",5,29,161,76,85
050,19,047,"Iowa","Crawford County",5,30,174,87,87
050,19,047,"Iowa","Crawford County",5,31,203,88,115
050,19,047,"Iowa","Crawford County",5,32,222,103,119
050,19,047,"Iowa","Crawford County",5,33,175,90,85
050,19,047,"Iowa","Crawford County",5,34,187,92,95
050,19,047,"Iowa","Crawford County",5,35,198,96,102
050,19,047,"Iowa","Crawford County",5,36,200,112,88
050,19,047,"Iowa","Crawford County",5,37,173,93,80
050,19,047,"Iowa","Crawford County",5,38,192,117,75
050,19,047,"Iowa","Crawford County",5,39,164,89,75
050,19,047,"Iowa","Crawford County",5,40,174,101,73
050,19,047,"Iowa","Crawford County",5,41,164,91,73
050,19,047,"Iowa","Crawford County",5,42,180,101,79
050,19,047,"Iowa","Crawford County",5,43,193,112,81
050,19,047,"Iowa","Crawford County",5,44,188,103,85
050,19,047,"Iowa","Crawford County",5,45,173,97,76
050,19,047,"Iowa","Crawford County",5,46,185,100,85
050,19,047,"Iowa","Crawford County",5,47,181,102,79
050,19,047,"Iowa","Crawford County",5,48,170,99,71
050,19,047,"Iowa","Crawford County",5,49,177,92,85
050,19,047,"Iowa","Crawford County",5,50,184,99,85
050,19,047,"Iowa","Crawford County",5,51,199,109,90
050,19,047,"Iowa","Crawford County",5,52,208,109,99
050,19,047,"Iowa","Crawford County",5,53,195,103,92
050,19,047,"Iowa","Crawford County",5,54,195,96,99
050,19,047,"Iowa","Crawford County",5,55,189,101,88
050,19,047,"Iowa","Crawford County",5,56,166,89,77
050,19,047,"Iowa","Crawford County",5,57,161,82,79
050,19,047,"Iowa","Crawford County",5,58,195,100,95
050,19,047,"Iowa","Crawford County",5,59,207,106,101
050,19,047,"Iowa","Crawford County",5,60,226,118,108
050,19,047,"Iowa","Crawford County",5,61,232,123,109
050,19,047,"Iowa","Crawford County",5,62,232,121,111
050,19,047,"Iowa","Crawford County",5,63,208,116,92
050,19,047,"Iowa","Crawford County",5,64,218,119,99
050,19,047,"Iowa","Crawford County",5,65,206,110,96
050,19,047,"Iowa","Crawford County",5,66,185,99,86
050,19,047,"Iowa","Crawford County",5,67,200,110,90
050,19,047,"Iowa","Crawford County",5,68,192,105,87
050,19,047,"Iowa","Crawford County",5,69,180,88,92
050,19,047,"Iowa","Crawford County",5,70,177,87,90
050,19,047,"Iowa","Crawford County",5,71,155,82,73
050,19,047,"Iowa","Crawford County",5,72,157,79,78
050,19,047,"Iowa","Crawford County",5,73,142,76,66
050,19,047,"Iowa","Crawford County",5,74,131,68,63
050,19,047,"Iowa","Crawford County",5,75,120,58,62
050,19,047,"Iowa","Crawford County",5,76,154,73,81
050,19,047,"Iowa","Crawford County",5,77,102,45,57
050,19,047,"Iowa","Crawford County",5,78,100,42,58
050,19,047,"Iowa","Crawford County",5,79,88,40,48
050,19,047,"Iowa","Crawford County",5,80,97,48,49
050,19,047,"Iowa","Crawford County",5,81,81,45,36
050,19,047,"Iowa","Crawford County",5,82,71,32,39
050,19,047,"Iowa","Crawford County",5,83,61,29,32
050,19,047,"Iowa","Crawford County",5,84,54,28,26
050,19,047,"Iowa","Crawford County",5,85,381,128,253
050,19,049,"Iowa","Dallas County",1,0,1324,681,643
050,19,049,"Iowa","Dallas County",1,1,1324,696,628
050,19,049,"Iowa","Dallas County",1,2,1384,695,689
050,19,049,"Iowa","Dallas County",1,3,1535,790,745
050,19,049,"Iowa","Dallas County",1,4,1550,787,763
050,19,049,"Iowa","Dallas County",1,5,1579,820,759
050,19,049,"Iowa","Dallas County",1,6,1619,830,789
050,19,049,"Iowa","Dallas County",1,7,1610,827,783
050,19,049,"Iowa","Dallas County",1,8,1535,790,745
050,19,049,"Iowa","Dallas County",1,9,1568,827,741
050,19,049,"Iowa","Dallas County",1,10,1632,813,819
050,19,049,"Iowa","Dallas County",1,11,1632,811,821
050,19,049,"Iowa","Dallas County",1,12,1629,850,779
050,19,049,"Iowa","Dallas County",1,13,1561,793,768
050,19,049,"Iowa","Dallas County",1,14,1543,789,754
050,19,049,"Iowa","Dallas County",1,15,1454,744,710
050,19,049,"Iowa","Dallas County",1,16,1407,703,704
050,19,049,"Iowa","Dallas County",1,17,1395,684,711
050,19,049,"Iowa","Dallas County",1,18,1116,575,541
050,19,049,"Iowa","Dallas County",1,19,862,453,409
050,19,049,"Iowa","Dallas County",1,20,948,494,454
050,19,049,"Iowa","Dallas County",1,21,945,488,457
050,19,049,"Iowa","Dallas County",1,22,996,499,497
050,19,049,"Iowa","Dallas County",1,23,1190,582,608
050,19,049,"Iowa","Dallas County",1,24,1304,606,698
050,19,049,"Iowa","Dallas County",1,25,1363,660,703
050,19,049,"Iowa","Dallas County",1,26,1377,705,672
050,19,049,"Iowa","Dallas County",1,27,1367,665,702
050,19,049,"Iowa","Dallas County",1,28,1407,728,679
050,19,049,"Iowa","Dallas County",1,29,1370,680,690
050,19,049,"Iowa","Dallas County",1,30,1357,667,690
050,19,049,"Iowa","Dallas County",1,31,1390,689,701
050,19,049,"Iowa","Dallas County",1,32,1454,730,724
050,19,049,"Iowa","Dallas County",1,33,1506,743,763
050,19,049,"Iowa","Dallas County",1,34,1651,810,841
050,19,049,"Iowa","Dallas County",1,35,1667,828,839
050,19,049,"Iowa","Dallas County",1,36,1695,857,838
050,19,049,"Iowa","Dallas County",1,37,1770,908,862
050,19,049,"Iowa","Dallas County",1,38,1651,818,833
050,19,049,"Iowa","Dallas County",1,39,1747,860,887
050,19,049,"Iowa","Dallas County",1,40,1753,893,860
050,19,049,"Iowa","Dallas County",1,41,1655,836,819
050,19,049,"Iowa","Dallas County",1,42,1580,817,763
050,19,049,"Iowa","Dallas County",1,43,1434,730,704
050,19,049,"Iowa","Dallas County",1,44,1357,719,638
050,19,049,"Iowa","Dallas County",1,45,1295,684,611
050,19,049,"Iowa","Dallas County",1,46,1241,632,609
050,19,049,"Iowa","Dallas County",1,47,1228,631,597
050,19,049,"Iowa","Dallas County",1,48,1282,636,646
050,19,049,"Iowa","Dallas County",1,49,1394,723,671
050,19,049,"Iowa","Dallas County",1,50,1296,674,622
050,19,049,"Iowa","Dallas County",1,51,1247,605,642
050,19,049,"Iowa","Dallas County",1,52,1162,579,583
050,19,049,"Iowa","Dallas County",1,53,1130,585,545
050,19,049,"Iowa","Dallas County",1,54,1109,569,540
050,19,049,"Iowa","Dallas County",1,55,1131,568,563
050,19,049,"Iowa","Dallas County",1,56,1115,570,545
050,19,049,"Iowa","Dallas County",1,57,1001,501,500
050,19,049,"Iowa","Dallas County",1,58,1043,509,534
050,19,049,"Iowa","Dallas County",1,59,1033,523,510
050,19,049,"Iowa","Dallas County",1,60,1028,529,499
050,19,049,"Iowa","Dallas County",1,61,980,459,521
050,19,049,"Iowa","Dallas County",1,62,914,449,465
050,19,049,"Iowa","Dallas County",1,63,913,428,485
050,19,049,"Iowa","Dallas County",1,64,860,404,456
050,19,049,"Iowa","Dallas County",1,65,850,394,456
050,19,049,"Iowa","Dallas County",1,66,859,394,465
050,19,049,"Iowa","Dallas County",1,67,816,378,438
050,19,049,"Iowa","Dallas County",1,68,799,363,436
050,19,049,"Iowa","Dallas County",1,69,725,337,388
050,19,049,"Iowa","Dallas County",1,70,724,331,393
050,19,049,"Iowa","Dallas County",1,71,720,322,398
050,19,049,"Iowa","Dallas County",1,72,675,314,361
050,19,049,"Iowa","Dallas County",1,73,662,316,346
050,19,049,"Iowa","Dallas County",1,74,461,212,249
050,19,049,"Iowa","Dallas County",1,75,441,192,249
050,19,049,"Iowa","Dallas County",1,76,405,189,216
050,19,049,"Iowa","Dallas County",1,77,411,181,230
050,19,049,"Iowa","Dallas County",1,78,380,175,205
050,19,049,"Iowa","Dallas County",1,79,334,152,182
050,19,049,"Iowa","Dallas County",1,80,292,121,171
050,19,049,"Iowa","Dallas County",1,81,298,113,185
050,19,049,"Iowa","Dallas County",1,82,251,108,143
050,19,049,"Iowa","Dallas County",1,83,248,95,153
050,19,049,"Iowa","Dallas County",1,84,249,94,155
050,19,049,"Iowa","Dallas County",1,85,1537,516,1021
050,19,049,"Iowa","Dallas County",2,0,1302,686,616
050,19,049,"Iowa","Dallas County",2,1,1336,700,636
050,19,049,"Iowa","Dallas County",2,2,1387,704,683
050,19,049,"Iowa","Dallas County",2,3,1504,771,733
050,19,049,"Iowa","Dallas County",2,4,1563,795,768
050,19,049,"Iowa","Dallas County",2,5,1581,815,766
050,19,049,"Iowa","Dallas County",2,6,1625,835,790
050,19,049,"Iowa","Dallas County",2,7,1616,832,784
050,19,049,"Iowa","Dallas County",2,8,1553,802,751
050,19,049,"Iowa","Dallas County",2,9,1568,820,748
050,19,049,"Iowa","Dallas County",2,10,1622,818,804
050,19,049,"Iowa","Dallas County",2,11,1637,816,821
050,19,049,"Iowa","Dallas County",2,12,1636,845,791
050,19,049,"Iowa","Dallas County",2,13,1583,813,770
050,19,049,"Iowa","Dallas County",2,14,1547,788,759
050,19,049,"Iowa","Dallas County",2,15,1478,754,724
050,19,049,"Iowa","Dallas County",2,16,1425,715,710
050,19,049,"Iowa","Dallas County",2,17,1395,688,707
050,19,049,"Iowa","Dallas County",2,18,1128,578,550
050,19,049,"Iowa","Dallas County",2,19,881,459,422
050,19,049,"Iowa","Dallas County",2,20,961,502,459
050,19,049,"Iowa","Dallas County",2,21,966,498,468
050,19,049,"Iowa","Dallas County",2,22,1033,521,512
050,19,049,"Iowa","Dallas County",2,23,1201,589,612
050,19,049,"Iowa","Dallas County",2,24,1326,626,700
050,19,049,"Iowa","Dallas County",2,25,1376,664,712
050,19,049,"Iowa","Dallas County",2,26,1390,702,688
050,19,049,"Iowa","Dallas County",2,27,1387,689,698
050,19,049,"Iowa","Dallas County",2,28,1407,722,685
050,19,049,"Iowa","Dallas County",2,29,1387,697,690
050,19,049,"Iowa","Dallas County",2,30,1379,677,702
050,19,049,"Iowa","Dallas County",2,31,1400,694,706
050,19,049,"Iowa","Dallas County",2,32,1451,726,725
050,19,049,"Iowa","Dallas County",2,33,1509,748,761
050,19,049,"Iowa","Dallas County",2,34,1623,797,826
050,19,049,"Iowa","Dallas County",2,35,1682,837,845
050,19,049,"Iowa","Dallas County",2,36,1693,851,842
050,19,049,"Iowa","Dallas County",2,37,1761,900,861
050,19,049,"Iowa","Dallas County",2,38,1692,848,844
050,19,049,"Iowa","Dallas County",2,39,1728,853,875
050,19,049,"Iowa","Dallas County",2,40,1770,894,876
050,19,049,"Iowa","Dallas County",2,41,1689,854,835
050,19,049,"Iowa","Dallas County",2,42,1596,820,776
050,19,049,"Iowa","Dallas County",2,43,1487,760,727
050,19,049,"Iowa","Dallas County",2,44,1364,715,649
050,19,049,"Iowa","Dallas County",2,45,1321,699,622
050,19,049,"Iowa","Dallas County",2,46,1260,648,612
050,19,049,"Iowa","Dallas County",2,47,1236,636,600
050,19,049,"Iowa","Dallas County",2,48,1270,635,635
050,19,049,"Iowa","Dallas County",2,49,1374,707,667
050,19,049,"Iowa","Dallas County",2,50,1327,689,638
050,19,049,"Iowa","Dallas County",2,51,1262,623,639
050,19,049,"Iowa","Dallas County",2,52,1184,588,596
050,19,049,"Iowa","Dallas County",2,53,1144,587,557
050,19,049,"Iowa","Dallas County",2,54,1113,570,543
050,19,049,"Iowa","Dallas County",2,55,1132,569,563
050,19,049,"Iowa","Dallas County",2,56,1122,570,552
050,19,049,"Iowa","Dallas County",2,57,1037,524,513
050,19,049,"Iowa","Dallas County",2,58,1031,505,526
050,19,049,"Iowa","Dallas County",2,59,1044,524,520
050,19,049,"Iowa","Dallas County",2,60,1026,522,504
050,19,049,"Iowa","Dallas County",2,61,994,477,517
050,19,049,"Iowa","Dallas County",2,62,939,455,484
050,19,049,"Iowa","Dallas County",2,63,927,439,488
050,19,049,"Iowa","Dallas County",2,64,875,411,464
050,19,049,"Iowa","Dallas County",2,65,856,397,459
050,19,049,"Iowa","Dallas County",2,66,864,396,468
050,19,049,"Iowa","Dallas County",2,67,826,382,444
050,19,049,"Iowa","Dallas County",2,68,799,364,435
050,19,049,"Iowa","Dallas County",2,69,756,349,407
050,19,049,"Iowa","Dallas County",2,70,726,332,394
050,19,049,"Iowa","Dallas County",2,71,723,323,400
050,19,049,"Iowa","Dallas County",2,72,680,311,369
050,19,049,"Iowa","Dallas County",2,73,705,335,370
050,19,049,"Iowa","Dallas County",2,74,473,217,256
050,19,049,"Iowa","Dallas County",2,75,452,199,253
050,19,049,"Iowa","Dallas County",2,76,411,187,224
050,19,049,"Iowa","Dallas County",2,77,418,186,232
050,19,049,"Iowa","Dallas County",2,78,380,171,209
050,19,049,"Iowa","Dallas County",2,79,342,156,186
050,19,049,"Iowa","Dallas County",2,80,301,125,176
050,19,049,"Iowa","Dallas County",2,81,293,112,181
050,19,049,"Iowa","Dallas County",2,82,255,104,151
050,19,049,"Iowa","Dallas County",2,83,241,94,147
050,19,049,"Iowa","Dallas County",2,84,246,93,153
050,19,049,"Iowa","Dallas County",2,85,1546,517,1029
050,19,049,"Iowa","Dallas County",3,0,1336,690,646
050,19,049,"Iowa","Dallas County",3,1,1369,717,652
050,19,049,"Iowa","Dallas County",3,2,1416,723,693
050,19,049,"Iowa","Dallas County",3,3,1471,735,736
050,19,049,"Iowa","Dallas County",3,4,1576,814,762
050,19,049,"Iowa","Dallas County",3,5,1603,807,796
050,19,049,"Iowa","Dallas County",3,6,1654,852,802
050,19,049,"Iowa","Dallas County",3,7,1659,860,799
050,19,049,"Iowa","Dallas County",3,8,1644,852,792
050,19,049,"Iowa","Dallas County",3,9,1581,795,786
050,19,049,"Iowa","Dallas County",3,10,1605,838,767
050,19,049,"Iowa","Dallas County",3,11,1659,828,831
050,19,049,"Iowa","Dallas County",3,12,1657,816,841
050,19,049,"Iowa","Dallas County",3,13,1682,877,805
050,19,049,"Iowa","Dallas County",3,14,1611,814,797
050,19,049,"Iowa","Dallas County",3,15,1563,779,784
050,19,049,"Iowa","Dallas County",3,16,1522,787,735
050,19,049,"Iowa","Dallas County",3,17,1446,731,715
050,19,049,"Iowa","Dallas County",3,18,1216,638,578
050,19,049,"Iowa","Dallas County",3,19,925,473,452
050,19,049,"Iowa","Dallas County",3,20,972,492,480
050,19,049,"Iowa","Dallas County",3,21,1044,534,510
050,19,049,"Iowa","Dallas County",3,22,1065,519,546
050,19,049,"Iowa","Dallas County",3,23,1258,624,634
050,19,049,"Iowa","Dallas County",3,24,1329,648,681
050,19,049,"Iowa","Dallas County",3,25,1463,732,731
050,19,049,"Iowa","Dallas County",3,26,1428,703,725
050,19,049,"Iowa","Dallas County",3,27,1419,719,700
050,19,049,"Iowa","Dallas County",3,28,1454,735,719
050,19,049,"Iowa","Dallas County",3,29,1516,776,740
050,19,049,"Iowa","Dallas County",3,30,1457,708,749
050,19,049,"Iowa","Dallas County",3,31,1431,708,723
050,19,049,"Iowa","Dallas County",3,32,1432,723,709
050,19,049,"Iowa","Dallas County",3,33,1558,796,762
050,19,049,"Iowa","Dallas County",3,34,1590,795,795
050,19,049,"Iowa","Dallas County",3,35,1710,844,866
050,19,049,"Iowa","Dallas County",3,36,1707,852,855
050,19,049,"Iowa","Dallas County",3,37,1726,866,860
050,19,049,"Iowa","Dallas County",3,38,1832,937,895
050,19,049,"Iowa","Dallas County",3,39,1750,883,867
050,19,049,"Iowa","Dallas County",3,40,1786,896,890
050,19,049,"Iowa","Dallas County",3,41,1798,909,889
050,19,049,"Iowa","Dallas County",3,42,1694,854,840
050,19,049,"Iowa","Dallas County",3,43,1619,849,770
050,19,049,"Iowa","Dallas County",3,44,1494,771,723
050,19,049,"Iowa","Dallas County",3,45,1368,709,659
050,19,049,"Iowa","Dallas County",3,46,1336,704,632
050,19,049,"Iowa","Dallas County",3,47,1269,653,616
050,19,049,"Iowa","Dallas County",3,48,1288,651,637
050,19,049,"Iowa","Dallas County",3,49,1296,643,653
050,19,049,"Iowa","Dallas County",3,50,1370,700,670
050,19,049,"Iowa","Dallas County",3,51,1368,699,669
050,19,049,"Iowa","Dallas County",3,52,1265,632,633
050,19,049,"Iowa","Dallas County",3,53,1216,597,619
050,19,049,"Iowa","Dallas County",3,54,1145,595,550
050,19,049,"Iowa","Dallas County",3,55,1134,587,547
050,19,049,"Iowa","Dallas County",3,56,1160,580,580
050,19,049,"Iowa","Dallas County",3,57,1152,589,563
050,19,049,"Iowa","Dallas County",3,58,1013,504,509
050,19,049,"Iowa","Dallas County",3,59,1011,502,509
050,19,049,"Iowa","Dallas County",3,60,1071,536,535
050,19,049,"Iowa","Dallas County",3,61,1045,537,508
050,19,049,"Iowa","Dallas County",3,62,1041,494,547
050,19,049,"Iowa","Dallas County",3,63,969,460,509
050,19,049,"Iowa","Dallas County",3,64,942,437,505
050,19,049,"Iowa","Dallas County",3,65,908,429,479
050,19,049,"Iowa","Dallas County",3,66,886,405,481
050,19,049,"Iowa","Dallas County",3,67,852,398,454
050,19,049,"Iowa","Dallas County",3,68,835,384,451
050,19,049,"Iowa","Dallas County",3,69,804,365,439
050,19,049,"Iowa","Dallas County",3,70,764,360,404
050,19,049,"Iowa","Dallas County",3,71,711,323,388
050,19,049,"Iowa","Dallas County",3,72,718,321,397
050,19,049,"Iowa","Dallas County",3,73,676,313,363
050,19,049,"Iowa","Dallas County",3,74,702,326,376
050,19,049,"Iowa","Dallas County",3,75,469,215,254
050,19,049,"Iowa","Dallas County",3,76,452,198,254
050,19,049,"Iowa","Dallas County",3,77,412,181,231
050,19,049,"Iowa","Dallas County",3,78,415,180,235
050,19,049,"Iowa","Dallas County",3,79,371,163,208
050,19,049,"Iowa","Dallas County",3,80,336,151,185
050,19,049,"Iowa","Dallas County",3,81,298,110,188
050,19,049,"Iowa","Dallas County",3,82,261,105,156
050,19,049,"Iowa","Dallas County",3,83,244,101,143
050,19,049,"Iowa","Dallas County",3,84,242,88,154
050,19,049,"Iowa","Dallas County",3,85,1632,543,1089
050,19,049,"Iowa","Dallas County",4,0,1392,696,696
050,19,049,"Iowa","Dallas County",4,1,1449,748,701
050,19,049,"Iowa","Dallas County",4,2,1467,740,727
050,19,049,"Iowa","Dallas County",4,3,1521,792,729
050,19,049,"Iowa","Dallas County",4,4,1524,751,773
050,19,049,"Iowa","Dallas County",4,5,1660,848,812
050,19,049,"Iowa","Dallas County",4,6,1645,839,806
050,19,049,"Iowa","Dallas County",4,7,1667,851,816
050,19,049,"Iowa","Dallas County",4,8,1714,889,825
050,19,049,"Iowa","Dallas County",4,9,1710,887,823
050,19,049,"Iowa","Dallas County",4,10,1634,824,810
050,19,049,"Iowa","Dallas County",4,11,1613,854,759
050,19,049,"Iowa","Dallas County",4,12,1703,859,844
050,19,049,"Iowa","Dallas County",4,13,1691,846,845
050,19,049,"Iowa","Dallas County",4,14,1723,892,831
050,19,049,"Iowa","Dallas County",4,15,1666,838,828
050,19,049,"Iowa","Dallas County",4,16,1617,821,796
050,19,049,"Iowa","Dallas County",4,17,1537,793,744
050,19,049,"Iowa","Dallas County",4,18,1253,666,587
050,19,049,"Iowa","Dallas County",4,19,945,496,449
050,19,049,"Iowa","Dallas County",4,20,983,503,480
050,19,049,"Iowa","Dallas County",4,21,1034,522,512
050,19,049,"Iowa","Dallas County",4,22,1187,587,600
050,19,049,"Iowa","Dallas County",4,23,1234,615,619
050,19,049,"Iowa","Dallas County",4,24,1402,680,722
050,19,049,"Iowa","Dallas County",4,25,1436,693,743
050,19,049,"Iowa","Dallas County",4,26,1521,765,756
050,19,049,"Iowa","Dallas County",4,27,1512,748,764
050,19,049,"Iowa","Dallas County",4,28,1468,755,713
050,19,049,"Iowa","Dallas County",4,29,1510,790,720
050,19,049,"Iowa","Dallas County",4,30,1588,802,786
050,19,049,"Iowa","Dallas County",4,31,1568,768,800
050,19,049,"Iowa","Dallas County",4,32,1556,777,779
050,19,049,"Iowa","Dallas County",4,33,1515,760,755
050,19,049,"Iowa","Dallas County",4,34,1677,866,811
050,19,049,"Iowa","Dallas County",4,35,1689,846,843
050,19,049,"Iowa","Dallas County",4,36,1777,886,891
050,19,049,"Iowa","Dallas County",4,37,1801,915,886
050,19,049,"Iowa","Dallas County",4,38,1783,885,898
050,19,049,"Iowa","Dallas County",4,39,1857,956,901
050,19,049,"Iowa","Dallas County",4,40,1812,920,892
050,19,049,"Iowa","Dallas County",4,41,1805,908,897
050,19,049,"Iowa","Dallas County",4,42,1828,932,896
050,19,049,"Iowa","Dallas County",4,43,1702,857,845
050,19,049,"Iowa","Dallas County",4,44,1625,842,783
050,19,049,"Iowa","Dallas County",4,45,1503,774,729
050,19,049,"Iowa","Dallas County",4,46,1370,711,659
050,19,049,"Iowa","Dallas County",4,47,1378,717,661
050,19,049,"Iowa","Dallas County",4,48,1312,669,643
050,19,049,"Iowa","Dallas County",4,49,1282,654,628
050,19,049,"Iowa","Dallas County",4,50,1301,637,664
050,19,049,"Iowa","Dallas County",4,51,1437,738,699
050,19,049,"Iowa","Dallas County",4,52,1373,697,676
050,19,049,"Iowa","Dallas County",4,53,1295,645,650
050,19,049,"Iowa","Dallas County",4,54,1210,592,618
050,19,049,"Iowa","Dallas County",4,55,1154,600,554
050,19,049,"Iowa","Dallas County",4,56,1157,602,555
050,19,049,"Iowa","Dallas County",4,57,1196,604,592
050,19,049,"Iowa","Dallas County",4,58,1162,586,576
050,19,049,"Iowa","Dallas County",4,59,1059,526,533
050,19,049,"Iowa","Dallas County",4,60,1034,504,530
050,19,049,"Iowa","Dallas County",4,61,1065,522,543
050,19,049,"Iowa","Dallas County",4,62,1047,539,508
050,19,049,"Iowa","Dallas County",4,63,1041,492,549
050,19,049,"Iowa","Dallas County",4,64,972,470,502
050,19,049,"Iowa","Dallas County",4,65,949,430,519
050,19,049,"Iowa","Dallas County",4,66,904,426,478
050,19,049,"Iowa","Dallas County",4,67,894,404,490
050,19,049,"Iowa","Dallas County",4,68,843,388,455
050,19,049,"Iowa","Dallas County",4,69,849,385,464
050,19,049,"Iowa","Dallas County",4,70,807,372,435
050,19,049,"Iowa","Dallas County",4,71,771,353,418
050,19,049,"Iowa","Dallas County",4,72,702,314,388
050,19,049,"Iowa","Dallas County",4,73,724,319,405
050,19,049,"Iowa","Dallas County",4,74,670,310,360
050,19,049,"Iowa","Dallas County",4,75,709,328,381
050,19,049,"Iowa","Dallas County",4,76,475,217,258
050,19,049,"Iowa","Dallas County",4,77,454,197,257
050,19,049,"Iowa","Dallas County",4,78,417,183,234
050,19,049,"Iowa","Dallas County",4,79,420,183,237
050,19,049,"Iowa","Dallas County",4,80,359,163,196
050,19,049,"Iowa","Dallas County",4,81,337,137,200
050,19,049,"Iowa","Dallas County",4,82,287,107,180
050,19,049,"Iowa","Dallas County",4,83,258,106,152
050,19,049,"Iowa","Dallas County",4,84,250,94,156
050,19,049,"Iowa","Dallas County",4,85,1718,566,1152
050,19,049,"Iowa","Dallas County",5,0,1405,702,703
050,19,049,"Iowa","Dallas County",5,1,1448,725,723
050,19,049,"Iowa","Dallas County",5,2,1473,758,715
050,19,049,"Iowa","Dallas County",5,3,1496,747,749
050,19,049,"Iowa","Dallas County",5,4,1558,812,746
050,19,049,"Iowa","Dallas County",5,5,1576,790,786
050,19,049,"Iowa","Dallas County",5,6,1683,864,819
050,19,049,"Iowa","Dallas County",5,7,1667,843,824
050,19,049,"Iowa","Dallas County",5,8,1713,883,830
050,19,049,"Iowa","Dallas County",5,9,1733,900,833
050,19,049,"Iowa","Dallas County",5,10,1706,890,816
050,19,049,"Iowa","Dallas County",5,11,1665,832,833
050,19,049,"Iowa","Dallas County",5,12,1669,870,799
050,19,049,"Iowa","Dallas County",5,13,1712,858,854
050,19,049,"Iowa","Dallas County",5,14,1727,846,881
050,19,049,"Iowa","Dallas County",5,15,1719,899,820
050,19,049,"Iowa","Dallas County",5,16,1681,845,836
050,19,049,"Iowa","Dallas County",5,17,1623,820,803
050,19,049,"Iowa","Dallas County",5,18,1313,699,614
050,19,049,"Iowa","Dallas County",5,19,1002,525,477
050,19,049,"Iowa","Dallas County",5,20,1054,557,497
050,19,049,"Iowa","Dallas County",5,21,1058,551,507
050,19,049,"Iowa","Dallas County",5,22,1187,568,619
050,19,049,"Iowa","Dallas County",5,23,1355,669,686
050,19,049,"Iowa","Dallas County",5,24,1415,698,717
050,19,049,"Iowa","Dallas County",5,25,1504,752,752
050,19,049,"Iowa","Dallas County",5,26,1499,730,769
050,19,049,"Iowa","Dallas County",5,27,1599,794,805
050,19,049,"Iowa","Dallas County",5,28,1546,754,792
050,19,049,"Iowa","Dallas County",5,29,1518,799,719
050,19,049,"Iowa","Dallas County",5,30,1573,809,764
050,19,049,"Iowa","Dallas County",5,31,1614,827,787
050,19,049,"Iowa","Dallas County",5,32,1569,751,818
050,19,049,"Iowa","Dallas County",5,33,1618,813,805
050,19,049,"Iowa","Dallas County",5,34,1576,783,793
050,19,049,"Iowa","Dallas County",5,35,1731,906,825
050,19,049,"Iowa","Dallas County",5,36,1740,851,889
050,19,049,"Iowa","Dallas County",5,37,1821,919,902
050,19,049,"Iowa","Dallas County",5,38,1820,917,903
050,19,049,"Iowa","Dallas County",5,39,1829,917,912
050,19,049,"Iowa","Dallas County",5,40,1871,966,905
050,19,049,"Iowa","Dallas County",5,41,1843,930,913
050,19,049,"Iowa","Dallas County",5,42,1823,916,907
050,19,049,"Iowa","Dallas County",5,43,1818,934,884
050,19,049,"Iowa","Dallas County",5,44,1703,861,842
050,19,049,"Iowa","Dallas County",5,45,1635,845,790
050,19,049,"Iowa","Dallas County",5,46,1521,783,738
050,19,049,"Iowa","Dallas County",5,47,1389,708,681
050,19,049,"Iowa","Dallas County",5,48,1373,709,664
050,19,049,"Iowa","Dallas County",5,49,1304,668,636
050,19,049,"Iowa","Dallas County",5,50,1268,640,628
050,19,049,"Iowa","Dallas County",5,51,1321,647,674
050,19,049,"Iowa","Dallas County",5,52,1459,741,718
050,19,049,"Iowa","Dallas County",5,53,1393,700,693
050,19,049,"Iowa","Dallas County",5,54,1291,643,648
050,19,049,"Iowa","Dallas County",5,55,1220,595,625
050,19,049,"Iowa","Dallas County",5,56,1180,618,562
050,19,049,"Iowa","Dallas County",5,57,1180,609,571
050,19,049,"Iowa","Dallas County",5,58,1194,600,594
050,19,049,"Iowa","Dallas County",5,59,1181,594,587
050,19,049,"Iowa","Dallas County",5,60,1086,546,540
050,19,049,"Iowa","Dallas County",5,61,1045,516,529
050,19,049,"Iowa","Dallas County",5,62,1117,539,578
050,19,049,"Iowa","Dallas County",5,63,1047,529,518
050,19,049,"Iowa","Dallas County",5,64,1083,505,578
050,19,049,"Iowa","Dallas County",5,65,992,472,520
050,19,049,"Iowa","Dallas County",5,66,955,446,509
050,19,049,"Iowa","Dallas County",5,67,901,425,476
050,19,049,"Iowa","Dallas County",5,68,903,400,503
050,19,049,"Iowa","Dallas County",5,69,856,395,461
050,19,049,"Iowa","Dallas County",5,70,859,400,459
050,19,049,"Iowa","Dallas County",5,71,807,366,441
050,19,049,"Iowa","Dallas County",5,72,766,347,419
050,19,049,"Iowa","Dallas County",5,73,700,321,379
050,19,049,"Iowa","Dallas County",5,74,716,313,403
050,19,049,"Iowa","Dallas County",5,75,673,306,367
050,19,049,"Iowa","Dallas County",5,76,705,331,374
050,19,049,"Iowa","Dallas County",5,77,483,215,268
050,19,049,"Iowa","Dallas County",5,78,450,190,260
050,19,049,"Iowa","Dallas County",5,79,404,177,227
050,19,049,"Iowa","Dallas County",5,80,406,175,231
050,19,049,"Iowa","Dallas County",5,81,352,144,208
050,19,049,"Iowa","Dallas County",5,82,321,137,184
050,19,049,"Iowa","Dallas County",5,83,268,99,169
050,19,049,"Iowa","Dallas County",5,84,261,99,162
050,19,049,"Iowa","Dallas County",5,85,1774,582,1192
050,19,051,"Iowa","Davis County",1,0,163,86,77
050,19,051,"Iowa","Davis County",1,1,162,84,78
050,19,051,"Iowa","Davis County",1,2,161,76,85
050,19,051,"Iowa","Davis County",1,3,166,98,68
050,19,051,"Iowa","Davis County",1,4,168,95,73
050,19,051,"Iowa","Davis County",1,5,151,72,79
050,19,051,"Iowa","Davis County",1,6,142,73,69
050,19,051,"Iowa","Davis County",1,7,134,66,68
050,19,051,"Iowa","Davis County",1,8,149,66,83
050,19,051,"Iowa","Davis County",1,9,136,71,65
050,19,051,"Iowa","Davis County",1,10,141,64,77
050,19,051,"Iowa","Davis County",1,11,156,75,81
050,19,051,"Iowa","Davis County",1,12,156,81,75
050,19,051,"Iowa","Davis County",1,13,161,88,73
050,19,051,"Iowa","Davis County",1,14,158,78,80
050,19,051,"Iowa","Davis County",1,15,161,77,84
050,19,051,"Iowa","Davis County",1,16,146,73,73
050,19,051,"Iowa","Davis County",1,17,131,64,67
050,19,051,"Iowa","Davis County",1,18,118,62,56
050,19,051,"Iowa","Davis County",1,19,93,47,46
050,19,051,"Iowa","Davis County",1,20,87,38,49
050,19,051,"Iowa","Davis County",1,21,94,46,48
050,19,051,"Iowa","Davis County",1,22,110,60,50
050,19,051,"Iowa","Davis County",1,23,110,63,47
050,19,051,"Iowa","Davis County",1,24,94,52,42
050,19,051,"Iowa","Davis County",1,25,93,49,44
050,19,051,"Iowa","Davis County",1,26,90,49,41
050,19,051,"Iowa","Davis County",1,27,97,52,45
050,19,051,"Iowa","Davis County",1,28,101,51,50
050,19,051,"Iowa","Davis County",1,29,86,43,43
050,19,051,"Iowa","Davis County",1,30,124,63,61
050,19,051,"Iowa","Davis County",1,31,92,46,46
050,19,051,"Iowa","Davis County",1,32,91,46,45
050,19,051,"Iowa","Davis County",1,33,95,47,48
050,19,051,"Iowa","Davis County",1,34,96,51,45
050,19,051,"Iowa","Davis County",1,35,91,46,45
050,19,051,"Iowa","Davis County",1,36,94,48,46
050,19,051,"Iowa","Davis County",1,37,90,47,43
050,19,051,"Iowa","Davis County",1,38,105,53,52
050,19,051,"Iowa","Davis County",1,39,114,56,58
050,19,051,"Iowa","Davis County",1,40,96,45,51
050,19,051,"Iowa","Davis County",1,41,105,58,47
050,19,051,"Iowa","Davis County",1,42,106,55,51
050,19,051,"Iowa","Davis County",1,43,91,42,49
050,19,051,"Iowa","Davis County",1,44,80,39,41
050,19,051,"Iowa","Davis County",1,45,98,51,47
050,19,051,"Iowa","Davis County",1,46,87,49,38
050,19,051,"Iowa","Davis County",1,47,99,48,51
050,19,051,"Iowa","Davis County",1,48,106,55,51
050,19,051,"Iowa","Davis County",1,49,103,59,44
050,19,051,"Iowa","Davis County",1,50,98,53,45
050,19,051,"Iowa","Davis County",1,51,97,50,47
050,19,051,"Iowa","Davis County",1,52,88,46,42
050,19,051,"Iowa","Davis County",1,53,98,47,51
050,19,051,"Iowa","Davis County",1,54,86,48,38
050,19,051,"Iowa","Davis County",1,55,109,49,60
050,19,051,"Iowa","Davis County",1,56,115,55,60
050,19,051,"Iowa","Davis County",1,57,124,59,65
050,19,051,"Iowa","Davis County",1,58,114,63,51
050,19,051,"Iowa","Davis County",1,59,118,62,56
050,19,051,"Iowa","Davis County",1,60,121,62,59
050,19,051,"Iowa","Davis County",1,61,117,58,59
050,19,051,"Iowa","Davis County",1,62,115,56,59
050,19,051,"Iowa","Davis County",1,63,113,61,52
050,19,051,"Iowa","Davis County",1,64,121,63,58
050,19,051,"Iowa","Davis County",1,65,113,58,55
050,19,051,"Iowa","Davis County",1,66,109,56,53
050,19,051,"Iowa","Davis County",1,67,112,57,55
050,19,051,"Iowa","Davis County",1,68,104,45,59
050,19,051,"Iowa","Davis County",1,69,88,38,50
050,19,051,"Iowa","Davis County",1,70,91,49,42
050,19,051,"Iowa","Davis County",1,71,84,44,40
050,19,051,"Iowa","Davis County",1,72,79,42,37
050,19,051,"Iowa","Davis County",1,73,80,46,34
050,19,051,"Iowa","Davis County",1,74,59,29,30
050,19,051,"Iowa","Davis County",1,75,53,22,31
050,19,051,"Iowa","Davis County",1,76,49,23,26
050,19,051,"Iowa","Davis County",1,77,62,25,37
050,19,051,"Iowa","Davis County",1,78,62,26,36
050,19,051,"Iowa","Davis County",1,79,45,22,23
050,19,051,"Iowa","Davis County",1,80,43,18,25
050,19,051,"Iowa","Davis County",1,81,46,18,28
050,19,051,"Iowa","Davis County",1,82,36,15,21
050,19,051,"Iowa","Davis County",1,83,38,15,23
050,19,051,"Iowa","Davis County",1,84,41,21,20
050,19,051,"Iowa","Davis County",1,85,203,73,130
050,19,051,"Iowa","Davis County",2,0,152,81,71
050,19,051,"Iowa","Davis County",2,1,160,83,77
050,19,051,"Iowa","Davis County",2,2,162,79,83
050,19,051,"Iowa","Davis County",2,3,165,93,72
050,19,051,"Iowa","Davis County",2,4,168,95,73
050,19,051,"Iowa","Davis County",2,5,155,78,77
050,19,051,"Iowa","Davis County",2,6,143,72,71
050,19,051,"Iowa","Davis County",2,7,138,69,69
050,19,051,"Iowa","Davis County",2,8,146,68,78
050,19,051,"Iowa","Davis County",2,9,139,70,69
050,19,051,"Iowa","Davis County",2,10,141,66,75
050,19,051,"Iowa","Davis County",2,11,151,72,79
050,19,051,"Iowa","Davis County",2,12,157,80,77
050,19,051,"Iowa","Davis County",2,13,161,87,74
050,19,051,"Iowa","Davis County",2,14,160,81,79
050,19,051,"Iowa","Davis County",2,15,161,78,83
050,19,051,"Iowa","Davis County",2,16,150,74,76
050,19,051,"Iowa","Davis County",2,17,135,66,69
050,19,051,"Iowa","Davis County",2,18,115,60,55
050,19,051,"Iowa","Davis County",2,19,94,48,46
050,19,051,"Iowa","Davis County",2,20,88,40,48
050,19,051,"Iowa","Davis County",2,21,93,44,49
050,19,051,"Iowa","Davis County",2,22,108,58,50
050,19,051,"Iowa","Davis County",2,23,112,63,49
050,19,051,"Iowa","Davis County",2,24,97,55,42
050,19,051,"Iowa","Davis County",2,25,93,50,43
050,19,051,"Iowa","Davis County",2,26,89,48,41
050,19,051,"Iowa","Davis County",2,27,94,50,44
050,19,051,"Iowa","Davis County",2,28,100,51,49
050,19,051,"Iowa","Davis County",2,29,90,45,45
050,19,051,"Iowa","Davis County",2,30,115,58,57
050,19,051,"Iowa","Davis County",2,31,99,50,49
050,19,051,"Iowa","Davis County",2,32,91,46,45
050,19,051,"Iowa","Davis County",2,33,93,47,46
050,19,051,"Iowa","Davis County",2,34,96,51,45
050,19,051,"Iowa","Davis County",2,35,94,48,46
050,19,051,"Iowa","Davis County",2,36,91,47,44
050,19,051,"Iowa","Davis County",2,37,91,48,43
050,19,051,"Iowa","Davis County",2,38,102,52,50
050,19,051,"Iowa","Davis County",2,39,112,55,57
050,19,051,"Iowa","Davis County",2,40,101,48,53
050,19,051,"Iowa","Davis County",2,41,103,55,48
050,19,051,"Iowa","Davis County",2,42,105,55,50
050,19,051,"Iowa","Davis County",2,43,94,44,50
050,19,051,"Iowa","Davis County",2,44,81,40,41
050,19,051,"Iowa","Davis County",2,45,94,49,45
050,19,051,"Iowa","Davis County",2,46,90,50,40
050,19,051,"Iowa","Davis County",2,47,96,48,48
050,19,051,"Iowa","Davis County",2,48,104,53,51
050,19,051,"Iowa","Davis County",2,49,105,58,47
050,19,051,"Iowa","Davis County",2,50,99,54,45
050,19,051,"Iowa","Davis County",2,51,96,50,46
050,19,051,"Iowa","Davis County",2,52,90,47,43
050,19,051,"Iowa","Davis County",2,53,96,47,49
050,19,051,"Iowa","Davis County",2,54,89,48,41
050,19,051,"Iowa","Davis County",2,55,103,48,55
050,19,051,"Iowa","Davis County",2,56,115,55,60
050,19,051,"Iowa","Davis County",2,57,121,58,63
050,19,051,"Iowa","Davis County",2,58,117,62,55
050,19,051,"Iowa","Davis County",2,59,117,62,55
050,19,051,"Iowa","Davis County",2,60,120,62,58
050,19,051,"Iowa","Davis County",2,61,118,59,59
050,19,051,"Iowa","Davis County",2,62,115,57,58
050,19,051,"Iowa","Davis County",2,63,113,60,53
050,19,051,"Iowa","Davis County",2,64,118,61,57
050,19,051,"Iowa","Davis County",2,65,115,59,56
050,19,051,"Iowa","Davis County",2,66,112,57,55
050,19,051,"Iowa","Davis County",2,67,111,57,54
050,19,051,"Iowa","Davis County",2,68,105,47,58
050,19,051,"Iowa","Davis County",2,69,93,40,53
050,19,051,"Iowa","Davis County",2,70,90,47,43
050,19,051,"Iowa","Davis County",2,71,85,45,40
050,19,051,"Iowa","Davis County",2,72,78,42,36
050,19,051,"Iowa","Davis County",2,73,83,47,36
050,19,051,"Iowa","Davis County",2,74,60,31,29
050,19,051,"Iowa","Davis County",2,75,54,24,30
050,19,051,"Iowa","Davis County",2,76,47,21,26
050,19,051,"Iowa","Davis County",2,77,60,25,35
050,19,051,"Iowa","Davis County",2,78,58,25,33
050,19,051,"Iowa","Davis County",2,79,49,23,26
050,19,051,"Iowa","Davis County",2,80,44,19,25
050,19,051,"Iowa","Davis County",2,81,45,18,27
050,19,051,"Iowa","Davis County",2,82,38,16,22
050,19,051,"Iowa","Davis County",2,83,38,15,23
050,19,051,"Iowa","Davis County",2,84,40,19,21
050,19,051,"Iowa","Davis County",2,85,205,75,130
050,19,051,"Iowa","Davis County",3,0,163,84,79
050,19,051,"Iowa","Davis County",3,1,137,71,66
050,19,051,"Iowa","Davis County",3,2,156,85,71
050,19,051,"Iowa","Davis County",3,3,163,83,80
050,19,051,"Iowa","Davis County",3,4,162,92,70
050,19,051,"Iowa","Davis County",3,5,164,94,70
050,19,051,"Iowa","Davis County",3,6,154,80,74
050,19,051,"Iowa","Davis County",3,7,140,73,67
050,19,051,"Iowa","Davis County",3,8,149,76,73
050,19,051,"Iowa","Davis County",3,9,141,68,73
050,19,051,"Iowa","Davis County",3,10,138,67,71
050,19,051,"Iowa","Davis County",3,11,145,73,72
050,19,051,"Iowa","Davis County",3,12,150,71,79
050,19,051,"Iowa","Davis County",3,13,159,79,80
050,19,051,"Iowa","Davis County",3,14,162,90,72
050,19,051,"Iowa","Davis County",3,15,164,83,81
050,19,051,"Iowa","Davis County",3,16,161,77,84
050,19,051,"Iowa","Davis County",3,17,150,76,74
050,19,051,"Iowa","Davis County",3,18,112,56,56
050,19,051,"Iowa","Davis County",3,19,86,47,39
050,19,051,"Iowa","Davis County",3,20,101,54,47
050,19,051,"Iowa","Davis County",3,21,94,42,52
050,19,051,"Iowa","Davis County",3,22,84,37,47
050,19,051,"Iowa","Davis County",3,23,110,59,51
050,19,051,"Iowa","Davis County",3,24,104,59,45
050,19,051,"Iowa","Davis County",3,25,100,55,45
050,19,051,"Iowa","Davis County",3,26,82,44,38
050,19,051,"Iowa","Davis County",3,27,87,43,44
050,19,051,"Iowa","Davis County",3,28,89,48,41
050,19,051,"Iowa","Davis County",3,29,109,58,51
050,19,051,"Iowa","Davis County",3,30,91,48,43
050,19,051,"Iowa","Davis County",3,31,115,60,55
050,19,051,"Iowa","Davis County",3,32,102,51,51
050,19,051,"Iowa","Davis County",3,33,88,41,47
050,19,051,"Iowa","Davis County",3,34,88,46,42
050,19,051,"Iowa","Davis County",3,35,96,50,46
050,19,051,"Iowa","Davis County",3,36,95,48,47
050,19,051,"Iowa","Davis County",3,37,103,53,50
050,19,051,"Iowa","Davis County",3,38,88,47,41
050,19,051,"Iowa","Davis County",3,39,99,50,49
050,19,051,"Iowa","Davis County",3,40,118,59,59
050,19,051,"Iowa","Davis County",3,41,104,47,57
050,19,051,"Iowa","Davis County",3,42,111,59,52
050,19,051,"Iowa","Davis County",3,43,101,54,47
050,19,051,"Iowa","Davis County",3,44,91,44,47
050,19,051,"Iowa","Davis County",3,45,80,39,41
050,19,051,"Iowa","Davis County",3,46,94,50,44
050,19,051,"Iowa","Davis County",3,47,88,48,40
050,19,051,"Iowa","Davis County",3,48,103,52,51
050,19,051,"Iowa","Davis County",3,49,104,54,50
050,19,051,"Iowa","Davis County",3,50,107,61,46
050,19,051,"Iowa","Davis County",3,51,98,56,42
050,19,051,"Iowa","Davis County",3,52,96,49,47
050,19,051,"Iowa","Davis County",3,53,94,48,46
050,19,051,"Iowa","Davis County",3,54,100,48,52
050,19,051,"Iowa","Davis County",3,55,89,50,39
050,19,051,"Iowa","Davis County",3,56,101,47,54
050,19,051,"Iowa","Davis County",3,57,117,58,59
050,19,051,"Iowa","Davis County",3,58,128,61,67
050,19,051,"Iowa","Davis County",3,59,115,60,55
050,19,051,"Iowa","Davis County",3,60,117,62,55
050,19,051,"Iowa","Davis County",3,61,121,62,59
050,19,051,"Iowa","Davis County",3,62,120,60,60
050,19,051,"Iowa","Davis County",3,63,109,54,55
050,19,051,"Iowa","Davis County",3,64,114,60,54
050,19,051,"Iowa","Davis County",3,65,116,61,55
050,19,051,"Iowa","Davis County",3,66,114,56,58
050,19,051,"Iowa","Davis County",3,67,115,59,56
050,19,051,"Iowa","Davis County",3,68,110,54,56
050,19,051,"Iowa","Davis County",3,69,101,46,55
050,19,051,"Iowa","Davis County",3,70,96,41,55
050,19,051,"Iowa","Davis County",3,71,90,47,43
050,19,051,"Iowa","Davis County",3,72,80,41,39
050,19,051,"Iowa","Davis County",3,73,74,40,34
050,19,051,"Iowa","Davis County",3,74,83,46,37
050,19,051,"Iowa","Davis County",3,75,56,30,26
050,19,051,"Iowa","Davis County",3,76,48,21,27
050,19,051,"Iowa","Davis County",3,77,43,18,25
050,19,051,"Iowa","Davis County",3,78,59,24,35
050,19,051,"Iowa","Davis County",3,79,57,24,33
050,19,051,"Iowa","Davis County",3,80,46,22,24
050,19,051,"Iowa","Davis County",3,81,45,19,26
050,19,051,"Iowa","Davis County",3,82,39,15,24
050,19,051,"Iowa","Davis County",3,83,35,15,20
050,19,051,"Iowa","Davis County",3,84,33,12,21
050,19,051,"Iowa","Davis County",3,85,209,80,129
050,19,051,"Iowa","Davis County",4,0,152,79,73
050,19,051,"Iowa","Davis County",4,1,158,79,79
050,19,051,"Iowa","Davis County",4,2,140,72,68
050,19,051,"Iowa","Davis County",4,3,152,82,70
050,19,051,"Iowa","Davis County",4,4,170,86,84
050,19,051,"Iowa","Davis County",4,5,165,92,73
050,19,051,"Iowa","Davis County",4,6,165,91,74
050,19,051,"Iowa","Davis County",4,7,149,77,72
050,19,051,"Iowa","Davis County",4,8,140,81,59
050,19,051,"Iowa","Davis County",4,9,139,68,71
050,19,051,"Iowa","Davis County",4,10,144,68,76
050,19,051,"Iowa","Davis County",4,11,138,65,73
050,19,051,"Iowa","Davis County",4,12,147,75,72
050,19,051,"Iowa","Davis County",4,13,150,68,82
050,19,051,"Iowa","Davis County",4,14,159,82,77
050,19,051,"Iowa","Davis County",4,15,154,86,68
050,19,051,"Iowa","Davis County",4,16,164,86,78
050,19,051,"Iowa","Davis County",4,17,162,74,88
050,19,051,"Iowa","Davis County",4,18,114,57,57
050,19,051,"Iowa","Davis County",4,19,78,41,37
050,19,051,"Iowa","Davis County",4,20,95,54,41
050,19,051,"Iowa","Davis County",4,21,98,52,46
050,19,051,"Iowa","Davis County",4,22,101,43,58
050,19,051,"Iowa","Davis County",4,23,82,39,43
050,19,051,"Iowa","Davis County",4,24,105,64,41
050,19,051,"Iowa","Davis County",4,25,104,59,45
050,19,051,"Iowa","Davis County",4,26,98,52,46
050,19,051,"Iowa","Davis County",4,27,83,46,37
050,19,051,"Iowa","Davis County",4,28,95,52,43
050,19,051,"Iowa","Davis County",4,29,100,50,50
050,19,051,"Iowa","Davis County",4,30,117,61,56
050,19,051,"Iowa","Davis County",4,31,89,46,43
050,19,051,"Iowa","Davis County",4,32,110,54,56
050,19,051,"Iowa","Davis County",4,33,100,51,49
050,19,051,"Iowa","Davis County",4,34,96,46,50
050,19,051,"Iowa","Davis County",4,35,86,46,40
050,19,051,"Iowa","Davis County",4,36,99,53,46
050,19,051,"Iowa","Davis County",4,37,94,49,45
050,19,051,"Iowa","Davis County",4,38,102,52,50
050,19,051,"Iowa","Davis County",4,39,89,48,41
050,19,051,"Iowa","Davis County",4,40,98,46,52
050,19,051,"Iowa","Davis County",4,41,115,58,57
050,19,051,"Iowa","Davis County",4,42,105,47,58
050,19,051,"Iowa","Davis County",4,43,114,62,52
050,19,051,"Iowa","Davis County",4,44,96,55,41
050,19,051,"Iowa","Davis County",4,45,91,44,47
050,19,051,"Iowa","Davis County",4,46,82,41,41
050,19,051,"Iowa","Davis County",4,47,89,47,42
050,19,051,"Iowa","Davis County",4,48,88,47,41
050,19,051,"Iowa","Davis County",4,49,103,51,52
050,19,051,"Iowa","Davis County",4,50,101,56,45
050,19,051,"Iowa","Davis County",4,51,108,62,46
050,19,051,"Iowa","Davis County",4,52,96,54,42
050,19,051,"Iowa","Davis County",4,53,95,48,47
050,19,051,"Iowa","Davis County",4,54,93,46,47
050,19,051,"Iowa","Davis County",4,55,97,48,49
050,19,051,"Iowa","Davis County",4,56,84,46,38
050,19,051,"Iowa","Davis County",4,57,99,46,53
050,19,051,"Iowa","Davis County",4,58,117,58,59
050,19,051,"Iowa","Davis County",4,59,126,61,65
050,19,051,"Iowa","Davis County",4,60,117,62,55
050,19,051,"Iowa","Davis County",4,61,117,60,57
050,19,051,"Iowa","Davis County",4,62,119,60,59
050,19,051,"Iowa","Davis County",4,63,118,60,58
050,19,051,"Iowa","Davis County",4,64,112,55,57
050,19,051,"Iowa","Davis County",4,65,106,55,51
050,19,051,"Iowa","Davis County",4,66,115,60,55
050,19,051,"Iowa","Davis County",4,67,117,59,58
050,19,051,"Iowa","Davis County",4,68,113,56,57
050,19,051,"Iowa","Davis County",4,69,102,49,53
050,19,051,"Iowa","Davis County",4,70,103,47,56
050,19,051,"Iowa","Davis County",4,71,93,39,54
050,19,051,"Iowa","Davis County",4,72,89,46,43
050,19,051,"Iowa","Davis County",4,73,78,41,37
050,19,051,"Iowa","Davis County",4,74,73,40,33
050,19,051,"Iowa","Davis County",4,75,79,44,35
050,19,051,"Iowa","Davis County",4,76,52,27,25
050,19,051,"Iowa","Davis County",4,77,47,21,26
050,19,051,"Iowa","Davis County",4,78,43,19,24
050,19,051,"Iowa","Davis County",4,79,57,24,33
050,19,051,"Iowa","Davis County",4,80,53,21,32
050,19,051,"Iowa","Davis County",4,81,45,21,24
050,19,051,"Iowa","Davis County",4,82,39,16,23
050,19,051,"Iowa","Davis County",4,83,39,15,24
050,19,051,"Iowa","Davis County",4,84,34,14,20
050,19,051,"Iowa","Davis County",4,85,207,77,130
050,19,051,"Iowa","Davis County",5,0,153,78,75
050,19,051,"Iowa","Davis County",5,1,145,72,73
050,19,051,"Iowa","Davis County",5,2,164,84,80
050,19,051,"Iowa","Davis County",5,3,142,72,70
050,19,051,"Iowa","Davis County",5,4,145,82,63
050,19,051,"Iowa","Davis County",5,5,166,87,79
050,19,051,"Iowa","Davis County",5,6,164,90,74
050,19,051,"Iowa","Davis County",5,7,166,92,74
050,19,051,"Iowa","Davis County",5,8,144,73,71
050,19,051,"Iowa","Davis County",5,9,140,79,61
050,19,051,"Iowa","Davis County",5,10,131,63,68
050,19,051,"Iowa","Davis County",5,11,146,72,74
050,19,051,"Iowa","Davis County",5,12,136,64,72
050,19,051,"Iowa","Davis County",5,13,141,74,67
050,19,051,"Iowa","Davis County",5,14,154,75,79
050,19,051,"Iowa","Davis County",5,15,165,78,87
050,19,051,"Iowa","Davis County",5,16,153,85,68
050,19,051,"Iowa","Davis County",5,17,168,88,80
050,19,051,"Iowa","Davis County",5,18,132,63,69
050,19,051,"Iowa","Davis County",5,19,87,46,41
050,19,051,"Iowa","Davis County",5,20,84,44,40
050,19,051,"Iowa","Davis County",5,21,92,52,40
050,19,051,"Iowa","Davis County",5,22,108,54,54
050,19,051,"Iowa","Davis County",5,23,105,44,61
050,19,051,"Iowa","Davis County",5,24,96,49,47
050,19,051,"Iowa","Davis County",5,25,105,63,42
050,19,051,"Iowa","Davis County",5,26,97,56,41
050,19,051,"Iowa","Davis County",5,27,99,54,45
050,19,051,"Iowa","Davis County",5,28,89,52,37
050,19,051,"Iowa","Davis County",5,29,92,51,41
050,19,051,"Iowa","Davis County",5,30,101,50,51
050,19,051,"Iowa","Davis County",5,31,114,62,52
050,19,051,"Iowa","Davis County",5,32,94,48,46
050,19,051,"Iowa","Davis County",5,33,111,56,55
050,19,051,"Iowa","Davis County",5,34,102,51,51
050,19,051,"Iowa","Davis County",5,35,105,51,54
050,19,051,"Iowa","Davis County",5,36,89,50,39
050,19,051,"Iowa","Davis County",5,37,95,50,45
050,19,051,"Iowa","Davis County",5,38,89,45,44
050,19,051,"Iowa","Davis County",5,39,100,50,50
050,19,051,"Iowa","Davis County",5,40,87,43,44
050,19,051,"Iowa","Davis County",5,41,96,45,51
050,19,051,"Iowa","Davis County",5,42,115,59,56
050,19,051,"Iowa","Davis County",5,43,105,46,59
050,19,051,"Iowa","Davis County",5,44,111,59,52
050,19,051,"Iowa","Davis County",5,45,93,55,38
050,19,051,"Iowa","Davis County",5,46,93,45,48
050,19,051,"Iowa","Davis County",5,47,79,41,38
050,19,051,"Iowa","Davis County",5,48,87,46,41
050,19,051,"Iowa","Davis County",5,49,94,50,44
050,19,051,"Iowa","Davis County",5,50,105,54,51
050,19,051,"Iowa","Davis County",5,51,104,58,46
050,19,051,"Iowa","Davis County",5,52,108,64,44
050,19,051,"Iowa","Davis County",5,53,98,55,43
050,19,051,"Iowa","Davis County",5,54,94,49,45
050,19,051,"Iowa","Davis County",5,55,91,46,45
050,19,051,"Iowa","Davis County",5,56,92,47,45
050,19,051,"Iowa","Davis County",5,57,81,44,37
050,19,051,"Iowa","Davis County",5,58,93,43,50
050,19,051,"Iowa","Davis County",5,59,114,57,57
050,19,051,"Iowa","Davis County",5,60,126,61,65
050,19,051,"Iowa","Davis County",5,61,121,63,58
050,19,051,"Iowa","Davis County",5,62,117,58,59
050,19,051,"Iowa","Davis County",5,63,114,58,56
050,19,051,"Iowa","Davis County",5,64,119,62,57
050,19,051,"Iowa","Davis County",5,65,103,50,53
050,19,051,"Iowa","Davis County",5,66,107,54,53
050,19,051,"Iowa","Davis County",5,67,117,62,55
050,19,051,"Iowa","Davis County",5,68,115,57,58
050,19,051,"Iowa","Davis County",5,69,108,55,53
050,19,051,"Iowa","Davis County",5,70,102,49,53
050,19,051,"Iowa","Davis County",5,71,103,45,58
050,19,051,"Iowa","Davis County",5,72,88,36,52
050,19,051,"Iowa","Davis County",5,73,90,47,43
050,19,051,"Iowa","Davis County",5,74,78,40,38
050,19,051,"Iowa","Davis County",5,75,70,41,29
050,19,051,"Iowa","Davis County",5,76,72,39,33
050,19,051,"Iowa","Davis County",5,77,49,25,24
050,19,051,"Iowa","Davis County",5,78,45,21,24
050,19,051,"Iowa","Davis County",5,79,38,16,22
050,19,051,"Iowa","Davis County",5,80,57,25,32
050,19,051,"Iowa","Davis County",5,81,54,21,33
050,19,051,"Iowa","Davis County",5,82,42,19,23
050,19,051,"Iowa","Davis County",5,83,37,15,22
050,19,051,"Iowa","Davis County",5,84,37,15,22
050,19,051,"Iowa","Davis County",5,85,211,79,132
050,19,053,"Iowa","Decatur County",1,0,92,49,43
050,19,053,"Iowa","Decatur County",1,1,92,54,38
050,19,053,"Iowa","Decatur County",1,2,92,48,44
050,19,053,"Iowa","Decatur County",1,3,102,55,47
050,19,053,"Iowa","Decatur County",1,4,98,50,48
050,19,053,"Iowa","Decatur County",1,5,101,58,43
050,19,053,"Iowa","Decatur County",1,6,105,57,48
050,19,053,"Iowa","Decatur County",1,7,89,48,41
050,19,053,"Iowa","Decatur County",1,8,92,48,44
050,19,053,"Iowa","Decatur County",1,9,78,38,40
050,19,053,"Iowa","Decatur County",1,10,100,52,48
050,19,053,"Iowa","Decatur County",1,11,100,51,49
050,19,053,"Iowa","Decatur County",1,12,113,62,51
050,19,053,"Iowa","Decatur County",1,13,112,56,56
050,19,053,"Iowa","Decatur County",1,14,104,52,52
050,19,053,"Iowa","Decatur County",1,15,100,49,51
050,19,053,"Iowa","Decatur County",1,16,100,49,51
050,19,053,"Iowa","Decatur County",1,17,103,55,48
050,19,053,"Iowa","Decatur County",1,18,129,65,64
050,19,053,"Iowa","Decatur County",1,19,189,102,87
050,19,053,"Iowa","Decatur County",1,20,200,103,97
050,19,053,"Iowa","Decatur County",1,21,223,125,98
050,19,053,"Iowa","Decatur County",1,22,165,84,81
050,19,053,"Iowa","Decatur County",1,23,115,73,42
050,19,053,"Iowa","Decatur County",1,24,96,51,45
050,19,053,"Iowa","Decatur County",1,25,90,45,45
050,19,053,"Iowa","Decatur County",1,26,74,43,31
050,19,053,"Iowa","Decatur County",1,27,63,39,24
050,19,053,"Iowa","Decatur County",1,28,89,47,42
050,19,053,"Iowa","Decatur County",1,29,67,35,32
050,19,053,"Iowa","Decatur County",1,30,72,33,39
050,19,053,"Iowa","Decatur County",1,31,68,31,37
050,19,053,"Iowa","Decatur County",1,32,75,45,30
050,19,053,"Iowa","Decatur County",1,33,77,43,34
050,19,053,"Iowa","Decatur County",1,34,67,32,35
050,19,053,"Iowa","Decatur County",1,35,80,35,45
050,19,053,"Iowa","Decatur County",1,36,69,32,37
050,19,053,"Iowa","Decatur County",1,37,70,42,28
050,19,053,"Iowa","Decatur County",1,38,80,42,38
050,19,053,"Iowa","Decatur County",1,39,79,39,40
050,19,053,"Iowa","Decatur County",1,40,74,34,40
050,19,053,"Iowa","Decatur County",1,41,75,39,36
050,19,053,"Iowa","Decatur County",1,42,66,29,37
050,19,053,"Iowa","Decatur County",1,43,72,34,38
050,19,053,"Iowa","Decatur County",1,44,72,40,32
050,19,053,"Iowa","Decatur County",1,45,76,40,36
050,19,053,"Iowa","Decatur County",1,46,74,36,38
050,19,053,"Iowa","Decatur County",1,47,70,37,33
050,19,053,"Iowa","Decatur County",1,48,83,49,34
050,19,053,"Iowa","Decatur County",1,49,79,45,34
050,19,053,"Iowa","Decatur County",1,50,77,34,43
050,19,053,"Iowa","Decatur County",1,51,74,32,42
050,19,053,"Iowa","Decatur County",1,52,60,31,29
050,19,053,"Iowa","Decatur County",1,53,65,33,32
050,19,053,"Iowa","Decatur County",1,54,67,37,30
050,19,053,"Iowa","Decatur County",1,55,87,45,42
050,19,053,"Iowa","Decatur County",1,56,89,41,48
050,19,053,"Iowa","Decatur County",1,57,102,56,46
050,19,053,"Iowa","Decatur County",1,58,87,39,48
050,19,053,"Iowa","Decatur County",1,59,96,49,47
050,19,053,"Iowa","Decatur County",1,60,97,54,43
050,19,053,"Iowa","Decatur County",1,61,111,53,58
050,19,053,"Iowa","Decatur County",1,62,105,53,52
050,19,053,"Iowa","Decatur County",1,63,95,51,44
050,19,053,"Iowa","Decatur County",1,64,91,45,46
050,19,053,"Iowa","Decatur County",1,65,100,49,51
050,19,053,"Iowa","Decatur County",1,66,98,46,52
050,19,053,"Iowa","Decatur County",1,67,106,55,51
050,19,053,"Iowa","Decatur County",1,68,103,52,51
050,19,053,"Iowa","Decatur County",1,69,87,48,39
050,19,053,"Iowa","Decatur County",1,70,67,35,32
050,19,053,"Iowa","Decatur County",1,71,83,44,39
050,19,053,"Iowa","Decatur County",1,72,79,41,38
050,19,053,"Iowa","Decatur County",1,73,87,47,40
050,19,053,"Iowa","Decatur County",1,74,62,29,33
050,19,053,"Iowa","Decatur County",1,75,64,27,37
050,19,053,"Iowa","Decatur County",1,76,69,30,39
050,19,053,"Iowa","Decatur County",1,77,57,23,34
050,19,053,"Iowa","Decatur County",1,78,48,21,27
050,19,053,"Iowa","Decatur County",1,79,45,22,23
050,19,053,"Iowa","Decatur County",1,80,47,21,26
050,19,053,"Iowa","Decatur County",1,81,44,18,26
050,19,053,"Iowa","Decatur County",1,82,42,17,25
050,19,053,"Iowa","Decatur County",1,83,39,20,19
050,19,053,"Iowa","Decatur County",1,84,28,12,16
050,19,053,"Iowa","Decatur County",1,85,231,78,153
050,19,053,"Iowa","Decatur County",2,0,81,44,37
050,19,053,"Iowa","Decatur County",2,1,90,51,39
050,19,053,"Iowa","Decatur County",2,2,91,48,43
050,19,053,"Iowa","Decatur County",2,3,99,53,46
050,19,053,"Iowa","Decatur County",2,4,101,52,49
050,19,053,"Iowa","Decatur County",2,5,101,57,44
050,19,053,"Iowa","Decatur County",2,6,103,57,46
050,19,053,"Iowa","Decatur County",2,7,94,51,43
050,19,053,"Iowa","Decatur County",2,8,89,46,43
050,19,053,"Iowa","Decatur County",2,9,79,39,40
050,19,053,"Iowa","Decatur County",2,10,93,48,45
050,19,053,"Iowa","Decatur County",2,11,98,51,47
050,19,053,"Iowa","Decatur County",2,12,111,60,51
050,19,053,"Iowa","Decatur County",2,13,112,57,55
050,19,053,"Iowa","Decatur County",2,14,107,54,53
050,19,053,"Iowa","Decatur County",2,15,100,50,50
050,19,053,"Iowa","Decatur County",2,16,99,49,50
050,19,053,"Iowa","Decatur County",2,17,102,54,48
050,19,053,"Iowa","Decatur County",2,18,130,65,65
050,19,053,"Iowa","Decatur County",2,19,188,102,86
050,19,053,"Iowa","Decatur County",2,20,201,102,99
050,19,053,"Iowa","Decatur County",2,21,218,124,94
050,19,053,"Iowa","Decatur County",2,22,167,84,83
050,19,053,"Iowa","Decatur County",2,23,114,72,42
050,19,053,"Iowa","Decatur County",2,24,98,53,45
050,19,053,"Iowa","Decatur County",2,25,88,43,45
050,19,053,"Iowa","Decatur County",2,26,77,44,33
050,19,053,"Iowa","Decatur County",2,27,66,40,26
050,19,053,"Iowa","Decatur County",2,28,81,45,36
050,19,053,"Iowa","Decatur County",2,29,72,37,35
050,19,053,"Iowa","Decatur County",2,30,73,34,39
050,19,053,"Iowa","Decatur County",2,31,70,33,37
050,19,053,"Iowa","Decatur County",2,32,73,42,31
050,19,053,"Iowa","Decatur County",2,33,76,43,33
050,19,053,"Iowa","Decatur County",2,34,70,36,34
050,19,053,"Iowa","Decatur County",2,35,77,34,43
050,19,053,"Iowa","Decatur County",2,36,69,32,37
050,19,053,"Iowa","Decatur County",2,37,70,39,31
050,19,053,"Iowa","Decatur County",2,38,79,42,37
050,19,053,"Iowa","Decatur County",2,39,80,40,40
050,19,053,"Iowa","Decatur County",2,40,76,35,41
050,19,053,"Iowa","Decatur County",2,41,75,38,37
050,19,053,"Iowa","Decatur County",2,42,68,31,37
050,19,053,"Iowa","Decatur County",2,43,70,33,37
050,19,053,"Iowa","Decatur County",2,44,71,38,33
050,19,053,"Iowa","Decatur County",2,45,74,39,35
050,19,053,"Iowa","Decatur County",2,46,76,37,39
050,19,053,"Iowa","Decatur County",2,47,71,37,34
050,19,053,"Iowa","Decatur County",2,48,80,47,33
050,19,053,"Iowa","Decatur County",2,49,80,46,34
050,19,053,"Iowa","Decatur County",2,50,78,36,42
050,19,053,"Iowa","Decatur County",2,51,74,32,42
050,19,053,"Iowa","Decatur County",2,52,60,29,31
050,19,053,"Iowa","Decatur County",2,53,61,30,31
050,19,053,"Iowa","Decatur County",2,54,68,36,32
050,19,053,"Iowa","Decatur County",2,55,82,44,38
050,19,053,"Iowa","Decatur County",2,56,87,41,46
050,19,053,"Iowa","Decatur County",2,57,97,52,45
050,19,053,"Iowa","Decatur County",2,58,87,42,45
050,19,053,"Iowa","Decatur County",2,59,94,47,47
050,19,053,"Iowa","Decatur County",2,60,96,52,44
050,19,053,"Iowa","Decatur County",2,61,108,53,55
050,19,053,"Iowa","Decatur County",2,62,105,53,52
050,19,053,"Iowa","Decatur County",2,63,99,52,47
050,19,053,"Iowa","Decatur County",2,64,90,46,44
050,19,053,"Iowa","Decatur County",2,65,98,48,50
050,19,053,"Iowa","Decatur County",2,66,98,47,51
050,19,053,"Iowa","Decatur County",2,67,104,53,51
050,19,053,"Iowa","Decatur County",2,68,102,52,50
050,19,053,"Iowa","Decatur County",2,69,91,49,42
050,19,053,"Iowa","Decatur County",2,70,72,38,34
050,19,053,"Iowa","Decatur County",2,71,80,42,38
050,19,053,"Iowa","Decatur County",2,72,78,40,38
050,19,053,"Iowa","Decatur County",2,73,89,48,41
050,19,053,"Iowa","Decatur County",2,74,64,31,33
050,19,053,"Iowa","Decatur County",2,75,64,28,36
050,19,053,"Iowa","Decatur County",2,76,67,28,39
050,19,053,"Iowa","Decatur County",2,77,61,25,36
050,19,053,"Iowa","Decatur County",2,78,50,22,28
050,19,053,"Iowa","Decatur County",2,79,46,22,24
050,19,053,"Iowa","Decatur County",2,80,46,21,25
050,19,053,"Iowa","Decatur County",2,81,45,19,26
050,19,053,"Iowa","Decatur County",2,82,41,17,24
050,19,053,"Iowa","Decatur County",2,83,39,19,20
050,19,053,"Iowa","Decatur County",2,84,30,14,16
050,19,053,"Iowa","Decatur County",2,85,227,77,150
050,19,053,"Iowa","Decatur County",3,0,85,40,45
050,19,053,"Iowa","Decatur County",3,1,80,42,38
050,19,053,"Iowa","Decatur County",3,2,92,48,44
050,19,053,"Iowa","Decatur County",3,3,91,48,43
050,19,053,"Iowa","Decatur County",3,4,91,49,42
050,19,053,"Iowa","Decatur County",3,5,104,53,51
050,19,053,"Iowa","Decatur County",3,6,98,53,45
050,19,053,"Iowa","Decatur County",3,7,102,56,46
050,19,053,"Iowa","Decatur County",3,8,98,56,42
050,19,053,"Iowa","Decatur County",3,9,91,46,45
050,19,053,"Iowa","Decatur County",3,10,86,43,43
050,19,053,"Iowa","Decatur County",3,11,92,48,44
050,19,053,"Iowa","Decatur County",3,12,103,55,48
050,19,053,"Iowa","Decatur County",3,13,117,62,55
050,19,053,"Iowa","Decatur County",3,14,109,57,52
050,19,053,"Iowa","Decatur County",3,15,105,50,55
050,19,053,"Iowa","Decatur County",3,16,106,51,55
050,19,053,"Iowa","Decatur County",3,17,95,49,46
050,19,053,"Iowa","Decatur County",3,18,134,69,65
050,19,053,"Iowa","Decatur County",3,19,187,103,84
050,19,053,"Iowa","Decatur County",3,20,192,98,94
050,19,053,"Iowa","Decatur County",3,21,214,122,92
050,19,053,"Iowa","Decatur County",3,22,180,91,89
050,19,053,"Iowa","Decatur County",3,23,111,74,37
050,19,053,"Iowa","Decatur County",3,24,105,57,48
050,19,053,"Iowa","Decatur County",3,25,76,36,40
050,19,053,"Iowa","Decatur County",3,26,89,46,43
050,19,053,"Iowa","Decatur County",3,27,86,47,39
050,19,053,"Iowa","Decatur County",3,28,75,45,30
050,19,053,"Iowa","Decatur County",3,29,80,44,36
050,19,053,"Iowa","Decatur County",3,30,75,36,39
050,19,053,"Iowa","Decatur County",3,31,70,33,37
050,19,053,"Iowa","Decatur County",3,32,67,31,36
050,19,053,"Iowa","Decatur County",3,33,75,41,34
050,19,053,"Iowa","Decatur County",3,34,78,45,33
050,19,053,"Iowa","Decatur County",3,35,70,36,34
050,19,053,"Iowa","Decatur County",3,36,81,36,45
050,19,053,"Iowa","Decatur County",3,37,73,33,40
050,19,053,"Iowa","Decatur County",3,38,69,41,28
050,19,053,"Iowa","Decatur County",3,39,82,38,44
050,19,053,"Iowa","Decatur County",3,40,75,33,42
050,19,053,"Iowa","Decatur County",3,41,76,36,40
050,19,053,"Iowa","Decatur County",3,42,73,38,35
050,19,053,"Iowa","Decatur County",3,43,71,34,37
050,19,053,"Iowa","Decatur County",3,44,74,33,41
050,19,053,"Iowa","Decatur County",3,45,73,41,32
050,19,053,"Iowa","Decatur County",3,46,78,38,40
050,19,053,"Iowa","Decatur County",3,47,78,38,40
050,19,053,"Iowa","Decatur County",3,48,68,36,32
050,19,053,"Iowa","Decatur County",3,49,81,50,31
050,19,053,"Iowa","Decatur County",3,50,80,46,34
050,19,053,"Iowa","Decatur County",3,51,77,35,42
050,19,053,"Iowa","Decatur County",3,52,77,35,42
050,19,053,"Iowa","Decatur County",3,53,69,33,36
050,19,053,"Iowa","Decatur County",3,54,64,29,35
050,19,053,"Iowa","Decatur County",3,55,65,34,31
050,19,053,"Iowa","Decatur County",3,56,84,43,41
050,19,053,"Iowa","Decatur County",3,57,90,41,49
050,19,053,"Iowa","Decatur County",3,58,99,54,45
050,19,053,"Iowa","Decatur County",3,59,88,41,47
050,19,053,"Iowa","Decatur County",3,60,93,44,49
050,19,053,"Iowa","Decatur County",3,61,105,53,52
050,19,053,"Iowa","Decatur County",3,62,104,51,53
050,19,053,"Iowa","Decatur County",3,63,103,51,52
050,19,053,"Iowa","Decatur County",3,64,101,51,50
050,19,053,"Iowa","Decatur County",3,65,88,43,45
050,19,053,"Iowa","Decatur County",3,66,98,46,52
050,19,053,"Iowa","Decatur County",3,67,97,48,49
050,19,053,"Iowa","Decatur County",3,68,100,50,50
050,19,053,"Iowa","Decatur County",3,69,104,53,51
050,19,053,"Iowa","Decatur County",3,70,92,49,43
050,19,053,"Iowa","Decatur County",3,71,75,38,37
050,19,053,"Iowa","Decatur County",3,72,78,40,38
050,19,053,"Iowa","Decatur County",3,73,79,40,39
050,19,053,"Iowa","Decatur County",3,74,89,47,42
050,19,053,"Iowa","Decatur County",3,75,58,27,31
050,19,053,"Iowa","Decatur County",3,76,56,21,35
050,19,053,"Iowa","Decatur County",3,77,66,28,38
050,19,053,"Iowa","Decatur County",3,78,62,26,36
050,19,053,"Iowa","Decatur County",3,79,44,21,23
050,19,053,"Iowa","Decatur County",3,80,46,20,26
050,19,053,"Iowa","Decatur County",3,81,44,21,23
050,19,053,"Iowa","Decatur County",3,82,46,18,28
050,19,053,"Iowa","Decatur County",3,83,42,17,25
050,19,053,"Iowa","Decatur County",3,84,35,20,15
050,19,053,"Iowa","Decatur County",3,85,209,75,134
050,19,053,"Iowa","Decatur County",4,0,85,36,49
050,19,053,"Iowa","Decatur County",4,1,89,38,51
050,19,053,"Iowa","Decatur County",4,2,85,45,40
050,19,053,"Iowa","Decatur County",4,3,87,50,37
050,19,053,"Iowa","Decatur County",4,4,91,48,43
050,19,053,"Iowa","Decatur County",4,5,99,50,49
050,19,053,"Iowa","Decatur County",4,6,110,50,60
050,19,053,"Iowa","Decatur County",4,7,108,58,50
050,19,053,"Iowa","Decatur County",4,8,110,60,50
050,19,053,"Iowa","Decatur County",4,9,102,62,40
050,19,053,"Iowa","Decatur County",4,10,94,50,44
050,19,053,"Iowa","Decatur County",4,11,79,42,37
050,19,053,"Iowa","Decatur County",4,12,89,47,42
050,19,053,"Iowa","Decatur County",4,13,100,53,47
050,19,053,"Iowa","Decatur County",4,14,111,59,52
050,19,053,"Iowa","Decatur County",4,15,111,57,54
050,19,053,"Iowa","Decatur County",4,16,112,50,62
050,19,053,"Iowa","Decatur County",4,17,108,52,56
050,19,053,"Iowa","Decatur County",4,18,144,74,70
050,19,053,"Iowa","Decatur County",4,19,197,112,85
050,19,053,"Iowa","Decatur County",4,20,197,98,99
050,19,053,"Iowa","Decatur County",4,21,209,121,88
050,19,053,"Iowa","Decatur County",4,22,174,89,85
050,19,053,"Iowa","Decatur County",4,23,117,74,43
050,19,053,"Iowa","Decatur County",4,24,89,53,36
050,19,053,"Iowa","Decatur County",4,25,84,37,47
050,19,053,"Iowa","Decatur County",4,26,70,36,34
050,19,053,"Iowa","Decatur County",4,27,84,41,43
050,19,053,"Iowa","Decatur County",4,28,89,46,43
050,19,053,"Iowa","Decatur County",4,29,65,41,24
050,19,053,"Iowa","Decatur County",4,30,84,43,41
050,19,053,"Iowa","Decatur County",4,31,76,37,39
050,19,053,"Iowa","Decatur County",4,32,76,33,43
050,19,053,"Iowa","Decatur County",4,33,69,32,37
050,19,053,"Iowa","Decatur County",4,34,73,38,35
050,19,053,"Iowa","Decatur County",4,35,71,39,32
050,19,053,"Iowa","Decatur County",4,36,69,39,30
050,19,053,"Iowa","Decatur County",4,37,84,36,48
050,19,053,"Iowa","Decatur County",4,38,75,36,39
050,19,053,"Iowa","Decatur County",4,39,68,39,29
050,19,053,"Iowa","Decatur County",4,40,85,40,45
050,19,053,"Iowa","Decatur County",4,41,74,33,41
050,19,053,"Iowa","Decatur County",4,42,76,33,43
050,19,053,"Iowa","Decatur County",4,43,73,38,35
050,19,053,"Iowa","Decatur County",4,44,70,35,35
050,19,053,"Iowa","Decatur County",4,45,76,36,40
050,19,053,"Iowa","Decatur County",4,46,72,41,31
050,19,053,"Iowa","Decatur County",4,47,81,41,40
050,19,053,"Iowa","Decatur County",4,48,80,39,41
050,19,053,"Iowa","Decatur County",4,49,71,36,35
050,19,053,"Iowa","Decatur County",4,50,75,46,29
050,19,053,"Iowa","Decatur County",4,51,76,44,32
050,19,053,"Iowa","Decatur County",4,52,77,35,42
050,19,053,"Iowa","Decatur County",4,53,76,35,41
050,19,053,"Iowa","Decatur County",4,54,74,37,37
050,19,053,"Iowa","Decatur County",4,55,63,27,36
050,19,053,"Iowa","Decatur County",4,56,67,35,32
050,19,053,"Iowa","Decatur County",4,57,86,42,44
050,19,053,"Iowa","Decatur County",4,58,89,41,48
050,19,053,"Iowa","Decatur County",4,59,94,51,43
050,19,053,"Iowa","Decatur County",4,60,89,41,48
050,19,053,"Iowa","Decatur County",4,61,107,47,60
050,19,053,"Iowa","Decatur County",4,62,103,53,50
050,19,053,"Iowa","Decatur County",4,63,104,51,53
050,19,053,"Iowa","Decatur County",4,64,103,51,52
050,19,053,"Iowa","Decatur County",4,65,95,50,45
050,19,053,"Iowa","Decatur County",4,66,88,42,46
050,19,053,"Iowa","Decatur County",4,67,97,45,52
050,19,053,"Iowa","Decatur County",4,68,91,43,48
050,19,053,"Iowa","Decatur County",4,69,100,51,49
050,19,053,"Iowa","Decatur County",4,70,102,52,50
050,19,053,"Iowa","Decatur County",4,71,91,48,43
050,19,053,"Iowa","Decatur County",4,72,72,37,35
050,19,053,"Iowa","Decatur County",4,73,83,40,43
050,19,053,"Iowa","Decatur County",4,74,73,37,36
050,19,053,"Iowa","Decatur County",4,75,86,47,39
050,19,053,"Iowa","Decatur County",4,76,56,25,31
050,19,053,"Iowa","Decatur County",4,77,55,20,35
050,19,053,"Iowa","Decatur County",4,78,67,29,38
050,19,053,"Iowa","Decatur County",4,79,60,28,32
050,19,053,"Iowa","Decatur County",4,80,43,18,25
050,19,053,"Iowa","Decatur County",4,81,45,21,24
050,19,053,"Iowa","Decatur County",4,82,45,20,25
050,19,053,"Iowa","Decatur County",4,83,41,15,26
050,19,053,"Iowa","Decatur County",4,84,35,16,19
050,19,053,"Iowa","Decatur County",4,85,195,71,124
050,19,053,"Iowa","Decatur County",5,0,86,37,49
050,19,053,"Iowa","Decatur County",5,1,97,37,60
050,19,053,"Iowa","Decatur County",5,2,90,38,52
050,19,053,"Iowa","Decatur County",5,3,80,40,40
050,19,053,"Iowa","Decatur County",5,4,91,48,43
050,19,053,"Iowa","Decatur County",5,5,89,46,43
050,19,053,"Iowa","Decatur County",5,6,106,52,54
050,19,053,"Iowa","Decatur County",5,7,120,58,62
050,19,053,"Iowa","Decatur County",5,8,104,59,45
050,19,053,"Iowa","Decatur County",5,9,110,58,52
050,19,053,"Iowa","Decatur County",5,10,104,60,44
050,19,053,"Iowa","Decatur County",5,11,95,54,41
050,19,053,"Iowa","Decatur County",5,12,76,38,38
050,19,053,"Iowa","Decatur County",5,13,94,49,45
050,19,053,"Iowa","Decatur County",5,14,103,57,46
050,19,053,"Iowa","Decatur County",5,15,120,60,60
050,19,053,"Iowa","Decatur County",5,16,111,54,57
050,19,053,"Iowa","Decatur County",5,17,114,52,62
050,19,053,"Iowa","Decatur County",5,18,152,74,78
050,19,053,"Iowa","Decatur County",5,19,194,105,89
050,19,053,"Iowa","Decatur County",5,20,203,98,105
050,19,053,"Iowa","Decatur County",5,21,211,122,89
050,19,053,"Iowa","Decatur County",5,22,166,82,84
050,19,053,"Iowa","Decatur County",5,23,122,72,50
050,19,053,"Iowa","Decatur County",5,24,100,59,41
050,19,053,"Iowa","Decatur County",5,25,69,41,28
050,19,053,"Iowa","Decatur County",5,26,78,37,41
050,19,053,"Iowa","Decatur County",5,27,64,29,35
050,19,053,"Iowa","Decatur County",5,28,85,43,42
050,19,053,"Iowa","Decatur County",5,29,87,43,44
050,19,053,"Iowa","Decatur County",5,30,63,42,21
050,19,053,"Iowa","Decatur County",5,31,86,43,43
050,19,053,"Iowa","Decatur County",5,32,78,34,44
050,19,053,"Iowa","Decatur County",5,33,73,29,44
050,19,053,"Iowa","Decatur County",5,34,71,34,37
050,19,053,"Iowa","Decatur County",5,35,77,45,32
050,19,053,"Iowa","Decatur County",5,36,73,39,34
050,19,053,"Iowa","Decatur County",5,37,76,44,32
050,19,053,"Iowa","Decatur County",5,38,85,38,47
050,19,053,"Iowa","Decatur County",5,39,73,36,37
050,19,053,"Iowa","Decatur County",5,40,72,43,29
050,19,053,"Iowa","Decatur County",5,41,83,38,45
050,19,053,"Iowa","Decatur County",5,42,71,33,38
050,19,053,"Iowa","Decatur County",5,43,70,28,42
050,19,053,"Iowa","Decatur County",5,44,73,35,38
050,19,053,"Iowa","Decatur County",5,45,66,31,35
050,19,053,"Iowa","Decatur County",5,46,75,37,38
050,19,053,"Iowa","Decatur County",5,47,70,41,29
050,19,053,"Iowa","Decatur County",5,48,81,41,40
050,19,053,"Iowa","Decatur County",5,49,81,39,42
050,19,053,"Iowa","Decatur County",5,50,69,35,34
050,19,053,"Iowa","Decatur County",5,51,71,42,29
050,19,053,"Iowa","Decatur County",5,52,77,47,30
050,19,053,"Iowa","Decatur County",5,53,73,32,41
050,19,053,"Iowa","Decatur County",5,54,75,34,41
050,19,053,"Iowa","Decatur County",5,55,73,35,38
050,19,053,"Iowa","Decatur County",5,56,63,28,35
050,19,053,"Iowa","Decatur County",5,57,62,32,30
050,19,053,"Iowa","Decatur County",5,58,80,41,39
050,19,053,"Iowa","Decatur County",5,59,83,38,45
050,19,053,"Iowa","Decatur County",5,60,93,48,45
050,19,053,"Iowa","Decatur County",5,61,88,41,47
050,19,053,"Iowa","Decatur County",5,62,99,41,58
050,19,053,"Iowa","Decatur County",5,63,99,53,46
050,19,053,"Iowa","Decatur County",5,64,105,52,53
050,19,053,"Iowa","Decatur County",5,65,96,49,47
050,19,053,"Iowa","Decatur County",5,66,96,49,47
050,19,053,"Iowa","Decatur County",5,67,86,41,45
050,19,053,"Iowa","Decatur County",5,68,93,42,51
050,19,053,"Iowa","Decatur County",5,69,92,44,48
050,19,053,"Iowa","Decatur County",5,70,94,50,44
050,19,053,"Iowa","Decatur County",5,71,99,52,47
050,19,053,"Iowa","Decatur County",5,72,87,46,41
050,19,053,"Iowa","Decatur County",5,73,72,37,35
050,19,053,"Iowa","Decatur County",5,74,81,39,42
050,19,053,"Iowa","Decatur County",5,75,71,35,36
050,19,053,"Iowa","Decatur County",5,76,79,41,38
050,19,053,"Iowa","Decatur County",5,77,55,23,32
050,19,053,"Iowa","Decatur County",5,78,53,20,33
050,19,053,"Iowa","Decatur County",5,79,64,28,36
050,19,053,"Iowa","Decatur County",5,80,57,24,33
050,19,053,"Iowa","Decatur County",5,81,40,17,23
050,19,053,"Iowa","Decatur County",5,82,46,20,26
050,19,053,"Iowa","Decatur County",5,83,45,20,25
050,19,053,"Iowa","Decatur County",5,84,36,14,22
050,19,053,"Iowa","Decatur County",5,85,195,72,123
050,19,055,"Iowa","Delaware County",1,0,193,99,94
050,19,055,"Iowa","Delaware County",1,1,198,105,93
050,19,055,"Iowa","Delaware County",1,2,206,112,94
050,19,055,"Iowa","Delaware County",1,3,198,104,94
050,19,055,"Iowa","Delaware County",1,4,235,120,115
050,19,055,"Iowa","Delaware County",1,5,237,132,105
050,19,055,"Iowa","Delaware County",1,6,222,106,116
050,19,055,"Iowa","Delaware County",1,7,231,123,108
050,19,055,"Iowa","Delaware County",1,8,227,113,114
050,19,055,"Iowa","Delaware County",1,9,196,100,96
050,19,055,"Iowa","Delaware County",1,10,219,117,102
050,19,055,"Iowa","Delaware County",1,11,253,131,122
050,19,055,"Iowa","Delaware County",1,12,248,129,119
050,19,055,"Iowa","Delaware County",1,13,254,131,123
050,19,055,"Iowa","Delaware County",1,14,262,135,127
050,19,055,"Iowa","Delaware County",1,15,250,124,126
050,19,055,"Iowa","Delaware County",1,16,263,135,128
050,19,055,"Iowa","Delaware County",1,17,259,137,122
050,19,055,"Iowa","Delaware County",1,18,206,114,92
050,19,055,"Iowa","Delaware County",1,19,160,89,71
050,19,055,"Iowa","Delaware County",1,20,174,92,82
050,19,055,"Iowa","Delaware County",1,21,187,88,99
050,19,055,"Iowa","Delaware County",1,22,189,87,102
050,19,055,"Iowa","Delaware County",1,23,182,97,85
050,19,055,"Iowa","Delaware County",1,24,176,95,81
050,19,055,"Iowa","Delaware County",1,25,187,102,85
050,19,055,"Iowa","Delaware County",1,26,162,84,78
050,19,055,"Iowa","Delaware County",1,27,172,90,82
050,19,055,"Iowa","Delaware County",1,28,163,89,74
050,19,055,"Iowa","Delaware County",1,29,160,88,72
050,19,055,"Iowa","Delaware County",1,30,143,77,66
050,19,055,"Iowa","Delaware County",1,31,155,72,83
050,19,055,"Iowa","Delaware County",1,32,153,73,80
050,19,055,"Iowa","Delaware County",1,33,163,79,84
050,19,055,"Iowa","Delaware County",1,34,194,101,93
050,19,055,"Iowa","Delaware County",1,35,192,95,97
050,19,055,"Iowa","Delaware County",1,36,212,112,100
050,19,055,"Iowa","Delaware County",1,37,212,115,97
050,19,055,"Iowa","Delaware County",1,38,190,103,87
050,19,055,"Iowa","Delaware County",1,39,211,108,103
050,19,055,"Iowa","Delaware County",1,40,216,112,104
050,19,055,"Iowa","Delaware County",1,41,194,93,101
050,19,055,"Iowa","Delaware County",1,42,183,88,95
050,19,055,"Iowa","Delaware County",1,43,187,100,87
050,19,055,"Iowa","Delaware County",1,44,171,89,82
050,19,055,"Iowa","Delaware County",1,45,181,90,91
050,19,055,"Iowa","Delaware County",1,46,184,87,97
050,19,055,"Iowa","Delaware County",1,47,196,96,100
050,19,055,"Iowa","Delaware County",1,48,212,113,99
050,19,055,"Iowa","Delaware County",1,49,225,118,107
050,19,055,"Iowa","Delaware County",1,50,207,111,96
050,19,055,"Iowa","Delaware County",1,51,201,108,93
050,19,055,"Iowa","Delaware County",1,52,195,105,90
050,19,055,"Iowa","Delaware County",1,53,230,118,112
050,19,055,"Iowa","Delaware County",1,54,241,124,117
050,19,055,"Iowa","Delaware County",1,55,254,131,123
050,19,055,"Iowa","Delaware County",1,56,279,143,136
050,19,055,"Iowa","Delaware County",1,57,302,146,156
050,19,055,"Iowa","Delaware County",1,58,298,147,151
050,19,055,"Iowa","Delaware County",1,59,306,154,152
050,19,055,"Iowa","Delaware County",1,60,292,150,142
050,19,055,"Iowa","Delaware County",1,61,294,147,147
050,19,055,"Iowa","Delaware County",1,62,302,162,140
050,19,055,"Iowa","Delaware County",1,63,273,145,128
050,19,055,"Iowa","Delaware County",1,64,261,140,121
050,19,055,"Iowa","Delaware County",1,65,263,137,126
050,19,055,"Iowa","Delaware County",1,66,243,117,126
050,19,055,"Iowa","Delaware County",1,67,224,120,104
050,19,055,"Iowa","Delaware County",1,68,212,109,103
050,19,055,"Iowa","Delaware County",1,69,186,91,95
050,19,055,"Iowa","Delaware County",1,70,193,101,92
050,19,055,"Iowa","Delaware County",1,71,192,96,96
050,19,055,"Iowa","Delaware County",1,72,177,91,86
050,19,055,"Iowa","Delaware County",1,73,158,78,80
050,19,055,"Iowa","Delaware County",1,74,128,65,63
050,19,055,"Iowa","Delaware County",1,75,118,57,61
050,19,055,"Iowa","Delaware County",1,76,118,53,65
050,19,055,"Iowa","Delaware County",1,77,124,53,71
050,19,055,"Iowa","Delaware County",1,78,107,48,59
050,19,055,"Iowa","Delaware County",1,79,104,46,58
050,19,055,"Iowa","Delaware County",1,80,96,47,49
050,19,055,"Iowa","Delaware County",1,81,100,50,50
050,19,055,"Iowa","Delaware County",1,82,92,44,48
050,19,055,"Iowa","Delaware County",1,83,95,44,51
050,19,055,"Iowa","Delaware County",1,84,100,48,52
050,19,055,"Iowa","Delaware County",1,85,476,172,304
050,19,055,"Iowa","Delaware County",2,0,187,94,93
050,19,055,"Iowa","Delaware County",2,1,195,102,93
050,19,055,"Iowa","Delaware County",2,2,203,110,93
050,19,055,"Iowa","Delaware County",2,3,199,105,94
050,19,055,"Iowa","Delaware County",2,4,229,118,111
050,19,055,"Iowa","Delaware County",2,5,236,129,107
050,19,055,"Iowa","Delaware County",2,6,227,114,113
050,19,055,"Iowa","Delaware County",2,7,230,119,111
050,19,055,"Iowa","Delaware County",2,8,225,113,112
050,19,055,"Iowa","Delaware County",2,9,203,104,99
050,19,055,"Iowa","Delaware County",2,10,213,113,100
050,19,055,"Iowa","Delaware County",2,11,244,127,117
050,19,055,"Iowa","Delaware County",2,12,248,129,119
050,19,055,"Iowa","Delaware County",2,13,253,131,122
050,19,055,"Iowa","Delaware County",2,14,261,135,126
050,19,055,"Iowa","Delaware County",2,15,257,129,128
050,19,055,"Iowa","Delaware County",2,16,261,133,128
050,19,055,"Iowa","Delaware County",2,17,260,138,122
050,19,055,"Iowa","Delaware County",2,18,207,114,93
050,19,055,"Iowa","Delaware County",2,19,163,89,74
050,19,055,"Iowa","Delaware County",2,20,176,94,82
050,19,055,"Iowa","Delaware County",2,21,187,90,97
050,19,055,"Iowa","Delaware County",2,22,188,88,100
050,19,055,"Iowa","Delaware County",2,23,181,92,89
050,19,055,"Iowa","Delaware County",2,24,179,97,82
050,19,055,"Iowa","Delaware County",2,25,182,98,84
050,19,055,"Iowa","Delaware County",2,26,166,86,80
050,19,055,"Iowa","Delaware County",2,27,168,88,80
050,19,055,"Iowa","Delaware County",2,28,166,91,75
050,19,055,"Iowa","Delaware County",2,29,158,86,72
050,19,055,"Iowa","Delaware County",2,30,150,80,70
050,19,055,"Iowa","Delaware County",2,31,154,74,80
050,19,055,"Iowa","Delaware County",2,32,152,72,80
050,19,055,"Iowa","Delaware County",2,33,162,79,83
050,19,055,"Iowa","Delaware County",2,34,187,96,91
050,19,055,"Iowa","Delaware County",2,35,193,96,97
050,19,055,"Iowa","Delaware County",2,36,204,105,99
050,19,055,"Iowa","Delaware County",2,37,211,115,96
050,19,055,"Iowa","Delaware County",2,38,196,105,91
050,19,055,"Iowa","Delaware County",2,39,203,105,98
050,19,055,"Iowa","Delaware County",2,40,215,111,104
050,19,055,"Iowa","Delaware County",2,41,199,97,102
050,19,055,"Iowa","Delaware County",2,42,185,89,96
050,19,055,"Iowa","Delaware County",2,43,185,96,89
050,19,055,"Iowa","Delaware County",2,44,170,90,80
050,19,055,"Iowa","Delaware County",2,45,180,90,90
050,19,055,"Iowa","Delaware County",2,46,184,88,96
050,19,055,"Iowa","Delaware County",2,47,194,95,99
050,19,055,"Iowa","Delaware County",2,48,208,109,99
050,19,055,"Iowa","Delaware County",2,49,223,118,105
050,19,055,"Iowa","Delaware County",2,50,214,114,100
050,19,055,"Iowa","Delaware County",2,51,204,110,94
050,19,055,"Iowa","Delaware County",2,52,197,106,91
050,19,055,"Iowa","Delaware County",2,53,221,114,107
050,19,055,"Iowa","Delaware County",2,54,237,121,116
050,19,055,"Iowa","Delaware County",2,55,249,129,120
050,19,055,"Iowa","Delaware County",2,56,271,138,133
050,19,055,"Iowa","Delaware County",2,57,297,146,151
050,19,055,"Iowa","Delaware County",2,58,298,146,152
050,19,055,"Iowa","Delaware County",2,59,306,154,152
050,19,055,"Iowa","Delaware County",2,60,295,151,144
050,19,055,"Iowa","Delaware County",2,61,292,147,145
050,19,055,"Iowa","Delaware County",2,62,299,158,141
050,19,055,"Iowa","Delaware County",2,63,282,150,132
050,19,055,"Iowa","Delaware County",2,64,261,140,121
050,19,055,"Iowa","Delaware County",2,65,264,138,126
050,19,055,"Iowa","Delaware County",2,66,246,121,125
050,19,055,"Iowa","Delaware County",2,67,229,119,110
050,19,055,"Iowa","Delaware County",2,68,211,110,101
050,19,055,"Iowa","Delaware County",2,69,193,95,98
050,19,055,"Iowa","Delaware County",2,70,190,97,93
050,19,055,"Iowa","Delaware County",2,71,193,97,96
050,19,055,"Iowa","Delaware County",2,72,178,91,87
050,19,055,"Iowa","Delaware County",2,73,170,85,85
050,19,055,"Iowa","Delaware County",2,74,124,62,62
050,19,055,"Iowa","Delaware County",2,75,121,59,62
050,19,055,"Iowa","Delaware County",2,76,115,52,63
050,19,055,"Iowa","Delaware County",2,77,128,55,73
050,19,055,"Iowa","Delaware County",2,78,105,47,58
050,19,055,"Iowa","Delaware County",2,79,104,45,59
050,19,055,"Iowa","Delaware County",2,80,97,46,51
050,19,055,"Iowa","Delaware County",2,81,99,49,50
050,19,055,"Iowa","Delaware County",2,82,92,44,48
050,19,055,"Iowa","Delaware County",2,83,95,44,51
050,19,055,"Iowa","Delaware County",2,84,96,47,49
050,19,055,"Iowa","Delaware County",2,85,478,175,303
050,19,055,"Iowa","Delaware County",3,0,200,109,91
050,19,055,"Iowa","Delaware County",3,1,211,112,99
050,19,055,"Iowa","Delaware County",3,2,195,100,95
050,19,055,"Iowa","Delaware County",3,3,216,115,101
050,19,055,"Iowa","Delaware County",3,4,205,108,97
050,19,055,"Iowa","Delaware County",3,5,228,117,111
050,19,055,"Iowa","Delaware County",3,6,238,131,107
050,19,055,"Iowa","Delaware County",3,7,238,115,123
050,19,055,"Iowa","Delaware County",3,8,227,113,114
050,19,055,"Iowa","Delaware County",3,9,218,110,108
050,19,055,"Iowa","Delaware County",3,10,200,106,94
050,19,055,"Iowa","Delaware County",3,11,221,116,105
050,19,055,"Iowa","Delaware County",3,12,245,129,116
050,19,055,"Iowa","Delaware County",3,13,254,136,118
050,19,055,"Iowa","Delaware County",3,14,253,130,123
050,19,055,"Iowa","Delaware County",3,15,265,137,128
050,19,055,"Iowa","Delaware County",3,16,255,128,127
050,19,055,"Iowa","Delaware County",3,17,259,131,128
050,19,055,"Iowa","Delaware County",3,18,220,120,100
050,19,055,"Iowa","Delaware County",3,19,159,87,72
050,19,055,"Iowa","Delaware County",3,20,177,96,81
050,19,055,"Iowa","Delaware County",3,21,191,104,87
050,19,055,"Iowa","Delaware County",3,22,192,93,99
050,19,055,"Iowa","Delaware County",3,23,174,91,83
050,19,055,"Iowa","Delaware County",3,24,185,88,97
050,19,055,"Iowa","Delaware County",3,25,187,104,83
050,19,055,"Iowa","Delaware County",3,26,179,97,82
050,19,055,"Iowa","Delaware County",3,27,170,89,81
050,19,055,"Iowa","Delaware County",3,28,158,85,73
050,19,055,"Iowa","Delaware County",3,29,154,80,74
050,19,055,"Iowa","Delaware County",3,30,164,83,81
050,19,055,"Iowa","Delaware County",3,31,161,84,77
050,19,055,"Iowa","Delaware County",3,32,157,75,82
050,19,055,"Iowa","Delaware County",3,33,164,82,82
050,19,055,"Iowa","Delaware County",3,34,165,83,82
050,19,055,"Iowa","Delaware County",3,35,185,94,91
050,19,055,"Iowa","Delaware County",3,36,194,96,98
050,19,055,"Iowa","Delaware County",3,37,207,106,101
050,19,055,"Iowa","Delaware County",3,38,213,120,93
050,19,055,"Iowa","Delaware County",3,39,194,107,87
050,19,055,"Iowa","Delaware County",3,40,203,106,97
050,19,055,"Iowa","Delaware County",3,41,208,108,100
050,19,055,"Iowa","Delaware County",3,42,203,93,110
050,19,055,"Iowa","Delaware County",3,43,187,90,97
050,19,055,"Iowa","Delaware County",3,44,185,96,89
050,19,055,"Iowa","Delaware County",3,45,166,88,78
050,19,055,"Iowa","Delaware County",3,46,183,91,92
050,19,055,"Iowa","Delaware County",3,47,181,87,94
050,19,055,"Iowa","Delaware County",3,48,192,96,96
050,19,055,"Iowa","Delaware County",3,49,207,106,101
050,19,055,"Iowa","Delaware County",3,50,221,115,106
050,19,055,"Iowa","Delaware County",3,51,215,114,101
050,19,055,"Iowa","Delaware County",3,52,204,112,92
050,19,055,"Iowa","Delaware County",3,53,201,105,96
050,19,055,"Iowa","Delaware County",3,54,224,118,106
050,19,055,"Iowa","Delaware County",3,55,239,126,113
050,19,055,"Iowa","Delaware County",3,56,250,128,122
050,19,055,"Iowa","Delaware County",3,57,273,140,133
050,19,055,"Iowa","Delaware County",3,58,296,144,152
050,19,055,"Iowa","Delaware County",3,59,306,145,161
050,19,055,"Iowa","Delaware County",3,60,306,155,151
050,19,055,"Iowa","Delaware County",3,61,294,151,143
050,19,055,"Iowa","Delaware County",3,62,295,152,143
050,19,055,"Iowa","Delaware County",3,63,301,161,140
050,19,055,"Iowa","Delaware County",3,64,288,154,134
050,19,055,"Iowa","Delaware County",3,65,265,139,126
050,19,055,"Iowa","Delaware County",3,66,254,134,120
050,19,055,"Iowa","Delaware County",3,67,243,121,122
050,19,055,"Iowa","Delaware County",3,68,224,116,108
050,19,055,"Iowa","Delaware County",3,69,212,112,100
050,19,055,"Iowa","Delaware County",3,70,191,93,98
050,19,055,"Iowa","Delaware County",3,71,186,94,92
050,19,055,"Iowa","Delaware County",3,72,193,96,97
050,19,055,"Iowa","Delaware County",3,73,173,89,84
050,19,055,"Iowa","Delaware County",3,74,170,85,85
050,19,055,"Iowa","Delaware County",3,75,121,61,60
050,19,055,"Iowa","Delaware County",3,76,122,59,63
050,19,055,"Iowa","Delaware County",3,77,118,55,63
050,19,055,"Iowa","Delaware County",3,78,112,48,64
050,19,055,"Iowa","Delaware County",3,79,104,45,59
050,19,055,"Iowa","Delaware County",3,80,102,44,58
050,19,055,"Iowa","Delaware County",3,81,89,43,46
050,19,055,"Iowa","Delaware County",3,82,94,45,49
050,19,055,"Iowa","Delaware County",3,83,96,44,52
050,19,055,"Iowa","Delaware County",3,84,89,41,48
050,19,055,"Iowa","Delaware County",3,85,489,187,302
050,19,055,"Iowa","Delaware County",4,0,201,109,92
050,19,055,"Iowa","Delaware County",4,1,196,102,94
050,19,055,"Iowa","Delaware County",4,2,215,110,105
050,19,055,"Iowa","Delaware County",4,3,187,95,92
050,19,055,"Iowa","Delaware County",4,4,220,118,102
050,19,055,"Iowa","Delaware County",4,5,200,104,96
050,19,055,"Iowa","Delaware County",4,6,231,113,118
050,19,055,"Iowa","Delaware County",4,7,249,136,113
050,19,055,"Iowa","Delaware County",4,8,229,110,119
050,19,055,"Iowa","Delaware County",4,9,233,117,116
050,19,055,"Iowa","Delaware County",4,10,223,116,107
050,19,055,"Iowa","Delaware County",4,11,200,105,95
050,19,055,"Iowa","Delaware County",4,12,226,119,107
050,19,055,"Iowa","Delaware County",4,13,250,130,120
050,19,055,"Iowa","Delaware County",4,14,263,137,126
050,19,055,"Iowa","Delaware County",4,15,258,133,125
050,19,055,"Iowa","Delaware County",4,16,268,144,124
050,19,055,"Iowa","Delaware County",4,17,257,130,127
050,19,055,"Iowa","Delaware County",4,18,213,113,100
050,19,055,"Iowa","Delaware County",4,19,169,93,76
050,19,055,"Iowa","Delaware County",4,20,165,93,72
050,19,055,"Iowa","Delaware County",4,21,189,103,86
050,19,055,"Iowa","Delaware County",4,22,195,107,88
050,19,055,"Iowa","Delaware County",4,23,195,91,104
050,19,055,"Iowa","Delaware County",4,24,187,98,89
050,19,055,"Iowa","Delaware County",4,25,186,79,107
050,19,055,"Iowa","Delaware County",4,26,166,94,72
050,19,055,"Iowa","Delaware County",4,27,173,94,79
050,19,055,"Iowa","Delaware County",4,28,178,88,90
050,19,055,"Iowa","Delaware County",4,29,153,81,72
050,19,055,"Iowa","Delaware County",4,30,172,92,80
050,19,055,"Iowa","Delaware County",4,31,166,78,88
050,19,055,"Iowa","Delaware County",4,32,174,90,84
050,19,055,"Iowa","Delaware County",4,33,163,80,83
050,19,055,"Iowa","Delaware County",4,34,174,88,86
050,19,055,"Iowa","Delaware County",4,35,166,86,80
050,19,055,"Iowa","Delaware County",4,36,182,91,91
050,19,055,"Iowa","Delaware County",4,37,196,97,99
050,19,055,"Iowa","Delaware County",4,38,215,111,104
050,19,055,"Iowa","Delaware County",4,39,214,119,95
050,19,055,"Iowa","Delaware County",4,40,194,105,89
050,19,055,"Iowa","Delaware County",4,41,207,106,101
050,19,055,"Iowa","Delaware County",4,42,210,110,100
050,19,055,"Iowa","Delaware County",4,43,203,95,108
050,19,055,"Iowa","Delaware County",4,44,180,87,93
050,19,055,"Iowa","Delaware County",4,45,192,99,93
050,19,055,"Iowa","Delaware County",4,46,170,88,82
050,19,055,"Iowa","Delaware County",4,47,185,94,91
050,19,055,"Iowa","Delaware County",4,48,179,86,93
050,19,055,"Iowa","Delaware County",4,49,191,96,95
050,19,055,"Iowa","Delaware County",4,50,210,109,101
050,19,055,"Iowa","Delaware County",4,51,222,115,107
050,19,055,"Iowa","Delaware County",4,52,221,118,103
050,19,055,"Iowa","Delaware County",4,53,207,116,91
050,19,055,"Iowa","Delaware County",4,54,203,105,98
050,19,055,"Iowa","Delaware County",4,55,223,117,106
050,19,055,"Iowa","Delaware County",4,56,236,124,112
050,19,055,"Iowa","Delaware County",4,57,250,128,122
050,19,055,"Iowa","Delaware County",4,58,272,140,132
050,19,055,"Iowa","Delaware County",4,59,295,143,152
050,19,055,"Iowa","Delaware County",4,60,302,144,158
050,19,055,"Iowa","Delaware County",4,61,308,155,153
050,19,055,"Iowa","Delaware County",4,62,286,145,141
050,19,055,"Iowa","Delaware County",4,63,291,148,143
050,19,055,"Iowa","Delaware County",4,64,297,158,139
050,19,055,"Iowa","Delaware County",4,65,292,154,138
050,19,055,"Iowa","Delaware County",4,66,252,131,121
050,19,055,"Iowa","Delaware County",4,67,246,131,115
050,19,055,"Iowa","Delaware County",4,68,245,124,121
050,19,055,"Iowa","Delaware County",4,69,221,114,107
050,19,055,"Iowa","Delaware County",4,70,212,114,98
050,19,055,"Iowa","Delaware County",4,71,194,93,101
050,19,055,"Iowa","Delaware County",4,72,184,93,91
050,19,055,"Iowa","Delaware County",4,73,182,94,88
050,19,055,"Iowa","Delaware County",4,74,167,87,80
050,19,055,"Iowa","Delaware County",4,75,165,82,83
050,19,055,"Iowa","Delaware County",4,76,116,58,58
050,19,055,"Iowa","Delaware County",4,77,122,59,63
050,19,055,"Iowa","Delaware County",4,78,108,52,56
050,19,055,"Iowa","Delaware County",4,79,110,44,66
050,19,055,"Iowa","Delaware County",4,80,97,41,56
050,19,055,"Iowa","Delaware County",4,81,96,40,56
050,19,055,"Iowa","Delaware County",4,82,81,37,44
050,19,055,"Iowa","Delaware County",4,83,97,43,54
050,19,055,"Iowa","Delaware County",4,84,95,45,50
050,19,055,"Iowa","Delaware County",4,85,494,198,296
050,19,055,"Iowa","Delaware County",5,0,201,108,93
050,19,055,"Iowa","Delaware County",5,1,224,125,99
050,19,055,"Iowa","Delaware County",5,2,199,103,96
050,19,055,"Iowa","Delaware County",5,3,220,115,105
050,19,055,"Iowa","Delaware County",5,4,198,101,97
050,19,055,"Iowa","Delaware County",5,5,233,131,102
050,19,055,"Iowa","Delaware County",5,6,204,101,103
050,19,055,"Iowa","Delaware County",5,7,226,111,115
050,19,055,"Iowa","Delaware County",5,8,247,137,110
050,19,055,"Iowa","Delaware County",5,9,226,105,121
050,19,055,"Iowa","Delaware County",5,10,228,115,113
050,19,055,"Iowa","Delaware County",5,11,216,111,105
050,19,055,"Iowa","Delaware County",5,12,205,109,96
050,19,055,"Iowa","Delaware County",5,13,219,112,107
050,19,055,"Iowa","Delaware County",5,14,244,126,118
050,19,055,"Iowa","Delaware County",5,15,256,137,119
050,19,055,"Iowa","Delaware County",5,16,260,134,126
050,19,055,"Iowa","Delaware County",5,17,266,137,129
050,19,055,"Iowa","Delaware County",5,18,208,108,100
050,19,055,"Iowa","Delaware County",5,19,159,82,77
050,19,055,"Iowa","Delaware County",5,20,175,99,76
050,19,055,"Iowa","Delaware County",5,21,177,96,81
050,19,055,"Iowa","Delaware County",5,22,192,101,91
050,19,055,"Iowa","Delaware County",5,23,191,104,87
050,19,055,"Iowa","Delaware County",5,24,181,86,95
050,19,055,"Iowa","Delaware County",5,25,181,99,82
050,19,055,"Iowa","Delaware County",5,26,181,84,97
050,19,055,"Iowa","Delaware County",5,27,173,92,81
050,19,055,"Iowa","Delaware County",5,28,183,97,86
050,19,055,"Iowa","Delaware County",5,29,189,95,94
050,19,055,"Iowa","Delaware County",5,30,160,80,80
050,19,055,"Iowa","Delaware County",5,31,171,92,79
050,19,055,"Iowa","Delaware County",5,32,185,86,99
050,19,055,"Iowa","Delaware County",5,33,179,93,86
050,19,055,"Iowa","Delaware County",5,34,161,77,84
050,19,055,"Iowa","Delaware County",5,35,187,96,91
050,19,055,"Iowa","Delaware County",5,36,172,90,82
050,19,055,"Iowa","Delaware County",5,37,179,92,87
050,19,055,"Iowa","Delaware County",5,38,197,97,100
050,19,055,"Iowa","Delaware County",5,39,208,111,97
050,19,055,"Iowa","Delaware County",5,40,213,117,96
050,19,055,"Iowa","Delaware County",5,41,197,105,92
050,19,055,"Iowa","Delaware County",5,42,207,104,103
050,19,055,"Iowa","Delaware County",5,43,210,108,102
050,19,055,"Iowa","Delaware County",5,44,199,93,106
050,19,055,"Iowa","Delaware County",5,45,178,85,93
050,19,055,"Iowa","Delaware County",5,46,192,99,93
050,19,055,"Iowa","Delaware County",5,47,171,87,84
050,19,055,"Iowa","Delaware County",5,48,182,94,88
050,19,055,"Iowa","Delaware County",5,49,179,86,93
050,19,055,"Iowa","Delaware County",5,50,192,96,96
050,19,055,"Iowa","Delaware County",5,51,212,113,99
050,19,055,"Iowa","Delaware County",5,52,219,111,108
050,19,055,"Iowa","Delaware County",5,53,220,117,103
050,19,055,"Iowa","Delaware County",5,54,207,116,91
050,19,055,"Iowa","Delaware County",5,55,199,103,96
050,19,055,"Iowa","Delaware County",5,56,217,115,102
050,19,055,"Iowa","Delaware County",5,57,236,124,112
050,19,055,"Iowa","Delaware County",5,58,248,126,122
050,19,055,"Iowa","Delaware County",5,59,276,142,134
050,19,055,"Iowa","Delaware County",5,60,291,141,150
050,19,055,"Iowa","Delaware County",5,61,298,143,155
050,19,055,"Iowa","Delaware County",5,62,301,149,152
050,19,055,"Iowa","Delaware County",5,63,284,144,140
050,19,055,"Iowa","Delaware County",5,64,283,146,137
050,19,055,"Iowa","Delaware County",5,65,299,158,141
050,19,055,"Iowa","Delaware County",5,66,282,150,132
050,19,055,"Iowa","Delaware County",5,67,253,131,122
050,19,055,"Iowa","Delaware County",5,68,239,128,111
050,19,055,"Iowa","Delaware County",5,69,236,117,119
050,19,055,"Iowa","Delaware County",5,70,217,110,107
050,19,055,"Iowa","Delaware County",5,71,212,116,96
050,19,055,"Iowa","Delaware County",5,72,190,89,101
050,19,055,"Iowa","Delaware County",5,73,182,95,87
050,19,055,"Iowa","Delaware County",5,74,179,89,90
050,19,055,"Iowa","Delaware County",5,75,164,84,80
050,19,055,"Iowa","Delaware County",5,76,156,77,79
050,19,055,"Iowa","Delaware County",5,77,122,59,63
050,19,055,"Iowa","Delaware County",5,78,113,56,57
050,19,055,"Iowa","Delaware County",5,79,105,47,58
050,19,055,"Iowa","Delaware County",5,80,105,43,62
050,19,055,"Iowa","Delaware County",5,81,94,42,52
050,19,055,"Iowa","Delaware County",5,82,87,33,54
050,19,055,"Iowa","Delaware County",5,83,86,35,51
050,19,055,"Iowa","Delaware County",5,84,95,42,53
050,19,055,"Iowa","Delaware County",5,85,512,215,297
050,19,057,"Iowa","Des Moines County",1,0,436,223,213
050,19,057,"Iowa","Des Moines County",1,1,424,213,211
050,19,057,"Iowa","Des Moines County",1,2,443,223,220
050,19,057,"Iowa","Des Moines County",1,3,424,203,221
050,19,057,"Iowa","Des Moines County",1,4,512,256,256
050,19,057,"Iowa","Des Moines County",1,5,469,242,227
050,19,057,"Iowa","Des Moines County",1,6,479,245,234
050,19,057,"Iowa","Des Moines County",1,7,489,247,242
050,19,057,"Iowa","Des Moines County",1,8,481,247,234
050,19,057,"Iowa","Des Moines County",1,9,495,264,231
050,19,057,"Iowa","Des Moines County",1,10,533,279,254
050,19,057,"Iowa","Des Moines County",1,11,555,292,263
050,19,057,"Iowa","Des Moines County",1,12,562,282,280
050,19,057,"Iowa","Des Moines County",1,13,547,275,272
050,19,057,"Iowa","Des Moines County",1,14,530,266,264
050,19,057,"Iowa","Des Moines County",1,15,509,249,260
050,19,057,"Iowa","Des Moines County",1,16,491,254,237
050,19,057,"Iowa","Des Moines County",1,17,481,236,245
050,19,057,"Iowa","Des Moines County",1,18,435,212,223
050,19,057,"Iowa","Des Moines County",1,19,389,201,188
050,19,057,"Iowa","Des Moines County",1,20,402,204,198
050,19,057,"Iowa","Des Moines County",1,21,398,206,192
050,19,057,"Iowa","Des Moines County",1,22,421,216,205
050,19,057,"Iowa","Des Moines County",1,23,452,228,224
050,19,057,"Iowa","Des Moines County",1,24,412,216,196
050,19,057,"Iowa","Des Moines County",1,25,444,226,218
050,19,057,"Iowa","Des Moines County",1,26,454,223,231
050,19,057,"Iowa","Des Moines County",1,27,458,226,232
050,19,057,"Iowa","Des Moines County",1,28,462,223,239
050,19,057,"Iowa","Des Moines County",1,29,441,221,220
050,19,057,"Iowa","Des Moines County",1,30,401,204,197
050,19,057,"Iowa","Des Moines County",1,31,419,211,208
050,19,057,"Iowa","Des Moines County",1,32,379,175,204
050,19,057,"Iowa","Des Moines County",1,33,415,185,230
050,19,057,"Iowa","Des Moines County",1,34,462,223,239
050,19,057,"Iowa","Des Moines County",1,35,468,225,243
050,19,057,"Iowa","Des Moines County",1,36,468,221,247
050,19,057,"Iowa","Des Moines County",1,37,496,242,254
050,19,057,"Iowa","Des Moines County",1,38,487,230,257
050,19,057,"Iowa","Des Moines County",1,39,504,251,253
050,19,057,"Iowa","Des Moines County",1,40,509,255,254
050,19,057,"Iowa","Des Moines County",1,41,468,237,231
050,19,057,"Iowa","Des Moines County",1,42,429,231,198
050,19,057,"Iowa","Des Moines County",1,43,439,234,205
050,19,057,"Iowa","Des Moines County",1,44,403,194,209
050,19,057,"Iowa","Des Moines County",1,45,434,208,226
050,19,057,"Iowa","Des Moines County",1,46,426,212,214
050,19,057,"Iowa","Des Moines County",1,47,406,196,210
050,19,057,"Iowa","Des Moines County",1,48,452,230,222
050,19,057,"Iowa","Des Moines County",1,49,484,239,245
050,19,057,"Iowa","Des Moines County",1,50,491,243,248
050,19,057,"Iowa","Des Moines County",1,51,481,232,249
050,19,057,"Iowa","Des Moines County",1,52,445,219,226
050,19,057,"Iowa","Des Moines County",1,53,466,237,229
050,19,057,"Iowa","Des Moines County",1,54,480,245,235
050,19,057,"Iowa","Des Moines County",1,55,537,266,271
050,19,057,"Iowa","Des Moines County",1,56,555,270,285
050,19,057,"Iowa","Des Moines County",1,57,575,276,299
050,19,057,"Iowa","Des Moines County",1,58,572,271,301
050,19,057,"Iowa","Des Moines County",1,59,575,280,295
050,19,057,"Iowa","Des Moines County",1,60,557,280,277
050,19,057,"Iowa","Des Moines County",1,61,550,272,278
050,19,057,"Iowa","Des Moines County",1,62,572,291,281
050,19,057,"Iowa","Des Moines County",1,63,572,291,281
050,19,057,"Iowa","Des Moines County",1,64,516,250,266
050,19,057,"Iowa","Des Moines County",1,65,525,264,261
050,19,057,"Iowa","Des Moines County",1,66,526,255,271
050,19,057,"Iowa","Des Moines County",1,67,531,257,274
050,19,057,"Iowa","Des Moines County",1,68,498,244,254
050,19,057,"Iowa","Des Moines County",1,69,473,239,234
050,19,057,"Iowa","Des Moines County",1,70,478,236,242
050,19,057,"Iowa","Des Moines County",1,71,447,215,232
050,19,057,"Iowa","Des Moines County",1,72,443,196,247
050,19,057,"Iowa","Des Moines County",1,73,426,198,228
050,19,057,"Iowa","Des Moines County",1,74,313,145,168
050,19,057,"Iowa","Des Moines County",1,75,306,148,158
050,19,057,"Iowa","Des Moines County",1,76,299,146,153
050,19,057,"Iowa","Des Moines County",1,77,332,159,173
050,19,057,"Iowa","Des Moines County",1,78,269,122,147
050,19,057,"Iowa","Des Moines County",1,79,236,109,127
050,19,057,"Iowa","Des Moines County",1,80,231,97,134
050,19,057,"Iowa","Des Moines County",1,81,200,86,114
050,19,057,"Iowa","Des Moines County",1,82,186,76,110
050,19,057,"Iowa","Des Moines County",1,83,169,70,99
050,19,057,"Iowa","Des Moines County",1,84,156,65,91
050,19,057,"Iowa","Des Moines County",1,85,945,320,625
050,19,057,"Iowa","Des Moines County",2,0,434,222,212
050,19,057,"Iowa","Des Moines County",2,1,423,214,209
050,19,057,"Iowa","Des Moines County",2,2,435,217,218
050,19,057,"Iowa","Des Moines County",2,3,426,208,218
050,19,057,"Iowa","Des Moines County",2,4,490,241,249
050,19,057,"Iowa","Des Moines County",2,5,477,246,231
050,19,057,"Iowa","Des Moines County",2,6,475,244,231
050,19,057,"Iowa","Des Moines County",2,7,483,244,239
050,19,057,"Iowa","Des Moines County",2,8,482,247,235
050,19,057,"Iowa","Des Moines County",2,9,490,260,230
050,19,057,"Iowa","Des Moines County",2,10,521,273,248
050,19,057,"Iowa","Des Moines County",2,11,544,286,258
050,19,057,"Iowa","Des Moines County",2,12,560,285,275
050,19,057,"Iowa","Des Moines County",2,13,548,275,273
050,19,057,"Iowa","Des Moines County",2,14,533,268,265
050,19,057,"Iowa","Des Moines County",2,15,511,254,257
050,19,057,"Iowa","Des Moines County",2,16,495,253,242
050,19,057,"Iowa","Des Moines County",2,17,485,240,245
050,19,057,"Iowa","Des Moines County",2,18,431,213,218
050,19,057,"Iowa","Des Moines County",2,19,387,197,190
050,19,057,"Iowa","Des Moines County",2,20,406,208,198
050,19,057,"Iowa","Des Moines County",2,21,401,207,194
050,19,057,"Iowa","Des Moines County",2,22,425,217,208
050,19,057,"Iowa","Des Moines County",2,23,444,225,219
050,19,057,"Iowa","Des Moines County",2,24,425,222,203
050,19,057,"Iowa","Des Moines County",2,25,438,224,214
050,19,057,"Iowa","Des Moines County",2,26,453,225,228
050,19,057,"Iowa","Des Moines County",2,27,458,226,232
050,19,057,"Iowa","Des Moines County",2,28,459,224,235
050,19,057,"Iowa","Des Moines County",2,29,440,218,222
050,19,057,"Iowa","Des Moines County",2,30,417,211,206
050,19,057,"Iowa","Des Moines County",2,31,409,206,203
050,19,057,"Iowa","Des Moines County",2,32,388,183,205
050,19,057,"Iowa","Des Moines County",2,33,405,183,222
050,19,057,"Iowa","Des Moines County",2,34,448,214,234
050,19,057,"Iowa","Des Moines County",2,35,467,226,241
050,19,057,"Iowa","Des Moines County",2,36,461,220,241
050,19,057,"Iowa","Des Moines County",2,37,491,238,253
050,19,057,"Iowa","Des Moines County",2,38,489,233,256
050,19,057,"Iowa","Des Moines County",2,39,499,245,254
050,19,057,"Iowa","Des Moines County",2,40,509,254,255
050,19,057,"Iowa","Des Moines County",2,41,478,239,239
050,19,057,"Iowa","Des Moines County",2,42,432,230,202
050,19,057,"Iowa","Des Moines County",2,43,442,236,206
050,19,057,"Iowa","Des Moines County",2,44,408,200,208
050,19,057,"Iowa","Des Moines County",2,45,427,202,225
050,19,057,"Iowa","Des Moines County",2,46,424,210,214
050,19,057,"Iowa","Des Moines County",2,47,408,198,210
050,19,057,"Iowa","Des Moines County",2,48,437,220,217
050,19,057,"Iowa","Des Moines County",2,49,476,236,240
050,19,057,"Iowa","Des Moines County",2,50,486,241,245
050,19,057,"Iowa","Des Moines County",2,51,482,234,248
050,19,057,"Iowa","Des Moines County",2,52,452,221,231
050,19,057,"Iowa","Des Moines County",2,53,461,231,230
050,19,057,"Iowa","Des Moines County",2,54,477,244,233
050,19,057,"Iowa","Des Moines County",2,55,519,259,260
050,19,057,"Iowa","Des Moines County",2,56,551,269,282
050,19,057,"Iowa","Des Moines County",2,57,570,275,295
050,19,057,"Iowa","Des Moines County",2,58,566,268,298
050,19,057,"Iowa","Des Moines County",2,59,574,278,296
050,19,057,"Iowa","Des Moines County",2,60,561,280,281
050,19,057,"Iowa","Des Moines County",2,61,545,271,274
050,19,057,"Iowa","Des Moines County",2,62,563,285,278
050,19,057,"Iowa","Des Moines County",2,63,574,291,283
050,19,057,"Iowa","Des Moines County",2,64,525,258,267
050,19,057,"Iowa","Des Moines County",2,65,521,261,260
050,19,057,"Iowa","Des Moines County",2,66,525,256,269
050,19,057,"Iowa","Des Moines County",2,67,528,257,271
050,19,057,"Iowa","Des Moines County",2,68,503,245,258
050,19,057,"Iowa","Des Moines County",2,69,481,241,240
050,19,057,"Iowa","Des Moines County",2,70,476,235,241
050,19,057,"Iowa","Des Moines County",2,71,454,220,234
050,19,057,"Iowa","Des Moines County",2,72,436,198,238
050,19,057,"Iowa","Des Moines County",2,73,452,206,246
050,19,057,"Iowa","Des Moines County",2,74,315,146,169
050,19,057,"Iowa","Des Moines County",2,75,307,148,159
050,19,057,"Iowa","Des Moines County",2,76,297,144,153
050,19,057,"Iowa","Des Moines County",2,77,327,157,170
050,19,057,"Iowa","Des Moines County",2,78,275,127,148
050,19,057,"Iowa","Des Moines County",2,79,242,110,132
050,19,057,"Iowa","Des Moines County",2,80,227,99,128
050,19,057,"Iowa","Des Moines County",2,81,203,87,116
050,19,057,"Iowa","Des Moines County",2,82,189,79,110
050,19,057,"Iowa","Des Moines County",2,83,167,66,101
050,19,057,"Iowa","Des Moines County",2,84,157,65,92
050,19,057,"Iowa","Des Moines County",2,85,941,319,622
050,19,057,"Iowa","Des Moines County",3,0,401,201,200
050,19,057,"Iowa","Des Moines County",3,1,419,226,193
050,19,057,"Iowa","Des Moines County",3,2,407,207,200
050,19,057,"Iowa","Des Moines County",3,3,428,200,228
050,19,057,"Iowa","Des Moines County",3,4,415,201,214
050,19,057,"Iowa","Des Moines County",3,5,487,239,248
050,19,057,"Iowa","Des Moines County",3,6,472,250,222
050,19,057,"Iowa","Des Moines County",3,7,484,250,234
050,19,057,"Iowa","Des Moines County",3,8,482,250,232
050,19,057,"Iowa","Des Moines County",3,9,468,243,225
050,19,057,"Iowa","Des Moines County",3,10,483,252,231
050,19,057,"Iowa","Des Moines County",3,11,517,269,248
050,19,057,"Iowa","Des Moines County",3,12,552,290,262
050,19,057,"Iowa","Des Moines County",3,13,557,280,277
050,19,057,"Iowa","Des Moines County",3,14,545,267,278
050,19,057,"Iowa","Des Moines County",3,15,536,270,266
050,19,057,"Iowa","Des Moines County",3,16,506,251,255
050,19,057,"Iowa","Des Moines County",3,17,504,249,255
050,19,057,"Iowa","Des Moines County",3,18,438,224,214
050,19,057,"Iowa","Des Moines County",3,19,377,186,191
050,19,057,"Iowa","Des Moines County",3,20,397,194,203
050,19,057,"Iowa","Des Moines County",3,21,424,215,209
050,19,057,"Iowa","Des Moines County",3,22,413,209,204
050,19,057,"Iowa","Des Moines County",3,23,419,215,204
050,19,057,"Iowa","Des Moines County",3,24,457,236,221
050,19,057,"Iowa","Des Moines County",3,25,431,220,211
050,19,057,"Iowa","Des Moines County",3,26,450,226,224
050,19,057,"Iowa","Des Moines County",3,27,439,221,218
050,19,057,"Iowa","Des Moines County",3,28,447,208,239
050,19,057,"Iowa","Des Moines County",3,29,443,219,224
050,19,057,"Iowa","Des Moines County",3,30,435,218,217
050,19,057,"Iowa","Des Moines County",3,31,435,217,218
050,19,057,"Iowa","Des Moines County",3,32,412,205,207
050,19,057,"Iowa","Des Moines County",3,33,395,185,210
050,19,057,"Iowa","Des Moines County",3,34,393,182,211
050,19,057,"Iowa","Des Moines County",3,35,434,210,224
050,19,057,"Iowa","Des Moines County",3,36,474,234,240
050,19,057,"Iowa","Des Moines County",3,37,466,220,246
050,19,057,"Iowa","Des Moines County",3,38,494,240,254
050,19,057,"Iowa","Des Moines County",3,39,476,231,245
050,19,057,"Iowa","Des Moines County",3,40,505,244,261
050,19,057,"Iowa","Des Moines County",3,41,508,255,253
050,19,057,"Iowa","Des Moines County",3,42,473,238,235
050,19,057,"Iowa","Des Moines County",3,43,433,230,203
050,19,057,"Iowa","Des Moines County",3,44,447,232,215
050,19,057,"Iowa","Des Moines County",3,45,393,194,199
050,19,057,"Iowa","Des Moines County",3,46,426,202,224
050,19,057,"Iowa","Des Moines County",3,47,429,213,216
050,19,057,"Iowa","Des Moines County",3,48,400,196,204
050,19,057,"Iowa","Des Moines County",3,49,443,229,214
050,19,057,"Iowa","Des Moines County",3,50,484,240,244
050,19,057,"Iowa","Des Moines County",3,51,483,242,241
050,19,057,"Iowa","Des Moines County",3,52,482,235,247
050,19,057,"Iowa","Des Moines County",3,53,445,213,232
050,19,057,"Iowa","Des Moines County",3,54,459,232,227
050,19,057,"Iowa","Des Moines County",3,55,473,244,229
050,19,057,"Iowa","Des Moines County",3,56,511,255,256
050,19,057,"Iowa","Des Moines County",3,57,551,271,280
050,19,057,"Iowa","Des Moines County",3,58,552,269,283
050,19,057,"Iowa","Des Moines County",3,59,546,254,292
050,19,057,"Iowa","Des Moines County",3,60,570,278,292
050,19,057,"Iowa","Des Moines County",3,61,559,275,284
050,19,057,"Iowa","Des Moines County",3,62,537,266,271
050,19,057,"Iowa","Des Moines County",3,63,551,281,270
050,19,057,"Iowa","Des Moines County",3,64,550,275,275
050,19,057,"Iowa","Des Moines County",3,65,520,254,266
050,19,057,"Iowa","Des Moines County",3,66,507,254,253
050,19,057,"Iowa","Des Moines County",3,67,510,250,260
050,19,057,"Iowa","Des Moines County",3,68,510,241,269
050,19,057,"Iowa","Des Moines County",3,69,486,240,246
050,19,057,"Iowa","Des Moines County",3,70,467,231,236
050,19,057,"Iowa","Des Moines County",3,71,465,230,235
050,19,057,"Iowa","Des Moines County",3,72,443,210,233
050,19,057,"Iowa","Des Moines County",3,73,426,192,234
050,19,057,"Iowa","Des Moines County",3,74,438,196,242
050,19,057,"Iowa","Des Moines County",3,75,298,144,154
050,19,057,"Iowa","Des Moines County",3,76,299,141,158
050,19,057,"Iowa","Des Moines County",3,77,274,131,143
050,19,057,"Iowa","Des Moines County",3,78,305,144,161
050,19,057,"Iowa","Des Moines County",3,79,256,118,138
050,19,057,"Iowa","Des Moines County",3,80,224,96,128
050,19,057,"Iowa","Des Moines County",3,81,212,90,122
050,19,057,"Iowa","Des Moines County",3,82,186,82,104
050,19,057,"Iowa","Des Moines County",3,83,175,68,107
050,19,057,"Iowa","Des Moines County",3,84,152,64,88
050,19,057,"Iowa","Des Moines County",3,85,931,332,599
050,19,057,"Iowa","Des Moines County",4,0,404,200,204
050,19,057,"Iowa","Des Moines County",4,1,413,216,197
050,19,057,"Iowa","Des Moines County",4,2,424,224,200
050,19,057,"Iowa","Des Moines County",4,3,409,214,195
050,19,057,"Iowa","Des Moines County",4,4,411,195,216
050,19,057,"Iowa","Des Moines County",4,5,425,211,214
050,19,057,"Iowa","Des Moines County",4,6,501,244,257
050,19,057,"Iowa","Des Moines County",4,7,468,250,218
050,19,057,"Iowa","Des Moines County",4,8,487,246,241
050,19,057,"Iowa","Des Moines County",4,9,470,247,223
050,19,057,"Iowa","Des Moines County",4,10,460,238,222
050,19,057,"Iowa","Des Moines County",4,11,495,258,237
050,19,057,"Iowa","Des Moines County",4,12,504,267,237
050,19,057,"Iowa","Des Moines County",4,13,543,285,258
050,19,057,"Iowa","Des Moines County",4,14,552,281,271
050,19,057,"Iowa","Des Moines County",4,15,541,266,275
050,19,057,"Iowa","Des Moines County",4,16,529,273,256
050,19,057,"Iowa","Des Moines County",4,17,496,243,253
050,19,057,"Iowa","Des Moines County",4,18,438,220,218
050,19,057,"Iowa","Des Moines County",4,19,375,196,179
050,19,057,"Iowa","Des Moines County",4,20,390,180,210
050,19,057,"Iowa","Des Moines County",4,21,400,192,208
050,19,057,"Iowa","Des Moines County",4,22,445,224,221
050,19,057,"Iowa","Des Moines County",4,23,421,215,206
050,19,057,"Iowa","Des Moines County",4,24,435,228,207
050,19,057,"Iowa","Des Moines County",4,25,439,217,222
050,19,057,"Iowa","Des Moines County",4,26,455,244,211
050,19,057,"Iowa","Des Moines County",4,27,449,215,234
050,19,057,"Iowa","Des Moines County",4,28,423,217,206
050,19,057,"Iowa","Des Moines County",4,29,453,214,239
050,19,057,"Iowa","Des Moines County",4,30,455,228,227
050,19,057,"Iowa","Des Moines County",4,31,437,213,224
050,19,057,"Iowa","Des Moines County",4,32,445,223,222
050,19,057,"Iowa","Des Moines County",4,33,423,208,215
050,19,057,"Iowa","Des Moines County",4,34,390,187,203
050,19,057,"Iowa","Des Moines County",4,35,387,178,209
050,19,057,"Iowa","Des Moines County",4,36,430,207,223
050,19,057,"Iowa","Des Moines County",4,37,483,239,244
050,19,057,"Iowa","Des Moines County",4,38,463,224,239
050,19,057,"Iowa","Des Moines County",4,39,503,243,260
050,19,057,"Iowa","Des Moines County",4,40,469,223,246
050,19,057,"Iowa","Des Moines County",4,41,504,242,262
050,19,057,"Iowa","Des Moines County",4,42,498,254,244
050,19,057,"Iowa","Des Moines County",4,43,475,240,235
050,19,057,"Iowa","Des Moines County",4,44,428,231,197
050,19,057,"Iowa","Des Moines County",4,45,441,230,211
050,19,057,"Iowa","Des Moines County",4,46,379,191,188
050,19,057,"Iowa","Des Moines County",4,47,424,196,228
050,19,057,"Iowa","Des Moines County",4,48,426,209,217
050,19,057,"Iowa","Des Moines County",4,49,407,204,203
050,19,057,"Iowa","Des Moines County",4,50,444,225,219
050,19,057,"Iowa","Des Moines County",4,51,492,249,243
050,19,057,"Iowa","Des Moines County",4,52,488,251,237
050,19,057,"Iowa","Des Moines County",4,53,469,228,241
050,19,057,"Iowa","Des Moines County",4,54,435,211,224
050,19,057,"Iowa","Des Moines County",4,55,450,227,223
050,19,057,"Iowa","Des Moines County",4,56,456,232,224
050,19,057,"Iowa","Des Moines County",4,57,510,250,260
050,19,057,"Iowa","Des Moines County",4,58,534,257,277
050,19,057,"Iowa","Des Moines County",4,59,555,272,283
050,19,057,"Iowa","Des Moines County",4,60,538,253,285
050,19,057,"Iowa","Des Moines County",4,61,564,276,288
050,19,057,"Iowa","Des Moines County",4,62,543,272,271
050,19,057,"Iowa","Des Moines County",4,63,516,255,261
050,19,057,"Iowa","Des Moines County",4,64,537,274,263
050,19,057,"Iowa","Des Moines County",4,65,535,265,270
050,19,057,"Iowa","Des Moines County",4,66,508,243,265
050,19,057,"Iowa","Des Moines County",4,67,495,245,250
050,19,057,"Iowa","Des Moines County",4,68,501,240,261
050,19,057,"Iowa","Des Moines County",4,69,499,239,260
050,19,057,"Iowa","Des Moines County",4,70,477,235,242
050,19,057,"Iowa","Des Moines County",4,71,454,229,225
050,19,057,"Iowa","Des Moines County",4,72,453,224,229
050,19,057,"Iowa","Des Moines County",4,73,421,198,223
050,19,057,"Iowa","Des Moines County",4,74,424,192,232
050,19,057,"Iowa","Des Moines County",4,75,421,189,232
050,19,057,"Iowa","Des Moines County",4,76,288,143,145
050,19,057,"Iowa","Des Moines County",4,77,284,135,149
050,19,057,"Iowa","Des Moines County",4,78,258,124,134
050,19,057,"Iowa","Des Moines County",4,79,289,136,153
050,19,057,"Iowa","Des Moines County",4,80,238,107,131
050,19,057,"Iowa","Des Moines County",4,81,213,90,123
050,19,057,"Iowa","Des Moines County",4,82,196,82,114
050,19,057,"Iowa","Des Moines County",4,83,167,67,100
050,19,057,"Iowa","Des Moines County",4,84,164,67,97
050,19,057,"Iowa","Des Moines County",4,85,904,335,569
050,19,057,"Iowa","Des Moines County",5,0,411,204,207
050,19,057,"Iowa","Des Moines County",5,1,389,199,190
050,19,057,"Iowa","Des Moines County",5,2,423,219,204
050,19,057,"Iowa","Des Moines County",5,3,424,220,204
050,19,057,"Iowa","Des Moines County",5,4,413,214,199
050,19,057,"Iowa","Des Moines County",5,5,413,195,218
050,19,057,"Iowa","Des Moines County",5,6,420,210,210
050,19,057,"Iowa","Des Moines County",5,7,492,244,248
050,19,057,"Iowa","Des Moines County",5,8,476,261,215
050,19,057,"Iowa","Des Moines County",5,9,480,245,235
050,19,057,"Iowa","Des Moines County",5,10,486,254,232
050,19,057,"Iowa","Des Moines County",5,11,463,238,225
050,19,057,"Iowa","Des Moines County",5,12,485,259,226
050,19,057,"Iowa","Des Moines County",5,13,505,273,232
050,19,057,"Iowa","Des Moines County",5,14,544,285,259
050,19,057,"Iowa","Des Moines County",5,15,561,277,284
050,19,057,"Iowa","Des Moines County",5,16,548,272,276
050,19,057,"Iowa","Des Moines County",5,17,525,273,252
050,19,057,"Iowa","Des Moines County",5,18,447,229,218
050,19,057,"Iowa","Des Moines County",5,19,393,199,194
050,19,057,"Iowa","Des Moines County",5,20,374,185,189
050,19,057,"Iowa","Des Moines County",5,21,402,189,213
050,19,057,"Iowa","Des Moines County",5,22,414,196,218
050,19,057,"Iowa","Des Moines County",5,23,459,231,228
050,19,057,"Iowa","Des Moines County",5,24,428,220,208
050,19,057,"Iowa","Des Moines County",5,25,441,226,215
050,19,057,"Iowa","Des Moines County",5,26,450,231,219
050,19,057,"Iowa","Des Moines County",5,27,472,239,233
050,19,057,"Iowa","Des Moines County",5,28,444,218,226
050,19,057,"Iowa","Des Moines County",5,29,429,224,205
050,19,057,"Iowa","Des Moines County",5,30,466,226,240
050,19,057,"Iowa","Des Moines County",5,31,469,237,232
050,19,057,"Iowa","Des Moines County",5,32,451,218,233
050,19,057,"Iowa","Des Moines County",5,33,452,218,234
050,19,057,"Iowa","Des Moines County",5,34,429,220,209
050,19,057,"Iowa","Des Moines County",5,35,384,183,201
050,19,057,"Iowa","Des Moines County",5,36,380,179,201
050,19,057,"Iowa","Des Moines County",5,37,422,208,214
050,19,057,"Iowa","Des Moines County",5,38,490,240,250
050,19,057,"Iowa","Des Moines County",5,39,469,233,236
050,19,057,"Iowa","Des Moines County",5,40,503,244,259
050,19,057,"Iowa","Des Moines County",5,41,458,215,243
050,19,057,"Iowa","Des Moines County",5,42,498,244,254
050,19,057,"Iowa","Des Moines County",5,43,496,253,243
050,19,057,"Iowa","Des Moines County",5,44,471,234,237
050,19,057,"Iowa","Des Moines County",5,45,428,231,197
050,19,057,"Iowa","Des Moines County",5,46,434,228,206
050,19,057,"Iowa","Des Moines County",5,47,387,187,200
050,19,057,"Iowa","Des Moines County",5,48,413,189,224
050,19,057,"Iowa","Des Moines County",5,49,426,214,212
050,19,057,"Iowa","Des Moines County",5,50,403,202,201
050,19,057,"Iowa","Des Moines County",5,51,435,218,217
050,19,057,"Iowa","Des Moines County",5,52,498,254,244
050,19,057,"Iowa","Des Moines County",5,53,480,244,236
050,19,057,"Iowa","Des Moines County",5,54,458,224,234
050,19,057,"Iowa","Des Moines County",5,55,437,210,227
050,19,057,"Iowa","Des Moines County",5,56,441,217,224
050,19,057,"Iowa","Des Moines County",5,57,458,236,222
050,19,057,"Iowa","Des Moines County",5,58,506,243,263
050,19,057,"Iowa","Des Moines County",5,59,537,256,281
050,19,057,"Iowa","Des Moines County",5,60,555,279,276
050,19,057,"Iowa","Des Moines County",5,61,539,256,283
050,19,057,"Iowa","Des Moines County",5,62,563,281,282
050,19,057,"Iowa","Des Moines County",5,63,532,269,263
050,19,057,"Iowa","Des Moines County",5,64,513,250,263
050,19,057,"Iowa","Des Moines County",5,65,527,264,263
050,19,057,"Iowa","Des Moines County",5,66,525,254,271
050,19,057,"Iowa","Des Moines County",5,67,499,241,258
050,19,057,"Iowa","Des Moines County",5,68,490,240,250
050,19,057,"Iowa","Des Moines County",5,69,496,235,261
050,19,057,"Iowa","Des Moines County",5,70,497,232,265
050,19,057,"Iowa","Des Moines County",5,71,467,236,231
050,19,057,"Iowa","Des Moines County",5,72,446,222,224
050,19,057,"Iowa","Des Moines County",5,73,446,223,223
050,19,057,"Iowa","Des Moines County",5,74,409,191,218
050,19,057,"Iowa","Des Moines County",5,75,410,189,221
050,19,057,"Iowa","Des Moines County",5,76,410,184,226
050,19,057,"Iowa","Des Moines County",5,77,270,137,133
050,19,057,"Iowa","Des Moines County",5,78,274,129,145
050,19,057,"Iowa","Des Moines County",5,79,242,114,128
050,19,057,"Iowa","Des Moines County",5,80,274,125,149
050,19,057,"Iowa","Des Moines County",5,81,222,93,129
050,19,057,"Iowa","Des Moines County",5,82,198,84,114
050,19,057,"Iowa","Des Moines County",5,83,176,66,110
050,19,057,"Iowa","Des Moines County",5,84,157,67,90
050,19,057,"Iowa","Des Moines County",5,85,926,347,579
050,19,059,"Iowa","Dickinson County",1,0,155,80,75
050,19,059,"Iowa","Dickinson County",1,1,176,91,85
050,19,059,"Iowa","Dickinson County",1,2,175,87,88
050,19,059,"Iowa","Dickinson County",1,3,151,72,79
050,19,059,"Iowa","Dickinson County",1,4,200,95,105
050,19,059,"Iowa","Dickinson County",1,5,192,99,93
050,19,059,"Iowa","Dickinson County",1,6,189,91,98
050,19,059,"Iowa","Dickinson County",1,7,194,93,101
050,19,059,"Iowa","Dickinson County",1,8,176,97,79
050,19,059,"Iowa","Dickinson County",1,9,168,101,67
050,19,059,"Iowa","Dickinson County",1,10,219,125,94
050,19,059,"Iowa","Dickinson County",1,11,208,107,101
050,19,059,"Iowa","Dickinson County",1,12,210,110,100
050,19,059,"Iowa","Dickinson County",1,13,209,108,101
050,19,059,"Iowa","Dickinson County",1,14,203,111,92
050,19,059,"Iowa","Dickinson County",1,15,205,100,105
050,19,059,"Iowa","Dickinson County",1,16,200,108,92
050,19,059,"Iowa","Dickinson County",1,17,191,110,81
050,19,059,"Iowa","Dickinson County",1,18,175,102,73
050,19,059,"Iowa","Dickinson County",1,19,144,70,74
050,19,059,"Iowa","Dickinson County",1,20,152,71,81
050,19,059,"Iowa","Dickinson County",1,21,164,79,85
050,19,059,"Iowa","Dickinson County",1,22,185,92,93
050,19,059,"Iowa","Dickinson County",1,23,188,92,96
050,19,059,"Iowa","Dickinson County",1,24,169,88,81
050,19,059,"Iowa","Dickinson County",1,25,169,91,78
050,19,059,"Iowa","Dickinson County",1,26,166,79,87
050,19,059,"Iowa","Dickinson County",1,27,166,78,88
050,19,059,"Iowa","Dickinson County",1,28,178,83,95
050,19,059,"Iowa","Dickinson County",1,29,211,111,100
050,19,059,"Iowa","Dickinson County",1,30,183,99,84
050,19,059,"Iowa","Dickinson County",1,31,159,88,71
050,19,059,"Iowa","Dickinson County",1,32,161,80,81
050,19,059,"Iowa","Dickinson County",1,33,173,93,80
050,19,059,"Iowa","Dickinson County",1,34,202,106,96
050,19,059,"Iowa","Dickinson County",1,35,195,111,84
050,19,059,"Iowa","Dickinson County",1,36,182,101,81
050,19,059,"Iowa","Dickinson County",1,37,196,106,90
050,19,059,"Iowa","Dickinson County",1,38,178,94,84
050,19,059,"Iowa","Dickinson County",1,39,190,94,96
050,19,059,"Iowa","Dickinson County",1,40,191,98,93
050,19,059,"Iowa","Dickinson County",1,41,192,102,90
050,19,059,"Iowa","Dickinson County",1,42,211,113,98
050,19,059,"Iowa","Dickinson County",1,43,175,94,81
050,19,059,"Iowa","Dickinson County",1,44,171,94,77
050,19,059,"Iowa","Dickinson County",1,45,183,101,82
050,19,059,"Iowa","Dickinson County",1,46,175,89,86
050,19,059,"Iowa","Dickinson County",1,47,170,85,85
050,19,059,"Iowa","Dickinson County",1,48,194,104,90
050,19,059,"Iowa","Dickinson County",1,49,237,126,111
050,19,059,"Iowa","Dickinson County",1,50,236,118,118
050,19,059,"Iowa","Dickinson County",1,51,205,106,99
050,19,059,"Iowa","Dickinson County",1,52,185,98,87
050,19,059,"Iowa","Dickinson County",1,53,186,92,94
050,19,059,"Iowa","Dickinson County",1,54,198,104,94
050,19,059,"Iowa","Dickinson County",1,55,233,104,129
050,19,059,"Iowa","Dickinson County",1,56,220,99,121
050,19,059,"Iowa","Dickinson County",1,57,240,132,108
050,19,059,"Iowa","Dickinson County",1,58,285,141,144
050,19,059,"Iowa","Dickinson County",1,59,285,143,142
050,19,059,"Iowa","Dickinson County",1,60,272,127,145
050,19,059,"Iowa","Dickinson County",1,61,292,148,144
050,19,059,"Iowa","Dickinson County",1,62,283,135,148
050,19,059,"Iowa","Dickinson County",1,63,295,156,139
050,19,059,"Iowa","Dickinson County",1,64,313,157,156
050,19,059,"Iowa","Dickinson County",1,65,316,151,165
050,19,059,"Iowa","Dickinson County",1,66,294,147,147
050,19,059,"Iowa","Dickinson County",1,67,322,153,169
050,19,059,"Iowa","Dickinson County",1,68,316,147,169
050,19,059,"Iowa","Dickinson County",1,69,281,129,152
050,19,059,"Iowa","Dickinson County",1,70,274,142,132
050,19,059,"Iowa","Dickinson County",1,71,281,146,135
050,19,059,"Iowa","Dickinson County",1,72,273,138,135
050,19,059,"Iowa","Dickinson County",1,73,261,129,132
050,19,059,"Iowa","Dickinson County",1,74,166,78,88
050,19,059,"Iowa","Dickinson County",1,75,160,67,93
050,19,059,"Iowa","Dickinson County",1,76,176,83,93
050,19,059,"Iowa","Dickinson County",1,77,161,71,90
050,19,059,"Iowa","Dickinson County",1,78,143,70,73
050,19,059,"Iowa","Dickinson County",1,79,138,75,63
050,19,059,"Iowa","Dickinson County",1,80,120,58,62
050,19,059,"Iowa","Dickinson County",1,81,116,46,70
050,19,059,"Iowa","Dickinson County",1,82,99,42,57
050,19,059,"Iowa","Dickinson County",1,83,113,45,68
050,19,059,"Iowa","Dickinson County",1,84,96,44,52
050,19,059,"Iowa","Dickinson County",1,85,663,229,434
050,19,059,"Iowa","Dickinson County",2,0,159,79,80
050,19,059,"Iowa","Dickinson County",2,1,173,89,84
050,19,059,"Iowa","Dickinson County",2,2,174,86,88
050,19,059,"Iowa","Dickinson County",2,3,158,76,82
050,19,059,"Iowa","Dickinson County",2,4,194,93,101
050,19,059,"Iowa","Dickinson County",2,5,195,99,96
050,19,059,"Iowa","Dickinson County",2,6,192,95,97
050,19,059,"Iowa","Dickinson County",2,7,193,94,99
050,19,059,"Iowa","Dickinson County",2,8,178,95,83
050,19,059,"Iowa","Dickinson County",2,9,173,102,71
050,19,059,"Iowa","Dickinson County",2,10,208,119,89
050,19,059,"Iowa","Dickinson County",2,11,211,112,99
050,19,059,"Iowa","Dickinson County",2,12,211,109,102
050,19,059,"Iowa","Dickinson County",2,13,209,108,101
050,19,059,"Iowa","Dickinson County",2,14,206,111,95
050,19,059,"Iowa","Dickinson County",2,15,206,105,101
050,19,059,"Iowa","Dickinson County",2,16,204,108,96
050,19,059,"Iowa","Dickinson County",2,17,197,113,84
050,19,059,"Iowa","Dickinson County",2,18,169,99,70
050,19,059,"Iowa","Dickinson County",2,19,144,73,71
050,19,059,"Iowa","Dickinson County",2,20,156,74,82
050,19,059,"Iowa","Dickinson County",2,21,168,81,87
050,19,059,"Iowa","Dickinson County",2,22,184,91,93
050,19,059,"Iowa","Dickinson County",2,23,190,94,96
050,19,059,"Iowa","Dickinson County",2,24,176,90,86
050,19,059,"Iowa","Dickinson County",2,25,170,90,80
050,19,059,"Iowa","Dickinson County",2,26,168,82,86
050,19,059,"Iowa","Dickinson County",2,27,166,77,89
050,19,059,"Iowa","Dickinson County",2,28,182,86,96
050,19,059,"Iowa","Dickinson County",2,29,206,106,100
050,19,059,"Iowa","Dickinson County",2,30,191,105,86
050,19,059,"Iowa","Dickinson County",2,31,168,93,75
050,19,059,"Iowa","Dickinson County",2,32,161,83,78
050,19,059,"Iowa","Dickinson County",2,33,172,90,82
050,19,059,"Iowa","Dickinson County",2,34,194,102,92
050,19,059,"Iowa","Dickinson County",2,35,198,111,87
050,19,059,"Iowa","Dickinson County",2,36,186,105,81
050,19,059,"Iowa","Dickinson County",2,37,192,104,88
050,19,059,"Iowa","Dickinson County",2,38,184,97,87
050,19,059,"Iowa","Dickinson County",2,39,188,95,93
050,19,059,"Iowa","Dickinson County",2,40,191,98,93
050,19,059,"Iowa","Dickinson County",2,41,192,101,91
050,19,059,"Iowa","Dickinson County",2,42,206,109,97
050,19,059,"Iowa","Dickinson County",2,43,183,100,83
050,19,059,"Iowa","Dickinson County",2,44,170,92,78
050,19,059,"Iowa","Dickinson County",2,45,179,97,82
050,19,059,"Iowa","Dickinson County",2,46,176,92,84
050,19,059,"Iowa","Dickinson County",2,47,169,86,83
050,19,059,"Iowa","Dickinson County",2,48,188,100,88
050,19,059,"Iowa","Dickinson County",2,49,231,122,109
050,19,059,"Iowa","Dickinson County",2,50,234,119,115
050,19,059,"Iowa","Dickinson County",2,51,212,109,103
050,19,059,"Iowa","Dickinson County",2,52,189,99,90
050,19,059,"Iowa","Dickinson County",2,53,186,93,93
050,19,059,"Iowa","Dickinson County",2,54,195,102,93
050,19,059,"Iowa","Dickinson County",2,55,228,105,123
050,19,059,"Iowa","Dickinson County",2,56,223,101,122
050,19,059,"Iowa","Dickinson County",2,57,237,125,112
050,19,059,"Iowa","Dickinson County",2,58,274,138,136
050,19,059,"Iowa","Dickinson County",2,59,287,144,143
050,19,059,"Iowa","Dickinson County",2,60,278,133,145
050,19,059,"Iowa","Dickinson County",2,61,286,141,145
050,19,059,"Iowa","Dickinson County",2,62,285,139,146
050,19,059,"Iowa","Dickinson County",2,63,293,151,142
050,19,059,"Iowa","Dickinson County",2,64,309,157,152
050,19,059,"Iowa","Dickinson County",2,65,316,153,163
050,19,059,"Iowa","Dickinson County",2,66,302,149,153
050,19,059,"Iowa","Dickinson County",2,67,318,153,165
050,19,059,"Iowa","Dickinson County",2,68,314,147,167
050,19,059,"Iowa","Dickinson County",2,69,293,135,158
050,19,059,"Iowa","Dickinson County",2,70,277,140,137
050,19,059,"Iowa","Dickinson County",2,71,277,144,133
050,19,059,"Iowa","Dickinson County",2,72,269,137,132
050,19,059,"Iowa","Dickinson County",2,73,277,137,140
050,19,059,"Iowa","Dickinson County",2,74,175,84,91
050,19,059,"Iowa","Dickinson County",2,75,165,71,94
050,19,059,"Iowa","Dickinson County",2,76,170,79,91
050,19,059,"Iowa","Dickinson County",2,77,168,77,91
050,19,059,"Iowa","Dickinson County",2,78,144,69,75
050,19,059,"Iowa","Dickinson County",2,79,140,74,66
050,19,059,"Iowa","Dickinson County",2,80,123,62,61
050,19,059,"Iowa","Dickinson County",2,81,115,48,67
050,19,059,"Iowa","Dickinson County",2,82,99,41,58
050,19,059,"Iowa","Dickinson County",2,83,107,43,64
050,19,059,"Iowa","Dickinson County",2,84,97,43,54
050,19,059,"Iowa","Dickinson County",2,85,666,230,436
050,19,059,"Iowa","Dickinson County",3,0,172,78,94
050,19,059,"Iowa","Dickinson County",3,1,176,90,86
050,19,059,"Iowa","Dickinson County",3,2,182,94,88
050,19,059,"Iowa","Dickinson County",3,3,181,89,92
050,19,059,"Iowa","Dickinson County",3,4,165,79,86
050,19,059,"Iowa","Dickinson County",3,5,191,89,102
050,19,059,"Iowa","Dickinson County",3,6,198,98,100
050,19,059,"Iowa","Dickinson County",3,7,194,96,98
050,19,059,"Iowa","Dickinson County",3,8,186,97,89
050,19,059,"Iowa","Dickinson County",3,9,183,96,87
050,19,059,"Iowa","Dickinson County",3,10,174,103,71
050,19,059,"Iowa","Dickinson County",3,11,204,116,88
050,19,059,"Iowa","Dickinson County",3,12,207,111,96
050,19,059,"Iowa","Dickinson County",3,13,207,108,99
050,19,059,"Iowa","Dickinson County",3,14,215,108,107
050,19,059,"Iowa","Dickinson County",3,15,208,115,93
050,19,059,"Iowa","Dickinson County",3,16,215,108,107
050,19,059,"Iowa","Dickinson County",3,17,203,109,94
050,19,059,"Iowa","Dickinson County",3,18,179,100,79
050,19,059,"Iowa","Dickinson County",3,19,129,76,53
050,19,059,"Iowa","Dickinson County",3,20,156,76,80
050,19,059,"Iowa","Dickinson County",3,21,160,75,85
050,19,059,"Iowa","Dickinson County",3,22,171,79,92
050,19,059,"Iowa","Dickinson County",3,23,197,90,107
050,19,059,"Iowa","Dickinson County",3,24,193,103,90
050,19,059,"Iowa","Dickinson County",3,25,181,92,89
050,19,059,"Iowa","Dickinson County",3,26,158,87,71
050,19,059,"Iowa","Dickinson County",3,27,161,84,77
050,19,059,"Iowa","Dickinson County",3,28,172,79,93
050,19,059,"Iowa","Dickinson County",3,29,189,92,97
050,19,059,"Iowa","Dickinson County",3,30,208,107,101
050,19,059,"Iowa","Dickinson County",3,31,193,107,86
050,19,059,"Iowa","Dickinson County",3,32,171,96,75
050,19,059,"Iowa","Dickinson County",3,33,166,84,82
050,19,059,"Iowa","Dickinson County",3,34,162,89,73
050,19,059,"Iowa","Dickinson County",3,35,184,101,83
050,19,059,"Iowa","Dickinson County",3,36,207,108,99
050,19,059,"Iowa","Dickinson County",3,37,186,104,82
050,19,059,"Iowa","Dickinson County",3,38,184,96,88
050,19,059,"Iowa","Dickinson County",3,39,188,95,93
050,19,059,"Iowa","Dickinson County",3,40,191,98,93
050,19,059,"Iowa","Dickinson County",3,41,189,99,90
050,19,059,"Iowa","Dickinson County",3,42,191,95,96
050,19,059,"Iowa","Dickinson County",3,43,216,115,101
050,19,059,"Iowa","Dickinson County",3,44,190,103,87
050,19,059,"Iowa","Dickinson County",3,45,170,88,82
050,19,059,"Iowa","Dickinson County",3,46,186,98,88
050,19,059,"Iowa","Dickinson County",3,47,174,93,81
050,19,059,"Iowa","Dickinson County",3,48,169,85,84
050,19,059,"Iowa","Dickinson County",3,49,196,103,93
050,19,059,"Iowa","Dickinson County",3,50,230,117,113
050,19,059,"Iowa","Dickinson County",3,51,238,118,120
050,19,059,"Iowa","Dickinson County",3,52,217,112,105
050,19,059,"Iowa","Dickinson County",3,53,200,105,95
050,19,059,"Iowa","Dickinson County",3,54,189,93,96
050,19,059,"Iowa","Dickinson County",3,55,212,106,106
050,19,059,"Iowa","Dickinson County",3,56,227,108,119
050,19,059,"Iowa","Dickinson County",3,57,226,102,124
050,19,059,"Iowa","Dickinson County",3,58,244,126,118
050,19,059,"Iowa","Dickinson County",3,59,283,142,141
050,19,059,"Iowa","Dickinson County",3,60,293,145,148
050,19,059,"Iowa","Dickinson County",3,61,296,145,151
050,19,059,"Iowa","Dickinson County",3,62,296,145,151
050,19,059,"Iowa","Dickinson County",3,63,282,137,145
050,19,059,"Iowa","Dickinson County",3,64,294,144,150
050,19,059,"Iowa","Dickinson County",3,65,298,149,149
050,19,059,"Iowa","Dickinson County",3,66,314,153,161
050,19,059,"Iowa","Dickinson County",3,67,308,155,153
050,19,059,"Iowa","Dickinson County",3,68,313,148,165
050,19,059,"Iowa","Dickinson County",3,69,305,142,163
050,19,059,"Iowa","Dickinson County",3,70,291,136,155
050,19,059,"Iowa","Dickinson County",3,71,269,137,132
050,19,059,"Iowa","Dickinson County",3,72,272,141,131
050,19,059,"Iowa","Dickinson County",3,73,263,132,131
050,19,059,"Iowa","Dickinson County",3,74,265,130,135
050,19,059,"Iowa","Dickinson County",3,75,175,83,92
050,19,059,"Iowa","Dickinson County",3,76,158,67,91
050,19,059,"Iowa","Dickinson County",3,77,164,79,85
050,19,059,"Iowa","Dickinson County",3,78,158,74,84
050,19,059,"Iowa","Dickinson County",3,79,142,65,77
050,19,059,"Iowa","Dickinson County",3,80,134,69,65
050,19,059,"Iowa","Dickinson County",3,81,120,61,59
050,19,059,"Iowa","Dickinson County",3,82,106,43,63
050,19,059,"Iowa","Dickinson County",3,83,94,40,54
050,19,059,"Iowa","Dickinson County",3,84,99,40,59
050,19,059,"Iowa","Dickinson County",3,85,665,227,438
050,19,059,"Iowa","Dickinson County",4,0,157,82,75
050,19,059,"Iowa","Dickinson County",4,1,167,73,94
050,19,059,"Iowa","Dickinson County",4,2,172,97,75
050,19,059,"Iowa","Dickinson County",4,3,183,95,88
050,19,059,"Iowa","Dickinson County",4,4,197,97,100
050,19,059,"Iowa","Dickinson County",4,5,174,83,91
050,19,059,"Iowa","Dickinson County",4,6,198,94,104
050,19,059,"Iowa","Dickinson County",4,7,197,102,95
050,19,059,"Iowa","Dickinson County",4,8,194,96,98
050,19,059,"Iowa","Dickinson County",4,9,185,94,91
050,19,059,"Iowa","Dickinson County",4,10,184,98,86
050,19,059,"Iowa","Dickinson County",4,11,167,97,70
050,19,059,"Iowa","Dickinson County",4,12,213,124,89
050,19,059,"Iowa","Dickinson County",4,13,210,114,96
050,19,059,"Iowa","Dickinson County",4,14,209,108,101
050,19,059,"Iowa","Dickinson County",4,15,211,108,103
050,19,059,"Iowa","Dickinson County",4,16,210,116,94
050,19,059,"Iowa","Dickinson County",4,17,226,113,113
050,19,059,"Iowa","Dickinson County",4,18,173,98,75
050,19,059,"Iowa","Dickinson County",4,19,136,80,56
050,19,059,"Iowa","Dickinson County",4,20,144,83,61
050,19,059,"Iowa","Dickinson County",4,21,162,76,86
050,19,059,"Iowa","Dickinson County",4,22,180,82,98
050,19,059,"Iowa","Dickinson County",4,23,185,86,99
050,19,059,"Iowa","Dickinson County",4,24,185,84,101
050,19,059,"Iowa","Dickinson County",4,25,190,103,87
050,19,059,"Iowa","Dickinson County",4,26,185,96,89
050,19,059,"Iowa","Dickinson County",4,27,165,88,77
050,19,059,"Iowa","Dickinson County",4,28,164,96,68
050,19,059,"Iowa","Dickinson County",4,29,167,81,86
050,19,059,"Iowa","Dickinson County",4,30,191,95,96
050,19,059,"Iowa","Dickinson County",4,31,213,108,105
050,19,059,"Iowa","Dickinson County",4,32,195,104,91
050,19,059,"Iowa","Dickinson County",4,33,179,95,84
050,19,059,"Iowa","Dickinson County",4,34,168,83,85
050,19,059,"Iowa","Dickinson County",4,35,170,91,79
050,19,059,"Iowa","Dickinson County",4,36,196,104,92
050,19,059,"Iowa","Dickinson County",4,37,216,114,102
050,19,059,"Iowa","Dickinson County",4,38,202,112,90
050,19,059,"Iowa","Dickinson County",4,39,189,98,91
050,19,059,"Iowa","Dickinson County",4,40,191,101,90
050,19,059,"Iowa","Dickinson County",4,41,194,102,92
050,19,059,"Iowa","Dickinson County",4,42,192,97,95
050,19,059,"Iowa","Dickinson County",4,43,195,103,92
050,19,059,"Iowa","Dickinson County",4,44,207,110,97
050,19,059,"Iowa","Dickinson County",4,45,193,105,88
050,19,059,"Iowa","Dickinson County",4,46,165,88,77
050,19,059,"Iowa","Dickinson County",4,47,186,98,88
050,19,059,"Iowa","Dickinson County",4,48,172,94,78
050,19,059,"Iowa","Dickinson County",4,49,172,86,86
050,19,059,"Iowa","Dickinson County",4,50,198,105,93
050,19,059,"Iowa","Dickinson County",4,51,236,116,120
050,19,059,"Iowa","Dickinson County",4,52,242,118,124
050,19,059,"Iowa","Dickinson County",4,53,223,115,108
050,19,059,"Iowa","Dickinson County",4,54,205,111,94
050,19,059,"Iowa","Dickinson County",4,55,197,95,102
050,19,059,"Iowa","Dickinson County",4,56,213,108,105
050,19,059,"Iowa","Dickinson County",4,57,236,113,123
050,19,059,"Iowa","Dickinson County",4,58,229,101,128
050,19,059,"Iowa","Dickinson County",4,59,243,129,114
050,19,059,"Iowa","Dickinson County",4,60,288,146,142
050,19,059,"Iowa","Dickinson County",4,61,287,148,139
050,19,059,"Iowa","Dickinson County",4,62,296,142,154
050,19,059,"Iowa","Dickinson County",4,63,303,152,151
050,19,059,"Iowa","Dickinson County",4,64,284,141,143
050,19,059,"Iowa","Dickinson County",4,65,288,136,152
050,19,059,"Iowa","Dickinson County",4,66,297,144,153
050,19,059,"Iowa","Dickinson County",4,67,322,153,169
050,19,059,"Iowa","Dickinson County",4,68,311,153,158
050,19,059,"Iowa","Dickinson County",4,69,318,156,162
050,19,059,"Iowa","Dickinson County",4,70,304,140,164
050,19,059,"Iowa","Dickinson County",4,71,291,132,159
050,19,059,"Iowa","Dickinson County",4,72,267,136,131
050,19,059,"Iowa","Dickinson County",4,73,270,140,130
050,19,059,"Iowa","Dickinson County",4,74,255,128,127
050,19,059,"Iowa","Dickinson County",4,75,269,129,140
050,19,059,"Iowa","Dickinson County",4,76,166,77,89
050,19,059,"Iowa","Dickinson County",4,77,153,70,83
050,19,059,"Iowa","Dickinson County",4,78,164,77,87
050,19,059,"Iowa","Dickinson County",4,79,155,71,84
050,19,059,"Iowa","Dickinson County",4,80,134,57,77
050,19,059,"Iowa","Dickinson County",4,81,124,68,56
050,19,059,"Iowa","Dickinson County",4,82,111,54,57
050,19,059,"Iowa","Dickinson County",4,83,109,47,62
050,19,059,"Iowa","Dickinson County",4,84,88,39,49
050,19,059,"Iowa","Dickinson County",4,85,696,243,453
050,19,059,"Iowa","Dickinson County",5,0,154,80,74
050,19,059,"Iowa","Dickinson County",5,1,163,82,81
050,19,059,"Iowa","Dickinson County",5,2,161,68,93
050,19,059,"Iowa","Dickinson County",5,3,165,90,75
050,19,059,"Iowa","Dickinson County",5,4,177,88,89
050,19,059,"Iowa","Dickinson County",5,5,192,97,95
050,19,059,"Iowa","Dickinson County",5,6,177,86,91
050,19,059,"Iowa","Dickinson County",5,7,208,102,106
050,19,059,"Iowa","Dickinson County",5,8,196,101,95
050,19,059,"Iowa","Dickinson County",5,9,205,97,108
050,19,059,"Iowa","Dickinson County",5,10,188,91,97
050,19,059,"Iowa","Dickinson County",5,11,197,104,93
050,19,059,"Iowa","Dickinson County",5,12,179,105,74
050,19,059,"Iowa","Dickinson County",5,13,213,125,88
050,19,059,"Iowa","Dickinson County",5,14,220,119,101
050,19,059,"Iowa","Dickinson County",5,15,209,109,100
050,19,059,"Iowa","Dickinson County",5,16,217,110,107
050,19,059,"Iowa","Dickinson County",5,17,220,120,100
050,19,059,"Iowa","Dickinson County",5,18,188,95,93
050,19,059,"Iowa","Dickinson County",5,19,137,78,59
050,19,059,"Iowa","Dickinson County",5,20,147,84,63
050,19,059,"Iowa","Dickinson County",5,21,145,83,62
050,19,059,"Iowa","Dickinson County",5,22,154,72,82
050,19,059,"Iowa","Dickinson County",5,23,168,80,88
050,19,059,"Iowa","Dickinson County",5,24,182,84,98
050,19,059,"Iowa","Dickinson County",5,25,175,81,94
050,19,059,"Iowa","Dickinson County",5,26,167,91,76
050,19,059,"Iowa","Dickinson County",5,27,189,98,91
050,19,059,"Iowa","Dickinson County",5,28,178,98,80
050,19,059,"Iowa","Dickinson County",5,29,171,95,76
050,19,059,"Iowa","Dickinson County",5,30,161,77,84
050,19,059,"Iowa","Dickinson County",5,31,185,89,96
050,19,059,"Iowa","Dickinson County",5,32,190,92,98
050,19,059,"Iowa","Dickinson County",5,33,198,106,92
050,19,059,"Iowa","Dickinson County",5,34,171,93,78
050,19,059,"Iowa","Dickinson County",5,35,167,77,90
050,19,059,"Iowa","Dickinson County",5,36,176,90,86
050,19,059,"Iowa","Dickinson County",5,37,199,104,95
050,19,059,"Iowa","Dickinson County",5,38,233,120,113
050,19,059,"Iowa","Dickinson County",5,39,204,112,92
050,19,059,"Iowa","Dickinson County",5,40,189,96,93
050,19,059,"Iowa","Dickinson County",5,41,189,102,87
050,19,059,"Iowa","Dickinson County",5,42,197,100,97
050,19,059,"Iowa","Dickinson County",5,43,190,98,92
050,19,059,"Iowa","Dickinson County",5,44,199,100,99
050,19,059,"Iowa","Dickinson County",5,45,204,110,94
050,19,059,"Iowa","Dickinson County",5,46,196,105,91
050,19,059,"Iowa","Dickinson County",5,47,170,95,75
050,19,059,"Iowa","Dickinson County",5,48,189,102,87
050,19,059,"Iowa","Dickinson County",5,49,168,91,77
050,19,059,"Iowa","Dickinson County",5,50,174,84,90
050,19,059,"Iowa","Dickinson County",5,51,195,96,99
050,19,059,"Iowa","Dickinson County",5,52,234,115,119
050,19,059,"Iowa","Dickinson County",5,53,238,114,124
050,19,059,"Iowa","Dickinson County",5,54,222,113,109
050,19,059,"Iowa","Dickinson County",5,55,209,111,98
050,19,059,"Iowa","Dickinson County",5,56,199,98,101
050,19,059,"Iowa","Dickinson County",5,57,215,114,101
050,19,059,"Iowa","Dickinson County",5,58,242,113,129
050,19,059,"Iowa","Dickinson County",5,59,234,109,125
050,19,059,"Iowa","Dickinson County",5,60,256,140,116
050,19,059,"Iowa","Dickinson County",5,61,299,149,150
050,19,059,"Iowa","Dickinson County",5,62,299,152,147
050,19,059,"Iowa","Dickinson County",5,63,302,143,159
050,19,059,"Iowa","Dickinson County",5,64,305,154,151
050,19,059,"Iowa","Dickinson County",5,65,286,143,143
050,19,059,"Iowa","Dickinson County",5,66,283,132,151
050,19,059,"Iowa","Dickinson County",5,67,296,146,150
050,19,059,"Iowa","Dickinson County",5,68,316,152,164
050,19,059,"Iowa","Dickinson County",5,69,310,153,157
050,19,059,"Iowa","Dickinson County",5,70,314,160,154
050,19,059,"Iowa","Dickinson County",5,71,300,136,164
050,19,059,"Iowa","Dickinson County",5,72,272,124,148
050,19,059,"Iowa","Dickinson County",5,73,262,131,131
050,19,059,"Iowa","Dickinson County",5,74,263,137,126
050,19,059,"Iowa","Dickinson County",5,75,253,125,128
050,19,059,"Iowa","Dickinson County",5,76,260,125,135
050,19,059,"Iowa","Dickinson County",5,77,165,79,86
050,19,059,"Iowa","Dickinson County",5,78,152,71,81
050,19,059,"Iowa","Dickinson County",5,79,158,73,85
050,19,059,"Iowa","Dickinson County",5,80,144,63,81
050,19,059,"Iowa","Dickinson County",5,81,130,57,73
050,19,059,"Iowa","Dickinson County",5,82,114,61,53
050,19,059,"Iowa","Dickinson County",5,83,114,57,57
050,19,059,"Iowa","Dickinson County",5,84,104,47,57
050,19,059,"Iowa","Dickinson County",5,85,720,255,465
050,19,061,"Iowa","Dubuque County",1,0,1212,624,588
050,19,061,"Iowa","Dubuque County",1,1,1216,617,599
050,19,061,"Iowa","Dubuque County",1,2,1198,594,604
050,19,061,"Iowa","Dubuque County",1,3,1230,585,645
050,19,061,"Iowa","Dubuque County",1,4,1264,648,616
050,19,061,"Iowa","Dubuque County",1,5,1300,693,607
050,19,061,"Iowa","Dubuque County",1,6,1296,663,633
050,19,061,"Iowa","Dubuque County",1,7,1233,617,616
050,19,061,"Iowa","Dubuque County",1,8,1236,609,627
050,19,061,"Iowa","Dubuque County",1,9,1257,646,611
050,19,061,"Iowa","Dubuque County",1,10,1294,669,625
050,19,061,"Iowa","Dubuque County",1,11,1313,662,651
050,19,061,"Iowa","Dubuque County",1,12,1361,684,677
050,19,061,"Iowa","Dubuque County",1,13,1320,645,675
050,19,061,"Iowa","Dubuque County",1,14,1247,629,618
050,19,061,"Iowa","Dubuque County",1,15,1256,636,620
050,19,061,"Iowa","Dubuque County",1,16,1316,674,642
050,19,061,"Iowa","Dubuque County",1,17,1342,700,642
050,19,061,"Iowa","Dubuque County",1,18,1371,716,655
050,19,061,"Iowa","Dubuque County",1,19,1591,805,786
050,19,061,"Iowa","Dubuque County",1,20,1449,719,730
050,19,061,"Iowa","Dubuque County",1,21,1395,728,667
050,19,061,"Iowa","Dubuque County",1,22,1324,676,648
050,19,061,"Iowa","Dubuque County",1,23,1298,666,632
050,19,061,"Iowa","Dubuque County",1,24,1327,676,651
050,19,061,"Iowa","Dubuque County",1,25,1299,670,629
050,19,061,"Iowa","Dubuque County",1,26,1340,703,637
050,19,061,"Iowa","Dubuque County",1,27,1291,663,628
050,19,061,"Iowa","Dubuque County",1,28,1299,685,614
050,19,061,"Iowa","Dubuque County",1,29,1272,649,623
050,19,061,"Iowa","Dubuque County",1,30,1238,609,629
050,19,061,"Iowa","Dubuque County",1,31,1239,625,614
050,19,061,"Iowa","Dubuque County",1,32,1210,618,592
050,19,061,"Iowa","Dubuque County",1,33,1236,628,608
050,19,061,"Iowa","Dubuque County",1,34,1209,617,592
050,19,061,"Iowa","Dubuque County",1,35,1209,622,587
050,19,061,"Iowa","Dubuque County",1,36,1256,655,601
050,19,061,"Iowa","Dubuque County",1,37,1268,658,610
050,19,061,"Iowa","Dubuque County",1,38,1213,613,600
050,19,061,"Iowa","Dubuque County",1,39,1192,593,599
050,19,061,"Iowa","Dubuque County",1,40,1153,609,544
050,19,061,"Iowa","Dubuque County",1,41,1129,577,552
050,19,061,"Iowa","Dubuque County",1,42,1053,517,536
050,19,061,"Iowa","Dubuque County",1,43,980,480,500
050,19,061,"Iowa","Dubuque County",1,44,998,498,500
050,19,061,"Iowa","Dubuque County",1,45,1003,492,511
050,19,061,"Iowa","Dubuque County",1,46,987,516,471
050,19,061,"Iowa","Dubuque County",1,47,983,500,483
050,19,061,"Iowa","Dubuque County",1,48,1025,524,501
050,19,061,"Iowa","Dubuque County",1,49,1123,574,549
050,19,061,"Iowa","Dubuque County",1,50,1146,593,553
050,19,061,"Iowa","Dubuque County",1,51,1174,600,574
050,19,061,"Iowa","Dubuque County",1,52,1166,600,566
050,19,061,"Iowa","Dubuque County",1,53,1230,603,627
050,19,061,"Iowa","Dubuque County",1,54,1208,599,609
050,19,061,"Iowa","Dubuque County",1,55,1289,635,654
050,19,061,"Iowa","Dubuque County",1,56,1367,712,655
050,19,061,"Iowa","Dubuque County",1,57,1349,677,672
050,19,061,"Iowa","Dubuque County",1,58,1405,713,692
050,19,061,"Iowa","Dubuque County",1,59,1386,708,678
050,19,061,"Iowa","Dubuque County",1,60,1364,693,671
050,19,061,"Iowa","Dubuque County",1,61,1346,665,681
050,19,061,"Iowa","Dubuque County",1,62,1335,673,662
050,19,061,"Iowa","Dubuque County",1,63,1345,686,659
050,19,061,"Iowa","Dubuque County",1,64,1308,656,652
050,19,061,"Iowa","Dubuque County",1,65,1213,587,626
050,19,061,"Iowa","Dubuque County",1,66,1209,584,625
050,19,061,"Iowa","Dubuque County",1,67,1199,590,609
050,19,061,"Iowa","Dubuque County",1,68,1167,567,600
050,19,061,"Iowa","Dubuque County",1,69,1066,507,559
050,19,061,"Iowa","Dubuque County",1,70,1033,519,514
050,19,061,"Iowa","Dubuque County",1,71,972,477,495
050,19,061,"Iowa","Dubuque County",1,72,913,417,496
050,19,061,"Iowa","Dubuque County",1,73,878,411,467
050,19,061,"Iowa","Dubuque County",1,74,583,269,314
050,19,061,"Iowa","Dubuque County",1,75,616,297,319
050,19,061,"Iowa","Dubuque County",1,76,624,286,338
050,19,061,"Iowa","Dubuque County",1,77,653,284,369
050,19,061,"Iowa","Dubuque County",1,78,578,229,349
050,19,061,"Iowa","Dubuque County",1,79,557,229,328
050,19,061,"Iowa","Dubuque County",1,80,494,210,284
050,19,061,"Iowa","Dubuque County",1,81,494,208,286
050,19,061,"Iowa","Dubuque County",1,82,466,199,267
050,19,061,"Iowa","Dubuque County",1,83,432,186,246
050,19,061,"Iowa","Dubuque County",1,84,386,156,230
050,19,061,"Iowa","Dubuque County",1,85,2473,778,1695
050,19,061,"Iowa","Dubuque County",2,0,1188,609,579
050,19,061,"Iowa","Dubuque County",2,1,1211,617,594
050,19,061,"Iowa","Dubuque County",2,2,1203,598,605
050,19,061,"Iowa","Dubuque County",2,3,1216,587,629
050,19,061,"Iowa","Dubuque County",2,4,1264,637,627
050,19,061,"Iowa","Dubuque County",2,5,1295,682,613
050,19,061,"Iowa","Dubuque County",2,6,1301,674,627
050,19,061,"Iowa","Dubuque County",2,7,1250,631,619
050,19,061,"Iowa","Dubuque County",2,8,1236,610,626
050,19,061,"Iowa","Dubuque County",2,9,1255,638,617
050,19,061,"Iowa","Dubuque County",2,10,1285,663,622
050,19,061,"Iowa","Dubuque County",2,11,1305,661,644
050,19,061,"Iowa","Dubuque County",2,12,1356,680,676
050,19,061,"Iowa","Dubuque County",2,13,1326,654,672
050,19,061,"Iowa","Dubuque County",2,14,1264,631,633
050,19,061,"Iowa","Dubuque County",2,15,1257,635,622
050,19,061,"Iowa","Dubuque County",2,16,1306,668,638
050,19,061,"Iowa","Dubuque County",2,17,1337,695,642
050,19,061,"Iowa","Dubuque County",2,18,1375,720,655
050,19,061,"Iowa","Dubuque County",2,19,1593,808,785
050,19,061,"Iowa","Dubuque County",2,20,1462,727,735
050,19,061,"Iowa","Dubuque County",2,21,1395,723,672
050,19,061,"Iowa","Dubuque County",2,22,1326,677,649
050,19,061,"Iowa","Dubuque County",2,23,1294,667,627
050,19,061,"Iowa","Dubuque County",2,24,1318,677,641
050,19,061,"Iowa","Dubuque County",2,25,1314,678,636
050,19,061,"Iowa","Dubuque County",2,26,1327,696,631
050,19,061,"Iowa","Dubuque County",2,27,1300,670,630
050,19,061,"Iowa","Dubuque County",2,28,1293,679,614
050,19,061,"Iowa","Dubuque County",2,29,1275,657,618
050,19,061,"Iowa","Dubuque County",2,30,1250,620,630
050,19,061,"Iowa","Dubuque County",2,31,1237,622,615
050,19,061,"Iowa","Dubuque County",2,32,1216,618,598
050,19,061,"Iowa","Dubuque County",2,33,1229,626,603
050,19,061,"Iowa","Dubuque County",2,34,1211,618,593
050,19,061,"Iowa","Dubuque County",2,35,1214,620,594
050,19,061,"Iowa","Dubuque County",2,36,1237,642,595
050,19,061,"Iowa","Dubuque County",2,37,1266,661,605
050,19,061,"Iowa","Dubuque County",2,38,1228,625,603
050,19,061,"Iowa","Dubuque County",2,39,1195,596,599
050,19,061,"Iowa","Dubuque County",2,40,1169,607,562
050,19,061,"Iowa","Dubuque County",2,41,1138,586,552
050,19,061,"Iowa","Dubuque County",2,42,1066,528,538
050,19,061,"Iowa","Dubuque County",2,43,1004,492,512
050,19,061,"Iowa","Dubuque County",2,44,983,488,495
050,19,061,"Iowa","Dubuque County",2,45,1001,494,507
050,19,061,"Iowa","Dubuque County",2,46,985,506,479
050,19,061,"Iowa","Dubuque County",2,47,979,501,478
050,19,061,"Iowa","Dubuque County",2,48,1013,519,494
050,19,061,"Iowa","Dubuque County",2,49,1101,563,538
050,19,061,"Iowa","Dubuque County",2,50,1142,590,552
050,19,061,"Iowa","Dubuque County",2,51,1159,594,565
050,19,061,"Iowa","Dubuque County",2,52,1164,599,565
050,19,061,"Iowa","Dubuque County",2,53,1213,598,615
050,19,061,"Iowa","Dubuque County",2,54,1209,598,611
050,19,061,"Iowa","Dubuque County",2,55,1266,624,642
050,19,061,"Iowa","Dubuque County",2,56,1352,695,657
050,19,061,"Iowa","Dubuque County",2,57,1348,683,665
050,19,061,"Iowa","Dubuque County",2,58,1394,706,688
050,19,061,"Iowa","Dubuque County",2,59,1399,716,683
050,19,061,"Iowa","Dubuque County",2,60,1363,694,669
050,19,061,"Iowa","Dubuque County",2,61,1343,665,678
050,19,061,"Iowa","Dubuque County",2,62,1334,670,664
050,19,061,"Iowa","Dubuque County",2,63,1349,683,666
050,19,061,"Iowa","Dubuque County",2,64,1301,656,645
050,19,061,"Iowa","Dubuque County",2,65,1234,603,631
050,19,061,"Iowa","Dubuque County",2,66,1206,580,626
050,19,061,"Iowa","Dubuque County",2,67,1194,586,608
050,19,061,"Iowa","Dubuque County",2,68,1167,569,598
050,19,061,"Iowa","Dubuque County",2,69,1088,521,567
050,19,061,"Iowa","Dubuque County",2,70,1034,512,522
050,19,061,"Iowa","Dubuque County",2,71,984,482,502
050,19,061,"Iowa","Dubuque County",2,72,909,425,484
050,19,061,"Iowa","Dubuque County",2,73,922,428,494
050,19,061,"Iowa","Dubuque County",2,74,612,285,327
050,19,061,"Iowa","Dubuque County",2,75,609,287,322
050,19,061,"Iowa","Dubuque County",2,76,613,286,327
050,19,061,"Iowa","Dubuque County",2,77,658,291,367
050,19,061,"Iowa","Dubuque County",2,78,578,235,343
050,19,061,"Iowa","Dubuque County",2,79,552,226,326
050,19,061,"Iowa","Dubuque County",2,80,501,212,289
050,19,061,"Iowa","Dubuque County",2,81,479,198,281
050,19,061,"Iowa","Dubuque County",2,82,467,196,271
050,19,061,"Iowa","Dubuque County",2,83,436,187,249
050,19,061,"Iowa","Dubuque County",2,84,393,160,233
050,19,061,"Iowa","Dubuque County",2,85,2487,783,1704
050,19,061,"Iowa","Dubuque County",3,0,1081,537,544
050,19,061,"Iowa","Dubuque County",3,1,1208,618,590
050,19,061,"Iowa","Dubuque County",3,2,1222,618,604
050,19,061,"Iowa","Dubuque County",3,3,1178,587,591
050,19,061,"Iowa","Dubuque County",3,4,1203,572,631
050,19,061,"Iowa","Dubuque County",3,5,1239,626,613
050,19,061,"Iowa","Dubuque County",3,6,1259,652,607
050,19,061,"Iowa","Dubuque County",3,7,1286,670,616
050,19,061,"Iowa","Dubuque County",3,8,1229,626,603
050,19,061,"Iowa","Dubuque County",3,9,1212,598,614
050,19,061,"Iowa","Dubuque County",3,10,1240,637,603
050,19,061,"Iowa","Dubuque County",3,11,1282,665,617
050,19,061,"Iowa","Dubuque County",3,12,1293,649,644
050,19,061,"Iowa","Dubuque County",3,13,1333,675,658
050,19,061,"Iowa","Dubuque County",3,14,1328,662,666
050,19,061,"Iowa","Dubuque County",3,15,1235,619,616
050,19,061,"Iowa","Dubuque County",3,16,1242,625,617
050,19,061,"Iowa","Dubuque County",3,17,1313,667,646
050,19,061,"Iowa","Dubuque County",3,18,1402,734,668
050,19,061,"Iowa","Dubuque County",3,19,1605,817,788
050,19,061,"Iowa","Dubuque County",3,20,1462,722,740
050,19,061,"Iowa","Dubuque County",3,21,1409,728,681
050,19,061,"Iowa","Dubuque County",3,22,1311,648,663
050,19,061,"Iowa","Dubuque County",3,23,1299,693,606
050,19,061,"Iowa","Dubuque County",3,24,1295,691,604
050,19,061,"Iowa","Dubuque County",3,25,1292,662,630
050,19,061,"Iowa","Dubuque County",3,26,1296,677,619
050,19,061,"Iowa","Dubuque County",3,27,1305,669,636
050,19,061,"Iowa","Dubuque County",3,28,1298,662,636
050,19,061,"Iowa","Dubuque County",3,29,1282,677,605
050,19,061,"Iowa","Dubuque County",3,30,1264,657,607
050,19,061,"Iowa","Dubuque County",3,31,1217,602,615
050,19,061,"Iowa","Dubuque County",3,32,1209,618,591
050,19,061,"Iowa","Dubuque County",3,33,1222,618,604
050,19,061,"Iowa","Dubuque County",3,34,1189,611,578
050,19,061,"Iowa","Dubuque County",3,35,1196,605,591
050,19,061,"Iowa","Dubuque County",3,36,1221,620,601
050,19,061,"Iowa","Dubuque County",3,37,1242,651,591
050,19,061,"Iowa","Dubuque County",3,38,1258,655,603
050,19,061,"Iowa","Dubuque County",3,39,1227,612,615
050,19,061,"Iowa","Dubuque County",3,40,1176,584,592
050,19,061,"Iowa","Dubuque County",3,41,1169,605,564
050,19,061,"Iowa","Dubuque County",3,42,1115,576,539
050,19,061,"Iowa","Dubuque County",3,43,1066,535,531
050,19,061,"Iowa","Dubuque County",3,44,997,483,514
050,19,061,"Iowa","Dubuque County",3,45,958,477,481
050,19,061,"Iowa","Dubuque County",3,46,1005,491,514
050,19,061,"Iowa","Dubuque County",3,47,964,497,467
050,19,061,"Iowa","Dubuque County",3,48,975,502,473
050,19,061,"Iowa","Dubuque County",3,49,1011,515,496
050,19,061,"Iowa","Dubuque County",3,50,1104,568,536
050,19,061,"Iowa","Dubuque County",3,51,1135,583,552
050,19,061,"Iowa","Dubuque County",3,52,1151,597,554
050,19,061,"Iowa","Dubuque County",3,53,1146,588,558
050,19,061,"Iowa","Dubuque County",3,54,1220,604,616
050,19,061,"Iowa","Dubuque County",3,55,1199,589,610
050,19,061,"Iowa","Dubuque County",3,56,1267,619,648
050,19,061,"Iowa","Dubuque County",3,57,1308,667,641
050,19,061,"Iowa","Dubuque County",3,58,1343,681,662
050,19,061,"Iowa","Dubuque County",3,59,1380,702,678
050,19,061,"Iowa","Dubuque County",3,60,1382,701,681
050,19,061,"Iowa","Dubuque County",3,61,1366,684,682
050,19,061,"Iowa","Dubuque County",3,62,1318,652,666
050,19,061,"Iowa","Dubuque County",3,63,1329,658,671
050,19,061,"Iowa","Dubuque County",3,64,1310,667,643
050,19,061,"Iowa","Dubuque County",3,65,1307,652,655
050,19,061,"Iowa","Dubuque County",3,66,1219,589,630
050,19,061,"Iowa","Dubuque County",3,67,1174,571,603
050,19,061,"Iowa","Dubuque County",3,68,1193,581,612
050,19,061,"Iowa","Dubuque County",3,69,1135,549,586
050,19,061,"Iowa","Dubuque County",3,70,1077,510,567
050,19,061,"Iowa","Dubuque County",3,71,1008,485,523
050,19,061,"Iowa","Dubuque County",3,72,956,471,485
050,19,061,"Iowa","Dubuque County",3,73,881,410,471
050,19,061,"Iowa","Dubuque County",3,74,896,410,486
050,19,061,"Iowa","Dubuque County",3,75,603,279,324
050,19,061,"Iowa","Dubuque County",3,76,587,269,318
050,19,061,"Iowa","Dubuque County",3,77,597,277,320
050,19,061,"Iowa","Dubuque County",3,78,623,262,361
050,19,061,"Iowa","Dubuque County",3,79,554,231,323
050,19,061,"Iowa","Dubuque County",3,80,522,203,319
050,19,061,"Iowa","Dubuque County",3,81,475,196,279
050,19,061,"Iowa","Dubuque County",3,82,446,178,268
050,19,061,"Iowa","Dubuque County",3,83,438,184,254
050,19,061,"Iowa","Dubuque County",3,84,407,165,242
050,19,061,"Iowa","Dubuque County",3,85,2478,787,1691
050,19,061,"Iowa","Dubuque County",4,0,1112,587,525
050,19,061,"Iowa","Dubuque County",4,1,1085,535,550
050,19,061,"Iowa","Dubuque County",4,2,1210,612,598
050,19,061,"Iowa","Dubuque County",4,3,1220,623,597
050,19,061,"Iowa","Dubuque County",4,4,1213,602,611
050,19,061,"Iowa","Dubuque County",4,5,1204,576,628
050,19,061,"Iowa","Dubuque County",4,6,1227,619,608
050,19,061,"Iowa","Dubuque County",4,7,1238,636,602
050,19,061,"Iowa","Dubuque County",4,8,1286,682,604
050,19,061,"Iowa","Dubuque County",4,9,1224,633,591
050,19,061,"Iowa","Dubuque County",4,10,1245,602,643
050,19,061,"Iowa","Dubuque County",4,11,1218,632,586
050,19,061,"Iowa","Dubuque County",4,12,1270,661,609
050,19,061,"Iowa","Dubuque County",4,13,1291,645,646
050,19,061,"Iowa","Dubuque County",4,14,1315,665,650
050,19,061,"Iowa","Dubuque County",4,15,1322,665,657
050,19,061,"Iowa","Dubuque County",4,16,1225,606,619
050,19,061,"Iowa","Dubuque County",4,17,1230,625,605
050,19,061,"Iowa","Dubuque County",4,18,1377,713,664
050,19,061,"Iowa","Dubuque County",4,19,1636,840,796
050,19,061,"Iowa","Dubuque County",4,20,1454,733,721
050,19,061,"Iowa","Dubuque County",4,21,1405,708,697
050,19,061,"Iowa","Dubuque County",4,22,1315,655,660
050,19,061,"Iowa","Dubuque County",4,23,1226,621,605
050,19,061,"Iowa","Dubuque County",4,24,1299,700,599
050,19,061,"Iowa","Dubuque County",4,25,1260,674,586
050,19,061,"Iowa","Dubuque County",4,26,1279,656,623
050,19,061,"Iowa","Dubuque County",4,27,1265,637,628
050,19,061,"Iowa","Dubuque County",4,28,1285,665,620
050,19,061,"Iowa","Dubuque County",4,29,1289,678,611
050,19,061,"Iowa","Dubuque County",4,30,1261,653,608
050,19,061,"Iowa","Dubuque County",4,31,1275,663,612
050,19,061,"Iowa","Dubuque County",4,32,1194,600,594
050,19,061,"Iowa","Dubuque County",4,33,1231,634,597
050,19,061,"Iowa","Dubuque County",4,34,1195,617,578
050,19,061,"Iowa","Dubuque County",4,35,1203,600,603
050,19,061,"Iowa","Dubuque County",4,36,1201,614,587
050,19,061,"Iowa","Dubuque County",4,37,1229,623,606
050,19,061,"Iowa","Dubuque County",4,38,1228,647,581
050,19,061,"Iowa","Dubuque County",4,39,1240,629,611
050,19,061,"Iowa","Dubuque County",4,40,1238,622,616
050,19,061,"Iowa","Dubuque County",4,41,1198,593,605
050,19,061,"Iowa","Dubuque County",4,42,1169,603,566
050,19,061,"Iowa","Dubuque County",4,43,1114,581,533
050,19,061,"Iowa","Dubuque County",4,44,1055,534,521
050,19,061,"Iowa","Dubuque County",4,45,975,475,500
050,19,061,"Iowa","Dubuque County",4,46,958,478,480
050,19,061,"Iowa","Dubuque County",4,47,994,487,507
050,19,061,"Iowa","Dubuque County",4,48,964,497,467
050,19,061,"Iowa","Dubuque County",4,49,961,481,480
050,19,061,"Iowa","Dubuque County",4,50,1013,521,492
050,19,061,"Iowa","Dubuque County",4,51,1097,559,538
050,19,061,"Iowa","Dubuque County",4,52,1124,587,537
050,19,061,"Iowa","Dubuque County",4,53,1141,592,549
050,19,061,"Iowa","Dubuque County",4,54,1148,589,559
050,19,061,"Iowa","Dubuque County",4,55,1205,592,613
050,19,061,"Iowa","Dubuque County",4,56,1202,590,612
050,19,061,"Iowa","Dubuque County",4,57,1232,599,633
050,19,061,"Iowa","Dubuque County",4,58,1315,667,648
050,19,061,"Iowa","Dubuque County",4,59,1355,691,664
050,19,061,"Iowa","Dubuque County",4,60,1368,686,682
050,19,061,"Iowa","Dubuque County",4,61,1377,691,686
050,19,061,"Iowa","Dubuque County",4,62,1338,672,666
050,19,061,"Iowa","Dubuque County",4,63,1326,640,686
050,19,061,"Iowa","Dubuque County",4,64,1316,658,658
050,19,061,"Iowa","Dubuque County",4,65,1318,675,643
050,19,061,"Iowa","Dubuque County",4,66,1267,620,647
050,19,061,"Iowa","Dubuque County",4,67,1204,588,616
050,19,061,"Iowa","Dubuque County",4,68,1157,559,598
050,19,061,"Iowa","Dubuque County",4,69,1171,567,604
050,19,061,"Iowa","Dubuque County",4,70,1111,540,571
050,19,061,"Iowa","Dubuque County",4,71,1054,491,563
050,19,061,"Iowa","Dubuque County",4,72,987,478,509
050,19,061,"Iowa","Dubuque County",4,73,929,457,472
050,19,061,"Iowa","Dubuque County",4,74,866,408,458
050,19,061,"Iowa","Dubuque County",4,75,886,397,489
050,19,061,"Iowa","Dubuque County",4,76,575,260,315
050,19,061,"Iowa","Dubuque County",4,77,578,266,312
050,19,061,"Iowa","Dubuque County",4,78,571,253,318
050,19,061,"Iowa","Dubuque County",4,79,601,256,345
050,19,061,"Iowa","Dubuque County",4,80,509,204,305
050,19,061,"Iowa","Dubuque County",4,81,491,187,304
050,19,061,"Iowa","Dubuque County",4,82,444,179,265
050,19,061,"Iowa","Dubuque County",4,83,428,167,261
050,19,061,"Iowa","Dubuque County",4,84,411,163,248
050,19,061,"Iowa","Dubuque County",4,85,2492,803,1689
050,19,061,"Iowa","Dubuque County",5,0,1117,597,520
050,19,061,"Iowa","Dubuque County",5,1,1109,594,515
050,19,061,"Iowa","Dubuque County",5,2,1088,540,548
050,19,061,"Iowa","Dubuque County",5,3,1218,618,600
050,19,061,"Iowa","Dubuque County",5,4,1236,623,613
050,19,061,"Iowa","Dubuque County",5,5,1190,598,592
050,19,061,"Iowa","Dubuque County",5,6,1197,574,623
050,19,061,"Iowa","Dubuque County",5,7,1225,624,601
050,19,061,"Iowa","Dubuque County",5,8,1249,640,609
050,19,061,"Iowa","Dubuque County",5,9,1290,681,609
050,19,061,"Iowa","Dubuque County",5,10,1222,613,609
050,19,061,"Iowa","Dubuque County",5,11,1262,613,649
050,19,061,"Iowa","Dubuque County",5,12,1221,634,587
050,19,061,"Iowa","Dubuque County",5,13,1256,650,606
050,19,061,"Iowa","Dubuque County",5,14,1301,646,655
050,19,061,"Iowa","Dubuque County",5,15,1332,678,654
050,19,061,"Iowa","Dubuque County",5,16,1348,675,673
050,19,061,"Iowa","Dubuque County",5,17,1237,624,613
050,19,061,"Iowa","Dubuque County",5,18,1309,689,620
050,19,061,"Iowa","Dubuque County",5,19,1590,814,776
050,19,061,"Iowa","Dubuque County",5,20,1481,751,730
050,19,061,"Iowa","Dubuque County",5,21,1404,725,679
050,19,061,"Iowa","Dubuque County",5,22,1302,636,666
050,19,061,"Iowa","Dubuque County",5,23,1267,658,609
050,19,061,"Iowa","Dubuque County",5,24,1247,633,614
050,19,061,"Iowa","Dubuque County",5,25,1288,715,573
050,19,061,"Iowa","Dubuque County",5,26,1234,662,572
050,19,061,"Iowa","Dubuque County",5,27,1246,636,610
050,19,061,"Iowa","Dubuque County",5,28,1255,652,603
050,19,061,"Iowa","Dubuque County",5,29,1260,645,615
050,19,061,"Iowa","Dubuque County",5,30,1231,644,587
050,19,061,"Iowa","Dubuque County",5,31,1280,673,607
050,19,061,"Iowa","Dubuque County",5,32,1267,668,599
050,19,061,"Iowa","Dubuque County",5,33,1181,595,586
050,19,061,"Iowa","Dubuque County",5,34,1207,621,586
050,19,061,"Iowa","Dubuque County",5,35,1194,601,593
050,19,061,"Iowa","Dubuque County",5,36,1217,608,609
050,19,061,"Iowa","Dubuque County",5,37,1200,616,584
050,19,061,"Iowa","Dubuque County",5,38,1228,625,603
050,19,061,"Iowa","Dubuque County",5,39,1222,637,585
050,19,061,"Iowa","Dubuque County",5,40,1251,635,616
050,19,061,"Iowa","Dubuque County",5,41,1257,626,631
050,19,061,"Iowa","Dubuque County",5,42,1217,603,614
050,19,061,"Iowa","Dubuque County",5,43,1177,605,572
050,19,061,"Iowa","Dubuque County",5,44,1125,594,531
050,19,061,"Iowa","Dubuque County",5,45,1042,528,514
050,19,061,"Iowa","Dubuque County",5,46,977,474,503
050,19,061,"Iowa","Dubuque County",5,47,945,476,469
050,19,061,"Iowa","Dubuque County",5,48,985,488,497
050,19,061,"Iowa","Dubuque County",5,49,952,489,463
050,19,061,"Iowa","Dubuque County",5,50,978,489,489
050,19,061,"Iowa","Dubuque County",5,51,1010,509,501
050,19,061,"Iowa","Dubuque County",5,52,1094,570,524
050,19,061,"Iowa","Dubuque County",5,53,1113,574,539
050,19,061,"Iowa","Dubuque County",5,54,1140,597,543
050,19,061,"Iowa","Dubuque County",5,55,1150,578,572
050,19,061,"Iowa","Dubuque County",5,56,1219,602,617
050,19,061,"Iowa","Dubuque County",5,57,1173,574,599
050,19,061,"Iowa","Dubuque County",5,58,1222,589,633
050,19,061,"Iowa","Dubuque County",5,59,1309,662,647
050,19,061,"Iowa","Dubuque County",5,60,1344,681,663
050,19,061,"Iowa","Dubuque County",5,61,1369,677,692
050,19,061,"Iowa","Dubuque County",5,62,1353,680,673
050,19,061,"Iowa","Dubuque County",5,63,1321,659,662
050,19,061,"Iowa","Dubuque County",5,64,1307,638,669
050,19,061,"Iowa","Dubuque County",5,65,1304,648,656
050,19,061,"Iowa","Dubuque County",5,66,1274,637,637
050,19,061,"Iowa","Dubuque County",5,67,1245,613,632
050,19,061,"Iowa","Dubuque County",5,68,1200,580,620
050,19,061,"Iowa","Dubuque County",5,69,1138,546,592
050,19,061,"Iowa","Dubuque County",5,70,1161,559,602
050,19,061,"Iowa","Dubuque County",5,71,1094,527,567
050,19,061,"Iowa","Dubuque County",5,72,1037,484,553
050,19,061,"Iowa","Dubuque County",5,73,966,468,498
050,19,061,"Iowa","Dubuque County",5,74,919,450,469
050,19,061,"Iowa","Dubuque County",5,75,859,397,462
050,19,061,"Iowa","Dubuque County",5,76,856,369,487
050,19,061,"Iowa","Dubuque County",5,77,564,256,308
050,19,061,"Iowa","Dubuque County",5,78,555,245,310
050,19,061,"Iowa","Dubuque County",5,79,562,257,305
050,19,061,"Iowa","Dubuque County",5,80,566,231,335
050,19,061,"Iowa","Dubuque County",5,81,485,189,296
050,19,061,"Iowa","Dubuque County",5,82,465,174,291
050,19,061,"Iowa","Dubuque County",5,83,429,171,258
050,19,061,"Iowa","Dubuque County",5,84,402,147,255
050,19,061,"Iowa","Dubuque County",5,85,2568,842,1726
050,19,063,"Iowa","Emmet County",1,0,102,52,50
050,19,063,"Iowa","Emmet County",1,1,96,48,48
050,19,063,"Iowa","Emmet County",1,2,96,38,58
050,19,063,"Iowa","Emmet County",1,3,87,42,45
050,19,063,"Iowa","Emmet County",1,4,102,53,49
050,19,063,"Iowa","Emmet County",1,5,97,45,52
050,19,063,"Iowa","Emmet County",1,6,93,46,47
050,19,063,"Iowa","Emmet County",1,7,92,55,37
050,19,063,"Iowa","Emmet County",1,8,91,49,42
050,19,063,"Iowa","Emmet County",1,9,91,53,38
050,19,063,"Iowa","Emmet County",1,10,97,58,39
050,19,063,"Iowa","Emmet County",1,11,94,46,48
050,19,063,"Iowa","Emmet County",1,12,96,50,46
050,19,063,"Iowa","Emmet County",1,13,112,55,57
050,19,063,"Iowa","Emmet County",1,14,114,61,53
050,19,063,"Iowa","Emmet County",1,15,114,62,52
050,19,063,"Iowa","Emmet County",1,16,117,61,56
050,19,063,"Iowa","Emmet County",1,17,115,64,51
050,19,063,"Iowa","Emmet County",1,18,128,75,53
050,19,063,"Iowa","Emmet County",1,19,181,107,74
050,19,063,"Iowa","Emmet County",1,20,145,95,50
050,19,063,"Iowa","Emmet County",1,21,111,65,46
050,19,063,"Iowa","Emmet County",1,22,102,50,52
050,19,063,"Iowa","Emmet County",1,23,97,50,47
050,19,063,"Iowa","Emmet County",1,24,105,49,56
050,19,063,"Iowa","Emmet County",1,25,102,52,50
050,19,063,"Iowa","Emmet County",1,26,98,51,47
050,19,063,"Iowa","Emmet County",1,27,98,51,47
050,19,063,"Iowa","Emmet County",1,28,111,61,50
050,19,063,"Iowa","Emmet County",1,29,111,60,51
050,19,063,"Iowa","Emmet County",1,30,108,62,46
050,19,063,"Iowa","Emmet County",1,31,105,60,45
050,19,063,"Iowa","Emmet County",1,32,73,35,38
050,19,063,"Iowa","Emmet County",1,33,92,48,44
050,19,063,"Iowa","Emmet County",1,34,123,66,57
050,19,063,"Iowa","Emmet County",1,35,110,57,53
050,19,063,"Iowa","Emmet County",1,36,102,47,55
050,19,063,"Iowa","Emmet County",1,37,107,59,48
050,19,063,"Iowa","Emmet County",1,38,107,61,46
050,19,063,"Iowa","Emmet County",1,39,130,71,59
050,19,063,"Iowa","Emmet County",1,40,122,66,56
050,19,063,"Iowa","Emmet County",1,41,128,69,59
050,19,063,"Iowa","Emmet County",1,42,109,60,49
050,19,063,"Iowa","Emmet County",1,43,102,55,47
050,19,063,"Iowa","Emmet County",1,44,116,58,58
050,19,063,"Iowa","Emmet County",1,45,97,43,54
050,19,063,"Iowa","Emmet County",1,46,102,48,54
050,19,063,"Iowa","Emmet County",1,47,92,51,41
050,19,063,"Iowa","Emmet County",1,48,96,47,49
050,19,063,"Iowa","Emmet County",1,49,114,59,55
050,19,063,"Iowa","Emmet County",1,50,116,59,57
050,19,063,"Iowa","Emmet County",1,51,102,54,48
050,19,063,"Iowa","Emmet County",1,52,94,46,48
050,19,063,"Iowa","Emmet County",1,53,109,56,53
050,19,063,"Iowa","Emmet County",1,54,107,62,45
050,19,063,"Iowa","Emmet County",1,55,123,65,58
050,19,063,"Iowa","Emmet County",1,56,123,58,65
050,19,063,"Iowa","Emmet County",1,57,137,69,68
050,19,063,"Iowa","Emmet County",1,58,145,71,74
050,19,063,"Iowa","Emmet County",1,59,150,78,72
050,19,063,"Iowa","Emmet County",1,60,142,76,66
050,19,063,"Iowa","Emmet County",1,61,160,79,81
050,19,063,"Iowa","Emmet County",1,62,169,92,77
050,19,063,"Iowa","Emmet County",1,63,151,80,71
050,19,063,"Iowa","Emmet County",1,64,148,73,75
050,19,063,"Iowa","Emmet County",1,65,157,87,70
050,19,063,"Iowa","Emmet County",1,66,145,78,67
050,19,063,"Iowa","Emmet County",1,67,131,67,64
050,19,063,"Iowa","Emmet County",1,68,133,68,65
050,19,063,"Iowa","Emmet County",1,69,130,63,67
050,19,063,"Iowa","Emmet County",1,70,112,55,57
050,19,063,"Iowa","Emmet County",1,71,103,51,52
050,19,063,"Iowa","Emmet County",1,72,97,45,52
050,19,063,"Iowa","Emmet County",1,73,102,49,53
050,19,063,"Iowa","Emmet County",1,74,65,31,34
050,19,063,"Iowa","Emmet County",1,75,68,29,39
050,19,063,"Iowa","Emmet County",1,76,77,38,39
050,19,063,"Iowa","Emmet County",1,77,75,37,38
050,19,063,"Iowa","Emmet County",1,78,65,35,30
050,19,063,"Iowa","Emmet County",1,79,60,27,33
050,19,063,"Iowa","Emmet County",1,80,61,26,35
050,19,063,"Iowa","Emmet County",1,81,57,19,38
050,19,063,"Iowa","Emmet County",1,82,51,23,28
050,19,063,"Iowa","Emmet County",1,83,43,20,23
050,19,063,"Iowa","Emmet County",1,84,43,21,22
050,19,063,"Iowa","Emmet County",1,85,312,95,217
050,19,063,"Iowa","Emmet County",2,0,99,50,49
050,19,063,"Iowa","Emmet County",2,1,94,46,48
050,19,063,"Iowa","Emmet County",2,2,96,40,56
050,19,063,"Iowa","Emmet County",2,3,89,41,48
050,19,063,"Iowa","Emmet County",2,4,97,49,48
050,19,063,"Iowa","Emmet County",2,5,96,46,50
050,19,063,"Iowa","Emmet County",2,6,94,47,47
050,19,063,"Iowa","Emmet County",2,7,92,52,40
050,19,063,"Iowa","Emmet County",2,8,90,48,42
050,19,063,"Iowa","Emmet County",2,9,90,52,38
050,19,063,"Iowa","Emmet County",2,10,94,56,38
050,19,063,"Iowa","Emmet County",2,11,94,50,44
050,19,063,"Iowa","Emmet County",2,12,96,49,47
050,19,063,"Iowa","Emmet County",2,13,107,53,54
050,19,063,"Iowa","Emmet County",2,14,115,60,55
050,19,063,"Iowa","Emmet County",2,15,114,61,53
050,19,063,"Iowa","Emmet County",2,16,117,63,54
050,19,063,"Iowa","Emmet County",2,17,116,63,53
050,19,063,"Iowa","Emmet County",2,18,127,74,53
050,19,063,"Iowa","Emmet County",2,19,178,105,73
050,19,063,"Iowa","Emmet County",2,20,147,97,50
050,19,063,"Iowa","Emmet County",2,21,114,67,47
050,19,063,"Iowa","Emmet County",2,22,105,54,51
050,19,063,"Iowa","Emmet County",2,23,99,50,49
050,19,063,"Iowa","Emmet County",2,24,103,50,53
050,19,063,"Iowa","Emmet County",2,25,101,51,50
050,19,063,"Iowa","Emmet County",2,26,98,50,48
050,19,063,"Iowa","Emmet County",2,27,96,50,46
050,19,063,"Iowa","Emmet County",2,28,107,57,50
050,19,063,"Iowa","Emmet County",2,29,109,59,50
050,19,063,"Iowa","Emmet County",2,30,109,62,47
050,19,063,"Iowa","Emmet County",2,31,102,57,45
050,19,063,"Iowa","Emmet County",2,32,78,39,39
050,19,063,"Iowa","Emmet County",2,33,87,44,43
050,19,063,"Iowa","Emmet County",2,34,115,61,54
050,19,063,"Iowa","Emmet County",2,35,112,58,54
050,19,063,"Iowa","Emmet County",2,36,101,49,52
050,19,063,"Iowa","Emmet County",2,37,106,57,49
050,19,063,"Iowa","Emmet County",2,38,105,59,46
050,19,063,"Iowa","Emmet County",2,39,125,69,56
050,19,063,"Iowa","Emmet County",2,40,122,66,56
050,19,063,"Iowa","Emmet County",2,41,126,67,59
050,19,063,"Iowa","Emmet County",2,42,112,62,50
050,19,063,"Iowa","Emmet County",2,43,103,55,48
050,19,063,"Iowa","Emmet County",2,44,114,58,56
050,19,063,"Iowa","Emmet County",2,45,103,47,56
050,19,063,"Iowa","Emmet County",2,46,100,45,55
050,19,063,"Iowa","Emmet County",2,47,94,49,45
050,19,063,"Iowa","Emmet County",2,48,97,49,48
050,19,063,"Iowa","Emmet County",2,49,110,55,55
050,19,063,"Iowa","Emmet County",2,50,115,59,56
050,19,063,"Iowa","Emmet County",2,51,104,55,49
050,19,063,"Iowa","Emmet County",2,52,95,48,47
050,19,063,"Iowa","Emmet County",2,53,105,53,52
050,19,063,"Iowa","Emmet County",2,54,106,60,46
050,19,063,"Iowa","Emmet County",2,55,118,64,54
050,19,063,"Iowa","Emmet County",2,56,122,59,63
050,19,063,"Iowa","Emmet County",2,57,133,67,66
050,19,063,"Iowa","Emmet County",2,58,142,69,73
050,19,063,"Iowa","Emmet County",2,59,150,76,74
050,19,063,"Iowa","Emmet County",2,60,144,76,68
050,19,063,"Iowa","Emmet County",2,61,154,78,76
050,19,063,"Iowa","Emmet County",2,62,165,88,77
050,19,063,"Iowa","Emmet County",2,63,156,83,73
050,19,063,"Iowa","Emmet County",2,64,148,74,74
050,19,063,"Iowa","Emmet County",2,65,152,81,71
050,19,063,"Iowa","Emmet County",2,66,149,81,68
050,19,063,"Iowa","Emmet County",2,67,135,69,66
050,19,063,"Iowa","Emmet County",2,68,130,67,63
050,19,063,"Iowa","Emmet County",2,69,131,64,67
050,19,063,"Iowa","Emmet County",2,70,116,57,59
050,19,063,"Iowa","Emmet County",2,71,104,51,53
050,19,063,"Iowa","Emmet County",2,72,97,46,51
050,19,063,"Iowa","Emmet County",2,73,106,50,56
050,19,063,"Iowa","Emmet County",2,74,68,32,36
050,19,063,"Iowa","Emmet County",2,75,67,30,37
050,19,063,"Iowa","Emmet County",2,76,73,34,39
050,19,063,"Iowa","Emmet County",2,77,77,38,39
050,19,063,"Iowa","Emmet County",2,78,65,34,31
050,19,063,"Iowa","Emmet County",2,79,61,29,32
050,19,063,"Iowa","Emmet County",2,80,59,25,34
050,19,063,"Iowa","Emmet County",2,81,57,20,37
050,19,063,"Iowa","Emmet County",2,82,52,23,29
050,19,063,"Iowa","Emmet County",2,83,43,20,23
050,19,063,"Iowa","Emmet County",2,84,41,19,22
050,19,063,"Iowa","Emmet County",2,85,312,97,215
050,19,063,"Iowa","Emmet County",3,0,90,38,52
050,19,063,"Iowa","Emmet County",3,1,101,49,52
050,19,063,"Iowa","Emmet County",3,2,94,47,47
050,19,063,"Iowa","Emmet County",3,3,100,45,55
050,19,063,"Iowa","Emmet County",3,4,88,41,47
050,19,063,"Iowa","Emmet County",3,5,94,50,44
050,19,063,"Iowa","Emmet County",3,6,101,49,52
050,19,063,"Iowa","Emmet County",3,7,101,48,53
050,19,063,"Iowa","Emmet County",3,8,98,50,48
050,19,063,"Iowa","Emmet County",3,9,91,51,40
050,19,063,"Iowa","Emmet County",3,10,92,55,37
050,19,063,"Iowa","Emmet County",3,11,93,52,41
050,19,063,"Iowa","Emmet County",3,12,100,53,47
050,19,063,"Iowa","Emmet County",3,13,103,46,57
050,19,063,"Iowa","Emmet County",3,14,99,49,50
050,19,063,"Iowa","Emmet County",3,15,115,60,55
050,19,063,"Iowa","Emmet County",3,16,107,53,54
050,19,063,"Iowa","Emmet County",3,17,114,61,53
050,19,063,"Iowa","Emmet County",3,18,131,78,53
050,19,063,"Iowa","Emmet County",3,19,172,99,73
050,19,063,"Iowa","Emmet County",3,20,141,96,45
050,19,063,"Iowa","Emmet County",3,21,115,66,49
050,19,063,"Iowa","Emmet County",3,22,94,54,40
050,19,063,"Iowa","Emmet County",3,23,108,58,50
050,19,063,"Iowa","Emmet County",3,24,96,47,49
050,19,063,"Iowa","Emmet County",3,25,108,53,55
050,19,063,"Iowa","Emmet County",3,26,96,45,51
050,19,063,"Iowa","Emmet County",3,27,104,51,53
050,19,063,"Iowa","Emmet County",3,28,102,57,45
050,19,063,"Iowa","Emmet County",3,29,117,59,58
050,19,063,"Iowa","Emmet County",3,30,103,56,47
050,19,063,"Iowa","Emmet County",3,31,112,63,49
050,19,063,"Iowa","Emmet County",3,32,101,55,46
050,19,063,"Iowa","Emmet County",3,33,75,37,38
050,19,063,"Iowa","Emmet County",3,34,97,52,45
050,19,063,"Iowa","Emmet County",3,35,115,58,57
050,19,063,"Iowa","Emmet County",3,36,113,60,53
050,19,063,"Iowa","Emmet County",3,37,103,51,52
050,19,063,"Iowa","Emmet County",3,38,108,59,49
050,19,063,"Iowa","Emmet County",3,39,105,60,45
050,19,063,"Iowa","Emmet County",3,40,122,71,51
050,19,063,"Iowa","Emmet County",3,41,124,68,56
050,19,063,"Iowa","Emmet County",3,42,126,66,60
050,19,063,"Iowa","Emmet County",3,43,112,62,50
050,19,063,"Iowa","Emmet County",3,44,105,57,48
050,19,063,"Iowa","Emmet County",3,45,114,60,54
050,19,063,"Iowa","Emmet County",3,46,100,48,52
050,19,063,"Iowa","Emmet County",3,47,103,46,57
050,19,063,"Iowa","Emmet County",3,48,95,47,48
050,19,063,"Iowa","Emmet County",3,49,97,48,49
050,19,063,"Iowa","Emmet County",3,50,115,58,57
050,19,063,"Iowa","Emmet County",3,51,118,64,54
050,19,063,"Iowa","Emmet County",3,52,110,57,53
050,19,063,"Iowa","Emmet County",3,53,93,45,48
050,19,063,"Iowa","Emmet County",3,54,103,51,52
050,19,063,"Iowa","Emmet County",3,55,107,62,45
050,19,063,"Iowa","Emmet County",3,56,117,63,54
050,19,063,"Iowa","Emmet County",3,57,123,60,63
050,19,063,"Iowa","Emmet County",3,58,130,65,65
050,19,063,"Iowa","Emmet County",3,59,143,69,74
050,19,063,"Iowa","Emmet County",3,60,156,78,78
050,19,063,"Iowa","Emmet County",3,61,137,70,67
050,19,063,"Iowa","Emmet County",3,62,152,76,76
050,19,063,"Iowa","Emmet County",3,63,168,91,77
050,19,063,"Iowa","Emmet County",3,64,156,83,73
050,19,063,"Iowa","Emmet County",3,65,148,75,73
050,19,063,"Iowa","Emmet County",3,66,148,77,71
050,19,063,"Iowa","Emmet County",3,67,145,78,67
050,19,063,"Iowa","Emmet County",3,68,133,70,63
050,19,063,"Iowa","Emmet County",3,69,129,66,63
050,19,063,"Iowa","Emmet County",3,70,123,60,63
050,19,063,"Iowa","Emmet County",3,71,109,51,58
050,19,063,"Iowa","Emmet County",3,72,104,52,52
050,19,063,"Iowa","Emmet County",3,73,89,44,45
050,19,063,"Iowa","Emmet County",3,74,102,46,56
050,19,063,"Iowa","Emmet County",3,75,63,27,36
050,19,063,"Iowa","Emmet County",3,76,68,30,38
050,19,063,"Iowa","Emmet County",3,77,72,36,36
050,19,063,"Iowa","Emmet County",3,78,67,30,37
050,19,063,"Iowa","Emmet County",3,79,59,32,27
050,19,063,"Iowa","Emmet County",3,80,69,31,38
050,19,063,"Iowa","Emmet County",3,81,53,20,33
050,19,063,"Iowa","Emmet County",3,82,47,19,28
050,19,063,"Iowa","Emmet County",3,83,45,20,25
050,19,063,"Iowa","Emmet County",3,84,41,18,23
050,19,063,"Iowa","Emmet County",3,85,297,95,202
050,19,063,"Iowa","Emmet County",4,0,107,48,59
050,19,063,"Iowa","Emmet County",4,1,91,37,54
050,19,063,"Iowa","Emmet County",4,2,100,48,52
050,19,063,"Iowa","Emmet County",4,3,90,45,45
050,19,063,"Iowa","Emmet County",4,4,95,42,53
050,19,063,"Iowa","Emmet County",4,5,91,45,46
050,19,063,"Iowa","Emmet County",4,6,91,48,43
050,19,063,"Iowa","Emmet County",4,7,98,47,51
050,19,063,"Iowa","Emmet County",4,8,101,50,51
050,19,063,"Iowa","Emmet County",4,9,101,52,49
050,19,063,"Iowa","Emmet County",4,10,83,48,35
050,19,063,"Iowa","Emmet County",4,11,90,51,39
050,19,063,"Iowa","Emmet County",4,12,91,51,40
050,19,063,"Iowa","Emmet County",4,13,95,53,42
050,19,063,"Iowa","Emmet County",4,14,97,45,52
050,19,063,"Iowa","Emmet County",4,15,108,58,50
050,19,063,"Iowa","Emmet County",4,16,115,60,55
050,19,063,"Iowa","Emmet County",4,17,107,55,52
050,19,063,"Iowa","Emmet County",4,18,130,74,56
050,19,063,"Iowa","Emmet County",4,19,170,100,70
050,19,063,"Iowa","Emmet County",4,20,134,86,48
050,19,063,"Iowa","Emmet County",4,21,103,65,38
050,19,063,"Iowa","Emmet County",4,22,104,56,48
050,19,063,"Iowa","Emmet County",4,23,98,57,41
050,19,063,"Iowa","Emmet County",4,24,104,57,47
050,19,063,"Iowa","Emmet County",4,25,93,46,47
050,19,063,"Iowa","Emmet County",4,26,105,55,50
050,19,063,"Iowa","Emmet County",4,27,93,42,51
050,19,063,"Iowa","Emmet County",4,28,100,49,51
050,19,063,"Iowa","Emmet County",4,29,105,54,51
050,19,063,"Iowa","Emmet County",4,30,107,57,50
050,19,063,"Iowa","Emmet County",4,31,99,54,45
050,19,063,"Iowa","Emmet County",4,32,104,58,46
050,19,063,"Iowa","Emmet County",4,33,106,57,49
050,19,063,"Iowa","Emmet County",4,34,75,39,36
050,19,063,"Iowa","Emmet County",4,35,96,52,44
050,19,063,"Iowa","Emmet County",4,36,113,59,54
050,19,063,"Iowa","Emmet County",4,37,115,61,54
050,19,063,"Iowa","Emmet County",4,38,107,52,55
050,19,063,"Iowa","Emmet County",4,39,105,57,48
050,19,063,"Iowa","Emmet County",4,40,101,53,48
050,19,063,"Iowa","Emmet County",4,41,128,69,59
050,19,063,"Iowa","Emmet County",4,42,123,68,55
050,19,063,"Iowa","Emmet County",4,43,123,62,61
050,19,063,"Iowa","Emmet County",4,44,113,63,50
050,19,063,"Iowa","Emmet County",4,45,102,60,42
050,19,063,"Iowa","Emmet County",4,46,113,60,53
050,19,063,"Iowa","Emmet County",4,47,99,49,50
050,19,063,"Iowa","Emmet County",4,48,102,45,57
050,19,063,"Iowa","Emmet County",4,49,91,45,46
050,19,063,"Iowa","Emmet County",4,50,98,48,50
050,19,063,"Iowa","Emmet County",4,51,113,57,56
050,19,063,"Iowa","Emmet County",4,52,115,60,55
050,19,063,"Iowa","Emmet County",4,53,109,56,53
050,19,063,"Iowa","Emmet County",4,54,96,46,50
050,19,063,"Iowa","Emmet County",4,55,102,52,50
050,19,063,"Iowa","Emmet County",4,56,107,62,45
050,19,063,"Iowa","Emmet County",4,57,116,66,50
050,19,063,"Iowa","Emmet County",4,58,120,60,60
050,19,063,"Iowa","Emmet County",4,59,126,61,65
050,19,063,"Iowa","Emmet County",4,60,142,64,78
050,19,063,"Iowa","Emmet County",4,61,150,73,77
050,19,063,"Iowa","Emmet County",4,62,132,67,65
050,19,063,"Iowa","Emmet County",4,63,149,73,76
050,19,063,"Iowa","Emmet County",4,64,166,89,77
050,19,063,"Iowa","Emmet County",4,65,152,81,71
050,19,063,"Iowa","Emmet County",4,66,144,74,70
050,19,063,"Iowa","Emmet County",4,67,145,76,69
050,19,063,"Iowa","Emmet County",4,68,136,73,63
050,19,063,"Iowa","Emmet County",4,69,132,64,68
050,19,063,"Iowa","Emmet County",4,70,125,64,61
050,19,063,"Iowa","Emmet County",4,71,116,55,61
050,19,063,"Iowa","Emmet County",4,72,106,52,54
050,19,063,"Iowa","Emmet County",4,73,99,50,49
050,19,063,"Iowa","Emmet County",4,74,92,46,46
050,19,063,"Iowa","Emmet County",4,75,93,41,52
050,19,063,"Iowa","Emmet County",4,76,63,28,35
050,19,063,"Iowa","Emmet County",4,77,67,32,35
050,19,063,"Iowa","Emmet County",4,78,67,31,36
050,19,063,"Iowa","Emmet County",4,79,66,32,34
050,19,063,"Iowa","Emmet County",4,80,61,31,30
050,19,063,"Iowa","Emmet County",4,81,64,29,35
050,19,063,"Iowa","Emmet County",4,82,48,20,28
050,19,063,"Iowa","Emmet County",4,83,40,16,24
050,19,063,"Iowa","Emmet County",4,84,40,19,21
050,19,063,"Iowa","Emmet County",4,85,305,101,204
050,19,063,"Iowa","Emmet County",5,0,93,43,50
050,19,063,"Iowa","Emmet County",5,1,114,52,62
050,19,063,"Iowa","Emmet County",5,2,96,39,57
050,19,063,"Iowa","Emmet County",5,3,98,46,52
050,19,063,"Iowa","Emmet County",5,4,98,48,50
050,19,063,"Iowa","Emmet County",5,5,98,44,54
050,19,063,"Iowa","Emmet County",5,6,95,49,46
050,19,063,"Iowa","Emmet County",5,7,91,47,44
050,19,063,"Iowa","Emmet County",5,8,99,52,47
050,19,063,"Iowa","Emmet County",5,9,102,48,54
050,19,063,"Iowa","Emmet County",5,10,99,50,49
050,19,063,"Iowa","Emmet County",5,11,82,47,35
050,19,063,"Iowa","Emmet County",5,12,90,51,39
050,19,063,"Iowa","Emmet County",5,13,92,50,42
050,19,063,"Iowa","Emmet County",5,14,101,59,42
050,19,063,"Iowa","Emmet County",5,15,107,48,59
050,19,063,"Iowa","Emmet County",5,16,103,53,50
050,19,063,"Iowa","Emmet County",5,17,115,62,53
050,19,063,"Iowa","Emmet County",5,18,123,68,55
050,19,063,"Iowa","Emmet County",5,19,176,101,75
050,19,063,"Iowa","Emmet County",5,20,136,93,43
050,19,063,"Iowa","Emmet County",5,21,96,54,42
050,19,063,"Iowa","Emmet County",5,22,91,59,32
050,19,063,"Iowa","Emmet County",5,23,113,59,54
050,19,063,"Iowa","Emmet County",5,24,95,54,41
050,19,063,"Iowa","Emmet County",5,25,95,47,48
050,19,063,"Iowa","Emmet County",5,26,104,55,49
050,19,063,"Iowa","Emmet County",5,27,103,52,51
050,19,063,"Iowa","Emmet County",5,28,96,44,52
050,19,063,"Iowa","Emmet County",5,29,105,56,49
050,19,063,"Iowa","Emmet County",5,30,117,64,53
050,19,063,"Iowa","Emmet County",5,31,110,58,52
050,19,063,"Iowa","Emmet County",5,32,100,53,47
050,19,063,"Iowa","Emmet County",5,33,109,60,49
050,19,063,"Iowa","Emmet County",5,34,112,57,55
050,19,063,"Iowa","Emmet County",5,35,77,41,36
050,19,063,"Iowa","Emmet County",5,36,95,50,45
050,19,063,"Iowa","Emmet County",5,37,114,59,55
050,19,063,"Iowa","Emmet County",5,38,110,60,50
050,19,063,"Iowa","Emmet County",5,39,102,52,50
050,19,063,"Iowa","Emmet County",5,40,103,57,46
050,19,063,"Iowa","Emmet County",5,41,101,54,47
050,19,063,"Iowa","Emmet County",5,42,130,69,61
050,19,063,"Iowa","Emmet County",5,43,124,69,55
050,19,063,"Iowa","Emmet County",5,44,125,64,61
050,19,063,"Iowa","Emmet County",5,45,111,61,50
050,19,063,"Iowa","Emmet County",5,46,103,60,43
050,19,063,"Iowa","Emmet County",5,47,113,62,51
050,19,063,"Iowa","Emmet County",5,48,96,47,49
050,19,063,"Iowa","Emmet County",5,49,99,44,55
050,19,063,"Iowa","Emmet County",5,50,92,45,47
050,19,063,"Iowa","Emmet County",5,51,92,46,46
050,19,063,"Iowa","Emmet County",5,52,110,56,54
050,19,063,"Iowa","Emmet County",5,53,112,59,53
050,19,063,"Iowa","Emmet County",5,54,110,59,51
050,19,063,"Iowa","Emmet County",5,55,97,49,48
050,19,063,"Iowa","Emmet County",5,56,98,51,47
050,19,063,"Iowa","Emmet County",5,57,108,61,47
050,19,063,"Iowa","Emmet County",5,58,109,58,51
050,19,063,"Iowa","Emmet County",5,59,115,56,59
050,19,063,"Iowa","Emmet County",5,60,128,61,67
050,19,063,"Iowa","Emmet County",5,61,147,69,78
050,19,063,"Iowa","Emmet County",5,62,148,74,74
050,19,063,"Iowa","Emmet County",5,63,130,65,65
050,19,063,"Iowa","Emmet County",5,64,150,74,76
050,19,063,"Iowa","Emmet County",5,65,162,87,75
050,19,063,"Iowa","Emmet County",5,66,146,77,69
050,19,063,"Iowa","Emmet County",5,67,143,75,68
050,19,063,"Iowa","Emmet County",5,68,143,76,67
050,19,063,"Iowa","Emmet County",5,69,138,75,63
050,19,063,"Iowa","Emmet County",5,70,128,64,64
050,19,063,"Iowa","Emmet County",5,71,119,61,58
050,19,063,"Iowa","Emmet County",5,72,114,56,58
050,19,063,"Iowa","Emmet County",5,73,100,49,51
050,19,063,"Iowa","Emmet County",5,74,100,51,49
050,19,063,"Iowa","Emmet County",5,75,87,44,43
050,19,063,"Iowa","Emmet County",5,76,90,40,50
050,19,063,"Iowa","Emmet County",5,77,64,31,33
050,19,063,"Iowa","Emmet County",5,78,62,27,35
050,19,063,"Iowa","Emmet County",5,79,64,32,32
050,19,063,"Iowa","Emmet County",5,80,71,32,39
050,19,063,"Iowa","Emmet County",5,81,56,28,28
050,19,063,"Iowa","Emmet County",5,82,57,27,30
050,19,063,"Iowa","Emmet County",5,83,41,18,23
050,19,063,"Iowa","Emmet County",5,84,35,14,21
050,19,063,"Iowa","Emmet County",5,85,306,108,198
050,19,065,"Iowa","Fayette County",1,0,205,106,99
050,19,065,"Iowa","Fayette County",1,1,209,105,104
050,19,065,"Iowa","Fayette County",1,2,217,117,100
050,19,065,"Iowa","Fayette County",1,3,213,104,109
050,19,065,"Iowa","Fayette County",1,4,223,114,109
050,19,065,"Iowa","Fayette County",1,5,213,105,108
050,19,065,"Iowa","Fayette County",1,6,210,107,103
050,19,065,"Iowa","Fayette County",1,7,217,113,104
050,19,065,"Iowa","Fayette County",1,8,215,107,108
050,19,065,"Iowa","Fayette County",1,9,222,131,91
050,19,065,"Iowa","Fayette County",1,10,258,135,123
050,19,065,"Iowa","Fayette County",1,11,253,141,112
050,19,065,"Iowa","Fayette County",1,12,249,138,111
050,19,065,"Iowa","Fayette County",1,13,264,141,123
050,19,065,"Iowa","Fayette County",1,14,274,150,124
050,19,065,"Iowa","Fayette County",1,15,248,130,118
050,19,065,"Iowa","Fayette County",1,16,234,115,119
050,19,065,"Iowa","Fayette County",1,17,237,123,114
050,19,065,"Iowa","Fayette County",1,18,254,120,134
050,19,065,"Iowa","Fayette County",1,19,318,187,131
050,19,065,"Iowa","Fayette County",1,20,281,146,135
050,19,065,"Iowa","Fayette County",1,21,220,114,106
050,19,065,"Iowa","Fayette County",1,22,224,117,107
050,19,065,"Iowa","Fayette County",1,23,229,125,104
050,19,065,"Iowa","Fayette County",1,24,202,111,91
050,19,065,"Iowa","Fayette County",1,25,191,101,90
050,19,065,"Iowa","Fayette County",1,26,204,122,82
050,19,065,"Iowa","Fayette County",1,27,222,127,95
050,19,065,"Iowa","Fayette County",1,28,213,111,102
050,19,065,"Iowa","Fayette County",1,29,204,102,102
050,19,065,"Iowa","Fayette County",1,30,220,110,110
050,19,065,"Iowa","Fayette County",1,31,226,116,110
050,19,065,"Iowa","Fayette County",1,32,214,113,101
050,19,065,"Iowa","Fayette County",1,33,214,104,110
050,19,065,"Iowa","Fayette County",1,34,179,85,94
050,19,065,"Iowa","Fayette County",1,35,203,103,100
050,19,065,"Iowa","Fayette County",1,36,210,102,108
050,19,065,"Iowa","Fayette County",1,37,199,100,99
050,19,065,"Iowa","Fayette County",1,38,219,117,102
050,19,065,"Iowa","Fayette County",1,39,221,111,110
050,19,065,"Iowa","Fayette County",1,40,222,102,120
050,19,065,"Iowa","Fayette County",1,41,210,105,105
050,19,065,"Iowa","Fayette County",1,42,206,109,97
050,19,065,"Iowa","Fayette County",1,43,187,114,73
050,19,065,"Iowa","Fayette County",1,44,193,106,87
050,19,065,"Iowa","Fayette County",1,45,192,98,94
050,19,065,"Iowa","Fayette County",1,46,170,83,87
050,19,065,"Iowa","Fayette County",1,47,190,96,94
050,19,065,"Iowa","Fayette County",1,48,206,107,99
050,19,065,"Iowa","Fayette County",1,49,202,101,101
050,19,065,"Iowa","Fayette County",1,50,202,95,107
050,19,065,"Iowa","Fayette County",1,51,247,135,112
050,19,065,"Iowa","Fayette County",1,52,255,141,114
050,19,065,"Iowa","Fayette County",1,53,245,121,124
050,19,065,"Iowa","Fayette County",1,54,266,142,124
050,19,065,"Iowa","Fayette County",1,55,266,135,131
050,19,065,"Iowa","Fayette County",1,56,283,158,125
050,19,065,"Iowa","Fayette County",1,57,302,165,137
050,19,065,"Iowa","Fayette County",1,58,312,159,153
050,19,065,"Iowa","Fayette County",1,59,325,171,154
050,19,065,"Iowa","Fayette County",1,60,316,168,148
050,19,065,"Iowa","Fayette County",1,61,315,156,159
050,19,065,"Iowa","Fayette County",1,62,300,149,151
050,19,065,"Iowa","Fayette County",1,63,314,161,153
050,19,065,"Iowa","Fayette County",1,64,299,155,144
050,19,065,"Iowa","Fayette County",1,65,302,159,143
050,19,065,"Iowa","Fayette County",1,66,256,124,132
050,19,065,"Iowa","Fayette County",1,67,252,119,133
050,19,065,"Iowa","Fayette County",1,68,261,127,134
050,19,065,"Iowa","Fayette County",1,69,239,125,114
050,19,065,"Iowa","Fayette County",1,70,226,113,113
050,19,065,"Iowa","Fayette County",1,71,202,93,109
050,19,065,"Iowa","Fayette County",1,72,204,109,95
050,19,065,"Iowa","Fayette County",1,73,209,107,102
050,19,065,"Iowa","Fayette County",1,74,156,74,82
050,19,065,"Iowa","Fayette County",1,75,159,72,87
050,19,065,"Iowa","Fayette County",1,76,156,73,83
050,19,065,"Iowa","Fayette County",1,77,157,70,87
050,19,065,"Iowa","Fayette County",1,78,137,61,76
050,19,065,"Iowa","Fayette County",1,79,135,62,73
050,19,065,"Iowa","Fayette County",1,80,129,54,75
050,19,065,"Iowa","Fayette County",1,81,119,48,71
050,19,065,"Iowa","Fayette County",1,82,105,43,62
050,19,065,"Iowa","Fayette County",1,83,106,45,61
050,19,065,"Iowa","Fayette County",1,84,107,45,62
050,19,065,"Iowa","Fayette County",1,85,640,189,451
050,19,065,"Iowa","Fayette County",2,0,220,111,109
050,19,065,"Iowa","Fayette County",2,1,205,104,101
050,19,065,"Iowa","Fayette County",2,2,213,112,101
050,19,065,"Iowa","Fayette County",2,3,213,107,106
050,19,065,"Iowa","Fayette County",2,4,220,113,107
050,19,065,"Iowa","Fayette County",2,5,214,108,106
050,19,065,"Iowa","Fayette County",2,6,211,107,104
050,19,065,"Iowa","Fayette County",2,7,217,113,104
050,19,065,"Iowa","Fayette County",2,8,217,111,106
050,19,065,"Iowa","Fayette County",2,9,219,123,96
050,19,065,"Iowa","Fayette County",2,10,248,132,116
050,19,065,"Iowa","Fayette County",2,11,252,139,113
050,19,065,"Iowa","Fayette County",2,12,251,140,111
050,19,065,"Iowa","Fayette County",2,13,263,141,122
050,19,065,"Iowa","Fayette County",2,14,270,147,123
050,19,065,"Iowa","Fayette County",2,15,254,136,118
050,19,065,"Iowa","Fayette County",2,16,239,119,120
050,19,065,"Iowa","Fayette County",2,17,235,120,115
050,19,065,"Iowa","Fayette County",2,18,255,124,131
050,19,065,"Iowa","Fayette County",2,19,315,185,130
050,19,065,"Iowa","Fayette County",2,20,280,145,135
050,19,065,"Iowa","Fayette County",2,21,217,111,106
050,19,065,"Iowa","Fayette County",2,22,218,113,105
050,19,065,"Iowa","Fayette County",2,23,226,123,103
050,19,065,"Iowa","Fayette County",2,24,201,110,91
050,19,065,"Iowa","Fayette County",2,25,191,102,89
050,19,065,"Iowa","Fayette County",2,26,199,115,84
050,19,065,"Iowa","Fayette County",2,27,216,125,91
050,19,065,"Iowa","Fayette County",2,28,212,113,99
050,19,065,"Iowa","Fayette County",2,29,203,102,101
050,19,065,"Iowa","Fayette County",2,30,219,110,109
050,19,065,"Iowa","Fayette County",2,31,226,117,109
050,19,065,"Iowa","Fayette County",2,32,216,113,103
050,19,065,"Iowa","Fayette County",2,33,211,104,107
050,19,065,"Iowa","Fayette County",2,34,187,90,97
050,19,065,"Iowa","Fayette County",2,35,197,98,99
050,19,065,"Iowa","Fayette County",2,36,206,100,106
050,19,065,"Iowa","Fayette County",2,37,202,100,102
050,19,065,"Iowa","Fayette County",2,38,216,114,102
050,19,065,"Iowa","Fayette County",2,39,219,112,107
050,19,065,"Iowa","Fayette County",2,40,223,106,117
050,19,065,"Iowa","Fayette County",2,41,212,104,108
050,19,065,"Iowa","Fayette County",2,42,205,107,98
050,19,065,"Iowa","Fayette County",2,43,195,115,80
050,19,065,"Iowa","Fayette County",2,44,186,104,82
050,19,065,"Iowa","Fayette County",2,45,193,99,94
050,19,065,"Iowa","Fayette County",2,46,173,84,89
050,19,065,"Iowa","Fayette County",2,47,184,93,91
050,19,065,"Iowa","Fayette County",2,48,200,102,98
050,19,065,"Iowa","Fayette County",2,49,203,103,100
050,19,065,"Iowa","Fayette County",2,50,201,95,106
050,19,065,"Iowa","Fayette County",2,51,236,125,111
050,19,065,"Iowa","Fayette County",2,52,249,138,111
050,19,065,"Iowa","Fayette County",2,53,245,123,122
050,19,065,"Iowa","Fayette County",2,54,261,137,124
050,19,065,"Iowa","Fayette County",2,55,264,135,129
050,19,065,"Iowa","Fayette County",2,56,279,153,126
050,19,065,"Iowa","Fayette County",2,57,297,164,133
050,19,065,"Iowa","Fayette County",2,58,308,159,149
050,19,065,"Iowa","Fayette County",2,59,323,169,154
050,19,065,"Iowa","Fayette County",2,60,319,170,149
050,19,065,"Iowa","Fayette County",2,61,315,159,156
050,19,065,"Iowa","Fayette County",2,62,303,150,153
050,19,065,"Iowa","Fayette County",2,63,315,161,154
050,19,065,"Iowa","Fayette County",2,64,300,156,144
050,19,065,"Iowa","Fayette County",2,65,299,157,142
050,19,065,"Iowa","Fayette County",2,66,269,135,134
050,19,065,"Iowa","Fayette County",2,67,252,118,134
050,19,065,"Iowa","Fayette County",2,68,255,124,131
050,19,065,"Iowa","Fayette County",2,69,244,125,119
050,19,065,"Iowa","Fayette County",2,70,227,115,112
050,19,065,"Iowa","Fayette County",2,71,207,98,109
050,19,065,"Iowa","Fayette County",2,72,197,101,96
050,19,065,"Iowa","Fayette County",2,73,219,113,106
050,19,065,"Iowa","Fayette County",2,74,157,76,81
050,19,065,"Iowa","Fayette County",2,75,160,74,86
050,19,065,"Iowa","Fayette County",2,76,152,70,82
050,19,065,"Iowa","Fayette County",2,77,158,72,86
050,19,065,"Iowa","Fayette County",2,78,136,60,76
050,19,065,"Iowa","Fayette County",2,79,131,59,72
050,19,065,"Iowa","Fayette County",2,80,129,55,74
050,19,065,"Iowa","Fayette County",2,81,118,48,70
050,19,065,"Iowa","Fayette County",2,82,105,43,62
050,19,065,"Iowa","Fayette County",2,83,105,44,61
050,19,065,"Iowa","Fayette County",2,84,106,44,62
050,19,065,"Iowa","Fayette County",2,85,637,188,449
050,19,065,"Iowa","Fayette County",3,0,182,95,87
050,19,065,"Iowa","Fayette County",3,1,232,119,113
050,19,065,"Iowa","Fayette County",3,2,207,107,100
050,19,065,"Iowa","Fayette County",3,3,219,115,104
050,19,065,"Iowa","Fayette County",3,4,206,107,99
050,19,065,"Iowa","Fayette County",3,5,216,112,104
050,19,065,"Iowa","Fayette County",3,6,212,105,107
050,19,065,"Iowa","Fayette County",3,7,206,110,96
050,19,065,"Iowa","Fayette County",3,8,212,106,106
050,19,065,"Iowa","Fayette County",3,9,217,108,109
050,19,065,"Iowa","Fayette County",3,10,222,122,100
050,19,065,"Iowa","Fayette County",3,11,248,134,114
050,19,065,"Iowa","Fayette County",3,12,253,138,115
050,19,065,"Iowa","Fayette County",3,13,260,142,118
050,19,065,"Iowa","Fayette County",3,14,268,139,129
050,19,065,"Iowa","Fayette County",3,15,257,142,115
050,19,065,"Iowa","Fayette County",3,16,257,134,123
050,19,065,"Iowa","Fayette County",3,17,239,122,117
050,19,065,"Iowa","Fayette County",3,18,266,135,131
050,19,065,"Iowa","Fayette County",3,19,304,178,126
050,19,065,"Iowa","Fayette County",3,20,270,147,123
050,19,065,"Iowa","Fayette County",3,21,222,111,111
050,19,065,"Iowa","Fayette County",3,22,209,101,108
050,19,065,"Iowa","Fayette County",3,23,213,111,102
050,19,065,"Iowa","Fayette County",3,24,204,115,89
050,19,065,"Iowa","Fayette County",3,25,200,113,87
050,19,065,"Iowa","Fayette County",3,26,194,99,95
050,19,065,"Iowa","Fayette County",3,27,200,119,81
050,19,065,"Iowa","Fayette County",3,28,211,117,94
050,19,065,"Iowa","Fayette County",3,29,202,110,92
050,19,065,"Iowa","Fayette County",3,30,205,102,103
050,19,065,"Iowa","Fayette County",3,31,213,107,106
050,19,065,"Iowa","Fayette County",3,32,221,110,111
050,19,065,"Iowa","Fayette County",3,33,213,114,99
050,19,065,"Iowa","Fayette County",3,34,205,106,99
050,19,065,"Iowa","Fayette County",3,35,195,94,101
050,19,065,"Iowa","Fayette County",3,36,196,101,95
050,19,065,"Iowa","Fayette County",3,37,206,102,104
050,19,065,"Iowa","Fayette County",3,38,209,105,104
050,19,065,"Iowa","Fayette County",3,39,217,114,103
050,19,065,"Iowa","Fayette County",3,40,231,112,119
050,19,065,"Iowa","Fayette County",3,41,219,114,105
050,19,065,"Iowa","Fayette County",3,42,214,100,114
050,19,065,"Iowa","Fayette County",3,43,207,109,98
050,19,065,"Iowa","Fayette County",3,44,183,108,75
050,19,065,"Iowa","Fayette County",3,45,180,101,79
050,19,065,"Iowa","Fayette County",3,46,193,100,93
050,19,065,"Iowa","Fayette County",3,47,176,88,88
050,19,065,"Iowa","Fayette County",3,48,178,88,90
050,19,065,"Iowa","Fayette County",3,49,205,108,97
050,19,065,"Iowa","Fayette County",3,50,205,100,105
050,19,065,"Iowa","Fayette County",3,51,202,94,108
050,19,065,"Iowa","Fayette County",3,52,229,122,107
050,19,065,"Iowa","Fayette County",3,53,243,128,115
050,19,065,"Iowa","Fayette County",3,54,245,132,113
050,19,065,"Iowa","Fayette County",3,55,251,127,124
050,19,065,"Iowa","Fayette County",3,56,260,130,130
050,19,065,"Iowa","Fayette County",3,57,279,154,125
050,19,065,"Iowa","Fayette County",3,58,295,160,135
050,19,065,"Iowa","Fayette County",3,59,307,156,151
050,19,065,"Iowa","Fayette County",3,60,320,165,155
050,19,065,"Iowa","Fayette County",3,61,323,167,156
050,19,065,"Iowa","Fayette County",3,62,310,156,154
050,19,065,"Iowa","Fayette County",3,63,305,152,153
050,19,065,"Iowa","Fayette County",3,64,313,160,153
050,19,065,"Iowa","Fayette County",3,65,301,155,146
050,19,065,"Iowa","Fayette County",3,66,301,160,141
050,19,065,"Iowa","Fayette County",3,67,265,129,136
050,19,065,"Iowa","Fayette County",3,68,248,116,132
050,19,065,"Iowa","Fayette County",3,69,249,119,130
050,19,065,"Iowa","Fayette County",3,70,235,122,113
050,19,065,"Iowa","Fayette County",3,71,219,110,109
050,19,065,"Iowa","Fayette County",3,72,207,96,111
050,19,065,"Iowa","Fayette County",3,73,190,100,90
050,19,065,"Iowa","Fayette County",3,74,211,110,101
050,19,065,"Iowa","Fayette County",3,75,158,74,84
050,19,065,"Iowa","Fayette County",3,76,154,71,83
050,19,065,"Iowa","Fayette County",3,77,149,72,77
050,19,065,"Iowa","Fayette County",3,78,150,66,84
050,19,065,"Iowa","Fayette County",3,79,127,54,73
050,19,065,"Iowa","Fayette County",3,80,126,56,70
050,19,065,"Iowa","Fayette County",3,81,116,46,70
050,19,065,"Iowa","Fayette County",3,82,102,39,63
050,19,065,"Iowa","Fayette County",3,83,106,45,61
050,19,065,"Iowa","Fayette County",3,84,88,33,55
050,19,065,"Iowa","Fayette County",3,85,632,186,446
050,19,065,"Iowa","Fayette County",4,0,196,95,101
050,19,065,"Iowa","Fayette County",4,1,198,109,89
050,19,065,"Iowa","Fayette County",4,2,229,119,110
050,19,065,"Iowa","Fayette County",4,3,228,117,111
050,19,065,"Iowa","Fayette County",4,4,218,117,101
050,19,065,"Iowa","Fayette County",4,5,203,107,96
050,19,065,"Iowa","Fayette County",4,6,224,117,107
050,19,065,"Iowa","Fayette County",4,7,211,104,107
050,19,065,"Iowa","Fayette County",4,8,216,116,100
050,19,065,"Iowa","Fayette County",4,9,228,115,113
050,19,065,"Iowa","Fayette County",4,10,215,110,105
050,19,065,"Iowa","Fayette County",4,11,234,132,102
050,19,065,"Iowa","Fayette County",4,12,244,132,112
050,19,065,"Iowa","Fayette County",4,13,259,144,115
050,19,065,"Iowa","Fayette County",4,14,263,148,115
050,19,065,"Iowa","Fayette County",4,15,255,132,123
050,19,065,"Iowa","Fayette County",4,16,257,144,113
050,19,065,"Iowa","Fayette County",4,17,249,129,120
050,19,065,"Iowa","Fayette County",4,18,264,137,127
050,19,065,"Iowa","Fayette County",4,19,312,185,127
050,19,065,"Iowa","Fayette County",4,20,261,142,119
050,19,065,"Iowa","Fayette County",4,21,208,110,98
050,19,065,"Iowa","Fayette County",4,22,214,102,112
050,19,065,"Iowa","Fayette County",4,23,210,106,104
050,19,065,"Iowa","Fayette County",4,24,198,105,93
050,19,065,"Iowa","Fayette County",4,25,197,110,87
050,19,065,"Iowa","Fayette County",4,26,195,108,87
050,19,065,"Iowa","Fayette County",4,27,210,111,99
050,19,065,"Iowa","Fayette County",4,28,190,109,81
050,19,065,"Iowa","Fayette County",4,29,213,118,95
050,19,065,"Iowa","Fayette County",4,30,207,112,95
050,19,065,"Iowa","Fayette County",4,31,199,98,101
050,19,065,"Iowa","Fayette County",4,32,226,111,115
050,19,065,"Iowa","Fayette County",4,33,217,112,105
050,19,065,"Iowa","Fayette County",4,34,210,113,97
050,19,065,"Iowa","Fayette County",4,35,214,112,102
050,19,065,"Iowa","Fayette County",4,36,207,99,108
050,19,065,"Iowa","Fayette County",4,37,195,99,96
050,19,065,"Iowa","Fayette County",4,38,206,98,108
050,19,065,"Iowa","Fayette County",4,39,205,101,104
050,19,065,"Iowa","Fayette County",4,40,228,116,112
050,19,065,"Iowa","Fayette County",4,41,227,118,109
050,19,065,"Iowa","Fayette County",4,42,208,109,99
050,19,065,"Iowa","Fayette County",4,43,223,111,112
050,19,065,"Iowa","Fayette County",4,44,194,98,96
050,19,065,"Iowa","Fayette County",4,45,185,109,76
050,19,065,"Iowa","Fayette County",4,46,179,101,78
050,19,065,"Iowa","Fayette County",4,47,202,108,94
050,19,065,"Iowa","Fayette County",4,48,175,85,90
050,19,065,"Iowa","Fayette County",4,49,180,91,89
050,19,065,"Iowa","Fayette County",4,50,199,104,95
050,19,065,"Iowa","Fayette County",4,51,208,100,108
050,19,065,"Iowa","Fayette County",4,52,206,101,105
050,19,065,"Iowa","Fayette County",4,53,225,118,107
050,19,065,"Iowa","Fayette County",4,54,249,137,112
050,19,065,"Iowa","Fayette County",4,55,240,123,117
050,19,065,"Iowa","Fayette County",4,56,256,131,125
050,19,065,"Iowa","Fayette County",4,57,267,137,130
050,19,065,"Iowa","Fayette County",4,58,279,153,126
050,19,065,"Iowa","Fayette County",4,59,298,156,142
050,19,065,"Iowa","Fayette County",4,60,301,156,145
050,19,065,"Iowa","Fayette County",4,61,320,161,159
050,19,065,"Iowa","Fayette County",4,62,317,163,154
050,19,065,"Iowa","Fayette County",4,63,306,154,152
050,19,065,"Iowa","Fayette County",4,64,294,146,148
050,19,065,"Iowa","Fayette County",4,65,309,157,152
050,19,065,"Iowa","Fayette County",4,66,302,156,146
050,19,065,"Iowa","Fayette County",4,67,300,156,144
050,19,065,"Iowa","Fayette County",4,68,263,128,135
050,19,065,"Iowa","Fayette County",4,69,239,110,129
050,19,065,"Iowa","Fayette County",4,70,237,117,120
050,19,065,"Iowa","Fayette County",4,71,229,115,114
050,19,065,"Iowa","Fayette County",4,72,217,106,111
050,19,065,"Iowa","Fayette County",4,73,207,99,108
050,19,065,"Iowa","Fayette County",4,74,179,93,86
050,19,065,"Iowa","Fayette County",4,75,215,113,102
050,19,065,"Iowa","Fayette County",4,76,149,68,81
050,19,065,"Iowa","Fayette County",4,77,145,70,75
050,19,065,"Iowa","Fayette County",4,78,137,65,72
050,19,065,"Iowa","Fayette County",4,79,139,58,81
050,19,065,"Iowa","Fayette County",4,80,117,48,69
050,19,065,"Iowa","Fayette County",4,81,120,51,69
050,19,065,"Iowa","Fayette County",4,82,102,39,63
050,19,065,"Iowa","Fayette County",4,83,101,38,63
050,19,065,"Iowa","Fayette County",4,84,92,34,58
050,19,065,"Iowa","Fayette County",4,85,616,181,435
050,19,065,"Iowa","Fayette County",5,0,204,96,108
050,19,065,"Iowa","Fayette County",5,1,206,99,107
050,19,065,"Iowa","Fayette County",5,2,198,103,95
050,19,065,"Iowa","Fayette County",5,3,224,117,107
050,19,065,"Iowa","Fayette County",5,4,236,117,119
050,19,065,"Iowa","Fayette County",5,5,228,125,103
050,19,065,"Iowa","Fayette County",5,6,209,107,102
050,19,065,"Iowa","Fayette County",5,7,221,117,104
050,19,065,"Iowa","Fayette County",5,8,210,100,110
050,19,065,"Iowa","Fayette County",5,9,216,116,100
050,19,065,"Iowa","Fayette County",5,10,220,110,110
050,19,065,"Iowa","Fayette County",5,11,215,107,108
050,19,065,"Iowa","Fayette County",5,12,222,125,97
050,19,065,"Iowa","Fayette County",5,13,253,139,114
050,19,065,"Iowa","Fayette County",5,14,256,139,117
050,19,065,"Iowa","Fayette County",5,15,268,149,119
050,19,065,"Iowa","Fayette County",5,16,263,144,119
050,19,065,"Iowa","Fayette County",5,17,261,150,111
050,19,065,"Iowa","Fayette County",5,18,282,151,131
050,19,065,"Iowa","Fayette County",5,19,309,190,119
050,19,065,"Iowa","Fayette County",5,20,264,145,119
050,19,065,"Iowa","Fayette County",5,21,203,103,100
050,19,065,"Iowa","Fayette County",5,22,191,94,97
050,19,065,"Iowa","Fayette County",5,23,202,102,100
050,19,065,"Iowa","Fayette County",5,24,198,109,89
050,19,065,"Iowa","Fayette County",5,25,196,99,97
050,19,065,"Iowa","Fayette County",5,26,210,113,97
050,19,065,"Iowa","Fayette County",5,27,207,123,84
050,19,065,"Iowa","Fayette County",5,28,201,106,95
050,19,065,"Iowa","Fayette County",5,29,187,109,78
050,19,065,"Iowa","Fayette County",5,30,226,123,103
050,19,065,"Iowa","Fayette County",5,31,208,108,100
050,19,065,"Iowa","Fayette County",5,32,198,95,103
050,19,065,"Iowa","Fayette County",5,33,225,112,113
050,19,065,"Iowa","Fayette County",5,34,225,116,109
050,19,065,"Iowa","Fayette County",5,35,212,110,102
050,19,065,"Iowa","Fayette County",5,36,218,116,102
050,19,065,"Iowa","Fayette County",5,37,205,100,105
050,19,065,"Iowa","Fayette County",5,38,199,105,94
050,19,065,"Iowa","Fayette County",5,39,212,100,112
050,19,065,"Iowa","Fayette County",5,40,212,105,107
050,19,065,"Iowa","Fayette County",5,41,222,118,104
050,19,065,"Iowa","Fayette County",5,42,224,113,111
050,19,065,"Iowa","Fayette County",5,43,214,111,103
050,19,065,"Iowa","Fayette County",5,44,216,106,110
050,19,065,"Iowa","Fayette County",5,45,193,99,94
050,19,065,"Iowa","Fayette County",5,46,186,110,76
050,19,065,"Iowa","Fayette County",5,47,185,104,81
050,19,065,"Iowa","Fayette County",5,48,199,105,94
050,19,065,"Iowa","Fayette County",5,49,169,87,82
050,19,065,"Iowa","Fayette County",5,50,178,92,86
050,19,065,"Iowa","Fayette County",5,51,212,107,105
050,19,065,"Iowa","Fayette County",5,52,202,97,105
050,19,065,"Iowa","Fayette County",5,53,208,98,110
050,19,065,"Iowa","Fayette County",5,54,225,121,104
050,19,065,"Iowa","Fayette County",5,55,243,130,113
050,19,065,"Iowa","Fayette County",5,56,240,122,118
050,19,065,"Iowa","Fayette County",5,57,250,132,118
050,19,065,"Iowa","Fayette County",5,58,258,129,129
050,19,065,"Iowa","Fayette County",5,59,276,155,121
050,19,065,"Iowa","Fayette County",5,60,294,156,138
050,19,065,"Iowa","Fayette County",5,61,302,155,147
050,19,065,"Iowa","Fayette County",5,62,313,155,158
050,19,065,"Iowa","Fayette County",5,63,316,156,160
050,19,065,"Iowa","Fayette County",5,64,301,154,147
050,19,065,"Iowa","Fayette County",5,65,290,143,147
050,19,065,"Iowa","Fayette County",5,66,311,160,151
050,19,065,"Iowa","Fayette County",5,67,300,153,147
050,19,065,"Iowa","Fayette County",5,68,293,153,140
050,19,065,"Iowa","Fayette County",5,69,254,121,133
050,19,065,"Iowa","Fayette County",5,70,231,108,123
050,19,065,"Iowa","Fayette County",5,71,228,111,117
050,19,065,"Iowa","Fayette County",5,72,227,111,116
050,19,065,"Iowa","Fayette County",5,73,209,105,104
050,19,065,"Iowa","Fayette County",5,74,195,93,102
050,19,065,"Iowa","Fayette County",5,75,180,92,88
050,19,065,"Iowa","Fayette County",5,76,209,109,100
050,19,065,"Iowa","Fayette County",5,77,143,68,75
050,19,065,"Iowa","Fayette County",5,78,137,64,73
050,19,065,"Iowa","Fayette County",5,79,124,57,67
050,19,065,"Iowa","Fayette County",5,80,133,55,78
050,19,065,"Iowa","Fayette County",5,81,110,44,66
050,19,065,"Iowa","Fayette County",5,82,103,43,60
050,19,065,"Iowa","Fayette County",5,83,105,39,66
050,19,065,"Iowa","Fayette County",5,84,86,26,60
050,19,065,"Iowa","Fayette County",5,85,616,183,433
050,19,067,"Iowa","Floyd County",1,0,168,85,83
050,19,067,"Iowa","Floyd County",1,1,173,82,91
050,19,067,"Iowa","Floyd County",1,2,194,101,93
050,19,067,"Iowa","Floyd County",1,3,214,120,94
050,19,067,"Iowa","Floyd County",1,4,195,95,100
050,19,067,"Iowa","Floyd County",1,5,192,109,83
050,19,067,"Iowa","Floyd County",1,6,187,98,89
050,19,067,"Iowa","Floyd County",1,7,179,82,97
050,19,067,"Iowa","Floyd County",1,8,196,107,89
050,19,067,"Iowa","Floyd County",1,9,195,104,91
050,19,067,"Iowa","Floyd County",1,10,183,92,91
050,19,067,"Iowa","Floyd County",1,11,212,105,107
050,19,067,"Iowa","Floyd County",1,12,241,126,115
050,19,067,"Iowa","Floyd County",1,13,228,113,115
050,19,067,"Iowa","Floyd County",1,14,211,103,108
050,19,067,"Iowa","Floyd County",1,15,208,107,101
050,19,067,"Iowa","Floyd County",1,16,184,104,80
050,19,067,"Iowa","Floyd County",1,17,206,101,105
050,19,067,"Iowa","Floyd County",1,18,200,108,92
050,19,067,"Iowa","Floyd County",1,19,157,82,75
050,19,067,"Iowa","Floyd County",1,20,146,74,72
050,19,067,"Iowa","Floyd County",1,21,152,76,76
050,19,067,"Iowa","Floyd County",1,22,153,82,71
050,19,067,"Iowa","Floyd County",1,23,155,76,79
050,19,067,"Iowa","Floyd County",1,24,164,83,81
050,19,067,"Iowa","Floyd County",1,25,171,79,92
050,19,067,"Iowa","Floyd County",1,26,170,86,84
050,19,067,"Iowa","Floyd County",1,27,167,82,85
050,19,067,"Iowa","Floyd County",1,28,180,93,87
050,19,067,"Iowa","Floyd County",1,29,175,89,86
050,19,067,"Iowa","Floyd County",1,30,149,74,75
050,19,067,"Iowa","Floyd County",1,31,156,76,80
050,19,067,"Iowa","Floyd County",1,32,150,78,72
050,19,067,"Iowa","Floyd County",1,33,154,79,75
050,19,067,"Iowa","Floyd County",1,34,181,85,96
050,19,067,"Iowa","Floyd County",1,35,183,94,89
050,19,067,"Iowa","Floyd County",1,36,171,96,75
050,19,067,"Iowa","Floyd County",1,37,168,93,75
050,19,067,"Iowa","Floyd County",1,38,176,90,86
050,19,067,"Iowa","Floyd County",1,39,160,85,75
050,19,067,"Iowa","Floyd County",1,40,183,92,91
050,19,067,"Iowa","Floyd County",1,41,189,92,97
050,19,067,"Iowa","Floyd County",1,42,156,75,81
050,19,067,"Iowa","Floyd County",1,43,161,74,87
050,19,067,"Iowa","Floyd County",1,44,158,83,75
050,19,067,"Iowa","Floyd County",1,45,166,86,80
050,19,067,"Iowa","Floyd County",1,46,165,88,77
050,19,067,"Iowa","Floyd County",1,47,171,89,82
050,19,067,"Iowa","Floyd County",1,48,187,96,91
050,19,067,"Iowa","Floyd County",1,49,189,94,95
050,19,067,"Iowa","Floyd County",1,50,183,86,97
050,19,067,"Iowa","Floyd County",1,51,193,100,93
050,19,067,"Iowa","Floyd County",1,52,194,104,90
050,19,067,"Iowa","Floyd County",1,53,206,96,110
050,19,067,"Iowa","Floyd County",1,54,209,102,107
050,19,067,"Iowa","Floyd County",1,55,211,106,105
050,19,067,"Iowa","Floyd County",1,56,234,118,116
050,19,067,"Iowa","Floyd County",1,57,230,121,109
050,19,067,"Iowa","Floyd County",1,58,237,128,109
050,19,067,"Iowa","Floyd County",1,59,251,122,129
050,19,067,"Iowa","Floyd County",1,60,228,112,116
050,19,067,"Iowa","Floyd County",1,61,232,115,117
050,19,067,"Iowa","Floyd County",1,62,224,113,111
050,19,067,"Iowa","Floyd County",1,63,205,103,102
050,19,067,"Iowa","Floyd County",1,64,200,98,102
050,19,067,"Iowa","Floyd County",1,65,212,107,105
050,19,067,"Iowa","Floyd County",1,66,214,110,104
050,19,067,"Iowa","Floyd County",1,67,211,104,107
050,19,067,"Iowa","Floyd County",1,68,206,91,115
050,19,067,"Iowa","Floyd County",1,69,205,90,115
050,19,067,"Iowa","Floyd County",1,70,192,88,104
050,19,067,"Iowa","Floyd County",1,71,180,87,93
050,19,067,"Iowa","Floyd County",1,72,181,91,90
050,19,067,"Iowa","Floyd County",1,73,166,80,86
050,19,067,"Iowa","Floyd County",1,74,132,58,74
050,19,067,"Iowa","Floyd County",1,75,140,61,79
050,19,067,"Iowa","Floyd County",1,76,135,63,72
050,19,067,"Iowa","Floyd County",1,77,136,74,62
050,19,067,"Iowa","Floyd County",1,78,120,58,62
050,19,067,"Iowa","Floyd County",1,79,121,60,61
050,19,067,"Iowa","Floyd County",1,80,108,49,59
050,19,067,"Iowa","Floyd County",1,81,97,45,52
050,19,067,"Iowa","Floyd County",1,82,91,38,53
050,19,067,"Iowa","Floyd County",1,83,77,27,50
050,19,067,"Iowa","Floyd County",1,84,92,40,52
050,19,067,"Iowa","Floyd County",1,85,456,174,282
050,19,067,"Iowa","Floyd County",2,0,177,90,87
050,19,067,"Iowa","Floyd County",2,1,172,83,89
050,19,067,"Iowa","Floyd County",2,2,188,95,93
050,19,067,"Iowa","Floyd County",2,3,208,114,94
050,19,067,"Iowa","Floyd County",2,4,200,102,98
050,19,067,"Iowa","Floyd County",2,5,190,103,87
050,19,067,"Iowa","Floyd County",2,6,189,101,88
050,19,067,"Iowa","Floyd County",2,7,182,88,94
050,19,067,"Iowa","Floyd County",2,8,189,100,89
050,19,067,"Iowa","Floyd County",2,9,196,104,92
050,19,067,"Iowa","Floyd County",2,10,187,96,91
050,19,067,"Iowa","Floyd County",2,11,205,102,103
050,19,067,"Iowa","Floyd County",2,12,235,121,114
050,19,067,"Iowa","Floyd County",2,13,231,116,115
050,19,067,"Iowa","Floyd County",2,14,217,106,111
050,19,067,"Iowa","Floyd County",2,15,207,105,102
050,19,067,"Iowa","Floyd County",2,16,189,104,85
050,19,067,"Iowa","Floyd County",2,17,203,104,99
050,19,067,"Iowa","Floyd County",2,18,193,104,89
050,19,067,"Iowa","Floyd County",2,19,160,84,76
050,19,067,"Iowa","Floyd County",2,20,152,78,74
050,19,067,"Iowa","Floyd County",2,21,150,77,73
050,19,067,"Iowa","Floyd County",2,22,155,82,73
050,19,067,"Iowa","Floyd County",2,23,154,77,77
050,19,067,"Iowa","Floyd County",2,24,162,82,80
050,19,067,"Iowa","Floyd County",2,25,166,78,88
050,19,067,"Iowa","Floyd County",2,26,170,84,86
050,19,067,"Iowa","Floyd County",2,27,167,82,85
050,19,067,"Iowa","Floyd County",2,28,175,90,85
050,19,067,"Iowa","Floyd County",2,29,175,89,86
050,19,067,"Iowa","Floyd County",2,30,155,77,78
050,19,067,"Iowa","Floyd County",2,31,151,73,78
050,19,067,"Iowa","Floyd County",2,32,149,75,74
050,19,067,"Iowa","Floyd County",2,33,152,77,75
050,19,067,"Iowa","Floyd County",2,34,175,85,90
050,19,067,"Iowa","Floyd County",2,35,183,93,90
050,19,067,"Iowa","Floyd County",2,36,172,94,78
050,19,067,"Iowa","Floyd County",2,37,167,92,75
050,19,067,"Iowa","Floyd County",2,38,175,92,83
050,19,067,"Iowa","Floyd County",2,39,165,88,77
050,19,067,"Iowa","Floyd County",2,40,180,91,89
050,19,067,"Iowa","Floyd County",2,41,186,92,94
050,19,067,"Iowa","Floyd County",2,42,161,77,84
050,19,067,"Iowa","Floyd County",2,43,160,76,84
050,19,067,"Iowa","Floyd County",2,44,157,81,76
050,19,067,"Iowa","Floyd County",2,45,163,84,79
050,19,067,"Iowa","Floyd County",2,46,164,87,77
050,19,067,"Iowa","Floyd County",2,47,169,88,81
050,19,067,"Iowa","Floyd County",2,48,181,93,88
050,19,067,"Iowa","Floyd County",2,49,189,95,94
050,19,067,"Iowa","Floyd County",2,50,186,89,97
050,19,067,"Iowa","Floyd County",2,51,189,97,92
050,19,067,"Iowa","Floyd County",2,52,192,102,90
050,19,067,"Iowa","Floyd County",2,53,205,99,106
050,19,067,"Iowa","Floyd County",2,54,208,101,107
050,19,067,"Iowa","Floyd County",2,55,209,104,105
050,19,067,"Iowa","Floyd County",2,56,230,116,114
050,19,067,"Iowa","Floyd County",2,57,231,121,110
050,19,067,"Iowa","Floyd County",2,58,237,127,110
050,19,067,"Iowa","Floyd County",2,59,248,125,123
050,19,067,"Iowa","Floyd County",2,60,231,112,119
050,19,067,"Iowa","Floyd County",2,61,228,113,115
050,19,067,"Iowa","Floyd County",2,62,225,113,112
050,19,067,"Iowa","Floyd County",2,63,211,106,105
050,19,067,"Iowa","Floyd County",2,64,198,98,100
050,19,067,"Iowa","Floyd County",2,65,209,105,104
050,19,067,"Iowa","Floyd County",2,66,215,110,105
050,19,067,"Iowa","Floyd County",2,67,212,106,106
050,19,067,"Iowa","Floyd County",2,68,204,92,112
050,19,067,"Iowa","Floyd County",2,69,206,91,115
050,19,067,"Iowa","Floyd County",2,70,193,87,106
050,19,067,"Iowa","Floyd County",2,71,183,87,96
050,19,067,"Iowa","Floyd County",2,72,176,88,88
050,19,067,"Iowa","Floyd County",2,73,177,86,91
050,19,067,"Iowa","Floyd County",2,74,130,59,71
050,19,067,"Iowa","Floyd County",2,75,138,61,77
050,19,067,"Iowa","Floyd County",2,76,134,62,72
050,19,067,"Iowa","Floyd County",2,77,140,74,66
050,19,067,"Iowa","Floyd County",2,78,121,61,60
050,19,067,"Iowa","Floyd County",2,79,118,57,61
050,19,067,"Iowa","Floyd County",2,80,110,52,58
050,19,067,"Iowa","Floyd County",2,81,98,45,53
050,19,067,"Iowa","Floyd County",2,82,91,39,52
050,19,067,"Iowa","Floyd County",2,83,79,29,50
050,19,067,"Iowa","Floyd County",2,84,88,37,51
050,19,067,"Iowa","Floyd County",2,85,456,175,281
050,19,067,"Iowa","Floyd County",3,0,164,92,72
050,19,067,"Iowa","Floyd County",3,1,181,92,89
050,19,067,"Iowa","Floyd County",3,2,172,81,91
050,19,067,"Iowa","Floyd County",3,3,187,92,95
050,19,067,"Iowa","Floyd County",3,4,214,117,97
050,19,067,"Iowa","Floyd County",3,5,206,107,99
050,19,067,"Iowa","Floyd County",3,6,192,105,87
050,19,067,"Iowa","Floyd County",3,7,197,99,98
050,19,067,"Iowa","Floyd County",3,8,182,90,92
050,19,067,"Iowa","Floyd County",3,9,177,94,83
050,19,067,"Iowa","Floyd County",3,10,197,104,93
050,19,067,"Iowa","Floyd County",3,11,173,87,86
050,19,067,"Iowa","Floyd County",3,12,203,97,106
050,19,067,"Iowa","Floyd County",3,13,237,119,118
050,19,067,"Iowa","Floyd County",3,14,232,120,112
050,19,067,"Iowa","Floyd County",3,15,212,103,109
050,19,067,"Iowa","Floyd County",3,16,203,101,102
050,19,067,"Iowa","Floyd County",3,17,193,112,81
050,19,067,"Iowa","Floyd County",3,18,184,96,88
050,19,067,"Iowa","Floyd County",3,19,147,80,67
050,19,067,"Iowa","Floyd County",3,20,163,90,73
050,19,067,"Iowa","Floyd County",3,21,155,80,75
050,19,067,"Iowa","Floyd County",3,22,155,83,72
050,19,067,"Iowa","Floyd County",3,23,153,72,81
050,19,067,"Iowa","Floyd County",3,24,152,85,67
050,19,067,"Iowa","Floyd County",3,25,149,75,74
050,19,067,"Iowa","Floyd County",3,26,171,77,94
050,19,067,"Iowa","Floyd County",3,27,170,84,86
050,19,067,"Iowa","Floyd County",3,28,165,77,88
050,19,067,"Iowa","Floyd County",3,29,172,91,81
050,19,067,"Iowa","Floyd County",3,30,179,82,97
050,19,067,"Iowa","Floyd County",3,31,167,83,84
050,19,067,"Iowa","Floyd County",3,32,161,82,79
050,19,067,"Iowa","Floyd County",3,33,154,75,79
050,19,067,"Iowa","Floyd County",3,34,157,79,78
050,19,067,"Iowa","Floyd County",3,35,167,83,84
050,19,067,"Iowa","Floyd County",3,36,188,93,95
050,19,067,"Iowa","Floyd County",3,37,167,94,73
050,19,067,"Iowa","Floyd County",3,38,168,91,77
050,19,067,"Iowa","Floyd County",3,39,168,85,83
050,19,067,"Iowa","Floyd County",3,40,165,92,73
050,19,067,"Iowa","Floyd County",3,41,177,92,85
050,19,067,"Iowa","Floyd County",3,42,183,86,97
050,19,067,"Iowa","Floyd County",3,43,161,78,83
050,19,067,"Iowa","Floyd County",3,44,171,81,90
050,19,067,"Iowa","Floyd County",3,45,156,78,78
050,19,067,"Iowa","Floyd County",3,46,165,87,78
050,19,067,"Iowa","Floyd County",3,47,165,87,78
050,19,067,"Iowa","Floyd County",3,48,163,86,77
050,19,067,"Iowa","Floyd County",3,49,180,90,90
050,19,067,"Iowa","Floyd County",3,50,183,92,91
050,19,067,"Iowa","Floyd County",3,51,184,87,97
050,19,067,"Iowa","Floyd County",3,52,184,93,91
050,19,067,"Iowa","Floyd County",3,53,186,99,87
050,19,067,"Iowa","Floyd County",3,54,197,97,100
050,19,067,"Iowa","Floyd County",3,55,204,99,105
050,19,067,"Iowa","Floyd County",3,56,214,106,108
050,19,067,"Iowa","Floyd County",3,57,233,118,115
050,19,067,"Iowa","Floyd County",3,58,232,122,110
050,19,067,"Iowa","Floyd County",3,59,240,130,110
050,19,067,"Iowa","Floyd County",3,60,237,117,120
050,19,067,"Iowa","Floyd County",3,61,223,106,117
050,19,067,"Iowa","Floyd County",3,62,233,113,120
050,19,067,"Iowa","Floyd County",3,63,217,106,111
050,19,067,"Iowa","Floyd County",3,64,205,106,99
050,19,067,"Iowa","Floyd County",3,65,196,96,100
050,19,067,"Iowa","Floyd County",3,66,203,104,99
050,19,067,"Iowa","Floyd County",3,67,213,110,103
050,19,067,"Iowa","Floyd County",3,68,211,105,106
050,19,067,"Iowa","Floyd County",3,69,200,91,109
050,19,067,"Iowa","Floyd County",3,70,208,92,116
050,19,067,"Iowa","Floyd County",3,71,182,81,101
050,19,067,"Iowa","Floyd County",3,72,178,84,94
050,19,067,"Iowa","Floyd County",3,73,166,83,83
050,19,067,"Iowa","Floyd County",3,74,168,81,87
050,19,067,"Iowa","Floyd County",3,75,125,57,68
050,19,067,"Iowa","Floyd County",3,76,132,58,74
050,19,067,"Iowa","Floyd County",3,77,131,60,71
050,19,067,"Iowa","Floyd County",3,78,137,72,65
050,19,067,"Iowa","Floyd County",3,79,110,55,55
050,19,067,"Iowa","Floyd County",3,80,114,54,60
050,19,067,"Iowa","Floyd County",3,81,103,48,55
050,19,067,"Iowa","Floyd County",3,82,93,43,50
050,19,067,"Iowa","Floyd County",3,83,78,32,46
050,19,067,"Iowa","Floyd County",3,84,76,26,50
050,19,067,"Iowa","Floyd County",3,85,449,166,283
050,19,067,"Iowa","Floyd County",4,0,161,87,74
050,19,067,"Iowa","Floyd County",4,1,173,96,77
050,19,067,"Iowa","Floyd County",4,2,189,95,94
050,19,067,"Iowa","Floyd County",4,3,192,90,102
050,19,067,"Iowa","Floyd County",4,4,192,95,97
050,19,067,"Iowa","Floyd County",4,5,217,117,100
050,19,067,"Iowa","Floyd County",4,6,213,115,98
050,19,067,"Iowa","Floyd County",4,7,193,107,86
050,19,067,"Iowa","Floyd County",4,8,197,102,95
050,19,067,"Iowa","Floyd County",4,9,183,91,92
050,19,067,"Iowa","Floyd County",4,10,183,99,84
050,19,067,"Iowa","Floyd County",4,11,194,100,94
050,19,067,"Iowa","Floyd County",4,12,186,92,94
050,19,067,"Iowa","Floyd County",4,13,203,96,107
050,19,067,"Iowa","Floyd County",4,14,237,123,114
050,19,067,"Iowa","Floyd County",4,15,229,114,115
050,19,067,"Iowa","Floyd County",4,16,194,93,101
050,19,067,"Iowa","Floyd County",4,17,202,104,98
050,19,067,"Iowa","Floyd County",4,18,168,97,71
050,19,067,"Iowa","Floyd County",4,19,135,70,65
050,19,067,"Iowa","Floyd County",4,20,145,78,67
050,19,067,"Iowa","Floyd County",4,21,157,85,72
050,19,067,"Iowa","Floyd County",4,22,156,87,69
050,19,067,"Iowa","Floyd County",4,23,159,86,73
050,19,067,"Iowa","Floyd County",4,24,148,71,77
050,19,067,"Iowa","Floyd County",4,25,161,85,76
050,19,067,"Iowa","Floyd County",4,26,156,75,81
050,19,067,"Iowa","Floyd County",4,27,180,85,95
050,19,067,"Iowa","Floyd County",4,28,174,90,84
050,19,067,"Iowa","Floyd County",4,29,178,85,93
050,19,067,"Iowa","Floyd County",4,30,179,92,87
050,19,067,"Iowa","Floyd County",4,31,172,81,91
050,19,067,"Iowa","Floyd County",4,32,171,84,87
050,19,067,"Iowa","Floyd County",4,33,160,82,78
050,19,067,"Iowa","Floyd County",4,34,149,72,77
050,19,067,"Iowa","Floyd County",4,35,164,82,82
050,19,067,"Iowa","Floyd County",4,36,169,88,81
050,19,067,"Iowa","Floyd County",4,37,194,89,105
050,19,067,"Iowa","Floyd County",4,38,169,98,71
050,19,067,"Iowa","Floyd County",4,39,165,91,74
050,19,067,"Iowa","Floyd County",4,40,169,85,84
050,19,067,"Iowa","Floyd County",4,41,166,93,73
050,19,067,"Iowa","Floyd County",4,42,171,87,84
050,19,067,"Iowa","Floyd County",4,43,179,85,94
050,19,067,"Iowa","Floyd County",4,44,157,77,80
050,19,067,"Iowa","Floyd County",4,45,167,79,88
050,19,067,"Iowa","Floyd County",4,46,155,79,76
050,19,067,"Iowa","Floyd County",4,47,157,81,76
050,19,067,"Iowa","Floyd County",4,48,161,84,77
050,19,067,"Iowa","Floyd County",4,49,162,87,75
050,19,067,"Iowa","Floyd County",4,50,172,87,85
050,19,067,"Iowa","Floyd County",4,51,183,94,89
050,19,067,"Iowa","Floyd County",4,52,188,86,102
050,19,067,"Iowa","Floyd County",4,53,180,89,91
050,19,067,"Iowa","Floyd County",4,54,179,95,84
050,19,067,"Iowa","Floyd County",4,55,193,93,100
050,19,067,"Iowa","Floyd County",4,56,203,101,102
050,19,067,"Iowa","Floyd County",4,57,209,105,104
050,19,067,"Iowa","Floyd County",4,58,233,122,111
050,19,067,"Iowa","Floyd County",4,59,231,126,105
050,19,067,"Iowa","Floyd County",4,60,230,121,109
050,19,067,"Iowa","Floyd County",4,61,227,113,114
050,19,067,"Iowa","Floyd County",4,62,216,102,114
050,19,067,"Iowa","Floyd County",4,63,228,109,119
050,19,067,"Iowa","Floyd County",4,64,215,105,110
050,19,067,"Iowa","Floyd County",4,65,204,104,100
050,19,067,"Iowa","Floyd County",4,66,193,93,100
050,19,067,"Iowa","Floyd County",4,67,199,98,101
050,19,067,"Iowa","Floyd County",4,68,206,103,103
050,19,067,"Iowa","Floyd County",4,69,209,103,106
050,19,067,"Iowa","Floyd County",4,70,200,92,108
050,19,067,"Iowa","Floyd County",4,71,205,91,114
050,19,067,"Iowa","Floyd County",4,72,176,82,94
050,19,067,"Iowa","Floyd County",4,73,167,81,86
050,19,067,"Iowa","Floyd County",4,74,158,80,78
050,19,067,"Iowa","Floyd County",4,75,162,78,84
050,19,067,"Iowa","Floyd County",4,76,116,51,65
050,19,067,"Iowa","Floyd County",4,77,118,53,65
050,19,067,"Iowa","Floyd County",4,78,126,56,70
050,19,067,"Iowa","Floyd County",4,79,119,62,57
050,19,067,"Iowa","Floyd County",4,80,102,50,52
050,19,067,"Iowa","Floyd County",4,81,108,49,59
050,19,067,"Iowa","Floyd County",4,82,101,49,52
050,19,067,"Iowa","Floyd County",4,83,88,40,48
050,19,067,"Iowa","Floyd County",4,84,74,30,44
050,19,067,"Iowa","Floyd County",4,85,439,156,283
050,19,067,"Iowa","Floyd County",5,0,164,88,76
050,19,067,"Iowa","Floyd County",5,1,189,100,89
050,19,067,"Iowa","Floyd County",5,2,169,88,81
050,19,067,"Iowa","Floyd County",5,3,190,89,101
050,19,067,"Iowa","Floyd County",5,4,183,92,91
050,19,067,"Iowa","Floyd County",5,5,186,86,100
050,19,067,"Iowa","Floyd County",5,6,229,126,103
050,19,067,"Iowa","Floyd County",5,7,229,119,110
050,19,067,"Iowa","Floyd County",5,8,193,104,89
050,19,067,"Iowa","Floyd County",5,9,194,105,89
050,19,067,"Iowa","Floyd County",5,10,187,98,89
050,19,067,"Iowa","Floyd County",5,11,187,97,90
050,19,067,"Iowa","Floyd County",5,12,186,96,90
050,19,067,"Iowa","Floyd County",5,13,185,92,93
050,19,067,"Iowa","Floyd County",5,14,195,97,98
050,19,067,"Iowa","Floyd County",5,15,222,115,107
050,19,067,"Iowa","Floyd County",5,16,234,118,116
050,19,067,"Iowa","Floyd County",5,17,197,92,105
050,19,067,"Iowa","Floyd County",5,18,167,94,73
050,19,067,"Iowa","Floyd County",5,19,130,74,56
050,19,067,"Iowa","Floyd County",5,20,146,76,70
050,19,067,"Iowa","Floyd County",5,21,147,80,67
050,19,067,"Iowa","Floyd County",5,22,169,91,78
050,19,067,"Iowa","Floyd County",5,23,158,87,71
050,19,067,"Iowa","Floyd County",5,24,165,96,69
050,19,067,"Iowa","Floyd County",5,25,149,74,75
050,19,067,"Iowa","Floyd County",5,26,151,77,74
050,19,067,"Iowa","Floyd County",5,27,155,75,80
050,19,067,"Iowa","Floyd County",5,28,186,88,98
050,19,067,"Iowa","Floyd County",5,29,182,87,95
050,19,067,"Iowa","Floyd County",5,30,173,81,92
050,19,067,"Iowa","Floyd County",5,31,181,93,88
050,19,067,"Iowa","Floyd County",5,32,175,79,96
050,19,067,"Iowa","Floyd County",5,33,163,82,81
050,19,067,"Iowa","Floyd County",5,34,174,89,85
050,19,067,"Iowa","Floyd County",5,35,153,70,83
050,19,067,"Iowa","Floyd County",5,36,158,83,75
050,19,067,"Iowa","Floyd County",5,37,166,84,82
050,19,067,"Iowa","Floyd County",5,38,198,94,104
050,19,067,"Iowa","Floyd County",5,39,172,103,69
050,19,067,"Iowa","Floyd County",5,40,175,93,82
050,19,067,"Iowa","Floyd County",5,41,165,89,76
050,19,067,"Iowa","Floyd County",5,42,167,94,73
050,19,067,"Iowa","Floyd County",5,43,163,82,81
050,19,067,"Iowa","Floyd County",5,44,185,88,97
050,19,067,"Iowa","Floyd County",5,45,161,76,85
050,19,067,"Iowa","Floyd County",5,46,176,87,89
050,19,067,"Iowa","Floyd County",5,47,158,81,77
050,19,067,"Iowa","Floyd County",5,48,157,83,74
050,19,067,"Iowa","Floyd County",5,49,159,80,79
050,19,067,"Iowa","Floyd County",5,50,159,85,74
050,19,067,"Iowa","Floyd County",5,51,175,86,89
050,19,067,"Iowa","Floyd County",5,52,189,95,94
050,19,067,"Iowa","Floyd County",5,53,188,88,100
050,19,067,"Iowa","Floyd County",5,54,179,90,89
050,19,067,"Iowa","Floyd County",5,55,174,89,85
050,19,067,"Iowa","Floyd County",5,56,202,96,106
050,19,067,"Iowa","Floyd County",5,57,200,97,103
050,19,067,"Iowa","Floyd County",5,58,209,107,102
050,19,067,"Iowa","Floyd County",5,59,242,130,112
050,19,067,"Iowa","Floyd County",5,60,223,118,105
050,19,067,"Iowa","Floyd County",5,61,223,116,107
050,19,067,"Iowa","Floyd County",5,62,228,112,116
050,19,067,"Iowa","Floyd County",5,63,220,102,118
050,19,067,"Iowa","Floyd County",5,64,230,111,119
050,19,067,"Iowa","Floyd County",5,65,218,105,113
050,19,067,"Iowa","Floyd County",5,66,200,104,96
050,19,067,"Iowa","Floyd County",5,67,190,91,99
050,19,067,"Iowa","Floyd County",5,68,199,98,101
050,19,067,"Iowa","Floyd County",5,69,200,102,98
050,19,067,"Iowa","Floyd County",5,70,210,104,106
050,19,067,"Iowa","Floyd County",5,71,196,94,102
050,19,067,"Iowa","Floyd County",5,72,193,89,104
050,19,067,"Iowa","Floyd County",5,73,168,78,90
050,19,067,"Iowa","Floyd County",5,74,157,75,82
050,19,067,"Iowa","Floyd County",5,75,156,77,79
050,19,067,"Iowa","Floyd County",5,76,149,72,77
050,19,067,"Iowa","Floyd County",5,77,108,46,62
050,19,067,"Iowa","Floyd County",5,78,112,50,62
050,19,067,"Iowa","Floyd County",5,79,107,47,60
050,19,067,"Iowa","Floyd County",5,80,110,58,52
050,19,067,"Iowa","Floyd County",5,81,95,46,49
050,19,067,"Iowa","Floyd County",5,82,99,46,53
050,19,067,"Iowa","Floyd County",5,83,96,47,49
050,19,067,"Iowa","Floyd County",5,84,85,39,46
050,19,067,"Iowa","Floyd County",5,85,434,151,283
050,19,069,"Iowa","Franklin County",1,0,111,58,53
050,19,069,"Iowa","Franklin County",1,1,116,60,56
050,19,069,"Iowa","Franklin County",1,2,128,70,58
050,19,069,"Iowa","Franklin County",1,3,137,69,68
050,19,069,"Iowa","Franklin County",1,4,130,62,68
050,19,069,"Iowa","Franklin County",1,5,120,62,58
050,19,069,"Iowa","Franklin County",1,6,125,63,62
050,19,069,"Iowa","Franklin County",1,7,121,62,59
050,19,069,"Iowa","Franklin County",1,8,118,60,58
050,19,069,"Iowa","Franklin County",1,9,122,72,50
050,19,069,"Iowa","Franklin County",1,10,145,89,56
050,19,069,"Iowa","Franklin County",1,11,145,84,61
050,19,069,"Iowa","Franklin County",1,12,161,92,69
050,19,069,"Iowa","Franklin County",1,13,162,92,70
050,19,069,"Iowa","Franklin County",1,14,139,84,55
050,19,069,"Iowa","Franklin County",1,15,147,91,56
050,19,069,"Iowa","Franklin County",1,16,156,90,66
050,19,069,"Iowa","Franklin County",1,17,132,67,65
050,19,069,"Iowa","Franklin County",1,18,118,51,67
050,19,069,"Iowa","Franklin County",1,19,103,46,57
050,19,069,"Iowa","Franklin County",1,20,98,41,57
050,19,069,"Iowa","Franklin County",1,21,101,52,49
050,19,069,"Iowa","Franklin County",1,22,97,49,48
050,19,069,"Iowa","Franklin County",1,23,103,59,44
050,19,069,"Iowa","Franklin County",1,24,93,57,36
050,19,069,"Iowa","Franklin County",1,25,92,45,47
050,19,069,"Iowa","Franklin County",1,26,108,49,59
050,19,069,"Iowa","Franklin County",1,27,108,48,60
050,19,069,"Iowa","Franklin County",1,28,113,54,59
050,19,069,"Iowa","Franklin County",1,29,101,49,52
050,19,069,"Iowa","Franklin County",1,30,88,44,44
050,19,069,"Iowa","Franklin County",1,31,88,48,40
050,19,069,"Iowa","Franklin County",1,32,94,50,44
050,19,069,"Iowa","Franklin County",1,33,92,47,45
050,19,069,"Iowa","Franklin County",1,34,104,60,44
050,19,069,"Iowa","Franklin County",1,35,125,67,58
050,19,069,"Iowa","Franklin County",1,36,142,72,70
050,19,069,"Iowa","Franklin County",1,37,113,64,49
050,19,069,"Iowa","Franklin County",1,38,134,79,55
050,19,069,"Iowa","Franklin County",1,39,115,63,52
050,19,069,"Iowa","Franklin County",1,40,126,67,59
050,19,069,"Iowa","Franklin County",1,41,127,73,54
050,19,069,"Iowa","Franklin County",1,42,114,57,57
050,19,069,"Iowa","Franklin County",1,43,111,51,60
050,19,069,"Iowa","Franklin County",1,44,104,50,54
050,19,069,"Iowa","Franklin County",1,45,98,49,49
050,19,069,"Iowa","Franklin County",1,46,103,60,43
050,19,069,"Iowa","Franklin County",1,47,107,62,45
050,19,069,"Iowa","Franklin County",1,48,106,55,51
050,19,069,"Iowa","Franklin County",1,49,117,62,55
050,19,069,"Iowa","Franklin County",1,50,110,55,55
050,19,069,"Iowa","Franklin County",1,51,107,51,56
050,19,069,"Iowa","Franklin County",1,52,119,65,54
050,19,069,"Iowa","Franklin County",1,53,121,57,64
050,19,069,"Iowa","Franklin County",1,54,119,51,68
050,19,069,"Iowa","Franklin County",1,55,129,70,59
050,19,069,"Iowa","Franklin County",1,56,131,74,57
050,19,069,"Iowa","Franklin County",1,57,138,72,66
050,19,069,"Iowa","Franklin County",1,58,146,65,81
050,19,069,"Iowa","Franklin County",1,59,147,70,77
050,19,069,"Iowa","Franklin County",1,60,154,78,76
050,19,069,"Iowa","Franklin County",1,61,149,78,71
050,19,069,"Iowa","Franklin County",1,62,161,80,81
050,19,069,"Iowa","Franklin County",1,63,155,78,77
050,19,069,"Iowa","Franklin County",1,64,165,84,81
050,19,069,"Iowa","Franklin County",1,65,166,90,76
050,19,069,"Iowa","Franklin County",1,66,141,72,69
050,19,069,"Iowa","Franklin County",1,67,130,63,67
050,19,069,"Iowa","Franklin County",1,68,134,70,64
050,19,069,"Iowa","Franklin County",1,69,111,59,52
050,19,069,"Iowa","Franklin County",1,70,104,51,53
050,19,069,"Iowa","Franklin County",1,71,105,52,53
050,19,069,"Iowa","Franklin County",1,72,108,55,53
050,19,069,"Iowa","Franklin County",1,73,105,55,50
050,19,069,"Iowa","Franklin County",1,74,81,42,39
050,19,069,"Iowa","Franklin County",1,75,87,42,45
050,19,069,"Iowa","Franklin County",1,76,69,34,35
050,19,069,"Iowa","Franklin County",1,77,68,31,37
050,19,069,"Iowa","Franklin County",1,78,74,41,33
050,19,069,"Iowa","Franklin County",1,79,72,40,32
050,19,069,"Iowa","Franklin County",1,80,62,26,36
050,19,069,"Iowa","Franklin County",1,81,62,26,36
050,19,069,"Iowa","Franklin County",1,82,52,21,31
050,19,069,"Iowa","Franklin County",1,83,44,21,23
050,19,069,"Iowa","Franklin County",1,84,41,20,21
050,19,069,"Iowa","Franklin County",1,85,294,106,188
050,19,069,"Iowa","Franklin County",2,0,122,65,57
050,19,069,"Iowa","Franklin County",2,1,112,58,54
050,19,069,"Iowa","Franklin County",2,2,124,68,56
050,19,069,"Iowa","Franklin County",2,3,134,68,66
050,19,069,"Iowa","Franklin County",2,4,130,63,67
050,19,069,"Iowa","Franklin County",2,5,124,63,61
050,19,069,"Iowa","Franklin County",2,6,125,63,62
050,19,069,"Iowa","Franklin County",2,7,121,61,60
050,19,069,"Iowa","Franklin County",2,8,121,62,59
050,19,069,"Iowa","Franklin County",2,9,122,70,52
050,19,069,"Iowa","Franklin County",2,10,137,84,53
050,19,069,"Iowa","Franklin County",2,11,145,85,60
050,19,069,"Iowa","Franklin County",2,12,158,90,68
050,19,069,"Iowa","Franklin County",2,13,161,93,68
050,19,069,"Iowa","Franklin County",2,14,141,85,56
050,19,069,"Iowa","Franklin County",2,15,144,89,55
050,19,069,"Iowa","Franklin County",2,16,154,89,65
050,19,069,"Iowa","Franklin County",2,17,137,71,66
050,19,069,"Iowa","Franklin County",2,18,117,53,64
050,19,069,"Iowa","Franklin County",2,19,100,44,56
050,19,069,"Iowa","Franklin County",2,20,102,43,59
050,19,069,"Iowa","Franklin County",2,21,99,49,50
050,19,069,"Iowa","Franklin County",2,22,100,51,49
050,19,069,"Iowa","Franklin County",2,23,101,58,43
050,19,069,"Iowa","Franklin County",2,24,96,57,39
050,19,069,"Iowa","Franklin County",2,25,93,48,45
050,19,069,"Iowa","Franklin County",2,26,104,47,57
050,19,069,"Iowa","Franklin County",2,27,107,48,59
050,19,069,"Iowa","Franklin County",2,28,111,52,59
050,19,069,"Iowa","Franklin County",2,29,104,49,55
050,19,069,"Iowa","Franklin County",2,30,94,46,48
050,19,069,"Iowa","Franklin County",2,31,89,48,41
050,19,069,"Iowa","Franklin County",2,32,93,50,43
050,19,069,"Iowa","Franklin County",2,33,94,50,44
050,19,069,"Iowa","Franklin County",2,34,102,57,45
050,19,069,"Iowa","Franklin County",2,35,121,66,55
050,19,069,"Iowa","Franklin County",2,36,136,70,66
050,19,069,"Iowa","Franklin County",2,37,122,67,55
050,19,069,"Iowa","Franklin County",2,38,130,76,54
050,19,069,"Iowa","Franklin County",2,39,117,65,52
050,19,069,"Iowa","Franklin County",2,40,124,66,58
050,19,069,"Iowa","Franklin County",2,41,124,69,55
050,19,069,"Iowa","Franklin County",2,42,116,60,56
050,19,069,"Iowa","Franklin County",2,43,113,53,60
050,19,069,"Iowa","Franklin County",2,44,104,49,55
050,19,069,"Iowa","Franklin County",2,45,100,50,50
050,19,069,"Iowa","Franklin County",2,46,102,58,44
050,19,069,"Iowa","Franklin County",2,47,105,61,44
050,19,069,"Iowa","Franklin County",2,48,106,57,49
050,19,069,"Iowa","Franklin County",2,49,114,60,54
050,19,069,"Iowa","Franklin County",2,50,111,56,55
050,19,069,"Iowa","Franklin County",2,51,106,52,54
050,19,069,"Iowa","Franklin County",2,52,116,62,54
050,19,069,"Iowa","Franklin County",2,53,120,59,61
050,19,069,"Iowa","Franklin County",2,54,117,52,65
050,19,069,"Iowa","Franklin County",2,55,127,65,62
050,19,069,"Iowa","Franklin County",2,56,132,74,58
050,19,069,"Iowa","Franklin County",2,57,134,71,63
050,19,069,"Iowa","Franklin County",2,58,145,67,78
050,19,069,"Iowa","Franklin County",2,59,147,69,78
050,19,069,"Iowa","Franklin County",2,60,152,76,76
050,19,069,"Iowa","Franklin County",2,61,148,76,72
050,19,069,"Iowa","Franklin County",2,62,157,79,78
050,19,069,"Iowa","Franklin County",2,63,158,79,79
050,19,069,"Iowa","Franklin County",2,64,160,80,80
050,19,069,"Iowa","Franklin County",2,65,164,88,76
050,19,069,"Iowa","Franklin County",2,66,146,76,70
050,19,069,"Iowa","Franklin County",2,67,133,65,68
050,19,069,"Iowa","Franklin County",2,68,131,68,63
050,19,069,"Iowa","Franklin County",2,69,117,61,56
050,19,069,"Iowa","Franklin County",2,70,107,53,54
050,19,069,"Iowa","Franklin County",2,71,104,51,53
050,19,069,"Iowa","Franklin County",2,72,104,52,52
050,19,069,"Iowa","Franklin County",2,73,110,56,54
050,19,069,"Iowa","Franklin County",2,74,80,41,39
050,19,069,"Iowa","Franklin County",2,75,86,43,43
050,19,069,"Iowa","Franklin County",2,76,71,35,36
050,19,069,"Iowa","Franklin County",2,77,68,31,37
050,19,069,"Iowa","Franklin County",2,78,72,38,34
050,19,069,"Iowa","Franklin County",2,79,71,39,32
050,19,069,"Iowa","Franklin County",2,80,64,29,35
050,19,069,"Iowa","Franklin County",2,81,60,26,34
050,19,069,"Iowa","Franklin County",2,82,54,21,33
050,19,069,"Iowa","Franklin County",2,83,44,21,23
050,19,069,"Iowa","Franklin County",2,84,44,20,24
050,19,069,"Iowa","Franklin County",2,85,290,107,183
050,19,069,"Iowa","Franklin County",3,0,145,75,70
050,19,069,"Iowa","Franklin County",3,1,120,67,53
050,19,069,"Iowa","Franklin County",3,2,116,60,56
050,19,069,"Iowa","Franklin County",3,3,114,65,49
050,19,069,"Iowa","Franklin County",3,4,132,64,68
050,19,069,"Iowa","Franklin County",3,5,134,59,75
050,19,069,"Iowa","Franklin County",3,6,123,65,58
050,19,069,"Iowa","Franklin County",3,7,119,60,59
050,19,069,"Iowa","Franklin County",3,8,120,56,64
050,19,069,"Iowa","Franklin County",3,9,126,67,59
050,19,069,"Iowa","Franklin County",3,10,118,66,52
050,19,069,"Iowa","Franklin County",3,11,135,80,55
050,19,069,"Iowa","Franklin County",3,12,146,87,59
050,19,069,"Iowa","Franklin County",3,13,160,93,67
050,19,069,"Iowa","Franklin County",3,14,166,96,70
050,19,069,"Iowa","Franklin County",3,15,142,86,56
050,19,069,"Iowa","Franklin County",3,16,146,86,60
050,19,069,"Iowa","Franklin County",3,17,154,87,67
050,19,069,"Iowa","Franklin County",3,18,115,61,54
050,19,069,"Iowa","Franklin County",3,19,101,49,52
050,19,069,"Iowa","Franklin County",3,20,98,47,51
050,19,069,"Iowa","Franklin County",3,21,107,44,63
050,19,069,"Iowa","Franklin County",3,22,103,53,50
050,19,069,"Iowa","Franklin County",3,23,103,54,49
050,19,069,"Iowa","Franklin County",3,24,88,47,41
050,19,069,"Iowa","Franklin County",3,25,98,53,45
050,19,069,"Iowa","Franklin County",3,26,86,45,41
050,19,069,"Iowa","Franklin County",3,27,95,45,50
050,19,069,"Iowa","Franklin County",3,28,107,52,55
050,19,069,"Iowa","Franklin County",3,29,114,55,59
050,19,069,"Iowa","Franklin County",3,30,105,52,53
050,19,069,"Iowa","Franklin County",3,31,97,52,45
050,19,069,"Iowa","Franklin County",3,32,89,44,45
050,19,069,"Iowa","Franklin County",3,33,94,44,50
050,19,069,"Iowa","Franklin County",3,34,96,50,46
050,19,069,"Iowa","Franklin County",3,35,104,59,45
050,19,069,"Iowa","Franklin County",3,36,117,65,52
050,19,069,"Iowa","Franklin County",3,37,127,67,60
050,19,069,"Iowa","Franklin County",3,38,125,69,56
050,19,069,"Iowa","Franklin County",3,39,129,74,55
050,19,069,"Iowa","Franklin County",3,40,116,68,48
050,19,069,"Iowa","Franklin County",3,41,128,67,61
050,19,069,"Iowa","Franklin County",3,42,123,69,54
050,19,069,"Iowa","Franklin County",3,43,117,62,55
050,19,069,"Iowa","Franklin County",3,44,114,52,62
050,19,069,"Iowa","Franklin County",3,45,107,50,57
050,19,069,"Iowa","Franklin County",3,46,105,52,53
050,19,069,"Iowa","Franklin County",3,47,101,58,43
050,19,069,"Iowa","Franklin County",3,48,99,58,41
050,19,069,"Iowa","Franklin County",3,49,104,55,49
050,19,069,"Iowa","Franklin County",3,50,124,65,59
050,19,069,"Iowa","Franklin County",3,51,110,56,54
050,19,069,"Iowa","Franklin County",3,52,106,53,53
050,19,069,"Iowa","Franklin County",3,53,113,58,55
050,19,069,"Iowa","Franklin County",3,54,115,58,57
050,19,069,"Iowa","Franklin County",3,55,121,56,65
050,19,069,"Iowa","Franklin County",3,56,125,67,58
050,19,069,"Iowa","Franklin County",3,57,126,67,59
050,19,069,"Iowa","Franklin County",3,58,133,68,65
050,19,069,"Iowa","Franklin County",3,59,142,68,74
050,19,069,"Iowa","Franklin County",3,60,146,69,77
050,19,069,"Iowa","Franklin County",3,61,144,69,75
050,19,069,"Iowa","Franklin County",3,62,150,76,74
050,19,069,"Iowa","Franklin County",3,63,159,81,78
050,19,069,"Iowa","Franklin County",3,64,162,79,83
050,19,069,"Iowa","Franklin County",3,65,159,76,83
050,19,069,"Iowa","Franklin County",3,66,161,86,75
050,19,069,"Iowa","Franklin County",3,67,141,72,69
050,19,069,"Iowa","Franklin County",3,68,129,63,66
050,19,069,"Iowa","Franklin County",3,69,130,66,64
050,19,069,"Iowa","Franklin County",3,70,122,66,56
050,19,069,"Iowa","Franklin County",3,71,103,52,51
050,19,069,"Iowa","Franklin County",3,72,100,48,52
050,19,069,"Iowa","Franklin County",3,73,96,44,52
050,19,069,"Iowa","Franklin County",3,74,104,52,52
050,19,069,"Iowa","Franklin County",3,75,76,39,37
050,19,069,"Iowa","Franklin County",3,76,77,38,39
050,19,069,"Iowa","Franklin County",3,77,65,31,34
050,19,069,"Iowa","Franklin County",3,78,68,30,38
050,19,069,"Iowa","Franklin County",3,79,69,36,33
050,19,069,"Iowa","Franklin County",3,80,63,32,31
050,19,069,"Iowa","Franklin County",3,81,57,24,33
050,19,069,"Iowa","Franklin County",3,82,56,21,35
050,19,069,"Iowa","Franklin County",3,83,46,23,23
050,19,069,"Iowa","Franklin County",3,84,50,18,32
050,19,069,"Iowa","Franklin County",3,85,276,104,172
050,19,069,"Iowa","Franklin County",4,0,128,51,77
050,19,069,"Iowa","Franklin County",4,1,156,82,74
050,19,069,"Iowa","Franklin County",4,2,119,61,58
050,19,069,"Iowa","Franklin County",4,3,118,65,53
050,19,069,"Iowa","Franklin County",4,4,119,65,54
050,19,069,"Iowa","Franklin County",4,5,134,68,66
050,19,069,"Iowa","Franklin County",4,6,134,61,73
050,19,069,"Iowa","Franklin County",4,7,125,65,60
050,19,069,"Iowa","Franklin County",4,8,126,60,66
050,19,069,"Iowa","Franklin County",4,9,123,58,65
050,19,069,"Iowa","Franklin County",4,10,127,65,62
050,19,069,"Iowa","Franklin County",4,11,129,71,58
050,19,069,"Iowa","Franklin County",4,12,141,84,57
050,19,069,"Iowa","Franklin County",4,13,137,86,51
050,19,069,"Iowa","Franklin County",4,14,156,91,65
050,19,069,"Iowa","Franklin County",4,15,161,92,69
050,19,069,"Iowa","Franklin County",4,16,141,84,57
050,19,069,"Iowa","Franklin County",4,17,141,86,55
050,19,069,"Iowa","Franklin County",4,18,126,78,48
050,19,069,"Iowa","Franklin County",4,19,83,47,36
050,19,069,"Iowa","Franklin County",4,20,99,52,47
050,19,069,"Iowa","Franklin County",4,21,92,45,47
050,19,069,"Iowa","Franklin County",4,22,99,35,64
050,19,069,"Iowa","Franklin County",4,23,107,50,57
050,19,069,"Iowa","Franklin County",4,24,106,53,53
050,19,069,"Iowa","Franklin County",4,25,82,45,37
050,19,069,"Iowa","Franklin County",4,26,94,51,43
050,19,069,"Iowa","Franklin County",4,27,91,49,42
050,19,069,"Iowa","Franklin County",4,28,107,50,57
050,19,069,"Iowa","Franklin County",4,29,109,53,56
050,19,069,"Iowa","Franklin County",4,30,111,53,58
050,19,069,"Iowa","Franklin County",4,31,109,52,57
050,19,069,"Iowa","Franklin County",4,32,93,51,42
050,19,069,"Iowa","Franklin County",4,33,91,46,45
050,19,069,"Iowa","Franklin County",4,34,95,47,48
050,19,069,"Iowa","Franklin County",4,35,94,49,45
050,19,069,"Iowa","Franklin County",4,36,106,57,49
050,19,069,"Iowa","Franklin County",4,37,110,60,50
050,19,069,"Iowa","Franklin County",4,38,129,67,62
050,19,069,"Iowa","Franklin County",4,39,123,67,56
050,19,069,"Iowa","Franklin County",4,40,122,72,50
050,19,069,"Iowa","Franklin County",4,41,121,73,48
050,19,069,"Iowa","Franklin County",4,42,130,69,61
050,19,069,"Iowa","Franklin County",4,43,118,66,52
050,19,069,"Iowa","Franklin County",4,44,120,63,57
050,19,069,"Iowa","Franklin County",4,45,116,55,61
050,19,069,"Iowa","Franklin County",4,46,124,54,70
050,19,069,"Iowa","Franklin County",4,47,95,47,48
050,19,069,"Iowa","Franklin County",4,48,103,62,41
050,19,069,"Iowa","Franklin County",4,49,97,57,40
050,19,069,"Iowa","Franklin County",4,50,105,53,52
050,19,069,"Iowa","Franklin County",4,51,122,64,58
050,19,069,"Iowa","Franklin County",4,52,109,56,53
050,19,069,"Iowa","Franklin County",4,53,111,54,57
050,19,069,"Iowa","Franklin County",4,54,120,63,57
050,19,069,"Iowa","Franklin County",4,55,123,64,59
050,19,069,"Iowa","Franklin County",4,56,122,61,61
050,19,069,"Iowa","Franklin County",4,57,122,62,60
050,19,069,"Iowa","Franklin County",4,58,130,65,65
050,19,069,"Iowa","Franklin County",4,59,128,69,59
050,19,069,"Iowa","Franklin County",4,60,146,72,74
050,19,069,"Iowa","Franklin County",4,61,137,64,73
050,19,069,"Iowa","Franklin County",4,62,143,67,76
050,19,069,"Iowa","Franklin County",4,63,146,75,71
050,19,069,"Iowa","Franklin County",4,64,157,79,78
050,19,069,"Iowa","Franklin County",4,65,157,78,79
050,19,069,"Iowa","Franklin County",4,66,160,76,84
050,19,069,"Iowa","Franklin County",4,67,155,83,72
050,19,069,"Iowa","Franklin County",4,68,138,70,68
050,19,069,"Iowa","Franklin County",4,69,129,60,69
050,19,069,"Iowa","Franklin County",4,70,132,68,64
050,19,069,"Iowa","Franklin County",4,71,123,69,54
050,19,069,"Iowa","Franklin County",4,72,93,48,45
050,19,069,"Iowa","Franklin County",4,73,95,46,49
050,19,069,"Iowa","Franklin County",4,74,93,43,50
050,19,069,"Iowa","Franklin County",4,75,101,49,52
050,19,069,"Iowa","Franklin County",4,76,70,36,34
050,19,069,"Iowa","Franklin County",4,77,72,36,36
050,19,069,"Iowa","Franklin County",4,78,68,30,38
050,19,069,"Iowa","Franklin County",4,79,68,32,36
050,19,069,"Iowa","Franklin County",4,80,66,33,33
050,19,069,"Iowa","Franklin County",4,81,58,29,29
050,19,069,"Iowa","Franklin County",4,82,51,18,33
050,19,069,"Iowa","Franklin County",4,83,45,21,24
050,19,069,"Iowa","Franklin County",4,84,53,22,31
050,19,069,"Iowa","Franklin County",4,85,281,106,175
050,19,069,"Iowa","Franklin County",5,0,129,53,76
050,19,069,"Iowa","Franklin County",5,1,130,56,74
050,19,069,"Iowa","Franklin County",5,2,134,61,73
050,19,069,"Iowa","Franklin County",5,3,130,71,59
050,19,069,"Iowa","Franklin County",5,4,115,62,53
050,19,069,"Iowa","Franklin County",5,5,117,67,50
050,19,069,"Iowa","Franklin County",5,6,140,73,67
050,19,069,"Iowa","Franklin County",5,7,131,63,68
050,19,069,"Iowa","Franklin County",5,8,129,67,62
050,19,069,"Iowa","Franklin County",5,9,129,64,65
050,19,069,"Iowa","Franklin County",5,10,123,58,65
050,19,069,"Iowa","Franklin County",5,11,134,72,62
050,19,069,"Iowa","Franklin County",5,12,133,77,56
050,19,069,"Iowa","Franklin County",5,13,142,86,56
050,19,069,"Iowa","Franklin County",5,14,146,90,56
050,19,069,"Iowa","Franklin County",5,15,151,91,60
050,19,069,"Iowa","Franklin County",5,16,167,96,71
050,19,069,"Iowa","Franklin County",5,17,147,86,61
050,19,069,"Iowa","Franklin County",5,18,122,74,48
050,19,069,"Iowa","Franklin County",5,19,100,63,37
050,19,069,"Iowa","Franklin County",5,20,76,44,32
050,19,069,"Iowa","Franklin County",5,21,91,47,44
050,19,069,"Iowa","Franklin County",5,22,95,44,51
050,19,069,"Iowa","Franklin County",5,23,91,35,56
050,19,069,"Iowa","Franklin County",5,24,100,50,50
050,19,069,"Iowa","Franklin County",5,25,102,52,50
050,19,069,"Iowa","Franklin County",5,26,85,45,40
050,19,069,"Iowa","Franklin County",5,27,91,47,44
050,19,069,"Iowa","Franklin County",5,28,84,40,44
050,19,069,"Iowa","Franklin County",5,29,103,47,56
050,19,069,"Iowa","Franklin County",5,30,110,54,56
050,19,069,"Iowa","Franklin County",5,31,99,47,52
050,19,069,"Iowa","Franklin County",5,32,108,51,57
050,19,069,"Iowa","Franklin County",5,33,100,56,44
050,19,069,"Iowa","Franklin County",5,34,90,42,48
050,19,069,"Iowa","Franklin County",5,35,97,50,47
050,19,069,"Iowa","Franklin County",5,36,94,47,47
050,19,069,"Iowa","Franklin County",5,37,109,62,47
050,19,069,"Iowa","Franklin County",5,38,118,64,54
050,19,069,"Iowa","Franklin County",5,39,127,69,58
050,19,069,"Iowa","Franklin County",5,40,127,67,60
050,19,069,"Iowa","Franklin County",5,41,119,72,47
050,19,069,"Iowa","Franklin County",5,42,116,69,47
050,19,069,"Iowa","Franklin County",5,43,128,68,60
050,19,069,"Iowa","Franklin County",5,44,122,67,55
050,19,069,"Iowa","Franklin County",5,45,120,59,61
050,19,069,"Iowa","Franklin County",5,46,127,56,71
050,19,069,"Iowa","Franklin County",5,47,125,51,74
050,19,069,"Iowa","Franklin County",5,48,97,48,49
050,19,069,"Iowa","Franklin County",5,49,107,65,42
050,19,069,"Iowa","Franklin County",5,50,100,59,41
050,19,069,"Iowa","Franklin County",5,51,104,54,50
050,19,069,"Iowa","Franklin County",5,52,112,59,53
050,19,069,"Iowa","Franklin County",5,53,109,56,53
050,19,069,"Iowa","Franklin County",5,54,113,58,55
050,19,069,"Iowa","Franklin County",5,55,116,59,57
050,19,069,"Iowa","Franklin County",5,56,118,61,57
050,19,069,"Iowa","Franklin County",5,57,116,58,58
050,19,069,"Iowa","Franklin County",5,58,118,58,60
050,19,069,"Iowa","Franklin County",5,59,125,65,60
050,19,069,"Iowa","Franklin County",5,60,123,64,59
050,19,069,"Iowa","Franklin County",5,61,141,68,73
050,19,069,"Iowa","Franklin County",5,62,137,62,75
050,19,069,"Iowa","Franklin County",5,63,138,65,73
050,19,069,"Iowa","Franklin County",5,64,148,74,74
050,19,069,"Iowa","Franklin County",5,65,153,75,78
050,19,069,"Iowa","Franklin County",5,66,153,75,78
050,19,069,"Iowa","Franklin County",5,67,159,73,86
050,19,069,"Iowa","Franklin County",5,68,150,81,69
050,19,069,"Iowa","Franklin County",5,69,139,71,68
050,19,069,"Iowa","Franklin County",5,70,127,60,67
050,19,069,"Iowa","Franklin County",5,71,131,69,62
050,19,069,"Iowa","Franklin County",5,72,116,64,52
050,19,069,"Iowa","Franklin County",5,73,89,45,44
050,19,069,"Iowa","Franklin County",5,74,92,43,49
050,19,069,"Iowa","Franklin County",5,75,92,42,50
050,19,069,"Iowa","Franklin County",5,76,91,46,45
050,19,069,"Iowa","Franklin County",5,77,65,33,32
050,19,069,"Iowa","Franklin County",5,78,73,36,37
050,19,069,"Iowa","Franklin County",5,79,68,28,40
050,19,069,"Iowa","Franklin County",5,80,63,28,35
050,19,069,"Iowa","Franklin County",5,81,61,30,31
050,19,069,"Iowa","Franklin County",5,82,55,26,29
050,19,069,"Iowa","Franklin County",5,83,42,19,23
050,19,069,"Iowa","Franklin County",5,84,52,20,32
050,19,069,"Iowa","Franklin County",5,85,279,107,172
050,19,071,"Iowa","Fremont County",1,0,63,31,32
050,19,071,"Iowa","Fremont County",1,1,66,30,36
050,19,071,"Iowa","Fremont County",1,2,81,46,35
050,19,071,"Iowa","Fremont County",1,3,80,39,41
050,19,071,"Iowa","Fremont County",1,4,89,49,40
050,19,071,"Iowa","Fremont County",1,5,75,45,30
050,19,071,"Iowa","Fremont County",1,6,74,48,26
050,19,071,"Iowa","Fremont County",1,7,67,37,30
050,19,071,"Iowa","Fremont County",1,8,80,39,41
050,19,071,"Iowa","Fremont County",1,9,83,44,39
050,19,071,"Iowa","Fremont County",1,10,91,44,47
050,19,071,"Iowa","Fremont County",1,11,98,51,47
050,19,071,"Iowa","Fremont County",1,12,87,41,46
050,19,071,"Iowa","Fremont County",1,13,95,48,47
050,19,071,"Iowa","Fremont County",1,14,100,53,47
050,19,071,"Iowa","Fremont County",1,15,88,45,43
050,19,071,"Iowa","Fremont County",1,16,90,48,42
050,19,071,"Iowa","Fremont County",1,17,90,47,43
050,19,071,"Iowa","Fremont County",1,18,67,40,27
050,19,071,"Iowa","Fremont County",1,19,51,30,21
050,19,071,"Iowa","Fremont County",1,20,47,29,18
050,19,071,"Iowa","Fremont County",1,21,65,34,31
050,19,071,"Iowa","Fremont County",1,22,67,37,30
050,19,071,"Iowa","Fremont County",1,23,55,26,29
050,19,071,"Iowa","Fremont County",1,24,66,33,33
050,19,071,"Iowa","Fremont County",1,25,72,41,31
050,19,071,"Iowa","Fremont County",1,26,62,35,27
050,19,071,"Iowa","Fremont County",1,27,67,34,33
050,19,071,"Iowa","Fremont County",1,28,72,35,37
050,19,071,"Iowa","Fremont County",1,29,54,29,25
050,19,071,"Iowa","Fremont County",1,30,52,27,25
050,19,071,"Iowa","Fremont County",1,31,65,36,29
050,19,071,"Iowa","Fremont County",1,32,60,32,28
050,19,071,"Iowa","Fremont County",1,33,62,29,33
050,19,071,"Iowa","Fremont County",1,34,74,41,33
050,19,071,"Iowa","Fremont County",1,35,71,37,34
050,19,071,"Iowa","Fremont County",1,36,67,28,39
050,19,071,"Iowa","Fremont County",1,37,66,36,30
050,19,071,"Iowa","Fremont County",1,38,88,51,37
050,19,071,"Iowa","Fremont County",1,39,75,42,33
050,19,071,"Iowa","Fremont County",1,40,68,40,28
050,19,071,"Iowa","Fremont County",1,41,86,45,41
050,19,071,"Iowa","Fremont County",1,42,77,37,40
050,19,071,"Iowa","Fremont County",1,43,65,31,34
050,19,071,"Iowa","Fremont County",1,44,63,32,31
050,19,071,"Iowa","Fremont County",1,45,67,31,36
050,19,071,"Iowa","Fremont County",1,46,80,34,46
050,19,071,"Iowa","Fremont County",1,47,87,43,44
050,19,071,"Iowa","Fremont County",1,48,88,48,40
050,19,071,"Iowa","Fremont County",1,49,90,50,40
050,19,071,"Iowa","Fremont County",1,50,68,31,37
050,19,071,"Iowa","Fremont County",1,51,67,33,34
050,19,071,"Iowa","Fremont County",1,52,67,37,30
050,19,071,"Iowa","Fremont County",1,53,81,46,35
050,19,071,"Iowa","Fremont County",1,54,82,41,41
050,19,071,"Iowa","Fremont County",1,55,91,38,53
050,19,071,"Iowa","Fremont County",1,56,92,45,47
050,19,071,"Iowa","Fremont County",1,57,108,53,55
050,19,071,"Iowa","Fremont County",1,58,105,48,57
050,19,071,"Iowa","Fremont County",1,59,98,52,46
050,19,071,"Iowa","Fremont County",1,60,102,53,49
050,19,071,"Iowa","Fremont County",1,61,111,58,53
050,19,071,"Iowa","Fremont County",1,62,120,64,56
050,19,071,"Iowa","Fremont County",1,63,124,65,59
050,19,071,"Iowa","Fremont County",1,64,105,54,51
050,19,071,"Iowa","Fremont County",1,65,100,46,54
050,19,071,"Iowa","Fremont County",1,66,97,48,49
050,19,071,"Iowa","Fremont County",1,67,92,53,39
050,19,071,"Iowa","Fremont County",1,68,107,52,55
050,19,071,"Iowa","Fremont County",1,69,88,41,47
050,19,071,"Iowa","Fremont County",1,70,79,38,41
050,19,071,"Iowa","Fremont County",1,71,89,42,47
050,19,071,"Iowa","Fremont County",1,72,84,44,40
050,19,071,"Iowa","Fremont County",1,73,82,43,39
050,19,071,"Iowa","Fremont County",1,74,49,26,23
050,19,071,"Iowa","Fremont County",1,75,52,28,24
050,19,071,"Iowa","Fremont County",1,76,52,21,31
050,19,071,"Iowa","Fremont County",1,77,51,22,29
050,19,071,"Iowa","Fremont County",1,78,45,26,19
050,19,071,"Iowa","Fremont County",1,79,45,24,21
050,19,071,"Iowa","Fremont County",1,80,34,12,22
050,19,071,"Iowa","Fremont County",1,81,37,13,24
050,19,071,"Iowa","Fremont County",1,82,38,15,23
050,19,071,"Iowa","Fremont County",1,83,36,20,16
050,19,071,"Iowa","Fremont County",1,84,26,12,14
050,19,071,"Iowa","Fremont County",1,85,203,76,127
050,19,071,"Iowa","Fremont County",2,0,64,31,33
050,19,071,"Iowa","Fremont County",2,1,64,29,35
050,19,071,"Iowa","Fremont County",2,2,79,43,36
050,19,071,"Iowa","Fremont County",2,3,83,41,42
050,19,071,"Iowa","Fremont County",2,4,87,47,40
050,19,071,"Iowa","Fremont County",2,5,77,45,32
050,19,071,"Iowa","Fremont County",2,6,73,47,26
050,19,071,"Iowa","Fremont County",2,7,69,40,29
050,19,071,"Iowa","Fremont County",2,8,76,38,38
050,19,071,"Iowa","Fremont County",2,9,80,41,39
050,19,071,"Iowa","Fremont County",2,10,90,43,47
050,19,071,"Iowa","Fremont County",2,11,96,50,46
050,19,071,"Iowa","Fremont County",2,12,92,45,47
050,19,071,"Iowa","Fremont County",2,13,93,47,46
050,19,071,"Iowa","Fremont County",2,14,99,52,47
050,19,071,"Iowa","Fremont County",2,15,92,47,45
050,19,071,"Iowa","Fremont County",2,16,89,46,43
050,19,071,"Iowa","Fremont County",2,17,87,45,42
050,19,071,"Iowa","Fremont County",2,18,67,39,28
050,19,071,"Iowa","Fremont County",2,19,50,30,20
050,19,071,"Iowa","Fremont County",2,20,49,29,20
050,19,071,"Iowa","Fremont County",2,21,61,33,28
050,19,071,"Iowa","Fremont County",2,22,66,35,31
050,19,071,"Iowa","Fremont County",2,23,59,29,30
050,19,071,"Iowa","Fremont County",2,24,62,30,32
050,19,071,"Iowa","Fremont County",2,25,69,38,31
050,19,071,"Iowa","Fremont County",2,26,66,38,28
050,19,071,"Iowa","Fremont County",2,27,64,33,31
050,19,071,"Iowa","Fremont County",2,28,70,35,35
050,19,071,"Iowa","Fremont County",2,29,56,30,26
050,19,071,"Iowa","Fremont County",2,30,54,29,25
050,19,071,"Iowa","Fremont County",2,31,61,33,28
050,19,071,"Iowa","Fremont County",2,32,63,34,29
050,19,071,"Iowa","Fremont County",2,33,63,31,32
050,19,071,"Iowa","Fremont County",2,34,71,39,32
050,19,071,"Iowa","Fremont County",2,35,73,38,35
050,19,071,"Iowa","Fremont County",2,36,65,29,36
050,19,071,"Iowa","Fremont County",2,37,65,34,31
050,19,071,"Iowa","Fremont County",2,38,83,48,35
050,19,071,"Iowa","Fremont County",2,39,76,44,32
050,19,071,"Iowa","Fremont County",2,40,69,40,29
050,19,071,"Iowa","Fremont County",2,41,81,43,38
050,19,071,"Iowa","Fremont County",2,42,79,38,41
050,19,071,"Iowa","Fremont County",2,43,69,33,36
050,19,071,"Iowa","Fremont County",2,44,64,32,32
050,19,071,"Iowa","Fremont County",2,45,67,31,36
050,19,071,"Iowa","Fremont County",2,46,75,33,42
050,19,071,"Iowa","Fremont County",2,47,85,41,44
050,19,071,"Iowa","Fremont County",2,48,88,47,41
050,19,071,"Iowa","Fremont County",2,49,88,49,39
050,19,071,"Iowa","Fremont County",2,50,74,36,38
050,19,071,"Iowa","Fremont County",2,51,67,33,34
050,19,071,"Iowa","Fremont County",2,52,66,36,30
050,19,071,"Iowa","Fremont County",2,53,77,44,33
050,19,071,"Iowa","Fremont County",2,54,81,42,39
050,19,071,"Iowa","Fremont County",2,55,88,38,50
050,19,071,"Iowa","Fremont County",2,56,92,44,48
050,19,071,"Iowa","Fremont County",2,57,104,51,53
050,19,071,"Iowa","Fremont County",2,58,104,49,55
050,19,071,"Iowa","Fremont County",2,59,99,51,48
050,19,071,"Iowa","Fremont County",2,60,101,53,48
050,19,071,"Iowa","Fremont County",2,61,108,56,52
050,19,071,"Iowa","Fremont County",2,62,116,61,55
050,19,071,"Iowa","Fremont County",2,63,125,67,58
050,19,071,"Iowa","Fremont County",2,64,109,57,52
050,19,071,"Iowa","Fremont County",2,65,99,46,53
050,19,071,"Iowa","Fremont County",2,66,97,47,50
050,19,071,"Iowa","Fremont County",2,67,94,52,42
050,19,071,"Iowa","Fremont County",2,68,101,50,51
050,19,071,"Iowa","Fremont County",2,69,93,44,49
050,19,071,"Iowa","Fremont County",2,70,79,38,41
050,19,071,"Iowa","Fremont County",2,71,86,41,45
050,19,071,"Iowa","Fremont County",2,72,83,42,41
050,19,071,"Iowa","Fremont County",2,73,87,46,41
050,19,071,"Iowa","Fremont County",2,74,53,28,25
050,19,071,"Iowa","Fremont County",2,75,50,28,22
050,19,071,"Iowa","Fremont County",2,76,50,21,29
050,19,071,"Iowa","Fremont County",2,77,52,22,30
050,19,071,"Iowa","Fremont County",2,78,46,25,21
050,19,071,"Iowa","Fremont County",2,79,44,24,20
050,19,071,"Iowa","Fremont County",2,80,37,15,22
050,19,071,"Iowa","Fremont County",2,81,34,13,21
050,19,071,"Iowa","Fremont County",2,82,37,14,23
050,19,071,"Iowa","Fremont County",2,83,36,19,17
050,19,071,"Iowa","Fremont County",2,84,29,14,15
050,19,071,"Iowa","Fremont County",2,85,200,74,126
050,19,071,"Iowa","Fremont County",3,0,58,28,30
050,19,071,"Iowa","Fremont County",3,1,73,42,31
050,19,071,"Iowa","Fremont County",3,2,62,31,31
050,19,071,"Iowa","Fremont County",3,3,76,42,34
050,19,071,"Iowa","Fremont County",3,4,75,38,37
050,19,071,"Iowa","Fremont County",3,5,87,47,40
050,19,071,"Iowa","Fremont County",3,6,79,47,32
050,19,071,"Iowa","Fremont County",3,7,75,46,29
050,19,071,"Iowa","Fremont County",3,8,65,36,29
050,19,071,"Iowa","Fremont County",3,9,80,43,37
050,19,071,"Iowa","Fremont County",3,10,83,38,45
050,19,071,"Iowa","Fremont County",3,11,98,49,49
050,19,071,"Iowa","Fremont County",3,12,91,48,43
050,19,071,"Iowa","Fremont County",3,13,92,45,47
050,19,071,"Iowa","Fremont County",3,14,85,41,44
050,19,071,"Iowa","Fremont County",3,15,99,54,45
050,19,071,"Iowa","Fremont County",3,16,94,49,45
050,19,071,"Iowa","Fremont County",3,17,85,45,40
050,19,071,"Iowa","Fremont County",3,18,74,38,36
050,19,071,"Iowa","Fremont County",3,19,49,29,20
050,19,071,"Iowa","Fremont County",3,20,59,35,24
050,19,071,"Iowa","Fremont County",3,21,54,33,21
050,19,071,"Iowa","Fremont County",3,22,63,32,31
050,19,071,"Iowa","Fremont County",3,23,74,40,34
050,19,071,"Iowa","Fremont County",3,24,63,29,34
050,19,071,"Iowa","Fremont County",3,25,70,32,38
050,19,071,"Iowa","Fremont County",3,26,73,43,30
050,19,071,"Iowa","Fremont County",3,27,74,41,33
050,19,071,"Iowa","Fremont County",3,28,73,35,38
050,19,071,"Iowa","Fremont County",3,29,74,36,38
050,19,071,"Iowa","Fremont County",3,30,60,34,26
050,19,071,"Iowa","Fremont County",3,31,65,34,31
050,19,071,"Iowa","Fremont County",3,32,60,33,27
050,19,071,"Iowa","Fremont County",3,33,58,29,29
050,19,071,"Iowa","Fremont County",3,34,64,33,31
050,19,071,"Iowa","Fremont County",3,35,67,33,34
050,19,071,"Iowa","Fremont County",3,36,75,40,35
050,19,071,"Iowa","Fremont County",3,37,67,27,40
050,19,071,"Iowa","Fremont County",3,38,68,36,32
050,19,071,"Iowa","Fremont County",3,39,79,48,31
050,19,071,"Iowa","Fremont County",3,40,80,43,37
050,19,071,"Iowa","Fremont County",3,41,69,39,30
050,19,071,"Iowa","Fremont County",3,42,79,42,37
050,19,071,"Iowa","Fremont County",3,43,78,38,40
050,19,071,"Iowa","Fremont County",3,44,70,35,35
050,19,071,"Iowa","Fremont County",3,45,66,33,33
050,19,071,"Iowa","Fremont County",3,46,67,30,37
050,19,071,"Iowa","Fremont County",3,47,76,33,43
050,19,071,"Iowa","Fremont County",3,48,88,44,44
050,19,071,"Iowa","Fremont County",3,49,85,46,39
050,19,071,"Iowa","Fremont County",3,50,91,51,40
050,19,071,"Iowa","Fremont County",3,51,73,35,38
050,19,071,"Iowa","Fremont County",3,52,70,32,38
050,19,071,"Iowa","Fremont County",3,53,71,40,31
050,19,071,"Iowa","Fremont County",3,54,72,42,30
050,19,071,"Iowa","Fremont County",3,55,82,41,41
050,19,071,"Iowa","Fremont County",3,56,85,38,47
050,19,071,"Iowa","Fremont County",3,57,93,44,49
050,19,071,"Iowa","Fremont County",3,58,105,52,53
050,19,071,"Iowa","Fremont County",3,59,102,49,53
050,19,071,"Iowa","Fremont County",3,60,97,53,44
050,19,071,"Iowa","Fremont County",3,61,98,51,47
050,19,071,"Iowa","Fremont County",3,62,104,53,51
050,19,071,"Iowa","Fremont County",3,63,112,61,51
050,19,071,"Iowa","Fremont County",3,64,119,65,54
050,19,071,"Iowa","Fremont County",3,65,109,56,53
050,19,071,"Iowa","Fremont County",3,66,98,47,51
050,19,071,"Iowa","Fremont County",3,67,99,49,50
050,19,071,"Iowa","Fremont County",3,68,97,53,44
050,19,071,"Iowa","Fremont County",3,69,102,51,51
050,19,071,"Iowa","Fremont County",3,70,91,44,47
050,19,071,"Iowa","Fremont County",3,71,75,38,37
050,19,071,"Iowa","Fremont County",3,72,84,40,44
050,19,071,"Iowa","Fremont County",3,73,81,41,40
050,19,071,"Iowa","Fremont County",3,74,85,45,40
050,19,071,"Iowa","Fremont County",3,75,50,27,23
050,19,071,"Iowa","Fremont County",3,76,44,21,23
050,19,071,"Iowa","Fremont County",3,77,47,20,27
050,19,071,"Iowa","Fremont County",3,78,49,21,28
050,19,071,"Iowa","Fremont County",3,79,46,24,22
050,19,071,"Iowa","Fremont County",3,80,41,21,20
050,19,071,"Iowa","Fremont County",3,81,34,14,20
050,19,071,"Iowa","Fremont County",3,82,32,12,20
050,19,071,"Iowa","Fremont County",3,83,34,12,22
050,19,071,"Iowa","Fremont County",3,84,33,18,15
050,19,071,"Iowa","Fremont County",3,85,200,72,128
050,19,071,"Iowa","Fremont County",4,0,65,38,27
050,19,071,"Iowa","Fremont County",4,1,50,26,24
050,19,071,"Iowa","Fremont County",4,2,70,38,32
050,19,071,"Iowa","Fremont County",4,3,59,27,32
050,19,071,"Iowa","Fremont County",4,4,76,43,33
050,19,071,"Iowa","Fremont County",4,5,78,41,37
050,19,071,"Iowa","Fremont County",4,6,88,45,43
050,19,071,"Iowa","Fremont County",4,7,82,48,34
050,19,071,"Iowa","Fremont County",4,8,72,43,29
050,19,071,"Iowa","Fremont County",4,9,66,37,29
050,19,071,"Iowa","Fremont County",4,10,83,44,39
050,19,071,"Iowa","Fremont County",4,11,84,37,47
050,19,071,"Iowa","Fremont County",4,12,99,48,51
050,19,071,"Iowa","Fremont County",4,13,97,52,45
050,19,071,"Iowa","Fremont County",4,14,90,48,42
050,19,071,"Iowa","Fremont County",4,15,84,39,45
050,19,071,"Iowa","Fremont County",4,16,99,52,47
050,19,071,"Iowa","Fremont County",4,17,93,46,47
050,19,071,"Iowa","Fremont County",4,18,62,33,29
050,19,071,"Iowa","Fremont County",4,19,49,27,22
050,19,071,"Iowa","Fremont County",4,20,52,30,22
050,19,071,"Iowa","Fremont County",4,21,65,38,27
050,19,071,"Iowa","Fremont County",4,22,56,32,24
050,19,071,"Iowa","Fremont County",4,23,65,31,34
050,19,071,"Iowa","Fremont County",4,24,62,35,27
050,19,071,"Iowa","Fremont County",4,25,57,25,32
050,19,071,"Iowa","Fremont County",4,26,57,28,29
050,19,071,"Iowa","Fremont County",4,27,73,41,32
050,19,071,"Iowa","Fremont County",4,28,70,43,27
050,19,071,"Iowa","Fremont County",4,29,71,31,40
050,19,071,"Iowa","Fremont County",4,30,68,34,34
050,19,071,"Iowa","Fremont County",4,31,61,40,21
050,19,071,"Iowa","Fremont County",4,32,66,33,33
050,19,071,"Iowa","Fremont County",4,33,63,31,32
050,19,071,"Iowa","Fremont County",4,34,63,29,34
050,19,071,"Iowa","Fremont County",4,35,65,31,34
050,19,071,"Iowa","Fremont County",4,36,66,32,34
050,19,071,"Iowa","Fremont County",4,37,78,46,32
050,19,071,"Iowa","Fremont County",4,38,66,26,40
050,19,071,"Iowa","Fremont County",4,39,68,36,32
050,19,071,"Iowa","Fremont County",4,40,77,46,31
050,19,071,"Iowa","Fremont County",4,41,71,38,33
050,19,071,"Iowa","Fremont County",4,42,70,39,31
050,19,071,"Iowa","Fremont County",4,43,79,42,37
050,19,071,"Iowa","Fremont County",4,44,80,39,41
050,19,071,"Iowa","Fremont County",4,45,70,35,35
050,19,071,"Iowa","Fremont County",4,46,65,32,33
050,19,071,"Iowa","Fremont County",4,47,63,29,34
050,19,071,"Iowa","Fremont County",4,48,78,34,44
050,19,071,"Iowa","Fremont County",4,49,82,38,44
050,19,071,"Iowa","Fremont County",4,50,86,46,40
050,19,071,"Iowa","Fremont County",4,51,85,47,38
050,19,071,"Iowa","Fremont County",4,52,70,33,37
050,19,071,"Iowa","Fremont County",4,53,72,34,38
050,19,071,"Iowa","Fremont County",4,54,70,39,31
050,19,071,"Iowa","Fremont County",4,55,70,39,31
050,19,071,"Iowa","Fremont County",4,56,85,42,43
050,19,071,"Iowa","Fremont County",4,57,81,35,46
050,19,071,"Iowa","Fremont County",4,58,91,44,47
050,19,071,"Iowa","Fremont County",4,59,102,48,54
050,19,071,"Iowa","Fremont County",4,60,102,49,53
050,19,071,"Iowa","Fremont County",4,61,97,52,45
050,19,071,"Iowa","Fremont County",4,62,93,48,45
050,19,071,"Iowa","Fremont County",4,63,106,54,52
050,19,071,"Iowa","Fremont County",4,64,112,61,51
050,19,071,"Iowa","Fremont County",4,65,117,64,53
050,19,071,"Iowa","Fremont County",4,66,106,55,51
050,19,071,"Iowa","Fremont County",4,67,102,49,53
050,19,071,"Iowa","Fremont County",4,68,97,47,50
050,19,071,"Iowa","Fremont County",4,69,96,52,44
050,19,071,"Iowa","Fremont County",4,70,97,46,51
050,19,071,"Iowa","Fremont County",4,71,88,44,44
050,19,071,"Iowa","Fremont County",4,72,75,36,39
050,19,071,"Iowa","Fremont County",4,73,80,37,43
050,19,071,"Iowa","Fremont County",4,74,79,40,39
050,19,071,"Iowa","Fremont County",4,75,84,44,40
050,19,071,"Iowa","Fremont County",4,76,46,22,24
050,19,071,"Iowa","Fremont County",4,77,43,22,21
050,19,071,"Iowa","Fremont County",4,78,41,20,21
050,19,071,"Iowa","Fremont County",4,79,48,20,28
050,19,071,"Iowa","Fremont County",4,80,41,21,20
050,19,071,"Iowa","Fremont County",4,81,38,21,17
050,19,071,"Iowa","Fremont County",4,82,34,14,20
050,19,071,"Iowa","Fremont County",4,83,30,12,18
050,19,071,"Iowa","Fremont County",4,84,32,12,20
050,19,071,"Iowa","Fremont County",4,85,206,76,130
050,19,071,"Iowa","Fremont County",5,0,66,39,27
050,19,071,"Iowa","Fremont County",5,1,56,33,23
050,19,071,"Iowa","Fremont County",5,2,49,26,23
050,19,071,"Iowa","Fremont County",5,3,68,38,30
050,19,071,"Iowa","Fremont County",5,4,58,25,33
050,19,071,"Iowa","Fremont County",5,5,77,43,34
050,19,071,"Iowa","Fremont County",5,6,77,40,37
050,19,071,"Iowa","Fremont County",5,7,83,46,37
050,19,071,"Iowa","Fremont County",5,8,82,48,34
050,19,071,"Iowa","Fremont County",5,9,73,47,26
050,19,071,"Iowa","Fremont County",5,10,70,38,32
050,19,071,"Iowa","Fremont County",5,11,81,39,42
050,19,071,"Iowa","Fremont County",5,12,84,36,48
050,19,071,"Iowa","Fremont County",5,13,99,47,52
050,19,071,"Iowa","Fremont County",5,14,93,50,43
050,19,071,"Iowa","Fremont County",5,15,91,50,41
050,19,071,"Iowa","Fremont County",5,16,84,39,45
050,19,071,"Iowa","Fremont County",5,17,108,59,49
050,19,071,"Iowa","Fremont County",5,18,71,39,32
050,19,071,"Iowa","Fremont County",5,19,49,26,23
050,19,071,"Iowa","Fremont County",5,20,50,25,25
050,19,071,"Iowa","Fremont County",5,21,57,33,24
050,19,071,"Iowa","Fremont County",5,22,69,35,34
050,19,071,"Iowa","Fremont County",5,23,58,33,25
050,19,071,"Iowa","Fremont County",5,24,66,32,34
050,19,071,"Iowa","Fremont County",5,25,61,33,28
050,19,071,"Iowa","Fremont County",5,26,64,30,34
050,19,071,"Iowa","Fremont County",5,27,64,33,31
050,19,071,"Iowa","Fremont County",5,28,73,42,31
050,19,071,"Iowa","Fremont County",5,29,68,39,29
050,19,071,"Iowa","Fremont County",5,30,71,34,37
050,19,071,"Iowa","Fremont County",5,31,59,29,30
050,19,071,"Iowa","Fremont County",5,32,60,38,22
050,19,071,"Iowa","Fremont County",5,33,63,31,32
050,19,071,"Iowa","Fremont County",5,34,60,28,32
050,19,071,"Iowa","Fremont County",5,35,63,31,32
050,19,071,"Iowa","Fremont County",5,36,63,28,35
050,19,071,"Iowa","Fremont County",5,37,66,33,33
050,19,071,"Iowa","Fremont County",5,38,82,45,37
050,19,071,"Iowa","Fremont County",5,39,70,26,44
050,19,071,"Iowa","Fremont County",5,40,69,36,33
050,19,071,"Iowa","Fremont County",5,41,81,49,32
050,19,071,"Iowa","Fremont County",5,42,79,42,37
050,19,071,"Iowa","Fremont County",5,43,64,34,30
050,19,071,"Iowa","Fremont County",5,44,83,45,38
050,19,071,"Iowa","Fremont County",5,45,75,37,38
050,19,071,"Iowa","Fremont County",5,46,72,36,36
050,19,071,"Iowa","Fremont County",5,47,67,31,36
050,19,071,"Iowa","Fremont County",5,48,67,29,38
050,19,071,"Iowa","Fremont County",5,49,78,33,45
050,19,071,"Iowa","Fremont County",5,50,83,39,44
050,19,071,"Iowa","Fremont County",5,51,90,47,43
050,19,071,"Iowa","Fremont County",5,52,87,46,41
050,19,071,"Iowa","Fremont County",5,53,71,34,37
050,19,071,"Iowa","Fremont County",5,54,75,37,38
050,19,071,"Iowa","Fremont County",5,55,73,39,34
050,19,071,"Iowa","Fremont County",5,56,64,35,29
050,19,071,"Iowa","Fremont County",5,57,86,42,44
050,19,071,"Iowa","Fremont County",5,58,79,34,45
050,19,071,"Iowa","Fremont County",5,59,89,42,47
050,19,071,"Iowa","Fremont County",5,60,102,48,54
050,19,071,"Iowa","Fremont County",5,61,104,48,56
050,19,071,"Iowa","Fremont County",5,62,94,51,43
050,19,071,"Iowa","Fremont County",5,63,98,52,46
050,19,071,"Iowa","Fremont County",5,64,99,51,48
050,19,071,"Iowa","Fremont County",5,65,111,61,50
050,19,071,"Iowa","Fremont County",5,66,116,62,54
050,19,071,"Iowa","Fremont County",5,67,106,54,52
050,19,071,"Iowa","Fremont County",5,68,102,46,56
050,19,071,"Iowa","Fremont County",5,69,96,48,48
050,19,071,"Iowa","Fremont County",5,70,93,48,45
050,19,071,"Iowa","Fremont County",5,71,90,42,48
050,19,071,"Iowa","Fremont County",5,72,85,42,43
050,19,071,"Iowa","Fremont County",5,73,73,34,39
050,19,071,"Iowa","Fremont County",5,74,75,36,39
050,19,071,"Iowa","Fremont County",5,75,79,40,39
050,19,071,"Iowa","Fremont County",5,76,79,37,42
050,19,071,"Iowa","Fremont County",5,77,45,24,21
050,19,071,"Iowa","Fremont County",5,78,38,22,16
050,19,071,"Iowa","Fremont County",5,79,40,20,20
050,19,071,"Iowa","Fremont County",5,80,45,18,27
050,19,071,"Iowa","Fremont County",5,81,40,20,20
050,19,071,"Iowa","Fremont County",5,82,36,20,16
050,19,071,"Iowa","Fremont County",5,83,34,14,20
050,19,071,"Iowa","Fremont County",5,84,29,12,17
050,19,071,"Iowa","Fremont County",5,85,211,80,131
050,19,073,"Iowa","Greene County",1,0,89,46,43
050,19,073,"Iowa","Greene County",1,1,92,43,49
050,19,073,"Iowa","Greene County",1,2,105,47,58
050,19,073,"Iowa","Greene County",1,3,115,60,55
050,19,073,"Iowa","Greene County",1,4,119,65,54
050,19,073,"Iowa","Greene County",1,5,100,59,41
050,19,073,"Iowa","Greene County",1,6,107,50,57
050,19,073,"Iowa","Greene County",1,7,110,52,58
050,19,073,"Iowa","Greene County",1,8,100,49,51
050,19,073,"Iowa","Greene County",1,9,103,52,51
050,19,073,"Iowa","Greene County",1,10,118,59,59
050,19,073,"Iowa","Greene County",1,11,127,71,56
050,19,073,"Iowa","Greene County",1,12,117,59,58
050,19,073,"Iowa","Greene County",1,13,131,70,61
050,19,073,"Iowa","Greene County",1,14,112,65,47
050,19,073,"Iowa","Greene County",1,15,110,54,56
050,19,073,"Iowa","Greene County",1,16,122,66,56
050,19,073,"Iowa","Greene County",1,17,122,58,64
050,19,073,"Iowa","Greene County",1,18,102,57,45
050,19,073,"Iowa","Greene County",1,19,82,44,38
050,19,073,"Iowa","Greene County",1,20,88,46,42
050,19,073,"Iowa","Greene County",1,21,94,50,44
050,19,073,"Iowa","Greene County",1,22,88,38,50
050,19,073,"Iowa","Greene County",1,23,95,53,42
050,19,073,"Iowa","Greene County",1,24,79,39,40
050,19,073,"Iowa","Greene County",1,25,79,39,40
050,19,073,"Iowa","Greene County",1,26,87,45,42
050,19,073,"Iowa","Greene County",1,27,87,44,43
050,19,073,"Iowa","Greene County",1,28,102,49,53
050,19,073,"Iowa","Greene County",1,29,83,42,41
050,19,073,"Iowa","Greene County",1,30,81,39,42
050,19,073,"Iowa","Greene County",1,31,84,45,39
050,19,073,"Iowa","Greene County",1,32,87,41,46
050,19,073,"Iowa","Greene County",1,33,88,54,34
050,19,073,"Iowa","Greene County",1,34,97,49,48
050,19,073,"Iowa","Greene County",1,35,95,45,50
050,19,073,"Iowa","Greene County",1,36,106,56,50
050,19,073,"Iowa","Greene County",1,37,100,50,50
050,19,073,"Iowa","Greene County",1,38,103,52,51
050,19,073,"Iowa","Greene County",1,39,98,52,46
050,19,073,"Iowa","Greene County",1,40,93,49,44
050,19,073,"Iowa","Greene County",1,41,89,44,45
050,19,073,"Iowa","Greene County",1,42,92,49,43
050,19,073,"Iowa","Greene County",1,43,93,54,39
050,19,073,"Iowa","Greene County",1,44,88,45,43
050,19,073,"Iowa","Greene County",1,45,93,45,48
050,19,073,"Iowa","Greene County",1,46,85,48,37
050,19,073,"Iowa","Greene County",1,47,83,43,40
050,19,073,"Iowa","Greene County",1,48,98,51,47
050,19,073,"Iowa","Greene County",1,49,107,60,47
050,19,073,"Iowa","Greene County",1,50,115,65,50
050,19,073,"Iowa","Greene County",1,51,101,50,51
050,19,073,"Iowa","Greene County",1,52,94,48,46
050,19,073,"Iowa","Greene County",1,53,104,54,50
050,19,073,"Iowa","Greene County",1,54,98,53,45
050,19,073,"Iowa","Greene County",1,55,110,60,50
050,19,073,"Iowa","Greene County",1,56,143,73,70
050,19,073,"Iowa","Greene County",1,57,139,65,74
050,19,073,"Iowa","Greene County",1,58,130,60,70
050,19,073,"Iowa","Greene County",1,59,127,64,63
050,19,073,"Iowa","Greene County",1,60,140,71,69
050,19,073,"Iowa","Greene County",1,61,135,64,71
050,19,073,"Iowa","Greene County",1,62,133,60,73
050,19,073,"Iowa","Greene County",1,63,139,64,75
050,19,073,"Iowa","Greene County",1,64,150,78,72
050,19,073,"Iowa","Greene County",1,65,134,67,67
050,19,073,"Iowa","Greene County",1,66,124,62,62
050,19,073,"Iowa","Greene County",1,67,110,59,51
050,19,073,"Iowa","Greene County",1,68,130,69,61
050,19,073,"Iowa","Greene County",1,69,116,58,58
050,19,073,"Iowa","Greene County",1,70,100,50,50
050,19,073,"Iowa","Greene County",1,71,98,50,48
050,19,073,"Iowa","Greene County",1,72,93,47,46
050,19,073,"Iowa","Greene County",1,73,104,47,57
050,19,073,"Iowa","Greene County",1,74,72,31,41
050,19,073,"Iowa","Greene County",1,75,72,31,41
050,19,073,"Iowa","Greene County",1,76,71,36,35
050,19,073,"Iowa","Greene County",1,77,75,37,38
050,19,073,"Iowa","Greene County",1,78,64,34,30
050,19,073,"Iowa","Greene County",1,79,63,29,34
050,19,073,"Iowa","Greene County",1,80,58,26,32
050,19,073,"Iowa","Greene County",1,81,66,29,37
050,19,073,"Iowa","Greene County",1,82,55,20,35
050,19,073,"Iowa","Greene County",1,83,48,23,25
050,19,073,"Iowa","Greene County",1,84,48,20,28
050,19,073,"Iowa","Greene County",1,85,280,79,201
050,19,073,"Iowa","Greene County",2,0,91,51,40
050,19,073,"Iowa","Greene County",2,1,91,42,49
050,19,073,"Iowa","Greene County",2,2,100,46,54
050,19,073,"Iowa","Greene County",2,3,112,56,56
050,19,073,"Iowa","Greene County",2,4,119,64,55
050,19,073,"Iowa","Greene County",2,5,106,61,45
050,19,073,"Iowa","Greene County",2,6,105,51,54
050,19,073,"Iowa","Greene County",2,7,108,51,57
050,19,073,"Iowa","Greene County",2,8,101,50,51
050,19,073,"Iowa","Greene County",2,9,100,50,50
050,19,073,"Iowa","Greene County",2,10,113,57,56
050,19,073,"Iowa","Greene County",2,11,124,68,56
050,19,073,"Iowa","Greene County",2,12,120,62,58
050,19,073,"Iowa","Greene County",2,13,128,68,60
050,19,073,"Iowa","Greene County",2,14,117,66,51
050,19,073,"Iowa","Greene County",2,15,112,56,56
050,19,073,"Iowa","Greene County",2,16,118,63,55
050,19,073,"Iowa","Greene County",2,17,121,58,63
050,19,073,"Iowa","Greene County",2,18,100,54,46
050,19,073,"Iowa","Greene County",2,19,83,46,37
050,19,073,"Iowa","Greene County",2,20,87,46,41
050,19,073,"Iowa","Greene County",2,21,92,48,44
050,19,073,"Iowa","Greene County",2,22,93,43,50
050,19,073,"Iowa","Greene County",2,23,94,50,44
050,19,073,"Iowa","Greene County",2,24,81,42,39
050,19,073,"Iowa","Greene County",2,25,78,39,39
050,19,073,"Iowa","Greene County",2,26,86,44,42
050,19,073,"Iowa","Greene County",2,27,88,45,43
050,19,073,"Iowa","Greene County",2,28,99,49,50
050,19,073,"Iowa","Greene County",2,29,86,43,43
050,19,073,"Iowa","Greene County",2,30,81,39,42
050,19,073,"Iowa","Greene County",2,31,83,44,39
050,19,073,"Iowa","Greene County",2,32,85,41,44
050,19,073,"Iowa","Greene County",2,33,86,50,36
050,19,073,"Iowa","Greene County",2,34,96,52,44
050,19,073,"Iowa","Greene County",2,35,96,47,49
050,19,073,"Iowa","Greene County",2,36,103,53,50
050,19,073,"Iowa","Greene County",2,37,100,50,50
050,19,073,"Iowa","Greene County",2,38,103,52,51
050,19,073,"Iowa","Greene County",2,39,99,52,47
050,19,073,"Iowa","Greene County",2,40,95,50,45
050,19,073,"Iowa","Greene County",2,41,91,46,45
050,19,073,"Iowa","Greene County",2,42,91,48,43
050,19,073,"Iowa","Greene County",2,43,92,53,39
050,19,073,"Iowa","Greene County",2,44,88,46,42
050,19,073,"Iowa","Greene County",2,45,92,44,48
050,19,073,"Iowa","Greene County",2,46,86,47,39
050,19,073,"Iowa","Greene County",2,47,81,43,38
050,19,073,"Iowa","Greene County",2,48,94,49,45
050,19,073,"Iowa","Greene County",2,49,106,58,48
050,19,073,"Iowa","Greene County",2,50,113,63,50
050,19,073,"Iowa","Greene County",2,51,103,52,51
050,19,073,"Iowa","Greene County",2,52,96,49,47
050,19,073,"Iowa","Greene County",2,53,101,53,48
050,19,073,"Iowa","Greene County",2,54,99,54,45
050,19,073,"Iowa","Greene County",2,55,109,59,50
050,19,073,"Iowa","Greene County",2,56,137,71,66
050,19,073,"Iowa","Greene County",2,57,141,67,74
050,19,073,"Iowa","Greene County",2,58,132,61,71
050,19,073,"Iowa","Greene County",2,59,130,64,66
050,19,073,"Iowa","Greene County",2,60,135,68,67
050,19,073,"Iowa","Greene County",2,61,136,66,70
050,19,073,"Iowa","Greene County",2,62,132,60,72
050,19,073,"Iowa","Greene County",2,63,139,64,75
050,19,073,"Iowa","Greene County",2,64,144,72,72
050,19,073,"Iowa","Greene County",2,65,138,69,69
050,19,073,"Iowa","Greene County",2,66,126,64,62
050,19,073,"Iowa","Greene County",2,67,113,59,54
050,19,073,"Iowa","Greene County",2,68,124,66,58
050,19,073,"Iowa","Greene County",2,69,121,62,59
050,19,073,"Iowa","Greene County",2,70,104,52,52
050,19,073,"Iowa","Greene County",2,71,100,51,49
050,19,073,"Iowa","Greene County",2,72,93,47,46
050,19,073,"Iowa","Greene County",2,73,107,50,57
050,19,073,"Iowa","Greene County",2,74,75,33,42
050,19,073,"Iowa","Greene County",2,75,72,31,41
050,19,073,"Iowa","Greene County",2,76,71,35,36
050,19,073,"Iowa","Greene County",2,77,77,38,39
050,19,073,"Iowa","Greene County",2,78,64,34,30
050,19,073,"Iowa","Greene County",2,79,62,30,32
050,19,073,"Iowa","Greene County",2,80,59,27,32
050,19,073,"Iowa","Greene County",2,81,65,29,36
050,19,073,"Iowa","Greene County",2,82,58,22,36
050,19,073,"Iowa","Greene County",2,83,48,21,27
050,19,073,"Iowa","Greene County",2,84,48,21,27
050,19,073,"Iowa","Greene County",2,85,279,79,200
050,19,073,"Iowa","Greene County",3,0,83,46,37
050,19,073,"Iowa","Greene County",3,1,88,48,40
050,19,073,"Iowa","Greene County",3,2,91,44,47
050,19,073,"Iowa","Greene County",3,3,99,46,53
050,19,073,"Iowa","Greene County",3,4,117,58,59
050,19,073,"Iowa","Greene County",3,5,120,66,54
050,19,073,"Iowa","Greene County",3,6,104,57,47
050,19,073,"Iowa","Greene County",3,7,104,50,54
050,19,073,"Iowa","Greene County",3,8,107,48,59
050,19,073,"Iowa","Greene County",3,9,105,54,51
050,19,073,"Iowa","Greene County",3,10,102,50,52
050,19,073,"Iowa","Greene County",3,11,121,62,59
050,19,073,"Iowa","Greene County",3,12,121,70,51
050,19,073,"Iowa","Greene County",3,13,119,60,59
050,19,073,"Iowa","Greene County",3,14,129,67,62
050,19,073,"Iowa","Greene County",3,15,117,61,56
050,19,073,"Iowa","Greene County",3,16,106,53,53
050,19,073,"Iowa","Greene County",3,17,118,65,53
050,19,073,"Iowa","Greene County",3,18,100,49,51
050,19,073,"Iowa","Greene County",3,19,75,42,33
050,19,073,"Iowa","Greene County",3,20,85,48,37
050,19,073,"Iowa","Greene County",3,21,93,48,45
050,19,073,"Iowa","Greene County",3,22,99,52,47
050,19,073,"Iowa","Greene County",3,23,90,46,44
050,19,073,"Iowa","Greene County",3,24,97,54,43
050,19,073,"Iowa","Greene County",3,25,76,40,36
050,19,073,"Iowa","Greene County",3,26,76,38,38
050,19,073,"Iowa","Greene County",3,27,92,49,43
050,19,073,"Iowa","Greene County",3,28,94,48,46
050,19,073,"Iowa","Greene County",3,29,97,43,54
050,19,073,"Iowa","Greene County",3,30,90,44,46
050,19,073,"Iowa","Greene County",3,31,87,41,46
050,19,073,"Iowa","Greene County",3,32,86,42,44
050,19,073,"Iowa","Greene County",3,33,86,43,43
050,19,073,"Iowa","Greene County",3,34,89,52,37
050,19,073,"Iowa","Greene County",3,35,99,53,46
050,19,073,"Iowa","Greene County",3,36,97,47,50
050,19,073,"Iowa","Greene County",3,37,106,56,50
050,19,073,"Iowa","Greene County",3,38,97,49,48
050,19,073,"Iowa","Greene County",3,39,110,56,54
050,19,073,"Iowa","Greene County",3,40,93,50,43
050,19,073,"Iowa","Greene County",3,41,104,54,50
050,19,073,"Iowa","Greene County",3,42,96,49,47
050,19,073,"Iowa","Greene County",3,43,91,49,42
050,19,073,"Iowa","Greene County",3,44,92,53,39
050,19,073,"Iowa","Greene County",3,45,88,46,42
050,19,073,"Iowa","Greene County",3,46,90,42,48
050,19,073,"Iowa","Greene County",3,47,89,50,39
050,19,073,"Iowa","Greene County",3,48,80,43,37
050,19,073,"Iowa","Greene County",3,49,98,49,49
050,19,073,"Iowa","Greene County",3,50,102,57,45
050,19,073,"Iowa","Greene County",3,51,106,61,45
050,19,073,"Iowa","Greene County",3,52,101,51,50
050,19,073,"Iowa","Greene County",3,53,95,49,46
050,19,073,"Iowa","Greene County",3,54,99,50,49
050,19,073,"Iowa","Greene County",3,55,104,57,47
050,19,073,"Iowa","Greene County",3,56,109,59,50
050,19,073,"Iowa","Greene County",3,57,138,71,67
050,19,073,"Iowa","Greene County",3,58,143,69,74
050,19,073,"Iowa","Greene County",3,59,132,61,71
050,19,073,"Iowa","Greene County",3,60,129,61,68
050,19,073,"Iowa","Greene County",3,61,127,64,63
050,19,073,"Iowa","Greene County",3,62,133,65,68
050,19,073,"Iowa","Greene County",3,63,127,58,69
050,19,073,"Iowa","Greene County",3,64,133,62,71
050,19,073,"Iowa","Greene County",3,65,141,72,69
050,19,073,"Iowa","Greene County",3,66,135,68,67
050,19,073,"Iowa","Greene County",3,67,125,60,65
050,19,073,"Iowa","Greene County",3,68,109,56,53
050,19,073,"Iowa","Greene County",3,69,117,60,57
050,19,073,"Iowa","Greene County",3,70,116,58,58
050,19,073,"Iowa","Greene County",3,71,99,48,51
050,19,073,"Iowa","Greene County",3,72,97,51,46
050,19,073,"Iowa","Greene County",3,73,92,45,47
050,19,073,"Iowa","Greene County",3,74,109,50,59
050,19,073,"Iowa","Greene County",3,75,75,33,42
050,19,073,"Iowa","Greene County",3,76,72,32,40
050,19,073,"Iowa","Greene County",3,77,71,33,38
050,19,073,"Iowa","Greene County",3,78,71,33,38
050,19,073,"Iowa","Greene County",3,79,63,33,30
050,19,073,"Iowa","Greene County",3,80,60,27,33
050,19,073,"Iowa","Greene County",3,81,55,26,29
050,19,073,"Iowa","Greene County",3,82,60,27,33
050,19,073,"Iowa","Greene County",3,83,57,21,36
050,19,073,"Iowa","Greene County",3,84,47,22,25
050,19,073,"Iowa","Greene County",3,85,282,84,198
050,19,073,"Iowa","Greene County",4,0,87,45,42
050,19,073,"Iowa","Greene County",4,1,87,53,34
050,19,073,"Iowa","Greene County",4,2,87,53,34
050,19,073,"Iowa","Greene County",4,3,98,46,52
050,19,073,"Iowa","Greene County",4,4,107,53,54
050,19,073,"Iowa","Greene County",4,5,116,61,55
050,19,073,"Iowa","Greene County",4,6,130,67,63
050,19,073,"Iowa","Greene County",4,7,104,58,46
050,19,073,"Iowa","Greene County",4,8,105,51,54
050,19,073,"Iowa","Greene County",4,9,111,55,56
050,19,073,"Iowa","Greene County",4,10,106,50,56
050,19,073,"Iowa","Greene County",4,11,109,54,55
050,19,073,"Iowa","Greene County",4,12,119,60,59
050,19,073,"Iowa","Greene County",4,13,121,65,56
050,19,073,"Iowa","Greene County",4,14,123,62,61
050,19,073,"Iowa","Greene County",4,15,130,66,64
050,19,073,"Iowa","Greene County",4,16,117,63,54
050,19,073,"Iowa","Greene County",4,17,110,53,57
050,19,073,"Iowa","Greene County",4,18,104,59,45
050,19,073,"Iowa","Greene County",4,19,73,36,37
050,19,073,"Iowa","Greene County",4,20,72,44,28
050,19,073,"Iowa","Greene County",4,21,85,42,43
050,19,073,"Iowa","Greene County",4,22,103,52,51
050,19,073,"Iowa","Greene County",4,23,95,47,48
050,19,073,"Iowa","Greene County",4,24,92,45,47
050,19,073,"Iowa","Greene County",4,25,100,54,46
050,19,073,"Iowa","Greene County",4,26,70,40,30
050,19,073,"Iowa","Greene County",4,27,66,30,36
050,19,073,"Iowa","Greene County",4,28,89,47,42
050,19,073,"Iowa","Greene County",4,29,100,57,43
050,19,073,"Iowa","Greene County",4,30,95,43,52
050,19,073,"Iowa","Greene County",4,31,90,43,47
050,19,073,"Iowa","Greene County",4,32,86,38,48
050,19,073,"Iowa","Greene County",4,33,86,40,46
050,19,073,"Iowa","Greene County",4,34,89,46,43
050,19,073,"Iowa","Greene County",4,35,90,51,39
050,19,073,"Iowa","Greene County",4,36,101,53,48
050,19,073,"Iowa","Greene County",4,37,100,46,54
050,19,073,"Iowa","Greene County",4,38,112,58,54
050,19,073,"Iowa","Greene County",4,39,99,52,47
050,19,073,"Iowa","Greene County",4,40,104,51,53
050,19,073,"Iowa","Greene County",4,41,89,50,39
050,19,073,"Iowa","Greene County",4,42,105,55,50
050,19,073,"Iowa","Greene County",4,43,100,51,49
050,19,073,"Iowa","Greene County",4,44,88,48,40
050,19,073,"Iowa","Greene County",4,45,90,51,39
050,19,073,"Iowa","Greene County",4,46,86,45,41
050,19,073,"Iowa","Greene County",4,47,90,42,48
050,19,073,"Iowa","Greene County",4,48,86,52,34
050,19,073,"Iowa","Greene County",4,49,81,44,37
050,19,073,"Iowa","Greene County",4,50,97,49,48
050,19,073,"Iowa","Greene County",4,51,100,55,45
050,19,073,"Iowa","Greene County",4,52,104,59,45
050,19,073,"Iowa","Greene County",4,53,99,53,46
050,19,073,"Iowa","Greene County",4,54,97,45,52
050,19,073,"Iowa","Greene County",4,55,99,50,49
050,19,073,"Iowa","Greene County",4,56,109,58,51
050,19,073,"Iowa","Greene County",4,57,108,58,50
050,19,073,"Iowa","Greene County",4,58,138,70,68
050,19,073,"Iowa","Greene County",4,59,143,69,74
050,19,073,"Iowa","Greene County",4,60,134,62,72
050,19,073,"Iowa","Greene County",4,61,130,62,68
050,19,073,"Iowa","Greene County",4,62,121,60,61
050,19,073,"Iowa","Greene County",4,63,138,66,72
050,19,073,"Iowa","Greene County",4,64,125,56,69
050,19,073,"Iowa","Greene County",4,65,128,61,67
050,19,073,"Iowa","Greene County",4,66,145,75,70
050,19,073,"Iowa","Greene County",4,67,132,65,67
050,19,073,"Iowa","Greene County",4,68,122,59,63
050,19,073,"Iowa","Greene County",4,69,106,55,51
050,19,073,"Iowa","Greene County",4,70,118,58,60
050,19,073,"Iowa","Greene County",4,71,114,55,59
050,19,073,"Iowa","Greene County",4,72,98,48,50
050,19,073,"Iowa","Greene County",4,73,91,46,45
050,19,073,"Iowa","Greene County",4,74,93,45,48
050,19,073,"Iowa","Greene County",4,75,106,48,58
050,19,073,"Iowa","Greene County",4,76,76,33,43
050,19,073,"Iowa","Greene County",4,77,76,32,44
050,19,073,"Iowa","Greene County",4,78,62,27,35
050,19,073,"Iowa","Greene County",4,79,70,33,37
050,19,073,"Iowa","Greene County",4,80,61,30,31
050,19,073,"Iowa","Greene County",4,81,52,24,28
050,19,073,"Iowa","Greene County",4,82,53,24,29
050,19,073,"Iowa","Greene County",4,83,53,23,30
050,19,073,"Iowa","Greene County",4,84,50,20,30
050,19,073,"Iowa","Greene County",4,85,279,90,189
050,19,073,"Iowa","Greene County",5,0,89,46,43
050,19,073,"Iowa","Greene County",5,1,88,45,43
050,19,073,"Iowa","Greene County",5,2,87,59,28
050,19,073,"Iowa","Greene County",5,3,84,51,33
050,19,073,"Iowa","Greene County",5,4,98,50,48
050,19,073,"Iowa","Greene County",5,5,103,49,54
050,19,073,"Iowa","Greene County",5,6,116,58,58
050,19,073,"Iowa","Greene County",5,7,126,65,61
050,19,073,"Iowa","Greene County",5,8,104,60,44
050,19,073,"Iowa","Greene County",5,9,105,47,58
050,19,073,"Iowa","Greene County",5,10,111,53,58
050,19,073,"Iowa","Greene County",5,11,109,54,55
050,19,073,"Iowa","Greene County",5,12,109,54,55
050,19,073,"Iowa","Greene County",5,13,117,59,58
050,19,073,"Iowa","Greene County",5,14,117,67,50
050,19,073,"Iowa","Greene County",5,15,119,57,62
050,19,073,"Iowa","Greene County",5,16,123,64,59
050,19,073,"Iowa","Greene County",5,17,112,61,51
050,19,073,"Iowa","Greene County",5,18,88,46,42
050,19,073,"Iowa","Greene County",5,19,77,43,34
050,19,073,"Iowa","Greene County",5,20,74,37,37
050,19,073,"Iowa","Greene County",5,21,79,45,34
050,19,073,"Iowa","Greene County",5,22,82,42,40
050,19,073,"Iowa","Greene County",5,23,91,43,48
050,19,073,"Iowa","Greene County",5,24,92,43,49
050,19,073,"Iowa","Greene County",5,25,92,49,43
050,19,073,"Iowa","Greene County",5,26,99,51,48
050,19,073,"Iowa","Greene County",5,27,77,40,37
050,19,073,"Iowa","Greene County",5,28,63,34,29
050,19,073,"Iowa","Greene County",5,29,85,45,40
050,19,073,"Iowa","Greene County",5,30,91,51,40
050,19,073,"Iowa","Greene County",5,31,89,39,50
050,19,073,"Iowa","Greene County",5,32,90,42,48
050,19,073,"Iowa","Greene County",5,33,89,40,49
050,19,073,"Iowa","Greene County",5,34,83,39,44
050,19,073,"Iowa","Greene County",5,35,87,43,44
050,19,073,"Iowa","Greene County",5,36,87,48,39
050,19,073,"Iowa","Greene County",5,37,105,54,51
050,19,073,"Iowa","Greene County",5,38,99,48,51
050,19,073,"Iowa","Greene County",5,39,114,59,55
050,19,073,"Iowa","Greene County",5,40,103,56,47
050,19,073,"Iowa","Greene County",5,41,103,51,52
050,19,073,"Iowa","Greene County",5,42,90,50,40
050,19,073,"Iowa","Greene County",5,43,103,57,46
050,19,073,"Iowa","Greene County",5,44,99,50,49
050,19,073,"Iowa","Greene County",5,45,93,47,46
050,19,073,"Iowa","Greene County",5,46,89,49,40
050,19,073,"Iowa","Greene County",5,47,88,45,43
050,19,073,"Iowa","Greene County",5,48,87,42,45
050,19,073,"Iowa","Greene County",5,49,89,52,37
050,19,073,"Iowa","Greene County",5,50,84,47,37
050,19,073,"Iowa","Greene County",5,51,97,49,48
050,19,073,"Iowa","Greene County",5,52,103,59,44
050,19,073,"Iowa","Greene County",5,53,102,53,49
050,19,073,"Iowa","Greene County",5,54,99,50,49
050,19,073,"Iowa","Greene County",5,55,93,44,49
050,19,073,"Iowa","Greene County",5,56,101,52,49
050,19,073,"Iowa","Greene County",5,57,105,55,50
050,19,073,"Iowa","Greene County",5,58,112,61,51
050,19,073,"Iowa","Greene County",5,59,137,70,67
050,19,073,"Iowa","Greene County",5,60,141,67,74
050,19,073,"Iowa","Greene County",5,61,130,60,70
050,19,073,"Iowa","Greene County",5,62,128,60,68
050,19,073,"Iowa","Greene County",5,63,123,61,62
050,19,073,"Iowa","Greene County",5,64,137,67,70
050,19,073,"Iowa","Greene County",5,65,125,55,70
050,19,073,"Iowa","Greene County",5,66,127,62,65
050,19,073,"Iowa","Greene County",5,67,140,72,68
050,19,073,"Iowa","Greene County",5,68,127,65,62
050,19,073,"Iowa","Greene County",5,69,117,56,61
050,19,073,"Iowa","Greene County",5,70,107,53,54
050,19,073,"Iowa","Greene County",5,71,115,56,59
050,19,073,"Iowa","Greene County",5,72,117,58,59
050,19,073,"Iowa","Greene County",5,73,92,40,52
050,19,073,"Iowa","Greene County",5,74,88,45,43
050,19,073,"Iowa","Greene County",5,75,90,43,47
050,19,073,"Iowa","Greene County",5,76,106,47,59
050,19,073,"Iowa","Greene County",5,77,73,32,41
050,19,073,"Iowa","Greene County",5,78,68,29,39
050,19,073,"Iowa","Greene County",5,79,58,27,31
050,19,073,"Iowa","Greene County",5,80,68,31,37
050,19,073,"Iowa","Greene County",5,81,57,28,29
050,19,073,"Iowa","Greene County",5,82,50,22,28
050,19,073,"Iowa","Greene County",5,83,45,20,25
050,19,073,"Iowa","Greene County",5,84,48,22,26
050,19,073,"Iowa","Greene County",5,85,280,95,185
050,19,075,"Iowa","Grundy County",1,0,129,67,62
050,19,075,"Iowa","Grundy County",1,1,141,77,64
050,19,075,"Iowa","Grundy County",1,2,127,69,58
050,19,075,"Iowa","Grundy County",1,3,129,80,49
050,19,075,"Iowa","Grundy County",1,4,146,75,71
050,19,075,"Iowa","Grundy County",1,5,144,67,77
050,19,075,"Iowa","Grundy County",1,6,155,69,86
050,19,075,"Iowa","Grundy County",1,7,147,75,72
050,19,075,"Iowa","Grundy County",1,8,151,88,63
050,19,075,"Iowa","Grundy County",1,9,161,78,83
050,19,075,"Iowa","Grundy County",1,10,180,83,97
050,19,075,"Iowa","Grundy County",1,11,181,83,98
050,19,075,"Iowa","Grundy County",1,12,188,91,97
050,19,075,"Iowa","Grundy County",1,13,198,92,106
050,19,075,"Iowa","Grundy County",1,14,178,90,88
050,19,075,"Iowa","Grundy County",1,15,165,82,83
050,19,075,"Iowa","Grundy County",1,16,168,84,84
050,19,075,"Iowa","Grundy County",1,17,159,78,81
050,19,075,"Iowa","Grundy County",1,18,144,78,66
050,19,075,"Iowa","Grundy County",1,19,117,69,48
050,19,075,"Iowa","Grundy County",1,20,117,61,56
050,19,075,"Iowa","Grundy County",1,21,131,66,65
050,19,075,"Iowa","Grundy County",1,22,127,61,66
050,19,075,"Iowa","Grundy County",1,23,125,61,64
050,19,075,"Iowa","Grundy County",1,24,122,64,58
050,19,075,"Iowa","Grundy County",1,25,122,70,52
050,19,075,"Iowa","Grundy County",1,26,135,73,62
050,19,075,"Iowa","Grundy County",1,27,127,68,59
050,19,075,"Iowa","Grundy County",1,28,132,59,73
050,19,075,"Iowa","Grundy County",1,29,143,78,65
050,19,075,"Iowa","Grundy County",1,30,144,74,70
050,19,075,"Iowa","Grundy County",1,31,142,76,66
050,19,075,"Iowa","Grundy County",1,32,118,60,58
050,19,075,"Iowa","Grundy County",1,33,119,56,63
050,19,075,"Iowa","Grundy County",1,34,160,83,77
050,19,075,"Iowa","Grundy County",1,35,135,67,68
050,19,075,"Iowa","Grundy County",1,36,152,80,72
050,19,075,"Iowa","Grundy County",1,37,157,79,78
050,19,075,"Iowa","Grundy County",1,38,156,82,74
050,19,075,"Iowa","Grundy County",1,39,152,81,71
050,19,075,"Iowa","Grundy County",1,40,173,96,77
050,19,075,"Iowa","Grundy County",1,41,154,84,70
050,19,075,"Iowa","Grundy County",1,42,148,75,73
050,19,075,"Iowa","Grundy County",1,43,136,64,72
050,19,075,"Iowa","Grundy County",1,44,138,71,67
050,19,075,"Iowa","Grundy County",1,45,145,80,65
050,19,075,"Iowa","Grundy County",1,46,121,63,58
050,19,075,"Iowa","Grundy County",1,47,133,71,62
050,19,075,"Iowa","Grundy County",1,48,152,78,74
050,19,075,"Iowa","Grundy County",1,49,149,78,71
050,19,075,"Iowa","Grundy County",1,50,141,81,60
050,19,075,"Iowa","Grundy County",1,51,149,74,75
050,19,075,"Iowa","Grundy County",1,52,159,78,81
050,19,075,"Iowa","Grundy County",1,53,147,76,71
050,19,075,"Iowa","Grundy County",1,54,150,76,74
050,19,075,"Iowa","Grundy County",1,55,156,83,73
050,19,075,"Iowa","Grundy County",1,56,181,95,86
050,19,075,"Iowa","Grundy County",1,57,181,93,88
050,19,075,"Iowa","Grundy County",1,58,173,85,88
050,19,075,"Iowa","Grundy County",1,59,199,92,107
050,19,075,"Iowa","Grundy County",1,60,183,86,97
050,19,075,"Iowa","Grundy County",1,61,172,85,87
050,19,075,"Iowa","Grundy County",1,62,177,94,83
050,19,075,"Iowa","Grundy County",1,63,184,94,90
050,19,075,"Iowa","Grundy County",1,64,172,81,91
050,19,075,"Iowa","Grundy County",1,65,175,98,77
050,19,075,"Iowa","Grundy County",1,66,168,94,74
050,19,075,"Iowa","Grundy County",1,67,160,79,81
050,19,075,"Iowa","Grundy County",1,68,146,69,77
050,19,075,"Iowa","Grundy County",1,69,134,64,70
050,19,075,"Iowa","Grundy County",1,70,126,59,67
050,19,075,"Iowa","Grundy County",1,71,123,58,65
050,19,075,"Iowa","Grundy County",1,72,129,57,72
050,19,075,"Iowa","Grundy County",1,73,139,69,70
050,19,075,"Iowa","Grundy County",1,74,101,48,53
050,19,075,"Iowa","Grundy County",1,75,98,46,52
050,19,075,"Iowa","Grundy County",1,76,96,45,51
050,19,075,"Iowa","Grundy County",1,77,89,44,45
050,19,075,"Iowa","Grundy County",1,78,90,48,42
050,19,075,"Iowa","Grundy County",1,79,81,38,43
050,19,075,"Iowa","Grundy County",1,80,79,37,42
050,19,075,"Iowa","Grundy County",1,81,74,34,40
050,19,075,"Iowa","Grundy County",1,82,73,32,41
050,19,075,"Iowa","Grundy County",1,83,59,24,35
050,19,075,"Iowa","Grundy County",1,84,64,29,35
050,19,075,"Iowa","Grundy County",1,85,325,104,221
050,19,075,"Iowa","Grundy County",2,0,133,70,63
050,19,075,"Iowa","Grundy County",2,1,138,75,63
050,19,075,"Iowa","Grundy County",2,2,131,71,60
050,19,075,"Iowa","Grundy County",2,3,129,78,51
050,19,075,"Iowa","Grundy County",2,4,143,77,66
050,19,075,"Iowa","Grundy County",2,5,146,70,76
050,19,075,"Iowa","Grundy County",2,6,152,68,84
050,19,075,"Iowa","Grundy County",2,7,150,75,75
050,19,075,"Iowa","Grundy County",2,8,150,85,65
050,19,075,"Iowa","Grundy County",2,9,160,82,78
050,19,075,"Iowa","Grundy County",2,10,175,82,93
050,19,075,"Iowa","Grundy County",2,11,182,83,99
050,19,075,"Iowa","Grundy County",2,12,189,90,99
050,19,075,"Iowa","Grundy County",2,13,194,90,104
050,19,075,"Iowa","Grundy County",2,14,184,91,93
050,19,075,"Iowa","Grundy County",2,15,171,85,86
050,19,075,"Iowa","Grundy County",2,16,168,84,84
050,19,075,"Iowa","Grundy County",2,17,160,79,81
050,19,075,"Iowa","Grundy County",2,18,139,74,65
050,19,075,"Iowa","Grundy County",2,19,116,66,50
050,19,075,"Iowa","Grundy County",2,20,122,66,56
050,19,075,"Iowa","Grundy County",2,21,128,64,64
050,19,075,"Iowa","Grundy County",2,22,130,62,68
050,19,075,"Iowa","Grundy County",2,23,129,62,67
050,19,075,"Iowa","Grundy County",2,24,123,63,60
050,19,075,"Iowa","Grundy County",2,25,120,68,52
050,19,075,"Iowa","Grundy County",2,26,131,72,59
050,19,075,"Iowa","Grundy County",2,27,130,69,61
050,19,075,"Iowa","Grundy County",2,28,132,63,69
050,19,075,"Iowa","Grundy County",2,29,141,74,67
050,19,075,"Iowa","Grundy County",2,30,145,76,69
050,19,075,"Iowa","Grundy County",2,31,142,75,67
050,19,075,"Iowa","Grundy County",2,32,123,64,59
050,19,075,"Iowa","Grundy County",2,33,120,57,63
050,19,075,"Iowa","Grundy County",2,34,149,76,73
050,19,075,"Iowa","Grundy County",2,35,143,72,71
050,19,075,"Iowa","Grundy County",2,36,147,76,71
050,19,075,"Iowa","Grundy County",2,37,157,80,77
050,19,075,"Iowa","Grundy County",2,38,159,83,76
050,19,075,"Iowa","Grundy County",2,39,154,82,72
050,19,075,"Iowa","Grundy County",2,40,169,93,76
050,19,075,"Iowa","Grundy County",2,41,158,86,72
050,19,075,"Iowa","Grundy County",2,42,148,76,72
050,19,075,"Iowa","Grundy County",2,43,141,68,73
050,19,075,"Iowa","Grundy County",2,44,136,69,67
050,19,075,"Iowa","Grundy County",2,45,145,77,68
050,19,075,"Iowa","Grundy County",2,46,126,67,59
050,19,075,"Iowa","Grundy County",2,47,128,69,59
050,19,075,"Iowa","Grundy County",2,48,147,76,71
050,19,075,"Iowa","Grundy County",2,49,150,78,72
050,19,075,"Iowa","Grundy County",2,50,143,79,64
050,19,075,"Iowa","Grundy County",2,51,144,75,69
050,19,075,"Iowa","Grundy County",2,52,157,78,79
050,19,075,"Iowa","Grundy County",2,53,149,76,73
050,19,075,"Iowa","Grundy County",2,54,151,77,74
050,19,075,"Iowa","Grundy County",2,55,152,80,72
050,19,075,"Iowa","Grundy County",2,56,175,92,83
050,19,075,"Iowa","Grundy County",2,57,181,93,88
050,19,075,"Iowa","Grundy County",2,58,174,86,88
050,19,075,"Iowa","Grundy County",2,59,192,91,101
050,19,075,"Iowa","Grundy County",2,60,187,87,100
050,19,075,"Iowa","Grundy County",2,61,172,83,89
050,19,075,"Iowa","Grundy County",2,62,175,91,84
050,19,075,"Iowa","Grundy County",2,63,184,95,89
050,19,075,"Iowa","Grundy County",2,64,175,84,91
050,19,075,"Iowa","Grundy County",2,65,175,95,80
050,19,075,"Iowa","Grundy County",2,66,168,95,73
050,19,075,"Iowa","Grundy County",2,67,161,83,78
050,19,075,"Iowa","Grundy County",2,68,146,70,76
050,19,075,"Iowa","Grundy County",2,69,137,65,72
050,19,075,"Iowa","Grundy County",2,70,125,59,66
050,19,075,"Iowa","Grundy County",2,71,123,57,66
050,19,075,"Iowa","Grundy County",2,72,125,56,69
050,19,075,"Iowa","Grundy County",2,73,143,69,74
050,19,075,"Iowa","Grundy County",2,74,103,49,54
050,19,075,"Iowa","Grundy County",2,75,99,47,52
050,19,075,"Iowa","Grundy County",2,76,96,45,51
050,19,075,"Iowa","Grundy County",2,77,91,44,47
050,19,075,"Iowa","Grundy County",2,78,88,46,42
050,19,075,"Iowa","Grundy County",2,79,83,40,43
050,19,075,"Iowa","Grundy County",2,80,77,35,42
050,19,075,"Iowa","Grundy County",2,81,72,32,40
050,19,075,"Iowa","Grundy County",2,82,75,33,42
050,19,075,"Iowa","Grundy County",2,83,61,25,36
050,19,075,"Iowa","Grundy County",2,84,61,27,34
050,19,075,"Iowa","Grundy County",2,85,330,108,222
050,19,075,"Iowa","Grundy County",3,0,123,72,51
050,19,075,"Iowa","Grundy County",3,1,146,77,69
050,19,075,"Iowa","Grundy County",3,2,139,79,60
050,19,075,"Iowa","Grundy County",3,3,132,72,60
050,19,075,"Iowa","Grundy County",3,4,135,80,55
050,19,075,"Iowa","Grundy County",3,5,151,78,73
050,19,075,"Iowa","Grundy County",3,6,148,68,80
050,19,075,"Iowa","Grundy County",3,7,160,68,92
050,19,075,"Iowa","Grundy County",3,8,156,77,79
050,19,075,"Iowa","Grundy County",3,9,151,84,67
050,19,075,"Iowa","Grundy County",3,10,159,82,77
050,19,075,"Iowa","Grundy County",3,11,182,88,94
050,19,075,"Iowa","Grundy County",3,12,180,81,99
050,19,075,"Iowa","Grundy County",3,13,189,92,97
050,19,075,"Iowa","Grundy County",3,14,197,90,107
050,19,075,"Iowa","Grundy County",3,15,182,86,96
050,19,075,"Iowa","Grundy County",3,16,174,86,88
050,19,075,"Iowa","Grundy County",3,17,166,81,85
050,19,075,"Iowa","Grundy County",3,18,139,71,68
050,19,075,"Iowa","Grundy County",3,19,103,56,47
050,19,075,"Iowa","Grundy County",3,20,124,69,55
050,19,075,"Iowa","Grundy County",3,21,117,64,53
050,19,075,"Iowa","Grundy County",3,22,148,74,74
050,19,075,"Iowa","Grundy County",3,23,129,64,65
050,19,075,"Iowa","Grundy County",3,24,124,66,58
050,19,075,"Iowa","Grundy County",3,25,119,59,60
050,19,075,"Iowa","Grundy County",3,26,128,71,57
050,19,075,"Iowa","Grundy County",3,27,127,69,58
050,19,075,"Iowa","Grundy County",3,28,132,66,66
050,19,075,"Iowa","Grundy County",3,29,140,67,73
050,19,075,"Iowa","Grundy County",3,30,139,69,70
050,19,075,"Iowa","Grundy County",3,31,154,80,74
050,19,075,"Iowa","Grundy County",3,32,140,74,66
050,19,075,"Iowa","Grundy County",3,33,126,63,63
050,19,075,"Iowa","Grundy County",3,34,127,62,65
050,19,075,"Iowa","Grundy County",3,35,160,82,78
050,19,075,"Iowa","Grundy County",3,36,143,68,75
050,19,075,"Iowa","Grundy County",3,37,144,71,73
050,19,075,"Iowa","Grundy County",3,38,154,75,79
050,19,075,"Iowa","Grundy County",3,39,168,88,80
050,19,075,"Iowa","Grundy County",3,40,156,82,74
050,19,075,"Iowa","Grundy County",3,41,166,93,73
050,19,075,"Iowa","Grundy County",3,42,164,86,78
050,19,075,"Iowa","Grundy County",3,43,155,80,75
050,19,075,"Iowa","Grundy County",3,44,139,69,70
050,19,075,"Iowa","Grundy County",3,45,136,69,67
050,19,075,"Iowa","Grundy County",3,46,140,73,67
050,19,075,"Iowa","Grundy County",3,47,121,67,54
050,19,075,"Iowa","Grundy County",3,48,124,67,57
050,19,075,"Iowa","Grundy County",3,49,150,73,77
050,19,075,"Iowa","Grundy County",3,50,149,77,72
050,19,075,"Iowa","Grundy County",3,51,144,77,67
050,19,075,"Iowa","Grundy County",3,52,143,78,65
050,19,075,"Iowa","Grundy County",3,53,158,77,81
050,19,075,"Iowa","Grundy County",3,54,157,80,77
050,19,075,"Iowa","Grundy County",3,55,143,73,70
050,19,075,"Iowa","Grundy County",3,56,153,79,74
050,19,075,"Iowa","Grundy County",3,57,170,91,79
050,19,075,"Iowa","Grundy County",3,58,181,93,88
050,19,075,"Iowa","Grundy County",3,59,180,89,91
050,19,075,"Iowa","Grundy County",3,60,196,89,107
050,19,075,"Iowa","Grundy County",3,61,186,89,97
050,19,075,"Iowa","Grundy County",3,62,169,81,88
050,19,075,"Iowa","Grundy County",3,63,177,94,83
050,19,075,"Iowa","Grundy County",3,64,179,94,85
050,19,075,"Iowa","Grundy County",3,65,172,83,89
050,19,075,"Iowa","Grundy County",3,66,178,94,84
050,19,075,"Iowa","Grundy County",3,67,164,94,70
050,19,075,"Iowa","Grundy County",3,68,155,79,76
050,19,075,"Iowa","Grundy County",3,69,145,69,76
050,19,075,"Iowa","Grundy County",3,70,129,59,70
050,19,075,"Iowa","Grundy County",3,71,115,55,60
050,19,075,"Iowa","Grundy County",3,72,121,55,66
050,19,075,"Iowa","Grundy County",3,73,119,56,63
050,19,075,"Iowa","Grundy County",3,74,141,67,74
050,19,075,"Iowa","Grundy County",3,75,98,47,51
050,19,075,"Iowa","Grundy County",3,76,99,46,53
050,19,075,"Iowa","Grundy County",3,77,90,43,47
050,19,075,"Iowa","Grundy County",3,78,88,44,44
050,19,075,"Iowa","Grundy County",3,79,92,46,46
050,19,075,"Iowa","Grundy County",3,80,76,40,36
050,19,075,"Iowa","Grundy County",3,81,67,32,35
050,19,075,"Iowa","Grundy County",3,82,71,33,38
050,19,075,"Iowa","Grundy County",3,83,66,27,39
050,19,075,"Iowa","Grundy County",3,84,56,22,34
050,19,075,"Iowa","Grundy County",3,85,325,111,214
050,19,075,"Iowa","Grundy County",4,0,139,72,67
050,19,075,"Iowa","Grundy County",4,1,124,68,56
050,19,075,"Iowa","Grundy County",4,2,153,81,72
050,19,075,"Iowa","Grundy County",4,3,144,79,65
050,19,075,"Iowa","Grundy County",4,4,138,77,61
050,19,075,"Iowa","Grundy County",4,5,142,83,59
050,19,075,"Iowa","Grundy County",4,6,155,77,78
050,19,075,"Iowa","Grundy County",4,7,159,75,84
050,19,075,"Iowa","Grundy County",4,8,165,71,94
050,19,075,"Iowa","Grundy County",4,9,154,77,77
050,19,075,"Iowa","Grundy County",4,10,156,86,70
050,19,075,"Iowa","Grundy County",4,11,168,88,80
050,19,075,"Iowa","Grundy County",4,12,187,93,94
050,19,075,"Iowa","Grundy County",4,13,171,79,92
050,19,075,"Iowa","Grundy County",4,14,190,94,96
050,19,075,"Iowa","Grundy County",4,15,191,87,104
050,19,075,"Iowa","Grundy County",4,16,185,92,93
050,19,075,"Iowa","Grundy County",4,17,172,85,87
050,19,075,"Iowa","Grundy County",4,18,143,75,68
050,19,075,"Iowa","Grundy County",4,19,106,58,48
050,19,075,"Iowa","Grundy County",4,20,101,56,45
050,19,075,"Iowa","Grundy County",4,21,129,68,61
050,19,075,"Iowa","Grundy County",4,22,130,68,62
050,19,075,"Iowa","Grundy County",4,23,137,64,73
050,19,075,"Iowa","Grundy County",4,24,119,62,57
050,19,075,"Iowa","Grundy County",4,25,115,64,51
050,19,075,"Iowa","Grundy County",4,26,120,62,58
050,19,075,"Iowa","Grundy County",4,27,131,71,60
050,19,075,"Iowa","Grundy County",4,28,136,74,62
050,19,075,"Iowa","Grundy County",4,29,146,71,75
050,19,075,"Iowa","Grundy County",4,30,135,63,72
050,19,075,"Iowa","Grundy County",4,31,140,70,70
050,19,075,"Iowa","Grundy County",4,32,151,76,75
050,19,075,"Iowa","Grundy County",4,33,142,73,69
050,19,075,"Iowa","Grundy County",4,34,121,63,58
050,19,075,"Iowa","Grundy County",4,35,135,69,66
050,19,075,"Iowa","Grundy County",4,36,166,84,82
050,19,075,"Iowa","Grundy County",4,37,146,69,77
050,19,075,"Iowa","Grundy County",4,38,148,71,77
050,19,075,"Iowa","Grundy County",4,39,160,78,82
050,19,075,"Iowa","Grundy County",4,40,169,85,84
050,19,075,"Iowa","Grundy County",4,41,156,80,76
050,19,075,"Iowa","Grundy County",4,42,163,93,70
050,19,075,"Iowa","Grundy County",4,43,160,85,75
050,19,075,"Iowa","Grundy County",4,44,145,75,70
050,19,075,"Iowa","Grundy County",4,45,143,73,70
050,19,075,"Iowa","Grundy County",4,46,134,68,66
050,19,075,"Iowa","Grundy County",4,47,143,75,68
050,19,075,"Iowa","Grundy County",4,48,126,67,59
050,19,075,"Iowa","Grundy County",4,49,123,70,53
050,19,075,"Iowa","Grundy County",4,50,150,71,79
050,19,075,"Iowa","Grundy County",4,51,141,74,67
050,19,075,"Iowa","Grundy County",4,52,140,77,63
050,19,075,"Iowa","Grundy County",4,53,142,77,65
050,19,075,"Iowa","Grundy County",4,54,153,78,75
050,19,075,"Iowa","Grundy County",4,55,153,77,76
050,19,075,"Iowa","Grundy County",4,56,140,71,69
050,19,075,"Iowa","Grundy County",4,57,155,75,80
050,19,075,"Iowa","Grundy County",4,58,165,90,75
050,19,075,"Iowa","Grundy County",4,59,179,90,89
050,19,075,"Iowa","Grundy County",4,60,185,91,94
050,19,075,"Iowa","Grundy County",4,61,190,89,101
050,19,075,"Iowa","Grundy County",4,62,186,90,96
050,19,075,"Iowa","Grundy County",4,63,162,76,86
050,19,075,"Iowa","Grundy County",4,64,170,92,78
050,19,075,"Iowa","Grundy County",4,65,182,96,86
050,19,075,"Iowa","Grundy County",4,66,159,74,85
050,19,075,"Iowa","Grundy County",4,67,177,92,85
050,19,075,"Iowa","Grundy County",4,68,163,94,69
050,19,075,"Iowa","Grundy County",4,69,148,75,73
050,19,075,"Iowa","Grundy County",4,70,150,72,78
050,19,075,"Iowa","Grundy County",4,71,121,55,66
050,19,075,"Iowa","Grundy County",4,72,119,57,62
050,19,075,"Iowa","Grundy County",4,73,114,51,63
050,19,075,"Iowa","Grundy County",4,74,124,57,67
050,19,075,"Iowa","Grundy County",4,75,133,64,69
050,19,075,"Iowa","Grundy County",4,76,96,44,52
050,19,075,"Iowa","Grundy County",4,77,94,46,48
050,19,075,"Iowa","Grundy County",4,78,90,42,48
050,19,075,"Iowa","Grundy County",4,79,89,42,47
050,19,075,"Iowa","Grundy County",4,80,86,43,43
050,19,075,"Iowa","Grundy County",4,81,71,38,33
050,19,075,"Iowa","Grundy County",4,82,64,31,33
050,19,075,"Iowa","Grundy County",4,83,66,27,39
050,19,075,"Iowa","Grundy County",4,84,62,25,37
050,19,075,"Iowa","Grundy County",4,85,324,110,214
050,19,075,"Iowa","Grundy County",5,0,140,72,68
050,19,075,"Iowa","Grundy County",5,1,146,67,79
050,19,075,"Iowa","Grundy County",5,2,132,69,63
050,19,075,"Iowa","Grundy County",5,3,158,77,81
050,19,075,"Iowa","Grundy County",5,4,150,85,65
050,19,075,"Iowa","Grundy County",5,5,141,80,61
050,19,075,"Iowa","Grundy County",5,6,154,88,66
050,19,075,"Iowa","Grundy County",5,7,167,83,84
050,19,075,"Iowa","Grundy County",5,8,162,77,85
050,19,075,"Iowa","Grundy County",5,9,167,76,91
050,19,075,"Iowa","Grundy County",5,10,161,77,84
050,19,075,"Iowa","Grundy County",5,11,161,87,74
050,19,075,"Iowa","Grundy County",5,12,171,88,83
050,19,075,"Iowa","Grundy County",5,13,193,91,102
050,19,075,"Iowa","Grundy County",5,14,178,85,93
050,19,075,"Iowa","Grundy County",5,15,183,90,93
050,19,075,"Iowa","Grundy County",5,16,195,91,104
050,19,075,"Iowa","Grundy County",5,17,174,84,90
050,19,075,"Iowa","Grundy County",5,18,143,74,69
050,19,075,"Iowa","Grundy County",5,19,106,54,52
050,19,075,"Iowa","Grundy County",5,20,113,62,51
050,19,075,"Iowa","Grundy County",5,21,106,60,46
050,19,075,"Iowa","Grundy County",5,22,127,69,58
050,19,075,"Iowa","Grundy County",5,23,118,69,49
050,19,075,"Iowa","Grundy County",5,24,127,55,72
050,19,075,"Iowa","Grundy County",5,25,117,62,55
050,19,075,"Iowa","Grundy County",5,26,106,59,47
050,19,075,"Iowa","Grundy County",5,27,123,59,64
050,19,075,"Iowa","Grundy County",5,28,132,72,60
050,19,075,"Iowa","Grundy County",5,29,139,71,68
050,19,075,"Iowa","Grundy County",5,30,145,70,75
050,19,075,"Iowa","Grundy County",5,31,148,71,77
050,19,075,"Iowa","Grundy County",5,32,139,66,73
050,19,075,"Iowa","Grundy County",5,33,151,76,75
050,19,075,"Iowa","Grundy County",5,34,148,77,71
050,19,075,"Iowa","Grundy County",5,35,129,70,59
050,19,075,"Iowa","Grundy County",5,36,143,70,73
050,19,075,"Iowa","Grundy County",5,37,171,89,82
050,19,075,"Iowa","Grundy County",5,38,150,70,80
050,19,075,"Iowa","Grundy County",5,39,154,74,80
050,19,075,"Iowa","Grundy County",5,40,163,80,83
050,19,075,"Iowa","Grundy County",5,41,168,86,82
050,19,075,"Iowa","Grundy County",5,42,153,81,72
050,19,075,"Iowa","Grundy County",5,43,166,93,73
050,19,075,"Iowa","Grundy County",5,44,160,84,76
050,19,075,"Iowa","Grundy County",5,45,139,69,70
050,19,075,"Iowa","Grundy County",5,46,143,72,71
050,19,075,"Iowa","Grundy County",5,47,132,68,64
050,19,075,"Iowa","Grundy County",5,48,142,76,66
050,19,075,"Iowa","Grundy County",5,49,125,67,58
050,19,075,"Iowa","Grundy County",5,50,118,66,52
050,19,075,"Iowa","Grundy County",5,51,155,72,83
050,19,075,"Iowa","Grundy County",5,52,142,72,70
050,19,075,"Iowa","Grundy County",5,53,146,83,63
050,19,075,"Iowa","Grundy County",5,54,146,81,65
050,19,075,"Iowa","Grundy County",5,55,156,81,75
050,19,075,"Iowa","Grundy County",5,56,148,75,73
050,19,075,"Iowa","Grundy County",5,57,139,69,70
050,19,075,"Iowa","Grundy County",5,58,151,71,80
050,19,075,"Iowa","Grundy County",5,59,167,92,75
050,19,075,"Iowa","Grundy County",5,60,175,88,87
050,19,075,"Iowa","Grundy County",5,61,180,88,92
050,19,075,"Iowa","Grundy County",5,62,187,88,99
050,19,075,"Iowa","Grundy County",5,63,181,90,91
050,19,075,"Iowa","Grundy County",5,64,156,73,83
050,19,075,"Iowa","Grundy County",5,65,170,95,75
050,19,075,"Iowa","Grundy County",5,66,170,86,84
050,19,075,"Iowa","Grundy County",5,67,154,72,82
050,19,075,"Iowa","Grundy County",5,68,180,95,85
050,19,075,"Iowa","Grundy County",5,69,162,92,70
050,19,075,"Iowa","Grundy County",5,70,149,74,75
050,19,075,"Iowa","Grundy County",5,71,144,66,78
050,19,075,"Iowa","Grundy County",5,72,122,56,66
050,19,075,"Iowa","Grundy County",5,73,115,57,58
050,19,075,"Iowa","Grundy County",5,74,118,53,65
050,19,075,"Iowa","Grundy County",5,75,120,59,61
050,19,075,"Iowa","Grundy County",5,76,135,61,74
050,19,075,"Iowa","Grundy County",5,77,85,40,45
050,19,075,"Iowa","Grundy County",5,78,93,44,49
050,19,075,"Iowa","Grundy County",5,79,92,41,51
050,19,075,"Iowa","Grundy County",5,80,76,40,36
050,19,075,"Iowa","Grundy County",5,81,80,40,40
050,19,075,"Iowa","Grundy County",5,82,67,35,32
050,19,075,"Iowa","Grundy County",5,83,60,25,35
050,19,075,"Iowa","Grundy County",5,84,59,25,34
050,19,075,"Iowa","Grundy County",5,85,327,113,214
050,19,077,"Iowa","Guthrie County",1,0,93,47,46
050,19,077,"Iowa","Guthrie County",1,1,99,46,53
050,19,077,"Iowa","Guthrie County",1,2,121,60,61
050,19,077,"Iowa","Guthrie County",1,3,106,61,45
050,19,077,"Iowa","Guthrie County",1,4,136,67,69
050,19,077,"Iowa","Guthrie County",1,5,116,53,63
050,19,077,"Iowa","Guthrie County",1,6,107,53,54
050,19,077,"Iowa","Guthrie County",1,7,121,59,62
050,19,077,"Iowa","Guthrie County",1,8,122,57,65
050,19,077,"Iowa","Guthrie County",1,9,127,70,57
050,19,077,"Iowa","Guthrie County",1,10,131,61,70
050,19,077,"Iowa","Guthrie County",1,11,135,69,66
050,19,077,"Iowa","Guthrie County",1,12,149,85,64
050,19,077,"Iowa","Guthrie County",1,13,141,77,64
050,19,077,"Iowa","Guthrie County",1,14,141,71,70
050,19,077,"Iowa","Guthrie County",1,15,142,79,63
050,19,077,"Iowa","Guthrie County",1,16,169,92,77
050,19,077,"Iowa","Guthrie County",1,17,175,96,79
050,19,077,"Iowa","Guthrie County",1,18,116,59,57
050,19,077,"Iowa","Guthrie County",1,19,95,50,45
050,19,077,"Iowa","Guthrie County",1,20,100,54,46
050,19,077,"Iowa","Guthrie County",1,21,109,61,48
050,19,077,"Iowa","Guthrie County",1,22,85,42,43
050,19,077,"Iowa","Guthrie County",1,23,106,49,57
050,19,077,"Iowa","Guthrie County",1,24,93,43,50
050,19,077,"Iowa","Guthrie County",1,25,88,46,42
050,19,077,"Iowa","Guthrie County",1,26,98,54,44
050,19,077,"Iowa","Guthrie County",1,27,128,70,58
050,19,077,"Iowa","Guthrie County",1,28,96,44,52
050,19,077,"Iowa","Guthrie County",1,29,85,43,42
050,19,077,"Iowa","Guthrie County",1,30,86,42,44
050,19,077,"Iowa","Guthrie County",1,31,100,46,54
050,19,077,"Iowa","Guthrie County",1,32,101,53,48
050,19,077,"Iowa","Guthrie County",1,33,101,52,49
050,19,077,"Iowa","Guthrie County",1,34,99,61,38
050,19,077,"Iowa","Guthrie County",1,35,116,63,53
050,19,077,"Iowa","Guthrie County",1,36,116,56,60
050,19,077,"Iowa","Guthrie County",1,37,111,53,58
050,19,077,"Iowa","Guthrie County",1,38,117,59,58
050,19,077,"Iowa","Guthrie County",1,39,120,64,56
050,19,077,"Iowa","Guthrie County",1,40,126,60,66
050,19,077,"Iowa","Guthrie County",1,41,121,58,63
050,19,077,"Iowa","Guthrie County",1,42,122,62,60
050,19,077,"Iowa","Guthrie County",1,43,139,72,67
050,19,077,"Iowa","Guthrie County",1,44,120,64,56
050,19,077,"Iowa","Guthrie County",1,45,103,60,43
050,19,077,"Iowa","Guthrie County",1,46,121,59,62
050,19,077,"Iowa","Guthrie County",1,47,110,57,53
050,19,077,"Iowa","Guthrie County",1,48,112,58,54
050,19,077,"Iowa","Guthrie County",1,49,143,74,69
050,19,077,"Iowa","Guthrie County",1,50,147,74,73
050,19,077,"Iowa","Guthrie County",1,51,128,63,65
050,19,077,"Iowa","Guthrie County",1,52,111,59,52
050,19,077,"Iowa","Guthrie County",1,53,128,67,61
050,19,077,"Iowa","Guthrie County",1,54,163,80,83
050,19,077,"Iowa","Guthrie County",1,55,155,74,81
050,19,077,"Iowa","Guthrie County",1,56,165,79,86
050,19,077,"Iowa","Guthrie County",1,57,172,87,85
050,19,077,"Iowa","Guthrie County",1,58,163,79,84
050,19,077,"Iowa","Guthrie County",1,59,184,103,81
050,19,077,"Iowa","Guthrie County",1,60,178,95,83
050,19,077,"Iowa","Guthrie County",1,61,166,84,82
050,19,077,"Iowa","Guthrie County",1,62,182,86,96
050,19,077,"Iowa","Guthrie County",1,63,161,72,89
050,19,077,"Iowa","Guthrie County",1,64,175,93,82
050,19,077,"Iowa","Guthrie County",1,65,162,87,75
050,19,077,"Iowa","Guthrie County",1,66,160,83,77
050,19,077,"Iowa","Guthrie County",1,67,177,96,81
050,19,077,"Iowa","Guthrie County",1,68,165,89,76
050,19,077,"Iowa","Guthrie County",1,69,134,68,66
050,19,077,"Iowa","Guthrie County",1,70,128,66,62
050,19,077,"Iowa","Guthrie County",1,71,128,66,62
050,19,077,"Iowa","Guthrie County",1,72,128,67,61
050,19,077,"Iowa","Guthrie County",1,73,116,60,56
050,19,077,"Iowa","Guthrie County",1,74,85,33,52
050,19,077,"Iowa","Guthrie County",1,75,100,46,54
050,19,077,"Iowa","Guthrie County",1,76,97,44,53
050,19,077,"Iowa","Guthrie County",1,77,92,41,51
050,19,077,"Iowa","Guthrie County",1,78,75,36,39
050,19,077,"Iowa","Guthrie County",1,79,62,33,29
050,19,077,"Iowa","Guthrie County",1,80,52,21,31
050,19,077,"Iowa","Guthrie County",1,81,63,21,42
050,19,077,"Iowa","Guthrie County",1,82,60,26,34
050,19,077,"Iowa","Guthrie County",1,83,54,27,27
050,19,077,"Iowa","Guthrie County",1,84,50,26,24
050,19,077,"Iowa","Guthrie County",1,85,341,120,221
050,19,077,"Iowa","Guthrie County",2,0,93,46,47
050,19,077,"Iowa","Guthrie County",2,1,98,46,52
050,19,077,"Iowa","Guthrie County",2,2,114,56,58
050,19,077,"Iowa","Guthrie County",2,3,109,60,49
050,19,077,"Iowa","Guthrie County",2,4,128,65,63
050,19,077,"Iowa","Guthrie County",2,5,119,55,64
050,19,077,"Iowa","Guthrie County",2,6,109,53,56
050,19,077,"Iowa","Guthrie County",2,7,117,57,60
050,19,077,"Iowa","Guthrie County",2,8,122,58,64
050,19,077,"Iowa","Guthrie County",2,9,125,66,59
050,19,077,"Iowa","Guthrie County",2,10,131,63,68
050,19,077,"Iowa","Guthrie County",2,11,134,67,67
050,19,077,"Iowa","Guthrie County",2,12,147,82,65
050,19,077,"Iowa","Guthrie County",2,13,142,78,64
050,19,077,"Iowa","Guthrie County",2,14,144,75,69
050,19,077,"Iowa","Guthrie County",2,15,142,77,65
050,19,077,"Iowa","Guthrie County",2,16,163,88,75
050,19,077,"Iowa","Guthrie County",2,17,171,94,77
050,19,077,"Iowa","Guthrie County",2,18,121,65,56
050,19,077,"Iowa","Guthrie County",2,19,95,49,46
050,19,077,"Iowa","Guthrie County",2,20,102,54,48
050,19,077,"Iowa","Guthrie County",2,21,107,60,47
050,19,077,"Iowa","Guthrie County",2,22,91,46,45
050,19,077,"Iowa","Guthrie County",2,23,101,47,54
050,19,077,"Iowa","Guthrie County",2,24,94,45,49
050,19,077,"Iowa","Guthrie County",2,25,90,47,43
050,19,077,"Iowa","Guthrie County",2,26,98,53,45
050,19,077,"Iowa","Guthrie County",2,27,122,66,56
050,19,077,"Iowa","Guthrie County",2,28,102,50,52
050,19,077,"Iowa","Guthrie County",2,29,87,44,43
050,19,077,"Iowa","Guthrie County",2,30,88,44,44
050,19,077,"Iowa","Guthrie County",2,31,99,46,53
050,19,077,"Iowa","Guthrie County",2,32,100,51,49
050,19,077,"Iowa","Guthrie County",2,33,102,53,49
050,19,077,"Iowa","Guthrie County",2,34,97,58,39
050,19,077,"Iowa","Guthrie County",2,35,113,63,50
050,19,077,"Iowa","Guthrie County",2,36,115,56,59
050,19,077,"Iowa","Guthrie County",2,37,113,54,59
050,19,077,"Iowa","Guthrie County",2,38,119,59,60
050,19,077,"Iowa","Guthrie County",2,39,119,62,57
050,19,077,"Iowa","Guthrie County",2,40,126,61,65
050,19,077,"Iowa","Guthrie County",2,41,124,59,65
050,19,077,"Iowa","Guthrie County",2,42,121,61,60
050,19,077,"Iowa","Guthrie County",2,43,136,70,66
050,19,077,"Iowa","Guthrie County",2,44,125,66,59
050,19,077,"Iowa","Guthrie County",2,45,109,62,47
050,19,077,"Iowa","Guthrie County",2,46,115,59,56
050,19,077,"Iowa","Guthrie County",2,47,113,58,55
050,19,077,"Iowa","Guthrie County",2,48,112,57,55
050,19,077,"Iowa","Guthrie County",2,49,138,72,66
050,19,077,"Iowa","Guthrie County",2,50,147,75,72
050,19,077,"Iowa","Guthrie County",2,51,132,66,66
050,19,077,"Iowa","Guthrie County",2,52,114,60,54
050,19,077,"Iowa","Guthrie County",2,53,125,65,60
050,19,077,"Iowa","Guthrie County",2,54,155,77,78
050,19,077,"Iowa","Guthrie County",2,55,157,75,82
050,19,077,"Iowa","Guthrie County",2,56,162,78,84
050,19,077,"Iowa","Guthrie County",2,57,170,85,85
050,19,077,"Iowa","Guthrie County",2,58,166,81,85
050,19,077,"Iowa","Guthrie County",2,59,182,99,83
050,19,077,"Iowa","Guthrie County",2,60,181,97,84
050,19,077,"Iowa","Guthrie County",2,61,170,88,82
050,19,077,"Iowa","Guthrie County",2,62,177,84,93
050,19,077,"Iowa","Guthrie County",2,63,165,75,90
050,19,077,"Iowa","Guthrie County",2,64,171,87,84
050,19,077,"Iowa","Guthrie County",2,65,164,89,75
050,19,077,"Iowa","Guthrie County",2,66,163,85,78
050,19,077,"Iowa","Guthrie County",2,67,172,93,79
050,19,077,"Iowa","Guthrie County",2,68,167,90,77
050,19,077,"Iowa","Guthrie County",2,69,141,73,68
050,19,077,"Iowa","Guthrie County",2,70,127,64,63
050,19,077,"Iowa","Guthrie County",2,71,127,65,62
050,19,077,"Iowa","Guthrie County",2,72,123,64,59
050,19,077,"Iowa","Guthrie County",2,73,122,63,59
050,19,077,"Iowa","Guthrie County",2,74,87,37,50
050,19,077,"Iowa","Guthrie County",2,75,95,42,53
050,19,077,"Iowa","Guthrie County",2,76,97,44,53
050,19,077,"Iowa","Guthrie County",2,77,95,42,53
050,19,077,"Iowa","Guthrie County",2,78,75,36,39
050,19,077,"Iowa","Guthrie County",2,79,65,33,32
050,19,077,"Iowa","Guthrie County",2,80,55,24,31
050,19,077,"Iowa","Guthrie County",2,81,59,21,38
050,19,077,"Iowa","Guthrie County",2,82,59,24,35
050,19,077,"Iowa","Guthrie County",2,83,55,25,30
050,19,077,"Iowa","Guthrie County",2,84,47,23,24
050,19,077,"Iowa","Guthrie County",2,85,341,121,220
050,19,077,"Iowa","Guthrie County",3,0,84,53,31
050,19,077,"Iowa","Guthrie County",3,1,95,48,47
050,19,077,"Iowa","Guthrie County",3,2,105,44,61
050,19,077,"Iowa","Guthrie County",3,3,115,61,54
050,19,077,"Iowa","Guthrie County",3,4,110,56,54
050,19,077,"Iowa","Guthrie County",3,5,128,67,61
050,19,077,"Iowa","Guthrie County",3,6,123,58,65
050,19,077,"Iowa","Guthrie County",3,7,106,52,54
050,19,077,"Iowa","Guthrie County",3,8,116,58,58
050,19,077,"Iowa","Guthrie County",3,9,122,61,61
050,19,077,"Iowa","Guthrie County",3,10,127,66,61
050,19,077,"Iowa","Guthrie County",3,11,131,62,69
050,19,077,"Iowa","Guthrie County",3,12,137,68,69
050,19,077,"Iowa","Guthrie County",3,13,139,77,62
050,19,077,"Iowa","Guthrie County",3,14,141,81,60
050,19,077,"Iowa","Guthrie County",3,15,144,70,74
050,19,077,"Iowa","Guthrie County",3,16,139,77,62
050,19,077,"Iowa","Guthrie County",3,17,160,85,75
050,19,077,"Iowa","Guthrie County",3,18,145,79,66
050,19,077,"Iowa","Guthrie County",3,19,97,56,41
050,19,077,"Iowa","Guthrie County",3,20,102,51,51
050,19,077,"Iowa","Guthrie County",3,21,100,54,46
050,19,077,"Iowa","Guthrie County",3,22,109,60,49
050,19,077,"Iowa","Guthrie County",3,23,95,48,47
050,19,077,"Iowa","Guthrie County",3,24,94,50,44
050,19,077,"Iowa","Guthrie County",3,25,99,46,53
050,19,077,"Iowa","Guthrie County",3,26,90,46,44
050,19,077,"Iowa","Guthrie County",3,27,97,52,45
050,19,077,"Iowa","Guthrie County",3,28,117,63,54
050,19,077,"Iowa","Guthrie County",3,29,105,54,51
050,19,077,"Iowa","Guthrie County",3,30,88,47,41
050,19,077,"Iowa","Guthrie County",3,31,89,43,46
050,19,077,"Iowa","Guthrie County",3,32,99,49,50
050,19,077,"Iowa","Guthrie County",3,33,105,54,51
050,19,077,"Iowa","Guthrie County",3,34,108,55,53
050,19,077,"Iowa","Guthrie County",3,35,98,57,41
050,19,077,"Iowa","Guthrie County",3,36,116,66,50
050,19,077,"Iowa","Guthrie County",3,37,116,56,60
050,19,077,"Iowa","Guthrie County",3,38,119,51,68
050,19,077,"Iowa","Guthrie County",3,39,124,60,64
050,19,077,"Iowa","Guthrie County",3,40,116,60,56
050,19,077,"Iowa","Guthrie County",3,41,123,66,57
050,19,077,"Iowa","Guthrie County",3,42,124,60,64
050,19,077,"Iowa","Guthrie County",3,43,133,62,71
050,19,077,"Iowa","Guthrie County",3,44,141,74,67
050,19,077,"Iowa","Guthrie County",3,45,125,66,59
050,19,077,"Iowa","Guthrie County",3,46,110,62,48
050,19,077,"Iowa","Guthrie County",3,47,115,61,54
050,19,077,"Iowa","Guthrie County",3,48,111,55,56
050,19,077,"Iowa","Guthrie County",3,49,113,57,56
050,19,077,"Iowa","Guthrie County",3,50,136,71,65
050,19,077,"Iowa","Guthrie County",3,51,137,70,67
050,19,077,"Iowa","Guthrie County",3,52,131,65,66
050,19,077,"Iowa","Guthrie County",3,53,118,60,58
050,19,077,"Iowa","Guthrie County",3,54,129,66,63
050,19,077,"Iowa","Guthrie County",3,55,150,76,74
050,19,077,"Iowa","Guthrie County",3,56,163,79,84
050,19,077,"Iowa","Guthrie County",3,57,160,74,86
050,19,077,"Iowa","Guthrie County",3,58,170,85,85
050,19,077,"Iowa","Guthrie County",3,59,166,81,85
050,19,077,"Iowa","Guthrie County",3,60,191,102,89
050,19,077,"Iowa","Guthrie County",3,61,186,100,86
050,19,077,"Iowa","Guthrie County",3,62,178,91,87
050,19,077,"Iowa","Guthrie County",3,63,178,89,89
050,19,077,"Iowa","Guthrie County",3,64,168,73,95
050,19,077,"Iowa","Guthrie County",3,65,168,84,84
050,19,077,"Iowa","Guthrie County",3,66,168,91,77
050,19,077,"Iowa","Guthrie County",3,67,160,85,75
050,19,077,"Iowa","Guthrie County",3,68,174,94,80
050,19,077,"Iowa","Guthrie County",3,69,163,85,78
050,19,077,"Iowa","Guthrie County",3,70,145,74,71
050,19,077,"Iowa","Guthrie County",3,71,127,65,62
050,19,077,"Iowa","Guthrie County",3,72,124,64,60
050,19,077,"Iowa","Guthrie County",3,73,117,59,58
050,19,077,"Iowa","Guthrie County",3,74,114,62,52
050,19,077,"Iowa","Guthrie County",3,75,83,35,48
050,19,077,"Iowa","Guthrie County",3,76,91,40,51
050,19,077,"Iowa","Guthrie County",3,77,94,43,51
050,19,077,"Iowa","Guthrie County",3,78,88,38,50
050,19,077,"Iowa","Guthrie County",3,79,74,35,39
050,19,077,"Iowa","Guthrie County",3,80,62,32,30
050,19,077,"Iowa","Guthrie County",3,81,47,18,29
050,19,077,"Iowa","Guthrie County",3,82,56,21,35
050,19,077,"Iowa","Guthrie County",3,83,56,20,36
050,19,077,"Iowa","Guthrie County",3,84,50,23,27
050,19,077,"Iowa","Guthrie County",3,85,321,111,210
050,19,077,"Iowa","Guthrie County",4,0,94,58,36
050,19,077,"Iowa","Guthrie County",4,1,107,65,42
050,19,077,"Iowa","Guthrie County",4,2,105,52,53
050,19,077,"Iowa","Guthrie County",4,3,115,47,68
050,19,077,"Iowa","Guthrie County",4,4,122,64,58
050,19,077,"Iowa","Guthrie County",4,5,118,60,58
050,19,077,"Iowa","Guthrie County",4,6,133,69,64
050,19,077,"Iowa","Guthrie County",4,7,126,62,64
050,19,077,"Iowa","Guthrie County",4,8,108,53,55
050,19,077,"Iowa","Guthrie County",4,9,123,64,59
050,19,077,"Iowa","Guthrie County",4,10,127,66,61
050,19,077,"Iowa","Guthrie County",4,11,131,68,63
050,19,077,"Iowa","Guthrie County",4,12,136,68,68
050,19,077,"Iowa","Guthrie County",4,13,139,68,71
050,19,077,"Iowa","Guthrie County",4,14,140,73,67
050,19,077,"Iowa","Guthrie County",4,15,144,78,66
050,19,077,"Iowa","Guthrie County",4,16,148,71,77
050,19,077,"Iowa","Guthrie County",4,17,143,80,63
050,19,077,"Iowa","Guthrie County",4,18,132,72,60
050,19,077,"Iowa","Guthrie County",4,19,103,59,44
050,19,077,"Iowa","Guthrie County",4,20,102,54,48
050,19,077,"Iowa","Guthrie County",4,21,102,50,52
050,19,077,"Iowa","Guthrie County",4,22,115,58,57
050,19,077,"Iowa","Guthrie County",4,23,110,59,51
050,19,077,"Iowa","Guthrie County",4,24,88,46,42
050,19,077,"Iowa","Guthrie County",4,25,85,45,40
050,19,077,"Iowa","Guthrie County",4,26,101,49,52
050,19,077,"Iowa","Guthrie County",4,27,92,45,47
050,19,077,"Iowa","Guthrie County",4,28,98,47,51
050,19,077,"Iowa","Guthrie County",4,29,127,66,61
050,19,077,"Iowa","Guthrie County",4,30,106,54,52
050,19,077,"Iowa","Guthrie County",4,31,98,51,47
050,19,077,"Iowa","Guthrie County",4,32,95,47,48
050,19,077,"Iowa","Guthrie County",4,33,95,46,49
050,19,077,"Iowa","Guthrie County",4,34,101,53,48
050,19,077,"Iowa","Guthrie County",4,35,120,61,59
050,19,077,"Iowa","Guthrie County",4,36,102,60,42
050,19,077,"Iowa","Guthrie County",4,37,117,69,48
050,19,077,"Iowa","Guthrie County",4,38,117,52,65
050,19,077,"Iowa","Guthrie County",4,39,118,52,66
050,19,077,"Iowa","Guthrie County",4,40,129,61,68
050,19,077,"Iowa","Guthrie County",4,41,124,66,58
050,19,077,"Iowa","Guthrie County",4,42,126,69,57
050,19,077,"Iowa","Guthrie County",4,43,128,62,66
050,19,077,"Iowa","Guthrie County",4,44,132,63,69
050,19,077,"Iowa","Guthrie County",4,45,141,71,70
050,19,077,"Iowa","Guthrie County",4,46,123,64,59
050,19,077,"Iowa","Guthrie County",4,47,111,66,45
050,19,077,"Iowa","Guthrie County",4,48,121,63,58
050,19,077,"Iowa","Guthrie County",4,49,118,62,56
050,19,077,"Iowa","Guthrie County",4,50,106,54,52
050,19,077,"Iowa","Guthrie County",4,51,139,70,69
050,19,077,"Iowa","Guthrie County",4,52,137,68,69
050,19,077,"Iowa","Guthrie County",4,53,127,62,65
050,19,077,"Iowa","Guthrie County",4,54,111,58,53
050,19,077,"Iowa","Guthrie County",4,55,132,66,66
050,19,077,"Iowa","Guthrie County",4,56,154,82,72
050,19,077,"Iowa","Guthrie County",4,57,162,77,85
050,19,077,"Iowa","Guthrie County",4,58,156,73,83
050,19,077,"Iowa","Guthrie County",4,59,164,82,82
050,19,077,"Iowa","Guthrie County",4,60,164,80,84
050,19,077,"Iowa","Guthrie County",4,61,181,96,85
050,19,077,"Iowa","Guthrie County",4,62,183,104,79
050,19,077,"Iowa","Guthrie County",4,63,183,92,91
050,19,077,"Iowa","Guthrie County",4,64,181,86,95
050,19,077,"Iowa","Guthrie County",4,65,168,72,96
050,19,077,"Iowa","Guthrie County",4,66,171,83,88
050,19,077,"Iowa","Guthrie County",4,67,167,92,75
050,19,077,"Iowa","Guthrie County",4,68,160,84,76
050,19,077,"Iowa","Guthrie County",4,69,173,91,82
050,19,077,"Iowa","Guthrie County",4,70,160,82,78
050,19,077,"Iowa","Guthrie County",4,71,148,75,73
050,19,077,"Iowa","Guthrie County",4,72,127,66,61
050,19,077,"Iowa","Guthrie County",4,73,120,62,58
050,19,077,"Iowa","Guthrie County",4,74,118,60,58
050,19,077,"Iowa","Guthrie County",4,75,106,54,52
050,19,077,"Iowa","Guthrie County",4,76,79,33,46
050,19,077,"Iowa","Guthrie County",4,77,91,38,53
050,19,077,"Iowa","Guthrie County",4,78,88,40,48
050,19,077,"Iowa","Guthrie County",4,79,85,35,50
050,19,077,"Iowa","Guthrie County",4,80,72,33,39
050,19,077,"Iowa","Guthrie County",4,81,60,31,29
050,19,077,"Iowa","Guthrie County",4,82,45,20,25
050,19,077,"Iowa","Guthrie County",4,83,55,20,35
050,19,077,"Iowa","Guthrie County",4,84,51,21,30
050,19,077,"Iowa","Guthrie County",4,85,321,112,209
050,19,077,"Iowa","Guthrie County",5,0,95,58,37
050,19,077,"Iowa","Guthrie County",5,1,97,58,39
050,19,077,"Iowa","Guthrie County",5,2,114,71,43
050,19,077,"Iowa","Guthrie County",5,3,113,49,64
050,19,077,"Iowa","Guthrie County",5,4,125,56,69
050,19,077,"Iowa","Guthrie County",5,5,125,66,59
050,19,077,"Iowa","Guthrie County",5,6,129,64,65
050,19,077,"Iowa","Guthrie County",5,7,140,74,66
050,19,077,"Iowa","Guthrie County",5,8,128,65,63
050,19,077,"Iowa","Guthrie County",5,9,116,57,59
050,19,077,"Iowa","Guthrie County",5,10,131,65,66
050,19,077,"Iowa","Guthrie County",5,11,129,68,61
050,19,077,"Iowa","Guthrie County",5,12,134,68,66
050,19,077,"Iowa","Guthrie County",5,13,136,70,66
050,19,077,"Iowa","Guthrie County",5,14,140,69,71
050,19,077,"Iowa","Guthrie County",5,15,130,71,59
050,19,077,"Iowa","Guthrie County",5,16,139,80,59
050,19,077,"Iowa","Guthrie County",5,17,147,72,75
050,19,077,"Iowa","Guthrie County",5,18,119,68,51
050,19,077,"Iowa","Guthrie County",5,19,95,52,43
050,19,077,"Iowa","Guthrie County",5,20,107,58,49
050,19,077,"Iowa","Guthrie County",5,21,98,47,51
050,19,077,"Iowa","Guthrie County",5,22,101,46,55
050,19,077,"Iowa","Guthrie County",5,23,107,56,51
050,19,077,"Iowa","Guthrie County",5,24,106,58,48
050,19,077,"Iowa","Guthrie County",5,25,93,47,46
050,19,077,"Iowa","Guthrie County",5,26,107,55,52
050,19,077,"Iowa","Guthrie County",5,27,101,53,48
050,19,077,"Iowa","Guthrie County",5,28,95,47,48
050,19,077,"Iowa","Guthrie County",5,29,106,53,53
050,19,077,"Iowa","Guthrie County",5,30,128,67,61
050,19,077,"Iowa","Guthrie County",5,31,115,56,59
050,19,077,"Iowa","Guthrie County",5,32,103,51,52
050,19,077,"Iowa","Guthrie County",5,33,98,49,49
050,19,077,"Iowa","Guthrie County",5,34,93,42,51
050,19,077,"Iowa","Guthrie County",5,35,109,61,48
050,19,077,"Iowa","Guthrie County",5,36,131,68,63
050,19,077,"Iowa","Guthrie County",5,37,99,59,40
050,19,077,"Iowa","Guthrie County",5,38,119,68,51
050,19,077,"Iowa","Guthrie County",5,39,112,50,62
050,19,077,"Iowa","Guthrie County",5,40,116,50,66
050,19,077,"Iowa","Guthrie County",5,41,136,68,68
050,19,077,"Iowa","Guthrie County",5,42,122,67,55
050,19,077,"Iowa","Guthrie County",5,43,125,70,55
050,19,077,"Iowa","Guthrie County",5,44,133,64,69
050,19,077,"Iowa","Guthrie County",5,45,126,61,65
050,19,077,"Iowa","Guthrie County",5,46,137,68,69
050,19,077,"Iowa","Guthrie County",5,47,124,64,60
050,19,077,"Iowa","Guthrie County",5,48,114,65,49
050,19,077,"Iowa","Guthrie County",5,49,111,57,54
050,19,077,"Iowa","Guthrie County",5,50,115,61,54
050,19,077,"Iowa","Guthrie County",5,51,107,54,53
050,19,077,"Iowa","Guthrie County",5,52,138,68,70
050,19,077,"Iowa","Guthrie County",5,53,136,71,65
050,19,077,"Iowa","Guthrie County",5,54,122,58,64
050,19,077,"Iowa","Guthrie County",5,55,118,62,56
050,19,077,"Iowa","Guthrie County",5,56,133,65,68
050,19,077,"Iowa","Guthrie County",5,57,159,84,75
050,19,077,"Iowa","Guthrie County",5,58,160,75,85
050,19,077,"Iowa","Guthrie County",5,59,162,74,88
050,19,077,"Iowa","Guthrie County",5,60,163,83,80
050,19,077,"Iowa","Guthrie County",5,61,168,82,86
050,19,077,"Iowa","Guthrie County",5,62,189,99,90
050,19,077,"Iowa","Guthrie County",5,63,183,104,79
050,19,077,"Iowa","Guthrie County",5,64,185,88,97
050,19,077,"Iowa","Guthrie County",5,65,182,85,97
050,19,077,"Iowa","Guthrie County",5,66,166,69,97
050,19,077,"Iowa","Guthrie County",5,67,171,87,84
050,19,077,"Iowa","Guthrie County",5,68,163,89,74
050,19,077,"Iowa","Guthrie County",5,69,154,80,74
050,19,077,"Iowa","Guthrie County",5,70,172,89,83
050,19,077,"Iowa","Guthrie County",5,71,163,83,80
050,19,077,"Iowa","Guthrie County",5,72,144,75,69
050,19,077,"Iowa","Guthrie County",5,73,124,63,61
050,19,077,"Iowa","Guthrie County",5,74,117,62,55
050,19,077,"Iowa","Guthrie County",5,75,111,53,58
050,19,077,"Iowa","Guthrie County",5,76,96,48,48
050,19,077,"Iowa","Guthrie County",5,77,78,32,46
050,19,077,"Iowa","Guthrie County",5,78,79,34,45
050,19,077,"Iowa","Guthrie County",5,79,84,37,47
050,19,077,"Iowa","Guthrie County",5,80,82,35,47
050,19,077,"Iowa","Guthrie County",5,81,66,28,38
050,19,077,"Iowa","Guthrie County",5,82,57,30,27
050,19,077,"Iowa","Guthrie County",5,83,47,19,28
050,19,077,"Iowa","Guthrie County",5,84,51,18,33
050,19,077,"Iowa","Guthrie County",5,85,323,114,209
050,19,079,"Iowa","Hamilton County",1,0,180,92,88
050,19,079,"Iowa","Hamilton County",1,1,179,93,86
050,19,079,"Iowa","Hamilton County",1,2,195,104,91
050,19,079,"Iowa","Hamilton County",1,3,194,102,92
050,19,079,"Iowa","Hamilton County",1,4,216,108,108
050,19,079,"Iowa","Hamilton County",1,5,198,103,95
050,19,079,"Iowa","Hamilton County",1,6,189,92,97
050,19,079,"Iowa","Hamilton County",1,7,178,89,89
050,19,079,"Iowa","Hamilton County",1,8,175,76,99
050,19,079,"Iowa","Hamilton County",1,9,187,87,100
050,19,079,"Iowa","Hamilton County",1,10,202,116,86
050,19,079,"Iowa","Hamilton County",1,11,213,111,102
050,19,079,"Iowa","Hamilton County",1,12,208,103,105
050,19,079,"Iowa","Hamilton County",1,13,218,119,99
050,19,079,"Iowa","Hamilton County",1,14,233,118,115
050,19,079,"Iowa","Hamilton County",1,15,207,116,91
050,19,079,"Iowa","Hamilton County",1,16,210,114,96
050,19,079,"Iowa","Hamilton County",1,17,204,104,100
050,19,079,"Iowa","Hamilton County",1,18,153,78,75
050,19,079,"Iowa","Hamilton County",1,19,139,71,68
050,19,079,"Iowa","Hamilton County",1,20,150,80,70
050,19,079,"Iowa","Hamilton County",1,21,151,72,79
050,19,079,"Iowa","Hamilton County",1,22,171,91,80
050,19,079,"Iowa","Hamilton County",1,23,163,87,76
050,19,079,"Iowa","Hamilton County",1,24,162,86,76
050,19,079,"Iowa","Hamilton County",1,25,134,72,62
050,19,079,"Iowa","Hamilton County",1,26,143,70,73
050,19,079,"Iowa","Hamilton County",1,27,151,72,79
050,19,079,"Iowa","Hamilton County",1,28,153,79,74
050,19,079,"Iowa","Hamilton County",1,29,151,77,74
050,19,079,"Iowa","Hamilton County",1,30,174,88,86
050,19,079,"Iowa","Hamilton County",1,31,144,72,72
050,19,079,"Iowa","Hamilton County",1,32,159,86,73
050,19,079,"Iowa","Hamilton County",1,33,152,80,72
050,19,079,"Iowa","Hamilton County",1,34,193,103,90
050,19,079,"Iowa","Hamilton County",1,35,160,88,72
050,19,079,"Iowa","Hamilton County",1,36,161,83,78
050,19,079,"Iowa","Hamilton County",1,37,188,97,91
050,19,079,"Iowa","Hamilton County",1,38,221,115,106
050,19,079,"Iowa","Hamilton County",1,39,190,99,91
050,19,079,"Iowa","Hamilton County",1,40,186,83,103
050,19,079,"Iowa","Hamilton County",1,41,171,79,92
050,19,079,"Iowa","Hamilton County",1,42,162,79,83
050,19,079,"Iowa","Hamilton County",1,43,174,87,87
050,19,079,"Iowa","Hamilton County",1,44,160,77,83
050,19,079,"Iowa","Hamilton County",1,45,177,92,85
050,19,079,"Iowa","Hamilton County",1,46,173,98,75
050,19,079,"Iowa","Hamilton County",1,47,171,95,76
050,19,079,"Iowa","Hamilton County",1,48,166,94,72
050,19,079,"Iowa","Hamilton County",1,49,179,93,86
050,19,079,"Iowa","Hamilton County",1,50,189,92,97
050,19,079,"Iowa","Hamilton County",1,51,166,87,79
050,19,079,"Iowa","Hamilton County",1,52,170,89,81
050,19,079,"Iowa","Hamilton County",1,53,171,89,82
050,19,079,"Iowa","Hamilton County",1,54,197,102,95
050,19,079,"Iowa","Hamilton County",1,55,217,112,105
050,19,079,"Iowa","Hamilton County",1,56,224,130,94
050,19,079,"Iowa","Hamilton County",1,57,218,112,106
050,19,079,"Iowa","Hamilton County",1,58,228,119,109
050,19,079,"Iowa","Hamilton County",1,59,233,122,111
050,19,079,"Iowa","Hamilton County",1,60,229,116,113
050,19,079,"Iowa","Hamilton County",1,61,243,125,118
050,19,079,"Iowa","Hamilton County",1,62,237,115,122
050,19,079,"Iowa","Hamilton County",1,63,218,118,100
050,19,079,"Iowa","Hamilton County",1,64,210,110,100
050,19,079,"Iowa","Hamilton County",1,65,175,81,94
050,19,079,"Iowa","Hamilton County",1,66,199,93,106
050,19,079,"Iowa","Hamilton County",1,67,194,92,102
050,19,079,"Iowa","Hamilton County",1,68,185,94,91
050,19,079,"Iowa","Hamilton County",1,69,156,79,77
050,19,079,"Iowa","Hamilton County",1,70,168,84,84
050,19,079,"Iowa","Hamilton County",1,71,155,84,71
050,19,079,"Iowa","Hamilton County",1,72,148,79,69
050,19,079,"Iowa","Hamilton County",1,73,160,78,82
050,19,079,"Iowa","Hamilton County",1,74,116,52,64
050,19,079,"Iowa","Hamilton County",1,75,108,48,60
050,19,079,"Iowa","Hamilton County",1,76,96,48,48
050,19,079,"Iowa","Hamilton County",1,77,108,56,52
050,19,079,"Iowa","Hamilton County",1,78,102,47,55
050,19,079,"Iowa","Hamilton County",1,79,86,35,51
050,19,079,"Iowa","Hamilton County",1,80,70,34,36
050,19,079,"Iowa","Hamilton County",1,81,72,37,35
050,19,079,"Iowa","Hamilton County",1,82,70,28,42
050,19,079,"Iowa","Hamilton County",1,83,76,28,48
050,19,079,"Iowa","Hamilton County",1,84,82,28,54
050,19,079,"Iowa","Hamilton County",1,85,493,163,330
050,19,079,"Iowa","Hamilton County",2,0,174,90,84
050,19,079,"Iowa","Hamilton County",2,1,179,91,88
050,19,079,"Iowa","Hamilton County",2,2,191,101,90
050,19,079,"Iowa","Hamilton County",2,3,192,102,90
050,19,079,"Iowa","Hamilton County",2,4,212,109,103
050,19,079,"Iowa","Hamilton County",2,5,201,104,97
050,19,079,"Iowa","Hamilton County",2,6,190,95,95
050,19,079,"Iowa","Hamilton County",2,7,180,89,91
050,19,079,"Iowa","Hamilton County",2,8,173,78,95
050,19,079,"Iowa","Hamilton County",2,9,185,87,98
050,19,079,"Iowa","Hamilton County",2,10,200,111,89
050,19,079,"Iowa","Hamilton County",2,11,209,112,97
050,19,079,"Iowa","Hamilton County",2,12,210,105,105
050,19,079,"Iowa","Hamilton County",2,13,217,116,101
050,19,079,"Iowa","Hamilton County",2,14,232,122,110
050,19,079,"Iowa","Hamilton County",2,15,215,118,97
050,19,079,"Iowa","Hamilton County",2,16,210,115,95
050,19,079,"Iowa","Hamilton County",2,17,205,105,100
050,19,079,"Iowa","Hamilton County",2,18,155,79,76
050,19,079,"Iowa","Hamilton County",2,19,134,69,65
050,19,079,"Iowa","Hamilton County",2,20,151,79,72
050,19,079,"Iowa","Hamilton County",2,21,152,75,77
050,19,079,"Iowa","Hamilton County",2,22,166,86,80
050,19,079,"Iowa","Hamilton County",2,23,167,89,78
050,19,079,"Iowa","Hamilton County",2,24,162,86,76
050,19,079,"Iowa","Hamilton County",2,25,144,77,67
050,19,079,"Iowa","Hamilton County",2,26,143,72,71
050,19,079,"Iowa","Hamilton County",2,27,151,74,77
050,19,079,"Iowa","Hamilton County",2,28,150,77,73
050,19,079,"Iowa","Hamilton County",2,29,153,78,75
050,19,079,"Iowa","Hamilton County",2,30,169,86,83
050,19,079,"Iowa","Hamilton County",2,31,150,75,75
050,19,079,"Iowa","Hamilton County",2,32,156,83,73
050,19,079,"Iowa","Hamilton County",2,33,153,81,72
050,19,079,"Iowa","Hamilton County",2,34,182,97,85
050,19,079,"Iowa","Hamilton County",2,35,169,94,75
050,19,079,"Iowa","Hamilton County",2,36,160,84,76
050,19,079,"Iowa","Hamilton County",2,37,184,95,89
050,19,079,"Iowa","Hamilton County",2,38,212,109,103
050,19,079,"Iowa","Hamilton County",2,39,196,102,94
050,19,079,"Iowa","Hamilton County",2,40,189,88,101
050,19,079,"Iowa","Hamilton County",2,41,172,80,92
050,19,079,"Iowa","Hamilton County",2,42,160,78,82
050,19,079,"Iowa","Hamilton County",2,43,170,84,86
050,19,079,"Iowa","Hamilton County",2,44,163,80,83
050,19,079,"Iowa","Hamilton County",2,45,174,88,86
050,19,079,"Iowa","Hamilton County",2,46,175,96,79
050,19,079,"Iowa","Hamilton County",2,47,172,95,77
050,19,079,"Iowa","Hamilton County",2,48,167,96,71
050,19,079,"Iowa","Hamilton County",2,49,176,94,82
050,19,079,"Iowa","Hamilton County",2,50,187,93,94
050,19,079,"Iowa","Hamilton County",2,51,170,87,83
050,19,079,"Iowa","Hamilton County",2,52,170,89,81
050,19,079,"Iowa","Hamilton County",2,53,169,88,81
050,19,079,"Iowa","Hamilton County",2,54,190,98,92
050,19,079,"Iowa","Hamilton County",2,55,213,109,104
050,19,079,"Iowa","Hamilton County",2,56,223,125,98
050,19,079,"Iowa","Hamilton County",2,57,219,116,103
050,19,079,"Iowa","Hamilton County",2,58,224,117,107
050,19,079,"Iowa","Hamilton County",2,59,233,122,111
050,19,079,"Iowa","Hamilton County",2,60,229,118,111
050,19,079,"Iowa","Hamilton County",2,61,237,120,117
050,19,079,"Iowa","Hamilton County",2,62,237,117,120
050,19,079,"Iowa","Hamilton County",2,63,224,118,106
050,19,079,"Iowa","Hamilton County",2,64,207,109,98
050,19,079,"Iowa","Hamilton County",2,65,181,87,94
050,19,079,"Iowa","Hamilton County",2,66,191,89,102
050,19,079,"Iowa","Hamilton County",2,67,192,91,101
050,19,079,"Iowa","Hamilton County",2,68,184,91,93
050,19,079,"Iowa","Hamilton County",2,69,165,84,81
050,19,079,"Iowa","Hamilton County",2,70,163,81,82
050,19,079,"Iowa","Hamilton County",2,71,158,85,73
050,19,079,"Iowa","Hamilton County",2,72,145,77,68
050,19,079,"Iowa","Hamilton County",2,73,167,83,84
050,19,079,"Iowa","Hamilton County",2,74,117,53,64
050,19,079,"Iowa","Hamilton County",2,75,111,49,62
050,19,079,"Iowa","Hamilton County",2,76,97,47,50
050,19,079,"Iowa","Hamilton County",2,77,108,55,53
050,19,079,"Iowa","Hamilton County",2,78,102,48,54
050,19,079,"Iowa","Hamilton County",2,79,86,36,50
050,19,079,"Iowa","Hamilton County",2,80,73,34,39
050,19,079,"Iowa","Hamilton County",2,81,65,31,34
050,19,079,"Iowa","Hamilton County",2,82,70,30,40
050,19,079,"Iowa","Hamilton County",2,83,73,29,44
050,19,079,"Iowa","Hamilton County",2,84,81,28,53
050,19,079,"Iowa","Hamilton County",2,85,495,164,331
050,19,079,"Iowa","Hamilton County",3,0,153,82,71
050,19,079,"Iowa","Hamilton County",3,1,176,97,79
050,19,079,"Iowa","Hamilton County",3,2,178,91,87
050,19,079,"Iowa","Hamilton County",3,3,198,108,90
050,19,079,"Iowa","Hamilton County",3,4,189,98,91
050,19,079,"Iowa","Hamilton County",3,5,219,121,98
050,19,079,"Iowa","Hamilton County",3,6,202,103,99
050,19,079,"Iowa","Hamilton County",3,7,196,99,97
050,19,079,"Iowa","Hamilton County",3,8,175,82,93
050,19,079,"Iowa","Hamilton County",3,9,177,79,98
050,19,079,"Iowa","Hamilton County",3,10,190,90,100
050,19,079,"Iowa","Hamilton County",3,11,210,113,97
050,19,079,"Iowa","Hamilton County",3,12,200,104,96
050,19,079,"Iowa","Hamilton County",3,13,208,102,106
050,19,079,"Iowa","Hamilton County",3,14,211,116,95
050,19,079,"Iowa","Hamilton County",3,15,221,113,108
050,19,079,"Iowa","Hamilton County",3,16,206,114,92
050,19,079,"Iowa","Hamilton County",3,17,217,117,100
050,19,079,"Iowa","Hamilton County",3,18,172,88,84
050,19,079,"Iowa","Hamilton County",3,19,121,61,60
050,19,079,"Iowa","Hamilton County",3,20,136,69,67
050,19,079,"Iowa","Hamilton County",3,21,146,78,68
050,19,079,"Iowa","Hamilton County",3,22,145,72,73
050,19,079,"Iowa","Hamilton County",3,23,165,85,80
050,19,079,"Iowa","Hamilton County",3,24,150,76,74
050,19,079,"Iowa","Hamilton County",3,25,166,89,77
050,19,079,"Iowa","Hamilton County",3,26,148,83,65
050,19,079,"Iowa","Hamilton County",3,27,137,66,71
050,19,079,"Iowa","Hamilton County",3,28,167,82,85
050,19,079,"Iowa","Hamilton County",3,29,145,73,72
050,19,079,"Iowa","Hamilton County",3,30,146,72,74
050,19,079,"Iowa","Hamilton County",3,31,180,90,90
050,19,079,"Iowa","Hamilton County",3,32,150,73,77
050,19,079,"Iowa","Hamilton County",3,33,151,81,70
050,19,079,"Iowa","Hamilton County",3,34,156,83,73
050,19,079,"Iowa","Hamilton County",3,35,184,100,84
050,19,079,"Iowa","Hamilton County",3,36,162,87,75
050,19,079,"Iowa","Hamilton County",3,37,157,81,76
050,19,079,"Iowa","Hamilton County",3,38,180,92,88
050,19,079,"Iowa","Hamilton County",3,39,203,104,99
050,19,079,"Iowa","Hamilton County",3,40,189,100,89
050,19,079,"Iowa","Hamilton County",3,41,186,89,97
050,19,079,"Iowa","Hamilton County",3,42,175,78,97
050,19,079,"Iowa","Hamilton County",3,43,166,80,86
050,19,079,"Iowa","Hamilton County",3,44,173,83,90
050,19,079,"Iowa","Hamilton County",3,45,156,75,81
050,19,079,"Iowa","Hamilton County",3,46,170,81,89
050,19,079,"Iowa","Hamilton County",3,47,175,96,79
050,19,079,"Iowa","Hamilton County",3,48,161,89,72
050,19,079,"Iowa","Hamilton County",3,49,166,94,72
050,19,079,"Iowa","Hamilton County",3,50,184,98,86
050,19,079,"Iowa","Hamilton County",3,51,191,93,98
050,19,079,"Iowa","Hamilton County",3,52,170,87,83
050,19,079,"Iowa","Hamilton County",3,53,173,89,84
050,19,079,"Iowa","Hamilton County",3,54,172,90,82
050,19,079,"Iowa","Hamilton County",3,55,190,97,93
050,19,079,"Iowa","Hamilton County",3,56,212,109,103
050,19,079,"Iowa","Hamilton County",3,57,227,122,105
050,19,079,"Iowa","Hamilton County",3,58,215,115,100
050,19,079,"Iowa","Hamilton County",3,59,229,123,106
050,19,079,"Iowa","Hamilton County",3,60,229,122,107
050,19,079,"Iowa","Hamilton County",3,61,233,119,114
050,19,079,"Iowa","Hamilton County",3,62,238,122,116
050,19,079,"Iowa","Hamilton County",3,63,232,118,114
050,19,079,"Iowa","Hamilton County",3,64,208,108,100
050,19,079,"Iowa","Hamilton County",3,65,200,103,97
050,19,079,"Iowa","Hamilton County",3,66,176,84,92
050,19,079,"Iowa","Hamilton County",3,67,183,84,99
050,19,079,"Iowa","Hamilton County",3,68,187,89,98
050,19,079,"Iowa","Hamilton County",3,69,183,87,96
050,19,079,"Iowa","Hamilton County",3,70,160,80,80
050,19,079,"Iowa","Hamilton County",3,71,162,82,80
050,19,079,"Iowa","Hamilton County",3,72,151,78,73
050,19,079,"Iowa","Hamilton County",3,73,143,76,67
050,19,079,"Iowa","Hamilton County",3,74,155,73,82
050,19,079,"Iowa","Hamilton County",3,75,123,57,66
050,19,079,"Iowa","Hamilton County",3,76,97,41,56
050,19,079,"Iowa","Hamilton County",3,77,100,48,52
050,19,079,"Iowa","Hamilton County",3,78,104,54,50
050,19,079,"Iowa","Hamilton County",3,79,99,46,53
050,19,079,"Iowa","Hamilton County",3,80,77,33,44
050,19,079,"Iowa","Hamilton County",3,81,69,30,39
050,19,079,"Iowa","Hamilton County",3,82,59,28,31
050,19,079,"Iowa","Hamilton County",3,83,62,26,36
050,19,079,"Iowa","Hamilton County",3,84,65,23,42
050,19,079,"Iowa","Hamilton County",3,85,495,159,336
050,19,079,"Iowa","Hamilton County",4,0,174,80,94
050,19,079,"Iowa","Hamilton County",4,1,167,94,73
050,19,079,"Iowa","Hamilton County",4,2,193,107,86
050,19,079,"Iowa","Hamilton County",4,3,187,93,94
050,19,079,"Iowa","Hamilton County",4,4,200,107,93
050,19,079,"Iowa","Hamilton County",4,5,189,97,92
050,19,079,"Iowa","Hamilton County",4,6,213,119,94
050,19,079,"Iowa","Hamilton County",4,7,204,106,98
050,19,079,"Iowa","Hamilton County",4,8,196,100,96
050,19,079,"Iowa","Hamilton County",4,9,176,86,90
050,19,079,"Iowa","Hamilton County",4,10,178,84,94
050,19,079,"Iowa","Hamilton County",4,11,183,88,95
050,19,079,"Iowa","Hamilton County",4,12,207,110,97
050,19,079,"Iowa","Hamilton County",4,13,198,101,97
050,19,079,"Iowa","Hamilton County",4,14,199,96,103
050,19,079,"Iowa","Hamilton County",4,15,206,114,92
050,19,079,"Iowa","Hamilton County",4,16,221,117,104
050,19,079,"Iowa","Hamilton County",4,17,208,112,96
050,19,079,"Iowa","Hamilton County",4,18,185,103,82
050,19,079,"Iowa","Hamilton County",4,19,131,65,66
050,19,079,"Iowa","Hamilton County",4,20,128,66,62
050,19,079,"Iowa","Hamilton County",4,21,137,68,69
050,19,079,"Iowa","Hamilton County",4,22,147,80,67
050,19,079,"Iowa","Hamilton County",4,23,159,79,80
050,19,079,"Iowa","Hamilton County",4,24,161,79,82
050,19,079,"Iowa","Hamilton County",4,25,157,82,75
050,19,079,"Iowa","Hamilton County",4,26,169,96,73
050,19,079,"Iowa","Hamilton County",4,27,148,81,67
050,19,079,"Iowa","Hamilton County",4,28,143,73,70
050,19,079,"Iowa","Hamilton County",4,29,163,84,79
050,19,079,"Iowa","Hamilton County",4,30,143,67,76
050,19,079,"Iowa","Hamilton County",4,31,155,79,76
050,19,079,"Iowa","Hamilton County",4,32,180,93,87
050,19,079,"Iowa","Hamilton County",4,33,153,76,77
050,19,079,"Iowa","Hamilton County",4,34,156,84,72
050,19,079,"Iowa","Hamilton County",4,35,150,80,70
050,19,079,"Iowa","Hamilton County",4,36,177,95,82
050,19,079,"Iowa","Hamilton County",4,37,174,89,85
050,19,079,"Iowa","Hamilton County",4,38,152,78,74
050,19,079,"Iowa","Hamilton County",4,39,182,90,92
050,19,079,"Iowa","Hamilton County",4,40,190,104,86
050,19,079,"Iowa","Hamilton County",4,41,189,96,93
050,19,079,"Iowa","Hamilton County",4,42,179,86,93
050,19,079,"Iowa","Hamilton County",4,43,169,77,92
050,19,079,"Iowa","Hamilton County",4,44,171,84,87
050,19,079,"Iowa","Hamilton County",4,45,173,83,90
050,19,079,"Iowa","Hamilton County",4,46,152,73,79
050,19,079,"Iowa","Hamilton County",4,47,174,85,89
050,19,079,"Iowa","Hamilton County",4,48,178,99,79
050,19,079,"Iowa","Hamilton County",4,49,156,87,69
050,19,079,"Iowa","Hamilton County",4,50,171,94,77
050,19,079,"Iowa","Hamilton County",4,51,184,96,88
050,19,079,"Iowa","Hamilton County",4,52,189,92,97
050,19,079,"Iowa","Hamilton County",4,53,168,84,84
050,19,079,"Iowa","Hamilton County",4,54,174,92,82
050,19,079,"Iowa","Hamilton County",4,55,168,89,79
050,19,079,"Iowa","Hamilton County",4,56,181,93,88
050,19,079,"Iowa","Hamilton County",4,57,211,107,104
050,19,079,"Iowa","Hamilton County",4,58,228,124,104
050,19,079,"Iowa","Hamilton County",4,59,217,113,104
050,19,079,"Iowa","Hamilton County",4,60,233,125,108
050,19,079,"Iowa","Hamilton County",4,61,226,116,110
050,19,079,"Iowa","Hamilton County",4,62,225,111,114
050,19,079,"Iowa","Hamilton County",4,63,235,124,111
050,19,079,"Iowa","Hamilton County",4,64,225,116,109
050,19,079,"Iowa","Hamilton County",4,65,200,106,94
050,19,079,"Iowa","Hamilton County",4,66,194,98,96
050,19,079,"Iowa","Hamilton County",4,67,163,78,85
050,19,079,"Iowa","Hamilton County",4,68,183,83,100
050,19,079,"Iowa","Hamilton County",4,69,182,85,97
050,19,079,"Iowa","Hamilton County",4,70,169,77,92
050,19,079,"Iowa","Hamilton County",4,71,157,80,77
050,19,079,"Iowa","Hamilton County",4,72,158,78,80
050,19,079,"Iowa","Hamilton County",4,73,152,79,73
050,19,079,"Iowa","Hamilton County",4,74,132,70,62
050,19,079,"Iowa","Hamilton County",4,75,154,73,81
050,19,079,"Iowa","Hamilton County",4,76,108,47,61
050,19,079,"Iowa","Hamilton County",4,77,98,41,57
050,19,079,"Iowa","Hamilton County",4,78,99,49,50
050,19,079,"Iowa","Hamilton County",4,79,104,53,51
050,19,079,"Iowa","Hamilton County",4,80,92,44,48
050,19,079,"Iowa","Hamilton County",4,81,73,28,45
050,19,079,"Iowa","Hamilton County",4,82,63,26,37
050,19,079,"Iowa","Hamilton County",4,83,61,29,32
050,19,079,"Iowa","Hamilton County",4,84,57,22,35
050,19,079,"Iowa","Hamilton County",4,85,489,156,333
050,19,079,"Iowa","Hamilton County",5,0,180,84,96
050,19,079,"Iowa","Hamilton County",5,1,176,82,94
050,19,079,"Iowa","Hamilton County",5,2,161,88,73
050,19,079,"Iowa","Hamilton County",5,3,192,102,90
050,19,079,"Iowa","Hamilton County",5,4,183,88,95
050,19,079,"Iowa","Hamilton County",5,5,205,107,98
050,19,079,"Iowa","Hamilton County",5,6,189,92,97
050,19,079,"Iowa","Hamilton County",5,7,205,110,95
050,19,079,"Iowa","Hamilton County",5,8,196,100,96
050,19,079,"Iowa","Hamilton County",5,9,193,106,87
050,19,079,"Iowa","Hamilton County",5,10,183,89,94
050,19,079,"Iowa","Hamilton County",5,11,181,84,97
050,19,079,"Iowa","Hamilton County",5,12,190,91,99
050,19,079,"Iowa","Hamilton County",5,13,210,105,105
050,19,079,"Iowa","Hamilton County",5,14,195,102,93
050,19,079,"Iowa","Hamilton County",5,15,209,104,105
050,19,079,"Iowa","Hamilton County",5,16,201,110,91
050,19,079,"Iowa","Hamilton County",5,17,221,117,104
050,19,079,"Iowa","Hamilton County",5,18,166,98,68
050,19,079,"Iowa","Hamilton County",5,19,150,87,63
050,19,079,"Iowa","Hamilton County",5,20,130,70,60
050,19,079,"Iowa","Hamilton County",5,21,132,63,69
050,19,079,"Iowa","Hamilton County",5,22,139,68,71
050,19,079,"Iowa","Hamilton County",5,23,157,88,69
050,19,079,"Iowa","Hamilton County",5,24,154,76,78
050,19,079,"Iowa","Hamilton County",5,25,161,81,80
050,19,079,"Iowa","Hamilton County",5,26,157,84,73
050,19,079,"Iowa","Hamilton County",5,27,171,98,73
050,19,079,"Iowa","Hamilton County",5,28,148,80,68
050,19,079,"Iowa","Hamilton County",5,29,139,72,67
050,19,079,"Iowa","Hamilton County",5,30,156,77,79
050,19,079,"Iowa","Hamilton County",5,31,148,69,79
050,19,079,"Iowa","Hamilton County",5,32,161,84,77
050,19,079,"Iowa","Hamilton County",5,33,174,87,87
050,19,079,"Iowa","Hamilton County",5,34,161,80,81
050,19,079,"Iowa","Hamilton County",5,35,159,87,72
050,19,079,"Iowa","Hamilton County",5,36,158,88,70
050,19,079,"Iowa","Hamilton County",5,37,176,95,81
050,19,079,"Iowa","Hamilton County",5,38,179,92,87
050,19,079,"Iowa","Hamilton County",5,39,165,87,78
050,19,079,"Iowa","Hamilton County",5,40,178,86,92
050,19,079,"Iowa","Hamilton County",5,41,189,102,87
050,19,079,"Iowa","Hamilton County",5,42,191,96,95
050,19,079,"Iowa","Hamilton County",5,43,182,90,92
050,19,079,"Iowa","Hamilton County",5,44,169,75,94
050,19,079,"Iowa","Hamilton County",5,45,162,79,83
050,19,079,"Iowa","Hamilton County",5,46,180,87,93
050,19,079,"Iowa","Hamilton County",5,47,152,72,80
050,19,079,"Iowa","Hamilton County",5,48,172,85,87
050,19,079,"Iowa","Hamilton County",5,49,178,102,76
050,19,079,"Iowa","Hamilton County",5,50,152,84,68
050,19,079,"Iowa","Hamilton County",5,51,162,90,72
050,19,079,"Iowa","Hamilton County",5,52,184,96,88
050,19,079,"Iowa","Hamilton County",5,53,186,89,97
050,19,079,"Iowa","Hamilton County",5,54,169,85,84
050,19,079,"Iowa","Hamilton County",5,55,177,92,85
050,19,079,"Iowa","Hamilton County",5,56,159,84,75
050,19,079,"Iowa","Hamilton County",5,57,178,93,85
050,19,079,"Iowa","Hamilton County",5,58,203,102,101
050,19,079,"Iowa","Hamilton County",5,59,224,122,102
050,19,079,"Iowa","Hamilton County",5,60,211,109,102
050,19,079,"Iowa","Hamilton County",5,61,229,118,111
050,19,079,"Iowa","Hamilton County",5,62,222,112,110
050,19,079,"Iowa","Hamilton County",5,63,216,109,107
050,19,079,"Iowa","Hamilton County",5,64,224,119,105
050,19,079,"Iowa","Hamilton County",5,65,220,111,109
050,19,079,"Iowa","Hamilton County",5,66,198,109,89
050,19,079,"Iowa","Hamilton County",5,67,187,92,95
050,19,079,"Iowa","Hamilton County",5,68,168,80,88
050,19,079,"Iowa","Hamilton County",5,69,183,83,100
050,19,079,"Iowa","Hamilton County",5,70,175,79,96
050,19,079,"Iowa","Hamilton County",5,71,167,79,88
050,19,079,"Iowa","Hamilton County",5,72,147,74,73
050,19,079,"Iowa","Hamilton County",5,73,154,77,77
050,19,079,"Iowa","Hamilton County",5,74,145,71,74
050,19,079,"Iowa","Hamilton County",5,75,135,72,63
050,19,079,"Iowa","Hamilton County",5,76,140,64,76
050,19,079,"Iowa","Hamilton County",5,77,110,49,61
050,19,079,"Iowa","Hamilton County",5,78,96,42,54
050,19,079,"Iowa","Hamilton County",5,79,96,46,50
050,19,079,"Iowa","Hamilton County",5,80,97,51,46
050,19,079,"Iowa","Hamilton County",5,81,83,38,45
050,19,079,"Iowa","Hamilton County",5,82,68,24,44
050,19,079,"Iowa","Hamilton County",5,83,60,25,35
050,19,079,"Iowa","Hamilton County",5,84,56,25,31
050,19,079,"Iowa","Hamilton County",5,85,484,158,326
050,19,081,"Iowa","Hancock County",1,0,113,58,55
050,19,081,"Iowa","Hancock County",1,1,113,57,56
050,19,081,"Iowa","Hancock County",1,2,124,66,58
050,19,081,"Iowa","Hancock County",1,3,131,70,61
050,19,081,"Iowa","Hancock County",1,4,120,75,45
050,19,081,"Iowa","Hancock County",1,5,125,62,63
050,19,081,"Iowa","Hancock County",1,6,126,62,64
050,19,081,"Iowa","Hancock County",1,7,123,57,66
050,19,081,"Iowa","Hancock County",1,8,104,50,54
050,19,081,"Iowa","Hancock County",1,9,117,58,59
050,19,081,"Iowa","Hancock County",1,10,138,71,67
050,19,081,"Iowa","Hancock County",1,11,133,66,67
050,19,081,"Iowa","Hancock County",1,12,142,67,75
050,19,081,"Iowa","Hancock County",1,13,153,84,69
050,19,081,"Iowa","Hancock County",1,14,154,80,74
050,19,081,"Iowa","Hancock County",1,15,152,77,75
050,19,081,"Iowa","Hancock County",1,16,147,80,67
050,19,081,"Iowa","Hancock County",1,17,152,83,69
050,19,081,"Iowa","Hancock County",1,18,127,66,61
050,19,081,"Iowa","Hancock County",1,19,95,47,48
050,19,081,"Iowa","Hancock County",1,20,109,58,51
050,19,081,"Iowa","Hancock County",1,21,108,64,44
050,19,081,"Iowa","Hancock County",1,22,115,64,51
050,19,081,"Iowa","Hancock County",1,23,112,63,49
050,19,081,"Iowa","Hancock County",1,24,119,62,57
050,19,081,"Iowa","Hancock County",1,25,103,57,46
050,19,081,"Iowa","Hancock County",1,26,109,59,50
050,19,081,"Iowa","Hancock County",1,27,112,60,52
050,19,081,"Iowa","Hancock County",1,28,116,62,54
050,19,081,"Iowa","Hancock County",1,29,108,62,46
050,19,081,"Iowa","Hancock County",1,30,102,51,51
050,19,081,"Iowa","Hancock County",1,31,114,53,61
050,19,081,"Iowa","Hancock County",1,32,104,54,50
050,19,081,"Iowa","Hancock County",1,33,102,49,53
050,19,081,"Iowa","Hancock County",1,34,110,51,59
050,19,081,"Iowa","Hancock County",1,35,132,77,55
050,19,081,"Iowa","Hancock County",1,36,136,71,65
050,19,081,"Iowa","Hancock County",1,37,124,66,58
050,19,081,"Iowa","Hancock County",1,38,126,67,59
050,19,081,"Iowa","Hancock County",1,39,136,74,62
050,19,081,"Iowa","Hancock County",1,40,127,65,62
050,19,081,"Iowa","Hancock County",1,41,106,56,50
050,19,081,"Iowa","Hancock County",1,42,124,62,62
050,19,081,"Iowa","Hancock County",1,43,131,69,62
050,19,081,"Iowa","Hancock County",1,44,134,67,67
050,19,081,"Iowa","Hancock County",1,45,116,55,61
050,19,081,"Iowa","Hancock County",1,46,108,51,57
050,19,081,"Iowa","Hancock County",1,47,107,56,51
050,19,081,"Iowa","Hancock County",1,48,118,62,56
050,19,081,"Iowa","Hancock County",1,49,119,60,59
050,19,081,"Iowa","Hancock County",1,50,103,55,48
050,19,081,"Iowa","Hancock County",1,51,108,54,54
050,19,081,"Iowa","Hancock County",1,52,103,50,53
050,19,081,"Iowa","Hancock County",1,53,113,57,56
050,19,081,"Iowa","Hancock County",1,54,118,59,59
050,19,081,"Iowa","Hancock County",1,55,141,70,71
050,19,081,"Iowa","Hancock County",1,56,160,82,78
050,19,081,"Iowa","Hancock County",1,57,170,88,82
050,19,081,"Iowa","Hancock County",1,58,183,92,91
050,19,081,"Iowa","Hancock County",1,59,162,72,90
050,19,081,"Iowa","Hancock County",1,60,165,79,86
050,19,081,"Iowa","Hancock County",1,61,175,93,82
050,19,081,"Iowa","Hancock County",1,62,163,86,77
050,19,081,"Iowa","Hancock County",1,63,175,90,85
050,19,081,"Iowa","Hancock County",1,64,169,91,78
050,19,081,"Iowa","Hancock County",1,65,181,88,93
050,19,081,"Iowa","Hancock County",1,66,158,77,81
050,19,081,"Iowa","Hancock County",1,67,158,83,75
050,19,081,"Iowa","Hancock County",1,68,153,85,68
050,19,081,"Iowa","Hancock County",1,69,145,83,62
050,19,081,"Iowa","Hancock County",1,70,130,65,65
050,19,081,"Iowa","Hancock County",1,71,125,64,61
050,19,081,"Iowa","Hancock County",1,72,123,59,64
050,19,081,"Iowa","Hancock County",1,73,123,63,60
050,19,081,"Iowa","Hancock County",1,74,80,40,40
050,19,081,"Iowa","Hancock County",1,75,77,34,43
050,19,081,"Iowa","Hancock County",1,76,93,38,55
050,19,081,"Iowa","Hancock County",1,77,90,44,46
050,19,081,"Iowa","Hancock County",1,78,68,36,32
050,19,081,"Iowa","Hancock County",1,79,72,38,34
050,19,081,"Iowa","Hancock County",1,80,67,26,41
050,19,081,"Iowa","Hancock County",1,81,65,27,38
050,19,081,"Iowa","Hancock County",1,82,75,27,48
050,19,081,"Iowa","Hancock County",1,83,65,31,34
050,19,081,"Iowa","Hancock County",1,84,50,22,28
050,19,081,"Iowa","Hancock County",1,85,407,129,278
050,19,081,"Iowa","Hancock County",2,0,117,62,55
050,19,081,"Iowa","Hancock County",2,1,110,56,54
050,19,081,"Iowa","Hancock County",2,2,122,65,57
050,19,081,"Iowa","Hancock County",2,3,129,69,60
050,19,081,"Iowa","Hancock County",2,4,122,73,49
050,19,081,"Iowa","Hancock County",2,5,124,64,60
050,19,081,"Iowa","Hancock County",2,6,129,64,65
050,19,081,"Iowa","Hancock County",2,7,123,58,65
050,19,081,"Iowa","Hancock County",2,8,106,50,56
050,19,081,"Iowa","Hancock County",2,9,115,57,58
050,19,081,"Iowa","Hancock County",2,10,132,67,65
050,19,081,"Iowa","Hancock County",2,11,132,66,66
050,19,081,"Iowa","Hancock County",2,12,139,66,73
050,19,081,"Iowa","Hancock County",2,13,150,79,71
050,19,081,"Iowa","Hancock County",2,14,152,80,72
050,19,081,"Iowa","Hancock County",2,15,149,77,72
050,19,081,"Iowa","Hancock County",2,16,148,79,69
050,19,081,"Iowa","Hancock County",2,17,148,80,68
050,19,081,"Iowa","Hancock County",2,18,124,66,58
050,19,081,"Iowa","Hancock County",2,19,96,48,48
050,19,081,"Iowa","Hancock County",2,20,108,57,51
050,19,081,"Iowa","Hancock County",2,21,111,63,48
050,19,081,"Iowa","Hancock County",2,22,113,64,49
050,19,081,"Iowa","Hancock County",2,23,115,64,51
050,19,081,"Iowa","Hancock County",2,24,116,62,54
050,19,081,"Iowa","Hancock County",2,25,108,60,48
050,19,081,"Iowa","Hancock County",2,26,108,60,48
050,19,081,"Iowa","Hancock County",2,27,108,57,51
050,19,081,"Iowa","Hancock County",2,28,116,62,54
050,19,081,"Iowa","Hancock County",2,29,108,61,47
050,19,081,"Iowa","Hancock County",2,30,105,54,51
050,19,081,"Iowa","Hancock County",2,31,109,52,57
050,19,081,"Iowa","Hancock County",2,32,108,55,53
050,19,081,"Iowa","Hancock County",2,33,102,50,52
050,19,081,"Iowa","Hancock County",2,34,108,51,57
050,19,081,"Iowa","Hancock County",2,35,125,70,55
050,19,081,"Iowa","Hancock County",2,36,133,71,62
050,19,081,"Iowa","Hancock County",2,37,127,67,60
050,19,081,"Iowa","Hancock County",2,38,128,68,60
050,19,081,"Iowa","Hancock County",2,39,134,73,61
050,19,081,"Iowa","Hancock County",2,40,129,67,62
050,19,081,"Iowa","Hancock County",2,41,111,58,53
050,19,081,"Iowa","Hancock County",2,42,117,60,57
050,19,081,"Iowa","Hancock County",2,43,130,67,63
050,19,081,"Iowa","Hancock County",2,44,133,67,66
050,19,081,"Iowa","Hancock County",2,45,121,58,63
050,19,081,"Iowa","Hancock County",2,46,109,52,57
050,19,081,"Iowa","Hancock County",2,47,107,55,52
050,19,081,"Iowa","Hancock County",2,48,115,60,55
050,19,081,"Iowa","Hancock County",2,49,119,61,58
050,19,081,"Iowa","Hancock County",2,50,104,55,49
050,19,081,"Iowa","Hancock County",2,51,106,54,52
050,19,081,"Iowa","Hancock County",2,52,104,51,53
050,19,081,"Iowa","Hancock County",2,53,112,55,57
050,19,081,"Iowa","Hancock County",2,54,116,58,58
050,19,081,"Iowa","Hancock County",2,55,137,68,69
050,19,081,"Iowa","Hancock County",2,56,151,76,75
050,19,081,"Iowa","Hancock County",2,57,167,86,81
050,19,081,"Iowa","Hancock County",2,58,180,91,89
050,19,081,"Iowa","Hancock County",2,59,168,77,91
050,19,081,"Iowa","Hancock County",2,60,164,77,87
050,19,081,"Iowa","Hancock County",2,61,173,91,82
050,19,081,"Iowa","Hancock County",2,62,167,88,79
050,19,081,"Iowa","Hancock County",2,63,172,89,83
050,19,081,"Iowa","Hancock County",2,64,169,90,79
050,19,081,"Iowa","Hancock County",2,65,179,89,90
050,19,081,"Iowa","Hancock County",2,66,164,80,84
050,19,081,"Iowa","Hancock County",2,67,155,80,75
050,19,081,"Iowa","Hancock County",2,68,153,84,69
050,19,081,"Iowa","Hancock County",2,69,148,84,64
050,19,081,"Iowa","Hancock County",2,70,132,68,64
050,19,081,"Iowa","Hancock County",2,71,124,64,60
050,19,081,"Iowa","Hancock County",2,72,119,57,62
050,19,081,"Iowa","Hancock County",2,73,128,63,65
050,19,081,"Iowa","Hancock County",2,74,84,42,42
050,19,081,"Iowa","Hancock County",2,75,77,35,42
050,19,081,"Iowa","Hancock County",2,76,89,37,52
050,19,081,"Iowa","Hancock County",2,77,94,45,49
050,19,081,"Iowa","Hancock County",2,78,71,37,34
050,19,081,"Iowa","Hancock County",2,79,67,35,32
050,19,081,"Iowa","Hancock County",2,80,68,29,39
050,19,081,"Iowa","Hancock County",2,81,65,27,38
050,19,081,"Iowa","Hancock County",2,82,75,27,48
050,19,081,"Iowa","Hancock County",2,83,66,31,35
050,19,081,"Iowa","Hancock County",2,84,53,24,29
050,19,081,"Iowa","Hancock County",2,85,405,130,275
050,19,081,"Iowa","Hancock County",3,0,121,66,55
050,19,081,"Iowa","Hancock County",3,1,121,64,57
050,19,081,"Iowa","Hancock County",3,2,115,59,56
050,19,081,"Iowa","Hancock County",3,3,125,67,58
050,19,081,"Iowa","Hancock County",3,4,129,64,65
050,19,081,"Iowa","Hancock County",3,5,123,72,51
050,19,081,"Iowa","Hancock County",3,6,127,67,60
050,19,081,"Iowa","Hancock County",3,7,124,62,62
050,19,081,"Iowa","Hancock County",3,8,117,55,62
050,19,081,"Iowa","Hancock County",3,9,108,51,57
050,19,081,"Iowa","Hancock County",3,10,115,61,54
050,19,081,"Iowa","Hancock County",3,11,134,64,70
050,19,081,"Iowa","Hancock County",3,12,138,69,69
050,19,081,"Iowa","Hancock County",3,13,139,67,72
050,19,081,"Iowa","Hancock County",3,14,146,79,67
050,19,081,"Iowa","Hancock County",3,15,145,72,73
050,19,081,"Iowa","Hancock County",3,16,152,79,73
050,19,081,"Iowa","Hancock County",3,17,142,77,65
050,19,081,"Iowa","Hancock County",3,18,120,69,51
050,19,081,"Iowa","Hancock County",3,19,101,55,46
050,19,081,"Iowa","Hancock County",3,20,90,48,42
050,19,081,"Iowa","Hancock County",3,21,108,54,54
050,19,081,"Iowa","Hancock County",3,22,118,63,55
050,19,081,"Iowa","Hancock County",3,23,113,61,52
050,19,081,"Iowa","Hancock County",3,24,118,71,47
050,19,081,"Iowa","Hancock County",3,25,111,58,53
050,19,081,"Iowa","Hancock County",3,26,107,57,50
050,19,081,"Iowa","Hancock County",3,27,115,63,52
050,19,081,"Iowa","Hancock County",3,28,104,55,49
050,19,081,"Iowa","Hancock County",3,29,123,66,57
050,19,081,"Iowa","Hancock County",3,30,110,57,53
050,19,081,"Iowa","Hancock County",3,31,108,57,51
050,19,081,"Iowa","Hancock County",3,32,112,53,59
050,19,081,"Iowa","Hancock County",3,33,115,60,55
050,19,081,"Iowa","Hancock County",3,34,100,49,51
050,19,081,"Iowa","Hancock County",3,35,111,54,57
050,19,081,"Iowa","Hancock County",3,36,126,70,56
050,19,081,"Iowa","Hancock County",3,37,129,70,59
050,19,081,"Iowa","Hancock County",3,38,123,65,58
050,19,081,"Iowa","Hancock County",3,39,131,69,62
050,19,081,"Iowa","Hancock County",3,40,136,75,61
050,19,081,"Iowa","Hancock County",3,41,131,70,61
050,19,081,"Iowa","Hancock County",3,42,113,58,55
050,19,081,"Iowa","Hancock County",3,43,117,57,60
050,19,081,"Iowa","Hancock County",3,44,125,66,59
050,19,081,"Iowa","Hancock County",3,45,132,67,65
050,19,081,"Iowa","Hancock County",3,46,118,54,64
050,19,081,"Iowa","Hancock County",3,47,105,52,53
050,19,081,"Iowa","Hancock County",3,48,110,56,54
050,19,081,"Iowa","Hancock County",3,49,115,62,53
050,19,081,"Iowa","Hancock County",3,50,119,62,57
050,19,081,"Iowa","Hancock County",3,51,102,55,47
050,19,081,"Iowa","Hancock County",3,52,100,49,51
050,19,081,"Iowa","Hancock County",3,53,103,49,54
050,19,081,"Iowa","Hancock County",3,54,112,57,55
050,19,081,"Iowa","Hancock County",3,55,125,63,62
050,19,081,"Iowa","Hancock County",3,56,132,68,64
050,19,081,"Iowa","Hancock County",3,57,146,72,74
050,19,081,"Iowa","Hancock County",3,58,168,87,81
050,19,081,"Iowa","Hancock County",3,59,175,86,89
050,19,081,"Iowa","Hancock County",3,60,168,78,90
050,19,081,"Iowa","Hancock County",3,61,164,77,87
050,19,081,"Iowa","Hancock County",3,62,171,91,80
050,19,081,"Iowa","Hancock County",3,63,164,86,78
050,19,081,"Iowa","Hancock County",3,64,170,88,82
050,19,081,"Iowa","Hancock County",3,65,168,89,79
050,19,081,"Iowa","Hancock County",3,66,173,86,87
050,19,081,"Iowa","Hancock County",3,67,161,76,85
050,19,081,"Iowa","Hancock County",3,68,146,76,70
050,19,081,"Iowa","Hancock County",3,69,152,85,67
050,19,081,"Iowa","Hancock County",3,70,143,78,65
050,19,081,"Iowa","Hancock County",3,71,135,71,64
050,19,081,"Iowa","Hancock County",3,72,116,61,55
050,19,081,"Iowa","Hancock County",3,73,118,57,61
050,19,081,"Iowa","Hancock County",3,74,126,62,64
050,19,081,"Iowa","Hancock County",3,75,81,40,41
050,19,081,"Iowa","Hancock County",3,76,73,31,42
050,19,081,"Iowa","Hancock County",3,77,84,35,49
050,19,081,"Iowa","Hancock County",3,78,87,43,44
050,19,081,"Iowa","Hancock County",3,79,68,34,34
050,19,081,"Iowa","Hancock County",3,80,61,28,33
050,19,081,"Iowa","Hancock County",3,81,63,30,33
050,19,081,"Iowa","Hancock County",3,82,64,20,44
050,19,081,"Iowa","Hancock County",3,83,68,29,39
050,19,081,"Iowa","Hancock County",3,84,63,29,34
050,19,081,"Iowa","Hancock County",3,85,395,122,273
050,19,081,"Iowa","Hancock County",4,0,117,63,54
050,19,081,"Iowa","Hancock County",4,1,122,61,61
050,19,081,"Iowa","Hancock County",4,2,134,72,62
050,19,081,"Iowa","Hancock County",4,3,114,58,56
050,19,081,"Iowa","Hancock County",4,4,129,70,59
050,19,081,"Iowa","Hancock County",4,5,129,68,61
050,19,081,"Iowa","Hancock County",4,6,116,70,46
050,19,081,"Iowa","Hancock County",4,7,132,71,61
050,19,081,"Iowa","Hancock County",4,8,127,66,61
050,19,081,"Iowa","Hancock County",4,9,122,56,66
050,19,081,"Iowa","Hancock County",4,10,111,52,59
050,19,081,"Iowa","Hancock County",4,11,117,59,58
050,19,081,"Iowa","Hancock County",4,12,137,69,68
050,19,081,"Iowa","Hancock County",4,13,136,66,70
050,19,081,"Iowa","Hancock County",4,14,135,66,69
050,19,081,"Iowa","Hancock County",4,15,142,75,67
050,19,081,"Iowa","Hancock County",4,16,137,71,66
050,19,081,"Iowa","Hancock County",4,17,150,82,68
050,19,081,"Iowa","Hancock County",4,18,109,60,49
050,19,081,"Iowa","Hancock County",4,19,87,49,38
050,19,081,"Iowa","Hancock County",4,20,102,56,46
050,19,081,"Iowa","Hancock County",4,21,100,48,52
050,19,081,"Iowa","Hancock County",4,22,107,50,57
050,19,081,"Iowa","Hancock County",4,23,119,62,57
050,19,081,"Iowa","Hancock County",4,24,116,67,49
050,19,081,"Iowa","Hancock County",4,25,120,72,48
050,19,081,"Iowa","Hancock County",4,26,107,49,58
050,19,081,"Iowa","Hancock County",4,27,115,63,52
050,19,081,"Iowa","Hancock County",4,28,114,65,49
050,19,081,"Iowa","Hancock County",4,29,105,55,50
050,19,081,"Iowa","Hancock County",4,30,123,65,58
050,19,081,"Iowa","Hancock County",4,31,119,59,60
050,19,081,"Iowa","Hancock County",4,32,114,60,54
050,19,081,"Iowa","Hancock County",4,33,122,59,63
050,19,081,"Iowa","Hancock County",4,34,117,58,59
050,19,081,"Iowa","Hancock County",4,35,102,54,48
050,19,081,"Iowa","Hancock County",4,36,114,55,59
050,19,081,"Iowa","Hancock County",4,37,126,70,56
050,19,081,"Iowa","Hancock County",4,38,122,65,57
050,19,081,"Iowa","Hancock County",4,39,122,67,55
050,19,081,"Iowa","Hancock County",4,40,134,72,62
050,19,081,"Iowa","Hancock County",4,41,137,77,60
050,19,081,"Iowa","Hancock County",4,42,135,73,62
050,19,081,"Iowa","Hancock County",4,43,113,56,57
050,19,081,"Iowa","Hancock County",4,44,113,54,59
050,19,081,"Iowa","Hancock County",4,45,129,68,61
050,19,081,"Iowa","Hancock County",4,46,134,68,66
050,19,081,"Iowa","Hancock County",4,47,125,58,67
050,19,081,"Iowa","Hancock County",4,48,111,58,53
050,19,081,"Iowa","Hancock County",4,49,108,55,53
050,19,081,"Iowa","Hancock County",4,50,115,62,53
050,19,081,"Iowa","Hancock County",4,51,124,63,61
050,19,081,"Iowa","Hancock County",4,52,108,58,50
050,19,081,"Iowa","Hancock County",4,53,97,47,50
050,19,081,"Iowa","Hancock County",4,54,105,52,53
050,19,081,"Iowa","Hancock County",4,55,115,57,58
050,19,081,"Iowa","Hancock County",4,56,115,58,57
050,19,081,"Iowa","Hancock County",4,57,139,72,67
050,19,081,"Iowa","Hancock County",4,58,149,74,75
050,19,081,"Iowa","Hancock County",4,59,167,89,78
050,19,081,"Iowa","Hancock County",4,60,170,83,87
050,19,081,"Iowa","Hancock County",4,61,174,82,92
050,19,081,"Iowa","Hancock County",4,62,163,76,87
050,19,081,"Iowa","Hancock County",4,63,163,83,80
050,19,081,"Iowa","Hancock County",4,64,158,82,76
050,19,081,"Iowa","Hancock County",4,65,180,91,89
050,19,081,"Iowa","Hancock County",4,66,161,84,77
050,19,081,"Iowa","Hancock County",4,67,172,87,85
050,19,081,"Iowa","Hancock County",4,68,151,71,80
050,19,081,"Iowa","Hancock County",4,69,143,76,67
050,19,081,"Iowa","Hancock County",4,70,142,78,64
050,19,081,"Iowa","Hancock County",4,71,143,80,63
050,19,081,"Iowa","Hancock County",4,72,127,65,62
050,19,081,"Iowa","Hancock County",4,73,110,57,53
050,19,081,"Iowa","Hancock County",4,74,116,59,57
050,19,081,"Iowa","Hancock County",4,75,119,61,58
050,19,081,"Iowa","Hancock County",4,76,81,37,44
050,19,081,"Iowa","Hancock County",4,77,76,33,43
050,19,081,"Iowa","Hancock County",4,78,75,30,45
050,19,081,"Iowa","Hancock County",4,79,74,34,40
050,19,081,"Iowa","Hancock County",4,80,62,29,33
050,19,081,"Iowa","Hancock County",4,81,56,28,28
050,19,081,"Iowa","Hancock County",4,82,63,26,37
050,19,081,"Iowa","Hancock County",4,83,54,18,36
050,19,081,"Iowa","Hancock County",4,84,60,23,37
050,19,081,"Iowa","Hancock County",4,85,396,121,275
050,19,081,"Iowa","Hancock County",5,0,120,64,56
050,19,081,"Iowa","Hancock County",5,1,123,68,55
050,19,081,"Iowa","Hancock County",5,2,119,58,61
050,19,081,"Iowa","Hancock County",5,3,121,63,58
050,19,081,"Iowa","Hancock County",5,4,119,62,57
050,19,081,"Iowa","Hancock County",5,5,132,69,63
050,19,081,"Iowa","Hancock County",5,6,135,66,69
050,19,081,"Iowa","Hancock County",5,7,112,68,44
050,19,081,"Iowa","Hancock County",5,8,134,72,62
050,19,081,"Iowa","Hancock County",5,9,130,70,60
050,19,081,"Iowa","Hancock County",5,10,113,55,58
050,19,081,"Iowa","Hancock County",5,11,115,51,64
050,19,081,"Iowa","Hancock County",5,12,117,61,56
050,19,081,"Iowa","Hancock County",5,13,133,64,69
050,19,081,"Iowa","Hancock County",5,14,137,67,70
050,19,081,"Iowa","Hancock County",5,15,136,66,70
050,19,081,"Iowa","Hancock County",5,16,148,81,67
050,19,081,"Iowa","Hancock County",5,17,139,73,66
050,19,081,"Iowa","Hancock County",5,18,124,72,52
050,19,081,"Iowa","Hancock County",5,19,82,46,36
050,19,081,"Iowa","Hancock County",5,20,89,54,35
050,19,081,"Iowa","Hancock County",5,21,110,59,51
050,19,081,"Iowa","Hancock County",5,22,97,46,51
050,19,081,"Iowa","Hancock County",5,23,114,57,57
050,19,081,"Iowa","Hancock County",5,24,125,64,61
050,19,081,"Iowa","Hancock County",5,25,99,58,41
050,19,081,"Iowa","Hancock County",5,26,122,70,52
050,19,081,"Iowa","Hancock County",5,27,108,54,54
050,19,081,"Iowa","Hancock County",5,28,127,73,54
050,19,081,"Iowa","Hancock County",5,29,114,63,51
050,19,081,"Iowa","Hancock County",5,30,104,53,51
050,19,081,"Iowa","Hancock County",5,31,121,60,61
050,19,081,"Iowa","Hancock County",5,32,123,58,65
050,19,081,"Iowa","Hancock County",5,33,129,68,61
050,19,081,"Iowa","Hancock County",5,34,121,58,63
050,19,081,"Iowa","Hancock County",5,35,122,63,59
050,19,081,"Iowa","Hancock County",5,36,103,56,47
050,19,081,"Iowa","Hancock County",5,37,113,54,59
050,19,081,"Iowa","Hancock County",5,38,126,74,52
050,19,081,"Iowa","Hancock County",5,39,126,67,59
050,19,081,"Iowa","Hancock County",5,40,122,68,54
050,19,081,"Iowa","Hancock County",5,41,137,76,61
050,19,081,"Iowa","Hancock County",5,42,136,76,60
050,19,081,"Iowa","Hancock County",5,43,142,78,64
050,19,081,"Iowa","Hancock County",5,44,113,55,58
050,19,081,"Iowa","Hancock County",5,45,109,50,59
050,19,081,"Iowa","Hancock County",5,46,131,69,62
050,19,081,"Iowa","Hancock County",5,47,130,67,63
050,19,081,"Iowa","Hancock County",5,48,120,54,66
050,19,081,"Iowa","Hancock County",5,49,111,58,53
050,19,081,"Iowa","Hancock County",5,50,105,55,50
050,19,081,"Iowa","Hancock County",5,51,118,64,54
050,19,081,"Iowa","Hancock County",5,52,120,61,59
050,19,081,"Iowa","Hancock County",5,53,100,52,48
050,19,081,"Iowa","Hancock County",5,54,104,54,50
050,19,081,"Iowa","Hancock County",5,55,116,56,60
050,19,081,"Iowa","Hancock County",5,56,105,53,52
050,19,081,"Iowa","Hancock County",5,57,122,61,61
050,19,081,"Iowa","Hancock County",5,58,139,73,66
050,19,081,"Iowa","Hancock County",5,59,141,69,72
050,19,081,"Iowa","Hancock County",5,60,166,87,79
050,19,081,"Iowa","Hancock County",5,61,170,84,86
050,19,081,"Iowa","Hancock County",5,62,172,83,89
050,19,081,"Iowa","Hancock County",5,63,155,69,86
050,19,081,"Iowa","Hancock County",5,64,164,84,80
050,19,081,"Iowa","Hancock County",5,65,164,85,79
050,19,081,"Iowa","Hancock County",5,66,170,85,85
050,19,081,"Iowa","Hancock County",5,67,157,82,75
050,19,081,"Iowa","Hancock County",5,68,165,83,82
050,19,081,"Iowa","Hancock County",5,69,152,72,80
050,19,081,"Iowa","Hancock County",5,70,138,71,67
050,19,081,"Iowa","Hancock County",5,71,139,82,57
050,19,081,"Iowa","Hancock County",5,72,136,76,60
050,19,081,"Iowa","Hancock County",5,73,124,64,60
050,19,081,"Iowa","Hancock County",5,74,109,58,51
050,19,081,"Iowa","Hancock County",5,75,109,55,54
050,19,081,"Iowa","Hancock County",5,76,119,58,61
050,19,081,"Iowa","Hancock County",5,77,79,40,39
050,19,081,"Iowa","Hancock County",5,78,66,28,38
050,19,081,"Iowa","Hancock County",5,79,63,25,38
050,19,081,"Iowa","Hancock County",5,80,71,30,41
050,19,081,"Iowa","Hancock County",5,81,53,27,26
050,19,081,"Iowa","Hancock County",5,82,58,24,34
050,19,081,"Iowa","Hancock County",5,83,59,26,33
050,19,081,"Iowa","Hancock County",5,84,52,16,36
050,19,081,"Iowa","Hancock County",5,85,402,117,285
050,19,083,"Iowa","Hardin County",1,0,153,79,74
050,19,083,"Iowa","Hardin County",1,1,157,74,83
050,19,083,"Iowa","Hardin County",1,2,179,79,100
050,19,083,"Iowa","Hardin County",1,3,170,75,95
050,19,083,"Iowa","Hardin County",1,4,169,92,77
050,19,083,"Iowa","Hardin County",1,5,169,82,87
050,19,083,"Iowa","Hardin County",1,6,164,75,89
050,19,083,"Iowa","Hardin County",1,7,173,84,89
050,19,083,"Iowa","Hardin County",1,8,183,100,83
050,19,083,"Iowa","Hardin County",1,9,174,92,82
050,19,083,"Iowa","Hardin County",1,10,182,85,97
050,19,083,"Iowa","Hardin County",1,11,200,99,101
050,19,083,"Iowa","Hardin County",1,12,191,90,101
050,19,083,"Iowa","Hardin County",1,13,185,97,88
050,19,083,"Iowa","Hardin County",1,14,197,98,99
050,19,083,"Iowa","Hardin County",1,15,195,98,97
050,19,083,"Iowa","Hardin County",1,16,207,121,86
050,19,083,"Iowa","Hardin County",1,17,234,141,93
050,19,083,"Iowa","Hardin County",1,18,212,119,93
050,19,083,"Iowa","Hardin County",1,19,251,148,103
050,19,083,"Iowa","Hardin County",1,20,218,126,92
050,19,083,"Iowa","Hardin County",1,21,165,98,67
050,19,083,"Iowa","Hardin County",1,22,147,80,67
050,19,083,"Iowa","Hardin County",1,23,163,80,83
050,19,083,"Iowa","Hardin County",1,24,167,80,87
050,19,083,"Iowa","Hardin County",1,25,182,100,82
050,19,083,"Iowa","Hardin County",1,26,171,95,76
050,19,083,"Iowa","Hardin County",1,27,189,96,93
050,19,083,"Iowa","Hardin County",1,28,178,87,91
050,19,083,"Iowa","Hardin County",1,29,193,93,100
050,19,083,"Iowa","Hardin County",1,30,183,97,86
050,19,083,"Iowa","Hardin County",1,31,159,82,77
050,19,083,"Iowa","Hardin County",1,32,162,94,68
050,19,083,"Iowa","Hardin County",1,33,172,84,88
050,19,083,"Iowa","Hardin County",1,34,199,95,104
050,19,083,"Iowa","Hardin County",1,35,189,91,98
050,19,083,"Iowa","Hardin County",1,36,206,111,95
050,19,083,"Iowa","Hardin County",1,37,206,105,101
050,19,083,"Iowa","Hardin County",1,38,208,101,107
050,19,083,"Iowa","Hardin County",1,39,248,126,122
050,19,083,"Iowa","Hardin County",1,40,198,101,97
050,19,083,"Iowa","Hardin County",1,41,190,103,87
050,19,083,"Iowa","Hardin County",1,42,180,103,77
050,19,083,"Iowa","Hardin County",1,43,183,91,92
050,19,083,"Iowa","Hardin County",1,44,190,95,95
050,19,083,"Iowa","Hardin County",1,45,192,94,98
050,19,083,"Iowa","Hardin County",1,46,168,88,80
050,19,083,"Iowa","Hardin County",1,47,182,95,87
050,19,083,"Iowa","Hardin County",1,48,210,118,92
050,19,083,"Iowa","Hardin County",1,49,214,115,99
050,19,083,"Iowa","Hardin County",1,50,195,109,86
050,19,083,"Iowa","Hardin County",1,51,190,95,95
050,19,083,"Iowa","Hardin County",1,52,195,93,102
050,19,083,"Iowa","Hardin County",1,53,212,111,101
050,19,083,"Iowa","Hardin County",1,54,212,106,106
050,19,083,"Iowa","Hardin County",1,55,214,102,112
050,19,083,"Iowa","Hardin County",1,56,253,121,132
050,19,083,"Iowa","Hardin County",1,57,291,142,149
050,19,083,"Iowa","Hardin County",1,58,276,134,142
050,19,083,"Iowa","Hardin County",1,59,243,120,123
050,19,083,"Iowa","Hardin County",1,60,276,132,144
050,19,083,"Iowa","Hardin County",1,61,295,153,142
050,19,083,"Iowa","Hardin County",1,62,288,147,141
050,19,083,"Iowa","Hardin County",1,63,283,160,123
050,19,083,"Iowa","Hardin County",1,64,280,159,121
050,19,083,"Iowa","Hardin County",1,65,261,139,122
050,19,083,"Iowa","Hardin County",1,66,245,128,117
050,19,083,"Iowa","Hardin County",1,67,268,139,129
050,19,083,"Iowa","Hardin County",1,68,226,120,106
050,19,083,"Iowa","Hardin County",1,69,201,104,97
050,19,083,"Iowa","Hardin County",1,70,180,86,94
050,19,083,"Iowa","Hardin County",1,71,191,84,107
050,19,083,"Iowa","Hardin County",1,72,182,82,100
050,19,083,"Iowa","Hardin County",1,73,177,89,88
050,19,083,"Iowa","Hardin County",1,74,130,58,72
050,19,083,"Iowa","Hardin County",1,75,124,52,72
050,19,083,"Iowa","Hardin County",1,76,139,68,71
050,19,083,"Iowa","Hardin County",1,77,135,63,72
050,19,083,"Iowa","Hardin County",1,78,128,51,77
050,19,083,"Iowa","Hardin County",1,79,112,47,65
050,19,083,"Iowa","Hardin County",1,80,107,43,64
050,19,083,"Iowa","Hardin County",1,81,109,51,58
050,19,083,"Iowa","Hardin County",1,82,100,39,61
050,19,083,"Iowa","Hardin County",1,83,94,33,61
050,19,083,"Iowa","Hardin County",1,84,93,36,57
050,19,083,"Iowa","Hardin County",1,85,617,210,407
050,19,083,"Iowa","Hardin County",2,0,158,82,76
050,19,083,"Iowa","Hardin County",2,1,154,74,80
050,19,083,"Iowa","Hardin County",2,2,171,77,94
050,19,083,"Iowa","Hardin County",2,3,171,76,95
050,19,083,"Iowa","Hardin County",2,4,170,88,82
050,19,083,"Iowa","Hardin County",2,5,168,85,83
050,19,083,"Iowa","Hardin County",2,6,164,77,87
050,19,083,"Iowa","Hardin County",2,7,170,81,89
050,19,083,"Iowa","Hardin County",2,8,180,96,84
050,19,083,"Iowa","Hardin County",2,9,174,91,83
050,19,083,"Iowa","Hardin County",2,10,178,84,94
050,19,083,"Iowa","Hardin County",2,11,195,95,100
050,19,083,"Iowa","Hardin County",2,12,193,92,101
050,19,083,"Iowa","Hardin County",2,13,187,96,91
050,19,083,"Iowa","Hardin County",2,14,194,96,98
050,19,083,"Iowa","Hardin County",2,15,197,100,97
050,19,083,"Iowa","Hardin County",2,16,208,119,89
050,19,083,"Iowa","Hardin County",2,17,228,139,89
050,19,083,"Iowa","Hardin County",2,18,207,117,90
050,19,083,"Iowa","Hardin County",2,19,246,146,100
050,19,083,"Iowa","Hardin County",2,20,218,125,93
050,19,083,"Iowa","Hardin County",2,21,167,98,69
050,19,083,"Iowa","Hardin County",2,22,147,80,67
050,19,083,"Iowa","Hardin County",2,23,157,79,78
050,19,083,"Iowa","Hardin County",2,24,165,78,87
050,19,083,"Iowa","Hardin County",2,25,179,96,83
050,19,083,"Iowa","Hardin County",2,26,172,96,76
050,19,083,"Iowa","Hardin County",2,27,182,94,88
050,19,083,"Iowa","Hardin County",2,28,184,92,92
050,19,083,"Iowa","Hardin County",2,29,191,93,98
050,19,083,"Iowa","Hardin County",2,30,187,98,89
050,19,083,"Iowa","Hardin County",2,31,163,85,78
050,19,083,"Iowa","Hardin County",2,32,161,91,70
050,19,083,"Iowa","Hardin County",2,33,168,85,83
050,19,083,"Iowa","Hardin County",2,34,190,91,99
050,19,083,"Iowa","Hardin County",2,35,192,92,100
050,19,083,"Iowa","Hardin County",2,36,200,105,95
050,19,083,"Iowa","Hardin County",2,37,206,107,99
050,19,083,"Iowa","Hardin County",2,38,212,104,108
050,19,083,"Iowa","Hardin County",2,39,235,119,116
050,19,083,"Iowa","Hardin County",2,40,211,108,103
050,19,083,"Iowa","Hardin County",2,41,189,102,87
050,19,083,"Iowa","Hardin County",2,42,181,102,79
050,19,083,"Iowa","Hardin County",2,43,185,95,90
050,19,083,"Iowa","Hardin County",2,44,185,93,92
050,19,083,"Iowa","Hardin County",2,45,191,94,97
050,19,083,"Iowa","Hardin County",2,46,173,89,84
050,19,083,"Iowa","Hardin County",2,47,179,93,86
050,19,083,"Iowa","Hardin County",2,48,203,113,90
050,19,083,"Iowa","Hardin County",2,49,212,115,97
050,19,083,"Iowa","Hardin County",2,50,201,111,90
050,19,083,"Iowa","Hardin County",2,51,189,97,92
050,19,083,"Iowa","Hardin County",2,52,195,93,102
050,19,083,"Iowa","Hardin County",2,53,209,107,102
050,19,083,"Iowa","Hardin County",2,54,211,106,105
050,19,083,"Iowa","Hardin County",2,55,213,103,110
050,19,083,"Iowa","Hardin County",2,56,246,119,127
050,19,083,"Iowa","Hardin County",2,57,285,139,146
050,19,083,"Iowa","Hardin County",2,58,278,135,143
050,19,083,"Iowa","Hardin County",2,59,255,125,130
050,19,083,"Iowa","Hardin County",2,60,270,130,140
050,19,083,"Iowa","Hardin County",2,61,288,148,140
050,19,083,"Iowa","Hardin County",2,62,287,147,140
050,19,083,"Iowa","Hardin County",2,63,286,158,128
050,19,083,"Iowa","Hardin County",2,64,278,158,120
050,19,083,"Iowa","Hardin County",2,65,265,144,121
050,19,083,"Iowa","Hardin County",2,66,249,130,119
050,19,083,"Iowa","Hardin County",2,67,259,134,125
050,19,083,"Iowa","Hardin County",2,68,234,123,111
050,19,083,"Iowa","Hardin County",2,69,207,107,100
050,19,083,"Iowa","Hardin County",2,70,182,87,95
050,19,083,"Iowa","Hardin County",2,71,189,85,104
050,19,083,"Iowa","Hardin County",2,72,180,80,100
050,19,083,"Iowa","Hardin County",2,73,187,93,94
050,19,083,"Iowa","Hardin County",2,74,132,62,70
050,19,083,"Iowa","Hardin County",2,75,126,54,72
050,19,083,"Iowa","Hardin County",2,76,133,63,70
050,19,083,"Iowa","Hardin County",2,77,134,61,73
050,19,083,"Iowa","Hardin County",2,78,127,53,74
050,19,083,"Iowa","Hardin County",2,79,113,47,66
050,19,083,"Iowa","Hardin County",2,80,110,44,66
050,19,083,"Iowa","Hardin County",2,81,105,48,57
050,19,083,"Iowa","Hardin County",2,82,102,40,62
050,19,083,"Iowa","Hardin County",2,83,95,34,61
050,19,083,"Iowa","Hardin County",2,84,92,33,59
050,19,083,"Iowa","Hardin County",2,85,618,212,406
050,19,083,"Iowa","Hardin County",3,0,128,70,58
050,19,083,"Iowa","Hardin County",3,1,165,83,82
050,19,083,"Iowa","Hardin County",3,2,158,76,82
050,19,083,"Iowa","Hardin County",3,3,182,80,102
050,19,083,"Iowa","Hardin County",3,4,176,82,94
050,19,083,"Iowa","Hardin County",3,5,180,86,94
050,19,083,"Iowa","Hardin County",3,6,162,86,76
050,19,083,"Iowa","Hardin County",3,7,164,81,83
050,19,083,"Iowa","Hardin County",3,8,164,85,79
050,19,083,"Iowa","Hardin County",3,9,180,98,82
050,19,083,"Iowa","Hardin County",3,10,175,93,82
050,19,083,"Iowa","Hardin County",3,11,183,93,90
050,19,083,"Iowa","Hardin County",3,12,192,88,104
050,19,083,"Iowa","Hardin County",3,13,191,96,95
050,19,083,"Iowa","Hardin County",3,14,184,92,92
050,19,083,"Iowa","Hardin County",3,15,196,101,95
050,19,083,"Iowa","Hardin County",3,16,207,109,98
050,19,083,"Iowa","Hardin County",3,17,223,135,88
050,19,083,"Iowa","Hardin County",3,18,200,123,77
050,19,083,"Iowa","Hardin County",3,19,232,135,97
050,19,083,"Iowa","Hardin County",3,20,223,127,96
050,19,083,"Iowa","Hardin County",3,21,178,98,80
050,19,083,"Iowa","Hardin County",3,22,151,80,71
050,19,083,"Iowa","Hardin County",3,23,146,78,68
050,19,083,"Iowa","Hardin County",3,24,153,68,85
050,19,083,"Iowa","Hardin County",3,25,165,88,77
050,19,083,"Iowa","Hardin County",3,26,182,99,83
050,19,083,"Iowa","Hardin County",3,27,164,93,71
050,19,083,"Iowa","Hardin County",3,28,184,96,88
050,19,083,"Iowa","Hardin County",3,29,193,99,94
050,19,083,"Iowa","Hardin County",3,30,186,92,94
050,19,083,"Iowa","Hardin County",3,31,181,94,87
050,19,083,"Iowa","Hardin County",3,32,168,87,81
050,19,083,"Iowa","Hardin County",3,33,169,97,72
050,19,083,"Iowa","Hardin County",3,34,173,87,86
050,19,083,"Iowa","Hardin County",3,35,201,98,103
050,19,083,"Iowa","Hardin County",3,36,201,93,108
050,19,083,"Iowa","Hardin County",3,37,211,111,100
050,19,083,"Iowa","Hardin County",3,38,206,105,101
050,19,083,"Iowa","Hardin County",3,39,215,109,106
050,19,083,"Iowa","Hardin County",3,40,234,121,113
050,19,083,"Iowa","Hardin County",3,41,211,107,104
050,19,083,"Iowa","Hardin County",3,42,202,110,92
050,19,083,"Iowa","Hardin County",3,43,185,103,82
050,19,083,"Iowa","Hardin County",3,44,181,95,86
050,19,083,"Iowa","Hardin County",3,45,179,91,88
050,19,083,"Iowa","Hardin County",3,46,187,93,94
050,19,083,"Iowa","Hardin County",3,47,182,92,90
050,19,083,"Iowa","Hardin County",3,48,175,93,82
050,19,083,"Iowa","Hardin County",3,49,205,116,89
050,19,083,"Iowa","Hardin County",3,50,208,113,95
050,19,083,"Iowa","Hardin County",3,51,197,109,88
050,19,083,"Iowa","Hardin County",3,52,182,94,88
050,19,083,"Iowa","Hardin County",3,53,185,89,96
050,19,083,"Iowa","Hardin County",3,54,206,104,102
050,19,083,"Iowa","Hardin County",3,55,200,99,101
050,19,083,"Iowa","Hardin County",3,56,212,104,108
050,19,083,"Iowa","Hardin County",3,57,244,120,124
050,19,083,"Iowa","Hardin County",3,58,281,133,148
050,19,083,"Iowa","Hardin County",3,59,284,137,147
050,19,083,"Iowa","Hardin County",3,60,256,128,128
050,19,083,"Iowa","Hardin County",3,61,275,132,143
050,19,083,"Iowa","Hardin County",3,62,284,142,142
050,19,083,"Iowa","Hardin County",3,63,282,144,138
050,19,083,"Iowa","Hardin County",3,64,277,152,125
050,19,083,"Iowa","Hardin County",3,65,278,160,118
050,19,083,"Iowa","Hardin County",3,66,261,142,119
050,19,083,"Iowa","Hardin County",3,67,251,134,117
050,19,083,"Iowa","Hardin County",3,68,257,134,123
050,19,083,"Iowa","Hardin County",3,69,232,121,111
050,19,083,"Iowa","Hardin County",3,70,202,102,100
050,19,083,"Iowa","Hardin County",3,71,176,83,93
050,19,083,"Iowa","Hardin County",3,72,182,81,101
050,19,083,"Iowa","Hardin County",3,73,178,83,95
050,19,083,"Iowa","Hardin County",3,74,177,87,90
050,19,083,"Iowa","Hardin County",3,75,123,60,63
050,19,083,"Iowa","Hardin County",3,76,123,55,68
050,19,083,"Iowa","Hardin County",3,77,121,54,67
050,19,083,"Iowa","Hardin County",3,78,127,60,67
050,19,083,"Iowa","Hardin County",3,79,112,41,71
050,19,083,"Iowa","Hardin County",3,80,109,43,66
050,19,083,"Iowa","Hardin County",3,81,102,43,59
050,19,083,"Iowa","Hardin County",3,82,100,44,56
050,19,083,"Iowa","Hardin County",3,83,94,33,61
050,19,083,"Iowa","Hardin County",3,84,85,28,57
050,19,083,"Iowa","Hardin County",3,85,606,206,400
050,19,083,"Iowa","Hardin County",4,0,146,71,75
050,19,083,"Iowa","Hardin County",4,1,136,72,64
050,19,083,"Iowa","Hardin County",4,2,155,81,74
050,19,083,"Iowa","Hardin County",4,3,158,76,82
050,19,083,"Iowa","Hardin County",4,4,182,85,97
050,19,083,"Iowa","Hardin County",4,5,182,84,98
050,19,083,"Iowa","Hardin County",4,6,176,83,93
050,19,083,"Iowa","Hardin County",4,7,161,85,76
050,19,083,"Iowa","Hardin County",4,8,155,77,78
050,19,083,"Iowa","Hardin County",4,9,168,86,82
050,19,083,"Iowa","Hardin County",4,10,176,99,77
050,19,083,"Iowa","Hardin County",4,11,167,89,78
050,19,083,"Iowa","Hardin County",4,12,178,88,90
050,19,083,"Iowa","Hardin County",4,13,185,91,94
050,19,083,"Iowa","Hardin County",4,14,183,92,91
050,19,083,"Iowa","Hardin County",4,15,201,108,93
050,19,083,"Iowa","Hardin County",4,16,200,110,90
050,19,083,"Iowa","Hardin County",4,17,220,123,97
050,19,083,"Iowa","Hardin County",4,18,196,115,81
050,19,083,"Iowa","Hardin County",4,19,239,155,84
050,19,083,"Iowa","Hardin County",4,20,212,116,96
050,19,083,"Iowa","Hardin County",4,21,183,101,82
050,19,083,"Iowa","Hardin County",4,22,181,97,84
050,19,083,"Iowa","Hardin County",4,23,151,83,68
050,19,083,"Iowa","Hardin County",4,24,149,72,77
050,19,083,"Iowa","Hardin County",4,25,156,74,82
050,19,083,"Iowa","Hardin County",4,26,188,105,83
050,19,083,"Iowa","Hardin County",4,27,172,93,79
050,19,083,"Iowa","Hardin County",4,28,172,100,72
050,19,083,"Iowa","Hardin County",4,29,184,95,89
050,19,083,"Iowa","Hardin County",4,30,202,104,98
050,19,083,"Iowa","Hardin County",4,31,186,91,95
050,19,083,"Iowa","Hardin County",4,32,180,96,84
050,19,083,"Iowa","Hardin County",4,33,169,82,87
050,19,083,"Iowa","Hardin County",4,34,180,102,78
050,19,083,"Iowa","Hardin County",4,35,186,95,91
050,19,083,"Iowa","Hardin County",4,36,197,99,98
050,19,083,"Iowa","Hardin County",4,37,205,100,105
050,19,083,"Iowa","Hardin County",4,38,215,114,101
050,19,083,"Iowa","Hardin County",4,39,203,103,100
050,19,083,"Iowa","Hardin County",4,40,223,118,105
050,19,083,"Iowa","Hardin County",4,41,230,123,107
050,19,083,"Iowa","Hardin County",4,42,215,112,103
050,19,083,"Iowa","Hardin County",4,43,208,112,96
050,19,083,"Iowa","Hardin County",4,44,189,104,85
050,19,083,"Iowa","Hardin County",4,45,176,90,86
050,19,083,"Iowa","Hardin County",4,46,179,91,88
050,19,083,"Iowa","Hardin County",4,47,190,93,97
050,19,083,"Iowa","Hardin County",4,48,178,89,89
050,19,083,"Iowa","Hardin County",4,49,174,93,81
050,19,083,"Iowa","Hardin County",4,50,201,117,84
050,19,083,"Iowa","Hardin County",4,51,201,107,94
050,19,083,"Iowa","Hardin County",4,52,208,113,95
050,19,083,"Iowa","Hardin County",4,53,181,92,89
050,19,083,"Iowa","Hardin County",4,54,193,96,97
050,19,083,"Iowa","Hardin County",4,55,197,100,97
050,19,083,"Iowa","Hardin County",4,56,197,99,98
050,19,083,"Iowa","Hardin County",4,57,207,101,106
050,19,083,"Iowa","Hardin County",4,58,235,114,121
050,19,083,"Iowa","Hardin County",4,59,282,130,152
050,19,083,"Iowa","Hardin County",4,60,279,134,145
050,19,083,"Iowa","Hardin County",4,61,262,130,132
050,19,083,"Iowa","Hardin County",4,62,268,125,143
050,19,083,"Iowa","Hardin County",4,63,282,141,141
050,19,083,"Iowa","Hardin County",4,64,285,145,140
050,19,083,"Iowa","Hardin County",4,65,277,154,123
050,19,083,"Iowa","Hardin County",4,66,270,156,114
050,19,083,"Iowa","Hardin County",4,67,254,139,115
050,19,083,"Iowa","Hardin County",4,68,247,129,118
050,19,083,"Iowa","Hardin County",4,69,253,132,121
050,19,083,"Iowa","Hardin County",4,70,230,118,112
050,19,083,"Iowa","Hardin County",4,71,193,97,96
050,19,083,"Iowa","Hardin County",4,72,169,81,88
050,19,083,"Iowa","Hardin County",4,73,177,77,100
050,19,083,"Iowa","Hardin County",4,74,173,80,93
050,19,083,"Iowa","Hardin County",4,75,163,82,81
050,19,083,"Iowa","Hardin County",4,76,122,61,61
050,19,083,"Iowa","Hardin County",4,77,107,46,61
050,19,083,"Iowa","Hardin County",4,78,120,55,65
050,19,083,"Iowa","Hardin County",4,79,113,55,58
050,19,083,"Iowa","Hardin County",4,80,111,39,72
050,19,083,"Iowa","Hardin County",4,81,98,44,54
050,19,083,"Iowa","Hardin County",4,82,95,35,60
050,19,083,"Iowa","Hardin County",4,83,94,39,55
050,19,083,"Iowa","Hardin County",4,84,87,25,62
050,19,083,"Iowa","Hardin County",4,85,586,196,390
050,19,083,"Iowa","Hardin County",5,0,149,74,75
050,19,083,"Iowa","Hardin County",5,1,157,73,84
050,19,083,"Iowa","Hardin County",5,2,139,73,66
050,19,083,"Iowa","Hardin County",5,3,147,74,73
050,19,083,"Iowa","Hardin County",5,4,159,80,79
050,19,083,"Iowa","Hardin County",5,5,184,87,97
050,19,083,"Iowa","Hardin County",5,6,172,78,94
050,19,083,"Iowa","Hardin County",5,7,176,84,92
050,19,083,"Iowa","Hardin County",5,8,156,80,76
050,19,083,"Iowa","Hardin County",5,9,164,87,77
050,19,083,"Iowa","Hardin County",5,10,155,76,79
050,19,083,"Iowa","Hardin County",5,11,181,100,81
050,19,083,"Iowa","Hardin County",5,12,179,94,85
050,19,083,"Iowa","Hardin County",5,13,177,91,86
050,19,083,"Iowa","Hardin County",5,14,185,91,94
050,19,083,"Iowa","Hardin County",5,15,193,105,88
050,19,083,"Iowa","Hardin County",5,16,208,118,90
050,19,083,"Iowa","Hardin County",5,17,213,123,90
050,19,083,"Iowa","Hardin County",5,18,191,104,87
050,19,083,"Iowa","Hardin County",5,19,234,144,90
050,19,083,"Iowa","Hardin County",5,20,192,118,74
050,19,083,"Iowa","Hardin County",5,21,163,82,81
050,19,083,"Iowa","Hardin County",5,22,157,82,75
050,19,083,"Iowa","Hardin County",5,23,167,87,80
050,19,083,"Iowa","Hardin County",5,24,143,78,65
050,19,083,"Iowa","Hardin County",5,25,167,88,79
050,19,083,"Iowa","Hardin County",5,26,173,90,83
050,19,083,"Iowa","Hardin County",5,27,190,110,80
050,19,083,"Iowa","Hardin County",5,28,179,99,80
050,19,083,"Iowa","Hardin County",5,29,173,103,70
050,19,083,"Iowa","Hardin County",5,30,183,97,86
050,19,083,"Iowa","Hardin County",5,31,192,100,92
050,19,083,"Iowa","Hardin County",5,32,186,93,93
050,19,083,"Iowa","Hardin County",5,33,190,93,97
050,19,083,"Iowa","Hardin County",5,34,170,85,85
050,19,083,"Iowa","Hardin County",5,35,181,102,79
050,19,083,"Iowa","Hardin County",5,36,184,90,94
050,19,083,"Iowa","Hardin County",5,37,195,100,95
050,19,083,"Iowa","Hardin County",5,38,195,93,102
050,19,083,"Iowa","Hardin County",5,39,217,112,105
050,19,083,"Iowa","Hardin County",5,40,205,105,100
050,19,083,"Iowa","Hardin County",5,41,227,118,109
050,19,083,"Iowa","Hardin County",5,42,231,124,107
050,19,083,"Iowa","Hardin County",5,43,219,110,109
050,19,083,"Iowa","Hardin County",5,44,205,113,92
050,19,083,"Iowa","Hardin County",5,45,194,108,86
050,19,083,"Iowa","Hardin County",5,46,176,92,84
050,19,083,"Iowa","Hardin County",5,47,183,91,92
050,19,083,"Iowa","Hardin County",5,48,185,91,94
050,19,083,"Iowa","Hardin County",5,49,174,87,87
050,19,083,"Iowa","Hardin County",5,50,179,95,84
050,19,083,"Iowa","Hardin County",5,51,202,117,85
050,19,083,"Iowa","Hardin County",5,52,203,107,96
050,19,083,"Iowa","Hardin County",5,53,204,113,91
050,19,083,"Iowa","Hardin County",5,54,188,94,94
050,19,083,"Iowa","Hardin County",5,55,191,93,98
050,19,083,"Iowa","Hardin County",5,56,190,102,88
050,19,083,"Iowa","Hardin County",5,57,195,96,99
050,19,083,"Iowa","Hardin County",5,58,204,96,108
050,19,083,"Iowa","Hardin County",5,59,227,109,118
050,19,083,"Iowa","Hardin County",5,60,279,130,149
050,19,083,"Iowa","Hardin County",5,61,276,135,141
050,19,083,"Iowa","Hardin County",5,62,262,129,133
050,19,083,"Iowa","Hardin County",5,63,264,119,145
050,19,083,"Iowa","Hardin County",5,64,282,141,141
050,19,083,"Iowa","Hardin County",5,65,280,138,142
050,19,083,"Iowa","Hardin County",5,66,275,155,120
050,19,083,"Iowa","Hardin County",5,67,272,158,114
050,19,083,"Iowa","Hardin County",5,68,244,131,113
050,19,083,"Iowa","Hardin County",5,69,239,125,114
050,19,083,"Iowa","Hardin County",5,70,238,121,117
050,19,083,"Iowa","Hardin County",5,71,222,114,108
050,19,083,"Iowa","Hardin County",5,72,186,94,92
050,19,083,"Iowa","Hardin County",5,73,167,81,86
050,19,083,"Iowa","Hardin County",5,74,175,75,100
050,19,083,"Iowa","Hardin County",5,75,165,77,88
050,19,083,"Iowa","Hardin County",5,76,159,81,78
050,19,083,"Iowa","Hardin County",5,77,109,52,57
050,19,083,"Iowa","Hardin County",5,78,98,44,54
050,19,083,"Iowa","Hardin County",5,79,111,50,61
050,19,083,"Iowa","Hardin County",5,80,111,53,58
050,19,083,"Iowa","Hardin County",5,81,98,37,61
050,19,083,"Iowa","Hardin County",5,82,92,38,54
050,19,083,"Iowa","Hardin County",5,83,90,31,59
050,19,083,"Iowa","Hardin County",5,84,88,31,57
050,19,083,"Iowa","Hardin County",5,85,583,191,392
050,19,085,"Iowa","Harrison County",1,0,164,82,82
050,19,085,"Iowa","Harrison County",1,1,172,80,92
050,19,085,"Iowa","Harrison County",1,2,156,79,77
050,19,085,"Iowa","Harrison County",1,3,187,98,89
050,19,085,"Iowa","Harrison County",1,4,173,82,91
050,19,085,"Iowa","Harrison County",1,5,188,93,95
050,19,085,"Iowa","Harrison County",1,6,192,97,95
050,19,085,"Iowa","Harrison County",1,7,169,95,74
050,19,085,"Iowa","Harrison County",1,8,164,91,73
050,19,085,"Iowa","Harrison County",1,9,179,95,84
050,19,085,"Iowa","Harrison County",1,10,192,95,97
050,19,085,"Iowa","Harrison County",1,11,214,118,96
050,19,085,"Iowa","Harrison County",1,12,241,128,113
050,19,085,"Iowa","Harrison County",1,13,222,123,99
050,19,085,"Iowa","Harrison County",1,14,197,104,93
050,19,085,"Iowa","Harrison County",1,15,186,89,97
050,19,085,"Iowa","Harrison County",1,16,203,99,104
050,19,085,"Iowa","Harrison County",1,17,203,100,103
050,19,085,"Iowa","Harrison County",1,18,177,93,84
050,19,085,"Iowa","Harrison County",1,19,138,72,66
050,19,085,"Iowa","Harrison County",1,20,132,69,63
050,19,085,"Iowa","Harrison County",1,21,136,71,65
050,19,085,"Iowa","Harrison County",1,22,124,68,56
050,19,085,"Iowa","Harrison County",1,23,148,80,68
050,19,085,"Iowa","Harrison County",1,24,138,70,68
050,19,085,"Iowa","Harrison County",1,25,154,80,74
050,19,085,"Iowa","Harrison County",1,26,141,72,69
050,19,085,"Iowa","Harrison County",1,27,167,85,82
050,19,085,"Iowa","Harrison County",1,28,155,83,72
050,19,085,"Iowa","Harrison County",1,29,141,76,65
050,19,085,"Iowa","Harrison County",1,30,154,85,69
050,19,085,"Iowa","Harrison County",1,31,132,66,66
050,19,085,"Iowa","Harrison County",1,32,143,75,68
050,19,085,"Iowa","Harrison County",1,33,160,91,69
050,19,085,"Iowa","Harrison County",1,34,180,91,89
050,19,085,"Iowa","Harrison County",1,35,182,81,101
050,19,085,"Iowa","Harrison County",1,36,166,82,84
050,19,085,"Iowa","Harrison County",1,37,163,80,83
050,19,085,"Iowa","Harrison County",1,38,167,86,81
050,19,085,"Iowa","Harrison County",1,39,168,89,79
050,19,085,"Iowa","Harrison County",1,40,181,96,85
050,19,085,"Iowa","Harrison County",1,41,162,86,76
050,19,085,"Iowa","Harrison County",1,42,159,83,76
050,19,085,"Iowa","Harrison County",1,43,156,77,79
050,19,085,"Iowa","Harrison County",1,44,173,88,85
050,19,085,"Iowa","Harrison County",1,45,188,99,89
050,19,085,"Iowa","Harrison County",1,46,179,98,81
050,19,085,"Iowa","Harrison County",1,47,163,86,77
050,19,085,"Iowa","Harrison County",1,48,182,99,83
050,19,085,"Iowa","Harrison County",1,49,198,96,102
050,19,085,"Iowa","Harrison County",1,50,192,94,98
050,19,085,"Iowa","Harrison County",1,51,185,100,85
050,19,085,"Iowa","Harrison County",1,52,163,79,84
050,19,085,"Iowa","Harrison County",1,53,182,96,86
050,19,085,"Iowa","Harrison County",1,54,185,91,94
050,19,085,"Iowa","Harrison County",1,55,193,94,99
050,19,085,"Iowa","Harrison County",1,56,218,109,109
050,19,085,"Iowa","Harrison County",1,57,234,119,115
050,19,085,"Iowa","Harrison County",1,58,240,128,112
050,19,085,"Iowa","Harrison County",1,59,263,129,134
050,19,085,"Iowa","Harrison County",1,60,248,130,118
050,19,085,"Iowa","Harrison County",1,61,237,120,117
050,19,085,"Iowa","Harrison County",1,62,230,123,107
050,19,085,"Iowa","Harrison County",1,63,232,112,120
050,19,085,"Iowa","Harrison County",1,64,227,116,111
050,19,085,"Iowa","Harrison County",1,65,199,111,88
050,19,085,"Iowa","Harrison County",1,66,173,87,86
050,19,085,"Iowa","Harrison County",1,67,168,85,83
050,19,085,"Iowa","Harrison County",1,68,179,90,89
050,19,085,"Iowa","Harrison County",1,69,172,84,88
050,19,085,"Iowa","Harrison County",1,70,171,89,82
050,19,085,"Iowa","Harrison County",1,71,157,87,70
050,19,085,"Iowa","Harrison County",1,72,162,82,80
050,19,085,"Iowa","Harrison County",1,73,146,71,75
050,19,085,"Iowa","Harrison County",1,74,89,42,47
050,19,085,"Iowa","Harrison County",1,75,93,48,45
050,19,085,"Iowa","Harrison County",1,76,107,53,54
050,19,085,"Iowa","Harrison County",1,77,112,50,62
050,19,085,"Iowa","Harrison County",1,78,96,44,52
050,19,085,"Iowa","Harrison County",1,79,96,43,53
050,19,085,"Iowa","Harrison County",1,80,86,40,46
050,19,085,"Iowa","Harrison County",1,81,75,40,35
050,19,085,"Iowa","Harrison County",1,82,63,27,36
050,19,085,"Iowa","Harrison County",1,83,58,23,35
050,19,085,"Iowa","Harrison County",1,84,56,27,29
050,19,085,"Iowa","Harrison County",1,85,386,129,257
050,19,085,"Iowa","Harrison County",2,0,169,80,89
050,19,085,"Iowa","Harrison County",2,1,166,79,87
050,19,085,"Iowa","Harrison County",2,2,161,80,81
050,19,085,"Iowa","Harrison County",2,3,176,91,85
050,19,085,"Iowa","Harrison County",2,4,178,87,91
050,19,085,"Iowa","Harrison County",2,5,184,90,94
050,19,085,"Iowa","Harrison County",2,6,191,95,96
050,19,085,"Iowa","Harrison County",2,7,173,93,80
050,19,085,"Iowa","Harrison County",2,8,167,92,75
050,19,085,"Iowa","Harrison County",2,9,173,92,81
050,19,085,"Iowa","Harrison County",2,10,190,95,95
050,19,085,"Iowa","Harrison County",2,11,212,114,98
050,19,085,"Iowa","Harrison County",2,12,237,126,111
050,19,085,"Iowa","Harrison County",2,13,227,125,102
050,19,085,"Iowa","Harrison County",2,14,203,109,94
050,19,085,"Iowa","Harrison County",2,15,189,92,97
050,19,085,"Iowa","Harrison County",2,16,198,97,101
050,19,085,"Iowa","Harrison County",2,17,204,101,103
050,19,085,"Iowa","Harrison County",2,18,172,89,83
050,19,085,"Iowa","Harrison County",2,19,137,71,66
050,19,085,"Iowa","Harrison County",2,20,137,71,66
050,19,085,"Iowa","Harrison County",2,21,134,72,62
050,19,085,"Iowa","Harrison County",2,22,130,71,59
050,19,085,"Iowa","Harrison County",2,23,143,77,66
050,19,085,"Iowa","Harrison County",2,24,138,70,68
050,19,085,"Iowa","Harrison County",2,25,150,78,72
050,19,085,"Iowa","Harrison County",2,26,146,75,71
050,19,085,"Iowa","Harrison County",2,27,160,81,79
050,19,085,"Iowa","Harrison County",2,28,158,83,75
050,19,085,"Iowa","Harrison County",2,29,143,78,65
050,19,085,"Iowa","Harrison County",2,30,151,82,69
050,19,085,"Iowa","Harrison County",2,31,135,69,66
050,19,085,"Iowa","Harrison County",2,32,141,74,67
050,19,085,"Iowa","Harrison County",2,33,159,90,69
050,19,085,"Iowa","Harrison County",2,34,175,90,85
050,19,085,"Iowa","Harrison County",2,35,183,84,99
050,19,085,"Iowa","Harrison County",2,36,169,81,88
050,19,085,"Iowa","Harrison County",2,37,163,80,83
050,19,085,"Iowa","Harrison County",2,38,167,85,82
050,19,085,"Iowa","Harrison County",2,39,168,88,80
050,19,085,"Iowa","Harrison County",2,40,180,96,84
050,19,085,"Iowa","Harrison County",2,41,166,88,78
050,19,085,"Iowa","Harrison County",2,42,158,82,76
050,19,085,"Iowa","Harrison County",2,43,160,80,80
050,19,085,"Iowa","Harrison County",2,44,168,85,83
050,19,085,"Iowa","Harrison County",2,45,186,97,89
050,19,085,"Iowa","Harrison County",2,46,177,96,81
050,19,085,"Iowa","Harrison County",2,47,167,88,79
050,19,085,"Iowa","Harrison County",2,48,177,95,82
050,19,085,"Iowa","Harrison County",2,49,195,98,97
050,19,085,"Iowa","Harrison County",2,50,191,93,98
050,19,085,"Iowa","Harrison County",2,51,184,97,87
050,19,085,"Iowa","Harrison County",2,52,170,85,85
050,19,085,"Iowa","Harrison County",2,53,175,90,85
050,19,085,"Iowa","Harrison County",2,54,185,93,92
050,19,085,"Iowa","Harrison County",2,55,191,94,97
050,19,085,"Iowa","Harrison County",2,56,213,106,107
050,19,085,"Iowa","Harrison County",2,57,229,116,113
050,19,085,"Iowa","Harrison County",2,58,235,124,111
050,19,085,"Iowa","Harrison County",2,59,257,129,128
050,19,085,"Iowa","Harrison County",2,60,250,129,121
050,19,085,"Iowa","Harrison County",2,61,240,123,117
050,19,085,"Iowa","Harrison County",2,62,232,123,109
050,19,085,"Iowa","Harrison County",2,63,237,118,119
050,19,085,"Iowa","Harrison County",2,64,222,112,110
050,19,085,"Iowa","Harrison County",2,65,205,111,94
050,19,085,"Iowa","Harrison County",2,66,180,92,88
050,19,085,"Iowa","Harrison County",2,67,168,85,83
050,19,085,"Iowa","Harrison County",2,68,174,87,87
050,19,085,"Iowa","Harrison County",2,69,174,86,88
050,19,085,"Iowa","Harrison County",2,70,169,87,82
050,19,085,"Iowa","Harrison County",2,71,161,88,73
050,19,085,"Iowa","Harrison County",2,72,155,80,75
050,19,085,"Iowa","Harrison County",2,73,156,76,80
050,19,085,"Iowa","Harrison County",2,74,95,45,50
050,19,085,"Iowa","Harrison County",2,75,93,47,46
050,19,085,"Iowa","Harrison County",2,76,103,50,53
050,19,085,"Iowa","Harrison County",2,77,110,50,60
050,19,085,"Iowa","Harrison County",2,78,98,45,53
050,19,085,"Iowa","Harrison County",2,79,94,41,53
050,19,085,"Iowa","Harrison County",2,80,87,41,46
050,19,085,"Iowa","Harrison County",2,81,76,40,36
050,19,085,"Iowa","Harrison County",2,82,67,30,37
050,19,085,"Iowa","Harrison County",2,83,58,23,35
050,19,085,"Iowa","Harrison County",2,84,55,25,30
050,19,085,"Iowa","Harrison County",2,85,389,134,255
050,19,085,"Iowa","Harrison County",3,0,152,70,82
050,19,085,"Iowa","Harrison County",3,1,180,80,100
050,19,085,"Iowa","Harrison County",3,2,168,75,93
050,19,085,"Iowa","Harrison County",3,3,167,85,82
050,19,085,"Iowa","Harrison County",3,4,188,93,95
050,19,085,"Iowa","Harrison County",3,5,189,96,93
050,19,085,"Iowa","Harrison County",3,6,192,95,97
050,19,085,"Iowa","Harrison County",3,7,200,96,104
050,19,085,"Iowa","Harrison County",3,8,190,100,90
050,19,085,"Iowa","Harrison County",3,9,169,100,69
050,19,085,"Iowa","Harrison County",3,10,181,94,87
050,19,085,"Iowa","Harrison County",3,11,195,101,94
050,19,085,"Iowa","Harrison County",3,12,224,121,103
050,19,085,"Iowa","Harrison County",3,13,237,129,108
050,19,085,"Iowa","Harrison County",3,14,232,132,100
050,19,085,"Iowa","Harrison County",3,15,206,105,101
050,19,085,"Iowa","Harrison County",3,16,187,92,95
050,19,085,"Iowa","Harrison County",3,17,194,97,97
050,19,085,"Iowa","Harrison County",3,18,176,89,87
050,19,085,"Iowa","Harrison County",3,19,126,66,60
050,19,085,"Iowa","Harrison County",3,20,154,84,70
050,19,085,"Iowa","Harrison County",3,21,144,76,68
050,19,085,"Iowa","Harrison County",3,22,140,77,63
050,19,085,"Iowa","Harrison County",3,23,137,75,62
050,19,085,"Iowa","Harrison County",3,24,131,71,60
050,19,085,"Iowa","Harrison County",3,25,148,76,72
050,19,085,"Iowa","Harrison County",3,26,164,76,88
050,19,085,"Iowa","Harrison County",3,27,155,74,81
050,19,085,"Iowa","Harrison County",3,28,174,90,84
050,19,085,"Iowa","Harrison County",3,29,153,82,71
050,19,085,"Iowa","Harrison County",3,30,152,75,77
050,19,085,"Iowa","Harrison County",3,31,152,79,73
050,19,085,"Iowa","Harrison County",3,32,141,71,70
050,19,085,"Iowa","Harrison County",3,33,152,81,71
050,19,085,"Iowa","Harrison County",3,34,161,90,71
050,19,085,"Iowa","Harrison County",3,35,179,91,88
050,19,085,"Iowa","Harrison County",3,36,196,92,104
050,19,085,"Iowa","Harrison County",3,37,176,87,89
050,19,085,"Iowa","Harrison County",3,38,165,82,83
050,19,085,"Iowa","Harrison County",3,39,176,89,87
050,19,085,"Iowa","Harrison County",3,40,175,90,85
050,19,085,"Iowa","Harrison County",3,41,189,97,92
050,19,085,"Iowa","Harrison County",3,42,171,91,80
050,19,085,"Iowa","Harrison County",3,43,159,83,76
050,19,085,"Iowa","Harrison County",3,44,160,79,81
050,19,085,"Iowa","Harrison County",3,45,168,86,82
050,19,085,"Iowa","Harrison County",3,46,195,106,89
050,19,085,"Iowa","Harrison County",3,47,178,94,84
050,19,085,"Iowa","Harrison County",3,48,165,89,76
050,19,085,"Iowa","Harrison County",3,49,176,92,84
050,19,085,"Iowa","Harrison County",3,50,199,97,102
050,19,085,"Iowa","Harrison County",3,51,187,90,97
050,19,085,"Iowa","Harrison County",3,52,175,94,81
050,19,085,"Iowa","Harrison County",3,53,170,85,85
050,19,085,"Iowa","Harrison County",3,54,170,85,85
050,19,085,"Iowa","Harrison County",3,55,178,90,88
050,19,085,"Iowa","Harrison County",3,56,189,95,94
050,19,085,"Iowa","Harrison County",3,57,215,104,111
050,19,085,"Iowa","Harrison County",3,58,227,118,109
050,19,085,"Iowa","Harrison County",3,59,235,126,109
050,19,085,"Iowa","Harrison County",3,60,247,125,122
050,19,085,"Iowa","Harrison County",3,61,250,129,121
050,19,085,"Iowa","Harrison County",3,62,244,125,119
050,19,085,"Iowa","Harrison County",3,63,235,122,113
050,19,085,"Iowa","Harrison County",3,64,233,120,113
050,19,085,"Iowa","Harrison County",3,65,212,107,105
050,19,085,"Iowa","Harrison County",3,66,201,106,95
050,19,085,"Iowa","Harrison County",3,67,183,92,91
050,19,085,"Iowa","Harrison County",3,68,158,76,82
050,19,085,"Iowa","Harrison County",3,69,170,88,82
050,19,085,"Iowa","Harrison County",3,70,171,79,92
050,19,085,"Iowa","Harrison County",3,71,163,87,76
050,19,085,"Iowa","Harrison County",3,72,150,81,69
050,19,085,"Iowa","Harrison County",3,73,148,78,70
050,19,085,"Iowa","Harrison County",3,74,145,70,75
050,19,085,"Iowa","Harrison County",3,75,96,45,51
050,19,085,"Iowa","Harrison County",3,76,92,46,46
050,19,085,"Iowa","Harrison County",3,77,97,46,51
050,19,085,"Iowa","Harrison County",3,78,104,51,53
050,19,085,"Iowa","Harrison County",3,79,88,35,53
050,19,085,"Iowa","Harrison County",3,80,85,40,45
050,19,085,"Iowa","Harrison County",3,81,84,44,40
050,19,085,"Iowa","Harrison County",3,82,70,33,37
050,19,085,"Iowa","Harrison County",3,83,60,24,36
050,19,085,"Iowa","Harrison County",3,84,49,21,28
050,19,085,"Iowa","Harrison County",3,85,371,133,238
050,19,085,"Iowa","Harrison County",4,0,165,73,92
050,19,085,"Iowa","Harrison County",4,1,174,82,92
050,19,085,"Iowa","Harrison County",4,2,182,85,97
050,19,085,"Iowa","Harrison County",4,3,167,76,91
050,19,085,"Iowa","Harrison County",4,4,171,83,88
050,19,085,"Iowa","Harrison County",4,5,188,92,96
050,19,085,"Iowa","Harrison County",4,6,181,92,89
050,19,085,"Iowa","Harrison County",4,7,184,90,94
050,19,085,"Iowa","Harrison County",4,8,203,99,104
050,19,085,"Iowa","Harrison County",4,9,182,97,85
050,19,085,"Iowa","Harrison County",4,10,170,95,75
050,19,085,"Iowa","Harrison County",4,11,189,98,91
050,19,085,"Iowa","Harrison County",4,12,199,101,98
050,19,085,"Iowa","Harrison County",4,13,223,121,102
050,19,085,"Iowa","Harrison County",4,14,248,129,119
050,19,085,"Iowa","Harrison County",4,15,227,129,98
050,19,085,"Iowa","Harrison County",4,16,202,105,97
050,19,085,"Iowa","Harrison County",4,17,186,91,95
050,19,085,"Iowa","Harrison County",4,18,157,84,73
050,19,085,"Iowa","Harrison County",4,19,136,66,70
050,19,085,"Iowa","Harrison County",4,20,131,67,64
050,19,085,"Iowa","Harrison County",4,21,151,81,70
050,19,085,"Iowa","Harrison County",4,22,150,81,69
050,19,085,"Iowa","Harrison County",4,23,134,70,64
050,19,085,"Iowa","Harrison County",4,24,146,80,66
050,19,085,"Iowa","Harrison County",4,25,138,74,64
050,19,085,"Iowa","Harrison County",4,26,151,76,75
050,19,085,"Iowa","Harrison County",4,27,169,75,94
050,19,085,"Iowa","Harrison County",4,28,152,74,78
050,19,085,"Iowa","Harrison County",4,29,180,90,90
050,19,085,"Iowa","Harrison County",4,30,158,86,72
050,19,085,"Iowa","Harrison County",4,31,148,74,74
050,19,085,"Iowa","Harrison County",4,32,160,83,77
050,19,085,"Iowa","Harrison County",4,33,152,82,70
050,19,085,"Iowa","Harrison County",4,34,160,88,72
050,19,085,"Iowa","Harrison County",4,35,166,93,73
050,19,085,"Iowa","Harrison County",4,36,173,90,83
050,19,085,"Iowa","Harrison County",4,37,191,91,100
050,19,085,"Iowa","Harrison County",4,38,177,90,87
050,19,085,"Iowa","Harrison County",4,39,166,83,83
050,19,085,"Iowa","Harrison County",4,40,179,90,89
050,19,085,"Iowa","Harrison County",4,41,181,95,86
050,19,085,"Iowa","Harrison County",4,42,184,93,91
050,19,085,"Iowa","Harrison County",4,43,168,88,80
050,19,085,"Iowa","Harrison County",4,44,164,83,81
050,19,085,"Iowa","Harrison County",4,45,163,76,87
050,19,085,"Iowa","Harrison County",4,46,169,89,80
050,19,085,"Iowa","Harrison County",4,47,203,110,93
050,19,085,"Iowa","Harrison County",4,48,179,92,87
050,19,085,"Iowa","Harrison County",4,49,167,93,74
050,19,085,"Iowa","Harrison County",4,50,177,92,85
050,19,085,"Iowa","Harrison County",4,51,201,100,101
050,19,085,"Iowa","Harrison County",4,52,192,96,96
050,19,085,"Iowa","Harrison County",4,53,166,92,74
050,19,085,"Iowa","Harrison County",4,54,169,82,87
050,19,085,"Iowa","Harrison County",4,55,172,87,85
050,19,085,"Iowa","Harrison County",4,56,180,88,92
050,19,085,"Iowa","Harrison County",4,57,199,101,98
050,19,085,"Iowa","Harrison County",4,58,208,98,110
050,19,085,"Iowa","Harrison County",4,59,226,122,104
050,19,085,"Iowa","Harrison County",4,60,232,124,108
050,19,085,"Iowa","Harrison County",4,61,248,123,125
050,19,085,"Iowa","Harrison County",4,62,247,129,118
050,19,085,"Iowa","Harrison County",4,63,249,125,124
050,19,085,"Iowa","Harrison County",4,64,225,118,107
050,19,085,"Iowa","Harrison County",4,65,228,117,111
050,19,085,"Iowa","Harrison County",4,66,205,101,104
050,19,085,"Iowa","Harrison County",4,67,198,106,92
050,19,085,"Iowa","Harrison County",4,68,175,87,88
050,19,085,"Iowa","Harrison County",4,69,158,77,81
050,19,085,"Iowa","Harrison County",4,70,170,85,85
050,19,085,"Iowa","Harrison County",4,71,167,80,87
050,19,085,"Iowa","Harrison County",4,72,154,82,72
050,19,085,"Iowa","Harrison County",4,73,133,74,59
050,19,085,"Iowa","Harrison County",4,74,136,71,65
050,19,085,"Iowa","Harrison County",4,75,143,68,75
050,19,085,"Iowa","Harrison County",4,76,95,44,51
050,19,085,"Iowa","Harrison County",4,77,87,43,44
050,19,085,"Iowa","Harrison County",4,78,93,44,49
050,19,085,"Iowa","Harrison County",4,79,98,41,57
050,19,085,"Iowa","Harrison County",4,80,80,31,49
050,19,085,"Iowa","Harrison County",4,81,75,38,37
050,19,085,"Iowa","Harrison County",4,82,83,41,42
050,19,085,"Iowa","Harrison County",4,83,60,27,33
050,19,085,"Iowa","Harrison County",4,84,51,21,30
050,19,085,"Iowa","Harrison County",4,85,356,127,229
050,19,085,"Iowa","Harrison County",5,0,157,75,82
050,19,085,"Iowa","Harrison County",5,1,170,74,96
050,19,085,"Iowa","Harrison County",5,2,177,87,90
050,19,085,"Iowa","Harrison County",5,3,182,85,97
050,19,085,"Iowa","Harrison County",5,4,173,78,95
050,19,085,"Iowa","Harrison County",5,5,165,81,84
050,19,085,"Iowa","Harrison County",5,6,180,94,86
050,19,085,"Iowa","Harrison County",5,7,196,100,96
050,19,085,"Iowa","Harrison County",5,8,181,91,90
050,19,085,"Iowa","Harrison County",5,9,210,103,107
050,19,085,"Iowa","Harrison County",5,10,182,95,87
050,19,085,"Iowa","Harrison County",5,11,171,96,75
050,19,085,"Iowa","Harrison County",5,12,191,102,89
050,19,085,"Iowa","Harrison County",5,13,198,101,97
050,19,085,"Iowa","Harrison County",5,14,226,123,103
050,19,085,"Iowa","Harrison County",5,15,245,127,118
050,19,085,"Iowa","Harrison County",5,16,218,125,93
050,19,085,"Iowa","Harrison County",5,17,197,102,95
050,19,085,"Iowa","Harrison County",5,18,148,75,73
050,19,085,"Iowa","Harrison County",5,19,118,64,54
050,19,085,"Iowa","Harrison County",5,20,142,69,73
050,19,085,"Iowa","Harrison County",5,21,140,77,63
050,19,085,"Iowa","Harrison County",5,22,158,76,82
050,19,085,"Iowa","Harrison County",5,23,153,79,74
050,19,085,"Iowa","Harrison County",5,24,140,77,63
050,19,085,"Iowa","Harrison County",5,25,136,70,66
050,19,085,"Iowa","Harrison County",5,26,141,72,69
050,19,085,"Iowa","Harrison County",5,27,158,78,80
050,19,085,"Iowa","Harrison County",5,28,181,83,98
050,19,085,"Iowa","Harrison County",5,29,149,75,74
050,19,085,"Iowa","Harrison County",5,30,181,89,92
050,19,085,"Iowa","Harrison County",5,31,161,91,70
050,19,085,"Iowa","Harrison County",5,32,144,73,71
050,19,085,"Iowa","Harrison County",5,33,156,80,76
050,19,085,"Iowa","Harrison County",5,34,156,88,68
050,19,085,"Iowa","Harrison County",5,35,149,81,68
050,19,085,"Iowa","Harrison County",5,36,166,93,73
050,19,085,"Iowa","Harrison County",5,37,169,84,85
050,19,085,"Iowa","Harrison County",5,38,198,94,104
050,19,085,"Iowa","Harrison County",5,39,186,95,91
050,19,085,"Iowa","Harrison County",5,40,171,87,84
050,19,085,"Iowa","Harrison County",5,41,178,93,85
050,19,085,"Iowa","Harrison County",5,42,172,89,83
050,19,085,"Iowa","Harrison County",5,43,182,92,90
050,19,085,"Iowa","Harrison County",5,44,165,87,78
050,19,085,"Iowa","Harrison County",5,45,169,83,86
050,19,085,"Iowa","Harrison County",5,46,164,80,84
050,19,085,"Iowa","Harrison County",5,47,169,88,81
050,19,085,"Iowa","Harrison County",5,48,198,103,95
050,19,085,"Iowa","Harrison County",5,49,175,91,84
050,19,085,"Iowa","Harrison County",5,50,165,94,71
050,19,085,"Iowa","Harrison County",5,51,179,94,85
050,19,085,"Iowa","Harrison County",5,52,205,101,104
050,19,085,"Iowa","Harrison County",5,53,192,98,94
050,19,085,"Iowa","Harrison County",5,54,173,95,78
050,19,085,"Iowa","Harrison County",5,55,172,83,89
050,19,085,"Iowa","Harrison County",5,56,179,91,88
050,19,085,"Iowa","Harrison County",5,57,183,91,92
050,19,085,"Iowa","Harrison County",5,58,195,96,99
050,19,085,"Iowa","Harrison County",5,59,207,100,107
050,19,085,"Iowa","Harrison County",5,60,217,113,104
050,19,085,"Iowa","Harrison County",5,61,234,123,111
050,19,085,"Iowa","Harrison County",5,62,246,123,123
050,19,085,"Iowa","Harrison County",5,63,253,130,123
050,19,085,"Iowa","Harrison County",5,64,253,128,125
050,19,085,"Iowa","Harrison County",5,65,221,117,104
050,19,085,"Iowa","Harrison County",5,66,221,116,105
050,19,085,"Iowa","Harrison County",5,67,206,103,103
050,19,085,"Iowa","Harrison County",5,68,195,102,93
050,19,085,"Iowa","Harrison County",5,69,175,91,84
050,19,085,"Iowa","Harrison County",5,70,157,75,82
050,19,085,"Iowa","Harrison County",5,71,165,85,80
050,19,085,"Iowa","Harrison County",5,72,162,77,85
050,19,085,"Iowa","Harrison County",5,73,144,78,66
050,19,085,"Iowa","Harrison County",5,74,124,73,51
050,19,085,"Iowa","Harrison County",5,75,136,70,66
050,19,085,"Iowa","Harrison County",5,76,130,62,68
050,19,085,"Iowa","Harrison County",5,77,92,41,51
050,19,085,"Iowa","Harrison County",5,78,82,40,42
050,19,085,"Iowa","Harrison County",5,79,84,36,48
050,19,085,"Iowa","Harrison County",5,80,94,40,54
050,19,085,"Iowa","Harrison County",5,81,73,32,41
050,19,085,"Iowa","Harrison County",5,82,75,35,40
050,19,085,"Iowa","Harrison County",5,83,74,37,37
050,19,085,"Iowa","Harrison County",5,84,52,24,28
050,19,085,"Iowa","Harrison County",5,85,363,125,238
050,19,087,"Iowa","Henry County",1,0,205,105,100
050,19,087,"Iowa","Henry County",1,1,216,111,105
050,19,087,"Iowa","Henry County",1,2,230,124,106
050,19,087,"Iowa","Henry County",1,3,216,111,105
050,19,087,"Iowa","Henry County",1,4,231,119,112
050,19,087,"Iowa","Henry County",1,5,240,126,114
050,19,087,"Iowa","Henry County",1,6,231,105,126
050,19,087,"Iowa","Henry County",1,7,233,111,122
050,19,087,"Iowa","Henry County",1,8,239,121,118
050,19,087,"Iowa","Henry County",1,9,255,132,123
050,19,087,"Iowa","Henry County",1,10,242,140,102
050,19,087,"Iowa","Henry County",1,11,244,129,115
050,19,087,"Iowa","Henry County",1,12,260,135,125
050,19,087,"Iowa","Henry County",1,13,264,134,130
050,19,087,"Iowa","Henry County",1,14,249,126,123
050,19,087,"Iowa","Henry County",1,15,261,134,127
050,19,087,"Iowa","Henry County",1,16,245,126,119
050,19,087,"Iowa","Henry County",1,17,264,137,127
050,19,087,"Iowa","Henry County",1,18,286,160,126
050,19,087,"Iowa","Henry County",1,19,352,218,134
050,19,087,"Iowa","Henry County",1,20,351,172,179
050,19,087,"Iowa","Henry County",1,21,358,182,176
050,19,087,"Iowa","Henry County",1,22,351,191,160
050,19,087,"Iowa","Henry County",1,23,269,155,114
050,19,087,"Iowa","Henry County",1,24,240,146,94
050,19,087,"Iowa","Henry County",1,25,260,148,112
050,19,087,"Iowa","Henry County",1,26,253,145,108
050,19,087,"Iowa","Henry County",1,27,263,156,107
050,19,087,"Iowa","Henry County",1,28,241,146,95
050,19,087,"Iowa","Henry County",1,29,233,144,89
050,19,087,"Iowa","Henry County",1,30,238,139,99
050,19,087,"Iowa","Henry County",1,31,209,113,96
050,19,087,"Iowa","Henry County",1,32,230,124,106
050,19,087,"Iowa","Henry County",1,33,220,120,100
050,19,087,"Iowa","Henry County",1,34,233,132,101
050,19,087,"Iowa","Henry County",1,35,249,143,106
050,19,087,"Iowa","Henry County",1,36,272,152,120
050,19,087,"Iowa","Henry County",1,37,258,158,100
050,19,087,"Iowa","Henry County",1,38,247,143,104
050,19,087,"Iowa","Henry County",1,39,249,125,124
050,19,087,"Iowa","Henry County",1,40,227,119,108
050,19,087,"Iowa","Henry County",1,41,240,131,109
050,19,087,"Iowa","Henry County",1,42,230,120,110
050,19,087,"Iowa","Henry County",1,43,236,131,105
050,19,087,"Iowa","Henry County",1,44,216,112,104
050,19,087,"Iowa","Henry County",1,45,233,120,113
050,19,087,"Iowa","Henry County",1,46,221,123,98
050,19,087,"Iowa","Henry County",1,47,236,127,109
050,19,087,"Iowa","Henry County",1,48,246,124,122
050,19,087,"Iowa","Henry County",1,49,267,135,132
050,19,087,"Iowa","Henry County",1,50,252,138,114
050,19,087,"Iowa","Henry County",1,51,249,135,114
050,19,087,"Iowa","Henry County",1,52,237,126,111
050,19,087,"Iowa","Henry County",1,53,255,144,111
050,19,087,"Iowa","Henry County",1,54,273,149,124
050,19,087,"Iowa","Henry County",1,55,284,141,143
050,19,087,"Iowa","Henry County",1,56,276,132,144
050,19,087,"Iowa","Henry County",1,57,293,162,131
050,19,087,"Iowa","Henry County",1,58,289,153,136
050,19,087,"Iowa","Henry County",1,59,282,143,139
050,19,087,"Iowa","Henry County",1,60,273,145,128
050,19,087,"Iowa","Henry County",1,61,284,143,141
050,19,087,"Iowa","Henry County",1,62,275,147,128
050,19,087,"Iowa","Henry County",1,63,269,141,128
050,19,087,"Iowa","Henry County",1,64,244,124,120
050,19,087,"Iowa","Henry County",1,65,243,119,124
050,19,087,"Iowa","Henry County",1,66,236,115,121
050,19,087,"Iowa","Henry County",1,67,250,130,120
050,19,087,"Iowa","Henry County",1,68,226,108,118
050,19,087,"Iowa","Henry County",1,69,209,105,104
050,19,087,"Iowa","Henry County",1,70,233,121,112
050,19,087,"Iowa","Henry County",1,71,238,120,118
050,19,087,"Iowa","Henry County",1,72,227,111,116
050,19,087,"Iowa","Henry County",1,73,223,107,116
050,19,087,"Iowa","Henry County",1,74,153,70,83
050,19,087,"Iowa","Henry County",1,75,142,60,82
050,19,087,"Iowa","Henry County",1,76,158,78,80
050,19,087,"Iowa","Henry County",1,77,138,66,72
050,19,087,"Iowa","Henry County",1,78,130,59,71
050,19,087,"Iowa","Henry County",1,79,120,49,71
050,19,087,"Iowa","Henry County",1,80,107,46,61
050,19,087,"Iowa","Henry County",1,81,115,49,66
050,19,087,"Iowa","Henry County",1,82,101,45,56
050,19,087,"Iowa","Henry County",1,83,82,37,45
050,19,087,"Iowa","Henry County",1,84,87,38,49
050,19,087,"Iowa","Henry County",1,85,490,162,328
050,19,087,"Iowa","Henry County",2,0,206,103,103
050,19,087,"Iowa","Henry County",2,1,213,110,103
050,19,087,"Iowa","Henry County",2,2,225,120,105
050,19,087,"Iowa","Henry County",2,3,215,111,104
050,19,087,"Iowa","Henry County",2,4,229,118,111
050,19,087,"Iowa","Henry County",2,5,238,124,114
050,19,087,"Iowa","Henry County",2,6,230,108,122
050,19,087,"Iowa","Henry County",2,7,230,109,121
050,19,087,"Iowa","Henry County",2,8,236,117,119
050,19,087,"Iowa","Henry County",2,9,247,128,119
050,19,087,"Iowa","Henry County",2,10,244,137,107
050,19,087,"Iowa","Henry County",2,11,241,131,110
050,19,087,"Iowa","Henry County",2,12,257,134,123
050,19,087,"Iowa","Henry County",2,13,260,132,128
050,19,087,"Iowa","Henry County",2,14,255,129,126
050,19,087,"Iowa","Henry County",2,15,256,131,125
050,19,087,"Iowa","Henry County",2,16,249,129,120
050,19,087,"Iowa","Henry County",2,17,259,134,125
050,19,087,"Iowa","Henry County",2,18,288,161,127
050,19,087,"Iowa","Henry County",2,19,353,218,135
050,19,087,"Iowa","Henry County",2,20,351,172,179
050,19,087,"Iowa","Henry County",2,21,356,180,176
050,19,087,"Iowa","Henry County",2,22,350,189,161
050,19,087,"Iowa","Henry County",2,23,277,156,121
050,19,087,"Iowa","Henry County",2,24,237,143,94
050,19,087,"Iowa","Henry County",2,25,257,147,110
050,19,087,"Iowa","Henry County",2,26,253,143,110
050,19,087,"Iowa","Henry County",2,27,261,154,107
050,19,087,"Iowa","Henry County",2,28,250,149,101
050,19,087,"Iowa","Henry County",2,29,230,143,87
050,19,087,"Iowa","Henry County",2,30,243,146,97
050,19,087,"Iowa","Henry County",2,31,213,117,96
050,19,087,"Iowa","Henry County",2,32,224,121,103
050,19,087,"Iowa","Henry County",2,33,222,120,102
050,19,087,"Iowa","Henry County",2,34,230,131,99
050,19,087,"Iowa","Henry County",2,35,243,138,105
050,19,087,"Iowa","Henry County",2,36,269,151,118
050,19,087,"Iowa","Henry County",2,37,260,157,103
050,19,087,"Iowa","Henry County",2,38,249,144,105
050,19,087,"Iowa","Henry County",2,39,247,127,120
050,19,087,"Iowa","Henry County",2,40,233,120,113
050,19,087,"Iowa","Henry County",2,41,240,132,108
050,19,087,"Iowa","Henry County",2,42,228,120,108
050,19,087,"Iowa","Henry County",2,43,239,130,109
050,19,087,"Iowa","Henry County",2,44,214,113,101
050,19,087,"Iowa","Henry County",2,45,229,117,112
050,19,087,"Iowa","Henry County",2,46,223,123,100
050,19,087,"Iowa","Henry County",2,47,229,124,105
050,19,087,"Iowa","Henry County",2,48,244,125,119
050,19,087,"Iowa","Henry County",2,49,263,133,130
050,19,087,"Iowa","Henry County",2,50,252,136,116
050,19,087,"Iowa","Henry County",2,51,250,138,112
050,19,087,"Iowa","Henry County",2,52,240,129,111
050,19,087,"Iowa","Henry County",2,53,247,137,110
050,19,087,"Iowa","Henry County",2,54,268,148,120
050,19,087,"Iowa","Henry County",2,55,283,144,139
050,19,087,"Iowa","Henry County",2,56,275,130,145
050,19,087,"Iowa","Henry County",2,57,292,158,134
050,19,087,"Iowa","Henry County",2,58,283,149,134
050,19,087,"Iowa","Henry County",2,59,286,148,138
050,19,087,"Iowa","Henry County",2,60,276,146,130
050,19,087,"Iowa","Henry County",2,61,279,141,138
050,19,087,"Iowa","Henry County",2,62,274,145,129
050,19,087,"Iowa","Henry County",2,63,271,144,127
050,19,087,"Iowa","Henry County",2,64,248,125,123
050,19,087,"Iowa","Henry County",2,65,242,119,123
050,19,087,"Iowa","Henry County",2,66,236,115,121
050,19,087,"Iowa","Henry County",2,67,246,126,120
050,19,087,"Iowa","Henry County",2,68,229,111,118
050,19,087,"Iowa","Henry County",2,69,211,104,107
050,19,087,"Iowa","Henry County",2,70,227,117,110
050,19,087,"Iowa","Henry County",2,71,238,119,119
050,19,087,"Iowa","Henry County",2,72,225,111,114
050,19,087,"Iowa","Henry County",2,73,236,113,123
050,19,087,"Iowa","Henry County",2,74,159,73,86
050,19,087,"Iowa","Henry County",2,75,146,62,84
050,19,087,"Iowa","Henry County",2,76,153,73,80
050,19,087,"Iowa","Henry County",2,77,145,70,75
050,19,087,"Iowa","Henry County",2,78,128,59,69
050,19,087,"Iowa","Henry County",2,79,119,49,70
050,19,087,"Iowa","Henry County",2,80,109,47,62
050,19,087,"Iowa","Henry County",2,81,114,48,66
050,19,087,"Iowa","Henry County",2,82,104,45,59
050,19,087,"Iowa","Henry County",2,83,86,38,48
050,19,087,"Iowa","Henry County",2,84,84,37,47
050,19,087,"Iowa","Henry County",2,85,491,162,329
050,19,087,"Iowa","Henry County",3,0,177,94,83
050,19,087,"Iowa","Henry County",3,1,208,113,95
050,19,087,"Iowa","Henry County",3,2,209,109,100
050,19,087,"Iowa","Henry County",3,3,220,115,105
050,19,087,"Iowa","Henry County",3,4,227,121,106
050,19,087,"Iowa","Henry County",3,5,226,118,108
050,19,087,"Iowa","Henry County",3,6,237,117,120
050,19,087,"Iowa","Henry County",3,7,241,110,131
050,19,087,"Iowa","Henry County",3,8,241,116,125
050,19,087,"Iowa","Henry County",3,9,232,115,117
050,19,087,"Iowa","Henry County",3,10,246,126,120
050,19,087,"Iowa","Henry County",3,11,250,137,113
050,19,087,"Iowa","Henry County",3,12,244,134,110
050,19,087,"Iowa","Henry County",3,13,269,148,121
050,19,087,"Iowa","Henry County",3,14,263,141,122
050,19,087,"Iowa","Henry County",3,15,261,130,131
050,19,087,"Iowa","Henry County",3,16,255,134,121
050,19,087,"Iowa","Henry County",3,17,258,133,125
050,19,087,"Iowa","Henry County",3,18,289,158,131
050,19,087,"Iowa","Henry County",3,19,349,220,129
050,19,087,"Iowa","Henry County",3,20,347,176,171
050,19,087,"Iowa","Henry County",3,21,338,178,160
050,19,087,"Iowa","Henry County",3,22,325,179,146
050,19,087,"Iowa","Henry County",3,23,288,157,131
050,19,087,"Iowa","Henry County",3,24,230,142,88
050,19,087,"Iowa","Henry County",3,25,234,145,89
050,19,087,"Iowa","Henry County",3,26,241,142,99
050,19,087,"Iowa","Henry County",3,27,272,152,120
050,19,087,"Iowa","Henry County",3,28,257,149,108
050,19,087,"Iowa","Henry County",3,29,244,148,96
050,19,087,"Iowa","Henry County",3,30,249,165,84
050,19,087,"Iowa","Henry County",3,31,235,141,94
050,19,087,"Iowa","Henry County",3,32,201,117,84
050,19,087,"Iowa","Henry County",3,33,218,106,112
050,19,087,"Iowa","Henry County",3,34,229,126,103
050,19,087,"Iowa","Henry County",3,35,223,123,100
050,19,087,"Iowa","Henry County",3,36,263,152,111
050,19,087,"Iowa","Henry County",3,37,284,166,118
050,19,087,"Iowa","Henry County",3,38,257,152,105
050,19,087,"Iowa","Henry County",3,39,258,149,109
050,19,087,"Iowa","Henry County",3,40,241,128,113
050,19,087,"Iowa","Henry County",3,41,251,140,111
050,19,087,"Iowa","Henry County",3,42,231,121,110
050,19,087,"Iowa","Henry County",3,43,243,129,114
050,19,087,"Iowa","Henry County",3,44,229,123,106
050,19,087,"Iowa","Henry County",3,45,231,120,111
050,19,087,"Iowa","Henry County",3,46,220,118,102
050,19,087,"Iowa","Henry County",3,47,221,120,101
050,19,087,"Iowa","Henry County",3,48,229,125,104
050,19,087,"Iowa","Henry County",3,49,228,113,115
050,19,087,"Iowa","Henry County",3,50,262,132,130
050,19,087,"Iowa","Henry County",3,51,256,142,114
050,19,087,"Iowa","Henry County",3,52,248,139,109
050,19,087,"Iowa","Henry County",3,53,230,118,112
050,19,087,"Iowa","Henry County",3,54,246,134,112
050,19,087,"Iowa","Henry County",3,55,278,157,121
050,19,087,"Iowa","Henry County",3,56,281,135,146
050,19,087,"Iowa","Henry County",3,57,285,141,144
050,19,087,"Iowa","Henry County",3,58,275,147,128
050,19,087,"Iowa","Henry County",3,59,297,154,143
050,19,087,"Iowa","Henry County",3,60,289,149,140
050,19,087,"Iowa","Henry County",3,61,266,136,130
050,19,087,"Iowa","Henry County",3,62,271,142,129
050,19,087,"Iowa","Henry County",3,63,260,137,123
050,19,087,"Iowa","Henry County",3,64,256,131,125
050,19,087,"Iowa","Henry County",3,65,244,126,118
050,19,087,"Iowa","Henry County",3,66,232,112,120
050,19,087,"Iowa","Henry County",3,67,234,116,118
050,19,087,"Iowa","Henry County",3,68,245,124,121
050,19,087,"Iowa","Henry County",3,69,220,108,112
050,19,087,"Iowa","Henry County",3,70,209,102,107
050,19,087,"Iowa","Henry County",3,71,215,109,106
050,19,087,"Iowa","Henry County",3,72,230,112,118
050,19,087,"Iowa","Henry County",3,73,217,104,113
050,19,087,"Iowa","Henry County",3,74,228,115,113
050,19,087,"Iowa","Henry County",3,75,155,68,87
050,19,087,"Iowa","Henry County",3,76,138,55,83
050,19,087,"Iowa","Henry County",3,77,143,67,76
050,19,087,"Iowa","Henry County",3,78,145,72,73
050,19,087,"Iowa","Henry County",3,79,123,57,66
050,19,087,"Iowa","Henry County",3,80,114,49,65
050,19,087,"Iowa","Henry County",3,81,101,43,58
050,19,087,"Iowa","Henry County",3,82,105,41,64
050,19,087,"Iowa","Henry County",3,83,95,40,55
050,19,087,"Iowa","Henry County",3,84,75,35,40
050,19,087,"Iowa","Henry County",3,85,495,166,329
050,19,087,"Iowa","Henry County",4,0,190,110,80
050,19,087,"Iowa","Henry County",4,1,187,107,80
050,19,087,"Iowa","Henry County",4,2,216,114,102
050,19,087,"Iowa","Henry County",4,3,211,109,102
050,19,087,"Iowa","Henry County",4,4,224,116,108
050,19,087,"Iowa","Henry County",4,5,218,109,109
050,19,087,"Iowa","Henry County",4,6,236,116,120
050,19,087,"Iowa","Henry County",4,7,240,122,118
050,19,087,"Iowa","Henry County",4,8,237,106,131
050,19,087,"Iowa","Henry County",4,9,248,116,132
050,19,087,"Iowa","Henry County",4,10,232,116,116
050,19,087,"Iowa","Henry County",4,11,234,113,121
050,19,087,"Iowa","Henry County",4,12,250,143,107
050,19,087,"Iowa","Henry County",4,13,254,135,119
050,19,087,"Iowa","Henry County",4,14,268,143,125
050,19,087,"Iowa","Henry County",4,15,255,133,122
050,19,087,"Iowa","Henry County",4,16,255,125,130
050,19,087,"Iowa","Henry County",4,17,253,136,117
050,19,087,"Iowa","Henry County",4,18,281,150,131
050,19,087,"Iowa","Henry County",4,19,344,212,132
050,19,087,"Iowa","Henry County",4,20,332,174,158
050,19,087,"Iowa","Henry County",4,21,337,179,158
050,19,087,"Iowa","Henry County",4,22,333,187,146
050,19,087,"Iowa","Henry County",4,23,276,153,123
050,19,087,"Iowa","Henry County",4,24,230,131,99
050,19,087,"Iowa","Henry County",4,25,247,157,90
050,19,087,"Iowa","Henry County",4,26,234,139,95
050,19,087,"Iowa","Henry County",4,27,230,132,98
050,19,087,"Iowa","Henry County",4,28,267,142,125
050,19,087,"Iowa","Henry County",4,29,245,138,107
050,19,087,"Iowa","Henry County",4,30,257,160,97
050,19,087,"Iowa","Henry County",4,31,240,155,85
050,19,087,"Iowa","Henry County",4,32,250,149,101
050,19,087,"Iowa","Henry County",4,33,195,103,92
050,19,087,"Iowa","Henry County",4,34,223,113,110
050,19,087,"Iowa","Henry County",4,35,227,121,106
050,19,087,"Iowa","Henry County",4,36,239,128,111
050,19,087,"Iowa","Henry County",4,37,256,156,100
050,19,087,"Iowa","Henry County",4,38,274,153,121
050,19,087,"Iowa","Henry County",4,39,252,144,108
050,19,087,"Iowa","Henry County",4,40,247,142,105
050,19,087,"Iowa","Henry County",4,41,263,145,118
050,19,087,"Iowa","Henry County",4,42,243,133,110
050,19,087,"Iowa","Henry County",4,43,243,127,116
050,19,087,"Iowa","Henry County",4,44,234,123,111
050,19,087,"Iowa","Henry County",4,45,231,121,110
050,19,087,"Iowa","Henry County",4,46,233,131,102
050,19,087,"Iowa","Henry County",4,47,211,112,99
050,19,087,"Iowa","Henry County",4,48,224,123,101
050,19,087,"Iowa","Henry County",4,49,218,117,101
050,19,087,"Iowa","Henry County",4,50,227,112,115
050,19,087,"Iowa","Henry County",4,51,269,139,130
050,19,087,"Iowa","Henry County",4,52,249,136,113
050,19,087,"Iowa","Henry County",4,53,239,129,110
050,19,087,"Iowa","Henry County",4,54,240,124,116
050,19,087,"Iowa","Henry County",4,55,250,144,106
050,19,087,"Iowa","Henry County",4,56,272,147,125
050,19,087,"Iowa","Henry County",4,57,295,149,146
050,19,087,"Iowa","Henry County",4,58,266,128,138
050,19,087,"Iowa","Henry County",4,59,266,144,122
050,19,087,"Iowa","Henry County",4,60,295,155,140
050,19,087,"Iowa","Henry County",4,61,278,136,142
050,19,087,"Iowa","Henry County",4,62,259,135,124
050,19,087,"Iowa","Henry County",4,63,267,144,123
050,19,087,"Iowa","Henry County",4,64,251,127,124
050,19,087,"Iowa","Henry County",4,65,243,125,118
050,19,087,"Iowa","Henry County",4,66,231,117,114
050,19,087,"Iowa","Henry County",4,67,231,113,118
050,19,087,"Iowa","Henry County",4,68,230,112,118
050,19,087,"Iowa","Henry County",4,69,227,117,110
050,19,087,"Iowa","Henry County",4,70,217,106,111
050,19,087,"Iowa","Henry County",4,71,198,94,104
050,19,087,"Iowa","Henry County",4,72,208,105,103
050,19,087,"Iowa","Henry County",4,73,222,106,116
050,19,087,"Iowa","Henry County",4,74,206,99,107
050,19,087,"Iowa","Henry County",4,75,218,108,110
050,19,087,"Iowa","Henry County",4,76,149,62,87
050,19,087,"Iowa","Henry County",4,77,128,50,78
050,19,087,"Iowa","Henry County",4,78,147,69,78
050,19,087,"Iowa","Henry County",4,79,145,70,75
050,19,087,"Iowa","Henry County",4,80,120,60,60
050,19,087,"Iowa","Henry County",4,81,112,48,64
050,19,087,"Iowa","Henry County",4,82,91,34,57
050,19,087,"Iowa","Henry County",4,83,92,31,61
050,19,087,"Iowa","Henry County",4,84,89,39,50
050,19,087,"Iowa","Henry County",4,85,502,171,331
050,19,087,"Iowa","Henry County",5,0,194,111,83
050,19,087,"Iowa","Henry County",5,1,185,101,84
050,19,087,"Iowa","Henry County",5,2,168,88,80
050,19,087,"Iowa","Henry County",5,3,220,116,104
050,19,087,"Iowa","Henry County",5,4,215,110,105
050,19,087,"Iowa","Henry County",5,5,213,111,102
050,19,087,"Iowa","Henry County",5,6,214,105,109
050,19,087,"Iowa","Henry County",5,7,237,119,118
050,19,087,"Iowa","Henry County",5,8,237,119,118
050,19,087,"Iowa","Henry County",5,9,234,105,129
050,19,087,"Iowa","Henry County",5,10,241,109,132
050,19,087,"Iowa","Henry County",5,11,230,114,116
050,19,087,"Iowa","Henry County",5,12,238,120,118
050,19,087,"Iowa","Henry County",5,13,253,142,111
050,19,087,"Iowa","Henry County",5,14,247,136,111
050,19,087,"Iowa","Henry County",5,15,277,153,124
050,19,087,"Iowa","Henry County",5,16,258,138,120
050,19,087,"Iowa","Henry County",5,17,250,125,125
050,19,087,"Iowa","Henry County",5,18,231,127,104
050,19,087,"Iowa","Henry County",5,19,199,112,87
050,19,087,"Iowa","Henry County",5,20,233,125,108
050,19,087,"Iowa","Henry County",5,21,228,132,96
050,19,087,"Iowa","Henry County",5,22,243,135,108
050,19,087,"Iowa","Henry County",5,23,272,163,109
050,19,087,"Iowa","Henry County",5,24,234,129,105
050,19,087,"Iowa","Henry County",5,25,235,134,101
050,19,087,"Iowa","Henry County",5,26,235,137,98
050,19,087,"Iowa","Henry County",5,27,228,144,84
050,19,087,"Iowa","Henry County",5,28,229,128,101
050,19,087,"Iowa","Henry County",5,29,241,126,115
050,19,087,"Iowa","Henry County",5,30,256,157,99
050,19,087,"Iowa","Henry County",5,31,234,137,97
050,19,087,"Iowa","Henry County",5,32,238,147,91
050,19,087,"Iowa","Henry County",5,33,233,134,99
050,19,087,"Iowa","Henry County",5,34,203,111,92
050,19,087,"Iowa","Henry County",5,35,209,104,105
050,19,087,"Iowa","Henry County",5,36,243,128,115
050,19,087,"Iowa","Henry County",5,37,243,138,105
050,19,087,"Iowa","Henry County",5,38,253,154,99
050,19,087,"Iowa","Henry County",5,39,267,152,115
050,19,087,"Iowa","Henry County",5,40,248,147,101
050,19,087,"Iowa","Henry County",5,41,268,156,112
050,19,087,"Iowa","Henry County",5,42,244,125,119
050,19,087,"Iowa","Henry County",5,43,254,139,115
050,19,087,"Iowa","Henry County",5,44,218,114,104
050,19,087,"Iowa","Henry County",5,45,239,122,117
050,19,087,"Iowa","Henry County",5,46,231,124,107
050,19,087,"Iowa","Henry County",5,47,242,131,111
050,19,087,"Iowa","Henry County",5,48,208,111,97
050,19,087,"Iowa","Henry County",5,49,210,115,95
050,19,087,"Iowa","Henry County",5,50,211,112,99
050,19,087,"Iowa","Henry County",5,51,224,117,107
050,19,087,"Iowa","Henry County",5,52,271,142,129
050,19,087,"Iowa","Henry County",5,53,241,127,114
050,19,087,"Iowa","Henry County",5,54,240,127,113
050,19,087,"Iowa","Henry County",5,55,238,127,111
050,19,087,"Iowa","Henry County",5,56,245,130,115
050,19,087,"Iowa","Henry County",5,57,280,159,121
050,19,087,"Iowa","Henry County",5,58,276,139,137
050,19,087,"Iowa","Henry County",5,59,261,131,130
050,19,087,"Iowa","Henry County",5,60,265,142,123
050,19,087,"Iowa","Henry County",5,61,283,143,140
050,19,087,"Iowa","Henry County",5,62,278,138,140
050,19,087,"Iowa","Henry County",5,63,254,133,121
050,19,087,"Iowa","Henry County",5,64,262,136,126
050,19,087,"Iowa","Henry County",5,65,246,129,117
050,19,087,"Iowa","Henry County",5,66,243,122,121
050,19,087,"Iowa","Henry County",5,67,234,120,114
050,19,087,"Iowa","Henry County",5,68,223,106,117
050,19,087,"Iowa","Henry County",5,69,215,107,108
050,19,087,"Iowa","Henry County",5,70,222,113,109
050,19,087,"Iowa","Henry County",5,71,204,95,109
050,19,087,"Iowa","Henry County",5,72,193,91,102
050,19,087,"Iowa","Henry County",5,73,200,96,104
050,19,087,"Iowa","Henry County",5,74,212,101,111
050,19,087,"Iowa","Henry County",5,75,199,93,106
050,19,087,"Iowa","Henry County",5,76,210,100,110
050,19,087,"Iowa","Henry County",5,77,140,58,82
050,19,087,"Iowa","Henry County",5,78,130,53,77
050,19,087,"Iowa","Henry County",5,79,142,67,75
050,19,087,"Iowa","Henry County",5,80,135,69,66
050,19,087,"Iowa","Henry County",5,81,124,60,64
050,19,087,"Iowa","Henry County",5,82,99,37,62
050,19,087,"Iowa","Henry County",5,83,82,28,54
050,19,087,"Iowa","Henry County",5,84,83,28,55
050,19,087,"Iowa","Henry County",5,85,522,181,341
050,19,089,"Iowa","Howard County",1,0,122,61,61
050,19,089,"Iowa","Howard County",1,1,131,66,65
050,19,089,"Iowa","Howard County",1,2,131,68,63
050,19,089,"Iowa","Howard County",1,3,124,66,58
050,19,089,"Iowa","Howard County",1,4,124,60,64
050,19,089,"Iowa","Howard County",1,5,142,71,71
050,19,089,"Iowa","Howard County",1,6,130,69,61
050,19,089,"Iowa","Howard County",1,7,112,51,61
050,19,089,"Iowa","Howard County",1,8,121,59,62
050,19,089,"Iowa","Howard County",1,9,112,55,57
050,19,089,"Iowa","Howard County",1,10,151,73,78
050,19,089,"Iowa","Howard County",1,11,157,83,74
050,19,089,"Iowa","Howard County",1,12,151,79,72
050,19,089,"Iowa","Howard County",1,13,150,76,74
050,19,089,"Iowa","Howard County",1,14,150,77,73
050,19,089,"Iowa","Howard County",1,15,156,88,68
050,19,089,"Iowa","Howard County",1,16,153,84,69
050,19,089,"Iowa","Howard County",1,17,133,59,74
050,19,089,"Iowa","Howard County",1,18,100,52,48
050,19,089,"Iowa","Howard County",1,19,86,47,39
050,19,089,"Iowa","Howard County",1,20,80,43,37
050,19,089,"Iowa","Howard County",1,21,89,50,39
050,19,089,"Iowa","Howard County",1,22,93,45,48
050,19,089,"Iowa","Howard County",1,23,97,50,47
050,19,089,"Iowa","Howard County",1,24,100,45,55
050,19,089,"Iowa","Howard County",1,25,97,57,40
050,19,089,"Iowa","Howard County",1,26,102,52,50
050,19,089,"Iowa","Howard County",1,27,101,51,50
050,19,089,"Iowa","Howard County",1,28,98,45,53
050,19,089,"Iowa","Howard County",1,29,104,41,63
050,19,089,"Iowa","Howard County",1,30,103,46,57
050,19,089,"Iowa","Howard County",1,31,91,42,49
050,19,089,"Iowa","Howard County",1,32,85,37,48
050,19,089,"Iowa","Howard County",1,33,104,56,48
050,19,089,"Iowa","Howard County",1,34,106,56,50
050,19,089,"Iowa","Howard County",1,35,115,57,58
050,19,089,"Iowa","Howard County",1,36,107,58,49
050,19,089,"Iowa","Howard County",1,37,102,56,46
050,19,089,"Iowa","Howard County",1,38,122,60,62
050,19,089,"Iowa","Howard County",1,39,111,50,61
050,19,089,"Iowa","Howard County",1,40,107,61,46
050,19,089,"Iowa","Howard County",1,41,104,52,52
050,19,089,"Iowa","Howard County",1,42,120,59,61
050,19,089,"Iowa","Howard County",1,43,114,68,46
050,19,089,"Iowa","Howard County",1,44,94,52,42
050,19,089,"Iowa","Howard County",1,45,86,44,42
050,19,089,"Iowa","Howard County",1,46,84,43,41
050,19,089,"Iowa","Howard County",1,47,81,41,40
050,19,089,"Iowa","Howard County",1,48,89,43,46
050,19,089,"Iowa","Howard County",1,49,107,58,49
050,19,089,"Iowa","Howard County",1,50,109,53,56
050,19,089,"Iowa","Howard County",1,51,96,55,41
050,19,089,"Iowa","Howard County",1,52,95,48,47
050,19,089,"Iowa","Howard County",1,53,112,60,52
050,19,089,"Iowa","Howard County",1,54,129,64,65
050,19,089,"Iowa","Howard County",1,55,136,68,68
050,19,089,"Iowa","Howard County",1,56,127,64,63
050,19,089,"Iowa","Howard County",1,57,140,69,71
050,19,089,"Iowa","Howard County",1,58,146,81,65
050,19,089,"Iowa","Howard County",1,59,141,71,70
050,19,089,"Iowa","Howard County",1,60,146,71,75
050,19,089,"Iowa","Howard County",1,61,146,78,68
050,19,089,"Iowa","Howard County",1,62,142,75,67
050,19,089,"Iowa","Howard County",1,63,138,67,71
050,19,089,"Iowa","Howard County",1,64,138,72,66
050,19,089,"Iowa","Howard County",1,65,133,71,62
050,19,089,"Iowa","Howard County",1,66,111,62,49
050,19,089,"Iowa","Howard County",1,67,117,67,50
050,19,089,"Iowa","Howard County",1,68,117,59,58
050,19,089,"Iowa","Howard County",1,69,106,55,51
050,19,089,"Iowa","Howard County",1,70,90,53,37
050,19,089,"Iowa","Howard County",1,71,88,42,46
050,19,089,"Iowa","Howard County",1,72,89,44,45
050,19,089,"Iowa","Howard County",1,73,90,45,45
050,19,089,"Iowa","Howard County",1,74,72,32,40
050,19,089,"Iowa","Howard County",1,75,82,36,46
050,19,089,"Iowa","Howard County",1,76,87,45,42
050,19,089,"Iowa","Howard County",1,77,71,34,37
050,19,089,"Iowa","Howard County",1,78,55,25,30
050,19,089,"Iowa","Howard County",1,79,61,28,33
050,19,089,"Iowa","Howard County",1,80,52,18,34
050,19,089,"Iowa","Howard County",1,81,56,31,25
050,19,089,"Iowa","Howard County",1,82,51,24,27
050,19,089,"Iowa","Howard County",1,83,43,20,23
050,19,089,"Iowa","Howard County",1,84,39,13,26
050,19,089,"Iowa","Howard County",1,85,285,100,185
050,19,089,"Iowa","Howard County",2,0,123,63,60
050,19,089,"Iowa","Howard County",2,1,129,65,64
050,19,089,"Iowa","Howard County",2,2,131,67,64
050,19,089,"Iowa","Howard County",2,3,126,67,59
050,19,089,"Iowa","Howard County",2,4,124,62,62
050,19,089,"Iowa","Howard County",2,5,139,68,71
050,19,089,"Iowa","Howard County",2,6,133,69,64
050,19,089,"Iowa","Howard County",2,7,117,55,62
050,19,089,"Iowa","Howard County",2,8,119,57,62
050,19,089,"Iowa","Howard County",2,9,116,58,58
050,19,089,"Iowa","Howard County",2,10,142,69,73
050,19,089,"Iowa","Howard County",2,11,154,80,74
050,19,089,"Iowa","Howard County",2,12,154,81,73
050,19,089,"Iowa","Howard County",2,13,151,77,74
050,19,089,"Iowa","Howard County",2,14,150,75,75
050,19,089,"Iowa","Howard County",2,15,157,87,70
050,19,089,"Iowa","Howard County",2,16,155,85,70
050,19,089,"Iowa","Howard County",2,17,136,64,72
050,19,089,"Iowa","Howard County",2,18,102,52,50
050,19,089,"Iowa","Howard County",2,19,85,46,39
050,19,089,"Iowa","Howard County",2,20,85,46,39
050,19,089,"Iowa","Howard County",2,21,89,49,40
050,19,089,"Iowa","Howard County",2,22,93,46,47
050,19,089,"Iowa","Howard County",2,23,99,50,49
050,19,089,"Iowa","Howard County",2,24,100,47,53
050,19,089,"Iowa","Howard County",2,25,98,54,44
050,19,089,"Iowa","Howard County",2,26,101,53,48
050,19,089,"Iowa","Howard County",2,27,103,52,51
050,19,089,"Iowa","Howard County",2,28,97,45,52
050,19,089,"Iowa","Howard County",2,29,103,42,61
050,19,089,"Iowa","Howard County",2,30,103,44,59
050,19,089,"Iowa","Howard County",2,31,92,42,50
050,19,089,"Iowa","Howard County",2,32,88,39,49
050,19,089,"Iowa","Howard County",2,33,99,51,48
050,19,089,"Iowa","Howard County",2,34,107,56,51
050,19,089,"Iowa","Howard County",2,35,114,58,56
050,19,089,"Iowa","Howard County",2,36,107,57,50
050,19,089,"Iowa","Howard County",2,37,105,58,47
050,19,089,"Iowa","Howard County",2,38,117,59,58
050,19,089,"Iowa","Howard County",2,39,112,52,60
050,19,089,"Iowa","Howard County",2,40,109,59,50
050,19,089,"Iowa","Howard County",2,41,104,53,51
050,19,089,"Iowa","Howard County",2,42,116,58,58
050,19,089,"Iowa","Howard County",2,43,115,66,49
050,19,089,"Iowa","Howard County",2,44,99,56,43
050,19,089,"Iowa","Howard County",2,45,88,46,42
050,19,089,"Iowa","Howard County",2,46,85,43,42
050,19,089,"Iowa","Howard County",2,47,83,43,40
050,19,089,"Iowa","Howard County",2,48,87,42,45
050,19,089,"Iowa","Howard County",2,49,102,55,47
050,19,089,"Iowa","Howard County",2,50,108,54,54
050,19,089,"Iowa","Howard County",2,51,99,54,45
050,19,089,"Iowa","Howard County",2,52,95,50,45
050,19,089,"Iowa","Howard County",2,53,107,57,50
050,19,089,"Iowa","Howard County",2,54,123,62,61
050,19,089,"Iowa","Howard County",2,55,134,67,67
050,19,089,"Iowa","Howard County",2,56,130,65,65
050,19,089,"Iowa","Howard County",2,57,137,68,69
050,19,089,"Iowa","Howard County",2,58,146,79,67
050,19,089,"Iowa","Howard County",2,59,142,73,69
050,19,089,"Iowa","Howard County",2,60,147,73,74
050,19,089,"Iowa","Howard County",2,61,145,76,69
050,19,089,"Iowa","Howard County",2,62,142,75,67
050,19,089,"Iowa","Howard County",2,63,140,70,70
050,19,089,"Iowa","Howard County",2,64,137,71,66
050,19,089,"Iowa","Howard County",2,65,134,71,63
050,19,089,"Iowa","Howard County",2,66,116,64,52
050,19,089,"Iowa","Howard County",2,67,117,66,51
050,19,089,"Iowa","Howard County",2,68,116,61,55
050,19,089,"Iowa","Howard County",2,69,109,57,52
050,19,089,"Iowa","Howard County",2,70,95,54,41
050,19,089,"Iowa","Howard County",2,71,88,45,43
050,19,089,"Iowa","Howard County",2,72,86,43,43
050,19,089,"Iowa","Howard County",2,73,96,48,48
050,19,089,"Iowa","Howard County",2,74,72,33,39
050,19,089,"Iowa","Howard County",2,75,80,35,45
050,19,089,"Iowa","Howard County",2,76,82,40,42
050,19,089,"Iowa","Howard County",2,77,77,38,39
050,19,089,"Iowa","Howard County",2,78,58,26,32
050,19,089,"Iowa","Howard County",2,79,58,28,30
050,19,089,"Iowa","Howard County",2,80,54,20,34
050,19,089,"Iowa","Howard County",2,81,54,27,27
050,19,089,"Iowa","Howard County",2,82,52,25,27
050,19,089,"Iowa","Howard County",2,83,44,21,23
050,19,089,"Iowa","Howard County",2,84,39,14,25
050,19,089,"Iowa","Howard County",2,85,287,101,186
050,19,089,"Iowa","Howard County",3,0,128,64,64
050,19,089,"Iowa","Howard County",3,1,125,61,64
050,19,089,"Iowa","Howard County",3,2,133,64,69
050,19,089,"Iowa","Howard County",3,3,132,67,65
050,19,089,"Iowa","Howard County",3,4,126,68,58
050,19,089,"Iowa","Howard County",3,5,125,63,62
050,19,089,"Iowa","Howard County",3,6,138,68,70
050,19,089,"Iowa","Howard County",3,7,130,64,66
050,19,089,"Iowa","Howard County",3,8,119,56,63
050,19,089,"Iowa","Howard County",3,9,120,58,62
050,19,089,"Iowa","Howard County",3,10,117,59,58
050,19,089,"Iowa","Howard County",3,11,136,65,71
050,19,089,"Iowa","Howard County",3,12,151,77,74
050,19,089,"Iowa","Howard County",3,13,154,84,70
050,19,089,"Iowa","Howard County",3,14,145,73,72
050,19,089,"Iowa","Howard County",3,15,148,74,74
050,19,089,"Iowa","Howard County",3,16,157,87,70
050,19,089,"Iowa","Howard County",3,17,151,83,68
050,19,089,"Iowa","Howard County",3,18,116,57,59
050,19,089,"Iowa","Howard County",3,19,81,40,41
050,19,089,"Iowa","Howard County",3,20,92,45,47
050,19,089,"Iowa","Howard County",3,21,98,51,47
050,19,089,"Iowa","Howard County",3,22,96,54,42
050,19,089,"Iowa","Howard County",3,23,102,51,51
050,19,089,"Iowa","Howard County",3,24,88,46,42
050,19,089,"Iowa","Howard County",3,25,108,53,55
050,19,089,"Iowa","Howard County",3,26,95,51,44
050,19,089,"Iowa","Howard County",3,27,109,57,52
050,19,089,"Iowa","Howard County",3,28,104,55,49
050,19,089,"Iowa","Howard County",3,29,92,40,52
050,19,089,"Iowa","Howard County",3,30,100,45,55
050,19,089,"Iowa","Howard County",3,31,96,41,55
050,19,089,"Iowa","Howard County",3,32,93,45,48
050,19,089,"Iowa","Howard County",3,33,89,42,47
050,19,089,"Iowa","Howard County",3,34,107,57,50
050,19,089,"Iowa","Howard County",3,35,109,54,55
050,19,089,"Iowa","Howard County",3,36,109,57,52
050,19,089,"Iowa","Howard County",3,37,106,54,52
050,19,089,"Iowa","Howard County",3,38,107,63,44
050,19,089,"Iowa","Howard County",3,39,123,64,59
050,19,089,"Iowa","Howard County",3,40,112,53,59
050,19,089,"Iowa","Howard County",3,41,109,59,50
050,19,089,"Iowa","Howard County",3,42,106,54,52
050,19,089,"Iowa","Howard County",3,43,114,58,56
050,19,089,"Iowa","Howard County",3,44,114,64,50
050,19,089,"Iowa","Howard County",3,45,103,55,48
050,19,089,"Iowa","Howard County",3,46,93,46,47
050,19,089,"Iowa","Howard County",3,47,87,44,43
050,19,089,"Iowa","Howard County",3,48,88,48,40
050,19,089,"Iowa","Howard County",3,49,92,47,45
050,19,089,"Iowa","Howard County",3,50,98,53,45
050,19,089,"Iowa","Howard County",3,51,105,52,53
050,19,089,"Iowa","Howard County",3,52,108,61,47
050,19,089,"Iowa","Howard County",3,53,94,48,46
050,19,089,"Iowa","Howard County",3,54,109,57,52
050,19,089,"Iowa","Howard County",3,55,123,62,61
050,19,089,"Iowa","Howard County",3,56,135,68,67
050,19,089,"Iowa","Howard County",3,57,132,63,69
050,19,089,"Iowa","Howard County",3,58,137,71,66
050,19,089,"Iowa","Howard County",3,59,150,82,68
050,19,089,"Iowa","Howard County",3,60,142,73,69
050,19,089,"Iowa","Howard County",3,61,148,77,71
050,19,089,"Iowa","Howard County",3,62,140,70,70
050,19,089,"Iowa","Howard County",3,63,144,75,69
050,19,089,"Iowa","Howard County",3,64,137,69,68
050,19,089,"Iowa","Howard County",3,65,131,66,65
050,19,089,"Iowa","Howard County",3,66,133,70,63
050,19,089,"Iowa","Howard County",3,67,114,62,52
050,19,089,"Iowa","Howard County",3,68,115,65,50
050,19,089,"Iowa","Howard County",3,69,109,58,51
050,19,089,"Iowa","Howard County",3,70,108,57,51
050,19,089,"Iowa","Howard County",3,71,91,49,42
050,19,089,"Iowa","Howard County",3,72,84,45,39
050,19,089,"Iowa","Howard County",3,73,88,44,44
050,19,089,"Iowa","Howard County",3,74,90,45,45
050,19,089,"Iowa","Howard County",3,75,71,32,39
050,19,089,"Iowa","Howard County",3,76,70,32,38
050,19,089,"Iowa","Howard County",3,77,79,36,43
050,19,089,"Iowa","Howard County",3,78,74,35,39
050,19,089,"Iowa","Howard County",3,79,55,27,28
050,19,089,"Iowa","Howard County",3,80,55,25,30
050,19,089,"Iowa","Howard County",3,81,52,20,32
050,19,089,"Iowa","Howard County",3,82,52,24,28
050,19,089,"Iowa","Howard County",3,83,46,22,24
050,19,089,"Iowa","Howard County",3,84,37,18,19
050,19,089,"Iowa","Howard County",3,85,267,93,174
050,19,089,"Iowa","Howard County",4,0,122,70,52
050,19,089,"Iowa","Howard County",4,1,116,62,54
050,19,089,"Iowa","Howard County",4,2,133,68,65
050,19,089,"Iowa","Howard County",4,3,131,60,71
050,19,089,"Iowa","Howard County",4,4,129,67,62
050,19,089,"Iowa","Howard County",4,5,128,68,60
050,19,089,"Iowa","Howard County",4,6,122,63,59
050,19,089,"Iowa","Howard County",4,7,147,73,74
050,19,089,"Iowa","Howard County",4,8,128,62,66
050,19,089,"Iowa","Howard County",4,9,129,63,66
050,19,089,"Iowa","Howard County",4,10,118,56,62
050,19,089,"Iowa","Howard County",4,11,119,59,60
050,19,089,"Iowa","Howard County",4,12,148,73,75
050,19,089,"Iowa","Howard County",4,13,155,79,76
050,19,089,"Iowa","Howard County",4,14,158,84,74
050,19,089,"Iowa","Howard County",4,15,148,76,72
050,19,089,"Iowa","Howard County",4,16,153,75,78
050,19,089,"Iowa","Howard County",4,17,155,82,73
050,19,089,"Iowa","Howard County",4,18,128,73,55
050,19,089,"Iowa","Howard County",4,19,88,40,48
050,19,089,"Iowa","Howard County",4,20,84,39,45
050,19,089,"Iowa","Howard County",4,21,96,48,48
050,19,089,"Iowa","Howard County",4,22,101,50,51
050,19,089,"Iowa","Howard County",4,23,101,60,41
050,19,089,"Iowa","Howard County",4,24,100,51,49
050,19,089,"Iowa","Howard County",4,25,89,52,37
050,19,089,"Iowa","Howard County",4,26,112,54,58
050,19,089,"Iowa","Howard County",4,27,92,48,44
050,19,089,"Iowa","Howard County",4,28,109,57,52
050,19,089,"Iowa","Howard County",4,29,99,56,43
050,19,089,"Iowa","Howard County",4,30,93,40,53
050,19,089,"Iowa","Howard County",4,31,103,46,57
050,19,089,"Iowa","Howard County",4,32,101,44,57
050,19,089,"Iowa","Howard County",4,33,92,42,50
050,19,089,"Iowa","Howard County",4,34,92,44,48
050,19,089,"Iowa","Howard County",4,35,108,63,45
050,19,089,"Iowa","Howard County",4,36,106,52,54
050,19,089,"Iowa","Howard County",4,37,108,58,50
050,19,089,"Iowa","Howard County",4,38,110,57,53
050,19,089,"Iowa","Howard County",4,39,116,71,45
050,19,089,"Iowa","Howard County",4,40,125,64,61
050,19,089,"Iowa","Howard County",4,41,114,54,60
050,19,089,"Iowa","Howard County",4,42,107,58,49
050,19,089,"Iowa","Howard County",4,43,106,56,50
050,19,089,"Iowa","Howard County",4,44,115,59,56
050,19,089,"Iowa","Howard County",4,45,114,66,48
050,19,089,"Iowa","Howard County",4,46,102,54,48
050,19,089,"Iowa","Howard County",4,47,91,45,46
050,19,089,"Iowa","Howard County",4,48,92,45,47
050,19,089,"Iowa","Howard County",4,49,88,45,43
050,19,089,"Iowa","Howard County",4,50,90,46,44
050,19,089,"Iowa","Howard County",4,51,96,51,45
050,19,089,"Iowa","Howard County",4,52,101,47,54
050,19,089,"Iowa","Howard County",4,53,104,57,47
050,19,089,"Iowa","Howard County",4,54,96,49,47
050,19,089,"Iowa","Howard County",4,55,111,58,53
050,19,089,"Iowa","Howard County",4,56,119,62,57
050,19,089,"Iowa","Howard County",4,57,133,67,66
050,19,089,"Iowa","Howard County",4,58,133,63,70
050,19,089,"Iowa","Howard County",4,59,140,74,66
050,19,089,"Iowa","Howard County",4,60,153,82,71
050,19,089,"Iowa","Howard County",4,61,146,75,71
050,19,089,"Iowa","Howard County",4,62,145,72,73
050,19,089,"Iowa","Howard County",4,63,139,68,71
050,19,089,"Iowa","Howard County",4,64,139,72,67
050,19,089,"Iowa","Howard County",4,65,139,68,71
050,19,089,"Iowa","Howard County",4,66,125,61,64
050,19,089,"Iowa","Howard County",4,67,129,68,61
050,19,089,"Iowa","Howard County",4,68,114,63,51
050,19,089,"Iowa","Howard County",4,69,111,62,49
050,19,089,"Iowa","Howard County",4,70,107,57,50
050,19,089,"Iowa","Howard County",4,71,104,54,50
050,19,089,"Iowa","Howard County",4,72,90,51,39
050,19,089,"Iowa","Howard County",4,73,86,44,42
050,19,089,"Iowa","Howard County",4,74,84,41,43
050,19,089,"Iowa","Howard County",4,75,88,42,46
050,19,089,"Iowa","Howard County",4,76,62,29,33
050,19,089,"Iowa","Howard County",4,77,69,30,39
050,19,089,"Iowa","Howard County",4,78,75,31,44
050,19,089,"Iowa","Howard County",4,79,72,37,35
050,19,089,"Iowa","Howard County",4,80,51,26,25
050,19,089,"Iowa","Howard County",4,81,53,25,28
050,19,089,"Iowa","Howard County",4,82,49,15,34
050,19,089,"Iowa","Howard County",4,83,43,20,23
050,19,089,"Iowa","Howard County",4,84,45,22,23
050,19,089,"Iowa","Howard County",4,85,247,87,160
050,19,089,"Iowa","Howard County",5,0,127,72,55
050,19,089,"Iowa","Howard County",5,1,118,70,48
050,19,089,"Iowa","Howard County",5,2,105,54,51
050,19,089,"Iowa","Howard County",5,3,126,66,60
050,19,089,"Iowa","Howard County",5,4,131,59,72
050,19,089,"Iowa","Howard County",5,5,128,66,62
050,19,089,"Iowa","Howard County",5,6,129,68,61
050,19,089,"Iowa","Howard County",5,7,122,65,57
050,19,089,"Iowa","Howard County",5,8,144,72,72
050,19,089,"Iowa","Howard County",5,9,123,57,66
050,19,089,"Iowa","Howard County",5,10,127,61,66
050,19,089,"Iowa","Howard County",5,11,117,53,64
050,19,089,"Iowa","Howard County",5,12,120,60,60
050,19,089,"Iowa","Howard County",5,13,136,67,69
050,19,089,"Iowa","Howard County",5,14,150,77,73
050,19,089,"Iowa","Howard County",5,15,159,81,78
050,19,089,"Iowa","Howard County",5,16,144,72,72
050,19,089,"Iowa","Howard County",5,17,144,73,71
050,19,089,"Iowa","Howard County",5,18,121,66,55
050,19,089,"Iowa","Howard County",5,19,92,52,40
050,19,089,"Iowa","Howard County",5,20,89,38,51
050,19,089,"Iowa","Howard County",5,21,93,44,49
050,19,089,"Iowa","Howard County",5,22,97,52,45
050,19,089,"Iowa","Howard County",5,23,114,58,56
050,19,089,"Iowa","Howard County",5,24,100,55,45
050,19,089,"Iowa","Howard County",5,25,102,58,44
050,19,089,"Iowa","Howard County",5,26,84,48,36
050,19,089,"Iowa","Howard County",5,27,109,53,56
050,19,089,"Iowa","Howard County",5,28,91,51,40
050,19,089,"Iowa","Howard County",5,29,107,57,50
050,19,089,"Iowa","Howard County",5,30,99,56,43
050,19,089,"Iowa","Howard County",5,31,92,40,52
050,19,089,"Iowa","Howard County",5,32,104,50,54
050,19,089,"Iowa","Howard County",5,33,99,47,52
050,19,089,"Iowa","Howard County",5,34,88,41,47
050,19,089,"Iowa","Howard County",5,35,92,43,49
050,19,089,"Iowa","Howard County",5,36,106,61,45
050,19,089,"Iowa","Howard County",5,37,104,50,54
050,19,089,"Iowa","Howard County",5,38,114,63,51
050,19,089,"Iowa","Howard County",5,39,107,59,48
050,19,089,"Iowa","Howard County",5,40,116,71,45
050,19,089,"Iowa","Howard County",5,41,120,60,60
050,19,089,"Iowa","Howard County",5,42,112,54,58
050,19,089,"Iowa","Howard County",5,43,107,59,48
050,19,089,"Iowa","Howard County",5,44,109,59,50
050,19,089,"Iowa","Howard County",5,45,108,56,52
050,19,089,"Iowa","Howard County",5,46,112,64,48
050,19,089,"Iowa","Howard County",5,47,102,54,48
050,19,089,"Iowa","Howard County",5,48,87,44,43
050,19,089,"Iowa","Howard County",5,49,93,46,47
050,19,089,"Iowa","Howard County",5,50,83,41,42
050,19,089,"Iowa","Howard County",5,51,92,50,42
050,19,089,"Iowa","Howard County",5,52,100,51,49
050,19,089,"Iowa","Howard County",5,53,101,47,54
050,19,089,"Iowa","Howard County",5,54,105,58,47
050,19,089,"Iowa","Howard County",5,55,94,49,45
050,19,089,"Iowa","Howard County",5,56,114,60,54
050,19,089,"Iowa","Howard County",5,57,120,62,58
050,19,089,"Iowa","Howard County",5,58,129,65,64
050,19,089,"Iowa","Howard County",5,59,133,62,71
050,19,089,"Iowa","Howard County",5,60,135,70,65
050,19,089,"Iowa","Howard County",5,61,158,84,74
050,19,089,"Iowa","Howard County",5,62,148,76,72
050,19,089,"Iowa","Howard County",5,63,145,73,72
050,19,089,"Iowa","Howard County",5,64,135,67,68
050,19,089,"Iowa","Howard County",5,65,133,69,64
050,19,089,"Iowa","Howard County",5,66,135,68,67
050,19,089,"Iowa","Howard County",5,67,123,60,63
050,19,089,"Iowa","Howard County",5,68,125,66,59
050,19,089,"Iowa","Howard County",5,69,112,61,51
050,19,089,"Iowa","Howard County",5,70,111,60,51
050,19,089,"Iowa","Howard County",5,71,109,56,53
050,19,089,"Iowa","Howard County",5,72,99,55,44
050,19,089,"Iowa","Howard County",5,73,92,51,41
050,19,089,"Iowa","Howard County",5,74,81,40,41
050,19,089,"Iowa","Howard County",5,75,83,39,44
050,19,089,"Iowa","Howard County",5,76,81,40,41
050,19,089,"Iowa","Howard County",5,77,63,27,36
050,19,089,"Iowa","Howard County",5,78,64,25,39
050,19,089,"Iowa","Howard County",5,79,72,32,40
050,19,089,"Iowa","Howard County",5,80,66,34,32
050,19,089,"Iowa","Howard County",5,81,49,26,23
050,19,089,"Iowa","Howard County",5,82,49,21,28
050,19,089,"Iowa","Howard County",5,83,40,11,29
050,19,089,"Iowa","Howard County",5,84,39,18,21
050,19,089,"Iowa","Howard County",5,85,238,88,150
050,19,091,"Iowa","Humboldt County",1,0,105,55,50
050,19,091,"Iowa","Humboldt County",1,1,124,64,60
050,19,091,"Iowa","Humboldt County",1,2,109,47,62
050,19,091,"Iowa","Humboldt County",1,3,115,63,52
050,19,091,"Iowa","Humboldt County",1,4,126,58,68
050,19,091,"Iowa","Humboldt County",1,5,129,67,62
050,19,091,"Iowa","Humboldt County",1,6,126,62,64
050,19,091,"Iowa","Humboldt County",1,7,127,62,65
050,19,091,"Iowa","Humboldt County",1,8,118,62,56
050,19,091,"Iowa","Humboldt County",1,9,113,55,58
050,19,091,"Iowa","Humboldt County",1,10,124,61,63
050,19,091,"Iowa","Humboldt County",1,11,136,72,64
050,19,091,"Iowa","Humboldt County",1,12,145,76,69
050,19,091,"Iowa","Humboldt County",1,13,155,83,72
050,19,091,"Iowa","Humboldt County",1,14,149,76,73
050,19,091,"Iowa","Humboldt County",1,15,145,76,69
050,19,091,"Iowa","Humboldt County",1,16,125,64,61
050,19,091,"Iowa","Humboldt County",1,17,128,59,69
050,19,091,"Iowa","Humboldt County",1,18,106,47,59
050,19,091,"Iowa","Humboldt County",1,19,84,41,43
050,19,091,"Iowa","Humboldt County",1,20,84,40,44
050,19,091,"Iowa","Humboldt County",1,21,88,45,43
050,19,091,"Iowa","Humboldt County",1,22,92,51,41
050,19,091,"Iowa","Humboldt County",1,23,92,48,44
050,19,091,"Iowa","Humboldt County",1,24,101,54,47
050,19,091,"Iowa","Humboldt County",1,25,93,49,44
050,19,091,"Iowa","Humboldt County",1,26,85,50,35
050,19,091,"Iowa","Humboldt County",1,27,95,51,44
050,19,091,"Iowa","Humboldt County",1,28,94,49,45
050,19,091,"Iowa","Humboldt County",1,29,98,50,48
050,19,091,"Iowa","Humboldt County",1,30,112,54,58
050,19,091,"Iowa","Humboldt County",1,31,98,45,53
050,19,091,"Iowa","Humboldt County",1,32,103,52,51
050,19,091,"Iowa","Humboldt County",1,33,117,55,62
050,19,091,"Iowa","Humboldt County",1,34,137,61,76
050,19,091,"Iowa","Humboldt County",1,35,115,50,65
050,19,091,"Iowa","Humboldt County",1,36,124,63,61
050,19,091,"Iowa","Humboldt County",1,37,122,69,53
050,19,091,"Iowa","Humboldt County",1,38,133,69,64
050,19,091,"Iowa","Humboldt County",1,39,116,65,51
050,19,091,"Iowa","Humboldt County",1,40,126,67,59
050,19,091,"Iowa","Humboldt County",1,41,108,60,48
050,19,091,"Iowa","Humboldt County",1,42,109,60,49
050,19,091,"Iowa","Humboldt County",1,43,100,52,48
050,19,091,"Iowa","Humboldt County",1,44,85,41,44
050,19,091,"Iowa","Humboldt County",1,45,78,40,38
050,19,091,"Iowa","Humboldt County",1,46,74,37,37
050,19,091,"Iowa","Humboldt County",1,47,89,42,47
050,19,091,"Iowa","Humboldt County",1,48,101,56,45
050,19,091,"Iowa","Humboldt County",1,49,111,59,52
050,19,091,"Iowa","Humboldt County",1,50,122,65,57
050,19,091,"Iowa","Humboldt County",1,51,109,59,50
050,19,091,"Iowa","Humboldt County",1,52,83,37,46
050,19,091,"Iowa","Humboldt County",1,53,97,49,48
050,19,091,"Iowa","Humboldt County",1,54,113,57,56
050,19,091,"Iowa","Humboldt County",1,55,130,66,64
050,19,091,"Iowa","Humboldt County",1,56,131,64,67
050,19,091,"Iowa","Humboldt County",1,57,147,74,73
050,19,091,"Iowa","Humboldt County",1,58,155,80,75
050,19,091,"Iowa","Humboldt County",1,59,160,81,79
050,19,091,"Iowa","Humboldt County",1,60,167,79,88
050,19,091,"Iowa","Humboldt County",1,61,154,73,81
050,19,091,"Iowa","Humboldt County",1,62,150,71,79
050,19,091,"Iowa","Humboldt County",1,63,161,85,76
050,19,091,"Iowa","Humboldt County",1,64,144,68,76
050,19,091,"Iowa","Humboldt County",1,65,126,64,62
050,19,091,"Iowa","Humboldt County",1,66,137,68,69
050,19,091,"Iowa","Humboldt County",1,67,124,67,57
050,19,091,"Iowa","Humboldt County",1,68,111,56,55
050,19,091,"Iowa","Humboldt County",1,69,96,49,47
050,19,091,"Iowa","Humboldt County",1,70,113,61,52
050,19,091,"Iowa","Humboldt County",1,71,101,53,48
050,19,091,"Iowa","Humboldt County",1,72,105,55,50
050,19,091,"Iowa","Humboldt County",1,73,94,45,49
050,19,091,"Iowa","Humboldt County",1,74,76,32,44
050,19,091,"Iowa","Humboldt County",1,75,63,25,38
050,19,091,"Iowa","Humboldt County",1,76,68,36,32
050,19,091,"Iowa","Humboldt County",1,77,75,36,39
050,19,091,"Iowa","Humboldt County",1,78,69,31,38
050,19,091,"Iowa","Humboldt County",1,79,65,34,31
050,19,091,"Iowa","Humboldt County",1,80,54,23,31
050,19,091,"Iowa","Humboldt County",1,81,57,25,32
050,19,091,"Iowa","Humboldt County",1,82,50,19,31
050,19,091,"Iowa","Humboldt County",1,83,51,21,30
050,19,091,"Iowa","Humboldt County",1,84,48,21,27
050,19,091,"Iowa","Humboldt County",1,85,324,112,212
050,19,091,"Iowa","Humboldt County",2,0,103,56,47
050,19,091,"Iowa","Humboldt County",2,1,118,61,57
050,19,091,"Iowa","Humboldt County",2,2,112,51,61
050,19,091,"Iowa","Humboldt County",2,3,115,59,56
050,19,091,"Iowa","Humboldt County",2,4,124,59,65
050,19,091,"Iowa","Humboldt County",2,5,127,64,63
050,19,091,"Iowa","Humboldt County",2,6,130,64,66
050,19,091,"Iowa","Humboldt County",2,7,129,63,66
050,19,091,"Iowa","Humboldt County",2,8,121,61,60
050,19,091,"Iowa","Humboldt County",2,9,113,56,57
050,19,091,"Iowa","Humboldt County",2,10,122,59,63
050,19,091,"Iowa","Humboldt County",2,11,135,70,65
050,19,091,"Iowa","Humboldt County",2,12,143,75,68
050,19,091,"Iowa","Humboldt County",2,13,153,82,71
050,19,091,"Iowa","Humboldt County",2,14,150,79,71
050,19,091,"Iowa","Humboldt County",2,15,144,75,69
050,19,091,"Iowa","Humboldt County",2,16,130,66,64
050,19,091,"Iowa","Humboldt County",2,17,128,61,67
050,19,091,"Iowa","Humboldt County",2,18,107,48,59
050,19,091,"Iowa","Humboldt County",2,19,84,40,44
050,19,091,"Iowa","Humboldt County",2,20,85,41,44
050,19,091,"Iowa","Humboldt County",2,21,89,45,44
050,19,091,"Iowa","Humboldt County",2,22,92,49,43
050,19,091,"Iowa","Humboldt County",2,23,93,49,44
050,19,091,"Iowa","Humboldt County",2,24,97,52,45
050,19,091,"Iowa","Humboldt County",2,25,94,50,44
050,19,091,"Iowa","Humboldt County",2,26,86,49,37
050,19,091,"Iowa","Humboldt County",2,27,94,52,42
050,19,091,"Iowa","Humboldt County",2,28,96,50,46
050,19,091,"Iowa","Humboldt County",2,29,99,51,48
050,19,091,"Iowa","Humboldt County",2,30,110,53,57
050,19,091,"Iowa","Humboldt County",2,31,102,48,54
050,19,091,"Iowa","Humboldt County",2,32,104,51,53
050,19,091,"Iowa","Humboldt County",2,33,114,54,60
050,19,091,"Iowa","Humboldt County",2,34,132,60,72
050,19,091,"Iowa","Humboldt County",2,35,119,52,67
050,19,091,"Iowa","Humboldt County",2,36,121,59,62
050,19,091,"Iowa","Humboldt County",2,37,123,67,56
050,19,091,"Iowa","Humboldt County",2,38,132,70,62
050,19,091,"Iowa","Humboldt County",2,39,120,66,54
050,19,091,"Iowa","Humboldt County",2,40,124,67,57
050,19,091,"Iowa","Humboldt County",2,41,111,61,50
050,19,091,"Iowa","Humboldt County",2,42,108,60,48
050,19,091,"Iowa","Humboldt County",2,43,104,55,49
050,19,091,"Iowa","Humboldt County",2,44,89,44,45
050,19,091,"Iowa","Humboldt County",2,45,80,40,40
050,19,091,"Iowa","Humboldt County",2,46,75,38,37
050,19,091,"Iowa","Humboldt County",2,47,85,40,45
050,19,091,"Iowa","Humboldt County",2,48,99,53,46
050,19,091,"Iowa","Humboldt County",2,49,110,59,51
050,19,091,"Iowa","Humboldt County",2,50,117,63,54
050,19,091,"Iowa","Humboldt County",2,51,109,59,50
050,19,091,"Iowa","Humboldt County",2,52,90,42,48
050,19,091,"Iowa","Humboldt County",2,53,93,46,47
050,19,091,"Iowa","Humboldt County",2,54,109,55,54
050,19,091,"Iowa","Humboldt County",2,55,126,63,63
050,19,091,"Iowa","Humboldt County",2,56,132,65,67
050,19,091,"Iowa","Humboldt County",2,57,143,71,72
050,19,091,"Iowa","Humboldt County",2,58,155,80,75
050,19,091,"Iowa","Humboldt County",2,59,157,79,78
050,19,091,"Iowa","Humboldt County",2,60,163,78,85
050,19,091,"Iowa","Humboldt County",2,61,155,74,81
050,19,091,"Iowa","Humboldt County",2,62,150,71,79
050,19,091,"Iowa","Humboldt County",2,63,159,81,78
050,19,091,"Iowa","Humboldt County",2,64,147,71,76
050,19,091,"Iowa","Humboldt County",2,65,131,66,65
050,19,091,"Iowa","Humboldt County",2,66,134,67,67
050,19,091,"Iowa","Humboldt County",2,67,127,67,60
050,19,091,"Iowa","Humboldt County",2,68,112,57,55
050,19,091,"Iowa","Humboldt County",2,69,97,50,47
050,19,091,"Iowa","Humboldt County",2,70,109,58,51
050,19,091,"Iowa","Humboldt County",2,71,104,55,49
050,19,091,"Iowa","Humboldt County",2,72,101,51,50
050,19,091,"Iowa","Humboldt County",2,73,100,49,51
050,19,091,"Iowa","Humboldt County",2,74,74,32,42
050,19,091,"Iowa","Humboldt County",2,75,66,27,39
050,19,091,"Iowa","Humboldt County",2,76,66,33,33
050,19,091,"Iowa","Humboldt County",2,77,76,37,39
050,19,091,"Iowa","Humboldt County",2,78,69,31,38
050,19,091,"Iowa","Humboldt County",2,79,67,35,32
050,19,091,"Iowa","Humboldt County",2,80,55,24,31
050,19,091,"Iowa","Humboldt County",2,81,55,24,31
050,19,091,"Iowa","Humboldt County",2,82,52,21,31
050,19,091,"Iowa","Humboldt County",2,83,50,20,30
050,19,091,"Iowa","Humboldt County",2,84,48,21,27
050,19,091,"Iowa","Humboldt County",2,85,326,113,213
050,19,091,"Iowa","Humboldt County",3,0,108,51,57
050,19,091,"Iowa","Humboldt County",3,1,111,55,56
050,19,091,"Iowa","Humboldt County",3,2,121,64,57
050,19,091,"Iowa","Humboldt County",3,3,116,56,60
050,19,091,"Iowa","Humboldt County",3,4,116,61,55
050,19,091,"Iowa","Humboldt County",3,5,127,63,64
050,19,091,"Iowa","Humboldt County",3,6,132,71,61
050,19,091,"Iowa","Humboldt County",3,7,130,67,63
050,19,091,"Iowa","Humboldt County",3,8,124,56,68
050,19,091,"Iowa","Humboldt County",3,9,127,66,61
050,19,091,"Iowa","Humboldt County",3,10,106,56,50
050,19,091,"Iowa","Humboldt County",3,11,131,65,66
050,19,091,"Iowa","Humboldt County",3,12,127,67,60
050,19,091,"Iowa","Humboldt County",3,13,142,73,69
050,19,091,"Iowa","Humboldt County",3,14,160,84,76
050,19,091,"Iowa","Humboldt County",3,15,143,75,68
050,19,091,"Iowa","Humboldt County",3,16,143,73,70
050,19,091,"Iowa","Humboldt County",3,17,128,68,60
050,19,091,"Iowa","Humboldt County",3,18,109,52,57
050,19,091,"Iowa","Humboldt County",3,19,90,42,48
050,19,091,"Iowa","Humboldt County",3,20,89,45,44
050,19,091,"Iowa","Humboldt County",3,21,88,44,44
050,19,091,"Iowa","Humboldt County",3,22,88,49,39
050,19,091,"Iowa","Humboldt County",3,23,99,53,46
050,19,091,"Iowa","Humboldt County",3,24,92,43,49
050,19,091,"Iowa","Humboldt County",3,25,95,54,41
050,19,091,"Iowa","Humboldt County",3,26,96,52,44
050,19,091,"Iowa","Humboldt County",3,27,87,43,44
050,19,091,"Iowa","Humboldt County",3,28,106,60,46
050,19,091,"Iowa","Humboldt County",3,29,104,54,50
050,19,091,"Iowa","Humboldt County",3,30,99,56,43
050,19,091,"Iowa","Humboldt County",3,31,124,62,62
050,19,091,"Iowa","Humboldt County",3,32,102,47,55
050,19,091,"Iowa","Humboldt County",3,33,97,46,51
050,19,091,"Iowa","Humboldt County",3,34,115,59,56
050,19,091,"Iowa","Humboldt County",3,35,132,60,72
050,19,091,"Iowa","Humboldt County",3,36,122,55,67
050,19,091,"Iowa","Humboldt County",3,37,126,63,63
050,19,091,"Iowa","Humboldt County",3,38,119,66,53
050,19,091,"Iowa","Humboldt County",3,39,136,71,65
050,19,091,"Iowa","Humboldt County",3,40,126,72,54
050,19,091,"Iowa","Humboldt County",3,41,127,68,59
050,19,091,"Iowa","Humboldt County",3,42,110,57,53
050,19,091,"Iowa","Humboldt County",3,43,107,57,50
050,19,091,"Iowa","Humboldt County",3,44,108,58,50
050,19,091,"Iowa","Humboldt County",3,45,94,48,46
050,19,091,"Iowa","Humboldt County",3,46,81,40,41
050,19,091,"Iowa","Humboldt County",3,47,71,37,34
050,19,091,"Iowa","Humboldt County",3,48,81,37,44
050,19,091,"Iowa","Humboldt County",3,49,99,53,46
050,19,091,"Iowa","Humboldt County",3,50,109,60,49
050,19,091,"Iowa","Humboldt County",3,51,119,65,54
050,19,091,"Iowa","Humboldt County",3,52,116,63,53
050,19,091,"Iowa","Humboldt County",3,53,90,41,49
050,19,091,"Iowa","Humboldt County",3,54,90,44,46
050,19,091,"Iowa","Humboldt County",3,55,113,58,55
050,19,091,"Iowa","Humboldt County",3,56,120,61,59
050,19,091,"Iowa","Humboldt County",3,57,129,63,66
050,19,091,"Iowa","Humboldt County",3,58,144,80,64
050,19,091,"Iowa","Humboldt County",3,59,146,71,75
050,19,091,"Iowa","Humboldt County",3,60,154,76,78
050,19,091,"Iowa","Humboldt County",3,61,153,72,81
050,19,091,"Iowa","Humboldt County",3,62,152,71,81
050,19,091,"Iowa","Humboldt County",3,63,152,71,81
050,19,091,"Iowa","Humboldt County",3,64,159,80,79
050,19,091,"Iowa","Humboldt County",3,65,143,69,74
050,19,091,"Iowa","Humboldt County",3,66,132,66,66
050,19,091,"Iowa","Humboldt County",3,67,135,68,67
050,19,091,"Iowa","Humboldt County",3,68,128,69,59
050,19,091,"Iowa","Humboldt County",3,69,109,56,53
050,19,091,"Iowa","Humboldt County",3,70,98,49,49
050,19,091,"Iowa","Humboldt County",3,71,107,54,53
050,19,091,"Iowa","Humboldt County",3,72,100,54,46
050,19,091,"Iowa","Humboldt County",3,73,98,51,47
050,19,091,"Iowa","Humboldt County",3,74,95,47,48
050,19,091,"Iowa","Humboldt County",3,75,70,30,40
050,19,091,"Iowa","Humboldt County",3,76,66,27,39
050,19,091,"Iowa","Humboldt County",3,77,62,31,31
050,19,091,"Iowa","Humboldt County",3,78,73,32,41
050,19,091,"Iowa","Humboldt County",3,79,71,36,35
050,19,091,"Iowa","Humboldt County",3,80,55,26,29
050,19,091,"Iowa","Humboldt County",3,81,56,25,31
050,19,091,"Iowa","Humboldt County",3,82,54,24,30
050,19,091,"Iowa","Humboldt County",3,83,45,18,27
050,19,091,"Iowa","Humboldt County",3,84,49,21,28
050,19,091,"Iowa","Humboldt County",3,85,327,112,215
050,19,091,"Iowa","Humboldt County",4,0,121,62,59
050,19,091,"Iowa","Humboldt County",4,1,106,47,59
050,19,091,"Iowa","Humboldt County",4,2,114,57,57
050,19,091,"Iowa","Humboldt County",4,3,120,65,55
050,19,091,"Iowa","Humboldt County",4,4,117,58,59
050,19,091,"Iowa","Humboldt County",4,5,119,60,59
050,19,091,"Iowa","Humboldt County",4,6,128,62,66
050,19,091,"Iowa","Humboldt County",4,7,130,67,63
050,19,091,"Iowa","Humboldt County",4,8,131,67,64
050,19,091,"Iowa","Humboldt County",4,9,117,53,64
050,19,091,"Iowa","Humboldt County",4,10,124,60,64
050,19,091,"Iowa","Humboldt County",4,11,107,56,51
050,19,091,"Iowa","Humboldt County",4,12,129,62,67
050,19,091,"Iowa","Humboldt County",4,13,135,70,65
050,19,091,"Iowa","Humboldt County",4,14,140,68,72
050,19,091,"Iowa","Humboldt County",4,15,158,86,72
050,19,091,"Iowa","Humboldt County",4,16,139,75,64
050,19,091,"Iowa","Humboldt County",4,17,142,73,69
050,19,091,"Iowa","Humboldt County",4,18,106,53,53
050,19,091,"Iowa","Humboldt County",4,19,75,35,40
050,19,091,"Iowa","Humboldt County",4,20,93,43,50
050,19,091,"Iowa","Humboldt County",4,21,91,44,47
050,19,091,"Iowa","Humboldt County",4,22,82,39,43
050,19,091,"Iowa","Humboldt County",4,23,92,53,39
050,19,091,"Iowa","Humboldt County",4,24,99,48,51
050,19,091,"Iowa","Humboldt County",4,25,96,47,49
050,19,091,"Iowa","Humboldt County",4,26,95,53,42
050,19,091,"Iowa","Humboldt County",4,27,96,54,42
050,19,091,"Iowa","Humboldt County",4,28,87,42,45
050,19,091,"Iowa","Humboldt County",4,29,110,59,51
050,19,091,"Iowa","Humboldt County",4,30,105,53,52
050,19,091,"Iowa","Humboldt County",4,31,109,62,47
050,19,091,"Iowa","Humboldt County",4,32,124,63,61
050,19,091,"Iowa","Humboldt County",4,33,107,47,60
050,19,091,"Iowa","Humboldt County",4,34,97,45,52
050,19,091,"Iowa","Humboldt County",4,35,115,61,54
050,19,091,"Iowa","Humboldt County",4,36,134,64,70
050,19,091,"Iowa","Humboldt County",4,37,121,56,65
050,19,091,"Iowa","Humboldt County",4,38,125,63,62
050,19,091,"Iowa","Humboldt County",4,39,113,65,48
050,19,091,"Iowa","Humboldt County",4,40,135,69,66
050,19,091,"Iowa","Humboldt County",4,41,122,66,56
050,19,091,"Iowa","Humboldt County",4,42,130,72,58
050,19,091,"Iowa","Humboldt County",4,43,107,57,50
050,19,091,"Iowa","Humboldt County",4,44,108,58,50
050,19,091,"Iowa","Humboldt County",4,45,109,63,46
050,19,091,"Iowa","Humboldt County",4,46,89,46,43
050,19,091,"Iowa","Humboldt County",4,47,80,38,42
050,19,091,"Iowa","Humboldt County",4,48,68,34,34
050,19,091,"Iowa","Humboldt County",4,49,82,37,45
050,19,091,"Iowa","Humboldt County",4,50,99,52,47
050,19,091,"Iowa","Humboldt County",4,51,104,57,47
050,19,091,"Iowa","Humboldt County",4,52,125,64,61
050,19,091,"Iowa","Humboldt County",4,53,108,62,46
050,19,091,"Iowa","Humboldt County",4,54,89,42,47
050,19,091,"Iowa","Humboldt County",4,55,98,49,49
050,19,091,"Iowa","Humboldt County",4,56,112,58,54
050,19,091,"Iowa","Humboldt County",4,57,118,61,57
050,19,091,"Iowa","Humboldt County",4,58,128,64,64
050,19,091,"Iowa","Humboldt County",4,59,142,78,64
050,19,091,"Iowa","Humboldt County",4,60,145,68,77
050,19,091,"Iowa","Humboldt County",4,61,151,74,77
050,19,091,"Iowa","Humboldt County",4,62,153,76,77
050,19,091,"Iowa","Humboldt County",4,63,152,73,79
050,19,091,"Iowa","Humboldt County",4,64,152,70,82
050,19,091,"Iowa","Humboldt County",4,65,153,79,74
050,19,091,"Iowa","Humboldt County",4,66,137,64,73
050,19,091,"Iowa","Humboldt County",4,67,130,64,66
050,19,091,"Iowa","Humboldt County",4,68,132,68,64
050,19,091,"Iowa","Humboldt County",4,69,126,67,59
050,19,091,"Iowa","Humboldt County",4,70,114,58,56
050,19,091,"Iowa","Humboldt County",4,71,95,46,49
050,19,091,"Iowa","Humboldt County",4,72,102,52,50
050,19,091,"Iowa","Humboldt County",4,73,92,50,42
050,19,091,"Iowa","Humboldt County",4,74,94,47,47
050,19,091,"Iowa","Humboldt County",4,75,91,44,47
050,19,091,"Iowa","Humboldt County",4,76,65,27,38
050,19,091,"Iowa","Humboldt County",4,77,60,23,37
050,19,091,"Iowa","Humboldt County",4,78,57,28,29
050,19,091,"Iowa","Humboldt County",4,79,74,35,39
050,19,091,"Iowa","Humboldt County",4,80,61,29,32
050,19,091,"Iowa","Humboldt County",4,81,50,24,26
050,19,091,"Iowa","Humboldt County",4,82,54,26,28
050,19,091,"Iowa","Humboldt County",4,83,47,20,27
050,19,091,"Iowa","Humboldt County",4,84,39,18,21
050,19,091,"Iowa","Humboldt County",4,85,293,108,185
050,19,091,"Iowa","Humboldt County",5,0,124,64,60
050,19,091,"Iowa","Humboldt County",5,1,115,56,59
050,19,091,"Iowa","Humboldt County",5,2,103,47,56
050,19,091,"Iowa","Humboldt County",5,3,115,61,54
050,19,091,"Iowa","Humboldt County",5,4,114,60,54
050,19,091,"Iowa","Humboldt County",5,5,104,49,55
050,19,091,"Iowa","Humboldt County",5,6,114,61,53
050,19,091,"Iowa","Humboldt County",5,7,117,55,62
050,19,091,"Iowa","Humboldt County",5,8,139,74,65
050,19,091,"Iowa","Humboldt County",5,9,131,70,61
050,19,091,"Iowa","Humboldt County",5,10,125,53,72
050,19,091,"Iowa","Humboldt County",5,11,126,64,62
050,19,091,"Iowa","Humboldt County",5,12,110,59,51
050,19,091,"Iowa","Humboldt County",5,13,140,71,69
050,19,091,"Iowa","Humboldt County",5,14,125,63,62
050,19,091,"Iowa","Humboldt County",5,15,143,69,74
050,19,091,"Iowa","Humboldt County",5,16,165,90,75
050,19,091,"Iowa","Humboldt County",5,17,143,75,68
050,19,091,"Iowa","Humboldt County",5,18,130,60,70
050,19,091,"Iowa","Humboldt County",5,19,86,43,43
050,19,091,"Iowa","Humboldt County",5,20,83,40,43
050,19,091,"Iowa","Humboldt County",5,21,103,52,51
050,19,091,"Iowa","Humboldt County",5,22,95,43,52
050,19,091,"Iowa","Humboldt County",5,23,87,38,49
050,19,091,"Iowa","Humboldt County",5,24,85,46,39
050,19,091,"Iowa","Humboldt County",5,25,91,44,47
050,19,091,"Iowa","Humboldt County",5,26,95,45,50
050,19,091,"Iowa","Humboldt County",5,27,90,54,36
050,19,091,"Iowa","Humboldt County",5,28,92,51,41
050,19,091,"Iowa","Humboldt County",5,29,88,41,47
050,19,091,"Iowa","Humboldt County",5,30,106,56,50
050,19,091,"Iowa","Humboldt County",5,31,103,53,50
050,19,091,"Iowa","Humboldt County",5,32,103,57,46
050,19,091,"Iowa","Humboldt County",5,33,123,69,54
050,19,091,"Iowa","Humboldt County",5,34,111,48,63
050,19,091,"Iowa","Humboldt County",5,35,103,51,52
050,19,091,"Iowa","Humboldt County",5,36,115,60,55
050,19,091,"Iowa","Humboldt County",5,37,135,68,67
050,19,091,"Iowa","Humboldt County",5,38,121,54,67
050,19,091,"Iowa","Humboldt County",5,39,120,62,58
050,19,091,"Iowa","Humboldt County",5,40,118,65,53
050,19,091,"Iowa","Humboldt County",5,41,128,67,61
050,19,091,"Iowa","Humboldt County",5,42,120,66,54
050,19,091,"Iowa","Humboldt County",5,43,125,68,57
050,19,091,"Iowa","Humboldt County",5,44,108,57,51
050,19,091,"Iowa","Humboldt County",5,45,104,57,47
050,19,091,"Iowa","Humboldt County",5,46,104,60,44
050,19,091,"Iowa","Humboldt County",5,47,84,43,41
050,19,091,"Iowa","Humboldt County",5,48,82,39,43
050,19,091,"Iowa","Humboldt County",5,49,68,31,37
050,19,091,"Iowa","Humboldt County",5,50,83,40,43
050,19,091,"Iowa","Humboldt County",5,51,101,50,51
050,19,091,"Iowa","Humboldt County",5,52,102,56,46
050,19,091,"Iowa","Humboldt County",5,53,124,63,61
050,19,091,"Iowa","Humboldt County",5,54,108,60,48
050,19,091,"Iowa","Humboldt County",5,55,89,44,45
050,19,091,"Iowa","Humboldt County",5,56,99,51,48
050,19,091,"Iowa","Humboldt County",5,57,112,58,54
050,19,091,"Iowa","Humboldt County",5,58,115,59,56
050,19,091,"Iowa","Humboldt County",5,59,124,62,62
050,19,091,"Iowa","Humboldt County",5,60,140,75,65
050,19,091,"Iowa","Humboldt County",5,61,141,64,77
050,19,091,"Iowa","Humboldt County",5,62,142,70,72
050,19,091,"Iowa","Humboldt County",5,63,159,76,83
050,19,091,"Iowa","Humboldt County",5,64,154,75,79
050,19,091,"Iowa","Humboldt County",5,65,149,69,80
050,19,091,"Iowa","Humboldt County",5,66,153,79,74
050,19,091,"Iowa","Humboldt County",5,67,132,61,71
050,19,091,"Iowa","Humboldt County",5,68,126,63,63
050,19,091,"Iowa","Humboldt County",5,69,130,68,62
050,19,091,"Iowa","Humboldt County",5,70,127,66,61
050,19,091,"Iowa","Humboldt County",5,71,108,54,54
050,19,091,"Iowa","Humboldt County",5,72,91,45,46
050,19,091,"Iowa","Humboldt County",5,73,100,51,49
050,19,091,"Iowa","Humboldt County",5,74,92,48,44
050,19,091,"Iowa","Humboldt County",5,75,97,48,49
050,19,091,"Iowa","Humboldt County",5,76,89,44,45
050,19,091,"Iowa","Humboldt County",5,77,65,26,39
050,19,091,"Iowa","Humboldt County",5,78,61,22,39
050,19,091,"Iowa","Humboldt County",5,79,59,30,29
050,19,091,"Iowa","Humboldt County",5,80,72,31,41
050,19,091,"Iowa","Humboldt County",5,81,57,27,30
050,19,091,"Iowa","Humboldt County",5,82,48,23,25
050,19,091,"Iowa","Humboldt County",5,83,46,21,25
050,19,091,"Iowa","Humboldt County",5,84,46,22,24
050,19,091,"Iowa","Humboldt County",5,85,300,114,186
050,19,093,"Iowa","Ida County",1,0,66,36,30
050,19,093,"Iowa","Ida County",1,1,81,41,40
050,19,093,"Iowa","Ida County",1,2,89,39,50
050,19,093,"Iowa","Ida County",1,3,82,43,39
050,19,093,"Iowa","Ida County",1,4,85,50,35
050,19,093,"Iowa","Ida County",1,5,91,48,43
050,19,093,"Iowa","Ida County",1,6,99,45,54
050,19,093,"Iowa","Ida County",1,7,91,41,50
050,19,093,"Iowa","Ida County",1,8,92,45,47
050,19,093,"Iowa","Ida County",1,9,99,51,48
050,19,093,"Iowa","Ida County",1,10,127,65,62
050,19,093,"Iowa","Ida County",1,11,106,58,48
050,19,093,"Iowa","Ida County",1,12,112,60,52
050,19,093,"Iowa","Ida County",1,13,112,60,52
050,19,093,"Iowa","Ida County",1,14,105,56,49
050,19,093,"Iowa","Ida County",1,15,100,50,50
050,19,093,"Iowa","Ida County",1,16,93,48,45
050,19,093,"Iowa","Ida County",1,17,95,57,38
050,19,093,"Iowa","Ida County",1,18,87,48,39
050,19,093,"Iowa","Ida County",1,19,68,37,31
050,19,093,"Iowa","Ida County",1,20,73,38,35
050,19,093,"Iowa","Ida County",1,21,61,32,29
050,19,093,"Iowa","Ida County",1,22,75,41,34
050,19,093,"Iowa","Ida County",1,23,93,46,47
050,19,093,"Iowa","Ida County",1,24,79,42,37
050,19,093,"Iowa","Ida County",1,25,67,38,29
050,19,093,"Iowa","Ida County",1,26,67,40,27
050,19,093,"Iowa","Ida County",1,27,69,32,37
050,19,093,"Iowa","Ida County",1,28,70,35,35
050,19,093,"Iowa","Ida County",1,29,75,29,46
050,19,093,"Iowa","Ida County",1,30,58,26,32
050,19,093,"Iowa","Ida County",1,31,55,30,25
050,19,093,"Iowa","Ida County",1,32,78,50,28
050,19,093,"Iowa","Ida County",1,33,77,37,40
050,19,093,"Iowa","Ida County",1,34,82,33,49
050,19,093,"Iowa","Ida County",1,35,81,48,33
050,19,093,"Iowa","Ida County",1,36,75,41,34
050,19,093,"Iowa","Ida County",1,37,79,41,38
050,19,093,"Iowa","Ida County",1,38,82,42,40
050,19,093,"Iowa","Ida County",1,39,87,42,45
050,19,093,"Iowa","Ida County",1,40,84,46,38
050,19,093,"Iowa","Ida County",1,41,80,44,36
050,19,093,"Iowa","Ida County",1,42,80,37,43
050,19,093,"Iowa","Ida County",1,43,76,37,39
050,19,093,"Iowa","Ida County",1,44,64,34,30
050,19,093,"Iowa","Ida County",1,45,70,35,35
050,19,093,"Iowa","Ida County",1,46,67,37,30
050,19,093,"Iowa","Ida County",1,47,61,30,31
050,19,093,"Iowa","Ida County",1,48,70,36,34
050,19,093,"Iowa","Ida County",1,49,78,41,37
050,19,093,"Iowa","Ida County",1,50,75,37,38
050,19,093,"Iowa","Ida County",1,51,69,31,38
050,19,093,"Iowa","Ida County",1,52,80,39,41
050,19,093,"Iowa","Ida County",1,53,83,37,46
050,19,093,"Iowa","Ida County",1,54,83,36,47
050,19,093,"Iowa","Ida County",1,55,72,33,39
050,19,093,"Iowa","Ida County",1,56,83,41,42
050,19,093,"Iowa","Ida County",1,57,95,48,47
050,19,093,"Iowa","Ida County",1,58,111,56,55
050,19,093,"Iowa","Ida County",1,59,114,61,53
050,19,093,"Iowa","Ida County",1,60,105,56,49
050,19,093,"Iowa","Ida County",1,61,103,59,44
050,19,093,"Iowa","Ida County",1,62,101,52,49
050,19,093,"Iowa","Ida County",1,63,108,50,58
050,19,093,"Iowa","Ida County",1,64,108,58,50
050,19,093,"Iowa","Ida County",1,65,99,51,48
050,19,093,"Iowa","Ida County",1,66,85,42,43
050,19,093,"Iowa","Ida County",1,67,89,45,44
050,19,093,"Iowa","Ida County",1,68,90,47,43
050,19,093,"Iowa","Ida County",1,69,85,43,42
050,19,093,"Iowa","Ida County",1,70,80,47,33
050,19,093,"Iowa","Ida County",1,71,80,41,39
050,19,093,"Iowa","Ida County",1,72,76,34,42
050,19,093,"Iowa","Ida County",1,73,74,32,42
050,19,093,"Iowa","Ida County",1,74,54,26,28
050,19,093,"Iowa","Ida County",1,75,55,29,26
050,19,093,"Iowa","Ida County",1,76,59,27,32
050,19,093,"Iowa","Ida County",1,77,44,17,27
050,19,093,"Iowa","Ida County",1,78,52,26,26
050,19,093,"Iowa","Ida County",1,79,52,27,25
050,19,093,"Iowa","Ida County",1,80,39,18,21
050,19,093,"Iowa","Ida County",1,81,36,18,18
050,19,093,"Iowa","Ida County",1,82,33,15,18
050,19,093,"Iowa","Ida County",1,83,32,14,18
050,19,093,"Iowa","Ida County",1,84,38,19,19
050,19,093,"Iowa","Ida County",1,85,268,86,182
050,19,093,"Iowa","Ida County",2,0,73,40,33
050,19,093,"Iowa","Ida County",2,1,77,39,38
050,19,093,"Iowa","Ida County",2,2,87,40,47
050,19,093,"Iowa","Ida County",2,3,83,42,41
050,19,093,"Iowa","Ida County",2,4,86,50,36
050,19,093,"Iowa","Ida County",2,5,89,49,40
050,19,093,"Iowa","Ida County",2,6,97,45,52
050,19,093,"Iowa","Ida County",2,7,93,42,51
050,19,093,"Iowa","Ida County",2,8,92,44,48
050,19,093,"Iowa","Ida County",2,9,96,50,46
050,19,093,"Iowa","Ida County",2,10,120,62,58
050,19,093,"Iowa","Ida County",2,11,110,59,51
050,19,093,"Iowa","Ida County",2,12,112,60,52
050,19,093,"Iowa","Ida County",2,13,113,61,52
050,19,093,"Iowa","Ida County",2,14,108,57,51
050,19,093,"Iowa","Ida County",2,15,101,50,51
050,19,093,"Iowa","Ida County",2,16,95,48,47
050,19,093,"Iowa","Ida County",2,17,95,55,40
050,19,093,"Iowa","Ida County",2,18,84,48,36
050,19,093,"Iowa","Ida County",2,19,71,39,32
050,19,093,"Iowa","Ida County",2,20,75,39,36
050,19,093,"Iowa","Ida County",2,21,65,35,30
050,19,093,"Iowa","Ida County",2,22,73,39,34
050,19,093,"Iowa","Ida County",2,23,91,46,45
050,19,093,"Iowa","Ida County",2,24,82,44,38
050,19,093,"Iowa","Ida County",2,25,70,39,31
050,19,093,"Iowa","Ida County",2,26,68,40,28
050,19,093,"Iowa","Ida County",2,27,69,33,36
050,19,093,"Iowa","Ida County",2,28,70,34,36
050,19,093,"Iowa","Ida County",2,29,73,30,43
050,19,093,"Iowa","Ida County",2,30,63,27,36
050,19,093,"Iowa","Ida County",2,31,55,29,26
050,19,093,"Iowa","Ida County",2,32,73,46,27
050,19,093,"Iowa","Ida County",2,33,77,39,38
050,19,093,"Iowa","Ida County",2,34,82,34,48
050,19,093,"Iowa","Ida County",2,35,82,45,37
050,19,093,"Iowa","Ida County",2,36,75,42,33
050,19,093,"Iowa","Ida County",2,37,78,41,37
050,19,093,"Iowa","Ida County",2,38,83,42,41
050,19,093,"Iowa","Ida County",2,39,86,42,44
050,19,093,"Iowa","Ida County",2,40,87,46,41
050,19,093,"Iowa","Ida County",2,41,82,46,36
050,19,093,"Iowa","Ida County",2,42,80,39,41
050,19,093,"Iowa","Ida County",2,43,77,37,40
050,19,093,"Iowa","Ida County",2,44,66,34,32
050,19,093,"Iowa","Ida County",2,45,69,36,33
050,19,093,"Iowa","Ida County",2,46,69,37,32
050,19,093,"Iowa","Ida County",2,47,62,32,30
050,19,093,"Iowa","Ida County",2,48,69,35,34
050,19,093,"Iowa","Ida County",2,49,77,40,37
050,19,093,"Iowa","Ida County",2,50,76,38,38
050,19,093,"Iowa","Ida County",2,51,71,33,38
050,19,093,"Iowa","Ida County",2,52,77,37,40
050,19,093,"Iowa","Ida County",2,53,82,38,44
050,19,093,"Iowa","Ida County",2,54,83,36,47
050,19,093,"Iowa","Ida County",2,55,74,34,40
050,19,093,"Iowa","Ida County",2,56,81,40,41
050,19,093,"Iowa","Ida County",2,57,93,47,46
050,19,093,"Iowa","Ida County",2,58,108,55,53
050,19,093,"Iowa","Ida County",2,59,112,58,54
050,19,093,"Iowa","Ida County",2,60,106,57,49
050,19,093,"Iowa","Ida County",2,61,104,58,46
050,19,093,"Iowa","Ida County",2,62,101,53,48
050,19,093,"Iowa","Ida County",2,63,107,51,56
050,19,093,"Iowa","Ida County",2,64,107,55,52
050,19,093,"Iowa","Ida County",2,65,100,52,48
050,19,093,"Iowa","Ida County",2,66,88,44,44
050,19,093,"Iowa","Ida County",2,67,87,44,43
050,19,093,"Iowa","Ida County",2,68,89,46,43
050,19,093,"Iowa","Ida County",2,69,86,44,42
050,19,093,"Iowa","Ida County",2,70,80,46,34
050,19,093,"Iowa","Ida County",2,71,81,43,38
050,19,093,"Iowa","Ida County",2,72,74,34,40
050,19,093,"Iowa","Ida County",2,73,77,33,44
050,19,093,"Iowa","Ida County",2,74,56,27,29
050,19,093,"Iowa","Ida County",2,75,55,28,27
050,19,093,"Iowa","Ida County",2,76,57,27,30
050,19,093,"Iowa","Ida County",2,77,50,21,29
050,19,093,"Iowa","Ida County",2,78,47,22,25
050,19,093,"Iowa","Ida County",2,79,51,27,24
050,19,093,"Iowa","Ida County",2,80,42,20,22
050,19,093,"Iowa","Ida County",2,81,38,18,20
050,19,093,"Iowa","Ida County",2,82,34,16,18
050,19,093,"Iowa","Ida County",2,83,31,13,18
050,19,093,"Iowa","Ida County",2,84,37,18,19
050,19,093,"Iowa","Ida County",2,85,270,89,181
050,19,093,"Iowa","Ida County",3,0,75,30,45
050,19,093,"Iowa","Ida County",3,1,66,33,33
050,19,093,"Iowa","Ida County",3,2,77,42,35
050,19,093,"Iowa","Ida County",3,3,91,38,53
050,19,093,"Iowa","Ida County",3,4,88,39,49
050,19,093,"Iowa","Ida County",3,5,88,51,37
050,19,093,"Iowa","Ida County",3,6,89,48,41
050,19,093,"Iowa","Ida County",3,7,102,48,54
050,19,093,"Iowa","Ida County",3,8,94,42,52
050,19,093,"Iowa","Ida County",3,9,94,44,50
050,19,093,"Iowa","Ida County",3,10,97,51,46
050,19,093,"Iowa","Ida County",3,11,127,67,60
050,19,093,"Iowa","Ida County",3,12,108,60,48
050,19,093,"Iowa","Ida County",3,13,113,64,49
050,19,093,"Iowa","Ida County",3,14,117,61,56
050,19,093,"Iowa","Ida County",3,15,114,61,53
050,19,093,"Iowa","Ida County",3,16,96,47,49
050,19,093,"Iowa","Ida County",3,17,104,52,52
050,19,093,"Iowa","Ida County",3,18,76,44,32
050,19,093,"Iowa","Ida County",3,19,62,39,23
050,19,093,"Iowa","Ida County",3,20,71,37,34
050,19,093,"Iowa","Ida County",3,21,75,39,36
050,19,093,"Iowa","Ida County",3,22,75,39,36
050,19,093,"Iowa","Ida County",3,23,76,45,31
050,19,093,"Iowa","Ida County",3,24,90,48,42
050,19,093,"Iowa","Ida County",3,25,82,41,41
050,19,093,"Iowa","Ida County",3,26,62,33,29
050,19,093,"Iowa","Ida County",3,27,65,43,22
050,19,093,"Iowa","Ida County",3,28,70,30,40
050,19,093,"Iowa","Ida County",3,29,70,34,36
050,19,093,"Iowa","Ida County",3,30,67,30,37
050,19,093,"Iowa","Ida County",3,31,66,27,39
050,19,093,"Iowa","Ida County",3,32,56,27,29
050,19,093,"Iowa","Ida County",3,33,73,46,27
050,19,093,"Iowa","Ida County",3,34,80,40,40
050,19,093,"Iowa","Ida County",3,35,86,37,49
050,19,093,"Iowa","Ida County",3,36,83,45,38
050,19,093,"Iowa","Ida County",3,37,79,43,36
050,19,093,"Iowa","Ida County",3,38,75,39,36
050,19,093,"Iowa","Ida County",3,39,81,40,41
050,19,093,"Iowa","Ida County",3,40,84,42,42
050,19,093,"Iowa","Ida County",3,41,88,45,43
050,19,093,"Iowa","Ida County",3,42,80,45,35
050,19,093,"Iowa","Ida County",3,43,78,38,40
050,19,093,"Iowa","Ida County",3,44,78,38,40
050,19,093,"Iowa","Ida County",3,45,69,37,32
050,19,093,"Iowa","Ida County",3,46,71,38,33
050,19,093,"Iowa","Ida County",3,47,72,37,35
050,19,093,"Iowa","Ida County",3,48,62,33,29
050,19,093,"Iowa","Ida County",3,49,65,31,34
050,19,093,"Iowa","Ida County",3,50,76,40,36
050,19,093,"Iowa","Ida County",3,51,76,38,38
050,19,093,"Iowa","Ida County",3,52,72,36,36
050,19,093,"Iowa","Ida County",3,53,77,36,41
050,19,093,"Iowa","Ida County",3,54,77,37,40
050,19,093,"Iowa","Ida County",3,55,81,35,46
050,19,093,"Iowa","Ida County",3,56,75,35,40
050,19,093,"Iowa","Ida County",3,57,83,40,43
050,19,093,"Iowa","Ida County",3,58,96,48,48
050,19,093,"Iowa","Ida County",3,59,106,51,55
050,19,093,"Iowa","Ida County",3,60,110,58,52
050,19,093,"Iowa","Ida County",3,61,100,56,44
050,19,093,"Iowa","Ida County",3,62,104,58,46
050,19,093,"Iowa","Ida County",3,63,104,55,49
050,19,093,"Iowa","Ida County",3,64,106,50,56
050,19,093,"Iowa","Ida County",3,65,102,51,51
050,19,093,"Iowa","Ida County",3,66,97,51,46
050,19,093,"Iowa","Ida County",3,67,86,43,43
050,19,093,"Iowa","Ida County",3,68,83,41,42
050,19,093,"Iowa","Ida County",3,69,88,44,44
050,19,093,"Iowa","Ida County",3,70,82,42,40
050,19,093,"Iowa","Ida County",3,71,81,45,36
050,19,093,"Iowa","Ida County",3,72,78,43,35
050,19,093,"Iowa","Ida County",3,73,68,32,36
050,19,093,"Iowa","Ida County",3,74,75,35,40
050,19,093,"Iowa","Ida County",3,75,54,24,30
050,19,093,"Iowa","Ida County",3,76,52,26,26
050,19,093,"Iowa","Ida County",3,77,57,29,28
050,19,093,"Iowa","Ida County",3,78,43,18,25
050,19,093,"Iowa","Ida County",3,79,44,20,24
050,19,093,"Iowa","Ida County",3,80,46,24,22
050,19,093,"Iowa","Ida County",3,81,39,18,21
050,19,093,"Iowa","Ida County",3,82,29,12,17
050,19,093,"Iowa","Ida County",3,83,28,11,17
050,19,093,"Iowa","Ida County",3,84,33,16,17
050,19,093,"Iowa","Ida County",3,85,254,81,173
050,19,093,"Iowa","Ida County",4,0,77,35,42
050,19,093,"Iowa","Ida County",4,1,76,36,40
050,19,093,"Iowa","Ida County",4,2,74,41,33
050,19,093,"Iowa","Ida County",4,3,81,40,41
050,19,093,"Iowa","Ida County",4,4,89,36,53
050,19,093,"Iowa","Ida County",4,5,94,47,47
050,19,093,"Iowa","Ida County",4,6,90,46,44
050,19,093,"Iowa","Ida County",4,7,91,45,46
050,19,093,"Iowa","Ida County",4,8,96,45,51
050,19,093,"Iowa","Ida County",4,9,96,47,49
050,19,093,"Iowa","Ida County",4,10,97,45,52
050,19,093,"Iowa","Ida County",4,11,91,46,45
050,19,093,"Iowa","Ida County",4,12,115,62,53
050,19,093,"Iowa","Ida County",4,13,104,56,48
050,19,093,"Iowa","Ida County",4,14,115,65,50
050,19,093,"Iowa","Ida County",4,15,115,62,53
050,19,093,"Iowa","Ida County",4,16,112,59,53
050,19,093,"Iowa","Ida County",4,17,99,50,49
050,19,093,"Iowa","Ida County",4,18,82,42,40
050,19,093,"Iowa","Ida County",4,19,56,34,22
050,19,093,"Iowa","Ida County",4,20,65,39,26
050,19,093,"Iowa","Ida County",4,21,71,38,33
050,19,093,"Iowa","Ida County",4,22,78,41,37
050,19,093,"Iowa","Ida County",4,23,69,37,32
050,19,093,"Iowa","Ida County",4,24,82,50,32
050,19,093,"Iowa","Ida County",4,25,86,43,43
050,19,093,"Iowa","Ida County",4,26,82,44,38
050,19,093,"Iowa","Ida County",4,27,60,31,29
050,19,093,"Iowa","Ida County",4,28,68,42,26
050,19,093,"Iowa","Ida County",4,29,67,31,36
050,19,093,"Iowa","Ida County",4,30,65,31,34
050,19,093,"Iowa","Ida County",4,31,72,33,39
050,19,093,"Iowa","Ida County",4,32,71,29,42
050,19,093,"Iowa","Ida County",4,33,61,31,30
050,19,093,"Iowa","Ida County",4,34,71,46,25
050,19,093,"Iowa","Ida County",4,35,76,37,39
050,19,093,"Iowa","Ida County",4,36,86,37,49
050,19,093,"Iowa","Ida County",4,37,84,45,39
050,19,093,"Iowa","Ida County",4,38,83,44,39
050,19,093,"Iowa","Ida County",4,39,74,37,37
050,19,093,"Iowa","Ida County",4,40,85,40,45
050,19,093,"Iowa","Ida County",4,41,88,45,43
050,19,093,"Iowa","Ida County",4,42,89,47,42
050,19,093,"Iowa","Ida County",4,43,76,45,31
050,19,093,"Iowa","Ida County",4,44,80,40,40
050,19,093,"Iowa","Ida County",4,45,75,37,38
050,19,093,"Iowa","Ida County",4,46,65,36,29
050,19,093,"Iowa","Ida County",4,47,72,38,34
050,19,093,"Iowa","Ida County",4,48,67,34,33
050,19,093,"Iowa","Ida County",4,49,62,31,31
050,19,093,"Iowa","Ida County",4,50,66,31,35
050,19,093,"Iowa","Ida County",4,51,73,38,35
050,19,093,"Iowa","Ida County",4,52,75,39,36
050,19,093,"Iowa","Ida County",4,53,70,34,36
050,19,093,"Iowa","Ida County",4,54,73,34,39
050,19,093,"Iowa","Ida County",4,55,77,37,40
050,19,093,"Iowa","Ida County",4,56,82,38,44
050,19,093,"Iowa","Ida County",4,57,73,34,39
050,19,093,"Iowa","Ida County",4,58,90,43,47
050,19,093,"Iowa","Ida County",4,59,98,45,53
050,19,093,"Iowa","Ida County",4,60,104,50,54
050,19,093,"Iowa","Ida County",4,61,111,60,51
050,19,093,"Iowa","Ida County",4,62,98,53,45
050,19,093,"Iowa","Ida County",4,63,110,63,47
050,19,093,"Iowa","Ida County",4,64,98,50,48
050,19,093,"Iowa","Ida County",4,65,107,48,59
050,19,093,"Iowa","Ida County",4,66,95,48,47
050,19,093,"Iowa","Ida County",4,67,96,51,45
050,19,093,"Iowa","Ida County",4,68,82,41,41
050,19,093,"Iowa","Ida County",4,69,83,41,42
050,19,093,"Iowa","Ida County",4,70,80,41,39
050,19,093,"Iowa","Ida County",4,71,81,40,41
050,19,093,"Iowa","Ida County",4,72,79,44,35
050,19,093,"Iowa","Ida County",4,73,76,41,35
050,19,093,"Iowa","Ida County",4,74,65,33,32
050,19,093,"Iowa","Ida County",4,75,70,30,40
050,19,093,"Iowa","Ida County",4,76,48,22,26
050,19,093,"Iowa","Ida County",4,77,52,25,27
050,19,093,"Iowa","Ida County",4,78,51,28,23
050,19,093,"Iowa","Ida County",4,79,41,17,24
050,19,093,"Iowa","Ida County",4,80,41,19,22
050,19,093,"Iowa","Ida County",4,81,44,22,22
050,19,093,"Iowa","Ida County",4,82,33,14,19
050,19,093,"Iowa","Ida County",4,83,28,10,18
050,19,093,"Iowa","Ida County",4,84,27,14,13
050,19,093,"Iowa","Ida County",4,85,248,77,171
050,19,093,"Iowa","Ida County",5,0,79,35,44
050,19,093,"Iowa","Ida County",5,1,73,33,40
050,19,093,"Iowa","Ida County",5,2,80,39,41
050,19,093,"Iowa","Ida County",5,3,69,36,33
050,19,093,"Iowa","Ida County",5,4,79,47,32
050,19,093,"Iowa","Ida County",5,5,82,35,47
050,19,093,"Iowa","Ida County",5,6,87,44,43
050,19,093,"Iowa","Ida County",5,7,86,44,42
050,19,093,"Iowa","Ida County",5,8,97,49,48
050,19,093,"Iowa","Ida County",5,9,96,47,49
050,19,093,"Iowa","Ida County",5,10,98,46,52
050,19,093,"Iowa","Ida County",5,11,93,44,49
050,19,093,"Iowa","Ida County",5,12,93,46,47
050,19,093,"Iowa","Ida County",5,13,117,64,53
050,19,093,"Iowa","Ida County",5,14,110,59,51
050,19,093,"Iowa","Ida County",5,15,113,64,49
050,19,093,"Iowa","Ida County",5,16,120,64,56
050,19,093,"Iowa","Ida County",5,17,110,60,50
050,19,093,"Iowa","Ida County",5,18,83,43,40
050,19,093,"Iowa","Ida County",5,19,64,35,29
050,19,093,"Iowa","Ida County",5,20,66,35,31
050,19,093,"Iowa","Ida County",5,21,70,40,30
050,19,093,"Iowa","Ida County",5,22,68,33,35
050,19,093,"Iowa","Ida County",5,23,80,42,38
050,19,093,"Iowa","Ida County",5,24,70,35,35
050,19,093,"Iowa","Ida County",5,25,77,50,27
050,19,093,"Iowa","Ida County",5,26,75,37,38
050,19,093,"Iowa","Ida County",5,27,80,43,37
050,19,093,"Iowa","Ida County",5,28,67,31,36
050,19,093,"Iowa","Ida County",5,29,70,45,25
050,19,093,"Iowa","Ida County",5,30,73,34,39
050,19,093,"Iowa","Ida County",5,31,64,30,34
050,19,093,"Iowa","Ida County",5,32,71,31,40
050,19,093,"Iowa","Ida County",5,33,70,27,43
050,19,093,"Iowa","Ida County",5,34,62,32,30
050,19,093,"Iowa","Ida County",5,35,70,44,26
050,19,093,"Iowa","Ida County",5,36,73,37,36
050,19,093,"Iowa","Ida County",5,37,87,43,44
050,19,093,"Iowa","Ida County",5,38,83,44,39
050,19,093,"Iowa","Ida County",5,39,82,44,38
050,19,093,"Iowa","Ida County",5,40,75,37,38
050,19,093,"Iowa","Ida County",5,41,86,41,45
050,19,093,"Iowa","Ida County",5,42,86,45,41
050,19,093,"Iowa","Ida County",5,43,80,41,39
050,19,093,"Iowa","Ida County",5,44,74,45,29
050,19,093,"Iowa","Ida County",5,45,84,40,44
050,19,093,"Iowa","Ida County",5,46,79,38,41
050,19,093,"Iowa","Ida County",5,47,66,36,30
050,19,093,"Iowa","Ida County",5,48,70,36,34
050,19,093,"Iowa","Ida County",5,49,63,30,33
050,19,093,"Iowa","Ida County",5,50,62,31,31
050,19,093,"Iowa","Ida County",5,51,65,30,35
050,19,093,"Iowa","Ida County",5,52,71,36,35
050,19,093,"Iowa","Ida County",5,53,76,41,35
050,19,093,"Iowa","Ida County",5,54,64,33,31
050,19,093,"Iowa","Ida County",5,55,78,37,41
050,19,093,"Iowa","Ida County",5,56,78,39,39
050,19,093,"Iowa","Ida County",5,57,79,37,42
050,19,093,"Iowa","Ida County",5,58,79,38,41
050,19,093,"Iowa","Ida County",5,59,84,38,46
050,19,093,"Iowa","Ida County",5,60,89,42,47
050,19,093,"Iowa","Ida County",5,61,105,51,54
050,19,093,"Iowa","Ida County",5,62,110,56,54
050,19,093,"Iowa","Ida County",5,63,102,56,46
050,19,093,"Iowa","Ida County",5,64,109,63,46
050,19,093,"Iowa","Ida County",5,65,99,48,51
050,19,093,"Iowa","Ida County",5,66,105,48,57
050,19,093,"Iowa","Ida County",5,67,93,47,46
050,19,093,"Iowa","Ida County",5,68,96,50,46
050,19,093,"Iowa","Ida County",5,69,80,40,40
050,19,093,"Iowa","Ida County",5,70,78,38,40
050,19,093,"Iowa","Ida County",5,71,82,41,41
050,19,093,"Iowa","Ida County",5,72,77,38,39
050,19,093,"Iowa","Ida County",5,73,73,39,34
050,19,093,"Iowa","Ida County",5,74,76,43,33
050,19,093,"Iowa","Ida County",5,75,60,28,32
050,19,093,"Iowa","Ida County",5,76,63,28,35
050,19,093,"Iowa","Ida County",5,77,48,24,24
050,19,093,"Iowa","Ida County",5,78,43,20,23
050,19,093,"Iowa","Ida County",5,79,50,27,23
050,19,093,"Iowa","Ida County",5,80,35,14,21
050,19,093,"Iowa","Ida County",5,81,40,18,22
050,19,093,"Iowa","Ida County",5,82,37,19,18
050,19,093,"Iowa","Ida County",5,83,29,11,18
050,19,093,"Iowa","Ida County",5,84,26,12,14
050,19,093,"Iowa","Ida County",5,85,242,71,171
050,19,095,"Iowa","Iowa County",1,0,165,85,80
050,19,095,"Iowa","Iowa County",1,1,179,96,83
050,19,095,"Iowa","Iowa County",1,2,202,125,77
050,19,095,"Iowa","Iowa County",1,3,198,115,83
050,19,095,"Iowa","Iowa County",1,4,215,121,94
050,19,095,"Iowa","Iowa County",1,5,213,113,100
050,19,095,"Iowa","Iowa County",1,6,223,111,112
050,19,095,"Iowa","Iowa County",1,7,224,111,113
050,19,095,"Iowa","Iowa County",1,8,225,116,109
050,19,095,"Iowa","Iowa County",1,9,218,109,109
050,19,095,"Iowa","Iowa County",1,10,240,125,115
050,19,095,"Iowa","Iowa County",1,11,247,136,111
050,19,095,"Iowa","Iowa County",1,12,229,120,109
050,19,095,"Iowa","Iowa County",1,13,233,118,115
050,19,095,"Iowa","Iowa County",1,14,237,115,122
050,19,095,"Iowa","Iowa County",1,15,242,128,114
050,19,095,"Iowa","Iowa County",1,16,220,113,107
050,19,095,"Iowa","Iowa County",1,17,231,121,110
050,19,095,"Iowa","Iowa County",1,18,177,94,83
050,19,095,"Iowa","Iowa County",1,19,140,64,76
050,19,095,"Iowa","Iowa County",1,20,157,82,75
050,19,095,"Iowa","Iowa County",1,21,145,75,70
050,19,095,"Iowa","Iowa County",1,22,182,94,88
050,19,095,"Iowa","Iowa County",1,23,180,94,86
050,19,095,"Iowa","Iowa County",1,24,161,76,85
050,19,095,"Iowa","Iowa County",1,25,181,90,91
050,19,095,"Iowa","Iowa County",1,26,181,97,84
050,19,095,"Iowa","Iowa County",1,27,178,98,80
050,19,095,"Iowa","Iowa County",1,28,194,98,96
050,19,095,"Iowa","Iowa County",1,29,166,91,75
050,19,095,"Iowa","Iowa County",1,30,174,89,85
050,19,095,"Iowa","Iowa County",1,31,165,80,85
050,19,095,"Iowa","Iowa County",1,32,181,80,101
050,19,095,"Iowa","Iowa County",1,33,175,80,95
050,19,095,"Iowa","Iowa County",1,34,187,100,87
050,19,095,"Iowa","Iowa County",1,35,202,105,97
050,19,095,"Iowa","Iowa County",1,36,205,106,99
050,19,095,"Iowa","Iowa County",1,37,219,121,98
050,19,095,"Iowa","Iowa County",1,38,215,105,110
050,19,095,"Iowa","Iowa County",1,39,212,111,101
050,19,095,"Iowa","Iowa County",1,40,204,100,104
050,19,095,"Iowa","Iowa County",1,41,205,97,108
050,19,095,"Iowa","Iowa County",1,42,209,107,102
050,19,095,"Iowa","Iowa County",1,43,182,99,83
050,19,095,"Iowa","Iowa County",1,44,178,96,82
050,19,095,"Iowa","Iowa County",1,45,182,90,92
050,19,095,"Iowa","Iowa County",1,46,159,87,72
050,19,095,"Iowa","Iowa County",1,47,180,88,92
050,19,095,"Iowa","Iowa County",1,48,203,98,105
050,19,095,"Iowa","Iowa County",1,49,199,105,94
050,19,095,"Iowa","Iowa County",1,50,205,105,100
050,19,095,"Iowa","Iowa County",1,51,197,102,95
050,19,095,"Iowa","Iowa County",1,52,191,107,84
050,19,095,"Iowa","Iowa County",1,53,225,118,107
050,19,095,"Iowa","Iowa County",1,54,239,123,116
050,19,095,"Iowa","Iowa County",1,55,239,127,112
050,19,095,"Iowa","Iowa County",1,56,252,125,127
050,19,095,"Iowa","Iowa County",1,57,252,129,123
050,19,095,"Iowa","Iowa County",1,58,287,145,142
050,19,095,"Iowa","Iowa County",1,59,285,144,141
050,19,095,"Iowa","Iowa County",1,60,273,140,133
050,19,095,"Iowa","Iowa County",1,61,265,137,128
050,19,095,"Iowa","Iowa County",1,62,284,145,139
050,19,095,"Iowa","Iowa County",1,63,262,128,134
050,19,095,"Iowa","Iowa County",1,64,237,117,120
050,19,095,"Iowa","Iowa County",1,65,237,119,118
050,19,095,"Iowa","Iowa County",1,66,212,104,108
050,19,095,"Iowa","Iowa County",1,67,194,100,94
050,19,095,"Iowa","Iowa County",1,68,200,109,91
050,19,095,"Iowa","Iowa County",1,69,175,96,79
050,19,095,"Iowa","Iowa County",1,70,166,89,77
050,19,095,"Iowa","Iowa County",1,71,153,77,76
050,19,095,"Iowa","Iowa County",1,72,152,74,78
050,19,095,"Iowa","Iowa County",1,73,150,70,80
050,19,095,"Iowa","Iowa County",1,74,92,41,51
050,19,095,"Iowa","Iowa County",1,75,106,54,52
050,19,095,"Iowa","Iowa County",1,76,109,49,60
050,19,095,"Iowa","Iowa County",1,77,108,51,57
050,19,095,"Iowa","Iowa County",1,78,100,44,56
050,19,095,"Iowa","Iowa County",1,79,91,41,50
050,19,095,"Iowa","Iowa County",1,80,104,45,59
050,19,095,"Iowa","Iowa County",1,81,97,36,61
050,19,095,"Iowa","Iowa County",1,82,80,28,52
050,19,095,"Iowa","Iowa County",1,83,72,27,45
050,19,095,"Iowa","Iowa County",1,84,70,28,42
050,19,095,"Iowa","Iowa County",1,85,485,166,319
050,19,095,"Iowa","Iowa County",2,0,159,82,77
050,19,095,"Iowa","Iowa County",2,1,178,94,84
050,19,095,"Iowa","Iowa County",2,2,198,121,77
050,19,095,"Iowa","Iowa County",2,3,202,118,84
050,19,095,"Iowa","Iowa County",2,4,215,122,93
050,19,095,"Iowa","Iowa County",2,5,215,115,100
050,19,095,"Iowa","Iowa County",2,6,218,111,107
050,19,095,"Iowa","Iowa County",2,7,223,110,113
050,19,095,"Iowa","Iowa County",2,8,222,113,109
050,19,095,"Iowa","Iowa County",2,9,222,112,110
050,19,095,"Iowa","Iowa County",2,10,239,124,115
050,19,095,"Iowa","Iowa County",2,11,247,136,111
050,19,095,"Iowa","Iowa County",2,12,232,122,110
050,19,095,"Iowa","Iowa County",2,13,234,120,114
050,19,095,"Iowa","Iowa County",2,14,236,116,120
050,19,095,"Iowa","Iowa County",2,15,242,126,116
050,19,095,"Iowa","Iowa County",2,16,225,116,109
050,19,095,"Iowa","Iowa County",2,17,229,119,110
050,19,095,"Iowa","Iowa County",2,18,178,96,82
050,19,095,"Iowa","Iowa County",2,19,142,67,75
050,19,095,"Iowa","Iowa County",2,20,155,79,76
050,19,095,"Iowa","Iowa County",2,21,150,78,72
050,19,095,"Iowa","Iowa County",2,22,175,90,85
050,19,095,"Iowa","Iowa County",2,23,178,93,85
050,19,095,"Iowa","Iowa County",2,24,167,80,87
050,19,095,"Iowa","Iowa County",2,25,176,86,90
050,19,095,"Iowa","Iowa County",2,26,181,96,85
050,19,095,"Iowa","Iowa County",2,27,179,97,82
050,19,095,"Iowa","Iowa County",2,28,191,100,91
050,19,095,"Iowa","Iowa County",2,29,174,94,80
050,19,095,"Iowa","Iowa County",2,30,171,89,82
050,19,095,"Iowa","Iowa County",2,31,167,83,84
050,19,095,"Iowa","Iowa County",2,32,180,80,100
050,19,095,"Iowa","Iowa County",2,33,177,81,96
050,19,095,"Iowa","Iowa County",2,34,185,96,89
050,19,095,"Iowa","Iowa County",2,35,200,104,96
050,19,095,"Iowa","Iowa County",2,36,205,106,99
050,19,095,"Iowa","Iowa County",2,37,218,120,98
050,19,095,"Iowa","Iowa County",2,38,219,111,108
050,19,095,"Iowa","Iowa County",2,39,213,110,103
050,19,095,"Iowa","Iowa County",2,40,209,104,105
050,19,095,"Iowa","Iowa County",2,41,204,97,107
050,19,095,"Iowa","Iowa County",2,42,208,105,103
050,19,095,"Iowa","Iowa County",2,43,189,101,88
050,19,095,"Iowa","Iowa County",2,44,179,96,83
050,19,095,"Iowa","Iowa County",2,45,182,91,91
050,19,095,"Iowa","Iowa County",2,46,163,87,76
050,19,095,"Iowa","Iowa County",2,47,177,89,88
050,19,095,"Iowa","Iowa County",2,48,196,95,101
050,19,095,"Iowa","Iowa County",2,49,202,105,97
050,19,095,"Iowa","Iowa County",2,50,203,105,98
050,19,095,"Iowa","Iowa County",2,51,197,102,95
050,19,095,"Iowa","Iowa County",2,52,192,105,87
050,19,095,"Iowa","Iowa County",2,53,217,115,102
050,19,095,"Iowa","Iowa County",2,54,232,120,112
050,19,095,"Iowa","Iowa County",2,55,240,127,113
050,19,095,"Iowa","Iowa County",2,56,249,126,123
050,19,095,"Iowa","Iowa County",2,57,251,128,123
050,19,095,"Iowa","Iowa County",2,58,277,141,136
050,19,095,"Iowa","Iowa County",2,59,291,145,146
050,19,095,"Iowa","Iowa County",2,60,272,140,132
050,19,095,"Iowa","Iowa County",2,61,266,137,129
050,19,095,"Iowa","Iowa County",2,62,279,143,136
050,19,095,"Iowa","Iowa County",2,63,269,132,137
050,19,095,"Iowa","Iowa County",2,64,241,118,123
050,19,095,"Iowa","Iowa County",2,65,235,117,118
050,19,095,"Iowa","Iowa County",2,66,216,108,108
050,19,095,"Iowa","Iowa County",2,67,196,99,97
050,19,095,"Iowa","Iowa County",2,68,195,105,90
050,19,095,"Iowa","Iowa County",2,69,181,99,82
050,19,095,"Iowa","Iowa County",2,70,165,87,78
050,19,095,"Iowa","Iowa County",2,71,153,77,76
050,19,095,"Iowa","Iowa County",2,72,148,73,75
050,19,095,"Iowa","Iowa County",2,73,155,73,82
050,19,095,"Iowa","Iowa County",2,74,98,44,54
050,19,095,"Iowa","Iowa County",2,75,103,50,53
050,19,095,"Iowa","Iowa County",2,76,106,50,56
050,19,095,"Iowa","Iowa County",2,77,112,52,60
050,19,095,"Iowa","Iowa County",2,78,101,44,57
050,19,095,"Iowa","Iowa County",2,79,89,41,48
050,19,095,"Iowa","Iowa County",2,80,102,44,58
050,19,095,"Iowa","Iowa County",2,81,97,38,59
050,19,095,"Iowa","Iowa County",2,82,84,30,54
050,19,095,"Iowa","Iowa County",2,83,73,27,46
050,19,095,"Iowa","Iowa County",2,84,69,28,41
050,19,095,"Iowa","Iowa County",2,85,478,161,317
050,19,095,"Iowa","Iowa County",3,0,164,87,77
050,19,095,"Iowa","Iowa County",3,1,176,89,87
050,19,095,"Iowa","Iowa County",3,2,180,104,76
050,19,095,"Iowa","Iowa County",3,3,202,117,85
050,19,095,"Iowa","Iowa County",3,4,206,123,83
050,19,095,"Iowa","Iowa County",3,5,200,116,84
050,19,095,"Iowa","Iowa County",3,6,202,109,93
050,19,095,"Iowa","Iowa County",3,7,226,111,115
050,19,095,"Iowa","Iowa County",3,8,222,114,108
050,19,095,"Iowa","Iowa County",3,9,229,120,109
050,19,095,"Iowa","Iowa County",3,10,220,111,109
050,19,095,"Iowa","Iowa County",3,11,251,129,122
050,19,095,"Iowa","Iowa County",3,12,234,127,107
050,19,095,"Iowa","Iowa County",3,13,233,122,111
050,19,095,"Iowa","Iowa County",3,14,228,115,113
050,19,095,"Iowa","Iowa County",3,15,224,112,112
050,19,095,"Iowa","Iowa County",3,16,251,128,123
050,19,095,"Iowa","Iowa County",3,17,221,113,108
050,19,095,"Iowa","Iowa County",3,18,199,104,95
050,19,095,"Iowa","Iowa County",3,19,134,70,64
050,19,095,"Iowa","Iowa County",3,20,141,63,78
050,19,095,"Iowa","Iowa County",3,21,155,79,76
050,19,095,"Iowa","Iowa County",3,22,164,86,78
050,19,095,"Iowa","Iowa County",3,23,161,92,69
050,19,095,"Iowa","Iowa County",3,24,173,89,84
050,19,095,"Iowa","Iowa County",3,25,167,84,83
050,19,095,"Iowa","Iowa County",3,26,176,87,89
050,19,095,"Iowa","Iowa County",3,27,164,91,73
050,19,095,"Iowa","Iowa County",3,28,188,103,85
050,19,095,"Iowa","Iowa County",3,29,205,101,104
050,19,095,"Iowa","Iowa County",3,30,175,94,81
050,19,095,"Iowa","Iowa County",3,31,172,95,77
050,19,095,"Iowa","Iowa County",3,32,188,91,97
050,19,095,"Iowa","Iowa County",3,33,182,82,100
050,19,095,"Iowa","Iowa County",3,34,173,82,91
050,19,095,"Iowa","Iowa County",3,35,183,91,92
050,19,095,"Iowa","Iowa County",3,36,203,102,101
050,19,095,"Iowa","Iowa County",3,37,197,106,91
050,19,095,"Iowa","Iowa County",3,38,225,126,99
050,19,095,"Iowa","Iowa County",3,39,226,110,116
050,19,095,"Iowa","Iowa County",3,40,210,110,100
050,19,095,"Iowa","Iowa County",3,41,205,104,101
050,19,095,"Iowa","Iowa County",3,42,204,100,104
050,19,095,"Iowa","Iowa County",3,43,200,98,102
050,19,095,"Iowa","Iowa County",3,44,199,107,92
050,19,095,"Iowa","Iowa County",3,45,174,90,84
050,19,095,"Iowa","Iowa County",3,46,179,93,86
050,19,095,"Iowa","Iowa County",3,47,159,87,72
050,19,095,"Iowa","Iowa County",3,48,171,85,86
050,19,095,"Iowa","Iowa County",3,49,203,97,106
050,19,095,"Iowa","Iowa County",3,50,204,109,95
050,19,095,"Iowa","Iowa County",3,51,205,107,98
050,19,095,"Iowa","Iowa County",3,52,196,99,97
050,19,095,"Iowa","Iowa County",3,53,192,109,83
050,19,095,"Iowa","Iowa County",3,54,215,115,100
050,19,095,"Iowa","Iowa County",3,55,229,116,113
050,19,095,"Iowa","Iowa County",3,56,245,129,116
050,19,095,"Iowa","Iowa County",3,57,254,129,125
050,19,095,"Iowa","Iowa County",3,58,253,129,124
050,19,095,"Iowa","Iowa County",3,59,285,140,145
050,19,095,"Iowa","Iowa County",3,60,276,144,132
050,19,095,"Iowa","Iowa County",3,61,280,142,138
050,19,095,"Iowa","Iowa County",3,62,265,136,129
050,19,095,"Iowa","Iowa County",3,63,279,141,138
050,19,095,"Iowa","Iowa County",3,64,268,126,142
050,19,095,"Iowa","Iowa County",3,65,239,121,118
050,19,095,"Iowa","Iowa County",3,66,228,112,116
050,19,095,"Iowa","Iowa County",3,67,209,105,104
050,19,095,"Iowa","Iowa County",3,68,191,97,94
050,19,095,"Iowa","Iowa County",3,69,194,102,92
050,19,095,"Iowa","Iowa County",3,70,182,100,82
050,19,095,"Iowa","Iowa County",3,71,159,82,77
050,19,095,"Iowa","Iowa County",3,72,147,73,74
050,19,095,"Iowa","Iowa County",3,73,134,71,63
050,19,095,"Iowa","Iowa County",3,74,150,68,82
050,19,095,"Iowa","Iowa County",3,75,98,45,53
050,19,095,"Iowa","Iowa County",3,76,99,46,53
050,19,095,"Iowa","Iowa County",3,77,107,52,55
050,19,095,"Iowa","Iowa County",3,78,107,51,56
050,19,095,"Iowa","Iowa County",3,79,94,42,52
050,19,095,"Iowa","Iowa County",3,80,90,43,47
050,19,095,"Iowa","Iowa County",3,81,95,41,54
050,19,095,"Iowa","Iowa County",3,82,85,33,52
050,19,095,"Iowa","Iowa County",3,83,82,27,55
050,19,095,"Iowa","Iowa County",3,84,63,27,36
050,19,095,"Iowa","Iowa County",3,85,463,161,302
050,19,095,"Iowa","Iowa County",4,0,181,95,86
050,19,095,"Iowa","Iowa County",4,1,171,79,92
050,19,095,"Iowa","Iowa County",4,2,177,98,79
050,19,095,"Iowa","Iowa County",4,3,175,97,78
050,19,095,"Iowa","Iowa County",4,4,208,121,87
050,19,095,"Iowa","Iowa County",4,5,209,124,85
050,19,095,"Iowa","Iowa County",4,6,205,123,82
050,19,095,"Iowa","Iowa County",4,7,214,111,103
050,19,095,"Iowa","Iowa County",4,8,221,109,112
050,19,095,"Iowa","Iowa County",4,9,227,113,114
050,19,095,"Iowa","Iowa County",4,10,233,118,115
050,19,095,"Iowa","Iowa County",4,11,229,119,110
050,19,095,"Iowa","Iowa County",4,12,240,122,118
050,19,095,"Iowa","Iowa County",4,13,237,125,112
050,19,095,"Iowa","Iowa County",4,14,233,123,110
050,19,095,"Iowa","Iowa County",4,15,227,114,113
050,19,095,"Iowa","Iowa County",4,16,221,112,109
050,19,095,"Iowa","Iowa County",4,17,244,122,122
050,19,095,"Iowa","Iowa County",4,18,184,100,84
050,19,095,"Iowa","Iowa County",4,19,165,87,78
050,19,095,"Iowa","Iowa County",4,20,128,67,61
050,19,095,"Iowa","Iowa County",4,21,129,60,69
050,19,095,"Iowa","Iowa County",4,22,160,82,78
050,19,095,"Iowa","Iowa County",4,23,146,79,67
050,19,095,"Iowa","Iowa County",4,24,156,87,69
050,19,095,"Iowa","Iowa County",4,25,170,82,88
050,19,095,"Iowa","Iowa County",4,26,167,82,85
050,19,095,"Iowa","Iowa County",4,27,180,89,91
050,19,095,"Iowa","Iowa County",4,28,177,98,79
050,19,095,"Iowa","Iowa County",4,29,182,94,88
050,19,095,"Iowa","Iowa County",4,30,201,98,103
050,19,095,"Iowa","Iowa County",4,31,195,106,89
050,19,095,"Iowa","Iowa County",4,32,184,92,92
050,19,095,"Iowa","Iowa County",4,33,198,102,96
050,19,095,"Iowa","Iowa County",4,34,183,84,99
050,19,095,"Iowa","Iowa County",4,35,174,87,87
050,19,095,"Iowa","Iowa County",4,36,186,90,96
050,19,095,"Iowa","Iowa County",4,37,200,107,93
050,19,095,"Iowa","Iowa County",4,38,197,106,91
050,19,095,"Iowa","Iowa County",4,39,227,123,104
050,19,095,"Iowa","Iowa County",4,40,228,112,116
050,19,095,"Iowa","Iowa County",4,41,207,109,98
050,19,095,"Iowa","Iowa County",4,42,208,104,104
050,19,095,"Iowa","Iowa County",4,43,202,98,104
050,19,095,"Iowa","Iowa County",4,44,206,103,103
050,19,095,"Iowa","Iowa County",4,45,195,102,93
050,19,095,"Iowa","Iowa County",4,46,176,90,86
050,19,095,"Iowa","Iowa County",4,47,178,95,83
050,19,095,"Iowa","Iowa County",4,48,149,84,65
050,19,095,"Iowa","Iowa County",4,49,172,87,85
050,19,095,"Iowa","Iowa County",4,50,194,94,100
050,19,095,"Iowa","Iowa County",4,51,207,110,97
050,19,095,"Iowa","Iowa County",4,52,211,110,101
050,19,095,"Iowa","Iowa County",4,53,195,98,97
050,19,095,"Iowa","Iowa County",4,54,194,106,88
050,19,095,"Iowa","Iowa County",4,55,213,113,100
050,19,095,"Iowa","Iowa County",4,56,226,116,110
050,19,095,"Iowa","Iowa County",4,57,241,123,118
050,19,095,"Iowa","Iowa County",4,58,250,124,126
050,19,095,"Iowa","Iowa County",4,59,254,123,131
050,19,095,"Iowa","Iowa County",4,60,269,132,137
050,19,095,"Iowa","Iowa County",4,61,276,145,131
050,19,095,"Iowa","Iowa County",4,62,271,139,132
050,19,095,"Iowa","Iowa County",4,63,266,135,131
050,19,095,"Iowa","Iowa County",4,64,275,138,137
050,19,095,"Iowa","Iowa County",4,65,263,125,138
050,19,095,"Iowa","Iowa County",4,66,231,119,112
050,19,095,"Iowa","Iowa County",4,67,219,111,108
050,19,095,"Iowa","Iowa County",4,68,204,99,105
050,19,095,"Iowa","Iowa County",4,69,187,96,91
050,19,095,"Iowa","Iowa County",4,70,194,98,96
050,19,095,"Iowa","Iowa County",4,71,175,96,79
050,19,095,"Iowa","Iowa County",4,72,156,81,75
050,19,095,"Iowa","Iowa County",4,73,144,74,70
050,19,095,"Iowa","Iowa County",4,74,137,73,64
050,19,095,"Iowa","Iowa County",4,75,151,69,82
050,19,095,"Iowa","Iowa County",4,76,93,43,50
050,19,095,"Iowa","Iowa County",4,77,94,45,49
050,19,095,"Iowa","Iowa County",4,78,107,50,57
050,19,095,"Iowa","Iowa County",4,79,95,44,51
050,19,095,"Iowa","Iowa County",4,80,93,41,52
050,19,095,"Iowa","Iowa County",4,81,86,43,43
050,19,095,"Iowa","Iowa County",4,82,81,34,47
050,19,095,"Iowa","Iowa County",4,83,86,31,55
050,19,095,"Iowa","Iowa County",4,84,70,26,44
050,19,095,"Iowa","Iowa County",4,85,427,149,278
050,19,095,"Iowa","Iowa County",5,0,185,96,89
050,19,095,"Iowa","Iowa County",5,1,189,101,88
050,19,095,"Iowa","Iowa County",5,2,172,88,84
050,19,095,"Iowa","Iowa County",5,3,184,91,93
050,19,095,"Iowa","Iowa County",5,4,173,96,77
050,19,095,"Iowa","Iowa County",5,5,213,127,86
050,19,095,"Iowa","Iowa County",5,6,199,120,79
050,19,095,"Iowa","Iowa County",5,7,213,124,89
050,19,095,"Iowa","Iowa County",5,8,214,112,102
050,19,095,"Iowa","Iowa County",5,9,219,103,116
050,19,095,"Iowa","Iowa County",5,10,234,120,114
050,19,095,"Iowa","Iowa County",5,11,238,127,111
050,19,095,"Iowa","Iowa County",5,12,219,108,111
050,19,095,"Iowa","Iowa County",5,13,241,120,121
050,19,095,"Iowa","Iowa County",5,14,238,125,113
050,19,095,"Iowa","Iowa County",5,15,216,121,95
050,19,095,"Iowa","Iowa County",5,16,231,120,111
050,19,095,"Iowa","Iowa County",5,17,213,105,108
050,19,095,"Iowa","Iowa County",5,18,193,98,95
050,19,095,"Iowa","Iowa County",5,19,137,75,62
050,19,095,"Iowa","Iowa County",5,20,171,89,82
050,19,095,"Iowa","Iowa County",5,21,134,73,61
050,19,095,"Iowa","Iowa County",5,22,141,68,73
050,19,095,"Iowa","Iowa County",5,23,148,75,73
050,19,095,"Iowa","Iowa County",5,24,134,69,65
050,19,095,"Iowa","Iowa County",5,25,164,89,75
050,19,095,"Iowa","Iowa County",5,26,169,86,83
050,19,095,"Iowa","Iowa County",5,27,158,76,82
050,19,095,"Iowa","Iowa County",5,28,188,98,90
050,19,095,"Iowa","Iowa County",5,29,179,91,88
050,19,095,"Iowa","Iowa County",5,30,185,95,90
050,19,095,"Iowa","Iowa County",5,31,192,96,96
050,19,095,"Iowa","Iowa County",5,32,195,103,92
050,19,095,"Iowa","Iowa County",5,33,182,94,88
050,19,095,"Iowa","Iowa County",5,34,195,102,93
050,19,095,"Iowa","Iowa County",5,35,180,80,100
050,19,095,"Iowa","Iowa County",5,36,183,93,90
050,19,095,"Iowa","Iowa County",5,37,192,95,97
050,19,095,"Iowa","Iowa County",5,38,195,101,94
050,19,095,"Iowa","Iowa County",5,39,198,107,91
050,19,095,"Iowa","Iowa County",5,40,228,123,105
050,19,095,"Iowa","Iowa County",5,41,230,119,111
050,19,095,"Iowa","Iowa County",5,42,211,108,103
050,19,095,"Iowa","Iowa County",5,43,205,102,103
050,19,095,"Iowa","Iowa County",5,44,202,102,100
050,19,095,"Iowa","Iowa County",5,45,199,99,100
050,19,095,"Iowa","Iowa County",5,46,189,103,86
050,19,095,"Iowa","Iowa County",5,47,170,88,82
050,19,095,"Iowa","Iowa County",5,48,182,95,87
050,19,095,"Iowa","Iowa County",5,49,152,87,65
050,19,095,"Iowa","Iowa County",5,50,167,87,80
050,19,095,"Iowa","Iowa County",5,51,200,97,103
050,19,095,"Iowa","Iowa County",5,52,203,104,99
050,19,095,"Iowa","Iowa County",5,53,207,109,98
050,19,095,"Iowa","Iowa County",5,54,190,93,97
050,19,095,"Iowa","Iowa County",5,55,202,111,91
050,19,095,"Iowa","Iowa County",5,56,218,118,100
050,19,095,"Iowa","Iowa County",5,57,224,116,108
050,19,095,"Iowa","Iowa County",5,58,239,120,119
050,19,095,"Iowa","Iowa County",5,59,251,119,132
050,19,095,"Iowa","Iowa County",5,60,244,123,121
050,19,095,"Iowa","Iowa County",5,61,270,128,142
050,19,095,"Iowa","Iowa County",5,62,274,143,131
050,19,095,"Iowa","Iowa County",5,63,272,140,132
050,19,095,"Iowa","Iowa County",5,64,262,134,128
050,19,095,"Iowa","Iowa County",5,65,272,138,134
050,19,095,"Iowa","Iowa County",5,66,258,125,133
050,19,095,"Iowa","Iowa County",5,67,219,114,105
050,19,095,"Iowa","Iowa County",5,68,218,107,111
050,19,095,"Iowa","Iowa County",5,69,205,99,106
050,19,095,"Iowa","Iowa County",5,70,187,94,93
050,19,095,"Iowa","Iowa County",5,71,186,96,90
050,19,095,"Iowa","Iowa County",5,72,169,91,78
050,19,095,"Iowa","Iowa County",5,73,150,80,70
050,19,095,"Iowa","Iowa County",5,74,141,71,70
050,19,095,"Iowa","Iowa County",5,75,138,74,64
050,19,095,"Iowa","Iowa County",5,76,146,65,81
050,19,095,"Iowa","Iowa County",5,77,89,42,47
050,19,095,"Iowa","Iowa County",5,78,94,44,50
050,19,095,"Iowa","Iowa County",5,79,97,44,53
050,19,095,"Iowa","Iowa County",5,80,92,43,49
050,19,095,"Iowa","Iowa County",5,81,86,39,47
050,19,095,"Iowa","Iowa County",5,82,73,36,37
050,19,095,"Iowa","Iowa County",5,83,80,30,50
050,19,095,"Iowa","Iowa County",5,84,75,30,45
050,19,095,"Iowa","Iowa County",5,85,411,144,267
050,19,097,"Iowa","Jackson County",1,0,215,111,104
050,19,097,"Iowa","Jackson County",1,1,215,114,101
050,19,097,"Iowa","Jackson County",1,2,217,109,108
050,19,097,"Iowa","Jackson County",1,3,228,122,106
050,19,097,"Iowa","Jackson County",1,4,233,121,112
050,19,097,"Iowa","Jackson County",1,5,230,126,104
050,19,097,"Iowa","Jackson County",1,6,241,122,119
050,19,097,"Iowa","Jackson County",1,7,224,106,118
050,19,097,"Iowa","Jackson County",1,8,234,114,120
050,19,097,"Iowa","Jackson County",1,9,230,120,110
050,19,097,"Iowa","Jackson County",1,10,237,127,110
050,19,097,"Iowa","Jackson County",1,11,251,136,115
050,19,097,"Iowa","Jackson County",1,12,263,130,133
050,19,097,"Iowa","Jackson County",1,13,278,141,137
050,19,097,"Iowa","Jackson County",1,14,276,139,137
050,19,097,"Iowa","Jackson County",1,15,249,128,121
050,19,097,"Iowa","Jackson County",1,16,264,137,127
050,19,097,"Iowa","Jackson County",1,17,250,121,129
050,19,097,"Iowa","Jackson County",1,18,223,117,106
050,19,097,"Iowa","Jackson County",1,19,183,99,84
050,19,097,"Iowa","Jackson County",1,20,193,104,89
050,19,097,"Iowa","Jackson County",1,21,188,102,86
050,19,097,"Iowa","Jackson County",1,22,208,112,96
050,19,097,"Iowa","Jackson County",1,23,199,107,92
050,19,097,"Iowa","Jackson County",1,24,209,113,96
050,19,097,"Iowa","Jackson County",1,25,212,110,102
050,19,097,"Iowa","Jackson County",1,26,196,105,91
050,19,097,"Iowa","Jackson County",1,27,198,98,100
050,19,097,"Iowa","Jackson County",1,28,229,117,112
050,19,097,"Iowa","Jackson County",1,29,191,90,101
050,19,097,"Iowa","Jackson County",1,30,190,93,97
050,19,097,"Iowa","Jackson County",1,31,193,104,89
050,19,097,"Iowa","Jackson County",1,32,183,95,88
050,19,097,"Iowa","Jackson County",1,33,199,107,92
050,19,097,"Iowa","Jackson County",1,34,197,105,92
050,19,097,"Iowa","Jackson County",1,35,199,104,95
050,19,097,"Iowa","Jackson County",1,36,210,105,105
050,19,097,"Iowa","Jackson County",1,37,237,123,114
050,19,097,"Iowa","Jackson County",1,38,228,127,101
050,19,097,"Iowa","Jackson County",1,39,217,118,99
050,19,097,"Iowa","Jackson County",1,40,209,108,101
050,19,097,"Iowa","Jackson County",1,41,224,116,108
050,19,097,"Iowa","Jackson County",1,42,206,103,103
050,19,097,"Iowa","Jackson County",1,43,185,99,86
050,19,097,"Iowa","Jackson County",1,44,197,100,97
050,19,097,"Iowa","Jackson County",1,45,206,108,98
050,19,097,"Iowa","Jackson County",1,46,206,109,97
050,19,097,"Iowa","Jackson County",1,47,200,97,103
050,19,097,"Iowa","Jackson County",1,48,226,108,118
050,19,097,"Iowa","Jackson County",1,49,237,113,124
050,19,097,"Iowa","Jackson County",1,50,248,126,122
050,19,097,"Iowa","Jackson County",1,51,238,119,119
050,19,097,"Iowa","Jackson County",1,52,236,112,124
050,19,097,"Iowa","Jackson County",1,53,276,149,127
050,19,097,"Iowa","Jackson County",1,54,303,156,147
050,19,097,"Iowa","Jackson County",1,55,304,150,154
050,19,097,"Iowa","Jackson County",1,56,312,154,158
050,19,097,"Iowa","Jackson County",1,57,315,154,161
050,19,097,"Iowa","Jackson County",1,58,338,179,159
050,19,097,"Iowa","Jackson County",1,59,333,179,154
050,19,097,"Iowa","Jackson County",1,60,319,159,160
050,19,097,"Iowa","Jackson County",1,61,323,164,159
050,19,097,"Iowa","Jackson County",1,62,332,165,167
050,19,097,"Iowa","Jackson County",1,63,304,157,147
050,19,097,"Iowa","Jackson County",1,64,298,149,149
050,19,097,"Iowa","Jackson County",1,65,306,158,148
050,19,097,"Iowa","Jackson County",1,66,265,140,125
050,19,097,"Iowa","Jackson County",1,67,257,132,125
050,19,097,"Iowa","Jackson County",1,68,277,134,143
050,19,097,"Iowa","Jackson County",1,69,236,116,120
050,19,097,"Iowa","Jackson County",1,70,214,109,105
050,19,097,"Iowa","Jackson County",1,71,202,103,99
050,19,097,"Iowa","Jackson County",1,72,214,113,101
050,19,097,"Iowa","Jackson County",1,73,230,105,125
050,19,097,"Iowa","Jackson County",1,74,166,82,84
050,19,097,"Iowa","Jackson County",1,75,172,91,81
050,19,097,"Iowa","Jackson County",1,76,164,81,83
050,19,097,"Iowa","Jackson County",1,77,145,65,80
050,19,097,"Iowa","Jackson County",1,78,124,54,70
050,19,097,"Iowa","Jackson County",1,79,109,39,70
050,19,097,"Iowa","Jackson County",1,80,99,49,50
050,19,097,"Iowa","Jackson County",1,81,115,56,59
050,19,097,"Iowa","Jackson County",1,82,103,47,56
050,19,097,"Iowa","Jackson County",1,83,83,34,49
050,19,097,"Iowa","Jackson County",1,84,76,34,42
050,19,097,"Iowa","Jackson County",1,85,536,197,339
050,19,097,"Iowa","Jackson County",2,0,211,106,105
050,19,097,"Iowa","Jackson County",2,1,215,113,102
050,19,097,"Iowa","Jackson County",2,2,216,109,107
050,19,097,"Iowa","Jackson County",2,3,224,118,106
050,19,097,"Iowa","Jackson County",2,4,231,121,110
050,19,097,"Iowa","Jackson County",2,5,232,125,107
050,19,097,"Iowa","Jackson County",2,6,238,122,116
050,19,097,"Iowa","Jackson County",2,7,226,109,117
050,19,097,"Iowa","Jackson County",2,8,230,112,118
050,19,097,"Iowa","Jackson County",2,9,231,118,113
050,19,097,"Iowa","Jackson County",2,10,236,125,111
050,19,097,"Iowa","Jackson County",2,11,245,132,113
050,19,097,"Iowa","Jackson County",2,12,262,132,130
050,19,097,"Iowa","Jackson County",2,13,275,139,136
050,19,097,"Iowa","Jackson County",2,14,274,138,136
050,19,097,"Iowa","Jackson County",2,15,256,130,126
050,19,097,"Iowa","Jackson County",2,16,259,135,124
050,19,097,"Iowa","Jackson County",2,17,251,123,128
050,19,097,"Iowa","Jackson County",2,18,217,113,104
050,19,097,"Iowa","Jackson County",2,19,183,98,85
050,19,097,"Iowa","Jackson County",2,20,194,104,90
050,19,097,"Iowa","Jackson County",2,21,190,103,87
050,19,097,"Iowa","Jackson County",2,22,206,110,96
050,19,097,"Iowa","Jackson County",2,23,203,109,94
050,19,097,"Iowa","Jackson County",2,24,207,111,96
050,19,097,"Iowa","Jackson County",2,25,209,111,98
050,19,097,"Iowa","Jackson County",2,26,197,105,92
050,19,097,"Iowa","Jackson County",2,27,199,99,100
050,19,097,"Iowa","Jackson County",2,28,221,112,109
050,19,097,"Iowa","Jackson County",2,29,201,97,104
050,19,097,"Iowa","Jackson County",2,30,192,94,98
050,19,097,"Iowa","Jackson County",2,31,193,101,92
050,19,097,"Iowa","Jackson County",2,32,185,96,89
050,19,097,"Iowa","Jackson County",2,33,193,104,89
050,19,097,"Iowa","Jackson County",2,34,199,107,92
050,19,097,"Iowa","Jackson County",2,35,201,106,95
050,19,097,"Iowa","Jackson County",2,36,209,105,104
050,19,097,"Iowa","Jackson County",2,37,228,118,110
050,19,097,"Iowa","Jackson County",2,38,233,128,105
050,19,097,"Iowa","Jackson County",2,39,219,120,99
050,19,097,"Iowa","Jackson County",2,40,213,113,100
050,19,097,"Iowa","Jackson County",2,41,217,112,105
050,19,097,"Iowa","Jackson County",2,42,210,106,104
050,19,097,"Iowa","Jackson County",2,43,191,101,90
050,19,097,"Iowa","Jackson County",2,44,191,99,92
050,19,097,"Iowa","Jackson County",2,45,204,106,98
050,19,097,"Iowa","Jackson County",2,46,205,108,97
050,19,097,"Iowa","Jackson County",2,47,200,99,101
050,19,097,"Iowa","Jackson County",2,48,220,106,114
050,19,097,"Iowa","Jackson County",2,49,234,112,122
050,19,097,"Iowa","Jackson County",2,50,245,124,121
050,19,097,"Iowa","Jackson County",2,51,239,121,118
050,19,097,"Iowa","Jackson County",2,52,236,114,122
050,19,097,"Iowa","Jackson County",2,53,269,141,128
050,19,097,"Iowa","Jackson County",2,54,295,153,142
050,19,097,"Iowa","Jackson County",2,55,302,151,151
050,19,097,"Iowa","Jackson County",2,56,312,155,157
050,19,097,"Iowa","Jackson County",2,57,313,153,160
050,19,097,"Iowa","Jackson County",2,58,334,173,161
050,19,097,"Iowa","Jackson County",2,59,335,179,156
050,19,097,"Iowa","Jackson County",2,60,319,160,159
050,19,097,"Iowa","Jackson County",2,61,319,163,156
050,19,097,"Iowa","Jackson County",2,62,330,164,166
050,19,097,"Iowa","Jackson County",2,63,312,159,153
050,19,097,"Iowa","Jackson County",2,64,298,150,148
050,19,097,"Iowa","Jackson County",2,65,302,156,146
050,19,097,"Iowa","Jackson County",2,66,277,145,132
050,19,097,"Iowa","Jackson County",2,67,259,134,125
050,19,097,"Iowa","Jackson County",2,68,269,133,136
050,19,097,"Iowa","Jackson County",2,69,245,120,125
050,19,097,"Iowa","Jackson County",2,70,218,109,109
050,19,097,"Iowa","Jackson County",2,71,205,105,100
050,19,097,"Iowa","Jackson County",2,72,207,108,99
050,19,097,"Iowa","Jackson County",2,73,237,111,126
050,19,097,"Iowa","Jackson County",2,74,167,81,86
050,19,097,"Iowa","Jackson County",2,75,170,87,83
050,19,097,"Iowa","Jackson County",2,76,164,83,81
050,19,097,"Iowa","Jackson County",2,77,153,70,83
050,19,097,"Iowa","Jackson County",2,78,125,55,70
050,19,097,"Iowa","Jackson County",2,79,110,42,68
050,19,097,"Iowa","Jackson County",2,80,99,47,52
050,19,097,"Iowa","Jackson County",2,81,108,51,57
050,19,097,"Iowa","Jackson County",2,82,106,50,56
050,19,097,"Iowa","Jackson County",2,83,88,37,51
050,19,097,"Iowa","Jackson County",2,84,77,34,43
050,19,097,"Iowa","Jackson County",2,85,535,197,338
050,19,097,"Iowa","Jackson County",3,0,202,96,106
050,19,097,"Iowa","Jackson County",3,1,219,110,109
050,19,097,"Iowa","Jackson County",3,2,218,116,102
050,19,097,"Iowa","Jackson County",3,3,234,123,111
050,19,097,"Iowa","Jackson County",3,4,231,122,109
050,19,097,"Iowa","Jackson County",3,5,240,123,117
050,19,097,"Iowa","Jackson County",3,6,235,124,111
050,19,097,"Iowa","Jackson County",3,7,251,128,123
050,19,097,"Iowa","Jackson County",3,8,232,116,116
050,19,097,"Iowa","Jackson County",3,9,233,112,121
050,19,097,"Iowa","Jackson County",3,10,234,118,116
050,19,097,"Iowa","Jackson County",3,11,228,116,112
050,19,097,"Iowa","Jackson County",3,12,245,137,108
050,19,097,"Iowa","Jackson County",3,13,258,130,128
050,19,097,"Iowa","Jackson County",3,14,274,140,134
050,19,097,"Iowa","Jackson County",3,15,271,135,136
050,19,097,"Iowa","Jackson County",3,16,258,130,128
050,19,097,"Iowa","Jackson County",3,17,254,132,122
050,19,097,"Iowa","Jackson County",3,18,221,108,113
050,19,097,"Iowa","Jackson County",3,19,176,92,84
050,19,097,"Iowa","Jackson County",3,20,187,101,86
050,19,097,"Iowa","Jackson County",3,21,202,111,91
050,19,097,"Iowa","Jackson County",3,22,193,104,89
050,19,097,"Iowa","Jackson County",3,23,200,111,89
050,19,097,"Iowa","Jackson County",3,24,197,109,88
050,19,097,"Iowa","Jackson County",3,25,195,103,92
050,19,097,"Iowa","Jackson County",3,26,198,106,92
050,19,097,"Iowa","Jackson County",3,27,210,109,101
050,19,097,"Iowa","Jackson County",3,28,199,101,98
050,19,097,"Iowa","Jackson County",3,29,218,110,108
050,19,097,"Iowa","Jackson County",3,30,193,96,97
050,19,097,"Iowa","Jackson County",3,31,194,92,102
050,19,097,"Iowa","Jackson County",3,32,195,106,89
050,19,097,"Iowa","Jackson County",3,33,181,91,90
050,19,097,"Iowa","Jackson County",3,34,205,107,98
050,19,097,"Iowa","Jackson County",3,35,196,102,94
050,19,097,"Iowa","Jackson County",3,36,197,104,93
050,19,097,"Iowa","Jackson County",3,37,208,106,102
050,19,097,"Iowa","Jackson County",3,38,248,128,120
050,19,097,"Iowa","Jackson County",3,39,232,130,102
050,19,097,"Iowa","Jackson County",3,40,231,129,102
050,19,097,"Iowa","Jackson County",3,41,205,107,98
050,19,097,"Iowa","Jackson County",3,42,216,110,106
050,19,097,"Iowa","Jackson County",3,43,209,103,106
050,19,097,"Iowa","Jackson County",3,44,183,99,84
050,19,097,"Iowa","Jackson County",3,45,188,97,91
050,19,097,"Iowa","Jackson County",3,46,211,108,103
050,19,097,"Iowa","Jackson County",3,47,213,112,101
050,19,097,"Iowa","Jackson County",3,48,197,98,99
050,19,097,"Iowa","Jackson County",3,49,213,104,109
050,19,097,"Iowa","Jackson County",3,50,230,114,116
050,19,097,"Iowa","Jackson County",3,51,243,124,119
050,19,097,"Iowa","Jackson County",3,52,248,125,123
050,19,097,"Iowa","Jackson County",3,53,234,114,120
050,19,097,"Iowa","Jackson County",3,54,265,140,125
050,19,097,"Iowa","Jackson County",3,55,297,150,147
050,19,097,"Iowa","Jackson County",3,56,305,151,154
050,19,097,"Iowa","Jackson County",3,57,306,154,152
050,19,097,"Iowa","Jackson County",3,58,317,154,163
050,19,097,"Iowa","Jackson County",3,59,334,175,159
050,19,097,"Iowa","Jackson County",3,60,339,177,162
050,19,097,"Iowa","Jackson County",3,61,315,160,155
050,19,097,"Iowa","Jackson County",3,62,326,166,160
050,19,097,"Iowa","Jackson County",3,63,327,161,166
050,19,097,"Iowa","Jackson County",3,64,300,148,152
050,19,097,"Iowa","Jackson County",3,65,293,147,146
050,19,097,"Iowa","Jackson County",3,66,296,152,144
050,19,097,"Iowa","Jackson County",3,67,275,147,128
050,19,097,"Iowa","Jackson County",3,68,257,126,131
050,19,097,"Iowa","Jackson County",3,69,264,134,130
050,19,097,"Iowa","Jackson County",3,70,236,114,122
050,19,097,"Iowa","Jackson County",3,71,217,103,114
050,19,097,"Iowa","Jackson County",3,72,196,97,99
050,19,097,"Iowa","Jackson County",3,73,202,104,98
050,19,097,"Iowa","Jackson County",3,74,224,108,116
050,19,097,"Iowa","Jackson County",3,75,161,77,84
050,19,097,"Iowa","Jackson County",3,76,162,82,80
050,19,097,"Iowa","Jackson County",3,77,159,79,80
050,19,097,"Iowa","Jackson County",3,78,150,68,82
050,19,097,"Iowa","Jackson County",3,79,120,52,68
050,19,097,"Iowa","Jackson County",3,80,103,39,64
050,19,097,"Iowa","Jackson County",3,81,94,41,53
050,19,097,"Iowa","Jackson County",3,82,92,46,46
050,19,097,"Iowa","Jackson County",3,83,97,46,51
050,19,097,"Iowa","Jackson County",3,84,80,37,43
050,19,097,"Iowa","Jackson County",3,85,507,181,326
050,19,097,"Iowa","Jackson County",4,0,207,88,119
050,19,097,"Iowa","Jackson County",4,1,209,95,114
050,19,097,"Iowa","Jackson County",4,2,225,116,109
050,19,097,"Iowa","Jackson County",4,3,215,113,102
050,19,097,"Iowa","Jackson County",4,4,237,122,115
050,19,097,"Iowa","Jackson County",4,5,229,125,104
050,19,097,"Iowa","Jackson County",4,6,243,124,119
050,19,097,"Iowa","Jackson County",4,7,239,126,113
050,19,097,"Iowa","Jackson County",4,8,249,124,125
050,19,097,"Iowa","Jackson County",4,9,237,119,118
050,19,097,"Iowa","Jackson County",4,10,231,106,125
050,19,097,"Iowa","Jackson County",4,11,239,118,121
050,19,097,"Iowa","Jackson County",4,12,222,115,107
050,19,097,"Iowa","Jackson County",4,13,246,139,107
050,19,097,"Iowa","Jackson County",4,14,257,134,123
050,19,097,"Iowa","Jackson County",4,15,278,143,135
050,19,097,"Iowa","Jackson County",4,16,268,135,133
050,19,097,"Iowa","Jackson County",4,17,245,122,123
050,19,097,"Iowa","Jackson County",4,18,214,116,98
050,19,097,"Iowa","Jackson County",4,19,162,84,78
050,19,097,"Iowa","Jackson County",4,20,186,96,90
050,19,097,"Iowa","Jackson County",4,21,199,108,91
050,19,097,"Iowa","Jackson County",4,22,217,114,103
050,19,097,"Iowa","Jackson County",4,23,210,117,93
050,19,097,"Iowa","Jackson County",4,24,206,108,98
050,19,097,"Iowa","Jackson County",4,25,188,102,86
050,19,097,"Iowa","Jackson County",4,26,185,98,87
050,19,097,"Iowa","Jackson County",4,27,214,116,98
050,19,097,"Iowa","Jackson County",4,28,210,110,100
050,19,097,"Iowa","Jackson County",4,29,195,97,98
050,19,097,"Iowa","Jackson County",4,30,208,104,104
050,19,097,"Iowa","Jackson County",4,31,197,96,101
050,19,097,"Iowa","Jackson County",4,32,199,93,106
050,19,097,"Iowa","Jackson County",4,33,200,112,88
050,19,097,"Iowa","Jackson County",4,34,192,99,93
050,19,097,"Iowa","Jackson County",4,35,201,106,95
050,19,097,"Iowa","Jackson County",4,36,200,111,89
050,19,097,"Iowa","Jackson County",4,37,191,101,90
050,19,097,"Iowa","Jackson County",4,38,211,111,100
050,19,097,"Iowa","Jackson County",4,39,242,124,118
050,19,097,"Iowa","Jackson County",4,40,233,133,100
050,19,097,"Iowa","Jackson County",4,41,226,121,105
050,19,097,"Iowa","Jackson County",4,42,205,109,96
050,19,097,"Iowa","Jackson County",4,43,218,111,107
050,19,097,"Iowa","Jackson County",4,44,211,104,107
050,19,097,"Iowa","Jackson County",4,45,192,100,92
050,19,097,"Iowa","Jackson County",4,46,189,101,88
050,19,097,"Iowa","Jackson County",4,47,206,103,103
050,19,097,"Iowa","Jackson County",4,48,211,112,99
050,19,097,"Iowa","Jackson County",4,49,204,105,99
050,19,097,"Iowa","Jackson County",4,50,214,106,108
050,19,097,"Iowa","Jackson County",4,51,236,118,118
050,19,097,"Iowa","Jackson County",4,52,245,126,119
050,19,097,"Iowa","Jackson County",4,53,253,132,121
050,19,097,"Iowa","Jackson County",4,54,234,112,122
050,19,097,"Iowa","Jackson County",4,55,262,139,123
050,19,097,"Iowa","Jackson County",4,56,294,150,144
050,19,097,"Iowa","Jackson County",4,57,307,152,155
050,19,097,"Iowa","Jackson County",4,58,306,154,152
050,19,097,"Iowa","Jackson County",4,59,320,156,164
050,19,097,"Iowa","Jackson County",4,60,335,176,159
050,19,097,"Iowa","Jackson County",4,61,334,176,158
050,19,097,"Iowa","Jackson County",4,62,304,152,152
050,19,097,"Iowa","Jackson County",4,63,319,160,159
050,19,097,"Iowa","Jackson County",4,64,319,152,167
050,19,097,"Iowa","Jackson County",4,65,298,148,150
050,19,097,"Iowa","Jackson County",4,66,294,147,147
050,19,097,"Iowa","Jackson County",4,67,283,144,139
050,19,097,"Iowa","Jackson County",4,68,267,143,124
050,19,097,"Iowa","Jackson County",4,69,252,127,125
050,19,097,"Iowa","Jackson County",4,70,255,129,126
050,19,097,"Iowa","Jackson County",4,71,227,112,115
050,19,097,"Iowa","Jackson County",4,72,215,99,116
050,19,097,"Iowa","Jackson County",4,73,187,93,94
050,19,097,"Iowa","Jackson County",4,74,194,99,95
050,19,097,"Iowa","Jackson County",4,75,215,101,114
050,19,097,"Iowa","Jackson County",4,76,154,72,82
050,19,097,"Iowa","Jackson County",4,77,160,79,81
050,19,097,"Iowa","Jackson County",4,78,151,74,77
050,19,097,"Iowa","Jackson County",4,79,144,65,79
050,19,097,"Iowa","Jackson County",4,80,113,52,61
050,19,097,"Iowa","Jackson County",4,81,97,34,63
050,19,097,"Iowa","Jackson County",4,82,79,37,42
050,19,097,"Iowa","Jackson County",4,83,88,43,45
050,19,097,"Iowa","Jackson County",4,84,94,49,45
050,19,097,"Iowa","Jackson County",4,85,499,174,325
050,19,097,"Iowa","Jackson County",5,0,205,86,119
050,19,097,"Iowa","Jackson County",5,1,204,91,113
050,19,097,"Iowa","Jackson County",5,2,216,101,115
050,19,097,"Iowa","Jackson County",5,3,227,119,108
050,19,097,"Iowa","Jackson County",5,4,211,113,98
050,19,097,"Iowa","Jackson County",5,5,246,131,115
050,19,097,"Iowa","Jackson County",5,6,232,125,107
050,19,097,"Iowa","Jackson County",5,7,241,118,123
050,19,097,"Iowa","Jackson County",5,8,244,128,116
050,19,097,"Iowa","Jackson County",5,9,255,129,126
050,19,097,"Iowa","Jackson County",5,10,230,117,113
050,19,097,"Iowa","Jackson County",5,11,237,113,124
050,19,097,"Iowa","Jackson County",5,12,237,122,115
050,19,097,"Iowa","Jackson County",5,13,229,114,115
050,19,097,"Iowa","Jackson County",5,14,252,141,111
050,19,097,"Iowa","Jackson County",5,15,264,138,126
050,19,097,"Iowa","Jackson County",5,16,280,146,134
050,19,097,"Iowa","Jackson County",5,17,266,135,131
050,19,097,"Iowa","Jackson County",5,18,203,103,100
050,19,097,"Iowa","Jackson County",5,19,160,87,73
050,19,097,"Iowa","Jackson County",5,20,175,86,89
050,19,097,"Iowa","Jackson County",5,21,197,100,97
050,19,097,"Iowa","Jackson County",5,22,207,113,94
050,19,097,"Iowa","Jackson County",5,23,218,119,99
050,19,097,"Iowa","Jackson County",5,24,214,122,92
050,19,097,"Iowa","Jackson County",5,25,197,112,85
050,19,097,"Iowa","Jackson County",5,26,186,103,83
050,19,097,"Iowa","Jackson County",5,27,202,106,96
050,19,097,"Iowa","Jackson County",5,28,212,119,93
050,19,097,"Iowa","Jackson County",5,29,213,114,99
050,19,097,"Iowa","Jackson County",5,30,203,96,107
050,19,097,"Iowa","Jackson County",5,31,202,103,99
050,19,097,"Iowa","Jackson County",5,32,196,97,99
050,19,097,"Iowa","Jackson County",5,33,201,93,108
050,19,097,"Iowa","Jackson County",5,34,197,110,87
050,19,097,"Iowa","Jackson County",5,35,192,99,93
050,19,097,"Iowa","Jackson County",5,36,202,107,95
050,19,097,"Iowa","Jackson County",5,37,204,113,91
050,19,097,"Iowa","Jackson County",5,38,199,108,91
050,19,097,"Iowa","Jackson County",5,39,214,113,101
050,19,097,"Iowa","Jackson County",5,40,246,127,119
050,19,097,"Iowa","Jackson County",5,41,225,125,100
050,19,097,"Iowa","Jackson County",5,42,229,123,106
050,19,097,"Iowa","Jackson County",5,43,206,109,97
050,19,097,"Iowa","Jackson County",5,44,218,112,106
050,19,097,"Iowa","Jackson County",5,45,209,99,110
050,19,097,"Iowa","Jackson County",5,46,198,105,93
050,19,097,"Iowa","Jackson County",5,47,185,98,87
050,19,097,"Iowa","Jackson County",5,48,208,102,106
050,19,097,"Iowa","Jackson County",5,49,216,114,102
050,19,097,"Iowa","Jackson County",5,50,206,110,96
050,19,097,"Iowa","Jackson County",5,51,215,106,109
050,19,097,"Iowa","Jackson County",5,52,236,120,116
050,19,097,"Iowa","Jackson County",5,53,247,129,118
050,19,097,"Iowa","Jackson County",5,54,250,133,117
050,19,097,"Iowa","Jackson County",5,55,231,106,125
050,19,097,"Iowa","Jackson County",5,56,261,140,121
050,19,097,"Iowa","Jackson County",5,57,288,146,142
050,19,097,"Iowa","Jackson County",5,58,306,152,154
050,19,097,"Iowa","Jackson County",5,59,306,152,154
050,19,097,"Iowa","Jackson County",5,60,322,157,165
050,19,097,"Iowa","Jackson County",5,61,331,174,157
050,19,097,"Iowa","Jackson County",5,62,328,173,155
050,19,097,"Iowa","Jackson County",5,63,302,151,151
050,19,097,"Iowa","Jackson County",5,64,306,153,153
050,19,097,"Iowa","Jackson County",5,65,317,150,167
050,19,097,"Iowa","Jackson County",5,66,305,151,154
050,19,097,"Iowa","Jackson County",5,67,295,149,146
050,19,097,"Iowa","Jackson County",5,68,275,138,137
050,19,097,"Iowa","Jackson County",5,69,266,144,122
050,19,097,"Iowa","Jackson County",5,70,243,121,122
050,19,097,"Iowa","Jackson County",5,71,248,124,124
050,19,097,"Iowa","Jackson County",5,72,222,106,116
050,19,097,"Iowa","Jackson County",5,73,209,93,116
050,19,097,"Iowa","Jackson County",5,74,183,91,92
050,19,097,"Iowa","Jackson County",5,75,187,93,94
050,19,097,"Iowa","Jackson County",5,76,198,90,108
050,19,097,"Iowa","Jackson County",5,77,146,66,80
050,19,097,"Iowa","Jackson County",5,78,160,79,81
050,19,097,"Iowa","Jackson County",5,79,146,70,76
050,19,097,"Iowa","Jackson County",5,80,137,62,75
050,19,097,"Iowa","Jackson County",5,81,104,46,58
050,19,097,"Iowa","Jackson County",5,82,83,29,54
050,19,097,"Iowa","Jackson County",5,83,75,37,38
050,19,097,"Iowa","Jackson County",5,84,81,41,40
050,19,097,"Iowa","Jackson County",5,85,517,180,337
050,19,099,"Iowa","Jasper County",1,0,404,209,195
050,19,099,"Iowa","Jasper County",1,1,415,226,189
050,19,099,"Iowa","Jasper County",1,2,415,215,200
050,19,099,"Iowa","Jasper County",1,3,456,249,207
050,19,099,"Iowa","Jasper County",1,4,431,227,204
050,19,099,"Iowa","Jasper County",1,5,442,224,218
050,19,099,"Iowa","Jasper County",1,6,434,224,210
050,19,099,"Iowa","Jasper County",1,7,499,258,241
050,19,099,"Iowa","Jasper County",1,8,492,245,247
050,19,099,"Iowa","Jasper County",1,9,437,228,209
050,19,099,"Iowa","Jasper County",1,10,475,244,231
050,19,099,"Iowa","Jasper County",1,11,458,224,234
050,19,099,"Iowa","Jasper County",1,12,510,273,237
050,19,099,"Iowa","Jasper County",1,13,496,251,245
050,19,099,"Iowa","Jasper County",1,14,517,261,256
050,19,099,"Iowa","Jasper County",1,15,519,258,261
050,19,099,"Iowa","Jasper County",1,16,509,260,249
050,19,099,"Iowa","Jasper County",1,17,511,258,253
050,19,099,"Iowa","Jasper County",1,18,422,230,192
050,19,099,"Iowa","Jasper County",1,19,362,202,160
050,19,099,"Iowa","Jasper County",1,20,365,194,171
050,19,099,"Iowa","Jasper County",1,21,379,205,174
050,19,099,"Iowa","Jasper County",1,22,404,230,174
050,19,099,"Iowa","Jasper County",1,23,379,212,167
050,19,099,"Iowa","Jasper County",1,24,418,217,201
050,19,099,"Iowa","Jasper County",1,25,426,225,201
050,19,099,"Iowa","Jasper County",1,26,437,243,194
050,19,099,"Iowa","Jasper County",1,27,421,248,173
050,19,099,"Iowa","Jasper County",1,28,510,274,236
050,19,099,"Iowa","Jasper County",1,29,494,272,222
050,19,099,"Iowa","Jasper County",1,30,441,255,186
050,19,099,"Iowa","Jasper County",1,31,422,243,179
050,19,099,"Iowa","Jasper County",1,32,473,275,198
050,19,099,"Iowa","Jasper County",1,33,477,260,217
050,19,099,"Iowa","Jasper County",1,34,488,274,214
050,19,099,"Iowa","Jasper County",1,35,481,268,213
050,19,099,"Iowa","Jasper County",1,36,466,247,219
050,19,099,"Iowa","Jasper County",1,37,496,279,217
050,19,099,"Iowa","Jasper County",1,38,507,262,245
050,19,099,"Iowa","Jasper County",1,39,515,259,256
050,19,099,"Iowa","Jasper County",1,40,477,266,211
050,19,099,"Iowa","Jasper County",1,41,490,279,211
050,19,099,"Iowa","Jasper County",1,42,482,268,214
050,19,099,"Iowa","Jasper County",1,43,456,260,196
050,19,099,"Iowa","Jasper County",1,44,435,241,194
050,19,099,"Iowa","Jasper County",1,45,443,254,189
050,19,099,"Iowa","Jasper County",1,46,441,265,176
050,19,099,"Iowa","Jasper County",1,47,447,251,196
050,19,099,"Iowa","Jasper County",1,48,446,253,193
050,19,099,"Iowa","Jasper County",1,49,502,281,221
050,19,099,"Iowa","Jasper County",1,50,518,278,240
050,19,099,"Iowa","Jasper County",1,51,485,259,226
050,19,099,"Iowa","Jasper County",1,52,467,238,229
050,19,099,"Iowa","Jasper County",1,53,468,228,240
050,19,099,"Iowa","Jasper County",1,54,504,257,247
050,19,099,"Iowa","Jasper County",1,55,492,266,226
050,19,099,"Iowa","Jasper County",1,56,512,257,255
050,19,099,"Iowa","Jasper County",1,57,533,263,270
050,19,099,"Iowa","Jasper County",1,58,568,293,275
050,19,099,"Iowa","Jasper County",1,59,579,283,296
050,19,099,"Iowa","Jasper County",1,60,558,271,287
050,19,099,"Iowa","Jasper County",1,61,527,266,261
050,19,099,"Iowa","Jasper County",1,62,541,282,259
050,19,099,"Iowa","Jasper County",1,63,522,272,250
050,19,099,"Iowa","Jasper County",1,64,497,255,242
050,19,099,"Iowa","Jasper County",1,65,499,256,243
050,19,099,"Iowa","Jasper County",1,66,442,235,207
050,19,099,"Iowa","Jasper County",1,67,427,218,209
050,19,099,"Iowa","Jasper County",1,68,472,229,243
050,19,099,"Iowa","Jasper County",1,69,419,186,233
050,19,099,"Iowa","Jasper County",1,70,358,166,192
050,19,099,"Iowa","Jasper County",1,71,373,176,197
050,19,099,"Iowa","Jasper County",1,72,380,186,194
050,19,099,"Iowa","Jasper County",1,73,383,190,193
050,19,099,"Iowa","Jasper County",1,74,275,126,149
050,19,099,"Iowa","Jasper County",1,75,272,126,146
050,19,099,"Iowa","Jasper County",1,76,285,137,148
050,19,099,"Iowa","Jasper County",1,77,289,130,159
050,19,099,"Iowa","Jasper County",1,78,221,88,133
050,19,099,"Iowa","Jasper County",1,79,198,85,113
050,19,099,"Iowa","Jasper County",1,80,212,98,114
050,19,099,"Iowa","Jasper County",1,81,188,75,113
050,19,099,"Iowa","Jasper County",1,82,179,76,103
050,19,099,"Iowa","Jasper County",1,83,170,69,101
050,19,099,"Iowa","Jasper County",1,84,166,61,105
050,19,099,"Iowa","Jasper County",1,85,1004,347,657
050,19,099,"Iowa","Jasper County",2,0,420,214,206
050,19,099,"Iowa","Jasper County",2,1,411,220,191
050,19,099,"Iowa","Jasper County",2,2,417,217,200
050,19,099,"Iowa","Jasper County",2,3,446,240,206
050,19,099,"Iowa","Jasper County",2,4,440,234,206
050,19,099,"Iowa","Jasper County",2,5,440,226,214
050,19,099,"Iowa","Jasper County",2,6,439,225,214
050,19,099,"Iowa","Jasper County",2,7,485,250,235
050,19,099,"Iowa","Jasper County",2,8,491,245,246
050,19,099,"Iowa","Jasper County",2,9,453,233,220
050,19,099,"Iowa","Jasper County",2,10,464,238,226
050,19,099,"Iowa","Jasper County",2,11,460,229,231
050,19,099,"Iowa","Jasper County",2,12,499,261,238
050,19,099,"Iowa","Jasper County",2,13,499,255,244
050,19,099,"Iowa","Jasper County",2,14,514,260,254
050,19,099,"Iowa","Jasper County",2,15,518,257,261
050,19,099,"Iowa","Jasper County",2,16,510,258,252
050,19,099,"Iowa","Jasper County",2,17,506,256,250
050,19,099,"Iowa","Jasper County",2,18,425,231,194
050,19,099,"Iowa","Jasper County",2,19,362,202,160
050,19,099,"Iowa","Jasper County",2,20,375,202,173
050,19,099,"Iowa","Jasper County",2,21,379,206,173
050,19,099,"Iowa","Jasper County",2,22,401,223,178
050,19,099,"Iowa","Jasper County",2,23,389,218,171
050,19,099,"Iowa","Jasper County",2,24,414,218,196
050,19,099,"Iowa","Jasper County",2,25,428,227,201
050,19,099,"Iowa","Jasper County",2,26,438,243,195
050,19,099,"Iowa","Jasper County",2,27,428,246,182
050,19,099,"Iowa","Jasper County",2,28,495,270,225
050,19,099,"Iowa","Jasper County",2,29,503,277,226
050,19,099,"Iowa","Jasper County",2,30,458,261,197
050,19,099,"Iowa","Jasper County",2,31,428,247,181
050,19,099,"Iowa","Jasper County",2,32,466,270,196
050,19,099,"Iowa","Jasper County",2,33,477,265,212
050,19,099,"Iowa","Jasper County",2,34,487,269,218
050,19,099,"Iowa","Jasper County",2,35,483,268,215
050,19,099,"Iowa","Jasper County",2,36,466,250,216
050,19,099,"Iowa","Jasper County",2,37,494,278,216
050,19,099,"Iowa","Jasper County",2,38,502,262,240
050,19,099,"Iowa","Jasper County",2,39,512,261,251
050,19,099,"Iowa","Jasper County",2,40,484,261,223
050,19,099,"Iowa","Jasper County",2,41,488,278,210
050,19,099,"Iowa","Jasper County",2,42,484,271,213
050,19,099,"Iowa","Jasper County",2,43,467,266,201
050,19,099,"Iowa","Jasper County",2,44,435,243,192
050,19,099,"Iowa","Jasper County",2,45,445,256,189
050,19,099,"Iowa","Jasper County",2,46,439,259,180
050,19,099,"Iowa","Jasper County",2,47,441,249,192
050,19,099,"Iowa","Jasper County",2,48,444,250,194
050,19,099,"Iowa","Jasper County",2,49,493,276,217
050,19,099,"Iowa","Jasper County",2,50,513,277,236
050,19,099,"Iowa","Jasper County",2,51,496,265,231
050,19,099,"Iowa","Jasper County",2,52,467,242,225
050,19,099,"Iowa","Jasper County",2,53,469,231,238
050,19,099,"Iowa","Jasper County",2,54,492,250,242
050,19,099,"Iowa","Jasper County",2,55,494,263,231
050,19,099,"Iowa","Jasper County",2,56,507,259,248
050,19,099,"Iowa","Jasper County",2,57,524,259,265
050,19,099,"Iowa","Jasper County",2,58,556,284,272
050,19,099,"Iowa","Jasper County",2,59,576,283,293
050,19,099,"Iowa","Jasper County",2,60,558,272,286
050,19,099,"Iowa","Jasper County",2,61,530,265,265
050,19,099,"Iowa","Jasper County",2,62,535,276,259
050,19,099,"Iowa","Jasper County",2,63,529,275,254
050,19,099,"Iowa","Jasper County",2,64,500,259,241
050,19,099,"Iowa","Jasper County",2,65,496,255,241
050,19,099,"Iowa","Jasper County",2,66,454,237,217
050,19,099,"Iowa","Jasper County",2,67,425,220,205
050,19,099,"Iowa","Jasper County",2,68,456,223,233
050,19,099,"Iowa","Jasper County",2,69,435,197,238
050,19,099,"Iowa","Jasper County",2,70,368,170,198
050,19,099,"Iowa","Jasper County",2,71,371,173,198
050,19,099,"Iowa","Jasper County",2,72,367,178,189
050,19,099,"Iowa","Jasper County",2,73,397,198,199
050,19,099,"Iowa","Jasper County",2,74,282,133,149
050,19,099,"Iowa","Jasper County",2,75,272,128,144
050,19,099,"Iowa","Jasper County",2,76,276,132,144
050,19,099,"Iowa","Jasper County",2,77,294,134,160
050,19,099,"Iowa","Jasper County",2,78,227,93,134
050,19,099,"Iowa","Jasper County",2,79,197,83,114
050,19,099,"Iowa","Jasper County",2,80,207,94,113
050,19,099,"Iowa","Jasper County",2,81,188,77,111
050,19,099,"Iowa","Jasper County",2,82,176,73,103
050,19,099,"Iowa","Jasper County",2,83,171,70,101
050,19,099,"Iowa","Jasper County",2,84,156,53,103
050,19,099,"Iowa","Jasper County",2,85,1007,351,656
050,19,099,"Iowa","Jasper County",3,0,390,180,210
050,19,099,"Iowa","Jasper County",3,1,397,217,180
050,19,099,"Iowa","Jasper County",3,2,412,216,196
050,19,099,"Iowa","Jasper County",3,3,423,224,199
050,19,099,"Iowa","Jasper County",3,4,443,231,212
050,19,099,"Iowa","Jasper County",3,5,450,248,202
050,19,099,"Iowa","Jasper County",3,6,450,227,223
050,19,099,"Iowa","Jasper County",3,7,445,232,213
050,19,099,"Iowa","Jasper County",3,8,480,243,237
050,19,099,"Iowa","Jasper County",3,9,491,254,237
050,19,099,"Iowa","Jasper County",3,10,447,230,217
050,19,099,"Iowa","Jasper County",3,11,473,241,232
050,19,099,"Iowa","Jasper County",3,12,476,239,237
050,19,099,"Iowa","Jasper County",3,13,502,259,243
050,19,099,"Iowa","Jasper County",3,14,517,269,248
050,19,099,"Iowa","Jasper County",3,15,514,256,258
050,19,099,"Iowa","Jasper County",3,16,515,258,257
050,19,099,"Iowa","Jasper County",3,17,511,263,248
050,19,099,"Iowa","Jasper County",3,18,431,232,199
050,19,099,"Iowa","Jasper County",3,19,347,196,151
050,19,099,"Iowa","Jasper County",3,20,378,212,166
050,19,099,"Iowa","Jasper County",3,21,402,209,193
050,19,099,"Iowa","Jasper County",3,22,415,221,194
050,19,099,"Iowa","Jasper County",3,23,398,230,168
050,19,099,"Iowa","Jasper County",3,24,427,247,180
050,19,099,"Iowa","Jasper County",3,25,440,239,201
050,19,099,"Iowa","Jasper County",3,26,434,234,200
050,19,099,"Iowa","Jasper County",3,27,424,244,180
050,19,099,"Iowa","Jasper County",3,28,470,273,197
050,19,099,"Iowa","Jasper County",3,29,507,272,235
050,19,099,"Iowa","Jasper County",3,30,504,281,223
050,19,099,"Iowa","Jasper County",3,31,439,249,190
050,19,099,"Iowa","Jasper County",3,32,466,271,195
050,19,099,"Iowa","Jasper County",3,33,483,274,209
050,19,099,"Iowa","Jasper County",3,34,477,258,219
050,19,099,"Iowa","Jasper County",3,35,483,270,213
050,19,099,"Iowa","Jasper County",3,36,482,262,220
050,19,099,"Iowa","Jasper County",3,37,482,262,220
050,19,099,"Iowa","Jasper County",3,38,484,267,217
050,19,099,"Iowa","Jasper County",3,39,513,271,242
050,19,099,"Iowa","Jasper County",3,40,503,255,248
050,19,099,"Iowa","Jasper County",3,41,514,277,237
050,19,099,"Iowa","Jasper County",3,42,497,270,227
050,19,099,"Iowa","Jasper County",3,43,482,277,205
050,19,099,"Iowa","Jasper County",3,44,469,267,202
050,19,099,"Iowa","Jasper County",3,45,436,250,186
050,19,099,"Iowa","Jasper County",3,46,442,257,185
050,19,099,"Iowa","Jasper County",3,47,433,246,187
050,19,099,"Iowa","Jasper County",3,48,424,238,186
050,19,099,"Iowa","Jasper County",3,49,450,256,194
050,19,099,"Iowa","Jasper County",3,50,492,275,217
050,19,099,"Iowa","Jasper County",3,51,528,287,241
050,19,099,"Iowa","Jasper County",3,52,481,264,217
050,19,099,"Iowa","Jasper County",3,53,465,242,223
050,19,099,"Iowa","Jasper County",3,54,459,231,228
050,19,099,"Iowa","Jasper County",3,55,478,240,238
050,19,099,"Iowa","Jasper County",3,56,488,258,230
050,19,099,"Iowa","Jasper County",3,57,492,253,239
050,19,099,"Iowa","Jasper County",3,58,521,260,261
050,19,099,"Iowa","Jasper County",3,59,560,278,282
050,19,099,"Iowa","Jasper County",3,60,565,274,291
050,19,099,"Iowa","Jasper County",3,61,544,269,275
050,19,099,"Iowa","Jasper County",3,62,529,264,265
050,19,099,"Iowa","Jasper County",3,63,518,268,250
050,19,099,"Iowa","Jasper County",3,64,541,285,256
050,19,099,"Iowa","Jasper County",3,65,501,256,245
050,19,099,"Iowa","Jasper County",3,66,493,247,246
050,19,099,"Iowa","Jasper County",3,67,426,219,207
050,19,099,"Iowa","Jasper County",3,68,421,213,208
050,19,099,"Iowa","Jasper County",3,69,447,215,232
050,19,099,"Iowa","Jasper County",3,70,415,188,227
050,19,099,"Iowa","Jasper County",3,71,363,164,199
050,19,099,"Iowa","Jasper County",3,72,367,171,196
050,19,099,"Iowa","Jasper County",3,73,348,165,183
050,19,099,"Iowa","Jasper County",3,74,379,184,195
050,19,099,"Iowa","Jasper County",3,75,270,123,147
050,19,099,"Iowa","Jasper County",3,76,264,125,139
050,19,099,"Iowa","Jasper County",3,77,271,126,145
050,19,099,"Iowa","Jasper County",3,78,280,125,155
050,19,099,"Iowa","Jasper County",3,79,225,97,128
050,19,099,"Iowa","Jasper County",3,80,188,79,109
050,19,099,"Iowa","Jasper County",3,81,179,79,100
050,19,099,"Iowa","Jasper County",3,82,174,70,104
050,19,099,"Iowa","Jasper County",3,83,169,68,101
050,19,099,"Iowa","Jasper County",3,84,161,62,99
050,19,099,"Iowa","Jasper County",3,85,1000,350,650
050,19,099,"Iowa","Jasper County",4,0,387,180,207
050,19,099,"Iowa","Jasper County",4,1,414,191,223
050,19,099,"Iowa","Jasper County",4,2,396,226,170
050,19,099,"Iowa","Jasper County",4,3,440,240,200
050,19,099,"Iowa","Jasper County",4,4,432,231,201
050,19,099,"Iowa","Jasper County",4,5,465,243,222
050,19,099,"Iowa","Jasper County",4,6,469,249,220
050,19,099,"Iowa","Jasper County",4,7,465,235,230
050,19,099,"Iowa","Jasper County",4,8,459,234,225
050,19,099,"Iowa","Jasper County",4,9,483,239,244
050,19,099,"Iowa","Jasper County",4,10,504,256,248
050,19,099,"Iowa","Jasper County",4,11,450,228,222
050,19,099,"Iowa","Jasper County",4,12,484,252,232
050,19,099,"Iowa","Jasper County",4,13,478,242,236
050,19,099,"Iowa","Jasper County",4,14,513,267,246
050,19,099,"Iowa","Jasper County",4,15,525,267,258
050,19,099,"Iowa","Jasper County",4,16,525,261,264
050,19,099,"Iowa","Jasper County",4,17,503,249,254
050,19,099,"Iowa","Jasper County",4,18,446,244,202
050,19,099,"Iowa","Jasper County",4,19,351,193,158
050,19,099,"Iowa","Jasper County",4,20,352,201,151
050,19,099,"Iowa","Jasper County",4,21,420,232,188
050,19,099,"Iowa","Jasper County",4,22,414,218,196
050,19,099,"Iowa","Jasper County",4,23,433,222,211
050,19,099,"Iowa","Jasper County",4,24,432,249,183
050,19,099,"Iowa","Jasper County",4,25,423,242,181
050,19,099,"Iowa","Jasper County",4,26,448,257,191
050,19,099,"Iowa","Jasper County",4,27,421,230,191
050,19,099,"Iowa","Jasper County",4,28,436,239,197
050,19,099,"Iowa","Jasper County",4,29,496,295,201
050,19,099,"Iowa","Jasper County",4,30,507,271,236
050,19,099,"Iowa","Jasper County",4,31,494,275,219
050,19,099,"Iowa","Jasper County",4,32,456,264,192
050,19,099,"Iowa","Jasper County",4,33,464,261,203
050,19,099,"Iowa","Jasper County",4,34,479,268,211
050,19,099,"Iowa","Jasper County",4,35,476,255,221
050,19,099,"Iowa","Jasper County",4,36,470,266,204
050,19,099,"Iowa","Jasper County",4,37,501,278,223
050,19,099,"Iowa","Jasper County",4,38,470,252,218
050,19,099,"Iowa","Jasper County",4,39,492,280,212
050,19,099,"Iowa","Jasper County",4,40,514,265,249
050,19,099,"Iowa","Jasper County",4,41,510,260,250
050,19,099,"Iowa","Jasper County",4,42,511,279,232
050,19,099,"Iowa","Jasper County",4,43,517,292,225
050,19,099,"Iowa","Jasper County",4,44,497,290,207
050,19,099,"Iowa","Jasper County",4,45,454,259,195
050,19,099,"Iowa","Jasper County",4,46,427,243,184
050,19,099,"Iowa","Jasper County",4,47,442,249,193
050,19,099,"Iowa","Jasper County",4,48,412,233,179
050,19,099,"Iowa","Jasper County",4,49,433,243,190
050,19,099,"Iowa","Jasper County",4,50,449,251,198
050,19,099,"Iowa","Jasper County",4,51,507,282,225
050,19,099,"Iowa","Jasper County",4,52,507,277,230
050,19,099,"Iowa","Jasper County",4,53,473,254,219
050,19,099,"Iowa","Jasper County",4,54,459,237,222
050,19,099,"Iowa","Jasper County",4,55,452,229,223
050,19,099,"Iowa","Jasper County",4,56,467,228,239
050,19,099,"Iowa","Jasper County",4,57,483,254,229
050,19,099,"Iowa","Jasper County",4,58,485,249,236
050,19,099,"Iowa","Jasper County",4,59,514,253,261
050,19,099,"Iowa","Jasper County",4,60,559,274,285
050,19,099,"Iowa","Jasper County",4,61,552,267,285
050,19,099,"Iowa","Jasper County",4,62,539,270,269
050,19,099,"Iowa","Jasper County",4,63,516,256,260
050,19,099,"Iowa","Jasper County",4,64,512,265,247
050,19,099,"Iowa","Jasper County",4,65,535,276,259
050,19,099,"Iowa","Jasper County",4,66,477,242,235
050,19,099,"Iowa","Jasper County",4,67,475,243,232
050,19,099,"Iowa","Jasper County",4,68,426,220,206
050,19,099,"Iowa","Jasper County",4,69,427,208,219
050,19,099,"Iowa","Jasper County",4,70,431,204,227
050,19,099,"Iowa","Jasper County",4,71,414,186,228
050,19,099,"Iowa","Jasper County",4,72,354,162,192
050,19,099,"Iowa","Jasper County",4,73,349,159,190
050,19,099,"Iowa","Jasper County",4,74,334,161,173
050,19,099,"Iowa","Jasper County",4,75,366,178,188
050,19,099,"Iowa","Jasper County",4,76,257,121,136
050,19,099,"Iowa","Jasper County",4,77,266,121,145
050,19,099,"Iowa","Jasper County",4,78,252,118,134
050,19,099,"Iowa","Jasper County",4,79,277,127,150
050,19,099,"Iowa","Jasper County",4,80,216,94,122
050,19,099,"Iowa","Jasper County",4,81,167,68,99
050,19,099,"Iowa","Jasper County",4,82,171,78,93
050,19,099,"Iowa","Jasper County",4,83,165,63,102
050,19,099,"Iowa","Jasper County",4,84,153,51,102
050,19,099,"Iowa","Jasper County",4,85,973,341,632
050,19,099,"Iowa","Jasper County",5,0,385,177,208
050,19,099,"Iowa","Jasper County",5,1,388,183,205
050,19,099,"Iowa","Jasper County",5,2,411,191,220
050,19,099,"Iowa","Jasper County",5,3,399,225,174
050,19,099,"Iowa","Jasper County",5,4,434,232,202
050,19,099,"Iowa","Jasper County",5,5,429,233,196
050,19,099,"Iowa","Jasper County",5,6,475,254,221
050,19,099,"Iowa","Jasper County",5,7,483,262,221
050,19,099,"Iowa","Jasper County",5,8,463,227,236
050,19,099,"Iowa","Jasper County",5,9,472,252,220
050,19,099,"Iowa","Jasper County",5,10,479,238,241
050,19,099,"Iowa","Jasper County",5,11,504,252,252
050,19,099,"Iowa","Jasper County",5,12,443,224,219
050,19,099,"Iowa","Jasper County",5,13,500,261,239
050,19,099,"Iowa","Jasper County",5,14,483,250,233
050,19,099,"Iowa","Jasper County",5,15,523,267,256
050,19,099,"Iowa","Jasper County",5,16,528,272,256
050,19,099,"Iowa","Jasper County",5,17,520,256,264
050,19,099,"Iowa","Jasper County",5,18,428,224,204
050,19,099,"Iowa","Jasper County",5,19,352,203,149
050,19,099,"Iowa","Jasper County",5,20,367,202,165
050,19,099,"Iowa","Jasper County",5,21,388,222,166
050,19,099,"Iowa","Jasper County",5,22,440,243,197
050,19,099,"Iowa","Jasper County",5,23,424,232,192
050,19,099,"Iowa","Jasper County",5,24,425,223,202
050,19,099,"Iowa","Jasper County",5,25,422,241,181
050,19,099,"Iowa","Jasper County",5,26,431,246,185
050,19,099,"Iowa","Jasper County",5,27,444,247,197
050,19,099,"Iowa","Jasper County",5,28,443,241,202
050,19,099,"Iowa","Jasper County",5,29,478,269,209
050,19,099,"Iowa","Jasper County",5,30,480,284,196
050,19,099,"Iowa","Jasper County",5,31,477,262,215
050,19,099,"Iowa","Jasper County",5,32,497,275,222
050,19,099,"Iowa","Jasper County",5,33,471,268,203
050,19,099,"Iowa","Jasper County",5,34,458,255,203
050,19,099,"Iowa","Jasper County",5,35,488,266,222
050,19,099,"Iowa","Jasper County",5,36,469,242,227
050,19,099,"Iowa","Jasper County",5,37,479,277,202
050,19,099,"Iowa","Jasper County",5,38,484,261,223
050,19,099,"Iowa","Jasper County",5,39,473,260,213
050,19,099,"Iowa","Jasper County",5,40,484,269,215
050,19,099,"Iowa","Jasper County",5,41,521,272,249
050,19,099,"Iowa","Jasper County",5,42,519,261,258
050,19,099,"Iowa","Jasper County",5,43,536,303,233
050,19,099,"Iowa","Jasper County",5,44,510,285,225
050,19,099,"Iowa","Jasper County",5,45,501,291,210
050,19,099,"Iowa","Jasper County",5,46,438,250,188
050,19,099,"Iowa","Jasper County",5,47,422,228,194
050,19,099,"Iowa","Jasper County",5,48,431,239,192
050,19,099,"Iowa","Jasper County",5,49,423,242,181
050,19,099,"Iowa","Jasper County",5,50,428,239,189
050,19,099,"Iowa","Jasper County",5,51,461,252,209
050,19,099,"Iowa","Jasper County",5,52,487,275,212
050,19,099,"Iowa","Jasper County",5,53,503,271,232
050,19,099,"Iowa","Jasper County",5,54,461,247,214
050,19,099,"Iowa","Jasper County",5,55,447,232,215
050,19,099,"Iowa","Jasper County",5,56,446,221,225
050,19,099,"Iowa","Jasper County",5,57,459,227,232
050,19,099,"Iowa","Jasper County",5,58,491,255,236
050,19,099,"Iowa","Jasper County",5,59,491,246,245
050,19,099,"Iowa","Jasper County",5,60,503,248,255
050,19,099,"Iowa","Jasper County",5,61,548,270,278
050,19,099,"Iowa","Jasper County",5,62,563,276,287
050,19,099,"Iowa","Jasper County",5,63,529,259,270
050,19,099,"Iowa","Jasper County",5,64,512,256,256
050,19,099,"Iowa","Jasper County",5,65,503,259,244
050,19,099,"Iowa","Jasper County",5,66,535,268,267
050,19,099,"Iowa","Jasper County",5,67,459,229,230
050,19,099,"Iowa","Jasper County",5,68,469,238,231
050,19,099,"Iowa","Jasper County",5,69,431,217,214
050,19,099,"Iowa","Jasper County",5,70,409,199,210
050,19,099,"Iowa","Jasper County",5,71,423,193,230
050,19,099,"Iowa","Jasper County",5,72,405,181,224
050,19,099,"Iowa","Jasper County",5,73,339,155,184
050,19,099,"Iowa","Jasper County",5,74,337,152,185
050,19,099,"Iowa","Jasper County",5,75,324,156,168
050,19,099,"Iowa","Jasper County",5,76,358,175,183
050,19,099,"Iowa","Jasper County",5,77,256,115,141
050,19,099,"Iowa","Jasper County",5,78,253,115,138
050,19,099,"Iowa","Jasper County",5,79,250,121,129
050,19,099,"Iowa","Jasper County",5,80,264,123,141
050,19,099,"Iowa","Jasper County",5,81,202,87,115
050,19,099,"Iowa","Jasper County",5,82,160,65,95
050,19,099,"Iowa","Jasper County",5,83,161,70,91
050,19,099,"Iowa","Jasper County",5,84,154,50,104
050,19,099,"Iowa","Jasper County",5,85,976,336,640
050,19,101,"Iowa","Jefferson County",1,0,128,66,62
050,19,101,"Iowa","Jefferson County",1,1,129,58,71
050,19,101,"Iowa","Jefferson County",1,2,133,69,64
050,19,101,"Iowa","Jefferson County",1,3,142,76,66
050,19,101,"Iowa","Jefferson County",1,4,164,82,82
050,19,101,"Iowa","Jefferson County",1,5,158,78,80
050,19,101,"Iowa","Jefferson County",1,6,129,67,62
050,19,101,"Iowa","Jefferson County",1,7,131,72,59
050,19,101,"Iowa","Jefferson County",1,8,136,77,59
050,19,101,"Iowa","Jefferson County",1,9,140,73,67
050,19,101,"Iowa","Jefferson County",1,10,138,68,70
050,19,101,"Iowa","Jefferson County",1,11,143,70,73
050,19,101,"Iowa","Jefferson County",1,12,156,78,78
050,19,101,"Iowa","Jefferson County",1,13,145,80,65
050,19,101,"Iowa","Jefferson County",1,14,155,80,75
050,19,101,"Iowa","Jefferson County",1,15,150,65,85
050,19,101,"Iowa","Jefferson County",1,16,140,77,63
050,19,101,"Iowa","Jefferson County",1,17,165,92,73
050,19,101,"Iowa","Jefferson County",1,18,135,75,60
050,19,101,"Iowa","Jefferson County",1,19,115,63,52
050,19,101,"Iowa","Jefferson County",1,20,140,78,62
050,19,101,"Iowa","Jefferson County",1,21,239,160,79
050,19,101,"Iowa","Jefferson County",1,22,234,168,66
050,19,101,"Iowa","Jefferson County",1,23,243,176,67
050,19,101,"Iowa","Jefferson County",1,24,254,184,70
050,19,101,"Iowa","Jefferson County",1,25,215,135,80
050,19,101,"Iowa","Jefferson County",1,26,245,164,81
050,19,101,"Iowa","Jefferson County",1,27,236,148,88
050,19,101,"Iowa","Jefferson County",1,28,274,184,90
050,19,101,"Iowa","Jefferson County",1,29,208,122,86
050,19,101,"Iowa","Jefferson County",1,30,189,115,74
050,19,101,"Iowa","Jefferson County",1,31,222,125,97
050,19,101,"Iowa","Jefferson County",1,32,180,101,79
050,19,101,"Iowa","Jefferson County",1,33,180,103,77
050,19,101,"Iowa","Jefferson County",1,34,184,106,78
050,19,101,"Iowa","Jefferson County",1,35,182,115,67
050,19,101,"Iowa","Jefferson County",1,36,181,105,76
050,19,101,"Iowa","Jefferson County",1,37,187,106,81
050,19,101,"Iowa","Jefferson County",1,38,186,87,99
050,19,101,"Iowa","Jefferson County",1,39,162,74,88
050,19,101,"Iowa","Jefferson County",1,40,204,109,95
050,19,101,"Iowa","Jefferson County",1,41,171,98,73
050,19,101,"Iowa","Jefferson County",1,42,150,72,78
050,19,101,"Iowa","Jefferson County",1,43,170,90,80
050,19,101,"Iowa","Jefferson County",1,44,175,94,81
050,19,101,"Iowa","Jefferson County",1,45,184,96,88
050,19,101,"Iowa","Jefferson County",1,46,148,81,67
050,19,101,"Iowa","Jefferson County",1,47,157,84,73
050,19,101,"Iowa","Jefferson County",1,48,164,83,81
050,19,101,"Iowa","Jefferson County",1,49,198,108,90
050,19,101,"Iowa","Jefferson County",1,50,180,85,95
050,19,101,"Iowa","Jefferson County",1,51,161,76,85
050,19,101,"Iowa","Jefferson County",1,52,151,70,81
050,19,101,"Iowa","Jefferson County",1,53,151,63,88
050,19,101,"Iowa","Jefferson County",1,54,160,83,77
050,19,101,"Iowa","Jefferson County",1,55,179,80,99
050,19,101,"Iowa","Jefferson County",1,56,190,93,97
050,19,101,"Iowa","Jefferson County",1,57,179,86,93
050,19,101,"Iowa","Jefferson County",1,58,201,97,104
050,19,101,"Iowa","Jefferson County",1,59,217,97,120
050,19,101,"Iowa","Jefferson County",1,60,211,102,109
050,19,101,"Iowa","Jefferson County",1,61,216,114,102
050,19,101,"Iowa","Jefferson County",1,62,250,121,129
050,19,101,"Iowa","Jefferson County",1,63,250,119,131
050,19,101,"Iowa","Jefferson County",1,64,266,135,131
050,19,101,"Iowa","Jefferson County",1,65,304,156,148
050,19,101,"Iowa","Jefferson County",1,66,294,159,135
050,19,101,"Iowa","Jefferson County",1,67,284,148,136
050,19,101,"Iowa","Jefferson County",1,68,320,167,153
050,19,101,"Iowa","Jefferson County",1,69,291,147,144
050,19,101,"Iowa","Jefferson County",1,70,277,144,133
050,19,101,"Iowa","Jefferson County",1,71,261,129,132
050,19,101,"Iowa","Jefferson County",1,72,255,123,132
050,19,101,"Iowa","Jefferson County",1,73,233,114,119
050,19,101,"Iowa","Jefferson County",1,74,148,76,72
050,19,101,"Iowa","Jefferson County",1,75,135,62,73
050,19,101,"Iowa","Jefferson County",1,76,124,54,70
050,19,101,"Iowa","Jefferson County",1,77,129,57,72
050,19,101,"Iowa","Jefferson County",1,78,88,41,47
050,19,101,"Iowa","Jefferson County",1,79,72,40,32
050,19,101,"Iowa","Jefferson County",1,80,83,42,41
050,19,101,"Iowa","Jefferson County",1,81,76,30,46
050,19,101,"Iowa","Jefferson County",1,82,68,21,47
050,19,101,"Iowa","Jefferson County",1,83,61,25,36
050,19,101,"Iowa","Jefferson County",1,84,51,21,30
050,19,101,"Iowa","Jefferson County",1,85,455,158,297
050,19,101,"Iowa","Jefferson County",2,0,140,71,69
050,19,101,"Iowa","Jefferson County",2,1,128,60,68
050,19,101,"Iowa","Jefferson County",2,2,133,67,66
050,19,101,"Iowa","Jefferson County",2,3,141,76,65
050,19,101,"Iowa","Jefferson County",2,4,159,83,76
050,19,101,"Iowa","Jefferson County",2,5,160,78,82
050,19,101,"Iowa","Jefferson County",2,6,138,71,67
050,19,101,"Iowa","Jefferson County",2,7,132,72,60
050,19,101,"Iowa","Jefferson County",2,8,133,74,59
050,19,101,"Iowa","Jefferson County",2,9,139,75,64
050,19,101,"Iowa","Jefferson County",2,10,141,70,71
050,19,101,"Iowa","Jefferson County",2,11,141,69,72
050,19,101,"Iowa","Jefferson County",2,12,155,77,78
050,19,101,"Iowa","Jefferson County",2,13,148,82,66
050,19,101,"Iowa","Jefferson County",2,14,154,80,74
050,19,101,"Iowa","Jefferson County",2,15,153,69,84
050,19,101,"Iowa","Jefferson County",2,16,145,76,69
050,19,101,"Iowa","Jefferson County",2,17,157,87,70
050,19,101,"Iowa","Jefferson County",2,18,139,78,61
050,19,101,"Iowa","Jefferson County",2,19,116,63,53
050,19,101,"Iowa","Jefferson County",2,20,140,79,61
050,19,101,"Iowa","Jefferson County",2,21,233,157,76
050,19,101,"Iowa","Jefferson County",2,22,237,167,70
050,19,101,"Iowa","Jefferson County",2,23,242,173,69
050,19,101,"Iowa","Jefferson County",2,24,235,166,69
050,19,101,"Iowa","Jefferson County",2,25,222,144,78
050,19,101,"Iowa","Jefferson County",2,26,229,148,81
050,19,101,"Iowa","Jefferson County",2,27,238,151,87
050,19,101,"Iowa","Jefferson County",2,28,253,163,90
050,19,101,"Iowa","Jefferson County",2,29,217,132,85
050,19,101,"Iowa","Jefferson County",2,30,196,116,80
050,19,101,"Iowa","Jefferson County",2,31,216,123,93
050,19,101,"Iowa","Jefferson County",2,32,191,106,85
050,19,101,"Iowa","Jefferson County",2,33,180,104,76
050,19,101,"Iowa","Jefferson County",2,34,184,107,77
050,19,101,"Iowa","Jefferson County",2,35,185,113,72
050,19,101,"Iowa","Jefferson County",2,36,183,108,75
050,19,101,"Iowa","Jefferson County",2,37,186,105,81
050,19,101,"Iowa","Jefferson County",2,38,187,93,94
050,19,101,"Iowa","Jefferson County",2,39,166,77,89
050,19,101,"Iowa","Jefferson County",2,40,196,102,94
050,19,101,"Iowa","Jefferson County",2,41,177,98,79
050,19,101,"Iowa","Jefferson County",2,42,156,79,77
050,19,101,"Iowa","Jefferson County",2,43,167,87,80
050,19,101,"Iowa","Jefferson County",2,44,175,93,82
050,19,101,"Iowa","Jefferson County",2,45,185,98,87
050,19,101,"Iowa","Jefferson County",2,46,156,84,72
050,19,101,"Iowa","Jefferson County",2,47,156,83,73
050,19,101,"Iowa","Jefferson County",2,48,163,82,81
050,19,101,"Iowa","Jefferson County",2,49,194,105,89
050,19,101,"Iowa","Jefferson County",2,50,185,91,94
050,19,101,"Iowa","Jefferson County",2,51,165,77,88
050,19,101,"Iowa","Jefferson County",2,52,155,73,82
050,19,101,"Iowa","Jefferson County",2,53,151,66,85
050,19,101,"Iowa","Jefferson County",2,54,158,79,79
050,19,101,"Iowa","Jefferson County",2,55,174,80,94
050,19,101,"Iowa","Jefferson County",2,56,189,91,98
050,19,101,"Iowa","Jefferson County",2,57,181,87,94
050,19,101,"Iowa","Jefferson County",2,58,198,96,102
050,19,101,"Iowa","Jefferson County",2,59,215,98,117
050,19,101,"Iowa","Jefferson County",2,60,213,101,112
050,19,101,"Iowa","Jefferson County",2,61,216,111,105
050,19,101,"Iowa","Jefferson County",2,62,243,117,126
050,19,101,"Iowa","Jefferson County",2,63,250,120,130
050,19,101,"Iowa","Jefferson County",2,64,261,131,130
050,19,101,"Iowa","Jefferson County",2,65,296,151,145
050,19,101,"Iowa","Jefferson County",2,66,296,158,138
050,19,101,"Iowa","Jefferson County",2,67,286,151,135
050,19,101,"Iowa","Jefferson County",2,68,308,162,146
050,19,101,"Iowa","Jefferson County",2,69,299,153,146
050,19,101,"Iowa","Jefferson County",2,70,280,145,135
050,19,101,"Iowa","Jefferson County",2,71,265,133,132
050,19,101,"Iowa","Jefferson County",2,72,255,124,131
050,19,101,"Iowa","Jefferson County",2,73,247,121,126
050,19,101,"Iowa","Jefferson County",2,74,158,79,79
050,19,101,"Iowa","Jefferson County",2,75,140,67,73
050,19,101,"Iowa","Jefferson County",2,76,123,54,69
050,19,101,"Iowa","Jefferson County",2,77,129,56,73
050,19,101,"Iowa","Jefferson County",2,78,96,44,52
050,19,101,"Iowa","Jefferson County",2,79,74,39,35
050,19,101,"Iowa","Jefferson County",2,80,83,42,41
050,19,101,"Iowa","Jefferson County",2,81,77,33,44
050,19,101,"Iowa","Jefferson County",2,82,68,23,45
050,19,101,"Iowa","Jefferson County",2,83,61,24,37
050,19,101,"Iowa","Jefferson County",2,84,51,21,30
050,19,101,"Iowa","Jefferson County",2,85,451,157,294
050,19,101,"Iowa","Jefferson County",3,0,150,70,80
050,19,101,"Iowa","Jefferson County",3,1,136,69,67
050,19,101,"Iowa","Jefferson County",3,2,126,61,65
050,19,101,"Iowa","Jefferson County",3,3,139,72,67
050,19,101,"Iowa","Jefferson County",3,4,145,78,67
050,19,101,"Iowa","Jefferson County",3,5,167,88,79
050,19,101,"Iowa","Jefferson County",3,6,167,78,89
050,19,101,"Iowa","Jefferson County",3,7,144,78,66
050,19,101,"Iowa","Jefferson County",3,8,136,75,61
050,19,101,"Iowa","Jefferson County",3,9,135,72,63
050,19,101,"Iowa","Jefferson County",3,10,144,75,69
050,19,101,"Iowa","Jefferson County",3,11,146,75,71
050,19,101,"Iowa","Jefferson County",3,12,144,68,76
050,19,101,"Iowa","Jefferson County",3,13,161,74,87
050,19,101,"Iowa","Jefferson County",3,14,151,79,72
050,19,101,"Iowa","Jefferson County",3,15,160,87,73
050,19,101,"Iowa","Jefferson County",3,16,155,73,82
050,19,101,"Iowa","Jefferson County",3,17,143,76,67
050,19,101,"Iowa","Jefferson County",3,18,155,87,68
050,19,101,"Iowa","Jefferson County",3,19,116,61,55
050,19,101,"Iowa","Jefferson County",3,20,143,80,63
050,19,101,"Iowa","Jefferson County",3,21,206,148,58
050,19,101,"Iowa","Jefferson County",3,22,253,171,82
050,19,101,"Iowa","Jefferson County",3,23,227,146,81
050,19,101,"Iowa","Jefferson County",3,24,234,156,78
050,19,101,"Iowa","Jefferson County",3,25,188,121,67
050,19,101,"Iowa","Jefferson County",3,26,207,123,84
050,19,101,"Iowa","Jefferson County",3,27,218,142,76
050,19,101,"Iowa","Jefferson County",3,28,230,139,91
050,19,101,"Iowa","Jefferson County",3,29,234,150,84
050,19,101,"Iowa","Jefferson County",3,30,218,128,90
050,19,101,"Iowa","Jefferson County",3,31,202,127,75
050,19,101,"Iowa","Jefferson County",3,32,205,106,99
050,19,101,"Iowa","Jefferson County",3,33,181,90,91
050,19,101,"Iowa","Jefferson County",3,34,181,103,78
050,19,101,"Iowa","Jefferson County",3,35,194,109,85
050,19,101,"Iowa","Jefferson County",3,36,197,117,80
050,19,101,"Iowa","Jefferson County",3,37,182,109,73
050,19,101,"Iowa","Jefferson County",3,38,188,107,81
050,19,101,"Iowa","Jefferson County",3,39,186,87,99
050,19,101,"Iowa","Jefferson County",3,40,180,81,99
050,19,101,"Iowa","Jefferson County",3,41,201,104,97
050,19,101,"Iowa","Jefferson County",3,42,182,100,82
050,19,101,"Iowa","Jefferson County",3,43,164,78,86
050,19,101,"Iowa","Jefferson County",3,44,168,92,76
050,19,101,"Iowa","Jefferson County",3,45,179,92,87
050,19,101,"Iowa","Jefferson County",3,46,180,91,89
050,19,101,"Iowa","Jefferson County",3,47,153,76,77
050,19,101,"Iowa","Jefferson County",3,48,154,84,70
050,19,101,"Iowa","Jefferson County",3,49,171,85,86
050,19,101,"Iowa","Jefferson County",3,50,197,108,89
050,19,101,"Iowa","Jefferson County",3,51,186,93,93
050,19,101,"Iowa","Jefferson County",3,52,167,84,83
050,19,101,"Iowa","Jefferson County",3,53,162,79,83
050,19,101,"Iowa","Jefferson County",3,54,158,67,91
050,19,101,"Iowa","Jefferson County",3,55,158,76,82
050,19,101,"Iowa","Jefferson County",3,56,173,78,95
050,19,101,"Iowa","Jefferson County",3,57,189,89,100
050,19,101,"Iowa","Jefferson County",3,58,185,91,94
050,19,101,"Iowa","Jefferson County",3,59,200,101,99
050,19,101,"Iowa","Jefferson County",3,60,211,98,113
050,19,101,"Iowa","Jefferson County",3,61,220,102,118
050,19,101,"Iowa","Jefferson County",3,62,227,110,117
050,19,101,"Iowa","Jefferson County",3,63,237,117,120
050,19,101,"Iowa","Jefferson County",3,64,253,123,130
050,19,101,"Iowa","Jefferson County",3,65,261,136,125
050,19,101,"Iowa","Jefferson County",3,66,292,149,143
050,19,101,"Iowa","Jefferson County",3,67,304,162,142
050,19,101,"Iowa","Jefferson County",3,68,274,142,132
050,19,101,"Iowa","Jefferson County",3,69,300,158,142
050,19,101,"Iowa","Jefferson County",3,70,288,146,142
050,19,101,"Iowa","Jefferson County",3,71,273,139,134
050,19,101,"Iowa","Jefferson County",3,72,262,133,129
050,19,101,"Iowa","Jefferson County",3,73,247,125,122
050,19,101,"Iowa","Jefferson County",3,74,232,113,119
050,19,101,"Iowa","Jefferson County",3,75,158,80,78
050,19,101,"Iowa","Jefferson County",3,76,135,63,72
050,19,101,"Iowa","Jefferson County",3,77,112,47,65
050,19,101,"Iowa","Jefferson County",3,78,125,51,74
050,19,101,"Iowa","Jefferson County",3,79,84,39,45
050,19,101,"Iowa","Jefferson County",3,80,77,39,38
050,19,101,"Iowa","Jefferson County",3,81,77,38,39
050,19,101,"Iowa","Jefferson County",3,82,70,30,40
050,19,101,"Iowa","Jefferson County",3,83,63,20,43
050,19,101,"Iowa","Jefferson County",3,84,55,19,36
050,19,101,"Iowa","Jefferson County",3,85,443,154,289
050,19,101,"Iowa","Jefferson County",4,0,139,75,64
050,19,101,"Iowa","Jefferson County",4,1,140,63,77
050,19,101,"Iowa","Jefferson County",4,2,131,71,60
050,19,101,"Iowa","Jefferson County",4,3,126,61,65
050,19,101,"Iowa","Jefferson County",4,4,132,69,63
050,19,101,"Iowa","Jefferson County",4,5,141,74,67
050,19,101,"Iowa","Jefferson County",4,6,174,85,89
050,19,101,"Iowa","Jefferson County",4,7,171,79,92
050,19,101,"Iowa","Jefferson County",4,8,142,75,67
050,19,101,"Iowa","Jefferson County",4,9,136,77,59
050,19,101,"Iowa","Jefferson County",4,10,143,75,68
050,19,101,"Iowa","Jefferson County",4,11,145,75,70
050,19,101,"Iowa","Jefferson County",4,12,141,74,67
050,19,101,"Iowa","Jefferson County",4,13,148,68,80
050,19,101,"Iowa","Jefferson County",4,14,155,71,84
050,19,101,"Iowa","Jefferson County",4,15,143,80,63
050,19,101,"Iowa","Jefferson County",4,16,163,86,77
050,19,101,"Iowa","Jefferson County",4,17,149,69,80
050,19,101,"Iowa","Jefferson County",4,18,122,74,48
050,19,101,"Iowa","Jefferson County",4,19,121,71,50
050,19,101,"Iowa","Jefferson County",4,20,134,77,57
050,19,101,"Iowa","Jefferson County",4,21,221,157,64
050,19,101,"Iowa","Jefferson County",4,22,212,145,67
050,19,101,"Iowa","Jefferson County",4,23,234,153,81
050,19,101,"Iowa","Jefferson County",4,24,192,113,79
050,19,101,"Iowa","Jefferson County",4,25,213,142,71
050,19,101,"Iowa","Jefferson County",4,26,194,125,69
050,19,101,"Iowa","Jefferson County",4,27,215,128,87
050,19,101,"Iowa","Jefferson County",4,28,198,119,79
050,19,101,"Iowa","Jefferson County",4,29,213,119,94
050,19,101,"Iowa","Jefferson County",4,30,234,143,91
050,19,101,"Iowa","Jefferson County",4,31,224,142,82
050,19,101,"Iowa","Jefferson County",4,32,194,129,65
050,19,101,"Iowa","Jefferson County",4,33,218,116,102
050,19,101,"Iowa","Jefferson County",4,34,191,88,103
050,19,101,"Iowa","Jefferson County",4,35,174,103,71
050,19,101,"Iowa","Jefferson County",4,36,182,102,80
050,19,101,"Iowa","Jefferson County",4,37,198,113,85
050,19,101,"Iowa","Jefferson County",4,38,185,113,72
050,19,101,"Iowa","Jefferson County",4,39,178,99,79
050,19,101,"Iowa","Jefferson County",4,40,192,86,106
050,19,101,"Iowa","Jefferson County",4,41,175,72,103
050,19,101,"Iowa","Jefferson County",4,42,194,100,94
050,19,101,"Iowa","Jefferson County",4,43,177,95,82
050,19,101,"Iowa","Jefferson County",4,44,167,81,86
050,19,101,"Iowa","Jefferson County",4,45,159,84,75
050,19,101,"Iowa","Jefferson County",4,46,183,95,88
050,19,101,"Iowa","Jefferson County",4,47,184,92,92
050,19,101,"Iowa","Jefferson County",4,48,157,79,78
050,19,101,"Iowa","Jefferson County",4,49,159,88,71
050,19,101,"Iowa","Jefferson County",4,50,174,85,89
050,19,101,"Iowa","Jefferson County",4,51,190,109,81
050,19,101,"Iowa","Jefferson County",4,52,180,90,90
050,19,101,"Iowa","Jefferson County",4,53,172,88,84
050,19,101,"Iowa","Jefferson County",4,54,167,81,86
050,19,101,"Iowa","Jefferson County",4,55,151,64,87
050,19,101,"Iowa","Jefferson County",4,56,166,80,86
050,19,101,"Iowa","Jefferson County",4,57,166,74,92
050,19,101,"Iowa","Jefferson County",4,58,190,91,99
050,19,101,"Iowa","Jefferson County",4,59,186,89,97
050,19,101,"Iowa","Jefferson County",4,60,199,101,98
050,19,101,"Iowa","Jefferson County",4,61,209,93,116
050,19,101,"Iowa","Jefferson County",4,62,232,102,130
050,19,101,"Iowa","Jefferson County",4,63,227,109,118
050,19,101,"Iowa","Jefferson County",4,64,230,112,118
050,19,101,"Iowa","Jefferson County",4,65,242,115,127
050,19,101,"Iowa","Jefferson County",4,66,251,130,121
050,19,101,"Iowa","Jefferson County",4,67,282,149,133
050,19,101,"Iowa","Jefferson County",4,68,291,155,136
050,19,101,"Iowa","Jefferson County",4,69,260,132,128
050,19,101,"Iowa","Jefferson County",4,70,297,161,136
050,19,101,"Iowa","Jefferson County",4,71,291,146,145
050,19,101,"Iowa","Jefferson County",4,72,274,136,138
050,19,101,"Iowa","Jefferson County",4,73,251,127,124
050,19,101,"Iowa","Jefferson County",4,74,245,123,122
050,19,101,"Iowa","Jefferson County",4,75,230,117,113
050,19,101,"Iowa","Jefferson County",4,76,156,80,76
050,19,101,"Iowa","Jefferson County",4,77,125,56,69
050,19,101,"Iowa","Jefferson County",4,78,116,45,71
050,19,101,"Iowa","Jefferson County",4,79,117,51,66
050,19,101,"Iowa","Jefferson County",4,80,82,37,45
050,19,101,"Iowa","Jefferson County",4,81,68,35,33
050,19,101,"Iowa","Jefferson County",4,82,70,35,35
050,19,101,"Iowa","Jefferson County",4,83,70,31,39
050,19,101,"Iowa","Jefferson County",4,84,64,17,47
050,19,101,"Iowa","Jefferson County",4,85,434,144,290
050,19,101,"Iowa","Jefferson County",5,0,143,77,66
050,19,101,"Iowa","Jefferson County",5,1,122,67,55
050,19,101,"Iowa","Jefferson County",5,2,135,65,70
050,19,101,"Iowa","Jefferson County",5,3,130,69,61
050,19,101,"Iowa","Jefferson County",5,4,121,54,67
050,19,101,"Iowa","Jefferson County",5,5,129,67,62
050,19,101,"Iowa","Jefferson County",5,6,145,78,67
050,19,101,"Iowa","Jefferson County",5,7,168,86,82
050,19,101,"Iowa","Jefferson County",5,8,163,78,85
050,19,101,"Iowa","Jefferson County",5,9,137,74,63
050,19,101,"Iowa","Jefferson County",5,10,141,78,63
050,19,101,"Iowa","Jefferson County",5,11,136,70,66
050,19,101,"Iowa","Jefferson County",5,12,139,77,62
050,19,101,"Iowa","Jefferson County",5,13,143,73,70
050,19,101,"Iowa","Jefferson County",5,14,149,67,82
050,19,101,"Iowa","Jefferson County",5,15,147,73,74
050,19,101,"Iowa","Jefferson County",5,16,143,82,61
050,19,101,"Iowa","Jefferson County",5,17,158,84,74
050,19,101,"Iowa","Jefferson County",5,18,124,60,64
050,19,101,"Iowa","Jefferson County",5,19,102,60,42
050,19,101,"Iowa","Jefferson County",5,20,129,76,53
050,19,101,"Iowa","Jefferson County",5,21,216,154,62
050,19,101,"Iowa","Jefferson County",5,22,226,155,71
050,19,101,"Iowa","Jefferson County",5,23,197,117,80
050,19,101,"Iowa","Jefferson County",5,24,200,122,78
050,19,101,"Iowa","Jefferson County",5,25,192,116,76
050,19,101,"Iowa","Jefferson County",5,26,187,123,64
050,19,101,"Iowa","Jefferson County",5,27,203,138,65
050,19,101,"Iowa","Jefferson County",5,28,197,108,89
050,19,101,"Iowa","Jefferson County",5,29,185,111,74
050,19,101,"Iowa","Jefferson County",5,30,205,111,94
050,19,101,"Iowa","Jefferson County",5,31,224,137,87
050,19,101,"Iowa","Jefferson County",5,32,214,130,84
050,19,101,"Iowa","Jefferson County",5,33,201,122,79
050,19,101,"Iowa","Jefferson County",5,34,207,102,105
050,19,101,"Iowa","Jefferson County",5,35,201,93,108
050,19,101,"Iowa","Jefferson County",5,36,158,96,62
050,19,101,"Iowa","Jefferson County",5,37,165,89,76
050,19,101,"Iowa","Jefferson County",5,38,194,113,81
050,19,101,"Iowa","Jefferson County",5,39,186,113,73
050,19,101,"Iowa","Jefferson County",5,40,174,94,80
050,19,101,"Iowa","Jefferson County",5,41,186,81,105
050,19,101,"Iowa","Jefferson County",5,42,172,74,98
050,19,101,"Iowa","Jefferson County",5,43,196,105,91
050,19,101,"Iowa","Jefferson County",5,44,178,93,85
050,19,101,"Iowa","Jefferson County",5,45,162,83,79
050,19,101,"Iowa","Jefferson County",5,46,163,85,78
050,19,101,"Iowa","Jefferson County",5,47,175,89,86
050,19,101,"Iowa","Jefferson County",5,48,177,92,85
050,19,101,"Iowa","Jefferson County",5,49,156,78,78
050,19,101,"Iowa","Jefferson County",5,50,156,88,68
050,19,101,"Iowa","Jefferson County",5,51,175,90,85
050,19,101,"Iowa","Jefferson County",5,52,184,104,80
050,19,101,"Iowa","Jefferson County",5,53,180,90,90
050,19,101,"Iowa","Jefferson County",5,54,179,93,86
050,19,101,"Iowa","Jefferson County",5,55,157,77,80
050,19,101,"Iowa","Jefferson County",5,56,146,59,87
050,19,101,"Iowa","Jefferson County",5,57,164,76,88
050,19,101,"Iowa","Jefferson County",5,58,166,74,92
050,19,101,"Iowa","Jefferson County",5,59,196,92,104
050,19,101,"Iowa","Jefferson County",5,60,184,87,97
050,19,101,"Iowa","Jefferson County",5,61,196,97,99
050,19,101,"Iowa","Jefferson County",5,62,213,89,124
050,19,101,"Iowa","Jefferson County",5,63,217,94,123
050,19,101,"Iowa","Jefferson County",5,64,221,108,113
050,19,101,"Iowa","Jefferson County",5,65,227,111,116
050,19,101,"Iowa","Jefferson County",5,66,236,111,125
050,19,101,"Iowa","Jefferson County",5,67,252,135,117
050,19,101,"Iowa","Jefferson County",5,68,277,142,135
050,19,101,"Iowa","Jefferson County",5,69,285,150,135
050,19,101,"Iowa","Jefferson County",5,70,256,132,124
050,19,101,"Iowa","Jefferson County",5,71,295,157,138
050,19,101,"Iowa","Jefferson County",5,72,285,144,141
050,19,101,"Iowa","Jefferson County",5,73,256,129,127
050,19,101,"Iowa","Jefferson County",5,74,247,125,122
050,19,101,"Iowa","Jefferson County",5,75,249,127,122
050,19,101,"Iowa","Jefferson County",5,76,228,114,114
050,19,101,"Iowa","Jefferson County",5,77,151,78,73
050,19,101,"Iowa","Jefferson County",5,78,124,53,71
050,19,101,"Iowa","Jefferson County",5,79,107,47,60
050,19,101,"Iowa","Jefferson County",5,80,119,52,67
050,19,101,"Iowa","Jefferson County",5,81,78,35,43
050,19,101,"Iowa","Jefferson County",5,82,60,31,29
050,19,101,"Iowa","Jefferson County",5,83,70,35,35
050,19,101,"Iowa","Jefferson County",5,84,66,26,40
050,19,101,"Iowa","Jefferson County",5,85,437,139,298
050,19,103,"Iowa","Johnson County",1,0,1691,875,816
050,19,103,"Iowa","Johnson County",1,1,1710,903,807
050,19,103,"Iowa","Johnson County",1,2,1698,852,846
050,19,103,"Iowa","Johnson County",1,3,1691,824,867
050,19,103,"Iowa","Johnson County",1,4,1756,917,839
050,19,103,"Iowa","Johnson County",1,5,1773,927,846
050,19,103,"Iowa","Johnson County",1,6,1653,865,788
050,19,103,"Iowa","Johnson County",1,7,1695,841,854
050,19,103,"Iowa","Johnson County",1,8,1684,868,816
050,19,103,"Iowa","Johnson County",1,9,1693,880,813
050,19,103,"Iowa","Johnson County",1,10,1704,899,805
050,19,103,"Iowa","Johnson County",1,11,1690,868,822
050,19,103,"Iowa","Johnson County",1,12,1718,867,851
050,19,103,"Iowa","Johnson County",1,13,1703,860,843
050,19,103,"Iowa","Johnson County",1,14,1616,811,805
050,19,103,"Iowa","Johnson County",1,15,1601,813,788
050,19,103,"Iowa","Johnson County",1,16,1666,860,806
050,19,103,"Iowa","Johnson County",1,17,1653,830,823
050,19,103,"Iowa","Johnson County",1,18,3108,1391,1717
050,19,103,"Iowa","Johnson County",1,19,5535,2593,2942
050,19,103,"Iowa","Johnson County",1,20,5420,2647,2773
050,19,103,"Iowa","Johnson County",1,21,5372,2465,2907
050,19,103,"Iowa","Johnson County",1,22,5247,2583,2664
050,19,103,"Iowa","Johnson County",1,23,3991,1923,2068
050,19,103,"Iowa","Johnson County",1,24,3369,1754,1615
050,19,103,"Iowa","Johnson County",1,25,3023,1588,1435
050,19,103,"Iowa","Johnson County",1,26,2692,1395,1297
050,19,103,"Iowa","Johnson County",1,27,2395,1209,1186
050,19,103,"Iowa","Johnson County",1,28,2247,1152,1095
050,19,103,"Iowa","Johnson County",1,29,2240,1177,1063
050,19,103,"Iowa","Johnson County",1,30,2171,1116,1055
050,19,103,"Iowa","Johnson County",1,31,2105,1058,1047
050,19,103,"Iowa","Johnson County",1,32,2080,1098,982
050,19,103,"Iowa","Johnson County",1,33,1980,1070,910
050,19,103,"Iowa","Johnson County",1,34,1958,1001,957
050,19,103,"Iowa","Johnson County",1,35,1995,1036,959
050,19,103,"Iowa","Johnson County",1,36,2015,1041,974
050,19,103,"Iowa","Johnson County",1,37,2019,1026,993
050,19,103,"Iowa","Johnson County",1,38,2046,1048,998
050,19,103,"Iowa","Johnson County",1,39,1954,1009,945
050,19,103,"Iowa","Johnson County",1,40,1934,989,945
050,19,103,"Iowa","Johnson County",1,41,1786,945,841
050,19,103,"Iowa","Johnson County",1,42,1752,924,828
050,19,103,"Iowa","Johnson County",1,43,1674,877,797
050,19,103,"Iowa","Johnson County",1,44,1571,830,741
050,19,103,"Iowa","Johnson County",1,45,1536,810,726
050,19,103,"Iowa","Johnson County",1,46,1422,742,680
050,19,103,"Iowa","Johnson County",1,47,1418,752,666
050,19,103,"Iowa","Johnson County",1,48,1563,809,754
050,19,103,"Iowa","Johnson County",1,49,1632,814,818
050,19,103,"Iowa","Johnson County",1,50,1584,809,775
050,19,103,"Iowa","Johnson County",1,51,1526,806,720
050,19,103,"Iowa","Johnson County",1,52,1453,754,699
050,19,103,"Iowa","Johnson County",1,53,1455,726,729
050,19,103,"Iowa","Johnson County",1,54,1392,674,718
050,19,103,"Iowa","Johnson County",1,55,1535,761,774
050,19,103,"Iowa","Johnson County",1,56,1522,768,754
050,19,103,"Iowa","Johnson County",1,57,1436,729,707
050,19,103,"Iowa","Johnson County",1,58,1456,718,738
050,19,103,"Iowa","Johnson County",1,59,1509,740,769
050,19,103,"Iowa","Johnson County",1,60,1560,752,808
050,19,103,"Iowa","Johnson County",1,61,1499,707,792
050,19,103,"Iowa","Johnson County",1,62,1495,729,766
050,19,103,"Iowa","Johnson County",1,63,1441,711,730
050,19,103,"Iowa","Johnson County",1,64,1450,686,764
050,19,103,"Iowa","Johnson County",1,65,1415,693,722
050,19,103,"Iowa","Johnson County",1,66,1357,641,716
050,19,103,"Iowa","Johnson County",1,67,1366,633,733
050,19,103,"Iowa","Johnson County",1,68,1378,651,727
050,19,103,"Iowa","Johnson County",1,69,1203,573,630
050,19,103,"Iowa","Johnson County",1,70,1167,556,611
050,19,103,"Iowa","Johnson County",1,71,1060,512,548
050,19,103,"Iowa","Johnson County",1,72,1065,497,568
050,19,103,"Iowa","Johnson County",1,73,1074,509,565
050,19,103,"Iowa","Johnson County",1,74,712,348,364
050,19,103,"Iowa","Johnson County",1,75,646,311,335
050,19,103,"Iowa","Johnson County",1,76,659,309,350
050,19,103,"Iowa","Johnson County",1,77,629,290,339
050,19,103,"Iowa","Johnson County",1,78,559,255,304
050,19,103,"Iowa","Johnson County",1,79,515,225,290
050,19,103,"Iowa","Johnson County",1,80,447,185,262
050,19,103,"Iowa","Johnson County",1,81,415,173,242
050,19,103,"Iowa","Johnson County",1,82,365,158,207
050,19,103,"Iowa","Johnson County",1,83,326,141,185
050,19,103,"Iowa","Johnson County",1,84,326,126,200
050,19,103,"Iowa","Johnson County",1,85,2220,740,1480
050,19,103,"Iowa","Johnson County",2,0,1659,849,810
050,19,103,"Iowa","Johnson County",2,1,1698,889,809
050,19,103,"Iowa","Johnson County",2,2,1696,859,837
050,19,103,"Iowa","Johnson County",2,3,1681,826,855
050,19,103,"Iowa","Johnson County",2,4,1736,894,842
050,19,103,"Iowa","Johnson County",2,5,1759,922,837
050,19,103,"Iowa","Johnson County",2,6,1683,887,796
050,19,103,"Iowa","Johnson County",2,7,1679,847,832
050,19,103,"Iowa","Johnson County",2,8,1683,865,818
050,19,103,"Iowa","Johnson County",2,9,1686,877,809
050,19,103,"Iowa","Johnson County",2,10,1703,895,808
050,19,103,"Iowa","Johnson County",2,11,1689,871,818
050,19,103,"Iowa","Johnson County",2,12,1715,869,846
050,19,103,"Iowa","Johnson County",2,13,1703,862,841
050,19,103,"Iowa","Johnson County",2,14,1634,823,811
050,19,103,"Iowa","Johnson County",2,15,1611,815,796
050,19,103,"Iowa","Johnson County",2,16,1656,851,805
050,19,103,"Iowa","Johnson County",2,17,1663,838,825
050,19,103,"Iowa","Johnson County",2,18,3108,1389,1719
050,19,103,"Iowa","Johnson County",2,19,5528,2598,2930
050,19,103,"Iowa","Johnson County",2,20,5451,2655,2796
050,19,103,"Iowa","Johnson County",2,21,5325,2444,2881
050,19,103,"Iowa","Johnson County",2,22,5218,2584,2634
050,19,103,"Iowa","Johnson County",2,23,4017,1927,2090
050,19,103,"Iowa","Johnson County",2,24,3375,1745,1630
050,19,103,"Iowa","Johnson County",2,25,2991,1570,1421
050,19,103,"Iowa","Johnson County",2,26,2718,1420,1298
050,19,103,"Iowa","Johnson County",2,27,2374,1196,1178
050,19,103,"Iowa","Johnson County",2,28,2263,1157,1106
050,19,103,"Iowa","Johnson County",2,29,2222,1162,1060
050,19,103,"Iowa","Johnson County",2,30,2184,1130,1054
050,19,103,"Iowa","Johnson County",2,31,2108,1066,1042
050,19,103,"Iowa","Johnson County",2,32,2072,1081,991
050,19,103,"Iowa","Johnson County",2,33,1987,1064,923
050,19,103,"Iowa","Johnson County",2,34,1955,1012,943
050,19,103,"Iowa","Johnson County",2,35,1990,1030,960
050,19,103,"Iowa","Johnson County",2,36,1981,1023,958
050,19,103,"Iowa","Johnson County",2,37,2013,1021,992
050,19,103,"Iowa","Johnson County",2,38,2034,1040,994
050,19,103,"Iowa","Johnson County",2,39,1969,1014,955
050,19,103,"Iowa","Johnson County",2,40,1943,996,947
050,19,103,"Iowa","Johnson County",2,41,1813,951,862
050,19,103,"Iowa","Johnson County",2,42,1754,928,826
050,19,103,"Iowa","Johnson County",2,43,1696,888,808
050,19,103,"Iowa","Johnson County",2,44,1583,835,748
050,19,103,"Iowa","Johnson County",2,45,1551,821,730
050,19,103,"Iowa","Johnson County",2,46,1444,754,690
050,19,103,"Iowa","Johnson County",2,47,1419,748,671
050,19,103,"Iowa","Johnson County",2,48,1529,793,736
050,19,103,"Iowa","Johnson County",2,49,1620,816,804
050,19,103,"Iowa","Johnson County",2,50,1602,813,789
050,19,103,"Iowa","Johnson County",2,51,1532,803,729
050,19,103,"Iowa","Johnson County",2,52,1459,757,702
050,19,103,"Iowa","Johnson County",2,53,1455,736,719
050,19,103,"Iowa","Johnson County",2,54,1396,680,716
050,19,103,"Iowa","Johnson County",2,55,1505,744,761
050,19,103,"Iowa","Johnson County",2,56,1530,767,763
050,19,103,"Iowa","Johnson County",2,57,1456,736,720
050,19,103,"Iowa","Johnson County",2,58,1447,720,727
050,19,103,"Iowa","Johnson County",2,59,1508,742,766
050,19,103,"Iowa","Johnson County",2,60,1545,745,800
050,19,103,"Iowa","Johnson County",2,61,1512,715,797
050,19,103,"Iowa","Johnson County",2,62,1486,719,767
050,19,103,"Iowa","Johnson County",2,63,1468,725,743
050,19,103,"Iowa","Johnson County",2,64,1438,684,754
050,19,103,"Iowa","Johnson County",2,65,1417,687,730
050,19,103,"Iowa","Johnson County",2,66,1369,654,715
050,19,103,"Iowa","Johnson County",2,67,1357,630,727
050,19,103,"Iowa","Johnson County",2,68,1367,644,723
050,19,103,"Iowa","Johnson County",2,69,1252,596,656
050,19,103,"Iowa","Johnson County",2,70,1169,557,612
050,19,103,"Iowa","Johnson County",2,71,1089,524,565
050,19,103,"Iowa","Johnson County",2,72,1050,493,557
050,19,103,"Iowa","Johnson County",2,73,1125,530,595
050,19,103,"Iowa","Johnson County",2,74,748,361,387
050,19,103,"Iowa","Johnson County",2,75,662,316,346
050,19,103,"Iowa","Johnson County",2,76,655,308,347
050,19,103,"Iowa","Johnson County",2,77,652,302,350
050,19,103,"Iowa","Johnson County",2,78,569,262,307
050,19,103,"Iowa","Johnson County",2,79,521,231,290
050,19,103,"Iowa","Johnson County",2,80,460,191,269
050,19,103,"Iowa","Johnson County",2,81,414,171,243
050,19,103,"Iowa","Johnson County",2,82,376,162,214
050,19,103,"Iowa","Johnson County",2,83,331,144,187
050,19,103,"Iowa","Johnson County",2,84,324,131,193
050,19,103,"Iowa","Johnson County",2,85,2241,749,1492
050,19,103,"Iowa","Johnson County",3,0,1633,833,800
050,19,103,"Iowa","Johnson County",3,1,1644,874,770
050,19,103,"Iowa","Johnson County",3,2,1710,915,795
050,19,103,"Iowa","Johnson County",3,3,1666,832,834
050,19,103,"Iowa","Johnson County",3,4,1685,829,856
050,19,103,"Iowa","Johnson County",3,5,1732,893,839
050,19,103,"Iowa","Johnson County",3,6,1754,920,834
050,19,103,"Iowa","Johnson County",3,7,1680,875,805
050,19,103,"Iowa","Johnson County",3,8,1657,828,829
050,19,103,"Iowa","Johnson County",3,9,1675,856,819
050,19,103,"Iowa","Johnson County",3,10,1713,883,830
050,19,103,"Iowa","Johnson County",3,11,1697,881,816
050,19,103,"Iowa","Johnson County",3,12,1674,857,817
050,19,103,"Iowa","Johnson County",3,13,1722,877,845
050,19,103,"Iowa","Johnson County",3,14,1718,865,853
050,19,103,"Iowa","Johnson County",3,15,1656,838,818
050,19,103,"Iowa","Johnson County",3,16,1633,826,807
050,19,103,"Iowa","Johnson County",3,17,1707,869,838
050,19,103,"Iowa","Johnson County",3,18,3138,1408,1730
050,19,103,"Iowa","Johnson County",3,19,5513,2607,2906
050,19,103,"Iowa","Johnson County",3,20,5449,2638,2811
050,19,103,"Iowa","Johnson County",3,21,5331,2449,2882
050,19,103,"Iowa","Johnson County",3,22,5262,2624,2638
050,19,103,"Iowa","Johnson County",3,23,4145,1966,2179
050,19,103,"Iowa","Johnson County",3,24,3462,1743,1719
050,19,103,"Iowa","Johnson County",3,25,3002,1540,1462
050,19,103,"Iowa","Johnson County",3,26,2775,1467,1308
050,19,103,"Iowa","Johnson County",3,27,2471,1291,1180
050,19,103,"Iowa","Johnson County",3,28,2318,1174,1144
050,19,103,"Iowa","Johnson County",3,29,2168,1126,1042
050,19,103,"Iowa","Johnson County",3,30,2157,1126,1031
050,19,103,"Iowa","Johnson County",3,31,2077,1061,1016
050,19,103,"Iowa","Johnson County",3,32,2102,1053,1049
050,19,103,"Iowa","Johnson County",3,33,2034,1059,975
050,19,103,"Iowa","Johnson County",3,34,1977,1035,942
050,19,103,"Iowa","Johnson County",3,35,1979,1030,949
050,19,103,"Iowa","Johnson County",3,36,1978,1033,945
050,19,103,"Iowa","Johnson County",3,37,1977,994,983
050,19,103,"Iowa","Johnson County",3,38,1983,989,994
050,19,103,"Iowa","Johnson County",3,39,2035,1044,991
050,19,103,"Iowa","Johnson County",3,40,2022,1033,989
050,19,103,"Iowa","Johnson County",3,41,1921,978,943
050,19,103,"Iowa","Johnson County",3,42,1838,969,869
050,19,103,"Iowa","Johnson County",3,43,1735,898,837
050,19,103,"Iowa","Johnson County",3,44,1753,922,831
050,19,103,"Iowa","Johnson County",3,45,1613,856,757
050,19,103,"Iowa","Johnson County",3,46,1575,834,741
050,19,103,"Iowa","Johnson County",3,47,1447,765,682
050,19,103,"Iowa","Johnson County",3,48,1428,754,674
050,19,103,"Iowa","Johnson County",3,49,1532,790,742
050,19,103,"Iowa","Johnson County",3,50,1649,827,822
050,19,103,"Iowa","Johnson County",3,51,1602,811,791
050,19,103,"Iowa","Johnson County",3,52,1524,783,741
050,19,103,"Iowa","Johnson County",3,53,1467,761,706
050,19,103,"Iowa","Johnson County",3,54,1432,726,706
050,19,103,"Iowa","Johnson County",3,55,1407,682,725
050,19,103,"Iowa","Johnson County",3,56,1517,745,772
050,19,103,"Iowa","Johnson County",3,57,1522,754,768
050,19,103,"Iowa","Johnson County",3,58,1443,729,714
050,19,103,"Iowa","Johnson County",3,59,1462,713,749
050,19,103,"Iowa","Johnson County",3,60,1493,728,765
050,19,103,"Iowa","Johnson County",3,61,1533,728,805
050,19,103,"Iowa","Johnson County",3,62,1501,705,796
050,19,103,"Iowa","Johnson County",3,63,1463,722,741
050,19,103,"Iowa","Johnson County",3,64,1441,700,741
050,19,103,"Iowa","Johnson County",3,65,1423,692,731
050,19,103,"Iowa","Johnson County",3,66,1407,680,727
050,19,103,"Iowa","Johnson County",3,67,1345,628,717
050,19,103,"Iowa","Johnson County",3,68,1341,628,713
050,19,103,"Iowa","Johnson County",3,69,1351,629,722
050,19,103,"Iowa","Johnson County",3,70,1231,576,655
050,19,103,"Iowa","Johnson County",3,71,1140,534,606
050,19,103,"Iowa","Johnson County",3,72,1074,502,572
050,19,103,"Iowa","Johnson County",3,73,1037,483,554
050,19,103,"Iowa","Johnson County",3,74,1086,505,581
050,19,103,"Iowa","Johnson County",3,75,741,356,385
050,19,103,"Iowa","Johnson County",3,76,660,304,356
050,19,103,"Iowa","Johnson County",3,77,640,296,344
050,19,103,"Iowa","Johnson County",3,78,650,301,349
050,19,103,"Iowa","Johnson County",3,79,557,249,308
050,19,103,"Iowa","Johnson County",3,80,514,221,293
050,19,103,"Iowa","Johnson County",3,81,439,181,258
050,19,103,"Iowa","Johnson County",3,82,393,169,224
050,19,103,"Iowa","Johnson County",3,83,379,165,214
050,19,103,"Iowa","Johnson County",3,84,309,128,181
050,19,103,"Iowa","Johnson County",3,85,2309,780,1529
050,19,103,"Iowa","Johnson County",4,0,1676,884,792
050,19,103,"Iowa","Johnson County",4,1,1588,810,778
050,19,103,"Iowa","Johnson County",4,2,1612,857,755
050,19,103,"Iowa","Johnson County",4,3,1693,903,790
050,19,103,"Iowa","Johnson County",4,4,1668,869,799
050,19,103,"Iowa","Johnson County",4,5,1673,818,855
050,19,103,"Iowa","Johnson County",4,6,1694,888,806
050,19,103,"Iowa","Johnson County",4,7,1750,921,829
050,19,103,"Iowa","Johnson County",4,8,1640,847,793
050,19,103,"Iowa","Johnson County",4,9,1675,834,841
050,19,103,"Iowa","Johnson County",4,10,1674,854,820
050,19,103,"Iowa","Johnson County",4,11,1719,878,841
050,19,103,"Iowa","Johnson County",4,12,1726,908,818
050,19,103,"Iowa","Johnson County",4,13,1680,868,812
050,19,103,"Iowa","Johnson County",4,14,1697,853,844
050,19,103,"Iowa","Johnson County",4,15,1720,872,848
050,19,103,"Iowa","Johnson County",4,16,1711,870,841
050,19,103,"Iowa","Johnson County",4,17,1673,852,821
050,19,103,"Iowa","Johnson County",4,18,3316,1496,1820
050,19,103,"Iowa","Johnson County",4,19,5805,2749,3056
050,19,103,"Iowa","Johnson County",4,20,5449,2650,2799
050,19,103,"Iowa","Johnson County",4,21,5417,2484,2933
050,19,103,"Iowa","Johnson County",4,22,5209,2578,2631
050,19,103,"Iowa","Johnson County",4,23,4171,2012,2159
050,19,103,"Iowa","Johnson County",4,24,3539,1767,1772
050,19,103,"Iowa","Johnson County",4,25,3096,1569,1527
050,19,103,"Iowa","Johnson County",4,26,2715,1415,1300
050,19,103,"Iowa","Johnson County",4,27,2415,1272,1143
050,19,103,"Iowa","Johnson County",4,28,2321,1222,1099
050,19,103,"Iowa","Johnson County",4,29,2288,1169,1119
050,19,103,"Iowa","Johnson County",4,30,2141,1122,1019
050,19,103,"Iowa","Johnson County",4,31,2079,1099,980
050,19,103,"Iowa","Johnson County",4,32,2051,1056,995
050,19,103,"Iowa","Johnson County",4,33,2057,995,1062
050,19,103,"Iowa","Johnson County",4,34,2012,1039,973
050,19,103,"Iowa","Johnson County",4,35,1963,1035,928
050,19,103,"Iowa","Johnson County",4,36,1949,1019,930
050,19,103,"Iowa","Johnson County",4,37,1939,994,945
050,19,103,"Iowa","Johnson County",4,38,1964,984,980
050,19,103,"Iowa","Johnson County",4,39,1941,983,958
050,19,103,"Iowa","Johnson County",4,40,2030,1043,987
050,19,103,"Iowa","Johnson County",4,41,1987,1016,971
050,19,103,"Iowa","Johnson County",4,42,1931,965,966
050,19,103,"Iowa","Johnson County",4,43,1833,927,906
050,19,103,"Iowa","Johnson County",4,44,1772,930,842
050,19,103,"Iowa","Johnson County",4,45,1779,950,829
050,19,103,"Iowa","Johnson County",4,46,1604,846,758
050,19,103,"Iowa","Johnson County",4,47,1578,836,742
050,19,103,"Iowa","Johnson County",4,48,1473,777,696
050,19,103,"Iowa","Johnson County",4,49,1472,772,700
050,19,103,"Iowa","Johnson County",4,50,1548,794,754
050,19,103,"Iowa","Johnson County",4,51,1604,803,801
050,19,103,"Iowa","Johnson County",4,52,1576,785,791
050,19,103,"Iowa","Johnson County",4,53,1547,799,748
050,19,103,"Iowa","Johnson County",4,54,1455,765,690
050,19,103,"Iowa","Johnson County",4,55,1454,747,707
050,19,103,"Iowa","Johnson County",4,56,1414,681,733
050,19,103,"Iowa","Johnson County",4,57,1488,717,771
050,19,103,"Iowa","Johnson County",4,58,1552,767,785
050,19,103,"Iowa","Johnson County",4,59,1470,739,731
050,19,103,"Iowa","Johnson County",4,60,1454,711,743
050,19,103,"Iowa","Johnson County",4,61,1478,715,763
050,19,103,"Iowa","Johnson County",4,62,1517,710,807
050,19,103,"Iowa","Johnson County",4,63,1514,732,782
050,19,103,"Iowa","Johnson County",4,64,1430,708,722
050,19,103,"Iowa","Johnson County",4,65,1443,701,742
050,19,103,"Iowa","Johnson County",4,66,1397,679,718
050,19,103,"Iowa","Johnson County",4,67,1377,661,716
050,19,103,"Iowa","Johnson County",4,68,1343,633,710
050,19,103,"Iowa","Johnson County",4,69,1320,611,709
050,19,103,"Iowa","Johnson County",4,70,1339,620,719
050,19,103,"Iowa","Johnson County",4,71,1201,558,643
050,19,103,"Iowa","Johnson County",4,72,1135,521,614
050,19,103,"Iowa","Johnson County",4,73,1064,488,576
050,19,103,"Iowa","Johnson County",4,74,996,462,534
050,19,103,"Iowa","Johnson County",4,75,1066,497,569
050,19,103,"Iowa","Johnson County",4,76,756,357,399
050,19,103,"Iowa","Johnson County",4,77,640,290,350
050,19,103,"Iowa","Johnson County",4,78,637,294,343
050,19,103,"Iowa","Johnson County",4,79,625,292,333
050,19,103,"Iowa","Johnson County",4,80,538,230,308
050,19,103,"Iowa","Johnson County",4,81,495,212,283
050,19,103,"Iowa","Johnson County",4,82,416,172,244
050,19,103,"Iowa","Johnson County",4,83,392,169,223
050,19,103,"Iowa","Johnson County",4,84,351,153,198
050,19,103,"Iowa","Johnson County",4,85,2318,788,1530
050,19,103,"Iowa","Johnson County",5,0,1684,886,798
050,19,103,"Iowa","Johnson County",5,1,1681,898,783
050,19,103,"Iowa","Johnson County",5,2,1534,767,767
050,19,103,"Iowa","Johnson County",5,3,1576,835,741
050,19,103,"Iowa","Johnson County",5,4,1686,917,769
050,19,103,"Iowa","Johnson County",5,5,1615,837,778
050,19,103,"Iowa","Johnson County",5,6,1690,819,871
050,19,103,"Iowa","Johnson County",5,7,1671,875,796
050,19,103,"Iowa","Johnson County",5,8,1723,908,815
050,19,103,"Iowa","Johnson County",5,9,1648,853,795
050,19,103,"Iowa","Johnson County",5,10,1682,829,853
050,19,103,"Iowa","Johnson County",5,11,1665,846,819
050,19,103,"Iowa","Johnson County",5,12,1727,866,861
050,19,103,"Iowa","Johnson County",5,13,1709,901,808
050,19,103,"Iowa","Johnson County",5,14,1665,854,811
050,19,103,"Iowa","Johnson County",5,15,1712,862,850
050,19,103,"Iowa","Johnson County",5,16,1746,892,854
050,19,103,"Iowa","Johnson County",5,17,1741,884,857
050,19,103,"Iowa","Johnson County",5,18,3246,1471,1775
050,19,103,"Iowa","Johnson County",5,19,5838,2772,3066
050,19,103,"Iowa","Johnson County",5,20,5453,2678,2775
050,19,103,"Iowa","Johnson County",5,21,5238,2393,2845
050,19,103,"Iowa","Johnson County",5,22,5251,2616,2635
050,19,103,"Iowa","Johnson County",5,23,4023,1921,2102
050,19,103,"Iowa","Johnson County",5,24,3569,1797,1772
050,19,103,"Iowa","Johnson County",5,25,3059,1529,1530
050,19,103,"Iowa","Johnson County",5,26,2843,1457,1386
050,19,103,"Iowa","Johnson County",5,27,2312,1207,1105
050,19,103,"Iowa","Johnson County",5,28,2256,1178,1078
050,19,103,"Iowa","Johnson County",5,29,2196,1155,1041
050,19,103,"Iowa","Johnson County",5,30,2214,1144,1070
050,19,103,"Iowa","Johnson County",5,31,2058,1060,998
050,19,103,"Iowa","Johnson County",5,32,2037,1069,968
050,19,103,"Iowa","Johnson County",5,33,2022,1026,996
050,19,103,"Iowa","Johnson County",5,34,2018,990,1028
050,19,103,"Iowa","Johnson County",5,35,1978,1037,941
050,19,103,"Iowa","Johnson County",5,36,1934,1021,913
050,19,103,"Iowa","Johnson County",5,37,1901,979,922
050,19,103,"Iowa","Johnson County",5,38,1962,1002,960
050,19,103,"Iowa","Johnson County",5,39,1935,984,951
050,19,103,"Iowa","Johnson County",5,40,1939,973,966
050,19,103,"Iowa","Johnson County",5,41,1960,1003,957
050,19,103,"Iowa","Johnson County",5,42,1966,1014,952
050,19,103,"Iowa","Johnson County",5,43,1921,931,990
050,19,103,"Iowa","Johnson County",5,44,1854,945,909
050,19,103,"Iowa","Johnson County",5,45,1802,952,850
050,19,103,"Iowa","Johnson County",5,46,1742,919,823
050,19,103,"Iowa","Johnson County",5,47,1567,818,749
050,19,103,"Iowa","Johnson County",5,48,1576,829,747
050,19,103,"Iowa","Johnson County",5,49,1483,784,699
050,19,103,"Iowa","Johnson County",5,50,1480,775,705
050,19,103,"Iowa","Johnson County",5,51,1547,794,753
050,19,103,"Iowa","Johnson County",5,52,1562,778,784
050,19,103,"Iowa","Johnson County",5,53,1573,791,782
050,19,103,"Iowa","Johnson County",5,54,1536,798,738
050,19,103,"Iowa","Johnson County",5,55,1448,761,687
050,19,103,"Iowa","Johnson County",5,56,1434,725,709
050,19,103,"Iowa","Johnson County",5,57,1394,673,721
050,19,103,"Iowa","Johnson County",5,58,1490,718,772
050,19,103,"Iowa","Johnson County",5,59,1560,772,788
050,19,103,"Iowa","Johnson County",5,60,1481,749,732
050,19,103,"Iowa","Johnson County",5,61,1444,709,735
050,19,103,"Iowa","Johnson County",5,62,1466,696,770
050,19,103,"Iowa","Johnson County",5,63,1514,727,787
050,19,103,"Iowa","Johnson County",5,64,1488,721,767
050,19,103,"Iowa","Johnson County",5,65,1427,701,726
050,19,103,"Iowa","Johnson County",5,66,1446,707,739
050,19,103,"Iowa","Johnson County",5,67,1379,654,725
050,19,103,"Iowa","Johnson County",5,68,1386,666,720
050,19,103,"Iowa","Johnson County",5,69,1314,613,701
050,19,103,"Iowa","Johnson County",5,70,1306,600,706
050,19,103,"Iowa","Johnson County",5,71,1335,620,715
050,19,103,"Iowa","Johnson County",5,72,1200,549,651
050,19,103,"Iowa","Johnson County",5,73,1130,510,620
050,19,103,"Iowa","Johnson County",5,74,1023,475,548
050,19,103,"Iowa","Johnson County",5,75,990,455,535
050,19,103,"Iowa","Johnson County",5,76,1068,490,578
050,19,103,"Iowa","Johnson County",5,77,745,349,396
050,19,103,"Iowa","Johnson County",5,78,633,285,348
050,19,103,"Iowa","Johnson County",5,79,628,297,331
050,19,103,"Iowa","Johnson County",5,80,613,273,340
050,19,103,"Iowa","Johnson County",5,81,518,223,295
050,19,103,"Iowa","Johnson County",5,82,480,203,277
050,19,103,"Iowa","Johnson County",5,83,418,174,244
050,19,103,"Iowa","Johnson County",5,84,360,151,209
050,19,103,"Iowa","Johnson County",5,85,2404,839,1565
050,19,105,"Iowa","Jones County",1,0,195,98,97
050,19,105,"Iowa","Jones County",1,1,199,103,96
050,19,105,"Iowa","Jones County",1,2,205,106,99
050,19,105,"Iowa","Jones County",1,3,206,112,94
050,19,105,"Iowa","Jones County",1,4,213,119,94
050,19,105,"Iowa","Jones County",1,5,215,117,98
050,19,105,"Iowa","Jones County",1,6,226,121,105
050,19,105,"Iowa","Jones County",1,7,215,111,104
050,19,105,"Iowa","Jones County",1,8,229,120,109
050,19,105,"Iowa","Jones County",1,9,260,131,129
050,19,105,"Iowa","Jones County",1,10,249,124,125
050,19,105,"Iowa","Jones County",1,11,257,124,133
050,19,105,"Iowa","Jones County",1,12,283,136,147
050,19,105,"Iowa","Jones County",1,13,270,129,141
050,19,105,"Iowa","Jones County",1,14,291,156,135
050,19,105,"Iowa","Jones County",1,15,273,144,129
050,19,105,"Iowa","Jones County",1,16,270,141,129
050,19,105,"Iowa","Jones County",1,17,273,143,130
050,19,105,"Iowa","Jones County",1,18,219,119,100
050,19,105,"Iowa","Jones County",1,19,177,95,82
050,19,105,"Iowa","Jones County",1,20,195,105,90
050,19,105,"Iowa","Jones County",1,21,203,112,91
050,19,105,"Iowa","Jones County",1,22,207,113,94
050,19,105,"Iowa","Jones County",1,23,222,138,84
050,19,105,"Iowa","Jones County",1,24,201,122,79
050,19,105,"Iowa","Jones County",1,25,210,113,97
050,19,105,"Iowa","Jones County",1,26,247,129,118
050,19,105,"Iowa","Jones County",1,27,223,126,97
050,19,105,"Iowa","Jones County",1,28,222,132,90
050,19,105,"Iowa","Jones County",1,29,226,125,101
050,19,105,"Iowa","Jones County",1,30,222,130,92
050,19,105,"Iowa","Jones County",1,31,241,121,120
050,19,105,"Iowa","Jones County",1,32,236,128,108
050,19,105,"Iowa","Jones County",1,33,228,134,94
050,19,105,"Iowa","Jones County",1,34,242,139,103
050,19,105,"Iowa","Jones County",1,35,235,123,112
050,19,105,"Iowa","Jones County",1,36,261,133,128
050,19,105,"Iowa","Jones County",1,37,266,143,123
050,19,105,"Iowa","Jones County",1,38,280,156,124
050,19,105,"Iowa","Jones County",1,39,274,159,115
050,19,105,"Iowa","Jones County",1,40,288,172,116
050,19,105,"Iowa","Jones County",1,41,252,140,112
050,19,105,"Iowa","Jones County",1,42,255,147,108
050,19,105,"Iowa","Jones County",1,43,264,151,113
050,19,105,"Iowa","Jones County",1,44,269,152,117
050,19,105,"Iowa","Jones County",1,45,231,125,106
050,19,105,"Iowa","Jones County",1,46,230,125,105
050,19,105,"Iowa","Jones County",1,47,263,155,108
050,19,105,"Iowa","Jones County",1,48,261,142,119
050,19,105,"Iowa","Jones County",1,49,279,147,132
050,19,105,"Iowa","Jones County",1,50,253,140,113
050,19,105,"Iowa","Jones County",1,51,263,132,131
050,19,105,"Iowa","Jones County",1,52,259,142,117
050,19,105,"Iowa","Jones County",1,53,276,153,123
050,19,105,"Iowa","Jones County",1,54,279,162,117
050,19,105,"Iowa","Jones County",1,55,325,182,143
050,19,105,"Iowa","Jones County",1,56,309,149,160
050,19,105,"Iowa","Jones County",1,57,332,167,165
050,19,105,"Iowa","Jones County",1,58,339,170,169
050,19,105,"Iowa","Jones County",1,59,370,192,178
050,19,105,"Iowa","Jones County",1,60,304,166,138
050,19,105,"Iowa","Jones County",1,61,296,157,139
050,19,105,"Iowa","Jones County",1,62,294,139,155
050,19,105,"Iowa","Jones County",1,63,280,140,140
050,19,105,"Iowa","Jones County",1,64,289,145,144
050,19,105,"Iowa","Jones County",1,65,287,150,137
050,19,105,"Iowa","Jones County",1,66,257,132,125
050,19,105,"Iowa","Jones County",1,67,267,149,118
050,19,105,"Iowa","Jones County",1,68,290,160,130
050,19,105,"Iowa","Jones County",1,69,250,136,114
050,19,105,"Iowa","Jones County",1,70,219,118,101
050,19,105,"Iowa","Jones County",1,71,227,105,122
050,19,105,"Iowa","Jones County",1,72,223,97,126
050,19,105,"Iowa","Jones County",1,73,221,107,114
050,19,105,"Iowa","Jones County",1,74,148,72,76
050,19,105,"Iowa","Jones County",1,75,143,68,75
050,19,105,"Iowa","Jones County",1,76,151,76,75
050,19,105,"Iowa","Jones County",1,77,162,81,81
050,19,105,"Iowa","Jones County",1,78,132,60,72
050,19,105,"Iowa","Jones County",1,79,128,60,68
050,19,105,"Iowa","Jones County",1,80,120,54,66
050,19,105,"Iowa","Jones County",1,81,110,50,60
050,19,105,"Iowa","Jones County",1,82,104,46,58
050,19,105,"Iowa","Jones County",1,83,101,44,57
050,19,105,"Iowa","Jones County",1,84,98,42,56
050,19,105,"Iowa","Jones County",1,85,580,211,369
050,19,105,"Iowa","Jones County",2,0,199,104,95
050,19,105,"Iowa","Jones County",2,1,198,101,97
050,19,105,"Iowa","Jones County",2,2,204,105,99
050,19,105,"Iowa","Jones County",2,3,205,110,95
050,19,105,"Iowa","Jones County",2,4,212,118,94
050,19,105,"Iowa","Jones County",2,5,215,118,97
050,19,105,"Iowa","Jones County",2,6,224,120,104
050,19,105,"Iowa","Jones County",2,7,220,115,105
050,19,105,"Iowa","Jones County",2,8,226,117,109
050,19,105,"Iowa","Jones County",2,9,252,128,124
050,19,105,"Iowa","Jones County",2,10,250,125,125
050,19,105,"Iowa","Jones County",2,11,254,123,131
050,19,105,"Iowa","Jones County",2,12,281,135,146
050,19,105,"Iowa","Jones County",2,13,273,131,142
050,19,105,"Iowa","Jones County",2,14,286,150,136
050,19,105,"Iowa","Jones County",2,15,280,148,132
050,19,105,"Iowa","Jones County",2,16,271,142,129
050,19,105,"Iowa","Jones County",2,17,271,143,128
050,19,105,"Iowa","Jones County",2,18,223,122,101
050,19,105,"Iowa","Jones County",2,19,177,97,80
050,19,105,"Iowa","Jones County",2,20,199,106,93
050,19,105,"Iowa","Jones County",2,21,201,111,90
050,19,105,"Iowa","Jones County",2,22,209,112,97
050,19,105,"Iowa","Jones County",2,23,222,139,83
050,19,105,"Iowa","Jones County",2,24,200,120,80
050,19,105,"Iowa","Jones County",2,25,204,112,92
050,19,105,"Iowa","Jones County",2,26,237,126,111
050,19,105,"Iowa","Jones County",2,27,228,127,101
050,19,105,"Iowa","Jones County",2,28,224,131,93
050,19,105,"Iowa","Jones County",2,29,225,127,98
050,19,105,"Iowa","Jones County",2,30,228,131,97
050,19,105,"Iowa","Jones County",2,31,241,126,115
050,19,105,"Iowa","Jones County",2,32,233,124,109
050,19,105,"Iowa","Jones County",2,33,230,132,98
050,19,105,"Iowa","Jones County",2,34,237,139,98
050,19,105,"Iowa","Jones County",2,35,236,125,111
050,19,105,"Iowa","Jones County",2,36,259,135,124
050,19,105,"Iowa","Jones County",2,37,264,140,124
050,19,105,"Iowa","Jones County",2,38,281,155,126
050,19,105,"Iowa","Jones County",2,39,277,160,117
050,19,105,"Iowa","Jones County",2,40,286,170,116
050,19,105,"Iowa","Jones County",2,41,261,148,113
050,19,105,"Iowa","Jones County",2,42,254,146,108
050,19,105,"Iowa","Jones County",2,43,267,154,113
050,19,105,"Iowa","Jones County",2,44,268,150,118
050,19,105,"Iowa","Jones County",2,45,236,128,108
050,19,105,"Iowa","Jones County",2,46,236,129,107
050,19,105,"Iowa","Jones County",2,47,257,151,106
050,19,105,"Iowa","Jones County",2,48,254,140,114
050,19,105,"Iowa","Jones County",2,49,283,149,134
050,19,105,"Iowa","Jones County",2,50,250,136,114
050,19,105,"Iowa","Jones County",2,51,259,130,129
050,19,105,"Iowa","Jones County",2,52,259,140,119
050,19,105,"Iowa","Jones County",2,53,272,152,120
050,19,105,"Iowa","Jones County",2,54,280,161,119
050,19,105,"Iowa","Jones County",2,55,316,180,136
050,19,105,"Iowa","Jones County",2,56,306,150,156
050,19,105,"Iowa","Jones County",2,57,324,164,160
050,19,105,"Iowa","Jones County",2,58,338,167,171
050,19,105,"Iowa","Jones County",2,59,368,192,176
050,19,105,"Iowa","Jones County",2,60,310,167,143
050,19,105,"Iowa","Jones County",2,61,295,156,139
050,19,105,"Iowa","Jones County",2,62,296,143,153
050,19,105,"Iowa","Jones County",2,63,283,140,143
050,19,105,"Iowa","Jones County",2,64,286,142,144
050,19,105,"Iowa","Jones County",2,65,286,148,138
050,19,105,"Iowa","Jones County",2,66,264,136,128
050,19,105,"Iowa","Jones County",2,67,263,144,119
050,19,105,"Iowa","Jones County",2,68,280,155,125
050,19,105,"Iowa","Jones County",2,69,262,143,119
050,19,105,"Iowa","Jones County",2,70,224,120,104
050,19,105,"Iowa","Jones County",2,71,224,108,116
050,19,105,"Iowa","Jones County",2,72,221,97,124
050,19,105,"Iowa","Jones County",2,73,231,110,121
050,19,105,"Iowa","Jones County",2,74,154,76,78
050,19,105,"Iowa","Jones County",2,75,144,69,75
050,19,105,"Iowa","Jones County",2,76,148,73,75
050,19,105,"Iowa","Jones County",2,77,163,81,82
050,19,105,"Iowa","Jones County",2,78,135,64,71
050,19,105,"Iowa","Jones County",2,79,128,59,69
050,19,105,"Iowa","Jones County",2,80,122,55,67
050,19,105,"Iowa","Jones County",2,81,113,51,62
050,19,105,"Iowa","Jones County",2,82,105,46,59
050,19,105,"Iowa","Jones County",2,83,100,43,57
050,19,105,"Iowa","Jones County",2,84,96,43,53
050,19,105,"Iowa","Jones County",2,85,590,215,375
050,19,105,"Iowa","Jones County",3,0,197,105,92
050,19,105,"Iowa","Jones County",3,1,216,115,101
050,19,105,"Iowa","Jones County",3,2,203,103,100
050,19,105,"Iowa","Jones County",3,3,219,109,110
050,19,105,"Iowa","Jones County",3,4,198,108,90
050,19,105,"Iowa","Jones County",3,5,218,121,97
050,19,105,"Iowa","Jones County",3,6,232,124,108
050,19,105,"Iowa","Jones County",3,7,231,126,105
050,19,105,"Iowa","Jones County",3,8,232,126,106
050,19,105,"Iowa","Jones County",3,9,220,112,108
050,19,105,"Iowa","Jones County",3,10,261,134,127
050,19,105,"Iowa","Jones County",3,11,243,121,122
050,19,105,"Iowa","Jones County",3,12,261,127,134
050,19,105,"Iowa","Jones County",3,13,282,131,151
050,19,105,"Iowa","Jones County",3,14,268,128,140
050,19,105,"Iowa","Jones County",3,15,275,143,132
050,19,105,"Iowa","Jones County",3,16,285,153,132
050,19,105,"Iowa","Jones County",3,17,269,143,126
050,19,105,"Iowa","Jones County",3,18,234,132,102
050,19,105,"Iowa","Jones County",3,19,174,97,77
050,19,105,"Iowa","Jones County",3,20,197,105,92
050,19,105,"Iowa","Jones County",3,21,205,110,95
050,19,105,"Iowa","Jones County",3,22,224,116,108
050,19,105,"Iowa","Jones County",3,23,220,135,85
050,19,105,"Iowa","Jones County",3,24,216,132,84
050,19,105,"Iowa","Jones County",3,25,195,109,86
050,19,105,"Iowa","Jones County",3,26,214,122,92
050,19,105,"Iowa","Jones County",3,27,238,128,110
050,19,105,"Iowa","Jones County",3,28,241,131,110
050,19,105,"Iowa","Jones County",3,29,238,141,97
050,19,105,"Iowa","Jones County",3,30,227,129,98
050,19,105,"Iowa","Jones County",3,31,248,143,105
050,19,105,"Iowa","Jones County",3,32,227,121,106
050,19,105,"Iowa","Jones County",3,33,241,127,114
050,19,105,"Iowa","Jones County",3,34,249,138,111
050,19,105,"Iowa","Jones County",3,35,237,139,98
050,19,105,"Iowa","Jones County",3,36,269,146,123
050,19,105,"Iowa","Jones County",3,37,261,134,127
050,19,105,"Iowa","Jones County",3,38,274,144,130
050,19,105,"Iowa","Jones County",3,39,294,162,132
050,19,105,"Iowa","Jones County",3,40,279,165,114
050,19,105,"Iowa","Jones County",3,41,280,166,114
050,19,105,"Iowa","Jones County",3,42,266,150,116
050,19,105,"Iowa","Jones County",3,43,274,160,114
050,19,105,"Iowa","Jones County",3,44,285,158,127
050,19,105,"Iowa","Jones County",3,45,240,128,112
050,19,105,"Iowa","Jones County",3,46,267,142,125
050,19,105,"Iowa","Jones County",3,47,262,151,111
050,19,105,"Iowa","Jones County",3,48,223,129,94
050,19,105,"Iowa","Jones County",3,49,274,145,129
050,19,105,"Iowa","Jones County",3,50,246,130,116
050,19,105,"Iowa","Jones County",3,51,247,133,114
050,19,105,"Iowa","Jones County",3,52,258,134,124
050,19,105,"Iowa","Jones County",3,53,270,148,122
050,19,105,"Iowa","Jones County",3,54,289,157,132
050,19,105,"Iowa","Jones County",3,55,298,177,121
050,19,105,"Iowa","Jones County",3,56,291,155,136
050,19,105,"Iowa","Jones County",3,57,312,163,149
050,19,105,"Iowa","Jones County",3,58,331,160,171
050,19,105,"Iowa","Jones County",3,59,356,183,173
050,19,105,"Iowa","Jones County",3,60,337,172,165
050,19,105,"Iowa","Jones County",3,61,302,158,144
050,19,105,"Iowa","Jones County",3,62,298,155,143
050,19,105,"Iowa","Jones County",3,63,291,143,148
050,19,105,"Iowa","Jones County",3,64,271,129,142
050,19,105,"Iowa","Jones County",3,65,291,148,143
050,19,105,"Iowa","Jones County",3,66,286,148,138
050,19,105,"Iowa","Jones County",3,67,267,138,129
050,19,105,"Iowa","Jones County",3,68,259,139,120
050,19,105,"Iowa","Jones County",3,69,277,151,126
050,19,105,"Iowa","Jones County",3,70,258,137,121
050,19,105,"Iowa","Jones County",3,71,225,118,107
050,19,105,"Iowa","Jones County",3,72,221,107,114
050,19,105,"Iowa","Jones County",3,73,216,95,121
050,19,105,"Iowa","Jones County",3,74,227,107,120
050,19,105,"Iowa","Jones County",3,75,152,75,77
050,19,105,"Iowa","Jones County",3,76,135,67,68
050,19,105,"Iowa","Jones County",3,77,141,66,75
050,19,105,"Iowa","Jones County",3,78,154,75,79
050,19,105,"Iowa","Jones County",3,79,129,62,67
050,19,105,"Iowa","Jones County",3,80,123,54,69
050,19,105,"Iowa","Jones County",3,81,111,51,60
050,19,105,"Iowa","Jones County",3,82,109,50,59
050,19,105,"Iowa","Jones County",3,83,99,44,55
050,19,105,"Iowa","Jones County",3,84,89,38,51
050,19,105,"Iowa","Jones County",3,85,577,217,360
050,19,105,"Iowa","Jones County",4,0,187,100,87
050,19,105,"Iowa","Jones County",4,1,215,120,95
050,19,105,"Iowa","Jones County",4,2,217,120,97
050,19,105,"Iowa","Jones County",4,3,206,100,106
050,19,105,"Iowa","Jones County",4,4,212,100,112
050,19,105,"Iowa","Jones County",4,5,204,114,90
050,19,105,"Iowa","Jones County",4,6,212,118,94
050,19,105,"Iowa","Jones County",4,7,235,123,112
050,19,105,"Iowa","Jones County",4,8,228,122,106
050,19,105,"Iowa","Jones County",4,9,238,131,107
050,19,105,"Iowa","Jones County",4,10,225,117,108
050,19,105,"Iowa","Jones County",4,11,254,129,125
050,19,105,"Iowa","Jones County",4,12,251,127,124
050,19,105,"Iowa","Jones County",4,13,259,127,132
050,19,105,"Iowa","Jones County",4,14,292,137,155
050,19,105,"Iowa","Jones County",4,15,273,128,145
050,19,105,"Iowa","Jones County",4,16,289,154,135
050,19,105,"Iowa","Jones County",4,17,283,150,133
050,19,105,"Iowa","Jones County",4,18,230,127,103
050,19,105,"Iowa","Jones County",4,19,185,109,76
050,19,105,"Iowa","Jones County",4,20,184,99,85
050,19,105,"Iowa","Jones County",4,21,205,114,91
050,19,105,"Iowa","Jones County",4,22,237,122,115
050,19,105,"Iowa","Jones County",4,23,242,152,90
050,19,105,"Iowa","Jones County",4,24,207,126,81
050,19,105,"Iowa","Jones County",4,25,194,118,76
050,19,105,"Iowa","Jones County",4,26,194,118,76
050,19,105,"Iowa","Jones County",4,27,220,124,96
050,19,105,"Iowa","Jones County",4,28,249,137,112
050,19,105,"Iowa","Jones County",4,29,253,139,114
050,19,105,"Iowa","Jones County",4,30,245,141,104
050,19,105,"Iowa","Jones County",4,31,247,142,105
050,19,105,"Iowa","Jones County",4,32,239,142,97
050,19,105,"Iowa","Jones County",4,33,240,133,107
050,19,105,"Iowa","Jones County",4,34,245,128,117
050,19,105,"Iowa","Jones County",4,35,237,130,107
050,19,105,"Iowa","Jones County",4,36,265,161,104
050,19,105,"Iowa","Jones County",4,37,270,146,124
050,19,105,"Iowa","Jones County",4,38,282,148,134
050,19,105,"Iowa","Jones County",4,39,281,152,129
050,19,105,"Iowa","Jones County",4,40,294,167,127
050,19,105,"Iowa","Jones County",4,41,280,163,117
050,19,105,"Iowa","Jones County",4,42,281,172,109
050,19,105,"Iowa","Jones County",4,43,288,171,117
050,19,105,"Iowa","Jones County",4,44,283,160,123
050,19,105,"Iowa","Jones County",4,45,262,143,119
050,19,105,"Iowa","Jones County",4,46,272,150,122
050,19,105,"Iowa","Jones County",4,47,289,163,126
050,19,105,"Iowa","Jones County",4,48,237,130,107
050,19,105,"Iowa","Jones County",4,49,250,140,110
050,19,105,"Iowa","Jones County",4,50,245,132,113
050,19,105,"Iowa","Jones County",4,51,249,129,120
050,19,105,"Iowa","Jones County",4,52,259,143,116
050,19,105,"Iowa","Jones County",4,53,259,136,123
050,19,105,"Iowa","Jones County",4,54,285,154,131
050,19,105,"Iowa","Jones County",4,55,310,173,137
050,19,105,"Iowa","Jones County",4,56,270,151,119
050,19,105,"Iowa","Jones County",4,57,286,163,123
050,19,105,"Iowa","Jones County",4,58,318,159,159
050,19,105,"Iowa","Jones County",4,59,341,174,167
050,19,105,"Iowa","Jones County",4,60,328,166,162
050,19,105,"Iowa","Jones County",4,61,337,163,174
050,19,105,"Iowa","Jones County",4,62,316,165,151
050,19,105,"Iowa","Jones County",4,63,296,161,135
050,19,105,"Iowa","Jones County",4,64,278,137,141
050,19,105,"Iowa","Jones County",4,65,276,132,144
050,19,105,"Iowa","Jones County",4,66,288,147,141
050,19,105,"Iowa","Jones County",4,67,279,144,135
050,19,105,"Iowa","Jones County",4,68,271,139,132
050,19,105,"Iowa","Jones County",4,69,254,133,121
050,19,105,"Iowa","Jones County",4,70,261,143,118
050,19,105,"Iowa","Jones County",4,71,253,130,123
050,19,105,"Iowa","Jones County",4,72,217,115,102
050,19,105,"Iowa","Jones County",4,73,214,103,111
050,19,105,"Iowa","Jones County",4,74,210,93,117
050,19,105,"Iowa","Jones County",4,75,219,105,114
050,19,105,"Iowa","Jones County",4,76,146,71,75
050,19,105,"Iowa","Jones County",4,77,127,62,65
050,19,105,"Iowa","Jones County",4,78,129,60,69
050,19,105,"Iowa","Jones County",4,79,150,76,74
050,19,105,"Iowa","Jones County",4,80,126,59,67
050,19,105,"Iowa","Jones County",4,81,113,49,64
050,19,105,"Iowa","Jones County",4,82,103,46,57
050,19,105,"Iowa","Jones County",4,83,101,48,53
050,19,105,"Iowa","Jones County",4,84,90,41,49
050,19,105,"Iowa","Jones County",4,85,578,219,359
050,19,105,"Iowa","Jones County",5,0,192,102,90
050,19,105,"Iowa","Jones County",5,1,192,101,91
050,19,105,"Iowa","Jones County",5,2,216,120,96
050,19,105,"Iowa","Jones County",5,3,213,118,95
050,19,105,"Iowa","Jones County",5,4,209,104,105
050,19,105,"Iowa","Jones County",5,5,210,101,109
050,19,105,"Iowa","Jones County",5,6,211,118,93
050,19,105,"Iowa","Jones County",5,7,211,114,97
050,19,105,"Iowa","Jones County",5,8,233,120,113
050,19,105,"Iowa","Jones County",5,9,231,118,113
050,19,105,"Iowa","Jones County",5,10,243,134,109
050,19,105,"Iowa","Jones County",5,11,222,116,106
050,19,105,"Iowa","Jones County",5,12,257,127,130
050,19,105,"Iowa","Jones County",5,13,257,123,134
050,19,105,"Iowa","Jones County",5,14,263,131,132
050,19,105,"Iowa","Jones County",5,15,280,134,146
050,19,105,"Iowa","Jones County",5,16,267,131,136
050,19,105,"Iowa","Jones County",5,17,288,154,134
050,19,105,"Iowa","Jones County",5,18,253,143,110
050,19,105,"Iowa","Jones County",5,19,178,104,74
050,19,105,"Iowa","Jones County",5,20,208,119,89
050,19,105,"Iowa","Jones County",5,21,189,112,77
050,19,105,"Iowa","Jones County",5,22,230,115,115
050,19,105,"Iowa","Jones County",5,23,262,154,108
050,19,105,"Iowa","Jones County",5,24,226,136,90
050,19,105,"Iowa","Jones County",5,25,190,115,75
050,19,105,"Iowa","Jones County",5,26,211,128,83
050,19,105,"Iowa","Jones County",5,27,202,113,89
050,19,105,"Iowa","Jones County",5,28,228,134,94
050,19,105,"Iowa","Jones County",5,29,243,136,107
050,19,105,"Iowa","Jones County",5,30,254,140,114
050,19,105,"Iowa","Jones County",5,31,260,148,112
050,19,105,"Iowa","Jones County",5,32,225,129,96
050,19,105,"Iowa","Jones County",5,33,251,149,102
050,19,105,"Iowa","Jones County",5,34,228,127,101
050,19,105,"Iowa","Jones County",5,35,235,114,121
050,19,105,"Iowa","Jones County",5,36,258,146,112
050,19,105,"Iowa","Jones County",5,37,261,156,105
050,19,105,"Iowa","Jones County",5,38,272,150,122
050,19,105,"Iowa","Jones County",5,39,288,154,134
050,19,105,"Iowa","Jones County",5,40,273,147,126
050,19,105,"Iowa","Jones County",5,41,291,160,131
050,19,105,"Iowa","Jones County",5,42,283,170,113
050,19,105,"Iowa","Jones County",5,43,293,186,107
050,19,105,"Iowa","Jones County",5,44,301,171,130
050,19,105,"Iowa","Jones County",5,45,248,139,109
050,19,105,"Iowa","Jones County",5,46,286,157,129
050,19,105,"Iowa","Jones County",5,47,293,164,129
050,19,105,"Iowa","Jones County",5,48,256,141,115
050,19,105,"Iowa","Jones County",5,49,262,143,119
050,19,105,"Iowa","Jones County",5,50,215,122,93
050,19,105,"Iowa","Jones County",5,51,247,126,121
050,19,105,"Iowa","Jones County",5,52,244,132,112
050,19,105,"Iowa","Jones County",5,53,257,144,113
050,19,105,"Iowa","Jones County",5,54,269,143,126
050,19,105,"Iowa","Jones County",5,55,298,167,131
050,19,105,"Iowa","Jones County",5,56,272,137,135
050,19,105,"Iowa","Jones County",5,57,275,161,114
050,19,105,"Iowa","Jones County",5,58,291,158,133
050,19,105,"Iowa","Jones County",5,59,340,181,159
050,19,105,"Iowa","Jones County",5,60,307,151,156
050,19,105,"Iowa","Jones County",5,61,321,159,162
050,19,105,"Iowa","Jones County",5,62,343,166,177
050,19,105,"Iowa","Jones County",5,63,307,168,139
050,19,105,"Iowa","Jones County",5,64,285,150,135
050,19,105,"Iowa","Jones County",5,65,277,138,139
050,19,105,"Iowa","Jones County",5,66,271,125,146
050,19,105,"Iowa","Jones County",5,67,285,146,139
050,19,105,"Iowa","Jones County",5,68,272,140,132
050,19,105,"Iowa","Jones County",5,69,262,132,130
050,19,105,"Iowa","Jones County",5,70,238,124,114
050,19,105,"Iowa","Jones County",5,71,263,142,121
050,19,105,"Iowa","Jones County",5,72,250,129,121
050,19,105,"Iowa","Jones County",5,73,210,111,99
050,19,105,"Iowa","Jones County",5,74,210,101,109
050,19,105,"Iowa","Jones County",5,75,211,95,116
050,19,105,"Iowa","Jones County",5,76,208,99,109
050,19,105,"Iowa","Jones County",5,77,140,66,74
050,19,105,"Iowa","Jones County",5,78,116,56,60
050,19,105,"Iowa","Jones County",5,79,123,59,64
050,19,105,"Iowa","Jones County",5,80,149,74,75
050,19,105,"Iowa","Jones County",5,81,117,55,62
050,19,105,"Iowa","Jones County",5,82,109,46,63
050,19,105,"Iowa","Jones County",5,83,99,44,55
050,19,105,"Iowa","Jones County",5,84,96,47,49
050,19,105,"Iowa","Jones County",5,85,590,232,358
050,19,107,"Iowa","Keokuk County",1,0,101,51,50
050,19,107,"Iowa","Keokuk County",1,1,108,52,56
050,19,107,"Iowa","Keokuk County",1,2,125,58,67
050,19,107,"Iowa","Keokuk County",1,3,121,65,56
050,19,107,"Iowa","Keokuk County",1,4,122,65,57
050,19,107,"Iowa","Keokuk County",1,5,114,59,55
050,19,107,"Iowa","Keokuk County",1,6,132,70,62
050,19,107,"Iowa","Keokuk County",1,7,137,74,63
050,19,107,"Iowa","Keokuk County",1,8,128,67,61
050,19,107,"Iowa","Keokuk County",1,9,122,60,62
050,19,107,"Iowa","Keokuk County",1,10,136,73,63
050,19,107,"Iowa","Keokuk County",1,11,135,71,64
050,19,107,"Iowa","Keokuk County",1,12,124,60,64
050,19,107,"Iowa","Keokuk County",1,13,135,71,64
050,19,107,"Iowa","Keokuk County",1,14,123,72,51
050,19,107,"Iowa","Keokuk County",1,15,143,81,62
050,19,107,"Iowa","Keokuk County",1,16,165,85,80
050,19,107,"Iowa","Keokuk County",1,17,149,80,69
050,19,107,"Iowa","Keokuk County",1,18,118,74,44
050,19,107,"Iowa","Keokuk County",1,19,92,53,39
050,19,107,"Iowa","Keokuk County",1,20,79,46,33
050,19,107,"Iowa","Keokuk County",1,21,96,54,42
050,19,107,"Iowa","Keokuk County",1,22,100,53,47
050,19,107,"Iowa","Keokuk County",1,23,107,54,53
050,19,107,"Iowa","Keokuk County",1,24,106,56,50
050,19,107,"Iowa","Keokuk County",1,25,104,55,49
050,19,107,"Iowa","Keokuk County",1,26,99,55,44
050,19,107,"Iowa","Keokuk County",1,27,113,61,52
050,19,107,"Iowa","Keokuk County",1,28,128,63,65
050,19,107,"Iowa","Keokuk County",1,29,100,48,52
050,19,107,"Iowa","Keokuk County",1,30,100,53,47
050,19,107,"Iowa","Keokuk County",1,31,100,60,40
050,19,107,"Iowa","Keokuk County",1,32,87,49,38
050,19,107,"Iowa","Keokuk County",1,33,89,45,44
050,19,107,"Iowa","Keokuk County",1,34,104,49,55
050,19,107,"Iowa","Keokuk County",1,35,129,66,63
050,19,107,"Iowa","Keokuk County",1,36,126,61,65
050,19,107,"Iowa","Keokuk County",1,37,108,50,58
050,19,107,"Iowa","Keokuk County",1,38,118,58,60
050,19,107,"Iowa","Keokuk County",1,39,128,68,60
050,19,107,"Iowa","Keokuk County",1,40,120,68,52
050,19,107,"Iowa","Keokuk County",1,41,117,60,57
050,19,107,"Iowa","Keokuk County",1,42,129,65,64
050,19,107,"Iowa","Keokuk County",1,43,106,50,56
050,19,107,"Iowa","Keokuk County",1,44,103,49,54
050,19,107,"Iowa","Keokuk County",1,45,113,62,51
050,19,107,"Iowa","Keokuk County",1,46,98,57,41
050,19,107,"Iowa","Keokuk County",1,47,95,49,46
050,19,107,"Iowa","Keokuk County",1,48,126,58,68
050,19,107,"Iowa","Keokuk County",1,49,123,66,57
050,19,107,"Iowa","Keokuk County",1,50,114,57,57
050,19,107,"Iowa","Keokuk County",1,51,116,58,58
050,19,107,"Iowa","Keokuk County",1,52,109,58,51
050,19,107,"Iowa","Keokuk County",1,53,111,61,50
050,19,107,"Iowa","Keokuk County",1,54,115,59,56
050,19,107,"Iowa","Keokuk County",1,55,125,67,58
050,19,107,"Iowa","Keokuk County",1,56,143,71,72
050,19,107,"Iowa","Keokuk County",1,57,155,76,79
050,19,107,"Iowa","Keokuk County",1,58,158,82,76
050,19,107,"Iowa","Keokuk County",1,59,160,84,76
050,19,107,"Iowa","Keokuk County",1,60,159,81,78
050,19,107,"Iowa","Keokuk County",1,61,154,84,70
050,19,107,"Iowa","Keokuk County",1,62,146,79,67
050,19,107,"Iowa","Keokuk County",1,63,154,75,79
050,19,107,"Iowa","Keokuk County",1,64,158,75,83
050,19,107,"Iowa","Keokuk County",1,65,161,84,77
050,19,107,"Iowa","Keokuk County",1,66,154,82,72
050,19,107,"Iowa","Keokuk County",1,67,129,74,55
050,19,107,"Iowa","Keokuk County",1,68,122,65,57
050,19,107,"Iowa","Keokuk County",1,69,117,59,58
050,19,107,"Iowa","Keokuk County",1,70,116,62,54
050,19,107,"Iowa","Keokuk County",1,71,113,57,56
050,19,107,"Iowa","Keokuk County",1,72,114,55,59
050,19,107,"Iowa","Keokuk County",1,73,108,56,52
050,19,107,"Iowa","Keokuk County",1,74,72,35,37
050,19,107,"Iowa","Keokuk County",1,75,65,34,31
050,19,107,"Iowa","Keokuk County",1,76,75,37,38
050,19,107,"Iowa","Keokuk County",1,77,92,35,57
050,19,107,"Iowa","Keokuk County",1,78,75,33,42
050,19,107,"Iowa","Keokuk County",1,79,68,34,34
050,19,107,"Iowa","Keokuk County",1,80,65,31,34
050,19,107,"Iowa","Keokuk County",1,81,54,27,27
050,19,107,"Iowa","Keokuk County",1,82,45,22,23
050,19,107,"Iowa","Keokuk County",1,83,54,25,29
050,19,107,"Iowa","Keokuk County",1,84,47,16,31
050,19,107,"Iowa","Keokuk County",1,85,322,109,213
050,19,107,"Iowa","Keokuk County",2,0,104,54,50
050,19,107,"Iowa","Keokuk County",2,1,106,51,55
050,19,107,"Iowa","Keokuk County",2,2,121,57,64
050,19,107,"Iowa","Keokuk County",2,3,122,63,59
050,19,107,"Iowa","Keokuk County",2,4,121,65,56
050,19,107,"Iowa","Keokuk County",2,5,118,61,57
050,19,107,"Iowa","Keokuk County",2,6,128,67,61
050,19,107,"Iowa","Keokuk County",2,7,135,73,62
050,19,107,"Iowa","Keokuk County",2,8,130,68,62
050,19,107,"Iowa","Keokuk County",2,9,123,62,61
050,19,107,"Iowa","Keokuk County",2,10,132,69,63
050,19,107,"Iowa","Keokuk County",2,11,133,69,64
050,19,107,"Iowa","Keokuk County",2,12,128,63,65
050,19,107,"Iowa","Keokuk County",2,13,131,68,63
050,19,107,"Iowa","Keokuk County",2,14,124,72,52
050,19,107,"Iowa","Keokuk County",2,15,140,80,60
050,19,107,"Iowa","Keokuk County",2,16,160,85,75
050,19,107,"Iowa","Keokuk County",2,17,155,83,72
050,19,107,"Iowa","Keokuk County",2,18,120,73,47
050,19,107,"Iowa","Keokuk County",2,19,92,56,36
050,19,107,"Iowa","Keokuk County",2,20,82,48,34
050,19,107,"Iowa","Keokuk County",2,21,91,52,39
050,19,107,"Iowa","Keokuk County",2,22,101,53,48
050,19,107,"Iowa","Keokuk County",2,23,108,56,52
050,19,107,"Iowa","Keokuk County",2,24,108,57,51
050,19,107,"Iowa","Keokuk County",2,25,105,56,49
050,19,107,"Iowa","Keokuk County",2,26,99,54,45
050,19,107,"Iowa","Keokuk County",2,27,111,60,51
050,19,107,"Iowa","Keokuk County",2,28,122,60,62
050,19,107,"Iowa","Keokuk County",2,29,107,51,56
050,19,107,"Iowa","Keokuk County",2,30,102,52,50
050,19,107,"Iowa","Keokuk County",2,31,97,57,40
050,19,107,"Iowa","Keokuk County",2,32,89,51,38
050,19,107,"Iowa","Keokuk County",2,33,87,45,42
050,19,107,"Iowa","Keokuk County",2,34,101,48,53
050,19,107,"Iowa","Keokuk County",2,35,124,62,62
050,19,107,"Iowa","Keokuk County",2,36,125,61,64
050,19,107,"Iowa","Keokuk County",2,37,112,52,60
050,19,107,"Iowa","Keokuk County",2,38,116,56,60
050,19,107,"Iowa","Keokuk County",2,39,123,64,59
050,19,107,"Iowa","Keokuk County",2,40,122,69,53
050,19,107,"Iowa","Keokuk County",2,41,118,63,55
050,19,107,"Iowa","Keokuk County",2,42,124,62,62
050,19,107,"Iowa","Keokuk County",2,43,114,55,59
050,19,107,"Iowa","Keokuk County",2,44,103,49,54
050,19,107,"Iowa","Keokuk County",2,45,110,58,52
050,19,107,"Iowa","Keokuk County",2,46,101,58,43
050,19,107,"Iowa","Keokuk County",2,47,95,51,44
050,19,107,"Iowa","Keokuk County",2,48,116,55,61
050,19,107,"Iowa","Keokuk County",2,49,125,65,60
050,19,107,"Iowa","Keokuk County",2,50,117,59,58
050,19,107,"Iowa","Keokuk County",2,51,115,58,57
050,19,107,"Iowa","Keokuk County",2,52,110,58,52
050,19,107,"Iowa","Keokuk County",2,53,110,59,51
050,19,107,"Iowa","Keokuk County",2,54,113,60,53
050,19,107,"Iowa","Keokuk County",2,55,122,65,57
050,19,107,"Iowa","Keokuk County",2,56,139,70,69
050,19,107,"Iowa","Keokuk County",2,57,151,74,77
050,19,107,"Iowa","Keokuk County",2,58,156,80,76
050,19,107,"Iowa","Keokuk County",2,59,159,82,77
050,19,107,"Iowa","Keokuk County",2,60,158,81,77
050,19,107,"Iowa","Keokuk County",2,61,156,83,73
050,19,107,"Iowa","Keokuk County",2,62,147,80,67
050,19,107,"Iowa","Keokuk County",2,63,152,76,76
050,19,107,"Iowa","Keokuk County",2,64,156,74,82
050,19,107,"Iowa","Keokuk County",2,65,160,82,78
050,19,107,"Iowa","Keokuk County",2,66,157,83,74
050,19,107,"Iowa","Keokuk County",2,67,134,76,58
050,19,107,"Iowa","Keokuk County",2,68,123,67,56
050,19,107,"Iowa","Keokuk County",2,69,119,60,59
050,19,107,"Iowa","Keokuk County",2,70,114,62,52
050,19,107,"Iowa","Keokuk County",2,71,114,58,56
050,19,107,"Iowa","Keokuk County",2,72,109,54,55
050,19,107,"Iowa","Keokuk County",2,73,115,58,57
050,19,107,"Iowa","Keokuk County",2,74,75,36,39
050,19,107,"Iowa","Keokuk County",2,75,67,35,32
050,19,107,"Iowa","Keokuk County",2,76,73,36,37
050,19,107,"Iowa","Keokuk County",2,77,90,36,54
050,19,107,"Iowa","Keokuk County",2,78,75,31,44
050,19,107,"Iowa","Keokuk County",2,79,68,32,36
050,19,107,"Iowa","Keokuk County",2,80,63,30,33
050,19,107,"Iowa","Keokuk County",2,81,57,28,29
050,19,107,"Iowa","Keokuk County",2,82,47,24,23
050,19,107,"Iowa","Keokuk County",2,83,51,24,27
050,19,107,"Iowa","Keokuk County",2,84,48,18,30
050,19,107,"Iowa","Keokuk County",2,85,323,109,214
050,19,107,"Iowa","Keokuk County",3,0,89,43,46
050,19,107,"Iowa","Keokuk County",3,1,105,53,52
050,19,107,"Iowa","Keokuk County",3,2,109,52,57
050,19,107,"Iowa","Keokuk County",3,3,120,55,65
050,19,107,"Iowa","Keokuk County",3,4,117,59,58
050,19,107,"Iowa","Keokuk County",3,5,123,65,58
050,19,107,"Iowa","Keokuk County",3,6,122,60,62
050,19,107,"Iowa","Keokuk County",3,7,128,67,61
050,19,107,"Iowa","Keokuk County",3,8,132,70,62
050,19,107,"Iowa","Keokuk County",3,9,132,68,64
050,19,107,"Iowa","Keokuk County",3,10,121,58,63
050,19,107,"Iowa","Keokuk County",3,11,136,64,72
050,19,107,"Iowa","Keokuk County",3,12,133,72,61
050,19,107,"Iowa","Keokuk County",3,13,128,64,64
050,19,107,"Iowa","Keokuk County",3,14,134,73,61
050,19,107,"Iowa","Keokuk County",3,15,131,75,56
050,19,107,"Iowa","Keokuk County",3,16,142,76,66
050,19,107,"Iowa","Keokuk County",3,17,158,83,75
050,19,107,"Iowa","Keokuk County",3,18,131,70,61
050,19,107,"Iowa","Keokuk County",3,19,95,59,36
050,19,107,"Iowa","Keokuk County",3,20,88,55,33
050,19,107,"Iowa","Keokuk County",3,21,86,49,37
050,19,107,"Iowa","Keokuk County",3,22,96,55,41
050,19,107,"Iowa","Keokuk County",3,23,100,55,45
050,19,107,"Iowa","Keokuk County",3,24,92,49,43
050,19,107,"Iowa","Keokuk County",3,25,111,57,54
050,19,107,"Iowa","Keokuk County",3,26,97,48,49
050,19,107,"Iowa","Keokuk County",3,27,102,53,49
050,19,107,"Iowa","Keokuk County",3,28,117,66,51
050,19,107,"Iowa","Keokuk County",3,29,122,62,60
050,19,107,"Iowa","Keokuk County",3,30,107,50,57
050,19,107,"Iowa","Keokuk County",3,31,112,56,56
050,19,107,"Iowa","Keokuk County",3,32,103,61,42
050,19,107,"Iowa","Keokuk County",3,33,98,55,43
050,19,107,"Iowa","Keokuk County",3,34,86,41,45
050,19,107,"Iowa","Keokuk County",3,35,105,52,53
050,19,107,"Iowa","Keokuk County",3,36,118,57,61
050,19,107,"Iowa","Keokuk County",3,37,129,65,64
050,19,107,"Iowa","Keokuk County",3,38,110,51,59
050,19,107,"Iowa","Keokuk County",3,39,120,62,58
050,19,107,"Iowa","Keokuk County",3,40,116,63,53
050,19,107,"Iowa","Keokuk County",3,41,126,68,58
050,19,107,"Iowa","Keokuk County",3,42,117,61,56
050,19,107,"Iowa","Keokuk County",3,43,124,62,62
050,19,107,"Iowa","Keokuk County",3,44,122,61,61
050,19,107,"Iowa","Keokuk County",3,45,102,47,55
050,19,107,"Iowa","Keokuk County",3,46,105,55,50
050,19,107,"Iowa","Keokuk County",3,47,97,58,39
050,19,107,"Iowa","Keokuk County",3,48,96,52,44
050,19,107,"Iowa","Keokuk County",3,49,115,54,61
050,19,107,"Iowa","Keokuk County",3,50,134,69,65
050,19,107,"Iowa","Keokuk County",3,51,113,59,54
050,19,107,"Iowa","Keokuk County",3,52,111,56,55
050,19,107,"Iowa","Keokuk County",3,53,114,60,54
050,19,107,"Iowa","Keokuk County",3,54,112,57,55
050,19,107,"Iowa","Keokuk County",3,55,115,61,54
050,19,107,"Iowa","Keokuk County",3,56,120,61,59
050,19,107,"Iowa","Keokuk County",3,57,134,65,69
050,19,107,"Iowa","Keokuk County",3,58,145,70,75
050,19,107,"Iowa","Keokuk County",3,59,154,82,72
050,19,107,"Iowa","Keokuk County",3,60,157,81,76
050,19,107,"Iowa","Keokuk County",3,61,156,80,76
050,19,107,"Iowa","Keokuk County",3,62,153,81,72
050,19,107,"Iowa","Keokuk County",3,63,146,78,68
050,19,107,"Iowa","Keokuk County",3,64,144,72,72
050,19,107,"Iowa","Keokuk County",3,65,154,72,82
050,19,107,"Iowa","Keokuk County",3,66,151,75,76
050,19,107,"Iowa","Keokuk County",3,67,156,85,71
050,19,107,"Iowa","Keokuk County",3,68,134,76,58
050,19,107,"Iowa","Keokuk County",3,69,119,62,57
050,19,107,"Iowa","Keokuk County",3,70,116,60,56
050,19,107,"Iowa","Keokuk County",3,71,112,60,52
050,19,107,"Iowa","Keokuk County",3,72,102,51,51
050,19,107,"Iowa","Keokuk County",3,73,107,53,54
050,19,107,"Iowa","Keokuk County",3,74,108,54,54
050,19,107,"Iowa","Keokuk County",3,75,71,33,38
050,19,107,"Iowa","Keokuk County",3,76,66,34,32
050,19,107,"Iowa","Keokuk County",3,77,74,35,39
050,19,107,"Iowa","Keokuk County",3,78,81,33,48
050,19,107,"Iowa","Keokuk County",3,79,72,28,44
050,19,107,"Iowa","Keokuk County",3,80,61,27,34
050,19,107,"Iowa","Keokuk County",3,81,59,29,30
050,19,107,"Iowa","Keokuk County",3,82,51,26,25
050,19,107,"Iowa","Keokuk County",3,83,43,22,21
050,19,107,"Iowa","Keokuk County",3,84,46,20,26
050,19,107,"Iowa","Keokuk County",3,85,306,102,204
050,19,107,"Iowa","Keokuk County",4,0,105,48,57
050,19,107,"Iowa","Keokuk County",4,1,86,43,43
050,19,107,"Iowa","Keokuk County",4,2,106,54,52
050,19,107,"Iowa","Keokuk County",4,3,106,55,51
050,19,107,"Iowa","Keokuk County",4,4,120,61,59
050,19,107,"Iowa","Keokuk County",4,5,117,63,54
050,19,107,"Iowa","Keokuk County",4,6,125,68,57
050,19,107,"Iowa","Keokuk County",4,7,123,60,63
050,19,107,"Iowa","Keokuk County",4,8,127,66,61
050,19,107,"Iowa","Keokuk County",4,9,134,76,58
050,19,107,"Iowa","Keokuk County",4,10,132,70,62
050,19,107,"Iowa","Keokuk County",4,11,120,61,59
050,19,107,"Iowa","Keokuk County",4,12,144,70,74
050,19,107,"Iowa","Keokuk County",4,13,133,70,63
050,19,107,"Iowa","Keokuk County",4,14,139,70,69
050,19,107,"Iowa","Keokuk County",4,15,143,73,70
050,19,107,"Iowa","Keokuk County",4,16,129,78,51
050,19,107,"Iowa","Keokuk County",4,17,142,83,59
050,19,107,"Iowa","Keokuk County",4,18,127,66,61
050,19,107,"Iowa","Keokuk County",4,19,94,51,43
050,19,107,"Iowa","Keokuk County",4,20,101,59,42
050,19,107,"Iowa","Keokuk County",4,21,91,50,41
050,19,107,"Iowa","Keokuk County",4,22,87,49,38
050,19,107,"Iowa","Keokuk County",4,23,104,59,45
050,19,107,"Iowa","Keokuk County",4,24,100,54,46
050,19,107,"Iowa","Keokuk County",4,25,89,49,40
050,19,107,"Iowa","Keokuk County",4,26,115,61,54
050,19,107,"Iowa","Keokuk County",4,27,95,49,46
050,19,107,"Iowa","Keokuk County",4,28,97,47,50
050,19,107,"Iowa","Keokuk County",4,29,125,67,58
050,19,107,"Iowa","Keokuk County",4,30,120,63,57
050,19,107,"Iowa","Keokuk County",4,31,99,44,55
050,19,107,"Iowa","Keokuk County",4,32,111,55,56
050,19,107,"Iowa","Keokuk County",4,33,107,62,45
050,19,107,"Iowa","Keokuk County",4,34,102,55,47
050,19,107,"Iowa","Keokuk County",4,35,86,41,45
050,19,107,"Iowa","Keokuk County",4,36,104,51,53
050,19,107,"Iowa","Keokuk County",4,37,124,60,64
050,19,107,"Iowa","Keokuk County",4,38,133,67,66
050,19,107,"Iowa","Keokuk County",4,39,121,61,60
050,19,107,"Iowa","Keokuk County",4,40,117,61,56
050,19,107,"Iowa","Keokuk County",4,41,119,64,55
050,19,107,"Iowa","Keokuk County",4,42,136,68,68
050,19,107,"Iowa","Keokuk County",4,43,113,61,52
050,19,107,"Iowa","Keokuk County",4,44,126,66,60
050,19,107,"Iowa","Keokuk County",4,45,120,63,57
050,19,107,"Iowa","Keokuk County",4,46,95,44,51
050,19,107,"Iowa","Keokuk County",4,47,106,54,52
050,19,107,"Iowa","Keokuk County",4,48,97,58,39
050,19,107,"Iowa","Keokuk County",4,49,90,49,41
050,19,107,"Iowa","Keokuk County",4,50,116,54,62
050,19,107,"Iowa","Keokuk County",4,51,134,68,66
050,19,107,"Iowa","Keokuk County",4,52,114,58,56
050,19,107,"Iowa","Keokuk County",4,53,111,57,54
050,19,107,"Iowa","Keokuk County",4,54,114,58,56
050,19,107,"Iowa","Keokuk County",4,55,110,56,54
050,19,107,"Iowa","Keokuk County",4,56,123,64,59
050,19,107,"Iowa","Keokuk County",4,57,126,63,63
050,19,107,"Iowa","Keokuk County",4,58,135,64,71
050,19,107,"Iowa","Keokuk County",4,59,145,69,76
050,19,107,"Iowa","Keokuk County",4,60,154,83,71
050,19,107,"Iowa","Keokuk County",4,61,152,76,76
050,19,107,"Iowa","Keokuk County",4,62,150,79,71
050,19,107,"Iowa","Keokuk County",4,63,154,82,72
050,19,107,"Iowa","Keokuk County",4,64,154,83,71
050,19,107,"Iowa","Keokuk County",4,65,138,72,66
050,19,107,"Iowa","Keokuk County",4,66,152,70,82
050,19,107,"Iowa","Keokuk County",4,67,150,76,74
050,19,107,"Iowa","Keokuk County",4,68,152,84,68
050,19,107,"Iowa","Keokuk County",4,69,135,73,62
050,19,107,"Iowa","Keokuk County",4,70,116,63,53
050,19,107,"Iowa","Keokuk County",4,71,115,61,54
050,19,107,"Iowa","Keokuk County",4,72,104,56,48
050,19,107,"Iowa","Keokuk County",4,73,98,50,48
050,19,107,"Iowa","Keokuk County",4,74,107,51,56
050,19,107,"Iowa","Keokuk County",4,75,107,52,55
050,19,107,"Iowa","Keokuk County",4,76,70,32,38
050,19,107,"Iowa","Keokuk County",4,77,67,33,34
050,19,107,"Iowa","Keokuk County",4,78,68,36,32
050,19,107,"Iowa","Keokuk County",4,79,75,30,45
050,19,107,"Iowa","Keokuk County",4,80,65,23,42
050,19,107,"Iowa","Keokuk County",4,81,59,26,33
050,19,107,"Iowa","Keokuk County",4,82,53,26,27
050,19,107,"Iowa","Keokuk County",4,83,45,23,22
050,19,107,"Iowa","Keokuk County",4,84,37,19,18
050,19,107,"Iowa","Keokuk County",4,85,296,99,197
050,19,107,"Iowa","Keokuk County",5,0,108,49,59
050,19,107,"Iowa","Keokuk County",5,1,112,55,57
050,19,107,"Iowa","Keokuk County",5,2,91,43,48
050,19,107,"Iowa","Keokuk County",5,3,110,59,51
050,19,107,"Iowa","Keokuk County",5,4,112,57,55
050,19,107,"Iowa","Keokuk County",5,5,125,64,61
050,19,107,"Iowa","Keokuk County",5,6,114,66,48
050,19,107,"Iowa","Keokuk County",5,7,130,70,60
050,19,107,"Iowa","Keokuk County",5,8,121,59,62
050,19,107,"Iowa","Keokuk County",5,9,128,70,58
050,19,107,"Iowa","Keokuk County",5,10,135,74,61
050,19,107,"Iowa","Keokuk County",5,11,135,68,67
050,19,107,"Iowa","Keokuk County",5,12,123,56,67
050,19,107,"Iowa","Keokuk County",5,13,138,62,76
050,19,107,"Iowa","Keokuk County",5,14,133,66,67
050,19,107,"Iowa","Keokuk County",5,15,139,73,66
050,19,107,"Iowa","Keokuk County",5,16,136,70,66
050,19,107,"Iowa","Keokuk County",5,17,130,75,55
050,19,107,"Iowa","Keokuk County",5,18,114,67,47
050,19,107,"Iowa","Keokuk County",5,19,92,50,42
050,19,107,"Iowa","Keokuk County",5,20,105,58,47
050,19,107,"Iowa","Keokuk County",5,21,117,67,50
050,19,107,"Iowa","Keokuk County",5,22,99,53,46
050,19,107,"Iowa","Keokuk County",5,23,94,54,40
050,19,107,"Iowa","Keokuk County",5,24,98,58,40
050,19,107,"Iowa","Keokuk County",5,25,102,52,50
050,19,107,"Iowa","Keokuk County",5,26,93,49,44
050,19,107,"Iowa","Keokuk County",5,27,112,53,59
050,19,107,"Iowa","Keokuk County",5,28,106,54,52
050,19,107,"Iowa","Keokuk County",5,29,104,49,55
050,19,107,"Iowa","Keokuk County",5,30,108,57,51
050,19,107,"Iowa","Keokuk County",5,31,123,69,54
050,19,107,"Iowa","Keokuk County",5,32,110,49,61
050,19,107,"Iowa","Keokuk County",5,33,119,60,59
050,19,107,"Iowa","Keokuk County",5,34,102,58,44
050,19,107,"Iowa","Keokuk County",5,35,108,57,51
050,19,107,"Iowa","Keokuk County",5,36,85,42,43
050,19,107,"Iowa","Keokuk County",5,37,108,51,57
050,19,107,"Iowa","Keokuk County",5,38,125,58,67
050,19,107,"Iowa","Keokuk County",5,39,132,68,64
050,19,107,"Iowa","Keokuk County",5,40,116,57,59
050,19,107,"Iowa","Keokuk County",5,41,122,64,58
050,19,107,"Iowa","Keokuk County",5,42,121,66,55
050,19,107,"Iowa","Keokuk County",5,43,134,65,69
050,19,107,"Iowa","Keokuk County",5,44,111,60,51
050,19,107,"Iowa","Keokuk County",5,45,133,70,63
050,19,107,"Iowa","Keokuk County",5,46,122,61,61
050,19,107,"Iowa","Keokuk County",5,47,97,45,52
050,19,107,"Iowa","Keokuk County",5,48,108,56,52
050,19,107,"Iowa","Keokuk County",5,49,97,56,41
050,19,107,"Iowa","Keokuk County",5,50,98,49,49
050,19,107,"Iowa","Keokuk County",5,51,117,57,60
050,19,107,"Iowa","Keokuk County",5,52,131,68,63
050,19,107,"Iowa","Keokuk County",5,53,108,57,51
050,19,107,"Iowa","Keokuk County",5,54,111,56,55
050,19,107,"Iowa","Keokuk County",5,55,118,60,58
050,19,107,"Iowa","Keokuk County",5,56,117,59,58
050,19,107,"Iowa","Keokuk County",5,57,123,65,58
050,19,107,"Iowa","Keokuk County",5,58,129,65,64
050,19,107,"Iowa","Keokuk County",5,59,136,65,71
050,19,107,"Iowa","Keokuk County",5,60,149,70,79
050,19,107,"Iowa","Keokuk County",5,61,154,84,70
050,19,107,"Iowa","Keokuk County",5,62,150,76,74
050,19,107,"Iowa","Keokuk County",5,63,150,80,70
050,19,107,"Iowa","Keokuk County",5,64,156,83,73
050,19,107,"Iowa","Keokuk County",5,65,153,84,69
050,19,107,"Iowa","Keokuk County",5,66,129,68,61
050,19,107,"Iowa","Keokuk County",5,67,150,71,79
050,19,107,"Iowa","Keokuk County",5,68,145,72,73
050,19,107,"Iowa","Keokuk County",5,69,150,81,69
050,19,107,"Iowa","Keokuk County",5,70,130,72,58
050,19,107,"Iowa","Keokuk County",5,71,116,64,52
050,19,107,"Iowa","Keokuk County",5,72,110,59,51
050,19,107,"Iowa","Keokuk County",5,73,103,55,48
050,19,107,"Iowa","Keokuk County",5,74,93,46,47
050,19,107,"Iowa","Keokuk County",5,75,99,45,54
050,19,107,"Iowa","Keokuk County",5,76,103,50,53
050,19,107,"Iowa","Keokuk County",5,77,70,31,39
050,19,107,"Iowa","Keokuk County",5,78,63,32,31
050,19,107,"Iowa","Keokuk County",5,79,66,33,33
050,19,107,"Iowa","Keokuk County",5,80,69,26,43
050,19,107,"Iowa","Keokuk County",5,81,60,20,40
050,19,107,"Iowa","Keokuk County",5,82,55,25,30
050,19,107,"Iowa","Keokuk County",5,83,48,25,23
050,19,107,"Iowa","Keokuk County",5,84,39,18,21
050,19,107,"Iowa","Keokuk County",5,85,279,94,185
050,19,109,"Iowa","Kossuth County",1,0,173,90,83
050,19,109,"Iowa","Kossuth County",1,1,175,94,81
050,19,109,"Iowa","Kossuth County",1,2,174,93,81
050,19,109,"Iowa","Kossuth County",1,3,167,80,87
050,19,109,"Iowa","Kossuth County",1,4,165,86,79
050,19,109,"Iowa","Kossuth County",1,5,181,99,82
050,19,109,"Iowa","Kossuth County",1,6,167,84,83
050,19,109,"Iowa","Kossuth County",1,7,165,87,78
050,19,109,"Iowa","Kossuth County",1,8,168,90,78
050,19,109,"Iowa","Kossuth County",1,9,173,92,81
050,19,109,"Iowa","Kossuth County",1,10,193,117,76
050,19,109,"Iowa","Kossuth County",1,11,184,104,80
050,19,109,"Iowa","Kossuth County",1,12,196,104,92
050,19,109,"Iowa","Kossuth County",1,13,211,111,100
050,19,109,"Iowa","Kossuth County",1,14,213,118,95
050,19,109,"Iowa","Kossuth County",1,15,201,96,105
050,19,109,"Iowa","Kossuth County",1,16,194,90,104
050,19,109,"Iowa","Kossuth County",1,17,205,103,102
050,19,109,"Iowa","Kossuth County",1,18,162,86,76
050,19,109,"Iowa","Kossuth County",1,19,127,67,60
050,19,109,"Iowa","Kossuth County",1,20,136,68,68
050,19,109,"Iowa","Kossuth County",1,21,137,72,65
050,19,109,"Iowa","Kossuth County",1,22,146,67,79
050,19,109,"Iowa","Kossuth County",1,23,137,67,70
050,19,109,"Iowa","Kossuth County",1,24,140,75,65
050,19,109,"Iowa","Kossuth County",1,25,153,83,70
050,19,109,"Iowa","Kossuth County",1,26,154,77,77
050,19,109,"Iowa","Kossuth County",1,27,149,76,73
050,19,109,"Iowa","Kossuth County",1,28,149,82,67
050,19,109,"Iowa","Kossuth County",1,29,144,73,71
050,19,109,"Iowa","Kossuth County",1,30,148,77,71
050,19,109,"Iowa","Kossuth County",1,31,155,79,76
050,19,109,"Iowa","Kossuth County",1,32,152,82,70
050,19,109,"Iowa","Kossuth County",1,33,146,82,64
050,19,109,"Iowa","Kossuth County",1,34,148,75,73
050,19,109,"Iowa","Kossuth County",1,35,172,83,89
050,19,109,"Iowa","Kossuth County",1,36,160,90,70
050,19,109,"Iowa","Kossuth County",1,37,170,81,89
050,19,109,"Iowa","Kossuth County",1,38,175,82,93
050,19,109,"Iowa","Kossuth County",1,39,176,89,87
050,19,109,"Iowa","Kossuth County",1,40,150,81,69
050,19,109,"Iowa","Kossuth County",1,41,159,83,76
050,19,109,"Iowa","Kossuth County",1,42,159,90,69
050,19,109,"Iowa","Kossuth County",1,43,145,74,71
050,19,109,"Iowa","Kossuth County",1,44,131,62,69
050,19,109,"Iowa","Kossuth County",1,45,130,69,61
050,19,109,"Iowa","Kossuth County",1,46,136,68,68
050,19,109,"Iowa","Kossuth County",1,47,153,80,73
050,19,109,"Iowa","Kossuth County",1,48,139,64,75
050,19,109,"Iowa","Kossuth County",1,49,152,81,71
050,19,109,"Iowa","Kossuth County",1,50,156,79,77
050,19,109,"Iowa","Kossuth County",1,51,147,78,69
050,19,109,"Iowa","Kossuth County",1,52,147,72,75
050,19,109,"Iowa","Kossuth County",1,53,166,82,84
050,19,109,"Iowa","Kossuth County",1,54,183,90,93
050,19,109,"Iowa","Kossuth County",1,55,197,102,95
050,19,109,"Iowa","Kossuth County",1,56,200,108,92
050,19,109,"Iowa","Kossuth County",1,57,234,124,110
050,19,109,"Iowa","Kossuth County",1,58,247,132,115
050,19,109,"Iowa","Kossuth County",1,59,244,128,116
050,19,109,"Iowa","Kossuth County",1,60,241,133,108
050,19,109,"Iowa","Kossuth County",1,61,257,130,127
050,19,109,"Iowa","Kossuth County",1,62,241,122,119
050,19,109,"Iowa","Kossuth County",1,63,235,135,100
050,19,109,"Iowa","Kossuth County",1,64,236,130,106
050,19,109,"Iowa","Kossuth County",1,65,228,119,109
050,19,109,"Iowa","Kossuth County",1,66,218,112,106
050,19,109,"Iowa","Kossuth County",1,67,213,105,108
050,19,109,"Iowa","Kossuth County",1,68,208,98,110
050,19,109,"Iowa","Kossuth County",1,69,169,85,84
050,19,109,"Iowa","Kossuth County",1,70,171,89,82
050,19,109,"Iowa","Kossuth County",1,71,186,87,99
050,19,109,"Iowa","Kossuth County",1,72,160,77,83
050,19,109,"Iowa","Kossuth County",1,73,168,81,87
050,19,109,"Iowa","Kossuth County",1,74,130,66,64
050,19,109,"Iowa","Kossuth County",1,75,121,61,60
050,19,109,"Iowa","Kossuth County",1,76,119,57,62
050,19,109,"Iowa","Kossuth County",1,77,127,58,69
050,19,109,"Iowa","Kossuth County",1,78,106,42,64
050,19,109,"Iowa","Kossuth County",1,79,115,53,62
050,19,109,"Iowa","Kossuth County",1,80,112,47,65
050,19,109,"Iowa","Kossuth County",1,81,121,57,64
050,19,109,"Iowa","Kossuth County",1,82,100,45,55
050,19,109,"Iowa","Kossuth County",1,83,97,45,52
050,19,109,"Iowa","Kossuth County",1,84,104,48,56
050,19,109,"Iowa","Kossuth County",1,85,627,233,394
050,19,109,"Iowa","Kossuth County",2,0,164,85,79
050,19,109,"Iowa","Kossuth County",2,1,172,92,80
050,19,109,"Iowa","Kossuth County",2,2,174,93,81
050,19,109,"Iowa","Kossuth County",2,3,167,82,85
050,19,109,"Iowa","Kossuth County",2,4,166,85,81
050,19,109,"Iowa","Kossuth County",2,5,178,97,81
050,19,109,"Iowa","Kossuth County",2,6,173,89,84
050,19,109,"Iowa","Kossuth County",2,7,164,85,79
050,19,109,"Iowa","Kossuth County",2,8,165,87,78
050,19,109,"Iowa","Kossuth County",2,9,174,93,81
050,19,109,"Iowa","Kossuth County",2,10,186,109,77
050,19,109,"Iowa","Kossuth County",2,11,185,107,78
050,19,109,"Iowa","Kossuth County",2,12,194,104,90
050,19,109,"Iowa","Kossuth County",2,13,206,109,97
050,19,109,"Iowa","Kossuth County",2,14,213,117,96
050,19,109,"Iowa","Kossuth County",2,15,202,100,102
050,19,109,"Iowa","Kossuth County",2,16,194,91,103
050,19,109,"Iowa","Kossuth County",2,17,204,102,102
050,19,109,"Iowa","Kossuth County",2,18,162,86,76
050,19,109,"Iowa","Kossuth County",2,19,128,69,59
050,19,109,"Iowa","Kossuth County",2,20,137,69,68
050,19,109,"Iowa","Kossuth County",2,21,137,71,66
050,19,109,"Iowa","Kossuth County",2,22,143,67,76
050,19,109,"Iowa","Kossuth County",2,23,139,67,72
050,19,109,"Iowa","Kossuth County",2,24,139,73,66
050,19,109,"Iowa","Kossuth County",2,25,150,80,70
050,19,109,"Iowa","Kossuth County",2,26,152,78,74
050,19,109,"Iowa","Kossuth County",2,27,150,77,73
050,19,109,"Iowa","Kossuth County",2,28,148,79,69
050,19,109,"Iowa","Kossuth County",2,29,146,76,70
050,19,109,"Iowa","Kossuth County",2,30,150,77,73
050,19,109,"Iowa","Kossuth County",2,31,152,77,75
050,19,109,"Iowa","Kossuth County",2,32,153,82,71
050,19,109,"Iowa","Kossuth County",2,33,147,82,65
050,19,109,"Iowa","Kossuth County",2,34,148,77,71
050,19,109,"Iowa","Kossuth County",2,35,167,81,86
050,19,109,"Iowa","Kossuth County",2,36,162,88,74
050,19,109,"Iowa","Kossuth County",2,37,168,83,85
050,19,109,"Iowa","Kossuth County",2,38,176,82,94
050,19,109,"Iowa","Kossuth County",2,39,172,86,86
050,19,109,"Iowa","Kossuth County",2,40,157,83,74
050,19,109,"Iowa","Kossuth County",2,41,159,84,75
050,19,109,"Iowa","Kossuth County",2,42,159,88,71
050,19,109,"Iowa","Kossuth County",2,43,148,78,70
050,19,109,"Iowa","Kossuth County",2,44,134,65,69
050,19,109,"Iowa","Kossuth County",2,45,130,67,63
050,19,109,"Iowa","Kossuth County",2,46,135,69,66
050,19,109,"Iowa","Kossuth County",2,47,149,76,73
050,19,109,"Iowa","Kossuth County",2,48,142,67,75
050,19,109,"Iowa","Kossuth County",2,49,149,77,72
050,19,109,"Iowa","Kossuth County",2,50,155,79,76
050,19,109,"Iowa","Kossuth County",2,51,150,80,70
050,19,109,"Iowa","Kossuth County",2,52,145,72,73
050,19,109,"Iowa","Kossuth County",2,53,162,80,82
050,19,109,"Iowa","Kossuth County",2,54,180,89,91
050,19,109,"Iowa","Kossuth County",2,55,192,99,93
050,19,109,"Iowa","Kossuth County",2,56,198,107,91
050,19,109,"Iowa","Kossuth County",2,57,226,120,106
050,19,109,"Iowa","Kossuth County",2,58,244,129,115
050,19,109,"Iowa","Kossuth County",2,59,244,130,114
050,19,109,"Iowa","Kossuth County",2,60,241,132,109
050,19,109,"Iowa","Kossuth County",2,61,254,130,124
050,19,109,"Iowa","Kossuth County",2,62,245,124,121
050,19,109,"Iowa","Kossuth County",2,63,240,134,106
050,19,109,"Iowa","Kossuth County",2,64,233,130,103
050,19,109,"Iowa","Kossuth County",2,65,229,121,108
050,19,109,"Iowa","Kossuth County",2,66,221,114,107
050,19,109,"Iowa","Kossuth County",2,67,214,106,108
050,19,109,"Iowa","Kossuth County",2,68,207,99,108
050,19,109,"Iowa","Kossuth County",2,69,178,88,90
050,19,109,"Iowa","Kossuth County",2,70,169,86,83
050,19,109,"Iowa","Kossuth County",2,71,182,87,95
050,19,109,"Iowa","Kossuth County",2,72,161,77,84
050,19,109,"Iowa","Kossuth County",2,73,174,83,91
050,19,109,"Iowa","Kossuth County",2,74,130,66,64
050,19,109,"Iowa","Kossuth County",2,75,125,63,62
050,19,109,"Iowa","Kossuth County",2,76,118,57,61
050,19,109,"Iowa","Kossuth County",2,77,128,59,69
050,19,109,"Iowa","Kossuth County",2,78,109,45,64
050,19,109,"Iowa","Kossuth County",2,79,112,50,62
050,19,109,"Iowa","Kossuth County",2,80,110,46,64
050,19,109,"Iowa","Kossuth County",2,81,119,54,65
050,19,109,"Iowa","Kossuth County",2,82,105,48,57
050,19,109,"Iowa","Kossuth County",2,83,95,44,51
050,19,109,"Iowa","Kossuth County",2,84,102,47,55
050,19,109,"Iowa","Kossuth County",2,85,633,235,398
050,19,109,"Iowa","Kossuth County",3,0,164,83,81
050,19,109,"Iowa","Kossuth County",3,1,168,86,82
050,19,109,"Iowa","Kossuth County",3,2,169,89,80
050,19,109,"Iowa","Kossuth County",3,3,169,90,79
050,19,109,"Iowa","Kossuth County",3,4,163,82,81
050,19,109,"Iowa","Kossuth County",3,5,162,81,81
050,19,109,"Iowa","Kossuth County",3,6,179,98,81
050,19,109,"Iowa","Kossuth County",3,7,165,84,81
050,19,109,"Iowa","Kossuth County",3,8,151,83,68
050,19,109,"Iowa","Kossuth County",3,9,163,87,76
050,19,109,"Iowa","Kossuth County",3,10,171,87,84
050,19,109,"Iowa","Kossuth County",3,11,176,101,75
050,19,109,"Iowa","Kossuth County",3,12,186,108,78
050,19,109,"Iowa","Kossuth County",3,13,187,105,82
050,19,109,"Iowa","Kossuth County",3,14,199,103,96
050,19,109,"Iowa","Kossuth County",3,15,209,112,97
050,19,109,"Iowa","Kossuth County",3,16,191,95,96
050,19,109,"Iowa","Kossuth County",3,17,203,98,105
050,19,109,"Iowa","Kossuth County",3,18,173,91,82
050,19,109,"Iowa","Kossuth County",3,19,125,65,60
050,19,109,"Iowa","Kossuth County",3,20,136,71,65
050,19,109,"Iowa","Kossuth County",3,21,140,76,64
050,19,109,"Iowa","Kossuth County",3,22,143,73,70
050,19,109,"Iowa","Kossuth County",3,23,130,64,66
050,19,109,"Iowa","Kossuth County",3,24,142,75,67
050,19,109,"Iowa","Kossuth County",3,25,139,69,70
050,19,109,"Iowa","Kossuth County",3,26,157,90,67
050,19,109,"Iowa","Kossuth County",3,27,143,82,61
050,19,109,"Iowa","Kossuth County",3,28,132,74,58
050,19,109,"Iowa","Kossuth County",3,29,148,83,65
050,19,109,"Iowa","Kossuth County",3,30,149,77,72
050,19,109,"Iowa","Kossuth County",3,31,157,80,77
050,19,109,"Iowa","Kossuth County",3,32,146,73,73
050,19,109,"Iowa","Kossuth County",3,33,152,82,70
050,19,109,"Iowa","Kossuth County",3,34,150,85,65
050,19,109,"Iowa","Kossuth County",3,35,144,76,68
050,19,109,"Iowa","Kossuth County",3,36,171,78,93
050,19,109,"Iowa","Kossuth County",3,37,163,90,73
050,19,109,"Iowa","Kossuth County",3,38,158,76,82
050,19,109,"Iowa","Kossuth County",3,39,168,82,86
050,19,109,"Iowa","Kossuth County",3,40,165,83,82
050,19,109,"Iowa","Kossuth County",3,41,166,86,80
050,19,109,"Iowa","Kossuth County",3,42,156,80,76
050,19,109,"Iowa","Kossuth County",3,43,148,77,71
050,19,109,"Iowa","Kossuth County",3,44,148,82,66
050,19,109,"Iowa","Kossuth County",3,45,133,66,67
050,19,109,"Iowa","Kossuth County",3,46,132,71,61
050,19,109,"Iowa","Kossuth County",3,47,134,69,65
050,19,109,"Iowa","Kossuth County",3,48,151,74,77
050,19,109,"Iowa","Kossuth County",3,49,137,66,71
050,19,109,"Iowa","Kossuth County",3,50,157,82,75
050,19,109,"Iowa","Kossuth County",3,51,143,75,68
050,19,109,"Iowa","Kossuth County",3,52,147,77,70
050,19,109,"Iowa","Kossuth County",3,53,147,76,71
050,19,109,"Iowa","Kossuth County",3,54,167,83,84
050,19,109,"Iowa","Kossuth County",3,55,177,86,91
050,19,109,"Iowa","Kossuth County",3,56,195,101,94
050,19,109,"Iowa","Kossuth County",3,57,199,107,92
050,19,109,"Iowa","Kossuth County",3,58,219,112,107
050,19,109,"Iowa","Kossuth County",3,59,241,133,108
050,19,109,"Iowa","Kossuth County",3,60,234,126,108
050,19,109,"Iowa","Kossuth County",3,61,232,124,108
050,19,109,"Iowa","Kossuth County",3,62,245,123,122
050,19,109,"Iowa","Kossuth County",3,63,240,122,118
050,19,109,"Iowa","Kossuth County",3,64,230,130,100
050,19,109,"Iowa","Kossuth County",3,65,233,132,101
050,19,109,"Iowa","Kossuth County",3,66,218,114,104
050,19,109,"Iowa","Kossuth County",3,67,213,107,106
050,19,109,"Iowa","Kossuth County",3,68,204,104,100
050,19,109,"Iowa","Kossuth County",3,69,197,96,101
050,19,109,"Iowa","Kossuth County",3,70,170,83,87
050,19,109,"Iowa","Kossuth County",3,71,167,86,81
050,19,109,"Iowa","Kossuth County",3,72,176,82,94
050,19,109,"Iowa","Kossuth County",3,73,153,71,82
050,19,109,"Iowa","Kossuth County",3,74,164,81,83
050,19,109,"Iowa","Kossuth County",3,75,127,65,62
050,19,109,"Iowa","Kossuth County",3,76,119,56,63
050,19,109,"Iowa","Kossuth County",3,77,120,56,64
050,19,109,"Iowa","Kossuth County",3,78,121,56,65
050,19,109,"Iowa","Kossuth County",3,79,108,47,61
050,19,109,"Iowa","Kossuth County",3,80,105,42,63
050,19,109,"Iowa","Kossuth County",3,81,105,46,59
050,19,109,"Iowa","Kossuth County",3,82,109,49,60
050,19,109,"Iowa","Kossuth County",3,83,92,44,48
050,19,109,"Iowa","Kossuth County",3,84,92,39,53
050,19,109,"Iowa","Kossuth County",3,85,638,237,401
050,19,109,"Iowa","Kossuth County",4,0,163,78,85
050,19,109,"Iowa","Kossuth County",4,1,162,85,77
050,19,109,"Iowa","Kossuth County",4,2,172,86,86
050,19,109,"Iowa","Kossuth County",4,3,171,86,85
050,19,109,"Iowa","Kossuth County",4,4,169,91,78
050,19,109,"Iowa","Kossuth County",4,5,166,85,81
050,19,109,"Iowa","Kossuth County",4,6,174,90,84
050,19,109,"Iowa","Kossuth County",4,7,184,103,81
050,19,109,"Iowa","Kossuth County",4,8,176,87,89
050,19,109,"Iowa","Kossuth County",4,9,158,87,71
050,19,109,"Iowa","Kossuth County",4,10,157,81,76
050,19,109,"Iowa","Kossuth County",4,11,170,89,81
050,19,109,"Iowa","Kossuth County",4,12,183,105,78
050,19,109,"Iowa","Kossuth County",4,13,189,110,79
050,19,109,"Iowa","Kossuth County",4,14,194,104,90
050,19,109,"Iowa","Kossuth County",4,15,209,107,102
050,19,109,"Iowa","Kossuth County",4,16,215,111,104
050,19,109,"Iowa","Kossuth County",4,17,205,104,101
050,19,109,"Iowa","Kossuth County",4,18,170,85,85
050,19,109,"Iowa","Kossuth County",4,19,131,68,63
050,19,109,"Iowa","Kossuth County",4,20,123,60,63
050,19,109,"Iowa","Kossuth County",4,21,145,77,68
050,19,109,"Iowa","Kossuth County",4,22,149,78,71
050,19,109,"Iowa","Kossuth County",4,23,136,71,65
050,19,109,"Iowa","Kossuth County",4,24,135,67,68
050,19,109,"Iowa","Kossuth County",4,25,154,83,71
050,19,109,"Iowa","Kossuth County",4,26,145,71,74
050,19,109,"Iowa","Kossuth County",4,27,145,81,64
050,19,109,"Iowa","Kossuth County",4,28,133,76,57
050,19,109,"Iowa","Kossuth County",4,29,133,75,58
050,19,109,"Iowa","Kossuth County",4,30,147,81,66
050,19,109,"Iowa","Kossuth County",4,31,150,81,69
050,19,109,"Iowa","Kossuth County",4,32,147,73,74
050,19,109,"Iowa","Kossuth County",4,33,146,69,77
050,19,109,"Iowa","Kossuth County",4,34,150,84,66
050,19,109,"Iowa","Kossuth County",4,35,152,86,66
050,19,109,"Iowa","Kossuth County",4,36,149,76,73
050,19,109,"Iowa","Kossuth County",4,37,168,72,96
050,19,109,"Iowa","Kossuth County",4,38,170,95,75
050,19,109,"Iowa","Kossuth County",4,39,160,79,81
050,19,109,"Iowa","Kossuth County",4,40,167,80,87
050,19,109,"Iowa","Kossuth County",4,41,172,85,87
050,19,109,"Iowa","Kossuth County",4,42,180,92,88
050,19,109,"Iowa","Kossuth County",4,43,156,77,79
050,19,109,"Iowa","Kossuth County",4,44,150,81,69
050,19,109,"Iowa","Kossuth County",4,45,154,83,71
050,19,109,"Iowa","Kossuth County",4,46,138,70,68
050,19,109,"Iowa","Kossuth County",4,47,122,63,59
050,19,109,"Iowa","Kossuth County",4,48,128,66,62
050,19,109,"Iowa","Kossuth County",4,49,141,69,72
050,19,109,"Iowa","Kossuth County",4,50,136,70,66
050,19,109,"Iowa","Kossuth County",4,51,153,77,76
050,19,109,"Iowa","Kossuth County",4,52,144,75,69
050,19,109,"Iowa","Kossuth County",4,53,141,75,66
050,19,109,"Iowa","Kossuth County",4,54,152,75,77
050,19,109,"Iowa","Kossuth County",4,55,161,81,80
050,19,109,"Iowa","Kossuth County",4,56,175,86,89
050,19,109,"Iowa","Kossuth County",4,57,195,102,93
050,19,109,"Iowa","Kossuth County",4,58,197,108,89
050,19,109,"Iowa","Kossuth County",4,59,216,113,103
050,19,109,"Iowa","Kossuth County",4,60,242,135,107
050,19,109,"Iowa","Kossuth County",4,61,231,121,110
050,19,109,"Iowa","Kossuth County",4,62,226,122,104
050,19,109,"Iowa","Kossuth County",4,63,246,124,122
050,19,109,"Iowa","Kossuth County",4,64,239,124,115
050,19,109,"Iowa","Kossuth County",4,65,228,130,98
050,19,109,"Iowa","Kossuth County",4,66,230,129,101
050,19,109,"Iowa","Kossuth County",4,67,212,111,101
050,19,109,"Iowa","Kossuth County",4,68,206,105,101
050,19,109,"Iowa","Kossuth County",4,69,199,103,96
050,19,109,"Iowa","Kossuth County",4,70,192,93,99
050,19,109,"Iowa","Kossuth County",4,71,174,85,89
050,19,109,"Iowa","Kossuth County",4,72,162,81,81
050,19,109,"Iowa","Kossuth County",4,73,166,76,90
050,19,109,"Iowa","Kossuth County",4,74,145,73,72
050,19,109,"Iowa","Kossuth County",4,75,157,77,80
050,19,109,"Iowa","Kossuth County",4,76,123,62,61
050,19,109,"Iowa","Kossuth County",4,77,113,53,60
050,19,109,"Iowa","Kossuth County",4,78,111,52,59
050,19,109,"Iowa","Kossuth County",4,79,117,57,60
050,19,109,"Iowa","Kossuth County",4,80,94,35,59
050,19,109,"Iowa","Kossuth County",4,81,104,40,64
050,19,109,"Iowa","Kossuth County",4,82,97,44,53
050,19,109,"Iowa","Kossuth County",4,83,100,47,53
050,19,109,"Iowa","Kossuth County",4,84,89,36,53
050,19,109,"Iowa","Kossuth County",4,85,629,235,394
050,19,109,"Iowa","Kossuth County",5,0,164,78,86
050,19,109,"Iowa","Kossuth County",5,1,166,79,87
050,19,109,"Iowa","Kossuth County",5,2,173,90,83
050,19,109,"Iowa","Kossuth County",5,3,174,86,88
050,19,109,"Iowa","Kossuth County",5,4,171,86,85
050,19,109,"Iowa","Kossuth County",5,5,173,93,80
050,19,109,"Iowa","Kossuth County",5,6,160,81,79
050,19,109,"Iowa","Kossuth County",5,7,170,87,83
050,19,109,"Iowa","Kossuth County",5,8,183,103,80
050,19,109,"Iowa","Kossuth County",5,9,171,87,84
050,19,109,"Iowa","Kossuth County",5,10,166,87,79
050,19,109,"Iowa","Kossuth County",5,11,162,85,77
050,19,109,"Iowa","Kossuth County",5,12,165,87,78
050,19,109,"Iowa","Kossuth County",5,13,182,102,80
050,19,109,"Iowa","Kossuth County",5,14,189,111,78
050,19,109,"Iowa","Kossuth County",5,15,196,105,91
050,19,109,"Iowa","Kossuth County",5,16,205,103,102
050,19,109,"Iowa","Kossuth County",5,17,218,113,105
050,19,109,"Iowa","Kossuth County",5,18,170,89,81
050,19,109,"Iowa","Kossuth County",5,19,137,68,69
050,19,109,"Iowa","Kossuth County",5,20,148,71,77
050,19,109,"Iowa","Kossuth County",5,21,137,63,74
050,19,109,"Iowa","Kossuth County",5,22,155,86,69
050,19,109,"Iowa","Kossuth County",5,23,143,79,64
050,19,109,"Iowa","Kossuth County",5,24,111,59,52
050,19,109,"Iowa","Kossuth County",5,25,150,71,79
050,19,109,"Iowa","Kossuth County",5,26,154,74,80
050,19,109,"Iowa","Kossuth County",5,27,151,78,73
050,19,109,"Iowa","Kossuth County",5,28,133,77,56
050,19,109,"Iowa","Kossuth County",5,29,129,74,55
050,19,109,"Iowa","Kossuth County",5,30,132,71,61
050,19,109,"Iowa","Kossuth County",5,31,146,78,68
050,19,109,"Iowa","Kossuth County",5,32,157,83,74
050,19,109,"Iowa","Kossuth County",5,33,152,73,79
050,19,109,"Iowa","Kossuth County",5,34,142,68,74
050,19,109,"Iowa","Kossuth County",5,35,146,82,64
050,19,109,"Iowa","Kossuth County",5,36,152,84,68
050,19,109,"Iowa","Kossuth County",5,37,151,73,78
050,19,109,"Iowa","Kossuth County",5,38,166,74,92
050,19,109,"Iowa","Kossuth County",5,39,173,99,74
050,19,109,"Iowa","Kossuth County",5,40,161,79,82
050,19,109,"Iowa","Kossuth County",5,41,162,74,88
050,19,109,"Iowa","Kossuth County",5,42,177,89,88
050,19,109,"Iowa","Kossuth County",5,43,171,86,85
050,19,109,"Iowa","Kossuth County",5,44,156,80,76
050,19,109,"Iowa","Kossuth County",5,45,149,78,71
050,19,109,"Iowa","Kossuth County",5,46,158,83,75
050,19,109,"Iowa","Kossuth County",5,47,142,71,71
050,19,109,"Iowa","Kossuth County",5,48,129,62,67
050,19,109,"Iowa","Kossuth County",5,49,130,68,62
050,19,109,"Iowa","Kossuth County",5,50,149,71,78
050,19,109,"Iowa","Kossuth County",5,51,137,71,66
050,19,109,"Iowa","Kossuth County",5,52,156,80,76
050,19,109,"Iowa","Kossuth County",5,53,144,71,73
050,19,109,"Iowa","Kossuth County",5,54,143,73,70
050,19,109,"Iowa","Kossuth County",5,55,150,74,76
050,19,109,"Iowa","Kossuth County",5,56,158,79,79
050,19,109,"Iowa","Kossuth County",5,57,177,87,90
050,19,109,"Iowa","Kossuth County",5,58,197,103,94
050,19,109,"Iowa","Kossuth County",5,59,198,111,87
050,19,109,"Iowa","Kossuth County",5,60,213,109,104
050,19,109,"Iowa","Kossuth County",5,61,238,129,109
050,19,109,"Iowa","Kossuth County",5,62,225,117,108
050,19,109,"Iowa","Kossuth County",5,63,223,123,100
050,19,109,"Iowa","Kossuth County",5,64,238,117,121
050,19,109,"Iowa","Kossuth County",5,65,238,125,113
050,19,109,"Iowa","Kossuth County",5,66,216,120,96
050,19,109,"Iowa","Kossuth County",5,67,227,125,102
050,19,109,"Iowa","Kossuth County",5,68,205,107,98
050,19,109,"Iowa","Kossuth County",5,69,201,104,97
050,19,109,"Iowa","Kossuth County",5,70,192,99,93
050,19,109,"Iowa","Kossuth County",5,71,195,92,103
050,19,109,"Iowa","Kossuth County",5,72,166,79,87
050,19,109,"Iowa","Kossuth County",5,73,157,80,77
050,19,109,"Iowa","Kossuth County",5,74,156,75,81
050,19,109,"Iowa","Kossuth County",5,75,144,68,76
050,19,109,"Iowa","Kossuth County",5,76,150,73,77
050,19,109,"Iowa","Kossuth County",5,77,116,56,60
050,19,109,"Iowa","Kossuth County",5,78,103,47,56
050,19,109,"Iowa","Kossuth County",5,79,111,54,57
050,19,109,"Iowa","Kossuth County",5,80,104,46,58
050,19,109,"Iowa","Kossuth County",5,81,94,36,58
050,19,109,"Iowa","Kossuth County",5,82,96,37,59
050,19,109,"Iowa","Kossuth County",5,83,87,41,46
050,19,109,"Iowa","Kossuth County",5,84,96,39,57
050,19,109,"Iowa","Kossuth County",5,85,638,238,400
050,19,111,"Iowa","Lee County",1,0,323,166,157
050,19,111,"Iowa","Lee County",1,1,359,188,171
050,19,111,"Iowa","Lee County",1,2,404,205,199
050,19,111,"Iowa","Lee County",1,3,420,217,203
050,19,111,"Iowa","Lee County",1,4,382,201,181
050,19,111,"Iowa","Lee County",1,5,420,215,205
050,19,111,"Iowa","Lee County",1,6,416,225,191
050,19,111,"Iowa","Lee County",1,7,404,207,197
050,19,111,"Iowa","Lee County",1,8,418,213,205
050,19,111,"Iowa","Lee County",1,9,381,196,185
050,19,111,"Iowa","Lee County",1,10,411,228,183
050,19,111,"Iowa","Lee County",1,11,398,205,193
050,19,111,"Iowa","Lee County",1,12,424,210,214
050,19,111,"Iowa","Lee County",1,13,431,224,207
050,19,111,"Iowa","Lee County",1,14,381,203,178
050,19,111,"Iowa","Lee County",1,15,396,194,202
050,19,111,"Iowa","Lee County",1,16,400,189,211
050,19,111,"Iowa","Lee County",1,17,415,207,208
050,19,111,"Iowa","Lee County",1,18,347,187,160
050,19,111,"Iowa","Lee County",1,19,284,149,135
050,19,111,"Iowa","Lee County",1,20,328,177,151
050,19,111,"Iowa","Lee County",1,21,345,188,157
050,19,111,"Iowa","Lee County",1,22,367,197,170
050,19,111,"Iowa","Lee County",1,23,344,180,164
050,19,111,"Iowa","Lee County",1,24,354,173,181
050,19,111,"Iowa","Lee County",1,25,355,179,176
050,19,111,"Iowa","Lee County",1,26,369,200,169
050,19,111,"Iowa","Lee County",1,27,430,240,190
050,19,111,"Iowa","Lee County",1,28,398,216,182
050,19,111,"Iowa","Lee County",1,29,393,207,186
050,19,111,"Iowa","Lee County",1,30,390,195,195
050,19,111,"Iowa","Lee County",1,31,367,186,181
050,19,111,"Iowa","Lee County",1,32,367,187,180
050,19,111,"Iowa","Lee County",1,33,365,187,178
050,19,111,"Iowa","Lee County",1,34,400,219,181
050,19,111,"Iowa","Lee County",1,35,390,207,183
050,19,111,"Iowa","Lee County",1,36,379,200,179
050,19,111,"Iowa","Lee County",1,37,378,190,188
050,19,111,"Iowa","Lee County",1,38,422,222,200
050,19,111,"Iowa","Lee County",1,39,412,221,191
050,19,111,"Iowa","Lee County",1,40,427,233,194
050,19,111,"Iowa","Lee County",1,41,391,206,185
050,19,111,"Iowa","Lee County",1,42,420,224,196
050,19,111,"Iowa","Lee County",1,43,378,199,179
050,19,111,"Iowa","Lee County",1,44,362,194,168
050,19,111,"Iowa","Lee County",1,45,335,175,160
050,19,111,"Iowa","Lee County",1,46,360,185,175
050,19,111,"Iowa","Lee County",1,47,376,189,187
050,19,111,"Iowa","Lee County",1,48,423,208,215
050,19,111,"Iowa","Lee County",1,49,431,213,218
050,19,111,"Iowa","Lee County",1,50,403,207,196
050,19,111,"Iowa","Lee County",1,51,396,203,193
050,19,111,"Iowa","Lee County",1,52,413,220,193
050,19,111,"Iowa","Lee County",1,53,418,205,213
050,19,111,"Iowa","Lee County",1,54,449,236,213
050,19,111,"Iowa","Lee County",1,55,470,241,229
050,19,111,"Iowa","Lee County",1,56,514,266,248
050,19,111,"Iowa","Lee County",1,57,499,247,252
050,19,111,"Iowa","Lee County",1,58,533,262,271
050,19,111,"Iowa","Lee County",1,59,521,257,264
050,19,111,"Iowa","Lee County",1,60,535,275,260
050,19,111,"Iowa","Lee County",1,61,520,268,252
050,19,111,"Iowa","Lee County",1,62,516,268,248
050,19,111,"Iowa","Lee County",1,63,492,241,251
050,19,111,"Iowa","Lee County",1,64,514,254,260
050,19,111,"Iowa","Lee County",1,65,510,260,250
050,19,111,"Iowa","Lee County",1,66,492,245,247
050,19,111,"Iowa","Lee County",1,67,467,230,237
050,19,111,"Iowa","Lee County",1,68,447,209,238
050,19,111,"Iowa","Lee County",1,69,427,215,212
050,19,111,"Iowa","Lee County",1,70,410,210,200
050,19,111,"Iowa","Lee County",1,71,401,182,219
050,19,111,"Iowa","Lee County",1,72,382,177,205
050,19,111,"Iowa","Lee County",1,73,402,198,204
050,19,111,"Iowa","Lee County",1,74,272,134,138
050,19,111,"Iowa","Lee County",1,75,277,129,148
050,19,111,"Iowa","Lee County",1,76,272,119,153
050,19,111,"Iowa","Lee County",1,77,270,110,160
050,19,111,"Iowa","Lee County",1,78,218,90,128
050,19,111,"Iowa","Lee County",1,79,228,102,126
050,19,111,"Iowa","Lee County",1,80,197,84,113
050,19,111,"Iowa","Lee County",1,81,174,74,100
050,19,111,"Iowa","Lee County",1,82,162,68,94
050,19,111,"Iowa","Lee County",1,83,132,61,71
050,19,111,"Iowa","Lee County",1,84,116,41,75
050,19,111,"Iowa","Lee County",1,85,840,275,565
050,19,111,"Iowa","Lee County",2,0,322,172,150
050,19,111,"Iowa","Lee County",2,1,352,184,168
050,19,111,"Iowa","Lee County",2,2,395,202,193
050,19,111,"Iowa","Lee County",2,3,417,213,204
050,19,111,"Iowa","Lee County",2,4,395,206,189
050,19,111,"Iowa","Lee County",2,5,411,212,199
050,19,111,"Iowa","Lee County",2,6,418,221,197
050,19,111,"Iowa","Lee County",2,7,406,211,195
050,19,111,"Iowa","Lee County",2,8,413,211,202
050,19,111,"Iowa","Lee County",2,9,390,202,188
050,19,111,"Iowa","Lee County",2,10,404,220,184
050,19,111,"Iowa","Lee County",2,11,402,210,192
050,19,111,"Iowa","Lee County",2,12,424,212,212
050,19,111,"Iowa","Lee County",2,13,428,219,209
050,19,111,"Iowa","Lee County",2,14,391,208,183
050,19,111,"Iowa","Lee County",2,15,395,197,198
050,19,111,"Iowa","Lee County",2,16,401,192,209
050,19,111,"Iowa","Lee County",2,17,411,204,207
050,19,111,"Iowa","Lee County",2,18,344,183,161
050,19,111,"Iowa","Lee County",2,19,287,152,135
050,19,111,"Iowa","Lee County",2,20,326,175,151
050,19,111,"Iowa","Lee County",2,21,346,189,157
050,19,111,"Iowa","Lee County",2,22,359,193,166
050,19,111,"Iowa","Lee County",2,23,355,186,169
050,19,111,"Iowa","Lee County",2,24,349,172,177
050,19,111,"Iowa","Lee County",2,25,356,178,178
050,19,111,"Iowa","Lee County",2,26,366,195,171
050,19,111,"Iowa","Lee County",2,27,415,230,185
050,19,111,"Iowa","Lee County",2,28,406,222,184
050,19,111,"Iowa","Lee County",2,29,396,210,186
050,19,111,"Iowa","Lee County",2,30,393,198,195
050,19,111,"Iowa","Lee County",2,31,371,187,184
050,19,111,"Iowa","Lee County",2,32,366,185,181
050,19,111,"Iowa","Lee County",2,33,365,187,178
050,19,111,"Iowa","Lee County",2,34,395,212,183
050,19,111,"Iowa","Lee County",2,35,393,209,184
050,19,111,"Iowa","Lee County",2,36,380,202,178
050,19,111,"Iowa","Lee County",2,37,378,192,186
050,19,111,"Iowa","Lee County",2,38,415,216,199
050,19,111,"Iowa","Lee County",2,39,418,223,195
050,19,111,"Iowa","Lee County",2,40,425,231,194
050,19,111,"Iowa","Lee County",2,41,402,214,188
050,19,111,"Iowa","Lee County",2,42,410,219,191
050,19,111,"Iowa","Lee County",2,43,389,205,184
050,19,111,"Iowa","Lee County",2,44,363,195,168
050,19,111,"Iowa","Lee County",2,45,342,179,163
050,19,111,"Iowa","Lee County",2,46,355,183,172
050,19,111,"Iowa","Lee County",2,47,371,187,184
050,19,111,"Iowa","Lee County",2,48,409,202,207
050,19,111,"Iowa","Lee County",2,49,430,213,217
050,19,111,"Iowa","Lee County",2,50,407,204,203
050,19,111,"Iowa","Lee County",2,51,399,205,194
050,19,111,"Iowa","Lee County",2,52,408,214,194
050,19,111,"Iowa","Lee County",2,53,415,207,208
050,19,111,"Iowa","Lee County",2,54,437,225,212
050,19,111,"Iowa","Lee County",2,55,464,239,225
050,19,111,"Iowa","Lee County",2,56,506,262,244
050,19,111,"Iowa","Lee County",2,57,501,249,252
050,19,111,"Iowa","Lee County",2,58,524,258,266
050,19,111,"Iowa","Lee County",2,59,525,259,266
050,19,111,"Iowa","Lee County",2,60,526,268,258
050,19,111,"Iowa","Lee County",2,61,522,269,253
050,19,111,"Iowa","Lee County",2,62,513,265,248
050,19,111,"Iowa","Lee County",2,63,499,251,248
050,19,111,"Iowa","Lee County",2,64,503,248,255
050,19,111,"Iowa","Lee County",2,65,508,257,251
050,19,111,"Iowa","Lee County",2,66,495,245,250
050,19,111,"Iowa","Lee County",2,67,468,229,239
050,19,111,"Iowa","Lee County",2,68,450,214,236
050,19,111,"Iowa","Lee County",2,69,430,210,220
050,19,111,"Iowa","Lee County",2,70,408,208,200
050,19,111,"Iowa","Lee County",2,71,401,188,213
050,19,111,"Iowa","Lee County",2,72,381,176,205
050,19,111,"Iowa","Lee County",2,73,409,201,208
050,19,111,"Iowa","Lee County",2,74,283,140,143
050,19,111,"Iowa","Lee County",2,75,267,123,144
050,19,111,"Iowa","Lee County",2,76,271,121,150
050,19,111,"Iowa","Lee County",2,77,275,114,161
050,19,111,"Iowa","Lee County",2,78,220,90,130
050,19,111,"Iowa","Lee County",2,79,226,99,127
050,19,111,"Iowa","Lee County",2,80,206,89,117
050,19,111,"Iowa","Lee County",2,81,179,76,103
050,19,111,"Iowa","Lee County",2,82,161,67,94
050,19,111,"Iowa","Lee County",2,83,138,63,75
050,19,111,"Iowa","Lee County",2,84,115,43,72
050,19,111,"Iowa","Lee County",2,85,843,276,567
050,19,111,"Iowa","Lee County",3,0,342,169,173
050,19,111,"Iowa","Lee County",3,1,329,162,167
050,19,111,"Iowa","Lee County",3,2,360,189,171
050,19,111,"Iowa","Lee County",3,3,400,208,192
050,19,111,"Iowa","Lee County",3,4,417,210,207
050,19,111,"Iowa","Lee County",3,5,398,213,185
050,19,111,"Iowa","Lee County",3,6,405,212,193
050,19,111,"Iowa","Lee County",3,7,411,214,197
050,19,111,"Iowa","Lee County",3,8,400,212,188
050,19,111,"Iowa","Lee County",3,9,409,215,194
050,19,111,"Iowa","Lee County",3,10,379,190,189
050,19,111,"Iowa","Lee County",3,11,399,214,185
050,19,111,"Iowa","Lee County",3,12,396,207,189
050,19,111,"Iowa","Lee County",3,13,424,211,213
050,19,111,"Iowa","Lee County",3,14,432,221,211
050,19,111,"Iowa","Lee County",3,15,402,213,189
050,19,111,"Iowa","Lee County",3,16,398,201,197
050,19,111,"Iowa","Lee County",3,17,391,190,201
050,19,111,"Iowa","Lee County",3,18,338,174,164
050,19,111,"Iowa","Lee County",3,19,271,144,127
050,19,111,"Iowa","Lee County",3,20,315,165,150
050,19,111,"Iowa","Lee County",3,21,334,187,147
050,19,111,"Iowa","Lee County",3,22,356,183,173
050,19,111,"Iowa","Lee County",3,23,366,199,167
050,19,111,"Iowa","Lee County",3,24,363,192,171
050,19,111,"Iowa","Lee County",3,25,340,169,171
050,19,111,"Iowa","Lee County",3,26,363,181,182
050,19,111,"Iowa","Lee County",3,27,380,203,177
050,19,111,"Iowa","Lee County",3,28,409,228,181
050,19,111,"Iowa","Lee County",3,29,406,221,185
050,19,111,"Iowa","Lee County",3,30,397,211,186
050,19,111,"Iowa","Lee County",3,31,385,198,187
050,19,111,"Iowa","Lee County",3,32,369,189,180
050,19,111,"Iowa","Lee County",3,33,372,188,184
050,19,111,"Iowa","Lee County",3,34,366,190,176
050,19,111,"Iowa","Lee County",3,35,384,201,183
050,19,111,"Iowa","Lee County",3,36,403,217,186
050,19,111,"Iowa","Lee County",3,37,379,191,188
050,19,111,"Iowa","Lee County",3,38,393,206,187
050,19,111,"Iowa","Lee County",3,39,415,218,197
050,19,111,"Iowa","Lee County",3,40,417,225,192
050,19,111,"Iowa","Lee County",3,41,419,221,198
050,19,111,"Iowa","Lee County",3,42,395,210,185
050,19,111,"Iowa","Lee County",3,43,403,216,187
050,19,111,"Iowa","Lee County",3,44,390,212,178
050,19,111,"Iowa","Lee County",3,45,357,188,169
050,19,111,"Iowa","Lee County",3,46,332,174,158
050,19,111,"Iowa","Lee County",3,47,346,177,169
050,19,111,"Iowa","Lee County",3,48,383,190,193
050,19,111,"Iowa","Lee County",3,49,415,207,208
050,19,111,"Iowa","Lee County",3,50,417,208,209
050,19,111,"Iowa","Lee County",3,51,414,212,202
050,19,111,"Iowa","Lee County",3,52,389,199,190
050,19,111,"Iowa","Lee County",3,53,407,212,195
050,19,111,"Iowa","Lee County",3,54,398,200,198
050,19,111,"Iowa","Lee County",3,55,432,219,213
050,19,111,"Iowa","Lee County",3,56,475,250,225
050,19,111,"Iowa","Lee County",3,57,493,255,238
050,19,111,"Iowa","Lee County",3,58,500,245,255
050,19,111,"Iowa","Lee County",3,59,520,259,261
050,19,111,"Iowa","Lee County",3,60,514,251,263
050,19,111,"Iowa","Lee County",3,61,514,259,255
050,19,111,"Iowa","Lee County",3,62,516,266,250
050,19,111,"Iowa","Lee County",3,63,511,266,245
050,19,111,"Iowa","Lee County",3,64,478,241,237
050,19,111,"Iowa","Lee County",3,65,494,243,251
050,19,111,"Iowa","Lee County",3,66,497,252,245
050,19,111,"Iowa","Lee County",3,67,483,239,244
050,19,111,"Iowa","Lee County",3,68,461,226,235
050,19,111,"Iowa","Lee County",3,69,447,214,233
050,19,111,"Iowa","Lee County",3,70,410,199,211
050,19,111,"Iowa","Lee County",3,71,391,201,190
050,19,111,"Iowa","Lee County",3,72,385,178,207
050,19,111,"Iowa","Lee County",3,73,367,164,203
050,19,111,"Iowa","Lee County",3,74,400,195,205
050,19,111,"Iowa","Lee County",3,75,270,131,139
050,19,111,"Iowa","Lee County",3,76,258,122,136
050,19,111,"Iowa","Lee County",3,77,258,111,147
050,19,111,"Iowa","Lee County",3,78,249,104,145
050,19,111,"Iowa","Lee County",3,79,207,85,122
050,19,111,"Iowa","Lee County",3,80,207,83,124
050,19,111,"Iowa","Lee County",3,81,189,80,109
050,19,111,"Iowa","Lee County",3,82,168,71,97
050,19,111,"Iowa","Lee County",3,83,142,64,78
050,19,111,"Iowa","Lee County",3,84,122,55,67
050,19,111,"Iowa","Lee County",3,85,821,267,554
050,19,111,"Iowa","Lee County",4,0,330,174,156
050,19,111,"Iowa","Lee County",4,1,345,163,182
050,19,111,"Iowa","Lee County",4,2,329,165,164
050,19,111,"Iowa","Lee County",4,3,357,183,174
050,19,111,"Iowa","Lee County",4,4,408,208,200
050,19,111,"Iowa","Lee County",4,5,409,211,198
050,19,111,"Iowa","Lee County",4,6,388,211,177
050,19,111,"Iowa","Lee County",4,7,410,218,192
050,19,111,"Iowa","Lee County",4,8,413,220,193
050,19,111,"Iowa","Lee County",4,9,400,211,189
050,19,111,"Iowa","Lee County",4,10,413,210,203
050,19,111,"Iowa","Lee County",4,11,390,203,187
050,19,111,"Iowa","Lee County",4,12,395,210,185
050,19,111,"Iowa","Lee County",4,13,393,208,185
050,19,111,"Iowa","Lee County",4,14,425,213,212
050,19,111,"Iowa","Lee County",4,15,419,218,201
050,19,111,"Iowa","Lee County",4,16,397,212,185
050,19,111,"Iowa","Lee County",4,17,386,192,194
050,19,111,"Iowa","Lee County",4,18,334,170,164
050,19,111,"Iowa","Lee County",4,19,270,137,133
050,19,111,"Iowa","Lee County",4,20,269,153,116
050,19,111,"Iowa","Lee County",4,21,324,180,144
050,19,111,"Iowa","Lee County",4,22,335,175,160
050,19,111,"Iowa","Lee County",4,23,355,179,176
050,19,111,"Iowa","Lee County",4,24,364,199,165
050,19,111,"Iowa","Lee County",4,25,360,189,171
050,19,111,"Iowa","Lee County",4,26,350,174,176
050,19,111,"Iowa","Lee County",4,27,351,172,179
050,19,111,"Iowa","Lee County",4,28,389,210,179
050,19,111,"Iowa","Lee County",4,29,414,232,182
050,19,111,"Iowa","Lee County",4,30,407,223,184
050,19,111,"Iowa","Lee County",4,31,402,208,194
050,19,111,"Iowa","Lee County",4,32,380,195,185
050,19,111,"Iowa","Lee County",4,33,373,194,179
050,19,111,"Iowa","Lee County",4,34,378,198,180
050,19,111,"Iowa","Lee County",4,35,370,187,183
050,19,111,"Iowa","Lee County",4,36,388,203,185
050,19,111,"Iowa","Lee County",4,37,395,211,184
050,19,111,"Iowa","Lee County",4,38,371,191,180
050,19,111,"Iowa","Lee County",4,39,396,213,183
050,19,111,"Iowa","Lee County",4,40,402,208,194
050,19,111,"Iowa","Lee County",4,41,416,224,192
050,19,111,"Iowa","Lee County",4,42,408,218,190
050,19,111,"Iowa","Lee County",4,43,392,209,183
050,19,111,"Iowa","Lee County",4,44,403,217,186
050,19,111,"Iowa","Lee County",4,45,375,200,175
050,19,111,"Iowa","Lee County",4,46,371,198,173
050,19,111,"Iowa","Lee County",4,47,320,164,156
050,19,111,"Iowa","Lee County",4,48,348,180,168
050,19,111,"Iowa","Lee County",4,49,389,199,190
050,19,111,"Iowa","Lee County",4,50,402,197,205
050,19,111,"Iowa","Lee County",4,51,420,206,214
050,19,111,"Iowa","Lee County",4,52,405,204,201
050,19,111,"Iowa","Lee County",4,53,387,199,188
050,19,111,"Iowa","Lee County",4,54,387,199,188
050,19,111,"Iowa","Lee County",4,55,390,186,204
050,19,111,"Iowa","Lee County",4,56,430,220,210
050,19,111,"Iowa","Lee County",4,57,476,252,224
050,19,111,"Iowa","Lee County",4,58,485,255,230
050,19,111,"Iowa","Lee County",4,59,488,237,251
050,19,111,"Iowa","Lee County",4,60,510,253,257
050,19,111,"Iowa","Lee County",4,61,518,251,267
050,19,111,"Iowa","Lee County",4,62,506,257,249
050,19,111,"Iowa","Lee County",4,63,493,250,243
050,19,111,"Iowa","Lee County",4,64,492,255,237
050,19,111,"Iowa","Lee County",4,65,465,234,231
050,19,111,"Iowa","Lee County",4,66,477,230,247
050,19,111,"Iowa","Lee County",4,67,486,247,239
050,19,111,"Iowa","Lee County",4,68,468,232,236
050,19,111,"Iowa","Lee County",4,69,446,218,228
050,19,111,"Iowa","Lee County",4,70,432,203,229
050,19,111,"Iowa","Lee County",4,71,390,193,197
050,19,111,"Iowa","Lee County",4,72,383,195,188
050,19,111,"Iowa","Lee County",4,73,370,169,201
050,19,111,"Iowa","Lee County",4,74,345,153,192
050,19,111,"Iowa","Lee County",4,75,376,179,197
050,19,111,"Iowa","Lee County",4,76,266,130,136
050,19,111,"Iowa","Lee County",4,77,238,106,132
050,19,111,"Iowa","Lee County",4,78,239,101,138
050,19,111,"Iowa","Lee County",4,79,241,103,138
050,19,111,"Iowa","Lee County",4,80,190,74,116
050,19,111,"Iowa","Lee County",4,81,189,78,111
050,19,111,"Iowa","Lee County",4,82,176,73,103
050,19,111,"Iowa","Lee County",4,83,145,67,78
050,19,111,"Iowa","Lee County",4,84,124,50,74
050,19,111,"Iowa","Lee County",4,85,788,267,521
050,19,111,"Iowa","Lee County",5,0,332,173,159
050,19,111,"Iowa","Lee County",5,1,346,181,165
050,19,111,"Iowa","Lee County",5,2,335,164,171
050,19,111,"Iowa","Lee County",5,3,329,168,161
050,19,111,"Iowa","Lee County",5,4,346,186,160
050,19,111,"Iowa","Lee County",5,5,396,202,194
050,19,111,"Iowa","Lee County",5,6,421,217,204
050,19,111,"Iowa","Lee County",5,7,378,205,173
050,19,111,"Iowa","Lee County",5,8,395,214,181
050,19,111,"Iowa","Lee County",5,9,418,220,198
050,19,111,"Iowa","Lee County",5,10,397,208,189
050,19,111,"Iowa","Lee County",5,11,409,215,194
050,19,111,"Iowa","Lee County",5,12,376,190,186
050,19,111,"Iowa","Lee County",5,13,398,209,189
050,19,111,"Iowa","Lee County",5,14,406,214,192
050,19,111,"Iowa","Lee County",5,15,425,213,212
050,19,111,"Iowa","Lee County",5,16,428,218,210
050,19,111,"Iowa","Lee County",5,17,407,210,197
050,19,111,"Iowa","Lee County",5,18,324,169,155
050,19,111,"Iowa","Lee County",5,19,267,139,128
050,19,111,"Iowa","Lee County",5,20,285,149,136
050,19,111,"Iowa","Lee County",5,21,301,172,129
050,19,111,"Iowa","Lee County",5,22,336,177,159
050,19,111,"Iowa","Lee County",5,23,337,186,151
050,19,111,"Iowa","Lee County",5,24,354,182,172
050,19,111,"Iowa","Lee County",5,25,374,204,170
050,19,111,"Iowa","Lee County",5,26,333,171,162
050,19,111,"Iowa","Lee County",5,27,343,171,172
050,19,111,"Iowa","Lee County",5,28,357,179,178
050,19,111,"Iowa","Lee County",5,29,400,217,183
050,19,111,"Iowa","Lee County",5,30,409,226,183
050,19,111,"Iowa","Lee County",5,31,411,223,188
050,19,111,"Iowa","Lee County",5,32,396,202,194
050,19,111,"Iowa","Lee County",5,33,380,198,182
050,19,111,"Iowa","Lee County",5,34,386,202,184
050,19,111,"Iowa","Lee County",5,35,380,193,187
050,19,111,"Iowa","Lee County",5,36,383,192,191
050,19,111,"Iowa","Lee County",5,37,375,191,184
050,19,111,"Iowa","Lee County",5,38,390,216,174
050,19,111,"Iowa","Lee County",5,39,365,187,178
050,19,111,"Iowa","Lee County",5,40,392,204,188
050,19,111,"Iowa","Lee County",5,41,400,204,196
050,19,111,"Iowa","Lee County",5,42,415,220,195
050,19,111,"Iowa","Lee County",5,43,409,220,189
050,19,111,"Iowa","Lee County",5,44,408,221,187
050,19,111,"Iowa","Lee County",5,45,394,207,187
050,19,111,"Iowa","Lee County",5,46,389,201,188
050,19,111,"Iowa","Lee County",5,47,364,192,172
050,19,111,"Iowa","Lee County",5,48,317,163,154
050,19,111,"Iowa","Lee County",5,49,348,185,163
050,19,111,"Iowa","Lee County",5,50,388,194,194
050,19,111,"Iowa","Lee County",5,51,403,198,205
050,19,111,"Iowa","Lee County",5,52,407,202,205
050,19,111,"Iowa","Lee County",5,53,393,197,196
050,19,111,"Iowa","Lee County",5,54,387,201,186
050,19,111,"Iowa","Lee County",5,55,377,189,188
050,19,111,"Iowa","Lee County",5,56,381,185,196
050,19,111,"Iowa","Lee County",5,57,426,218,208
050,19,111,"Iowa","Lee County",5,58,465,242,223
050,19,111,"Iowa","Lee County",5,59,480,254,226
050,19,111,"Iowa","Lee County",5,60,476,227,249
050,19,111,"Iowa","Lee County",5,61,513,252,261
050,19,111,"Iowa","Lee County",5,62,519,252,267
050,19,111,"Iowa","Lee County",5,63,492,254,238
050,19,111,"Iowa","Lee County",5,64,487,247,240
050,19,111,"Iowa","Lee County",5,65,482,252,230
050,19,111,"Iowa","Lee County",5,66,446,224,222
050,19,111,"Iowa","Lee County",5,67,468,226,242
050,19,111,"Iowa","Lee County",5,68,474,239,235
050,19,111,"Iowa","Lee County",5,69,452,223,229
050,19,111,"Iowa","Lee County",5,70,436,209,227
050,19,111,"Iowa","Lee County",5,71,409,195,214
050,19,111,"Iowa","Lee County",5,72,387,191,196
050,19,111,"Iowa","Lee County",5,73,366,185,181
050,19,111,"Iowa","Lee County",5,74,352,161,191
050,19,111,"Iowa","Lee County",5,75,318,139,179
050,19,111,"Iowa","Lee County",5,76,373,178,195
050,19,111,"Iowa","Lee County",5,77,245,117,128
050,19,111,"Iowa","Lee County",5,78,217,97,120
050,19,111,"Iowa","Lee County",5,79,227,99,128
050,19,111,"Iowa","Lee County",5,80,229,94,135
050,19,111,"Iowa","Lee County",5,81,176,70,106
050,19,111,"Iowa","Lee County",5,82,182,74,108
050,19,111,"Iowa","Lee County",5,83,160,69,91
050,19,111,"Iowa","Lee County",5,84,128,55,73
050,19,111,"Iowa","Lee County",5,85,780,268,512
050,19,113,"Iowa","Linn County",1,0,2684,1354,1330
050,19,113,"Iowa","Linn County",1,1,2728,1334,1394
050,19,113,"Iowa","Linn County",1,2,2790,1410,1380
050,19,113,"Iowa","Linn County",1,3,2874,1446,1428
050,19,113,"Iowa","Linn County",1,4,2877,1427,1450
050,19,113,"Iowa","Linn County",1,5,2938,1478,1460
050,19,113,"Iowa","Linn County",1,6,2921,1506,1415
050,19,113,"Iowa","Linn County",1,7,2879,1494,1385
050,19,113,"Iowa","Linn County",1,8,2850,1513,1337
050,19,113,"Iowa","Linn County",1,9,2818,1442,1376
050,19,113,"Iowa","Linn County",1,10,3069,1560,1509
050,19,113,"Iowa","Linn County",1,11,3127,1606,1521
050,19,113,"Iowa","Linn County",1,12,3147,1611,1536
050,19,113,"Iowa","Linn County",1,13,3125,1572,1553
050,19,113,"Iowa","Linn County",1,14,3093,1588,1505
050,19,113,"Iowa","Linn County",1,15,3094,1595,1499
050,19,113,"Iowa","Linn County",1,16,3141,1594,1547
050,19,113,"Iowa","Linn County",1,17,3085,1576,1509
050,19,113,"Iowa","Linn County",1,18,2845,1447,1398
050,19,113,"Iowa","Linn County",1,19,2920,1426,1494
050,19,113,"Iowa","Linn County",1,20,3108,1556,1552
050,19,113,"Iowa","Linn County",1,21,3087,1497,1590
050,19,113,"Iowa","Linn County",1,22,2947,1456,1491
050,19,113,"Iowa","Linn County",1,23,2871,1449,1422
050,19,113,"Iowa","Linn County",1,24,2844,1477,1367
050,19,113,"Iowa","Linn County",1,25,2994,1543,1451
050,19,113,"Iowa","Linn County",1,26,3063,1561,1502
050,19,113,"Iowa","Linn County",1,27,3120,1552,1568
050,19,113,"Iowa","Linn County",1,28,3288,1665,1623
050,19,113,"Iowa","Linn County",1,29,3249,1647,1602
050,19,113,"Iowa","Linn County",1,30,3134,1601,1533
050,19,113,"Iowa","Linn County",1,31,2987,1522,1465
050,19,113,"Iowa","Linn County",1,32,2917,1493,1424
050,19,113,"Iowa","Linn County",1,33,2901,1427,1474
050,19,113,"Iowa","Linn County",1,34,3103,1526,1577
050,19,113,"Iowa","Linn County",1,35,3162,1567,1595
050,19,113,"Iowa","Linn County",1,36,3223,1624,1599
050,19,113,"Iowa","Linn County",1,37,3222,1663,1559
050,19,113,"Iowa","Linn County",1,38,3157,1647,1510
050,19,113,"Iowa","Linn County",1,39,3134,1599,1535
050,19,113,"Iowa","Linn County",1,40,3146,1607,1539
050,19,113,"Iowa","Linn County",1,41,3060,1563,1497
050,19,113,"Iowa","Linn County",1,42,2973,1497,1476
050,19,113,"Iowa","Linn County",1,43,2918,1467,1451
050,19,113,"Iowa","Linn County",1,44,2755,1399,1356
050,19,113,"Iowa","Linn County",1,45,2737,1364,1373
050,19,113,"Iowa","Linn County",1,46,2567,1262,1305
050,19,113,"Iowa","Linn County",1,47,2663,1325,1338
050,19,113,"Iowa","Linn County",1,48,2860,1433,1427
050,19,113,"Iowa","Linn County",1,49,3022,1542,1480
050,19,113,"Iowa","Linn County",1,50,2875,1471,1404
050,19,113,"Iowa","Linn County",1,51,2851,1453,1398
050,19,113,"Iowa","Linn County",1,52,2778,1390,1388
050,19,113,"Iowa","Linn County",1,53,2855,1479,1376
050,19,113,"Iowa","Linn County",1,54,2893,1467,1426
050,19,113,"Iowa","Linn County",1,55,2970,1466,1504
050,19,113,"Iowa","Linn County",1,56,3034,1541,1493
050,19,113,"Iowa","Linn County",1,57,3032,1515,1517
050,19,113,"Iowa","Linn County",1,58,3115,1539,1576
050,19,113,"Iowa","Linn County",1,59,3031,1524,1507
050,19,113,"Iowa","Linn County",1,60,2984,1483,1501
050,19,113,"Iowa","Linn County",1,61,2944,1443,1501
050,19,113,"Iowa","Linn County",1,62,2884,1430,1454
050,19,113,"Iowa","Linn County",1,63,2801,1376,1425
050,19,113,"Iowa","Linn County",1,64,2651,1278,1373
050,19,113,"Iowa","Linn County",1,65,2514,1219,1295
050,19,113,"Iowa","Linn County",1,66,2579,1277,1302
050,19,113,"Iowa","Linn County",1,67,2477,1217,1260
050,19,113,"Iowa","Linn County",1,68,2306,1097,1209
050,19,113,"Iowa","Linn County",1,69,2170,984,1186
050,19,113,"Iowa","Linn County",1,70,2122,960,1162
050,19,113,"Iowa","Linn County",1,71,2053,946,1107
050,19,113,"Iowa","Linn County",1,72,2088,969,1119
050,19,113,"Iowa","Linn County",1,73,2079,1004,1075
050,19,113,"Iowa","Linn County",1,74,1402,656,746
050,19,113,"Iowa","Linn County",1,75,1422,626,796
050,19,113,"Iowa","Linn County",1,76,1453,664,789
050,19,113,"Iowa","Linn County",1,77,1351,614,737
050,19,113,"Iowa","Linn County",1,78,1205,556,649
050,19,113,"Iowa","Linn County",1,79,1069,454,615
050,19,113,"Iowa","Linn County",1,80,951,405,546
050,19,113,"Iowa","Linn County",1,81,954,403,551
050,19,113,"Iowa","Linn County",1,82,906,370,536
050,19,113,"Iowa","Linn County",1,83,828,343,485
050,19,113,"Iowa","Linn County",1,84,787,306,481
050,19,113,"Iowa","Linn County",1,85,4665,1580,3085
050,19,113,"Iowa","Linn County",2,0,2675,1363,1312
050,19,113,"Iowa","Linn County",2,1,2712,1339,1373
050,19,113,"Iowa","Linn County",2,2,2789,1399,1390
050,19,113,"Iowa","Linn County",2,3,2840,1430,1410
050,19,113,"Iowa","Linn County",2,4,2884,1435,1449
050,19,113,"Iowa","Linn County",2,5,2918,1462,1456
050,19,113,"Iowa","Linn County",2,6,2932,1501,1431
050,19,113,"Iowa","Linn County",2,7,2887,1491,1396
050,19,113,"Iowa","Linn County",2,8,2854,1503,1351
050,19,113,"Iowa","Linn County",2,9,2819,1455,1364
050,19,113,"Iowa","Linn County",2,10,3004,1530,1474
050,19,113,"Iowa","Linn County",2,11,3099,1585,1514
050,19,113,"Iowa","Linn County",2,12,3151,1610,1541
050,19,113,"Iowa","Linn County",2,13,3119,1576,1543
050,19,113,"Iowa","Linn County",2,14,3092,1581,1511
050,19,113,"Iowa","Linn County",2,15,3097,1592,1505
050,19,113,"Iowa","Linn County",2,16,3132,1594,1538
050,19,113,"Iowa","Linn County",2,17,3100,1575,1525
050,19,113,"Iowa","Linn County",2,18,2841,1441,1400
050,19,113,"Iowa","Linn County",2,19,2927,1429,1498
050,19,113,"Iowa","Linn County",2,20,3129,1568,1561
050,19,113,"Iowa","Linn County",2,21,3090,1504,1586
050,19,113,"Iowa","Linn County",2,22,2987,1477,1510
050,19,113,"Iowa","Linn County",2,23,2875,1447,1428
050,19,113,"Iowa","Linn County",2,24,2847,1467,1380
050,19,113,"Iowa","Linn County",2,25,2977,1535,1442
050,19,113,"Iowa","Linn County",2,26,3054,1556,1498
050,19,113,"Iowa","Linn County",2,27,3104,1556,1548
050,19,113,"Iowa","Linn County",2,28,3241,1637,1604
050,19,113,"Iowa","Linn County",2,29,3251,1647,1604
050,19,113,"Iowa","Linn County",2,30,3164,1614,1550
050,19,113,"Iowa","Linn County",2,31,3017,1540,1477
050,19,113,"Iowa","Linn County",2,32,2931,1491,1440
050,19,113,"Iowa","Linn County",2,33,2904,1444,1460
050,19,113,"Iowa","Linn County",2,34,3051,1498,1553
050,19,113,"Iowa","Linn County",2,35,3160,1563,1597
050,19,113,"Iowa","Linn County",2,36,3183,1596,1587
050,19,113,"Iowa","Linn County",2,37,3223,1649,1574
050,19,113,"Iowa","Linn County",2,38,3177,1651,1526
050,19,113,"Iowa","Linn County",2,39,3137,1610,1527
050,19,113,"Iowa","Linn County",2,40,3153,1609,1544
050,19,113,"Iowa","Linn County",2,41,3085,1579,1506
050,19,113,"Iowa","Linn County",2,42,2982,1508,1474
050,19,113,"Iowa","Linn County",2,43,2948,1489,1459
050,19,113,"Iowa","Linn County",2,44,2768,1404,1364
050,19,113,"Iowa","Linn County",2,45,2751,1379,1372
050,19,113,"Iowa","Linn County",2,46,2598,1282,1316
050,19,113,"Iowa","Linn County",2,47,2627,1303,1324
050,19,113,"Iowa","Linn County",2,48,2804,1400,1404
050,19,113,"Iowa","Linn County",2,49,2988,1521,1467
050,19,113,"Iowa","Linn County",2,50,2916,1490,1426
050,19,113,"Iowa","Linn County",2,51,2857,1456,1401
050,19,113,"Iowa","Linn County",2,52,2773,1392,1381
050,19,113,"Iowa","Linn County",2,53,2841,1461,1380
050,19,113,"Iowa","Linn County",2,54,2873,1462,1411
050,19,113,"Iowa","Linn County",2,55,2945,1463,1482
050,19,113,"Iowa","Linn County",2,56,3014,1521,1493
050,19,113,"Iowa","Linn County",2,57,3041,1526,1515
050,19,113,"Iowa","Linn County",2,58,3077,1527,1550
050,19,113,"Iowa","Linn County",2,59,3066,1536,1530
050,19,113,"Iowa","Linn County",2,60,2972,1478,1494
050,19,113,"Iowa","Linn County",2,61,2932,1439,1493
050,19,113,"Iowa","Linn County",2,62,2892,1425,1467
050,19,113,"Iowa","Linn County",2,63,2834,1389,1445
050,19,113,"Iowa","Linn County",2,64,2661,1286,1375
050,19,113,"Iowa","Linn County",2,65,2537,1228,1309
050,19,113,"Iowa","Linn County",2,66,2561,1263,1298
050,19,113,"Iowa","Linn County",2,67,2485,1222,1263
050,19,113,"Iowa","Linn County",2,68,2319,1111,1208
050,19,113,"Iowa","Linn County",2,69,2209,1015,1194
050,19,113,"Iowa","Linn County",2,70,2119,959,1160
050,19,113,"Iowa","Linn County",2,71,2071,947,1124
050,19,113,"Iowa","Linn County",2,72,2031,941,1090
050,19,113,"Iowa","Linn County",2,73,2176,1035,1141
050,19,113,"Iowa","Linn County",2,74,1461,690,771
050,19,113,"Iowa","Linn County",2,75,1410,624,786
050,19,113,"Iowa","Linn County",2,76,1421,648,773
050,19,113,"Iowa","Linn County",2,77,1404,641,763
050,19,113,"Iowa","Linn County",2,78,1205,552,653
050,19,113,"Iowa","Linn County",2,79,1092,469,623
050,19,113,"Iowa","Linn County",2,80,970,413,557
050,19,113,"Iowa","Linn County",2,81,936,399,537
050,19,113,"Iowa","Linn County",2,82,906,370,536
050,19,113,"Iowa","Linn County",2,83,839,349,490
050,19,113,"Iowa","Linn County",2,84,791,311,480
050,19,113,"Iowa","Linn County",2,85,4704,1598,3106
050,19,113,"Iowa","Linn County",3,0,2528,1299,1229
050,19,113,"Iowa","Linn County",3,1,2655,1340,1315
050,19,113,"Iowa","Linn County",3,2,2712,1344,1368
050,19,113,"Iowa","Linn County",3,3,2772,1409,1363
050,19,113,"Iowa","Linn County",3,4,2785,1409,1376
050,19,113,"Iowa","Linn County",3,5,2832,1406,1426
050,19,113,"Iowa","Linn County",3,6,2905,1452,1453
050,19,113,"Iowa","Linn County",3,7,2878,1487,1391
050,19,113,"Iowa","Linn County",3,8,2864,1481,1383
050,19,113,"Iowa","Linn County",3,9,2822,1493,1329
050,19,113,"Iowa","Linn County",3,10,2788,1440,1348
050,19,113,"Iowa","Linn County",3,11,3006,1530,1476
050,19,113,"Iowa","Linn County",3,12,3084,1580,1504
050,19,113,"Iowa","Linn County",3,13,3150,1625,1525
050,19,113,"Iowa","Linn County",3,14,3096,1570,1526
050,19,113,"Iowa","Linn County",3,15,3111,1588,1523
050,19,113,"Iowa","Linn County",3,16,3082,1585,1497
050,19,113,"Iowa","Linn County",3,17,3094,1586,1508
050,19,113,"Iowa","Linn County",3,18,2870,1445,1425
050,19,113,"Iowa","Linn County",3,19,2932,1437,1495
050,19,113,"Iowa","Linn County",3,20,3069,1539,1530
050,19,113,"Iowa","Linn County",3,21,3052,1500,1552
050,19,113,"Iowa","Linn County",3,22,2969,1426,1543
050,19,113,"Iowa","Linn County",3,23,2903,1472,1431
050,19,113,"Iowa","Linn County",3,24,2866,1477,1389
050,19,113,"Iowa","Linn County",3,25,2871,1463,1408
050,19,113,"Iowa","Linn County",3,26,2964,1499,1465
050,19,113,"Iowa","Linn County",3,27,3025,1534,1491
050,19,113,"Iowa","Linn County",3,28,3073,1546,1527
050,19,113,"Iowa","Linn County",3,29,3177,1617,1560
050,19,113,"Iowa","Linn County",3,30,3222,1636,1586
050,19,113,"Iowa","Linn County",3,31,3137,1582,1555
050,19,113,"Iowa","Linn County",3,32,2980,1515,1465
050,19,113,"Iowa","Linn County",3,33,2927,1509,1418
050,19,113,"Iowa","Linn County",3,34,2891,1441,1450
050,19,113,"Iowa","Linn County",3,35,3050,1502,1548
050,19,113,"Iowa","Linn County",3,36,3124,1560,1564
050,19,113,"Iowa","Linn County",3,37,3136,1559,1577
050,19,113,"Iowa","Linn County",3,38,3164,1626,1538
050,19,113,"Iowa","Linn County",3,39,3113,1620,1493
050,19,113,"Iowa","Linn County",3,40,3106,1576,1530
050,19,113,"Iowa","Linn County",3,41,3167,1624,1543
050,19,113,"Iowa","Linn County",3,42,3074,1579,1495
050,19,113,"Iowa","Linn County",3,43,2948,1501,1447
050,19,113,"Iowa","Linn County",3,44,2930,1466,1464
050,19,113,"Iowa","Linn County",3,45,2732,1389,1343
050,19,113,"Iowa","Linn County",3,46,2714,1364,1350
050,19,113,"Iowa","Linn County",3,47,2596,1280,1316
050,19,113,"Iowa","Linn County",3,48,2615,1284,1331
050,19,113,"Iowa","Linn County",3,49,2804,1412,1392
050,19,113,"Iowa","Linn County",3,50,2960,1510,1450
050,19,113,"Iowa","Linn County",3,51,2890,1492,1398
050,19,113,"Iowa","Linn County",3,52,2807,1434,1373
050,19,113,"Iowa","Linn County",3,53,2727,1360,1367
050,19,113,"Iowa","Linn County",3,54,2815,1433,1382
050,19,113,"Iowa","Linn County",3,55,2822,1419,1403
050,19,113,"Iowa","Linn County",3,56,2893,1441,1452
050,19,113,"Iowa","Linn County",3,57,3022,1530,1492
050,19,113,"Iowa","Linn County",3,58,3007,1509,1498
050,19,113,"Iowa","Linn County",3,59,3057,1522,1535
050,19,113,"Iowa","Linn County",3,60,3031,1512,1519
050,19,113,"Iowa","Linn County",3,61,2926,1438,1488
050,19,113,"Iowa","Linn County",3,62,2880,1399,1481
050,19,113,"Iowa","Linn County",3,63,2847,1397,1450
050,19,113,"Iowa","Linn County",3,64,2802,1369,1433
050,19,113,"Iowa","Linn County",3,65,2591,1256,1335
050,19,113,"Iowa","Linn County",3,66,2498,1198,1300
050,19,113,"Iowa","Linn County",3,67,2521,1238,1283
050,19,113,"Iowa","Linn County",3,68,2433,1203,1230
050,19,113,"Iowa","Linn County",3,69,2290,1082,1208
050,19,113,"Iowa","Linn County",3,70,2170,993,1177
050,19,113,"Iowa","Linn County",3,71,2092,945,1147
050,19,113,"Iowa","Linn County",3,72,2022,913,1109
050,19,113,"Iowa","Linn County",3,73,2013,925,1088
050,19,113,"Iowa","Linn County",3,74,2116,1005,1111
050,19,113,"Iowa","Linn County",3,75,1398,659,739
050,19,113,"Iowa","Linn County",3,76,1365,603,762
050,19,113,"Iowa","Linn County",3,77,1368,626,742
050,19,113,"Iowa","Linn County",3,78,1346,605,741
050,19,113,"Iowa","Linn County",3,79,1151,513,638
050,19,113,"Iowa","Linn County",3,80,1059,454,605
050,19,113,"Iowa","Linn County",3,81,908,392,516
050,19,113,"Iowa","Linn County",3,82,880,362,518
050,19,113,"Iowa","Linn County",3,83,842,353,489
050,19,113,"Iowa","Linn County",3,84,770,297,473
050,19,113,"Iowa","Linn County",3,85,4761,1624,3137
050,19,113,"Iowa","Linn County",4,0,2593,1346,1247
050,19,113,"Iowa","Linn County",4,1,2576,1285,1291
050,19,113,"Iowa","Linn County",4,2,2654,1327,1327
050,19,113,"Iowa","Linn County",4,3,2677,1338,1339
050,19,113,"Iowa","Linn County",4,4,2764,1405,1359
050,19,113,"Iowa","Linn County",4,5,2776,1411,1365
050,19,113,"Iowa","Linn County",4,6,2827,1394,1433
050,19,113,"Iowa","Linn County",4,7,2899,1474,1425
050,19,113,"Iowa","Linn County",4,8,2899,1508,1391
050,19,113,"Iowa","Linn County",4,9,2823,1469,1354
050,19,113,"Iowa","Linn County",4,10,2784,1454,1330
050,19,113,"Iowa","Linn County",4,11,2757,1433,1324
050,19,113,"Iowa","Linn County",4,12,2983,1519,1464
050,19,113,"Iowa","Linn County",4,13,3091,1577,1514
050,19,113,"Iowa","Linn County",4,14,3140,1619,1521
050,19,113,"Iowa","Linn County",4,15,3097,1551,1546
050,19,113,"Iowa","Linn County",4,16,3108,1575,1533
050,19,113,"Iowa","Linn County",4,17,3054,1579,1475
050,19,113,"Iowa","Linn County",4,18,2845,1439,1406
050,19,113,"Iowa","Linn County",4,19,2885,1393,1492
050,19,113,"Iowa","Linn County",4,20,3124,1570,1554
050,19,113,"Iowa","Linn County",4,21,2961,1470,1491
050,19,113,"Iowa","Linn County",4,22,3036,1505,1531
050,19,113,"Iowa","Linn County",4,23,2929,1418,1511
050,19,113,"Iowa","Linn County",4,24,2935,1485,1450
050,19,113,"Iowa","Linn County",4,25,2946,1513,1433
050,19,113,"Iowa","Linn County",4,26,2855,1435,1420
050,19,113,"Iowa","Linn County",4,27,2980,1493,1487
050,19,113,"Iowa","Linn County",4,28,2976,1497,1479
050,19,113,"Iowa","Linn County",4,29,3046,1537,1509
050,19,113,"Iowa","Linn County",4,30,3185,1618,1567
050,19,113,"Iowa","Linn County",4,31,3248,1640,1608
050,19,113,"Iowa","Linn County",4,32,3154,1571,1583
050,19,113,"Iowa","Linn County",4,33,2973,1525,1448
050,19,113,"Iowa","Linn County",4,34,2895,1488,1407
050,19,113,"Iowa","Linn County",4,35,2830,1408,1422
050,19,113,"Iowa","Linn County",4,36,3027,1512,1515
050,19,113,"Iowa","Linn County",4,37,3085,1539,1546
050,19,113,"Iowa","Linn County",4,38,3099,1539,1560
050,19,113,"Iowa","Linn County",4,39,3129,1615,1514
050,19,113,"Iowa","Linn County",4,40,3089,1567,1522
050,19,113,"Iowa","Linn County",4,41,3112,1588,1524
050,19,113,"Iowa","Linn County",4,42,3121,1592,1529
050,19,113,"Iowa","Linn County",4,43,3066,1582,1484
050,19,113,"Iowa","Linn County",4,44,2945,1511,1434
050,19,113,"Iowa","Linn County",4,45,2891,1439,1452
050,19,113,"Iowa","Linn County",4,46,2708,1363,1345
050,19,113,"Iowa","Linn County",4,47,2697,1359,1338
050,19,113,"Iowa","Linn County",4,48,2593,1282,1311
050,19,113,"Iowa","Linn County",4,49,2587,1275,1312
050,19,113,"Iowa","Linn County",4,50,2781,1404,1377
050,19,113,"Iowa","Linn County",4,51,2955,1502,1453
050,19,113,"Iowa","Linn County",4,52,2809,1450,1359
050,19,113,"Iowa","Linn County",4,53,2776,1412,1364
050,19,113,"Iowa","Linn County",4,54,2708,1344,1364
050,19,113,"Iowa","Linn County",4,55,2768,1403,1365
050,19,113,"Iowa","Linn County",4,56,2784,1398,1386
050,19,113,"Iowa","Linn County",4,57,2867,1444,1423
050,19,113,"Iowa","Linn County",4,58,2937,1481,1456
050,19,113,"Iowa","Linn County",4,59,2987,1501,1486
050,19,113,"Iowa","Linn County",4,60,3015,1493,1522
050,19,113,"Iowa","Linn County",4,61,2944,1467,1477
050,19,113,"Iowa","Linn County",4,62,2838,1390,1448
050,19,113,"Iowa","Linn County",4,63,2842,1371,1471
050,19,113,"Iowa","Linn County",4,64,2780,1365,1415
050,19,113,"Iowa","Linn County",4,65,2742,1331,1411
050,19,113,"Iowa","Linn County",4,66,2550,1236,1314
050,19,113,"Iowa","Linn County",4,67,2442,1163,1279
050,19,113,"Iowa","Linn County",4,68,2462,1209,1253
050,19,113,"Iowa","Linn County",4,69,2384,1171,1213
050,19,113,"Iowa","Linn County",4,70,2265,1062,1203
050,19,113,"Iowa","Linn County",4,71,2128,963,1165
050,19,113,"Iowa","Linn County",4,72,2040,914,1126
050,19,113,"Iowa","Linn County",4,73,2000,896,1104
050,19,113,"Iowa","Linn County",4,74,1948,887,1061
050,19,113,"Iowa","Linn County",4,75,2056,972,1084
050,19,113,"Iowa","Linn County",4,76,1357,637,720
050,19,113,"Iowa","Linn County",4,77,1328,580,748
050,19,113,"Iowa","Linn County",4,78,1308,584,724
050,19,113,"Iowa","Linn County",4,79,1295,559,736
050,19,113,"Iowa","Linn County",4,80,1119,502,617
050,19,113,"Iowa","Linn County",4,81,1028,456,572
050,19,113,"Iowa","Linn County",4,82,858,355,503
050,19,113,"Iowa","Linn County",4,83,829,348,481
050,19,113,"Iowa","Linn County",4,84,778,309,469
050,19,113,"Iowa","Linn County",4,85,4778,1639,3139
050,19,113,"Iowa","Linn County",5,0,2614,1354,1260
050,19,113,"Iowa","Linn County",5,1,2573,1323,1250
050,19,113,"Iowa","Linn County",5,2,2598,1305,1293
050,19,113,"Iowa","Linn County",5,3,2674,1332,1342
050,19,113,"Iowa","Linn County",5,4,2648,1321,1327
050,19,113,"Iowa","Linn County",5,5,2754,1398,1356
050,19,113,"Iowa","Linn County",5,6,2747,1376,1371
050,19,113,"Iowa","Linn County",5,7,2794,1379,1415
050,19,113,"Iowa","Linn County",5,8,2912,1471,1441
050,19,113,"Iowa","Linn County",5,9,2881,1488,1393
050,19,113,"Iowa","Linn County",5,10,2818,1470,1348
050,19,113,"Iowa","Linn County",5,11,2783,1460,1323
050,19,113,"Iowa","Linn County",5,12,2757,1432,1325
050,19,113,"Iowa","Linn County",5,13,2988,1521,1467
050,19,113,"Iowa","Linn County",5,14,3081,1571,1510
050,19,113,"Iowa","Linn County",5,15,3166,1612,1554
050,19,113,"Iowa","Linn County",5,16,3082,1546,1536
050,19,113,"Iowa","Linn County",5,17,3103,1578,1525
050,19,113,"Iowa","Linn County",5,18,2782,1426,1356
050,19,113,"Iowa","Linn County",5,19,2897,1408,1489
050,19,113,"Iowa","Linn County",5,20,3057,1516,1541
050,19,113,"Iowa","Linn County",5,21,3079,1503,1576
050,19,113,"Iowa","Linn County",5,22,2921,1478,1443
050,19,113,"Iowa","Linn County",5,23,2997,1507,1490
050,19,113,"Iowa","Linn County",5,24,2971,1439,1532
050,19,113,"Iowa","Linn County",5,25,2979,1529,1450
050,19,113,"Iowa","Linn County",5,26,2836,1454,1382
050,19,113,"Iowa","Linn County",5,27,2885,1450,1435
050,19,113,"Iowa","Linn County",5,28,2926,1460,1466
050,19,113,"Iowa","Linn County",5,29,2976,1512,1464
050,19,113,"Iowa","Linn County",5,30,3038,1544,1494
050,19,113,"Iowa","Linn County",5,31,3216,1625,1591
050,19,113,"Iowa","Linn County",5,32,3268,1655,1613
050,19,113,"Iowa","Linn County",5,33,3159,1570,1589
050,19,113,"Iowa","Linn County",5,34,2989,1527,1462
050,19,113,"Iowa","Linn County",5,35,2818,1437,1381
050,19,113,"Iowa","Linn County",5,36,2816,1385,1431
050,19,113,"Iowa","Linn County",5,37,2999,1484,1515
050,19,113,"Iowa","Linn County",5,38,3055,1525,1530
050,19,113,"Iowa","Linn County",5,39,3087,1530,1557
050,19,113,"Iowa","Linn County",5,40,3076,1588,1488
050,19,113,"Iowa","Linn County",5,41,3078,1578,1500
050,19,113,"Iowa","Linn County",5,42,3063,1550,1513
050,19,113,"Iowa","Linn County",5,43,3091,1572,1519
050,19,113,"Iowa","Linn County",5,44,3068,1586,1482
050,19,113,"Iowa","Linn County",5,45,2926,1499,1427
050,19,113,"Iowa","Linn County",5,46,2852,1413,1439
050,19,113,"Iowa","Linn County",5,47,2688,1365,1323
050,19,113,"Iowa","Linn County",5,48,2647,1325,1322
050,19,113,"Iowa","Linn County",5,49,2548,1273,1275
050,19,113,"Iowa","Linn County",5,50,2556,1256,1300
050,19,113,"Iowa","Linn County",5,51,2802,1412,1390
050,19,113,"Iowa","Linn County",5,52,2912,1472,1440
050,19,113,"Iowa","Linn County",5,53,2817,1448,1369
050,19,113,"Iowa","Linn County",5,54,2749,1373,1376
050,19,113,"Iowa","Linn County",5,55,2675,1325,1350
050,19,113,"Iowa","Linn County",5,56,2736,1387,1349
050,19,113,"Iowa","Linn County",5,57,2771,1390,1381
050,19,113,"Iowa","Linn County",5,58,2832,1422,1410
050,19,113,"Iowa","Linn County",5,59,2931,1497,1434
050,19,113,"Iowa","Linn County",5,60,2962,1475,1487
050,19,113,"Iowa","Linn County",5,61,2981,1471,1510
050,19,113,"Iowa","Linn County",5,62,2891,1433,1458
050,19,113,"Iowa","Linn County",5,63,2831,1386,1445
050,19,113,"Iowa","Linn County",5,64,2804,1358,1446
050,19,113,"Iowa","Linn County",5,65,2731,1340,1391
050,19,113,"Iowa","Linn County",5,66,2715,1307,1408
050,19,113,"Iowa","Linn County",5,67,2514,1208,1306
050,19,113,"Iowa","Linn County",5,68,2398,1147,1251
050,19,113,"Iowa","Linn County",5,69,2432,1195,1237
050,19,113,"Iowa","Linn County",5,70,2353,1150,1203
050,19,113,"Iowa","Linn County",5,71,2222,1031,1191
050,19,113,"Iowa","Linn County",5,72,2081,938,1143
050,19,113,"Iowa","Linn County",5,73,2026,900,1126
050,19,113,"Iowa","Linn County",5,74,1948,862,1086
050,19,113,"Iowa","Linn County",5,75,1910,859,1051
050,19,113,"Iowa","Linn County",5,76,2026,958,1068
050,19,113,"Iowa","Linn County",5,77,1310,613,697
050,19,113,"Iowa","Linn County",5,78,1280,551,729
050,19,113,"Iowa","Linn County",5,79,1269,558,711
050,19,113,"Iowa","Linn County",5,80,1264,539,725
050,19,113,"Iowa","Linn County",5,81,1076,486,590
050,19,113,"Iowa","Linn County",5,82,985,423,562
050,19,113,"Iowa","Linn County",5,83,814,343,471
050,19,113,"Iowa","Linn County",5,84,775,311,464
050,19,113,"Iowa","Linn County",5,85,4832,1698,3134
050,19,115,"Iowa","Louisa County",1,0,119,63,56
050,19,115,"Iowa","Louisa County",1,1,125,73,52
050,19,115,"Iowa","Louisa County",1,2,133,68,65
050,19,115,"Iowa","Louisa County",1,3,139,78,61
050,19,115,"Iowa","Louisa County",1,4,131,65,66
050,19,115,"Iowa","Louisa County",1,5,135,69,66
050,19,115,"Iowa","Louisa County",1,6,123,63,60
050,19,115,"Iowa","Louisa County",1,7,132,67,65
050,19,115,"Iowa","Louisa County",1,8,134,56,78
050,19,115,"Iowa","Louisa County",1,9,120,64,56
050,19,115,"Iowa","Louisa County",1,10,130,71,59
050,19,115,"Iowa","Louisa County",1,11,142,78,64
050,19,115,"Iowa","Louisa County",1,12,145,78,67
050,19,115,"Iowa","Louisa County",1,13,150,83,67
050,19,115,"Iowa","Louisa County",1,14,129,69,60
050,19,115,"Iowa","Louisa County",1,15,145,82,63
050,19,115,"Iowa","Louisa County",1,16,144,80,64
050,19,115,"Iowa","Louisa County",1,17,159,89,70
050,19,115,"Iowa","Louisa County",1,18,134,75,59
050,19,115,"Iowa","Louisa County",1,19,101,58,43
050,19,115,"Iowa","Louisa County",1,20,106,64,42
050,19,115,"Iowa","Louisa County",1,21,114,64,50
050,19,115,"Iowa","Louisa County",1,22,119,61,58
050,19,115,"Iowa","Louisa County",1,23,116,62,54
050,19,115,"Iowa","Louisa County",1,24,123,72,51
050,19,115,"Iowa","Louisa County",1,25,142,74,68
050,19,115,"Iowa","Louisa County",1,26,142,78,64
050,19,115,"Iowa","Louisa County",1,27,130,77,53
050,19,115,"Iowa","Louisa County",1,28,115,68,47
050,19,115,"Iowa","Louisa County",1,29,115,56,59
050,19,115,"Iowa","Louisa County",1,30,103,48,55
050,19,115,"Iowa","Louisa County",1,31,115,57,58
050,19,115,"Iowa","Louisa County",1,32,112,52,60
050,19,115,"Iowa","Louisa County",1,33,118,60,58
050,19,115,"Iowa","Louisa County",1,34,102,50,52
050,19,115,"Iowa","Louisa County",1,35,118,53,65
050,19,115,"Iowa","Louisa County",1,36,142,80,62
050,19,115,"Iowa","Louisa County",1,37,153,87,66
050,19,115,"Iowa","Louisa County",1,38,145,82,63
050,19,115,"Iowa","Louisa County",1,39,162,92,70
050,19,115,"Iowa","Louisa County",1,40,144,70,74
050,19,115,"Iowa","Louisa County",1,41,137,74,63
050,19,115,"Iowa","Louisa County",1,42,127,64,63
050,19,115,"Iowa","Louisa County",1,43,129,56,73
050,19,115,"Iowa","Louisa County",1,44,132,60,72
050,19,115,"Iowa","Louisa County",1,45,134,69,65
050,19,115,"Iowa","Louisa County",1,46,118,62,56
050,19,115,"Iowa","Louisa County",1,47,105,52,53
050,19,115,"Iowa","Louisa County",1,48,113,65,48
050,19,115,"Iowa","Louisa County",1,49,135,79,56
050,19,115,"Iowa","Louisa County",1,50,135,76,59
050,19,115,"Iowa","Louisa County",1,51,120,57,63
050,19,115,"Iowa","Louisa County",1,52,127,65,62
050,19,115,"Iowa","Louisa County",1,53,130,67,63
050,19,115,"Iowa","Louisa County",1,54,161,82,79
050,19,115,"Iowa","Louisa County",1,55,182,88,94
050,19,115,"Iowa","Louisa County",1,56,186,93,93
050,19,115,"Iowa","Louisa County",1,57,170,91,79
050,19,115,"Iowa","Louisa County",1,58,174,90,84
050,19,115,"Iowa","Louisa County",1,59,183,93,90
050,19,115,"Iowa","Louisa County",1,60,167,85,82
050,19,115,"Iowa","Louisa County",1,61,162,81,81
050,19,115,"Iowa","Louisa County",1,62,143,70,73
050,19,115,"Iowa","Louisa County",1,63,135,64,71
050,19,115,"Iowa","Louisa County",1,64,156,79,77
050,19,115,"Iowa","Louisa County",1,65,148,75,73
050,19,115,"Iowa","Louisa County",1,66,146,69,77
050,19,115,"Iowa","Louisa County",1,67,145,71,74
050,19,115,"Iowa","Louisa County",1,68,125,65,60
050,19,115,"Iowa","Louisa County",1,69,122,58,64
050,19,115,"Iowa","Louisa County",1,70,111,58,53
050,19,115,"Iowa","Louisa County",1,71,98,58,40
050,19,115,"Iowa","Louisa County",1,72,101,54,47
050,19,115,"Iowa","Louisa County",1,73,111,57,54
050,19,115,"Iowa","Louisa County",1,74,80,40,40
050,19,115,"Iowa","Louisa County",1,75,73,36,37
050,19,115,"Iowa","Louisa County",1,76,84,39,45
050,19,115,"Iowa","Louisa County",1,77,79,35,44
050,19,115,"Iowa","Louisa County",1,78,59,25,34
050,19,115,"Iowa","Louisa County",1,79,47,19,28
050,19,115,"Iowa","Louisa County",1,80,53,24,29
050,19,115,"Iowa","Louisa County",1,81,65,28,37
050,19,115,"Iowa","Louisa County",1,82,62,27,35
050,19,115,"Iowa","Louisa County",1,83,37,15,22
050,19,115,"Iowa","Louisa County",1,84,46,22,24
050,19,115,"Iowa","Louisa County",1,85,271,81,190
050,19,115,"Iowa","Louisa County",2,0,117,62,55
050,19,115,"Iowa","Louisa County",2,1,123,69,54
050,19,115,"Iowa","Louisa County",2,2,134,71,63
050,19,115,"Iowa","Louisa County",2,3,138,75,63
050,19,115,"Iowa","Louisa County",2,4,132,68,64
050,19,115,"Iowa","Louisa County",2,5,135,68,67
050,19,115,"Iowa","Louisa County",2,6,126,65,61
050,19,115,"Iowa","Louisa County",2,7,131,67,64
050,19,115,"Iowa","Louisa County",2,8,133,59,74
050,19,115,"Iowa","Louisa County",2,9,122,62,60
050,19,115,"Iowa","Louisa County",2,10,129,70,59
050,19,115,"Iowa","Louisa County",2,11,138,76,62
050,19,115,"Iowa","Louisa County",2,12,147,80,67
050,19,115,"Iowa","Louisa County",2,13,147,81,66
050,19,115,"Iowa","Louisa County",2,14,137,75,62
050,19,115,"Iowa","Louisa County",2,15,141,78,63
050,19,115,"Iowa","Louisa County",2,16,144,80,64
050,19,115,"Iowa","Louisa County",2,17,156,87,69
050,19,115,"Iowa","Louisa County",2,18,134,76,58
050,19,115,"Iowa","Louisa County",2,19,103,58,45
050,19,115,"Iowa","Louisa County",2,20,109,65,44
050,19,115,"Iowa","Louisa County",2,21,111,64,47
050,19,115,"Iowa","Louisa County",2,22,117,60,57
050,19,115,"Iowa","Louisa County",2,23,117,62,55
050,19,115,"Iowa","Louisa County",2,24,121,70,51
050,19,115,"Iowa","Louisa County",2,25,138,74,64
050,19,115,"Iowa","Louisa County",2,26,140,76,64
050,19,115,"Iowa","Louisa County",2,27,131,76,55
050,19,115,"Iowa","Louisa County",2,28,117,69,48
050,19,115,"Iowa","Louisa County",2,29,113,57,56
050,19,115,"Iowa","Louisa County",2,30,108,51,57
050,19,115,"Iowa","Louisa County",2,31,113,56,57
050,19,115,"Iowa","Louisa County",2,32,112,54,58
050,19,115,"Iowa","Louisa County",2,33,113,56,57
050,19,115,"Iowa","Louisa County",2,34,104,51,53
050,19,115,"Iowa","Louisa County",2,35,117,53,64
050,19,115,"Iowa","Louisa County",2,36,137,74,63
050,19,115,"Iowa","Louisa County",2,37,151,85,66
050,19,115,"Iowa","Louisa County",2,38,148,83,65
050,19,115,"Iowa","Louisa County",2,39,157,89,68
050,19,115,"Iowa","Louisa County",2,40,150,76,74
050,19,115,"Iowa","Louisa County",2,41,137,72,65
050,19,115,"Iowa","Louisa County",2,42,129,66,63
050,19,115,"Iowa","Louisa County",2,43,130,58,72
050,19,115,"Iowa","Louisa County",2,44,131,60,71
050,19,115,"Iowa","Louisa County",2,45,134,68,66
050,19,115,"Iowa","Louisa County",2,46,120,62,58
050,19,115,"Iowa","Louisa County",2,47,106,53,53
050,19,115,"Iowa","Louisa County",2,48,112,62,50
050,19,115,"Iowa","Louisa County",2,49,130,76,54
050,19,115,"Iowa","Louisa County",2,50,135,76,59
050,19,115,"Iowa","Louisa County",2,51,121,60,61
050,19,115,"Iowa","Louisa County",2,52,124,62,62
050,19,115,"Iowa","Louisa County",2,53,130,66,64
050,19,115,"Iowa","Louisa County",2,54,153,79,74
050,19,115,"Iowa","Louisa County",2,55,178,87,91
050,19,115,"Iowa","Louisa County",2,56,185,93,92
050,19,115,"Iowa","Louisa County",2,57,173,90,83
050,19,115,"Iowa","Louisa County",2,58,174,90,84
050,19,115,"Iowa","Louisa County",2,59,181,93,88
050,19,115,"Iowa","Louisa County",2,60,170,86,84
050,19,115,"Iowa","Louisa County",2,61,162,81,81
050,19,115,"Iowa","Louisa County",2,62,144,71,73
050,19,115,"Iowa","Louisa County",2,63,139,66,73
050,19,115,"Iowa","Louisa County",2,64,150,75,75
050,19,115,"Iowa","Louisa County",2,65,150,76,74
050,19,115,"Iowa","Louisa County",2,66,147,70,77
050,19,115,"Iowa","Louisa County",2,67,143,70,73
050,19,115,"Iowa","Louisa County",2,68,128,65,63
050,19,115,"Iowa","Louisa County",2,69,123,60,63
050,19,115,"Iowa","Louisa County",2,70,112,57,55
050,19,115,"Iowa","Louisa County",2,71,102,58,44
050,19,115,"Iowa","Louisa County",2,72,98,53,45
050,19,115,"Iowa","Louisa County",2,73,110,57,53
050,19,115,"Iowa","Louisa County",2,74,82,41,41
050,19,115,"Iowa","Louisa County",2,75,74,37,37
050,19,115,"Iowa","Louisa County",2,76,80,38,42
050,19,115,"Iowa","Louisa County",2,77,82,37,45
050,19,115,"Iowa","Louisa County",2,78,63,27,36
050,19,115,"Iowa","Louisa County",2,79,50,20,30
050,19,115,"Iowa","Louisa County",2,80,50,22,28
050,19,115,"Iowa","Louisa County",2,81,63,28,35
050,19,115,"Iowa","Louisa County",2,82,64,27,37
050,19,115,"Iowa","Louisa County",2,83,39,16,23
050,19,115,"Iowa","Louisa County",2,84,41,20,21
050,19,115,"Iowa","Louisa County",2,85,274,81,193
050,19,115,"Iowa","Louisa County",3,0,96,52,44
050,19,115,"Iowa","Louisa County",3,1,97,57,40
050,19,115,"Iowa","Louisa County",3,2,128,68,60
050,19,115,"Iowa","Louisa County",3,3,123,70,53
050,19,115,"Iowa","Louisa County",3,4,131,68,63
050,19,115,"Iowa","Louisa County",3,5,132,72,60
050,19,115,"Iowa","Louisa County",3,6,125,60,65
050,19,115,"Iowa","Louisa County",3,7,124,62,62
050,19,115,"Iowa","Louisa County",3,8,131,66,65
050,19,115,"Iowa","Louisa County",3,9,125,56,69
050,19,115,"Iowa","Louisa County",3,10,125,65,60
050,19,115,"Iowa","Louisa County",3,11,130,63,67
050,19,115,"Iowa","Louisa County",3,12,141,71,70
050,19,115,"Iowa","Louisa County",3,13,149,80,69
050,19,115,"Iowa","Louisa County",3,14,151,79,72
050,19,115,"Iowa","Louisa County",3,15,144,79,65
050,19,115,"Iowa","Louisa County",3,16,140,73,67
050,19,115,"Iowa","Louisa County",3,17,141,82,59
050,19,115,"Iowa","Louisa County",3,18,129,70,59
050,19,115,"Iowa","Louisa County",3,19,112,68,44
050,19,115,"Iowa","Louisa County",3,20,111,60,51
050,19,115,"Iowa","Louisa County",3,21,109,64,45
050,19,115,"Iowa","Louisa County",3,22,115,67,48
050,19,115,"Iowa","Louisa County",3,23,108,56,52
050,19,115,"Iowa","Louisa County",3,24,126,71,55
050,19,115,"Iowa","Louisa County",3,25,124,69,55
050,19,115,"Iowa","Louisa County",3,26,128,70,58
050,19,115,"Iowa","Louisa County",3,27,135,71,64
050,19,115,"Iowa","Louisa County",3,28,121,70,51
050,19,115,"Iowa","Louisa County",3,29,112,65,47
050,19,115,"Iowa","Louisa County",3,30,115,59,56
050,19,115,"Iowa","Louisa County",3,31,114,56,58
050,19,115,"Iowa","Louisa County",3,32,112,58,54
050,19,115,"Iowa","Louisa County",3,33,119,55,64
050,19,115,"Iowa","Louisa County",3,34,112,58,54
050,19,115,"Iowa","Louisa County",3,35,108,52,56
050,19,115,"Iowa","Louisa County",3,36,116,57,59
050,19,115,"Iowa","Louisa County",3,37,138,73,65
050,19,115,"Iowa","Louisa County",3,38,137,76,61
050,19,115,"Iowa","Louisa County",3,39,152,86,66
050,19,115,"Iowa","Louisa County",3,40,165,94,71
050,19,115,"Iowa","Louisa County",3,41,152,78,74
050,19,115,"Iowa","Louisa County",3,42,131,68,63
050,19,115,"Iowa","Louisa County",3,43,135,68,67
050,19,115,"Iowa","Louisa County",3,44,132,58,74
050,19,115,"Iowa","Louisa County",3,45,137,67,70
050,19,115,"Iowa","Louisa County",3,46,134,67,67
050,19,115,"Iowa","Louisa County",3,47,120,65,55
050,19,115,"Iowa","Louisa County",3,48,107,56,51
050,19,115,"Iowa","Louisa County",3,49,107,59,48
050,19,115,"Iowa","Louisa County",3,50,125,72,53
050,19,115,"Iowa","Louisa County",3,51,140,80,60
050,19,115,"Iowa","Louisa County",3,52,121,57,64
050,19,115,"Iowa","Louisa County",3,53,126,62,64
050,19,115,"Iowa","Louisa County",3,54,138,73,65
050,19,115,"Iowa","Louisa County",3,55,150,78,72
050,19,115,"Iowa","Louisa County",3,56,177,85,92
050,19,115,"Iowa","Louisa County",3,57,183,94,89
050,19,115,"Iowa","Louisa County",3,58,169,85,84
050,19,115,"Iowa","Louisa County",3,59,171,85,86
050,19,115,"Iowa","Louisa County",3,60,178,91,87
050,19,115,"Iowa","Louisa County",3,61,167,84,83
050,19,115,"Iowa","Louisa County",3,62,160,78,82
050,19,115,"Iowa","Louisa County",3,63,150,73,77
050,19,115,"Iowa","Louisa County",3,64,135,66,69
050,19,115,"Iowa","Louisa County",3,65,150,78,72
050,19,115,"Iowa","Louisa County",3,66,145,73,72
050,19,115,"Iowa","Louisa County",3,67,143,70,73
050,19,115,"Iowa","Louisa County",3,68,137,65,72
050,19,115,"Iowa","Louisa County",3,69,131,65,66
050,19,115,"Iowa","Louisa County",3,70,124,58,66
050,19,115,"Iowa","Louisa County",3,71,107,53,54
050,19,115,"Iowa","Louisa County",3,72,98,56,42
050,19,115,"Iowa","Louisa County",3,73,97,54,43
050,19,115,"Iowa","Louisa County",3,74,111,56,55
050,19,115,"Iowa","Louisa County",3,75,80,42,38
050,19,115,"Iowa","Louisa County",3,76,72,36,36
050,19,115,"Iowa","Louisa County",3,77,79,36,43
050,19,115,"Iowa","Louisa County",3,78,76,34,42
050,19,115,"Iowa","Louisa County",3,79,63,27,36
050,19,115,"Iowa","Louisa County",3,80,45,20,25
050,19,115,"Iowa","Louisa County",3,81,54,25,29
050,19,115,"Iowa","Louisa County",3,82,64,29,35
050,19,115,"Iowa","Louisa County",3,83,54,22,32
050,19,115,"Iowa","Louisa County",3,84,31,14,17
050,19,115,"Iowa","Louisa County",3,85,267,85,182
050,19,115,"Iowa","Louisa County",4,0,108,58,50
050,19,115,"Iowa","Louisa County",4,1,107,58,49
050,19,115,"Iowa","Louisa County",4,2,98,59,39
050,19,115,"Iowa","Louisa County",4,3,120,63,57
050,19,115,"Iowa","Louisa County",4,4,117,68,49
050,19,115,"Iowa","Louisa County",4,5,132,69,63
050,19,115,"Iowa","Louisa County",4,6,136,72,64
050,19,115,"Iowa","Louisa County",4,7,120,54,66
050,19,115,"Iowa","Louisa County",4,8,125,60,65
050,19,115,"Iowa","Louisa County",4,9,137,68,69
050,19,115,"Iowa","Louisa County",4,10,120,53,67
050,19,115,"Iowa","Louisa County",4,11,118,61,57
050,19,115,"Iowa","Louisa County",4,12,129,64,65
050,19,115,"Iowa","Louisa County",4,13,138,72,66
050,19,115,"Iowa","Louisa County",4,14,146,83,63
050,19,115,"Iowa","Louisa County",4,15,141,72,69
050,19,115,"Iowa","Louisa County",4,16,148,82,66
050,19,115,"Iowa","Louisa County",4,17,144,75,69
050,19,115,"Iowa","Louisa County",4,18,122,69,53
050,19,115,"Iowa","Louisa County",4,19,102,55,47
050,19,115,"Iowa","Louisa County",4,20,118,72,46
050,19,115,"Iowa","Louisa County",4,21,119,65,54
050,19,115,"Iowa","Louisa County",4,22,109,59,50
050,19,115,"Iowa","Louisa County",4,23,119,72,47
050,19,115,"Iowa","Louisa County",4,24,98,46,52
050,19,115,"Iowa","Louisa County",4,25,132,73,59
050,19,115,"Iowa","Louisa County",4,26,123,68,55
050,19,115,"Iowa","Louisa County",4,27,120,62,58
050,19,115,"Iowa","Louisa County",4,28,128,66,62
050,19,115,"Iowa","Louisa County",4,29,120,71,49
050,19,115,"Iowa","Louisa County",4,30,109,59,50
050,19,115,"Iowa","Louisa County",4,31,117,67,50
050,19,115,"Iowa","Louisa County",4,32,111,55,56
050,19,115,"Iowa","Louisa County",4,33,109,58,51
050,19,115,"Iowa","Louisa County",4,34,118,55,63
050,19,115,"Iowa","Louisa County",4,35,103,53,50
050,19,115,"Iowa","Louisa County",4,36,103,53,50
050,19,115,"Iowa","Louisa County",4,37,105,45,60
050,19,115,"Iowa","Louisa County",4,38,133,74,59
050,19,115,"Iowa","Louisa County",4,39,131,71,60
050,19,115,"Iowa","Louisa County",4,40,147,82,65
050,19,115,"Iowa","Louisa County",4,41,160,89,71
050,19,115,"Iowa","Louisa County",4,42,149,75,74
050,19,115,"Iowa","Louisa County",4,43,132,68,64
050,19,115,"Iowa","Louisa County",4,44,140,71,69
050,19,115,"Iowa","Louisa County",4,45,133,61,72
050,19,115,"Iowa","Louisa County",4,46,132,62,70
050,19,115,"Iowa","Louisa County",4,47,133,65,68
050,19,115,"Iowa","Louisa County",4,48,116,64,52
050,19,115,"Iowa","Louisa County",4,49,106,54,52
050,19,115,"Iowa","Louisa County",4,50,105,57,48
050,19,115,"Iowa","Louisa County",4,51,126,71,55
050,19,115,"Iowa","Louisa County",4,52,142,82,60
050,19,115,"Iowa","Louisa County",4,53,123,58,65
050,19,115,"Iowa","Louisa County",4,54,129,66,63
050,19,115,"Iowa","Louisa County",4,55,141,72,69
050,19,115,"Iowa","Louisa County",4,56,151,80,71
050,19,115,"Iowa","Louisa County",4,57,176,87,89
050,19,115,"Iowa","Louisa County",4,58,183,94,89
050,19,115,"Iowa","Louisa County",4,59,171,85,86
050,19,115,"Iowa","Louisa County",4,60,171,86,85
050,19,115,"Iowa","Louisa County",4,61,182,92,90
050,19,115,"Iowa","Louisa County",4,62,168,85,83
050,19,115,"Iowa","Louisa County",4,63,161,80,81
050,19,115,"Iowa","Louisa County",4,64,151,72,79
050,19,115,"Iowa","Louisa County",4,65,136,72,64
050,19,115,"Iowa","Louisa County",4,66,148,74,74
050,19,115,"Iowa","Louisa County",4,67,142,72,70
050,19,115,"Iowa","Louisa County",4,68,136,66,70
050,19,115,"Iowa","Louisa County",4,69,137,65,72
050,19,115,"Iowa","Louisa County",4,70,128,63,65
050,19,115,"Iowa","Louisa County",4,71,119,55,64
050,19,115,"Iowa","Louisa County",4,72,102,51,51
050,19,115,"Iowa","Louisa County",4,73,99,58,41
050,19,115,"Iowa","Louisa County",4,74,96,52,44
050,19,115,"Iowa","Louisa County",4,75,103,52,51
050,19,115,"Iowa","Louisa County",4,76,79,43,36
050,19,115,"Iowa","Louisa County",4,77,63,30,33
050,19,115,"Iowa","Louisa County",4,78,77,34,43
050,19,115,"Iowa","Louisa County",4,79,76,33,43
050,19,115,"Iowa","Louisa County",4,80,58,26,32
050,19,115,"Iowa","Louisa County",4,81,45,19,26
050,19,115,"Iowa","Louisa County",4,82,56,27,29
050,19,115,"Iowa","Louisa County",4,83,51,23,28
050,19,115,"Iowa","Louisa County",4,84,47,23,24
050,19,115,"Iowa","Louisa County",4,85,258,83,175
050,19,115,"Iowa","Louisa County",5,0,111,61,50
050,19,115,"Iowa","Louisa County",5,1,116,61,55
050,19,115,"Iowa","Louisa County",5,2,107,58,49
050,19,115,"Iowa","Louisa County",5,3,95,52,43
050,19,115,"Iowa","Louisa County",5,4,122,64,58
050,19,115,"Iowa","Louisa County",5,5,122,73,49
050,19,115,"Iowa","Louisa County",5,6,124,60,64
050,19,115,"Iowa","Louisa County",5,7,136,70,66
050,19,115,"Iowa","Louisa County",5,8,120,52,68
050,19,115,"Iowa","Louisa County",5,9,115,54,61
050,19,115,"Iowa","Louisa County",5,10,123,68,55
050,19,115,"Iowa","Louisa County",5,11,115,51,64
050,19,115,"Iowa","Louisa County",5,12,124,60,64
050,19,115,"Iowa","Louisa County",5,13,125,61,64
050,19,115,"Iowa","Louisa County",5,14,138,69,69
050,19,115,"Iowa","Louisa County",5,15,148,87,61
050,19,115,"Iowa","Louisa County",5,16,136,71,65
050,19,115,"Iowa","Louisa County",5,17,148,80,68
050,19,115,"Iowa","Louisa County",5,18,118,64,54
050,19,115,"Iowa","Louisa County",5,19,103,59,44
050,19,115,"Iowa","Louisa County",5,20,105,54,51
050,19,115,"Iowa","Louisa County",5,21,115,70,45
050,19,115,"Iowa","Louisa County",5,22,121,65,56
050,19,115,"Iowa","Louisa County",5,23,112,58,54
050,19,115,"Iowa","Louisa County",5,24,111,65,46
050,19,115,"Iowa","Louisa County",5,25,113,56,57
050,19,115,"Iowa","Louisa County",5,26,125,72,53
050,19,115,"Iowa","Louisa County",5,27,128,69,59
050,19,115,"Iowa","Louisa County",5,28,119,61,58
050,19,115,"Iowa","Louisa County",5,29,122,62,60
050,19,115,"Iowa","Louisa County",5,30,128,72,56
050,19,115,"Iowa","Louisa County",5,31,104,54,50
050,19,115,"Iowa","Louisa County",5,32,119,66,53
050,19,115,"Iowa","Louisa County",5,33,111,56,55
050,19,115,"Iowa","Louisa County",5,34,106,55,51
050,19,115,"Iowa","Louisa County",5,35,124,60,64
050,19,115,"Iowa","Louisa County",5,36,108,60,48
050,19,115,"Iowa","Louisa County",5,37,104,49,55
050,19,115,"Iowa","Louisa County",5,38,101,44,57
050,19,115,"Iowa","Louisa County",5,39,129,75,54
050,19,115,"Iowa","Louisa County",5,40,132,71,61
050,19,115,"Iowa","Louisa County",5,41,146,83,63
050,19,115,"Iowa","Louisa County",5,42,158,87,71
050,19,115,"Iowa","Louisa County",5,43,150,77,73
050,19,115,"Iowa","Louisa County",5,44,132,69,63
050,19,115,"Iowa","Louisa County",5,45,139,71,68
050,19,115,"Iowa","Louisa County",5,46,120,49,71
050,19,115,"Iowa","Louisa County",5,47,126,59,67
050,19,115,"Iowa","Louisa County",5,48,134,68,66
050,19,115,"Iowa","Louisa County",5,49,116,61,55
050,19,115,"Iowa","Louisa County",5,50,106,53,53
050,19,115,"Iowa","Louisa County",5,51,98,53,45
050,19,115,"Iowa","Louisa County",5,52,128,74,54
050,19,115,"Iowa","Louisa County",5,53,140,81,59
050,19,115,"Iowa","Louisa County",5,54,128,63,65
050,19,115,"Iowa","Louisa County",5,55,136,74,62
050,19,115,"Iowa","Louisa County",5,56,134,68,66
050,19,115,"Iowa","Louisa County",5,57,150,81,69
050,19,115,"Iowa","Louisa County",5,58,172,82,90
050,19,115,"Iowa","Louisa County",5,59,179,92,87
050,19,115,"Iowa","Louisa County",5,60,173,87,86
050,19,115,"Iowa","Louisa County",5,61,170,83,87
050,19,115,"Iowa","Louisa County",5,62,176,89,87
050,19,115,"Iowa","Louisa County",5,63,168,85,83
050,19,115,"Iowa","Louisa County",5,64,160,80,80
050,19,115,"Iowa","Louisa County",5,65,157,78,79
050,19,115,"Iowa","Louisa County",5,66,134,71,63
050,19,115,"Iowa","Louisa County",5,67,142,73,69
050,19,115,"Iowa","Louisa County",5,68,133,68,65
050,19,115,"Iowa","Louisa County",5,69,139,66,73
050,19,115,"Iowa","Louisa County",5,70,138,65,73
050,19,115,"Iowa","Louisa County",5,71,126,61,65
050,19,115,"Iowa","Louisa County",5,72,115,53,62
050,19,115,"Iowa","Louisa County",5,73,101,54,47
050,19,115,"Iowa","Louisa County",5,74,98,57,41
050,19,115,"Iowa","Louisa County",5,75,93,51,42
050,19,115,"Iowa","Louisa County",5,76,96,50,46
050,19,115,"Iowa","Louisa County",5,77,74,39,35
050,19,115,"Iowa","Louisa County",5,78,60,25,35
050,19,115,"Iowa","Louisa County",5,79,74,32,42
050,19,115,"Iowa","Louisa County",5,80,70,33,37
050,19,115,"Iowa","Louisa County",5,81,51,22,29
050,19,115,"Iowa","Louisa County",5,82,44,20,24
050,19,115,"Iowa","Louisa County",5,83,47,23,24
050,19,115,"Iowa","Louisa County",5,84,41,23,18
050,19,115,"Iowa","Louisa County",5,85,258,90,168
050,19,117,"Iowa","Lucas County",1,0,98,49,49
050,19,117,"Iowa","Lucas County",1,1,106,50,56
050,19,117,"Iowa","Lucas County",1,2,121,65,56
050,19,117,"Iowa","Lucas County",1,3,106,61,45
050,19,117,"Iowa","Lucas County",1,4,114,57,57
050,19,117,"Iowa","Lucas County",1,5,112,57,55
050,19,117,"Iowa","Lucas County",1,6,96,54,42
050,19,117,"Iowa","Lucas County",1,7,96,54,42
050,19,117,"Iowa","Lucas County",1,8,105,57,48
050,19,117,"Iowa","Lucas County",1,9,117,59,58
050,19,117,"Iowa","Lucas County",1,10,99,49,50
050,19,117,"Iowa","Lucas County",1,11,121,68,53
050,19,117,"Iowa","Lucas County",1,12,133,70,63
050,19,117,"Iowa","Lucas County",1,13,129,67,62
050,19,117,"Iowa","Lucas County",1,14,124,62,62
050,19,117,"Iowa","Lucas County",1,15,94,45,49
050,19,117,"Iowa","Lucas County",1,16,107,50,57
050,19,117,"Iowa","Lucas County",1,17,111,59,52
050,19,117,"Iowa","Lucas County",1,18,108,67,41
050,19,117,"Iowa","Lucas County",1,19,83,50,33
050,19,117,"Iowa","Lucas County",1,20,73,42,31
050,19,117,"Iowa","Lucas County",1,21,86,50,36
050,19,117,"Iowa","Lucas County",1,22,88,48,40
050,19,117,"Iowa","Lucas County",1,23,84,43,41
050,19,117,"Iowa","Lucas County",1,24,94,43,51
050,19,117,"Iowa","Lucas County",1,25,101,50,51
050,19,117,"Iowa","Lucas County",1,26,113,65,48
050,19,117,"Iowa","Lucas County",1,27,93,48,45
050,19,117,"Iowa","Lucas County",1,28,101,52,49
050,19,117,"Iowa","Lucas County",1,29,101,54,47
050,19,117,"Iowa","Lucas County",1,30,86,44,42
050,19,117,"Iowa","Lucas County",1,31,77,43,34
050,19,117,"Iowa","Lucas County",1,32,87,44,43
050,19,117,"Iowa","Lucas County",1,33,85,45,40
050,19,117,"Iowa","Lucas County",1,34,83,47,36
050,19,117,"Iowa","Lucas County",1,35,75,39,36
050,19,117,"Iowa","Lucas County",1,36,85,42,43
050,19,117,"Iowa","Lucas County",1,37,81,45,36
050,19,117,"Iowa","Lucas County",1,38,85,47,38
050,19,117,"Iowa","Lucas County",1,39,104,54,50
050,19,117,"Iowa","Lucas County",1,40,101,50,51
050,19,117,"Iowa","Lucas County",1,41,98,47,51
050,19,117,"Iowa","Lucas County",1,42,89,44,45
050,19,117,"Iowa","Lucas County",1,43,95,44,51
050,19,117,"Iowa","Lucas County",1,44,89,46,43
050,19,117,"Iowa","Lucas County",1,45,89,50,39
050,19,117,"Iowa","Lucas County",1,46,75,34,41
050,19,117,"Iowa","Lucas County",1,47,86,45,41
050,19,117,"Iowa","Lucas County",1,48,104,55,49
050,19,117,"Iowa","Lucas County",1,49,101,58,43
050,19,117,"Iowa","Lucas County",1,50,99,54,45
050,19,117,"Iowa","Lucas County",1,51,114,59,55
050,19,117,"Iowa","Lucas County",1,52,97,54,43
050,19,117,"Iowa","Lucas County",1,53,110,57,53
050,19,117,"Iowa","Lucas County",1,54,114,59,55
050,19,117,"Iowa","Lucas County",1,55,119,63,56
050,19,117,"Iowa","Lucas County",1,56,134,70,64
050,19,117,"Iowa","Lucas County",1,57,132,69,63
050,19,117,"Iowa","Lucas County",1,58,125,59,66
050,19,117,"Iowa","Lucas County",1,59,141,74,67
050,19,117,"Iowa","Lucas County",1,60,151,76,75
050,19,117,"Iowa","Lucas County",1,61,156,85,71
050,19,117,"Iowa","Lucas County",1,62,131,66,65
050,19,117,"Iowa","Lucas County",1,63,130,58,72
050,19,117,"Iowa","Lucas County",1,64,124,58,66
050,19,117,"Iowa","Lucas County",1,65,115,58,57
050,19,117,"Iowa","Lucas County",1,66,132,64,68
050,19,117,"Iowa","Lucas County",1,67,138,74,64
050,19,117,"Iowa","Lucas County",1,68,119,66,53
050,19,117,"Iowa","Lucas County",1,69,110,55,55
050,19,117,"Iowa","Lucas County",1,70,100,53,47
050,19,117,"Iowa","Lucas County",1,71,90,43,47
050,19,117,"Iowa","Lucas County",1,72,88,42,46
050,19,117,"Iowa","Lucas County",1,73,91,44,47
050,19,117,"Iowa","Lucas County",1,74,67,26,41
050,19,117,"Iowa","Lucas County",1,75,73,39,34
050,19,117,"Iowa","Lucas County",1,76,81,44,37
050,19,117,"Iowa","Lucas County",1,77,63,34,29
050,19,117,"Iowa","Lucas County",1,78,64,28,36
050,19,117,"Iowa","Lucas County",1,79,54,21,33
050,19,117,"Iowa","Lucas County",1,80,55,27,28
050,19,117,"Iowa","Lucas County",1,81,60,33,27
050,19,117,"Iowa","Lucas County",1,82,59,25,34
050,19,117,"Iowa","Lucas County",1,83,44,15,29
050,19,117,"Iowa","Lucas County",1,84,36,13,23
050,19,117,"Iowa","Lucas County",1,85,228,92,136
050,19,117,"Iowa","Lucas County",2,0,100,47,53
050,19,117,"Iowa","Lucas County",2,1,104,49,55
050,19,117,"Iowa","Lucas County",2,2,117,61,56
050,19,117,"Iowa","Lucas County",2,3,106,59,47
050,19,117,"Iowa","Lucas County",2,4,114,60,54
050,19,117,"Iowa","Lucas County",2,5,111,56,55
050,19,117,"Iowa","Lucas County",2,6,100,54,46
050,19,117,"Iowa","Lucas County",2,7,97,54,43
050,19,117,"Iowa","Lucas County",2,8,102,55,47
050,19,117,"Iowa","Lucas County",2,9,111,57,54
050,19,117,"Iowa","Lucas County",2,10,105,53,52
050,19,117,"Iowa","Lucas County",2,11,116,65,51
050,19,117,"Iowa","Lucas County",2,12,131,70,61
050,19,117,"Iowa","Lucas County",2,13,129,67,62
050,19,117,"Iowa","Lucas County",2,14,123,62,61
050,19,117,"Iowa","Lucas County",2,15,101,49,52
050,19,117,"Iowa","Lucas County",2,16,105,49,56
050,19,117,"Iowa","Lucas County",2,17,112,58,54
050,19,117,"Iowa","Lucas County",2,18,103,62,41
050,19,117,"Iowa","Lucas County",2,19,84,51,33
050,19,117,"Iowa","Lucas County",2,20,75,44,31
050,19,117,"Iowa","Lucas County",2,21,84,48,36
050,19,117,"Iowa","Lucas County",2,22,86,48,38
050,19,117,"Iowa","Lucas County",2,23,87,44,43
050,19,117,"Iowa","Lucas County",2,24,91,42,49
050,19,117,"Iowa","Lucas County",2,25,101,49,52
050,19,117,"Iowa","Lucas County",2,26,110,61,49
050,19,117,"Iowa","Lucas County",2,27,97,52,45
050,19,117,"Iowa","Lucas County",2,28,99,50,49
050,19,117,"Iowa","Lucas County",2,29,100,52,48
050,19,117,"Iowa","Lucas County",2,30,89,46,43
050,19,117,"Iowa","Lucas County",2,31,80,44,36
050,19,117,"Iowa","Lucas County",2,32,82,42,40
050,19,117,"Iowa","Lucas County",2,33,84,44,40
050,19,117,"Iowa","Lucas County",2,34,83,46,37
050,19,117,"Iowa","Lucas County",2,35,79,42,37
050,19,117,"Iowa","Lucas County",2,36,84,42,42
050,19,117,"Iowa","Lucas County",2,37,81,44,37
050,19,117,"Iowa","Lucas County",2,38,84,46,38
050,19,117,"Iowa","Lucas County",2,39,101,54,47
050,19,117,"Iowa","Lucas County",2,40,104,51,53
050,19,117,"Iowa","Lucas County",2,41,98,47,51
050,19,117,"Iowa","Lucas County",2,42,91,44,47
050,19,117,"Iowa","Lucas County",2,43,93,44,49
050,19,117,"Iowa","Lucas County",2,44,91,47,44
050,19,117,"Iowa","Lucas County",2,45,90,49,41
050,19,117,"Iowa","Lucas County",2,46,79,39,40
050,19,117,"Iowa","Lucas County",2,47,83,43,40
050,19,117,"Iowa","Lucas County",2,48,101,54,47
050,19,117,"Iowa","Lucas County",2,49,103,59,44
050,19,117,"Iowa","Lucas County",2,50,101,55,46
050,19,117,"Iowa","Lucas County",2,51,109,58,51
050,19,117,"Iowa","Lucas County",2,52,100,55,45
050,19,117,"Iowa","Lucas County",2,53,106,56,50
050,19,117,"Iowa","Lucas County",2,54,112,58,54
050,19,117,"Iowa","Lucas County",2,55,117,62,55
050,19,117,"Iowa","Lucas County",2,56,130,68,62
050,19,117,"Iowa","Lucas County",2,57,133,70,63
050,19,117,"Iowa","Lucas County",2,58,128,62,66
050,19,117,"Iowa","Lucas County",2,59,139,71,68
050,19,117,"Iowa","Lucas County",2,60,149,76,73
050,19,117,"Iowa","Lucas County",2,61,153,81,72
050,19,117,"Iowa","Lucas County",2,62,136,70,66
050,19,117,"Iowa","Lucas County",2,63,132,61,71
050,19,117,"Iowa","Lucas County",2,64,125,57,68
050,19,117,"Iowa","Lucas County",2,65,117,58,59
050,19,117,"Iowa","Lucas County",2,66,128,62,66
050,19,117,"Iowa","Lucas County",2,67,136,71,65
050,19,117,"Iowa","Lucas County",2,68,121,66,55
050,19,117,"Iowa","Lucas County",2,69,114,58,56
050,19,117,"Iowa","Lucas County",2,70,103,54,49
050,19,117,"Iowa","Lucas County",2,71,91,45,46
050,19,117,"Iowa","Lucas County",2,72,87,42,45
050,19,117,"Iowa","Lucas County",2,73,94,46,48
050,19,117,"Iowa","Lucas County",2,74,64,27,37
050,19,117,"Iowa","Lucas County",2,75,71,35,36
050,19,117,"Iowa","Lucas County",2,76,77,42,35
050,19,117,"Iowa","Lucas County",2,77,69,38,31
050,19,117,"Iowa","Lucas County",2,78,63,29,34
050,19,117,"Iowa","Lucas County",2,79,55,23,32
050,19,117,"Iowa","Lucas County",2,80,53,24,29
050,19,117,"Iowa","Lucas County",2,81,55,28,27
050,19,117,"Iowa","Lucas County",2,82,59,27,32
050,19,117,"Iowa","Lucas County",2,83,45,16,29
050,19,117,"Iowa","Lucas County",2,84,37,13,24
050,19,117,"Iowa","Lucas County",2,85,228,93,135
050,19,117,"Iowa","Lucas County",3,0,107,52,55
050,19,117,"Iowa","Lucas County",3,1,98,50,48
050,19,117,"Iowa","Lucas County",3,2,115,57,58
050,19,117,"Iowa","Lucas County",3,3,117,60,57
050,19,117,"Iowa","Lucas County",3,4,112,61,51
050,19,117,"Iowa","Lucas County",3,5,120,65,55
050,19,117,"Iowa","Lucas County",3,6,113,58,55
050,19,117,"Iowa","Lucas County",3,7,103,54,49
050,19,117,"Iowa","Lucas County",3,8,101,57,44
050,19,117,"Iowa","Lucas County",3,9,105,58,47
050,19,117,"Iowa","Lucas County",3,10,122,65,57
050,19,117,"Iowa","Lucas County",3,11,101,53,48
050,19,117,"Iowa","Lucas County",3,12,119,68,51
050,19,117,"Iowa","Lucas County",3,13,128,70,58
050,19,117,"Iowa","Lucas County",3,14,128,69,59
050,19,117,"Iowa","Lucas County",3,15,129,66,63
050,19,117,"Iowa","Lucas County",3,16,108,47,61
050,19,117,"Iowa","Lucas County",3,17,106,48,58
050,19,117,"Iowa","Lucas County",3,18,90,47,43
050,19,117,"Iowa","Lucas County",3,19,74,44,30
050,19,117,"Iowa","Lucas County",3,20,93,55,38
050,19,117,"Iowa","Lucas County",3,21,77,47,30
050,19,117,"Iowa","Lucas County",3,22,92,52,40
050,19,117,"Iowa","Lucas County",3,23,82,44,38
050,19,117,"Iowa","Lucas County",3,24,86,45,41
050,19,117,"Iowa","Lucas County",3,25,82,38,44
050,19,117,"Iowa","Lucas County",3,26,102,49,53
050,19,117,"Iowa","Lucas County",3,27,109,59,50
050,19,117,"Iowa","Lucas County",3,28,102,52,50
050,19,117,"Iowa","Lucas County",3,29,96,49,47
050,19,117,"Iowa","Lucas County",3,30,98,49,49
050,19,117,"Iowa","Lucas County",3,31,90,47,43
050,19,117,"Iowa","Lucas County",3,32,88,48,40
050,19,117,"Iowa","Lucas County",3,33,91,48,43
050,19,117,"Iowa","Lucas County",3,34,93,50,43
050,19,117,"Iowa","Lucas County",3,35,78,45,33
050,19,117,"Iowa","Lucas County",3,36,87,47,40
050,19,117,"Iowa","Lucas County",3,37,90,44,46
050,19,117,"Iowa","Lucas County",3,38,78,42,36
050,19,117,"Iowa","Lucas County",3,39,86,46,40
050,19,117,"Iowa","Lucas County",3,40,100,56,44
050,19,117,"Iowa","Lucas County",3,41,107,55,52
050,19,117,"Iowa","Lucas County",3,42,102,50,52
050,19,117,"Iowa","Lucas County",3,43,86,44,42
050,19,117,"Iowa","Lucas County",3,44,96,46,50
050,19,117,"Iowa","Lucas County",3,45,95,48,47
050,19,117,"Iowa","Lucas County",3,46,89,48,41
050,19,117,"Iowa","Lucas County",3,47,78,37,41
050,19,117,"Iowa","Lucas County",3,48,84,44,40
050,19,117,"Iowa","Lucas County",3,49,101,56,45
050,19,117,"Iowa","Lucas County",3,50,106,56,50
050,19,117,"Iowa","Lucas County",3,51,103,58,45
050,19,117,"Iowa","Lucas County",3,52,114,59,55
050,19,117,"Iowa","Lucas County",3,53,103,57,46
050,19,117,"Iowa","Lucas County",3,54,105,55,50
050,19,117,"Iowa","Lucas County",3,55,115,61,54
050,19,117,"Iowa","Lucas County",3,56,116,62,54
050,19,117,"Iowa","Lucas County",3,57,132,69,63
050,19,117,"Iowa","Lucas County",3,58,136,71,65
050,19,117,"Iowa","Lucas County",3,59,132,65,67
050,19,117,"Iowa","Lucas County",3,60,140,72,68
050,19,117,"Iowa","Lucas County",3,61,142,73,69
050,19,117,"Iowa","Lucas County",3,62,154,81,73
050,19,117,"Iowa","Lucas County",3,63,142,75,67
050,19,117,"Iowa","Lucas County",3,64,136,63,73
050,19,117,"Iowa","Lucas County",3,65,124,57,67
050,19,117,"Iowa","Lucas County",3,66,120,59,61
050,19,117,"Iowa","Lucas County",3,67,132,64,68
050,19,117,"Iowa","Lucas County",3,68,130,68,62
050,19,117,"Iowa","Lucas County",3,69,122,67,55
050,19,117,"Iowa","Lucas County",3,70,109,55,54
050,19,117,"Iowa","Lucas County",3,71,102,52,50
050,19,117,"Iowa","Lucas County",3,72,82,39,43
050,19,117,"Iowa","Lucas County",3,73,83,42,41
050,19,117,"Iowa","Lucas County",3,74,91,44,47
050,19,117,"Iowa","Lucas County",3,75,63,28,35
050,19,117,"Iowa","Lucas County",3,76,68,31,37
050,19,117,"Iowa","Lucas County",3,77,75,41,34
050,19,117,"Iowa","Lucas County",3,78,69,37,32
050,19,117,"Iowa","Lucas County",3,79,58,26,32
050,19,117,"Iowa","Lucas County",3,80,51,21,30
050,19,117,"Iowa","Lucas County",3,81,50,24,26
050,19,117,"Iowa","Lucas County",3,82,54,27,27
050,19,117,"Iowa","Lucas County",3,83,51,25,26
050,19,117,"Iowa","Lucas County",3,84,40,11,29
050,19,117,"Iowa","Lucas County",3,85,222,89,133
050,19,117,"Iowa","Lucas County",4,0,113,59,54
050,19,117,"Iowa","Lucas County",4,1,110,53,57
050,19,117,"Iowa","Lucas County",4,2,91,44,47
050,19,117,"Iowa","Lucas County",4,3,116,55,61
050,19,117,"Iowa","Lucas County",4,4,117,64,53
050,19,117,"Iowa","Lucas County",4,5,114,64,50
050,19,117,"Iowa","Lucas County",4,6,118,64,54
050,19,117,"Iowa","Lucas County",4,7,112,59,53
050,19,117,"Iowa","Lucas County",4,8,103,55,48
050,19,117,"Iowa","Lucas County",4,9,104,57,47
050,19,117,"Iowa","Lucas County",4,10,105,54,51
050,19,117,"Iowa","Lucas County",4,11,121,61,60
050,19,117,"Iowa","Lucas County",4,12,104,53,51
050,19,117,"Iowa","Lucas County",4,13,115,65,50
050,19,117,"Iowa","Lucas County",4,14,129,74,55
050,19,117,"Iowa","Lucas County",4,15,133,73,60
050,19,117,"Iowa","Lucas County",4,16,130,65,65
050,19,117,"Iowa","Lucas County",4,17,108,53,55
050,19,117,"Iowa","Lucas County",4,18,83,39,44
050,19,117,"Iowa","Lucas County",4,19,64,35,29
050,19,117,"Iowa","Lucas County",4,20,71,38,33
050,19,117,"Iowa","Lucas County",4,21,93,53,40
050,19,117,"Iowa","Lucas County",4,22,82,48,34
050,19,117,"Iowa","Lucas County",4,23,95,56,39
050,19,117,"Iowa","Lucas County",4,24,85,49,36
050,19,117,"Iowa","Lucas County",4,25,85,44,41
050,19,117,"Iowa","Lucas County",4,26,85,39,46
050,19,117,"Iowa","Lucas County",4,27,103,50,53
050,19,117,"Iowa","Lucas County",4,28,110,60,50
050,19,117,"Iowa","Lucas County",4,29,107,54,53
050,19,117,"Iowa","Lucas County",4,30,100,49,51
050,19,117,"Iowa","Lucas County",4,31,93,49,44
050,19,117,"Iowa","Lucas County",4,32,93,49,44
050,19,117,"Iowa","Lucas County",4,33,92,50,42
050,19,117,"Iowa","Lucas County",4,34,91,48,43
050,19,117,"Iowa","Lucas County",4,35,95,49,46
050,19,117,"Iowa","Lucas County",4,36,88,53,35
050,19,117,"Iowa","Lucas County",4,37,86,45,41
050,19,117,"Iowa","Lucas County",4,38,91,43,48
050,19,117,"Iowa","Lucas County",4,39,73,38,35
050,19,117,"Iowa","Lucas County",4,40,86,45,41
050,19,117,"Iowa","Lucas County",4,41,101,60,41
050,19,117,"Iowa","Lucas County",4,42,102,50,52
050,19,117,"Iowa","Lucas County",4,43,95,49,46
050,19,117,"Iowa","Lucas County",4,44,91,47,44
050,19,117,"Iowa","Lucas County",4,45,97,44,53
050,19,117,"Iowa","Lucas County",4,46,97,48,49
050,19,117,"Iowa","Lucas County",4,47,88,47,41
050,19,117,"Iowa","Lucas County",4,48,77,37,40
050,19,117,"Iowa","Lucas County",4,49,86,46,40
050,19,117,"Iowa","Lucas County",4,50,95,54,41
050,19,117,"Iowa","Lucas County",4,51,105,56,49
050,19,117,"Iowa","Lucas County",4,52,102,60,42
050,19,117,"Iowa","Lucas County",4,53,112,56,56
050,19,117,"Iowa","Lucas County",4,54,103,55,48
050,19,117,"Iowa","Lucas County",4,55,107,58,49
050,19,117,"Iowa","Lucas County",4,56,116,62,54
050,19,117,"Iowa","Lucas County",4,57,116,62,54
050,19,117,"Iowa","Lucas County",4,58,133,68,65
050,19,117,"Iowa","Lucas County",4,59,146,76,70
050,19,117,"Iowa","Lucas County",4,60,137,68,69
050,19,117,"Iowa","Lucas County",4,61,136,70,66
050,19,117,"Iowa","Lucas County",4,62,142,73,69
050,19,117,"Iowa","Lucas County",4,63,154,84,70
050,19,117,"Iowa","Lucas County",4,64,142,73,69
050,19,117,"Iowa","Lucas County",4,65,141,66,75
050,19,117,"Iowa","Lucas County",4,66,122,56,66
050,19,117,"Iowa","Lucas County",4,67,120,58,62
050,19,117,"Iowa","Lucas County",4,68,123,60,63
050,19,117,"Iowa","Lucas County",4,69,131,67,64
050,19,117,"Iowa","Lucas County",4,70,117,66,51
050,19,117,"Iowa","Lucas County",4,71,108,55,53
050,19,117,"Iowa","Lucas County",4,72,95,47,48
050,19,117,"Iowa","Lucas County",4,73,80,39,41
050,19,117,"Iowa","Lucas County",4,74,81,40,41
050,19,117,"Iowa","Lucas County",4,75,88,41,47
050,19,117,"Iowa","Lucas County",4,76,60,25,35
050,19,117,"Iowa","Lucas County",4,77,66,28,38
050,19,117,"Iowa","Lucas County",4,78,72,36,36
050,19,117,"Iowa","Lucas County",4,79,61,34,27
050,19,117,"Iowa","Lucas County",4,80,56,24,32
050,19,117,"Iowa","Lucas County",4,81,51,20,31
050,19,117,"Iowa","Lucas County",4,82,48,25,23
050,19,117,"Iowa","Lucas County",4,83,48,25,23
050,19,117,"Iowa","Lucas County",4,84,50,24,26
050,19,117,"Iowa","Lucas County",4,85,210,74,136
050,19,117,"Iowa","Lucas County",5,0,115,61,54
050,19,117,"Iowa","Lucas County",5,1,109,56,53
050,19,117,"Iowa","Lucas County",5,2,115,51,64
050,19,117,"Iowa","Lucas County",5,3,93,46,47
050,19,117,"Iowa","Lucas County",5,4,114,54,60
050,19,117,"Iowa","Lucas County",5,5,121,62,59
050,19,117,"Iowa","Lucas County",5,6,116,63,53
050,19,117,"Iowa","Lucas County",5,7,119,61,58
050,19,117,"Iowa","Lucas County",5,8,111,55,56
050,19,117,"Iowa","Lucas County",5,9,108,53,55
050,19,117,"Iowa","Lucas County",5,10,108,59,49
050,19,117,"Iowa","Lucas County",5,11,113,61,52
050,19,117,"Iowa","Lucas County",5,12,118,60,58
050,19,117,"Iowa","Lucas County",5,13,107,49,58
050,19,117,"Iowa","Lucas County",5,14,122,68,54
050,19,117,"Iowa","Lucas County",5,15,132,75,57
050,19,117,"Iowa","Lucas County",5,16,132,75,57
050,19,117,"Iowa","Lucas County",5,17,129,63,66
050,19,117,"Iowa","Lucas County",5,18,86,43,43
050,19,117,"Iowa","Lucas County",5,19,63,29,34
050,19,117,"Iowa","Lucas County",5,20,74,41,33
050,19,117,"Iowa","Lucas County",5,21,75,41,34
050,19,117,"Iowa","Lucas County",5,22,97,54,43
050,19,117,"Iowa","Lucas County",5,23,83,47,36
050,19,117,"Iowa","Lucas County",5,24,96,54,42
050,19,117,"Iowa","Lucas County",5,25,86,51,35
050,19,117,"Iowa","Lucas County",5,26,94,45,49
050,19,117,"Iowa","Lucas County",5,27,81,39,42
050,19,117,"Iowa","Lucas County",5,28,104,50,54
050,19,117,"Iowa","Lucas County",5,29,108,59,49
050,19,117,"Iowa","Lucas County",5,30,107,54,53
050,19,117,"Iowa","Lucas County",5,31,94,48,46
050,19,117,"Iowa","Lucas County",5,32,107,59,48
050,19,117,"Iowa","Lucas County",5,33,102,51,51
050,19,117,"Iowa","Lucas County",5,34,90,49,41
050,19,117,"Iowa","Lucas County",5,35,97,52,45
050,19,117,"Iowa","Lucas County",5,36,95,47,48
050,19,117,"Iowa","Lucas County",5,37,84,51,33
050,19,117,"Iowa","Lucas County",5,38,88,43,45
050,19,117,"Iowa","Lucas County",5,39,91,49,42
050,19,117,"Iowa","Lucas County",5,40,81,41,40
050,19,117,"Iowa","Lucas County",5,41,92,49,43
050,19,117,"Iowa","Lucas County",5,42,103,60,43
050,19,117,"Iowa","Lucas County",5,43,103,49,54
050,19,117,"Iowa","Lucas County",5,44,100,51,49
050,19,117,"Iowa","Lucas County",5,45,85,39,46
050,19,117,"Iowa","Lucas County",5,46,99,47,52
050,19,117,"Iowa","Lucas County",5,47,99,50,49
050,19,117,"Iowa","Lucas County",5,48,89,46,43
050,19,117,"Iowa","Lucas County",5,49,78,39,39
050,19,117,"Iowa","Lucas County",5,50,83,44,39
050,19,117,"Iowa","Lucas County",5,51,102,58,44
050,19,117,"Iowa","Lucas County",5,52,109,57,52
050,19,117,"Iowa","Lucas County",5,53,105,59,46
050,19,117,"Iowa","Lucas County",5,54,108,54,54
050,19,117,"Iowa","Lucas County",5,55,101,54,47
050,19,117,"Iowa","Lucas County",5,56,107,60,47
050,19,117,"Iowa","Lucas County",5,57,108,56,52
050,19,117,"Iowa","Lucas County",5,58,113,60,53
050,19,117,"Iowa","Lucas County",5,59,133,67,66
050,19,117,"Iowa","Lucas County",5,60,149,79,70
050,19,117,"Iowa","Lucas County",5,61,133,64,69
050,19,117,"Iowa","Lucas County",5,62,132,64,68
050,19,117,"Iowa","Lucas County",5,63,142,76,66
050,19,117,"Iowa","Lucas County",5,64,150,81,69
050,19,117,"Iowa","Lucas County",5,65,142,72,70
050,19,117,"Iowa","Lucas County",5,66,138,65,73
050,19,117,"Iowa","Lucas County",5,67,116,54,62
050,19,117,"Iowa","Lucas County",5,68,115,54,61
050,19,117,"Iowa","Lucas County",5,69,122,58,64
050,19,117,"Iowa","Lucas County",5,70,129,67,62
050,19,117,"Iowa","Lucas County",5,71,118,67,51
050,19,117,"Iowa","Lucas County",5,72,100,50,50
050,19,117,"Iowa","Lucas County",5,73,90,44,46
050,19,117,"Iowa","Lucas County",5,74,79,37,42
050,19,117,"Iowa","Lucas County",5,75,77,38,39
050,19,117,"Iowa","Lucas County",5,76,90,39,51
050,19,117,"Iowa","Lucas County",5,77,55,21,34
050,19,117,"Iowa","Lucas County",5,78,63,23,40
050,19,117,"Iowa","Lucas County",5,79,67,34,33
050,19,117,"Iowa","Lucas County",5,80,59,31,28
050,19,117,"Iowa","Lucas County",5,81,53,21,32
050,19,117,"Iowa","Lucas County",5,82,46,20,26
050,19,117,"Iowa","Lucas County",5,83,41,22,19
050,19,117,"Iowa","Lucas County",5,84,45,22,23
050,19,117,"Iowa","Lucas County",5,85,214,77,137
050,19,119,"Iowa","Lyon County",1,0,172,89,83
050,19,119,"Iowa","Lyon County",1,1,171,90,81
050,19,119,"Iowa","Lyon County",1,2,189,96,93
050,19,119,"Iowa","Lyon County",1,3,186,89,97
050,19,119,"Iowa","Lyon County",1,4,189,93,96
050,19,119,"Iowa","Lyon County",1,5,173,98,75
050,19,119,"Iowa","Lyon County",1,6,182,105,77
050,19,119,"Iowa","Lyon County",1,7,175,102,73
050,19,119,"Iowa","Lyon County",1,8,178,97,81
050,19,119,"Iowa","Lyon County",1,9,193,96,97
050,19,119,"Iowa","Lyon County",1,10,189,97,92
050,19,119,"Iowa","Lyon County",1,11,183,95,88
050,19,119,"Iowa","Lyon County",1,12,198,106,92
050,19,119,"Iowa","Lyon County",1,13,210,112,98
050,19,119,"Iowa","Lyon County",1,14,215,111,104
050,19,119,"Iowa","Lyon County",1,15,210,118,92
050,19,119,"Iowa","Lyon County",1,16,188,96,92
050,19,119,"Iowa","Lyon County",1,17,189,105,84
050,19,119,"Iowa","Lyon County",1,18,152,91,61
050,19,119,"Iowa","Lyon County",1,19,123,68,55
050,19,119,"Iowa","Lyon County",1,20,120,62,58
050,19,119,"Iowa","Lyon County",1,21,127,65,62
050,19,119,"Iowa","Lyon County",1,22,122,68,54
050,19,119,"Iowa","Lyon County",1,23,119,72,47
050,19,119,"Iowa","Lyon County",1,24,109,59,50
050,19,119,"Iowa","Lyon County",1,25,120,65,55
050,19,119,"Iowa","Lyon County",1,26,134,80,54
050,19,119,"Iowa","Lyon County",1,27,134,77,57
050,19,119,"Iowa","Lyon County",1,28,136,64,72
050,19,119,"Iowa","Lyon County",1,29,126,61,65
050,19,119,"Iowa","Lyon County",1,30,110,55,55
050,19,119,"Iowa","Lyon County",1,31,119,58,61
050,19,119,"Iowa","Lyon County",1,32,116,57,59
050,19,119,"Iowa","Lyon County",1,33,123,56,67
050,19,119,"Iowa","Lyon County",1,34,112,53,59
050,19,119,"Iowa","Lyon County",1,35,135,72,63
050,19,119,"Iowa","Lyon County",1,36,141,76,65
050,19,119,"Iowa","Lyon County",1,37,148,75,73
050,19,119,"Iowa","Lyon County",1,38,164,78,86
050,19,119,"Iowa","Lyon County",1,39,152,76,76
050,19,119,"Iowa","Lyon County",1,40,159,87,72
050,19,119,"Iowa","Lyon County",1,41,159,89,70
050,19,119,"Iowa","Lyon County",1,42,160,82,78
050,19,119,"Iowa","Lyon County",1,43,152,72,80
050,19,119,"Iowa","Lyon County",1,44,136,64,72
050,19,119,"Iowa","Lyon County",1,45,129,70,59
050,19,119,"Iowa","Lyon County",1,46,132,72,60
050,19,119,"Iowa","Lyon County",1,47,129,69,60
050,19,119,"Iowa","Lyon County",1,48,130,69,61
050,19,119,"Iowa","Lyon County",1,49,119,61,58
050,19,119,"Iowa","Lyon County",1,50,123,70,53
050,19,119,"Iowa","Lyon County",1,51,118,60,58
050,19,119,"Iowa","Lyon County",1,52,112,57,55
050,19,119,"Iowa","Lyon County",1,53,130,67,63
050,19,119,"Iowa","Lyon County",1,54,131,67,64
050,19,119,"Iowa","Lyon County",1,55,139,71,68
050,19,119,"Iowa","Lyon County",1,56,150,80,70
050,19,119,"Iowa","Lyon County",1,57,139,74,65
050,19,119,"Iowa","Lyon County",1,58,150,79,71
050,19,119,"Iowa","Lyon County",1,59,149,78,71
050,19,119,"Iowa","Lyon County",1,60,143,81,62
050,19,119,"Iowa","Lyon County",1,61,145,80,65
050,19,119,"Iowa","Lyon County",1,62,154,81,73
050,19,119,"Iowa","Lyon County",1,63,152,76,76
050,19,119,"Iowa","Lyon County",1,64,156,77,79
050,19,119,"Iowa","Lyon County",1,65,160,75,85
050,19,119,"Iowa","Lyon County",1,66,142,71,71
050,19,119,"Iowa","Lyon County",1,67,136,72,64
050,19,119,"Iowa","Lyon County",1,68,124,65,59
050,19,119,"Iowa","Lyon County",1,69,120,67,53
050,19,119,"Iowa","Lyon County",1,70,118,59,59
050,19,119,"Iowa","Lyon County",1,71,106,52,54
050,19,119,"Iowa","Lyon County",1,72,112,51,61
050,19,119,"Iowa","Lyon County",1,73,110,52,58
050,19,119,"Iowa","Lyon County",1,74,78,40,38
050,19,119,"Iowa","Lyon County",1,75,66,33,33
050,19,119,"Iowa","Lyon County",1,76,68,31,37
050,19,119,"Iowa","Lyon County",1,77,68,35,33
050,19,119,"Iowa","Lyon County",1,78,57,25,32
050,19,119,"Iowa","Lyon County",1,79,59,29,30
050,19,119,"Iowa","Lyon County",1,80,62,22,40
050,19,119,"Iowa","Lyon County",1,81,59,23,36
050,19,119,"Iowa","Lyon County",1,82,47,19,28
050,19,119,"Iowa","Lyon County",1,83,67,28,39
050,19,119,"Iowa","Lyon County",1,84,58,18,40
050,19,119,"Iowa","Lyon County",1,85,391,131,260
050,19,119,"Iowa","Lyon County",2,0,174,85,89
050,19,119,"Iowa","Lyon County",2,1,171,90,81
050,19,119,"Iowa","Lyon County",2,2,187,95,92
050,19,119,"Iowa","Lyon County",2,3,186,91,95
050,19,119,"Iowa","Lyon County",2,4,187,92,95
050,19,119,"Iowa","Lyon County",2,5,176,96,80
050,19,119,"Iowa","Lyon County",2,6,179,103,76
050,19,119,"Iowa","Lyon County",2,7,177,103,74
050,19,119,"Iowa","Lyon County",2,8,176,97,79
050,19,119,"Iowa","Lyon County",2,9,189,96,93
050,19,119,"Iowa","Lyon County",2,10,191,98,93
050,19,119,"Iowa","Lyon County",2,11,183,95,88
050,19,119,"Iowa","Lyon County",2,12,194,103,91
050,19,119,"Iowa","Lyon County",2,13,206,111,95
050,19,119,"Iowa","Lyon County",2,14,214,112,102
050,19,119,"Iowa","Lyon County",2,15,211,117,94
050,19,119,"Iowa","Lyon County",2,16,190,100,90
050,19,119,"Iowa","Lyon County",2,17,190,104,86
050,19,119,"Iowa","Lyon County",2,18,153,91,62
050,19,119,"Iowa","Lyon County",2,19,124,69,55
050,19,119,"Iowa","Lyon County",2,20,124,65,59
050,19,119,"Iowa","Lyon County",2,21,126,66,60
050,19,119,"Iowa","Lyon County",2,22,122,67,55
050,19,119,"Iowa","Lyon County",2,23,120,71,49
050,19,119,"Iowa","Lyon County",2,24,111,62,49
050,19,119,"Iowa","Lyon County",2,25,119,65,54
050,19,119,"Iowa","Lyon County",2,26,131,77,54
050,19,119,"Iowa","Lyon County",2,27,134,78,56
050,19,119,"Iowa","Lyon County",2,28,137,68,69
050,19,119,"Iowa","Lyon County",2,29,129,61,68
050,19,119,"Iowa","Lyon County",2,30,114,56,58
050,19,119,"Iowa","Lyon County",2,31,117,58,59
050,19,119,"Iowa","Lyon County",2,32,116,57,59
050,19,119,"Iowa","Lyon County",2,33,121,56,65
050,19,119,"Iowa","Lyon County",2,34,115,54,61
050,19,119,"Iowa","Lyon County",2,35,130,67,63
050,19,119,"Iowa","Lyon County",2,36,137,73,64
050,19,119,"Iowa","Lyon County",2,37,144,74,70
050,19,119,"Iowa","Lyon County",2,38,160,77,83
050,19,119,"Iowa","Lyon County",2,39,155,77,78
050,19,119,"Iowa","Lyon County",2,40,159,85,74
050,19,119,"Iowa","Lyon County",2,41,159,88,71
050,19,119,"Iowa","Lyon County",2,42,158,83,75
050,19,119,"Iowa","Lyon County",2,43,155,75,80
050,19,119,"Iowa","Lyon County",2,44,136,65,71
050,19,119,"Iowa","Lyon County",2,45,132,70,62
050,19,119,"Iowa","Lyon County",2,46,130,71,59
050,19,119,"Iowa","Lyon County",2,47,128,69,59
050,19,119,"Iowa","Lyon County",2,48,129,69,60
050,19,119,"Iowa","Lyon County",2,49,123,63,60
050,19,119,"Iowa","Lyon County",2,50,122,68,54
050,19,119,"Iowa","Lyon County",2,51,119,62,57
050,19,119,"Iowa","Lyon County",2,52,114,58,56
050,19,119,"Iowa","Lyon County",2,53,125,64,61
050,19,119,"Iowa","Lyon County",2,54,130,66,64
050,19,119,"Iowa","Lyon County",2,55,138,70,68
050,19,119,"Iowa","Lyon County",2,56,147,77,70
050,19,119,"Iowa","Lyon County",2,57,143,76,67
050,19,119,"Iowa","Lyon County",2,58,146,77,69
050,19,119,"Iowa","Lyon County",2,59,149,78,71
050,19,119,"Iowa","Lyon County",2,60,144,80,64
050,19,119,"Iowa","Lyon County",2,61,145,80,65
050,19,119,"Iowa","Lyon County",2,62,151,80,71
050,19,119,"Iowa","Lyon County",2,63,154,78,76
050,19,119,"Iowa","Lyon County",2,64,154,76,78
050,19,119,"Iowa","Lyon County",2,65,156,74,82
050,19,119,"Iowa","Lyon County",2,66,148,73,75
050,19,119,"Iowa","Lyon County",2,67,137,71,66
050,19,119,"Iowa","Lyon County",2,68,125,66,59
050,19,119,"Iowa","Lyon County",2,69,120,65,55
050,19,119,"Iowa","Lyon County",2,70,117,59,58
050,19,119,"Iowa","Lyon County",2,71,108,54,54
050,19,119,"Iowa","Lyon County",2,72,108,50,58
050,19,119,"Iowa","Lyon County",2,73,117,55,62
050,19,119,"Iowa","Lyon County",2,74,80,40,40
050,19,119,"Iowa","Lyon County",2,75,69,34,35
050,19,119,"Iowa","Lyon County",2,76,65,31,34
050,19,119,"Iowa","Lyon County",2,77,69,35,34
050,19,119,"Iowa","Lyon County",2,78,56,26,30
050,19,119,"Iowa","Lyon County",2,79,59,28,31
050,19,119,"Iowa","Lyon County",2,80,61,24,37
050,19,119,"Iowa","Lyon County",2,81,60,23,37
050,19,119,"Iowa","Lyon County",2,82,49,19,30
050,19,119,"Iowa","Lyon County",2,83,63,25,38
050,19,119,"Iowa","Lyon County",2,84,61,21,40
050,19,119,"Iowa","Lyon County",2,85,392,130,262
050,19,119,"Iowa","Lyon County",3,0,161,84,77
050,19,119,"Iowa","Lyon County",3,1,174,84,90
050,19,119,"Iowa","Lyon County",3,2,162,87,75
050,19,119,"Iowa","Lyon County",3,3,188,90,98
050,19,119,"Iowa","Lyon County",3,4,194,95,99
050,19,119,"Iowa","Lyon County",3,5,190,92,98
050,19,119,"Iowa","Lyon County",3,6,186,105,81
050,19,119,"Iowa","Lyon County",3,7,176,101,75
050,19,119,"Iowa","Lyon County",3,8,181,104,77
050,19,119,"Iowa","Lyon County",3,9,182,103,79
050,19,119,"Iowa","Lyon County",3,10,194,99,95
050,19,119,"Iowa","Lyon County",3,11,192,99,93
050,19,119,"Iowa","Lyon County",3,12,178,94,84
050,19,119,"Iowa","Lyon County",3,13,193,103,90
050,19,119,"Iowa","Lyon County",3,14,221,114,107
050,19,119,"Iowa","Lyon County",3,15,214,112,102
050,19,119,"Iowa","Lyon County",3,16,211,117,94
050,19,119,"Iowa","Lyon County",3,17,197,103,94
050,19,119,"Iowa","Lyon County",3,18,162,90,72
050,19,119,"Iowa","Lyon County",3,19,122,73,49
050,19,119,"Iowa","Lyon County",3,20,128,69,59
050,19,119,"Iowa","Lyon County",3,21,131,67,64
050,19,119,"Iowa","Lyon County",3,22,134,67,67
050,19,119,"Iowa","Lyon County",3,23,131,70,61
050,19,119,"Iowa","Lyon County",3,24,128,80,48
050,19,119,"Iowa","Lyon County",3,25,118,67,51
050,19,119,"Iowa","Lyon County",3,26,112,64,48
050,19,119,"Iowa","Lyon County",3,27,127,75,52
050,19,119,"Iowa","Lyon County",3,28,147,87,60
050,19,119,"Iowa","Lyon County",3,29,141,73,68
050,19,119,"Iowa","Lyon County",3,30,131,65,66
050,19,119,"Iowa","Lyon County",3,31,108,54,54
050,19,119,"Iowa","Lyon County",3,32,128,67,61
050,19,119,"Iowa","Lyon County",3,33,123,57,66
050,19,119,"Iowa","Lyon County",3,34,127,61,66
050,19,119,"Iowa","Lyon County",3,35,117,55,62
050,19,119,"Iowa","Lyon County",3,36,129,63,66
050,19,119,"Iowa","Lyon County",3,37,138,74,64
050,19,119,"Iowa","Lyon County",3,38,147,75,72
050,19,119,"Iowa","Lyon County",3,39,160,80,80
050,19,119,"Iowa","Lyon County",3,40,157,77,80
050,19,119,"Iowa","Lyon County",3,41,161,87,74
050,19,119,"Iowa","Lyon County",3,42,164,91,73
050,19,119,"Iowa","Lyon County",3,43,156,79,77
050,19,119,"Iowa","Lyon County",3,44,154,75,79
050,19,119,"Iowa","Lyon County",3,45,142,70,72
050,19,119,"Iowa","Lyon County",3,46,130,70,60
050,19,119,"Iowa","Lyon County",3,47,127,69,58
050,19,119,"Iowa","Lyon County",3,48,129,66,63
050,19,119,"Iowa","Lyon County",3,49,125,67,58
050,19,119,"Iowa","Lyon County",3,50,123,64,59
050,19,119,"Iowa","Lyon County",3,51,125,71,54
050,19,119,"Iowa","Lyon County",3,52,119,61,58
050,19,119,"Iowa","Lyon County",3,53,110,56,54
050,19,119,"Iowa","Lyon County",3,54,124,64,60
050,19,119,"Iowa","Lyon County",3,55,130,69,61
050,19,119,"Iowa","Lyon County",3,56,134,70,64
050,19,119,"Iowa","Lyon County",3,57,148,77,71
050,19,119,"Iowa","Lyon County",3,58,142,75,67
050,19,119,"Iowa","Lyon County",3,59,143,74,69
050,19,119,"Iowa","Lyon County",3,60,150,78,72
050,19,119,"Iowa","Lyon County",3,61,144,79,65
050,19,119,"Iowa","Lyon County",3,62,145,80,65
050,19,119,"Iowa","Lyon County",3,63,153,79,74
050,19,119,"Iowa","Lyon County",3,64,157,79,78
050,19,119,"Iowa","Lyon County",3,65,153,76,77
050,19,119,"Iowa","Lyon County",3,66,157,78,79
050,19,119,"Iowa","Lyon County",3,67,148,72,76
050,19,119,"Iowa","Lyon County",3,68,137,70,67
050,19,119,"Iowa","Lyon County",3,69,124,67,57
050,19,119,"Iowa","Lyon County",3,70,112,59,53
050,19,119,"Iowa","Lyon County",3,71,115,58,57
050,19,119,"Iowa","Lyon County",3,72,103,49,54
050,19,119,"Iowa","Lyon County",3,73,105,45,60
050,19,119,"Iowa","Lyon County",3,74,114,53,61
050,19,119,"Iowa","Lyon County",3,75,81,39,42
050,19,119,"Iowa","Lyon County",3,76,67,33,34
050,19,119,"Iowa","Lyon County",3,77,63,31,32
050,19,119,"Iowa","Lyon County",3,78,65,33,32
050,19,119,"Iowa","Lyon County",3,79,57,25,32
050,19,119,"Iowa","Lyon County",3,80,48,26,22
050,19,119,"Iowa","Lyon County",3,81,62,26,36
050,19,119,"Iowa","Lyon County",3,82,54,20,34
050,19,119,"Iowa","Lyon County",3,83,51,16,35
050,19,119,"Iowa","Lyon County",3,84,60,23,37
050,19,119,"Iowa","Lyon County",3,85,389,124,265
050,19,119,"Iowa","Lyon County",4,0,190,86,104
050,19,119,"Iowa","Lyon County",4,1,161,82,79
050,19,119,"Iowa","Lyon County",4,2,182,92,90
050,19,119,"Iowa","Lyon County",4,3,168,89,79
050,19,119,"Iowa","Lyon County",4,4,195,101,94
050,19,119,"Iowa","Lyon County",4,5,194,91,103
050,19,119,"Iowa","Lyon County",4,6,192,91,101
050,19,119,"Iowa","Lyon County",4,7,187,107,80
050,19,119,"Iowa","Lyon County",4,8,181,102,79
050,19,119,"Iowa","Lyon County",4,9,180,104,76
050,19,119,"Iowa","Lyon County",4,10,180,102,78
050,19,119,"Iowa","Lyon County",4,11,194,98,96
050,19,119,"Iowa","Lyon County",4,12,199,101,98
050,19,119,"Iowa","Lyon County",4,13,191,97,94
050,19,119,"Iowa","Lyon County",4,14,201,105,96
050,19,119,"Iowa","Lyon County",4,15,221,114,107
050,19,119,"Iowa","Lyon County",4,16,217,114,103
050,19,119,"Iowa","Lyon County",4,17,218,123,95
050,19,119,"Iowa","Lyon County",4,18,166,97,69
050,19,119,"Iowa","Lyon County",4,19,126,72,54
050,19,119,"Iowa","Lyon County",4,20,125,74,51
050,19,119,"Iowa","Lyon County",4,21,124,70,54
050,19,119,"Iowa","Lyon County",4,22,140,72,68
050,19,119,"Iowa","Lyon County",4,23,131,68,63
050,19,119,"Iowa","Lyon County",4,24,135,77,58
050,19,119,"Iowa","Lyon County",4,25,133,80,53
050,19,119,"Iowa","Lyon County",4,26,126,72,54
050,19,119,"Iowa","Lyon County",4,27,122,67,55
050,19,119,"Iowa","Lyon County",4,28,140,79,61
050,19,119,"Iowa","Lyon County",4,29,147,88,59
050,19,119,"Iowa","Lyon County",4,30,143,75,68
050,19,119,"Iowa","Lyon County",4,31,126,60,66
050,19,119,"Iowa","Lyon County",4,32,109,51,58
050,19,119,"Iowa","Lyon County",4,33,128,70,58
050,19,119,"Iowa","Lyon County",4,34,128,60,68
050,19,119,"Iowa","Lyon County",4,35,133,62,71
050,19,119,"Iowa","Lyon County",4,36,121,54,67
050,19,119,"Iowa","Lyon County",4,37,132,63,69
050,19,119,"Iowa","Lyon County",4,38,144,80,64
050,19,119,"Iowa","Lyon County",4,39,149,79,70
050,19,119,"Iowa","Lyon County",4,40,162,81,81
050,19,119,"Iowa","Lyon County",4,41,159,80,79
050,19,119,"Iowa","Lyon County",4,42,163,89,74
050,19,119,"Iowa","Lyon County",4,43,169,94,75
050,19,119,"Iowa","Lyon County",4,44,150,75,75
050,19,119,"Iowa","Lyon County",4,45,155,75,80
050,19,119,"Iowa","Lyon County",4,46,140,72,68
050,19,119,"Iowa","Lyon County",4,47,127,68,59
050,19,119,"Iowa","Lyon County",4,48,127,65,62
050,19,119,"Iowa","Lyon County",4,49,127,66,61
050,19,119,"Iowa","Lyon County",4,50,125,67,58
050,19,119,"Iowa","Lyon County",4,51,125,66,59
050,19,119,"Iowa","Lyon County",4,52,128,70,58
050,19,119,"Iowa","Lyon County",4,53,121,61,60
050,19,119,"Iowa","Lyon County",4,54,107,57,50
050,19,119,"Iowa","Lyon County",4,55,125,65,60
050,19,119,"Iowa","Lyon County",4,56,130,68,62
050,19,119,"Iowa","Lyon County",4,57,141,69,72
050,19,119,"Iowa","Lyon County",4,58,144,77,67
050,19,119,"Iowa","Lyon County",4,59,144,73,71
050,19,119,"Iowa","Lyon County",4,60,141,73,68
050,19,119,"Iowa","Lyon County",4,61,147,78,69
050,19,119,"Iowa","Lyon County",4,62,142,77,65
050,19,119,"Iowa","Lyon County",4,63,144,79,65
050,19,119,"Iowa","Lyon County",4,64,151,79,72
050,19,119,"Iowa","Lyon County",4,65,154,78,76
050,19,119,"Iowa","Lyon County",4,66,153,76,77
050,19,119,"Iowa","Lyon County",4,67,151,76,75
050,19,119,"Iowa","Lyon County",4,68,147,67,80
050,19,119,"Iowa","Lyon County",4,69,129,71,58
050,19,119,"Iowa","Lyon County",4,70,123,66,57
050,19,119,"Iowa","Lyon County",4,71,105,56,49
050,19,119,"Iowa","Lyon County",4,72,116,57,59
050,19,119,"Iowa","Lyon County",4,73,100,45,55
050,19,119,"Iowa","Lyon County",4,74,102,44,58
050,19,119,"Iowa","Lyon County",4,75,110,50,60
050,19,119,"Iowa","Lyon County",4,76,80,38,42
050,19,119,"Iowa","Lyon County",4,77,65,32,33
050,19,119,"Iowa","Lyon County",4,78,57,29,28
050,19,119,"Iowa","Lyon County",4,79,67,33,34
050,19,119,"Iowa","Lyon County",4,80,50,25,25
050,19,119,"Iowa","Lyon County",4,81,50,29,21
050,19,119,"Iowa","Lyon County",4,82,53,22,31
050,19,119,"Iowa","Lyon County",4,83,57,18,39
050,19,119,"Iowa","Lyon County",4,84,47,12,35
050,19,119,"Iowa","Lyon County",4,85,388,123,265
050,19,119,"Iowa","Lyon County",5,0,158,71,87
050,19,119,"Iowa","Lyon County",5,1,193,85,108
050,19,119,"Iowa","Lyon County",5,2,162,85,77
050,19,119,"Iowa","Lyon County",5,3,186,90,96
050,19,119,"Iowa","Lyon County",5,4,169,86,83
050,19,119,"Iowa","Lyon County",5,5,198,99,99
050,19,119,"Iowa","Lyon County",5,6,194,94,100
050,19,119,"Iowa","Lyon County",5,7,197,94,103
050,19,119,"Iowa","Lyon County",5,8,189,107,82
050,19,119,"Iowa","Lyon County",5,9,184,102,82
050,19,119,"Iowa","Lyon County",5,10,183,107,76
050,19,119,"Iowa","Lyon County",5,11,176,99,77
050,19,119,"Iowa","Lyon County",5,12,195,98,97
050,19,119,"Iowa","Lyon County",5,13,199,100,99
050,19,119,"Iowa","Lyon County",5,14,196,108,88
050,19,119,"Iowa","Lyon County",5,15,200,106,94
050,19,119,"Iowa","Lyon County",5,16,226,118,108
050,19,119,"Iowa","Lyon County",5,17,223,116,107
050,19,119,"Iowa","Lyon County",5,18,185,105,80
050,19,119,"Iowa","Lyon County",5,19,131,77,54
050,19,119,"Iowa","Lyon County",5,20,145,81,64
050,19,119,"Iowa","Lyon County",5,21,139,83,56
050,19,119,"Iowa","Lyon County",5,22,133,75,58
050,19,119,"Iowa","Lyon County",5,23,145,82,63
050,19,119,"Iowa","Lyon County",5,24,129,70,59
050,19,119,"Iowa","Lyon County",5,25,127,72,55
050,19,119,"Iowa","Lyon County",5,26,139,83,56
050,19,119,"Iowa","Lyon County",5,27,125,73,52
050,19,119,"Iowa","Lyon County",5,28,129,69,60
050,19,119,"Iowa","Lyon County",5,29,141,81,60
050,19,119,"Iowa","Lyon County",5,30,158,95,63
050,19,119,"Iowa","Lyon County",5,31,154,83,71
050,19,119,"Iowa","Lyon County",5,32,127,58,69
050,19,119,"Iowa","Lyon County",5,33,116,56,60
050,19,119,"Iowa","Lyon County",5,34,123,66,57
050,19,119,"Iowa","Lyon County",5,35,127,57,70
050,19,119,"Iowa","Lyon County",5,36,134,63,71
050,19,119,"Iowa","Lyon County",5,37,120,54,66
050,19,119,"Iowa","Lyon County",5,38,136,64,72
050,19,119,"Iowa","Lyon County",5,39,141,77,64
050,19,119,"Iowa","Lyon County",5,40,151,80,71
050,19,119,"Iowa","Lyon County",5,41,160,77,83
050,19,119,"Iowa","Lyon County",5,42,168,87,81
050,19,119,"Iowa","Lyon County",5,43,164,91,73
050,19,119,"Iowa","Lyon County",5,44,171,97,74
050,19,119,"Iowa","Lyon County",5,45,150,77,73
050,19,119,"Iowa","Lyon County",5,46,155,77,78
050,19,119,"Iowa","Lyon County",5,47,137,68,69
050,19,119,"Iowa","Lyon County",5,48,129,69,60
050,19,119,"Iowa","Lyon County",5,49,127,66,61
050,19,119,"Iowa","Lyon County",5,50,130,69,61
050,19,119,"Iowa","Lyon County",5,51,127,69,58
050,19,119,"Iowa","Lyon County",5,52,131,69,62
050,19,119,"Iowa","Lyon County",5,53,126,70,56
050,19,119,"Iowa","Lyon County",5,54,123,62,61
050,19,119,"Iowa","Lyon County",5,55,111,61,50
050,19,119,"Iowa","Lyon County",5,56,124,65,59
050,19,119,"Iowa","Lyon County",5,57,134,69,65
050,19,119,"Iowa","Lyon County",5,58,136,68,68
050,19,119,"Iowa","Lyon County",5,59,142,76,66
050,19,119,"Iowa","Lyon County",5,60,145,73,72
050,19,119,"Iowa","Lyon County",5,61,145,73,72
050,19,119,"Iowa","Lyon County",5,62,151,80,71
050,19,119,"Iowa","Lyon County",5,63,142,76,66
050,19,119,"Iowa","Lyon County",5,64,145,79,66
050,19,119,"Iowa","Lyon County",5,65,151,82,69
050,19,119,"Iowa","Lyon County",5,66,157,81,76
050,19,119,"Iowa","Lyon County",5,67,153,73,80
050,19,119,"Iowa","Lyon County",5,68,147,72,75
050,19,119,"Iowa","Lyon County",5,69,147,71,76
050,19,119,"Iowa","Lyon County",5,70,126,69,57
050,19,119,"Iowa","Lyon County",5,71,122,65,57
050,19,119,"Iowa","Lyon County",5,72,104,52,52
050,19,119,"Iowa","Lyon County",5,73,111,53,58
050,19,119,"Iowa","Lyon County",5,74,95,45,50
050,19,119,"Iowa","Lyon County",5,75,101,41,60
050,19,119,"Iowa","Lyon County",5,76,106,48,58
050,19,119,"Iowa","Lyon County",5,77,78,38,40
050,19,119,"Iowa","Lyon County",5,78,60,30,30
050,19,119,"Iowa","Lyon County",5,79,61,31,30
050,19,119,"Iowa","Lyon County",5,80,59,31,28
050,19,119,"Iowa","Lyon County",5,81,52,27,25
050,19,119,"Iowa","Lyon County",5,82,46,26,20
050,19,119,"Iowa","Lyon County",5,83,57,20,37
050,19,119,"Iowa","Lyon County",5,84,57,17,40
050,19,119,"Iowa","Lyon County",5,85,378,115,263
050,19,121,"Iowa","Madison County",1,0,172,88,84
050,19,121,"Iowa","Madison County",1,1,172,94,78
050,19,121,"Iowa","Madison County",1,2,165,88,77
050,19,121,"Iowa","Madison County",1,3,195,95,100
050,19,121,"Iowa","Madison County",1,4,199,101,98
050,19,121,"Iowa","Madison County",1,5,224,121,103
050,19,121,"Iowa","Madison County",1,6,217,111,106
050,19,121,"Iowa","Madison County",1,7,221,123,98
050,19,121,"Iowa","Madison County",1,8,222,114,108
050,19,121,"Iowa","Madison County",1,9,234,120,114
050,19,121,"Iowa","Madison County",1,10,266,133,133
050,19,121,"Iowa","Madison County",1,11,263,129,134
050,19,121,"Iowa","Madison County",1,12,281,146,135
050,19,121,"Iowa","Madison County",1,13,257,139,118
050,19,121,"Iowa","Madison County",1,14,265,140,125
050,19,121,"Iowa","Madison County",1,15,275,155,120
050,19,121,"Iowa","Madison County",1,16,270,146,124
050,19,121,"Iowa","Madison County",1,17,244,138,106
050,19,121,"Iowa","Madison County",1,18,217,115,102
050,19,121,"Iowa","Madison County",1,19,168,89,79
050,19,121,"Iowa","Madison County",1,20,168,87,81
050,19,121,"Iowa","Madison County",1,21,175,93,82
050,19,121,"Iowa","Madison County",1,22,169,87,82
050,19,121,"Iowa","Madison County",1,23,177,88,89
050,19,121,"Iowa","Madison County",1,24,144,68,76
050,19,121,"Iowa","Madison County",1,25,136,63,73
050,19,121,"Iowa","Madison County",1,26,157,84,73
050,19,121,"Iowa","Madison County",1,27,178,87,91
050,19,121,"Iowa","Madison County",1,28,156,71,85
050,19,121,"Iowa","Madison County",1,29,159,71,88
050,19,121,"Iowa","Madison County",1,30,169,80,89
050,19,121,"Iowa","Madison County",1,31,170,81,89
050,19,121,"Iowa","Madison County",1,32,161,74,87
050,19,121,"Iowa","Madison County",1,33,177,88,89
050,19,121,"Iowa","Madison County",1,34,185,86,99
050,19,121,"Iowa","Madison County",1,35,200,90,110
050,19,121,"Iowa","Madison County",1,36,195,95,100
050,19,121,"Iowa","Madison County",1,37,207,106,101
050,19,121,"Iowa","Madison County",1,38,233,126,107
050,19,121,"Iowa","Madison County",1,39,228,119,109
050,19,121,"Iowa","Madison County",1,40,249,129,120
050,19,121,"Iowa","Madison County",1,41,237,126,111
050,19,121,"Iowa","Madison County",1,42,227,116,111
050,19,121,"Iowa","Madison County",1,43,217,114,103
050,19,121,"Iowa","Madison County",1,44,204,104,100
050,19,121,"Iowa","Madison County",1,45,215,113,102
050,19,121,"Iowa","Madison County",1,46,201,112,89
050,19,121,"Iowa","Madison County",1,47,217,107,110
050,19,121,"Iowa","Madison County",1,48,232,118,114
050,19,121,"Iowa","Madison County",1,49,265,128,137
050,19,121,"Iowa","Madison County",1,50,263,123,140
050,19,121,"Iowa","Madison County",1,51,228,125,103
050,19,121,"Iowa","Madison County",1,52,214,111,103
050,19,121,"Iowa","Madison County",1,53,206,98,108
050,19,121,"Iowa","Madison County",1,54,234,120,114
050,19,121,"Iowa","Madison County",1,55,243,117,126
050,19,121,"Iowa","Madison County",1,56,249,119,130
050,19,121,"Iowa","Madison County",1,57,235,119,116
050,19,121,"Iowa","Madison County",1,58,229,104,125
050,19,121,"Iowa","Madison County",1,59,250,129,121
050,19,121,"Iowa","Madison County",1,60,243,125,118
050,19,121,"Iowa","Madison County",1,61,211,115,96
050,19,121,"Iowa","Madison County",1,62,212,109,103
050,19,121,"Iowa","Madison County",1,63,223,111,112
050,19,121,"Iowa","Madison County",1,64,206,104,102
050,19,121,"Iowa","Madison County",1,65,209,102,107
050,19,121,"Iowa","Madison County",1,66,202,109,93
050,19,121,"Iowa","Madison County",1,67,178,87,91
050,19,121,"Iowa","Madison County",1,68,191,88,103
050,19,121,"Iowa","Madison County",1,69,172,89,83
050,19,121,"Iowa","Madison County",1,70,154,86,68
050,19,121,"Iowa","Madison County",1,71,168,88,80
050,19,121,"Iowa","Madison County",1,72,157,80,77
050,19,121,"Iowa","Madison County",1,73,148,65,83
050,19,121,"Iowa","Madison County",1,74,93,46,47
050,19,121,"Iowa","Madison County",1,75,106,50,56
050,19,121,"Iowa","Madison County",1,76,99,42,57
050,19,121,"Iowa","Madison County",1,77,94,44,50
050,19,121,"Iowa","Madison County",1,78,86,41,45
050,19,121,"Iowa","Madison County",1,79,82,41,41
050,19,121,"Iowa","Madison County",1,80,86,39,47
050,19,121,"Iowa","Madison County",1,81,79,32,47
050,19,121,"Iowa","Madison County",1,82,66,34,32
050,19,121,"Iowa","Madison County",1,83,51,27,24
050,19,121,"Iowa","Madison County",1,84,53,21,32
050,19,121,"Iowa","Madison County",1,85,291,90,201
050,19,121,"Iowa","Madison County",2,0,176,88,88
050,19,121,"Iowa","Madison County",2,1,172,92,80
050,19,121,"Iowa","Madison County",2,2,168,89,79
050,19,121,"Iowa","Madison County",2,3,188,93,95
050,19,121,"Iowa","Madison County",2,4,202,101,101
050,19,121,"Iowa","Madison County",2,5,218,116,102
050,19,121,"Iowa","Madison County",2,6,223,116,107
050,19,121,"Iowa","Madison County",2,7,222,121,101
050,19,121,"Iowa","Madison County",2,8,224,116,108
050,19,121,"Iowa","Madison County",2,9,234,119,115
050,19,121,"Iowa","Madison County",2,10,261,132,129
050,19,121,"Iowa","Madison County",2,11,265,131,134
050,19,121,"Iowa","Madison County",2,12,282,144,138
050,19,121,"Iowa","Madison County",2,13,265,142,123
050,19,121,"Iowa","Madison County",2,14,267,142,125
050,19,121,"Iowa","Madison County",2,15,276,152,124
050,19,121,"Iowa","Madison County",2,16,274,151,123
050,19,121,"Iowa","Madison County",2,17,252,141,111
050,19,121,"Iowa","Madison County",2,18,212,114,98
050,19,121,"Iowa","Madison County",2,19,169,90,79
050,19,121,"Iowa","Madison County",2,20,174,89,85
050,19,121,"Iowa","Madison County",2,21,175,92,83
050,19,121,"Iowa","Madison County",2,22,172,89,83
050,19,121,"Iowa","Madison County",2,23,174,86,88
050,19,121,"Iowa","Madison County",2,24,151,72,79
050,19,121,"Iowa","Madison County",2,25,138,65,73
050,19,121,"Iowa","Madison County",2,26,154,80,74
050,19,121,"Iowa","Madison County",2,27,176,87,89
050,19,121,"Iowa","Madison County",2,28,163,75,88
050,19,121,"Iowa","Madison County",2,29,160,72,88
050,19,121,"Iowa","Madison County",2,30,171,80,91
050,19,121,"Iowa","Madison County",2,31,172,81,91
050,19,121,"Iowa","Madison County",2,32,165,77,88
050,19,121,"Iowa","Madison County",2,33,175,86,89
050,19,121,"Iowa","Madison County",2,34,182,86,96
050,19,121,"Iowa","Madison County",2,35,198,90,108
050,19,121,"Iowa","Madison County",2,36,196,95,101
050,19,121,"Iowa","Madison County",2,37,208,105,103
050,19,121,"Iowa","Madison County",2,38,228,122,106
050,19,121,"Iowa","Madison County",2,39,231,121,110
050,19,121,"Iowa","Madison County",2,40,251,131,120
050,19,121,"Iowa","Madison County",2,41,245,129,116
050,19,121,"Iowa","Madison County",2,42,232,120,112
050,19,121,"Iowa","Madison County",2,43,222,118,104
050,19,121,"Iowa","Madison County",2,44,207,106,101
050,19,121,"Iowa","Madison County",2,45,213,112,101
050,19,121,"Iowa","Madison County",2,46,206,113,93
050,19,121,"Iowa","Madison County",2,47,212,107,105
050,19,121,"Iowa","Madison County",2,48,228,115,113
050,19,121,"Iowa","Madison County",2,49,259,128,131
050,19,121,"Iowa","Madison County",2,50,264,124,140
050,19,121,"Iowa","Madison County",2,51,234,123,111
050,19,121,"Iowa","Madison County",2,52,216,113,103
050,19,121,"Iowa","Madison County",2,53,208,101,107
050,19,121,"Iowa","Madison County",2,54,226,115,111
050,19,121,"Iowa","Madison County",2,55,242,118,124
050,19,121,"Iowa","Madison County",2,56,249,120,129
050,19,121,"Iowa","Madison County",2,57,237,118,119
050,19,121,"Iowa","Madison County",2,58,230,108,122
050,19,121,"Iowa","Madison County",2,59,247,124,123
050,19,121,"Iowa","Madison County",2,60,243,125,118
050,19,121,"Iowa","Madison County",2,61,216,116,100
050,19,121,"Iowa","Madison County",2,62,213,111,102
050,19,121,"Iowa","Madison County",2,63,221,110,111
050,19,121,"Iowa","Madison County",2,64,205,103,102
050,19,121,"Iowa","Madison County",2,65,206,101,105
050,19,121,"Iowa","Madison County",2,66,205,108,97
050,19,121,"Iowa","Madison County",2,67,183,92,91
050,19,121,"Iowa","Madison County",2,68,185,86,99
050,19,121,"Iowa","Madison County",2,69,177,89,88
050,19,121,"Iowa","Madison County",2,70,154,82,72
050,19,121,"Iowa","Madison County",2,71,165,87,78
050,19,121,"Iowa","Madison County",2,72,158,81,77
050,19,121,"Iowa","Madison County",2,73,157,71,86
050,19,121,"Iowa","Madison County",2,74,99,47,52
050,19,121,"Iowa","Madison County",2,75,103,48,55
050,19,121,"Iowa","Madison County",2,76,100,44,56
050,19,121,"Iowa","Madison County",2,77,96,43,53
050,19,121,"Iowa","Madison County",2,78,85,40,45
050,19,121,"Iowa","Madison County",2,79,82,40,42
050,19,121,"Iowa","Madison County",2,80,86,39,47
050,19,121,"Iowa","Madison County",2,81,80,34,46
050,19,121,"Iowa","Madison County",2,82,70,34,36
050,19,121,"Iowa","Madison County",2,83,52,28,24
050,19,121,"Iowa","Madison County",2,84,51,22,29
050,19,121,"Iowa","Madison County",2,85,296,92,204
050,19,121,"Iowa","Madison County",3,0,175,76,99
050,19,121,"Iowa","Madison County",3,1,192,104,88
050,19,121,"Iowa","Madison County",3,2,190,99,91
050,19,121,"Iowa","Madison County",3,3,179,95,84
050,19,121,"Iowa","Madison County",3,4,187,91,96
050,19,121,"Iowa","Madison County",3,5,211,103,108
050,19,121,"Iowa","Madison County",3,6,236,120,116
050,19,121,"Iowa","Madison County",3,7,224,117,107
050,19,121,"Iowa","Madison County",3,8,221,118,103
050,19,121,"Iowa","Madison County",3,9,242,127,115
050,19,121,"Iowa","Madison County",3,10,219,116,103
050,19,121,"Iowa","Madison County",3,11,273,142,131
050,19,121,"Iowa","Madison County",3,12,258,126,132
050,19,121,"Iowa","Madison County",3,13,289,142,147
050,19,121,"Iowa","Madison County",3,14,281,146,135
050,19,121,"Iowa","Madison County",3,15,267,141,126
050,19,121,"Iowa","Madison County",3,16,276,150,126
050,19,121,"Iowa","Madison County",3,17,282,156,126
050,19,121,"Iowa","Madison County",3,18,216,126,90
050,19,121,"Iowa","Madison County",3,19,162,86,76
050,19,121,"Iowa","Madison County",3,20,173,94,79
050,19,121,"Iowa","Madison County",3,21,178,95,83
050,19,121,"Iowa","Madison County",3,22,175,92,83
050,19,121,"Iowa","Madison County",3,23,156,78,78
050,19,121,"Iowa","Madison County",3,24,158,78,80
050,19,121,"Iowa","Madison County",3,25,143,73,70
050,19,121,"Iowa","Madison County",3,26,145,68,77
050,19,121,"Iowa","Madison County",3,27,155,80,75
050,19,121,"Iowa","Madison County",3,28,175,82,93
050,19,121,"Iowa","Madison County",3,29,169,74,95
050,19,121,"Iowa","Madison County",3,30,160,75,85
050,19,121,"Iowa","Madison County",3,31,183,95,88
050,19,121,"Iowa","Madison County",3,32,182,78,104
050,19,121,"Iowa","Madison County",3,33,169,77,92
050,19,121,"Iowa","Madison County",3,34,180,94,86
050,19,121,"Iowa","Madison County",3,35,195,91,104
050,19,121,"Iowa","Madison County",3,36,206,96,110
050,19,121,"Iowa","Madison County",3,37,207,102,105
050,19,121,"Iowa","Madison County",3,38,203,103,100
050,19,121,"Iowa","Madison County",3,39,236,124,112
050,19,121,"Iowa","Madison County",3,40,230,124,106
050,19,121,"Iowa","Madison County",3,41,268,138,130
050,19,121,"Iowa","Madison County",3,42,248,128,120
050,19,121,"Iowa","Madison County",3,43,232,122,110
050,19,121,"Iowa","Madison County",3,44,223,116,107
050,19,121,"Iowa","Madison County",3,45,214,107,107
050,19,121,"Iowa","Madison County",3,46,211,113,98
050,19,121,"Iowa","Madison County",3,47,216,117,99
050,19,121,"Iowa","Madison County",3,48,212,107,105
050,19,121,"Iowa","Madison County",3,49,226,115,111
050,19,121,"Iowa","Madison County",3,50,266,136,130
050,19,121,"Iowa","Madison County",3,51,258,127,131
050,19,121,"Iowa","Madison County",3,52,230,120,110
050,19,121,"Iowa","Madison County",3,53,222,112,110
050,19,121,"Iowa","Madison County",3,54,209,102,107
050,19,121,"Iowa","Madison County",3,55,213,107,106
050,19,121,"Iowa","Madison County",3,56,235,113,122
050,19,121,"Iowa","Madison County",3,57,253,122,131
050,19,121,"Iowa","Madison County",3,58,237,111,126
050,19,121,"Iowa","Madison County",3,59,227,109,118
050,19,121,"Iowa","Madison County",3,60,251,128,123
050,19,121,"Iowa","Madison County",3,61,243,127,116
050,19,121,"Iowa","Madison County",3,62,219,116,103
050,19,121,"Iowa","Madison County",3,63,210,104,106
050,19,121,"Iowa","Madison County",3,64,223,111,112
050,19,121,"Iowa","Madison County",3,65,202,98,104
050,19,121,"Iowa","Madison County",3,66,198,96,102
050,19,121,"Iowa","Madison County",3,67,201,106,95
050,19,121,"Iowa","Madison County",3,68,186,94,92
050,19,121,"Iowa","Madison County",3,69,183,86,97
050,19,121,"Iowa","Madison County",3,70,174,86,88
050,19,121,"Iowa","Madison County",3,71,154,79,75
050,19,121,"Iowa","Madison County",3,72,167,89,78
050,19,121,"Iowa","Madison County",3,73,156,78,78
050,19,121,"Iowa","Madison County",3,74,153,69,84
050,19,121,"Iowa","Madison County",3,75,103,50,53
050,19,121,"Iowa","Madison County",3,76,103,47,56
050,19,121,"Iowa","Madison County",3,77,93,41,52
050,19,121,"Iowa","Madison County",3,78,89,40,49
050,19,121,"Iowa","Madison County",3,79,84,39,45
050,19,121,"Iowa","Madison County",3,80,78,36,42
050,19,121,"Iowa","Madison County",3,81,87,43,44
050,19,121,"Iowa","Madison County",3,82,74,29,45
050,19,121,"Iowa","Madison County",3,83,66,35,31
050,19,121,"Iowa","Madison County",3,84,54,27,27
050,19,121,"Iowa","Madison County",3,85,284,94,190
050,19,121,"Iowa","Madison County",4,0,188,86,102
050,19,121,"Iowa","Madison County",4,1,178,69,109
050,19,121,"Iowa","Madison County",4,2,209,108,101
050,19,121,"Iowa","Madison County",4,3,200,107,93
050,19,121,"Iowa","Madison County",4,4,198,103,95
050,19,121,"Iowa","Madison County",4,5,194,87,107
050,19,121,"Iowa","Madison County",4,6,233,111,122
050,19,121,"Iowa","Madison County",4,7,242,122,120
050,19,121,"Iowa","Madison County",4,8,225,118,107
050,19,121,"Iowa","Madison County",4,9,232,125,107
050,19,121,"Iowa","Madison County",4,10,243,130,113
050,19,121,"Iowa","Madison County",4,11,226,115,111
050,19,121,"Iowa","Madison County",4,12,287,153,134
050,19,121,"Iowa","Madison County",4,13,268,130,138
050,19,121,"Iowa","Madison County",4,14,297,144,153
050,19,121,"Iowa","Madison County",4,15,279,151,128
050,19,121,"Iowa","Madison County",4,16,264,146,118
050,19,121,"Iowa","Madison County",4,17,281,155,126
050,19,121,"Iowa","Madison County",4,18,238,137,101
050,19,121,"Iowa","Madison County",4,19,155,94,61
050,19,121,"Iowa","Madison County",4,20,164,89,75
050,19,121,"Iowa","Madison County",4,21,179,100,79
050,19,121,"Iowa","Madison County",4,22,188,96,92
050,19,121,"Iowa","Madison County",4,23,171,93,78
050,19,121,"Iowa","Madison County",4,24,136,65,71
050,19,121,"Iowa","Madison County",4,25,159,76,83
050,19,121,"Iowa","Madison County",4,26,143,76,67
050,19,121,"Iowa","Madison County",4,27,153,69,84
050,19,121,"Iowa","Madison County",4,28,172,87,85
050,19,121,"Iowa","Madison County",4,29,180,85,95
050,19,121,"Iowa","Madison County",4,30,185,76,109
050,19,121,"Iowa","Madison County",4,31,160,72,88
050,19,121,"Iowa","Madison County",4,32,191,99,92
050,19,121,"Iowa","Madison County",4,33,188,78,110
050,19,121,"Iowa","Madison County",4,34,177,85,92
050,19,121,"Iowa","Madison County",4,35,192,101,91
050,19,121,"Iowa","Madison County",4,36,209,100,109
050,19,121,"Iowa","Madison County",4,37,230,105,125
050,19,121,"Iowa","Madison County",4,38,211,105,106
050,19,121,"Iowa","Madison County",4,39,201,101,100
050,19,121,"Iowa","Madison County",4,40,236,122,114
050,19,121,"Iowa","Madison County",4,41,227,122,105
050,19,121,"Iowa","Madison County",4,42,264,136,128
050,19,121,"Iowa","Madison County",4,43,244,127,117
050,19,121,"Iowa","Madison County",4,44,241,131,110
050,19,121,"Iowa","Madison County",4,45,234,120,114
050,19,121,"Iowa","Madison County",4,46,222,111,111
050,19,121,"Iowa","Madison County",4,47,218,114,104
050,19,121,"Iowa","Madison County",4,48,219,114,105
050,19,121,"Iowa","Madison County",4,49,217,108,109
050,19,121,"Iowa","Madison County",4,50,228,118,110
050,19,121,"Iowa","Madison County",4,51,269,137,132
050,19,121,"Iowa","Madison County",4,52,260,129,131
050,19,121,"Iowa","Madison County",4,53,234,125,109
050,19,121,"Iowa","Madison County",4,54,218,116,102
050,19,121,"Iowa","Madison County",4,55,206,103,103
050,19,121,"Iowa","Madison County",4,56,221,109,112
050,19,121,"Iowa","Madison County",4,57,234,113,121
050,19,121,"Iowa","Madison County",4,58,253,121,132
050,19,121,"Iowa","Madison County",4,59,241,120,121
050,19,121,"Iowa","Madison County",4,60,228,105,123
050,19,121,"Iowa","Madison County",4,61,244,122,122
050,19,121,"Iowa","Madison County",4,62,242,126,116
050,19,121,"Iowa","Madison County",4,63,221,116,105
050,19,121,"Iowa","Madison County",4,64,216,109,107
050,19,121,"Iowa","Madison County",4,65,220,106,114
050,19,121,"Iowa","Madison County",4,66,199,95,104
050,19,121,"Iowa","Madison County",4,67,200,95,105
050,19,121,"Iowa","Madison County",4,68,203,105,98
050,19,121,"Iowa","Madison County",4,69,182,90,92
050,19,121,"Iowa","Madison County",4,70,180,87,93
050,19,121,"Iowa","Madison County",4,71,178,87,91
050,19,121,"Iowa","Madison County",4,72,153,81,72
050,19,121,"Iowa","Madison County",4,73,155,84,71
050,19,121,"Iowa","Madison County",4,74,149,75,74
050,19,121,"Iowa","Madison County",4,75,150,71,79
050,19,121,"Iowa","Madison County",4,76,101,47,54
050,19,121,"Iowa","Madison County",4,77,100,45,55
050,19,121,"Iowa","Madison County",4,78,88,37,51
050,19,121,"Iowa","Madison County",4,79,84,39,45
050,19,121,"Iowa","Madison County",4,80,76,30,46
050,19,121,"Iowa","Madison County",4,81,75,35,40
050,19,121,"Iowa","Madison County",4,82,77,34,43
050,19,121,"Iowa","Madison County",4,83,69,28,41
050,19,121,"Iowa","Madison County",4,84,64,32,32
050,19,121,"Iowa","Madison County",4,85,274,92,182
050,19,121,"Iowa","Madison County",5,0,192,87,105
050,19,121,"Iowa","Madison County",5,1,186,80,106
050,19,121,"Iowa","Madison County",5,2,182,72,110
050,19,121,"Iowa","Madison County",5,3,215,113,102
050,19,121,"Iowa","Madison County",5,4,190,100,90
050,19,121,"Iowa","Madison County",5,5,209,108,101
050,19,121,"Iowa","Madison County",5,6,193,91,102
050,19,121,"Iowa","Madison County",5,7,237,117,120
050,19,121,"Iowa","Madison County",5,8,259,134,125
050,19,121,"Iowa","Madison County",5,9,228,113,115
050,19,121,"Iowa","Madison County",5,10,234,121,113
050,19,121,"Iowa","Madison County",5,11,239,126,113
050,19,121,"Iowa","Madison County",5,12,230,122,108
050,19,121,"Iowa","Madison County",5,13,269,146,123
050,19,121,"Iowa","Madison County",5,14,272,125,147
050,19,121,"Iowa","Madison County",5,15,292,144,148
050,19,121,"Iowa","Madison County",5,16,286,146,140
050,19,121,"Iowa","Madison County",5,17,267,145,122
050,19,121,"Iowa","Madison County",5,18,229,130,99
050,19,121,"Iowa","Madison County",5,19,179,105,74
050,19,121,"Iowa","Madison County",5,20,164,98,66
050,19,121,"Iowa","Madison County",5,21,168,96,72
050,19,121,"Iowa","Madison County",5,22,179,89,90
050,19,121,"Iowa","Madison County",5,23,178,93,85
050,19,121,"Iowa","Madison County",5,24,161,89,72
050,19,121,"Iowa","Madison County",5,25,146,75,71
050,19,121,"Iowa","Madison County",5,26,153,71,82
050,19,121,"Iowa","Madison County",5,27,137,75,62
050,19,121,"Iowa","Madison County",5,28,163,71,92
050,19,121,"Iowa","Madison County",5,29,182,89,93
050,19,121,"Iowa","Madison County",5,30,203,95,108
050,19,121,"Iowa","Madison County",5,31,173,72,101
050,19,121,"Iowa","Madison County",5,32,156,72,84
050,19,121,"Iowa","Madison County",5,33,197,109,88
050,19,121,"Iowa","Madison County",5,34,195,80,115
050,19,121,"Iowa","Madison County",5,35,179,85,94
050,19,121,"Iowa","Madison County",5,36,196,102,94
050,19,121,"Iowa","Madison County",5,37,209,97,112
050,19,121,"Iowa","Madison County",5,38,238,115,123
050,19,121,"Iowa","Madison County",5,39,218,113,105
050,19,121,"Iowa","Madison County",5,40,201,93,108
050,19,121,"Iowa","Madison County",5,41,241,126,115
050,19,121,"Iowa","Madison County",5,42,221,119,102
050,19,121,"Iowa","Madison County",5,43,265,138,127
050,19,121,"Iowa","Madison County",5,44,243,128,115
050,19,121,"Iowa","Madison County",5,45,242,129,113
050,19,121,"Iowa","Madison County",5,46,235,123,112
050,19,121,"Iowa","Madison County",5,47,218,112,106
050,19,121,"Iowa","Madison County",5,48,219,114,105
050,19,121,"Iowa","Madison County",5,49,213,114,99
050,19,121,"Iowa","Madison County",5,50,210,105,105
050,19,121,"Iowa","Madison County",5,51,222,114,108
050,19,121,"Iowa","Madison County",5,52,273,136,137
050,19,121,"Iowa","Madison County",5,53,257,131,126
050,19,121,"Iowa","Madison County",5,54,229,127,102
050,19,121,"Iowa","Madison County",5,55,211,112,99
050,19,121,"Iowa","Madison County",5,56,203,100,103
050,19,121,"Iowa","Madison County",5,57,226,109,117
050,19,121,"Iowa","Madison County",5,58,230,109,121
050,19,121,"Iowa","Madison County",5,59,248,119,129
050,19,121,"Iowa","Madison County",5,60,247,125,122
050,19,121,"Iowa","Madison County",5,61,224,100,124
050,19,121,"Iowa","Madison County",5,62,239,117,122
050,19,121,"Iowa","Madison County",5,63,241,124,117
050,19,121,"Iowa","Madison County",5,64,222,119,103
050,19,121,"Iowa","Madison County",5,65,215,107,108
050,19,121,"Iowa","Madison County",5,66,213,102,111
050,19,121,"Iowa","Madison County",5,67,193,92,101
050,19,121,"Iowa","Madison County",5,68,198,93,105
050,19,121,"Iowa","Madison County",5,69,202,105,97
050,19,121,"Iowa","Madison County",5,70,172,84,88
050,19,121,"Iowa","Madison County",5,71,174,84,90
050,19,121,"Iowa","Madison County",5,72,171,86,85
050,19,121,"Iowa","Madison County",5,73,145,78,67
050,19,121,"Iowa","Madison County",5,74,150,83,67
050,19,121,"Iowa","Madison County",5,75,146,74,72
050,19,121,"Iowa","Madison County",5,76,143,66,77
050,19,121,"Iowa","Madison County",5,77,94,43,51
050,19,121,"Iowa","Madison County",5,78,98,43,55
050,19,121,"Iowa","Madison County",5,79,87,37,50
050,19,121,"Iowa","Madison County",5,80,81,35,46
050,19,121,"Iowa","Madison County",5,81,71,27,44
050,19,121,"Iowa","Madison County",5,82,68,29,39
050,19,121,"Iowa","Madison County",5,83,67,30,37
050,19,121,"Iowa","Madison County",5,84,64,26,38
050,19,121,"Iowa","Madison County",5,85,256,94,162
050,19,123,"Iowa","Mahaska County",1,0,272,139,133
050,19,123,"Iowa","Mahaska County",1,1,293,145,148
050,19,123,"Iowa","Mahaska County",1,2,279,131,148
050,19,123,"Iowa","Mahaska County",1,3,283,136,147
050,19,123,"Iowa","Mahaska County",1,4,341,182,159
050,19,123,"Iowa","Mahaska County",1,5,306,160,146
050,19,123,"Iowa","Mahaska County",1,6,295,147,148
050,19,123,"Iowa","Mahaska County",1,7,291,143,148
050,19,123,"Iowa","Mahaska County",1,8,295,153,142
050,19,123,"Iowa","Mahaska County",1,9,291,145,146
050,19,123,"Iowa","Mahaska County",1,10,277,148,129
050,19,123,"Iowa","Mahaska County",1,11,301,153,148
050,19,123,"Iowa","Mahaska County",1,12,291,155,136
050,19,123,"Iowa","Mahaska County",1,13,301,166,135
050,19,123,"Iowa","Mahaska County",1,14,300,162,138
050,19,123,"Iowa","Mahaska County",1,15,303,170,133
050,19,123,"Iowa","Mahaska County",1,16,325,173,152
050,19,123,"Iowa","Mahaska County",1,17,299,172,127
050,19,123,"Iowa","Mahaska County",1,18,314,179,135
050,19,123,"Iowa","Mahaska County",1,19,328,204,124
050,19,123,"Iowa","Mahaska County",1,20,331,188,143
050,19,123,"Iowa","Mahaska County",1,21,304,167,137
050,19,123,"Iowa","Mahaska County",1,22,264,151,113
050,19,123,"Iowa","Mahaska County",1,23,256,147,109
050,19,123,"Iowa","Mahaska County",1,24,267,148,119
050,19,123,"Iowa","Mahaska County",1,25,258,130,128
050,19,123,"Iowa","Mahaska County",1,26,240,128,112
050,19,123,"Iowa","Mahaska County",1,27,251,121,130
050,19,123,"Iowa","Mahaska County",1,28,256,133,123
050,19,123,"Iowa","Mahaska County",1,29,265,140,125
050,19,123,"Iowa","Mahaska County",1,30,234,112,122
050,19,123,"Iowa","Mahaska County",1,31,254,128,126
050,19,123,"Iowa","Mahaska County",1,32,234,117,117
050,19,123,"Iowa","Mahaska County",1,33,258,131,127
050,19,123,"Iowa","Mahaska County",1,34,270,123,147
050,19,123,"Iowa","Mahaska County",1,35,273,136,137
050,19,123,"Iowa","Mahaska County",1,36,243,124,119
050,19,123,"Iowa","Mahaska County",1,37,277,139,138
050,19,123,"Iowa","Mahaska County",1,38,266,132,134
050,19,123,"Iowa","Mahaska County",1,39,282,137,145
050,19,123,"Iowa","Mahaska County",1,40,284,155,129
050,19,123,"Iowa","Mahaska County",1,41,263,143,120
050,19,123,"Iowa","Mahaska County",1,42,264,135,129
050,19,123,"Iowa","Mahaska County",1,43,259,129,130
050,19,123,"Iowa","Mahaska County",1,44,258,127,131
050,19,123,"Iowa","Mahaska County",1,45,256,131,125
050,19,123,"Iowa","Mahaska County",1,46,241,126,115
050,19,123,"Iowa","Mahaska County",1,47,233,120,113
050,19,123,"Iowa","Mahaska County",1,48,237,129,108
050,19,123,"Iowa","Mahaska County",1,49,272,137,135
050,19,123,"Iowa","Mahaska County",1,50,255,124,131
050,19,123,"Iowa","Mahaska County",1,51,262,138,124
050,19,123,"Iowa","Mahaska County",1,52,250,125,125
050,19,123,"Iowa","Mahaska County",1,53,238,118,120
050,19,123,"Iowa","Mahaska County",1,54,243,139,104
050,19,123,"Iowa","Mahaska County",1,55,274,151,123
050,19,123,"Iowa","Mahaska County",1,56,269,147,122
050,19,123,"Iowa","Mahaska County",1,57,285,146,139
050,19,123,"Iowa","Mahaska County",1,58,305,152,153
050,19,123,"Iowa","Mahaska County",1,59,321,156,165
050,19,123,"Iowa","Mahaska County",1,60,319,159,160
050,19,123,"Iowa","Mahaska County",1,61,327,174,153
050,19,123,"Iowa","Mahaska County",1,62,327,169,158
050,19,123,"Iowa","Mahaska County",1,63,304,160,144
050,19,123,"Iowa","Mahaska County",1,64,278,149,129
050,19,123,"Iowa","Mahaska County",1,65,269,132,137
050,19,123,"Iowa","Mahaska County",1,66,269,139,130
050,19,123,"Iowa","Mahaska County",1,67,287,142,145
050,19,123,"Iowa","Mahaska County",1,68,255,130,125
050,19,123,"Iowa","Mahaska County",1,69,252,133,119
050,19,123,"Iowa","Mahaska County",1,70,210,107,103
050,19,123,"Iowa","Mahaska County",1,71,203,91,112
050,19,123,"Iowa","Mahaska County",1,72,204,88,116
050,19,123,"Iowa","Mahaska County",1,73,200,90,110
050,19,123,"Iowa","Mahaska County",1,74,148,79,69
050,19,123,"Iowa","Mahaska County",1,75,153,81,72
050,19,123,"Iowa","Mahaska County",1,76,166,80,86
050,19,123,"Iowa","Mahaska County",1,77,149,68,81
050,19,123,"Iowa","Mahaska County",1,78,117,57,60
050,19,123,"Iowa","Mahaska County",1,79,129,58,71
050,19,123,"Iowa","Mahaska County",1,80,133,52,81
050,19,123,"Iowa","Mahaska County",1,81,102,46,56
050,19,123,"Iowa","Mahaska County",1,82,92,42,50
050,19,123,"Iowa","Mahaska County",1,83,94,43,51
050,19,123,"Iowa","Mahaska County",1,84,91,43,48
050,19,123,"Iowa","Mahaska County",1,85,575,178,397
050,19,123,"Iowa","Mahaska County",2,0,267,136,131
050,19,123,"Iowa","Mahaska County",2,1,287,142,145
050,19,123,"Iowa","Mahaska County",2,2,283,134,149
050,19,123,"Iowa","Mahaska County",2,3,281,135,146
050,19,123,"Iowa","Mahaska County",2,4,326,168,158
050,19,123,"Iowa","Mahaska County",2,5,316,165,151
050,19,123,"Iowa","Mahaska County",2,6,300,150,150
050,19,123,"Iowa","Mahaska County",2,7,293,145,148
050,19,123,"Iowa","Mahaska County",2,8,290,148,142
050,19,123,"Iowa","Mahaska County",2,9,291,146,145
050,19,123,"Iowa","Mahaska County",2,10,280,147,133
050,19,123,"Iowa","Mahaska County",2,11,292,150,142
050,19,123,"Iowa","Mahaska County",2,12,294,155,139
050,19,123,"Iowa","Mahaska County",2,13,297,162,135
050,19,123,"Iowa","Mahaska County",2,14,298,161,137
050,19,123,"Iowa","Mahaska County",2,15,302,168,134
050,19,123,"Iowa","Mahaska County",2,16,321,174,147
050,19,123,"Iowa","Mahaska County",2,17,303,172,131
050,19,123,"Iowa","Mahaska County",2,18,311,179,132
050,19,123,"Iowa","Mahaska County",2,19,331,205,126
050,19,123,"Iowa","Mahaska County",2,20,326,185,141
050,19,123,"Iowa","Mahaska County",2,21,306,169,137
050,19,123,"Iowa","Mahaska County",2,22,269,155,114
050,19,123,"Iowa","Mahaska County",2,23,252,143,109
050,19,123,"Iowa","Mahaska County",2,24,265,147,118
050,19,123,"Iowa","Mahaska County",2,25,254,129,125
050,19,123,"Iowa","Mahaska County",2,26,242,125,117
050,19,123,"Iowa","Mahaska County",2,27,250,123,127
050,19,123,"Iowa","Mahaska County",2,28,254,132,122
050,19,123,"Iowa","Mahaska County",2,29,261,137,124
050,19,123,"Iowa","Mahaska County",2,30,243,119,124
050,19,123,"Iowa","Mahaska County",2,31,248,123,125
050,19,123,"Iowa","Mahaska County",2,32,238,121,117
050,19,123,"Iowa","Mahaska County",2,33,254,126,128
050,19,123,"Iowa","Mahaska County",2,34,268,125,143
050,19,123,"Iowa","Mahaska County",2,35,272,133,139
050,19,123,"Iowa","Mahaska County",2,36,251,126,125
050,19,123,"Iowa","Mahaska County",2,37,269,135,134
050,19,123,"Iowa","Mahaska County",2,38,272,135,137
050,19,123,"Iowa","Mahaska County",2,39,278,136,142
050,19,123,"Iowa","Mahaska County",2,40,289,153,136
050,19,123,"Iowa","Mahaska County",2,41,269,147,122
050,19,123,"Iowa","Mahaska County",2,42,261,136,125
050,19,123,"Iowa","Mahaska County",2,43,262,131,131
050,19,123,"Iowa","Mahaska County",2,44,255,126,129
050,19,123,"Iowa","Mahaska County",2,45,258,130,128
050,19,123,"Iowa","Mahaska County",2,46,243,126,117
050,19,123,"Iowa","Mahaska County",2,47,235,122,113
050,19,123,"Iowa","Mahaska County",2,48,237,127,110
050,19,123,"Iowa","Mahaska County",2,49,263,136,127
050,19,123,"Iowa","Mahaska County",2,50,260,128,132
050,19,123,"Iowa","Mahaska County",2,51,258,134,124
050,19,123,"Iowa","Mahaska County",2,52,252,127,125
050,19,123,"Iowa","Mahaska County",2,53,240,120,120
050,19,123,"Iowa","Mahaska County",2,54,242,135,107
050,19,123,"Iowa","Mahaska County",2,55,266,146,120
050,19,123,"Iowa","Mahaska County",2,56,275,150,125
050,19,123,"Iowa","Mahaska County",2,57,282,148,134
050,19,123,"Iowa","Mahaska County",2,58,299,150,149
050,19,123,"Iowa","Mahaska County",2,59,318,156,162
050,19,123,"Iowa","Mahaska County",2,60,319,158,161
050,19,123,"Iowa","Mahaska County",2,61,323,170,153
050,19,123,"Iowa","Mahaska County",2,62,327,171,156
050,19,123,"Iowa","Mahaska County",2,63,313,164,149
050,19,123,"Iowa","Mahaska County",2,64,280,148,132
050,19,123,"Iowa","Mahaska County",2,65,270,137,133
050,19,123,"Iowa","Mahaska County",2,66,270,138,132
050,19,123,"Iowa","Mahaska County",2,67,279,139,140
050,19,123,"Iowa","Mahaska County",2,68,259,131,128
050,19,123,"Iowa","Mahaska County",2,69,254,133,121
050,19,123,"Iowa","Mahaska County",2,70,217,112,105
050,19,123,"Iowa","Mahaska County",2,71,203,94,109
050,19,123,"Iowa","Mahaska County",2,72,201,88,113
050,19,123,"Iowa","Mahaska County",2,73,213,95,118
050,19,123,"Iowa","Mahaska County",2,74,148,75,73
050,19,123,"Iowa","Mahaska County",2,75,154,82,72
050,19,123,"Iowa","Mahaska County",2,76,159,79,80
050,19,123,"Iowa","Mahaska County",2,77,151,68,83
050,19,123,"Iowa","Mahaska County",2,78,121,58,63
050,19,123,"Iowa","Mahaska County",2,79,123,57,66
050,19,123,"Iowa","Mahaska County",2,80,132,52,80
050,19,123,"Iowa","Mahaska County",2,81,102,47,55
050,19,123,"Iowa","Mahaska County",2,82,95,42,53
050,19,123,"Iowa","Mahaska County",2,83,91,41,50
050,19,123,"Iowa","Mahaska County",2,84,88,41,47
050,19,123,"Iowa","Mahaska County",2,85,569,179,390
050,19,123,"Iowa","Mahaska County",3,0,239,133,106
050,19,123,"Iowa","Mahaska County",3,1,275,135,140
050,19,123,"Iowa","Mahaska County",3,2,275,135,140
050,19,123,"Iowa","Mahaska County",3,3,279,132,147
050,19,123,"Iowa","Mahaska County",3,4,283,141,142
050,19,123,"Iowa","Mahaska County",3,5,337,174,163
050,19,123,"Iowa","Mahaska County",3,6,311,170,141
050,19,123,"Iowa","Mahaska County",3,7,295,152,143
050,19,123,"Iowa","Mahaska County",3,8,295,146,149
050,19,123,"Iowa","Mahaska County",3,9,284,146,138
050,19,123,"Iowa","Mahaska County",3,10,299,149,150
050,19,123,"Iowa","Mahaska County",3,11,274,147,127
050,19,123,"Iowa","Mahaska County",3,12,287,148,139
050,19,123,"Iowa","Mahaska County",3,13,287,150,137
050,19,123,"Iowa","Mahaska County",3,14,292,155,137
050,19,123,"Iowa","Mahaska County",3,15,298,161,137
050,19,123,"Iowa","Mahaska County",3,16,295,166,129
050,19,123,"Iowa","Mahaska County",3,17,309,172,137
050,19,123,"Iowa","Mahaska County",3,18,324,187,137
050,19,123,"Iowa","Mahaska County",3,19,333,203,130
050,19,123,"Iowa","Mahaska County",3,20,311,179,132
050,19,123,"Iowa","Mahaska County",3,21,291,157,134
050,19,123,"Iowa","Mahaska County",3,22,293,165,128
050,19,123,"Iowa","Mahaska County",3,23,246,137,109
050,19,123,"Iowa","Mahaska County",3,24,266,147,119
050,19,123,"Iowa","Mahaska County",3,25,257,142,115
050,19,123,"Iowa","Mahaska County",3,26,256,132,124
050,19,123,"Iowa","Mahaska County",3,27,247,128,119
050,19,123,"Iowa","Mahaska County",3,28,248,126,122
050,19,123,"Iowa","Mahaska County",3,29,243,128,115
050,19,123,"Iowa","Mahaska County",3,30,262,141,121
050,19,123,"Iowa","Mahaska County",3,31,246,123,123
050,19,123,"Iowa","Mahaska County",3,32,258,126,132
050,19,123,"Iowa","Mahaska County",3,33,219,116,103
050,19,123,"Iowa","Mahaska County",3,34,256,125,131
050,19,123,"Iowa","Mahaska County",3,35,265,131,134
050,19,123,"Iowa","Mahaska County",3,36,269,135,134
050,19,123,"Iowa","Mahaska County",3,37,246,131,115
050,19,123,"Iowa","Mahaska County",3,38,277,144,133
050,19,123,"Iowa","Mahaska County",3,39,270,131,139
050,19,123,"Iowa","Mahaska County",3,40,272,136,136
050,19,123,"Iowa","Mahaska County",3,41,279,148,131
050,19,123,"Iowa","Mahaska County",3,42,265,147,118
050,19,123,"Iowa","Mahaska County",3,43,267,135,132
050,19,123,"Iowa","Mahaska County",3,44,262,135,127
050,19,123,"Iowa","Mahaska County",3,45,254,128,126
050,19,123,"Iowa","Mahaska County",3,46,258,129,129
050,19,123,"Iowa","Mahaska County",3,47,245,128,117
050,19,123,"Iowa","Mahaska County",3,48,236,120,116
050,19,123,"Iowa","Mahaska County",3,49,240,130,110
050,19,123,"Iowa","Mahaska County",3,50,258,130,128
050,19,123,"Iowa","Mahaska County",3,51,253,122,131
050,19,123,"Iowa","Mahaska County",3,52,256,126,130
050,19,123,"Iowa","Mahaska County",3,53,239,127,112
050,19,123,"Iowa","Mahaska County",3,54,243,125,118
050,19,123,"Iowa","Mahaska County",3,55,234,132,102
050,19,123,"Iowa","Mahaska County",3,56,256,138,118
050,19,123,"Iowa","Mahaska County",3,57,274,150,124
050,19,123,"Iowa","Mahaska County",3,58,278,143,135
050,19,123,"Iowa","Mahaska County",3,59,291,146,145
050,19,123,"Iowa","Mahaska County",3,60,320,155,165
050,19,123,"Iowa","Mahaska County",3,61,318,159,159
050,19,123,"Iowa","Mahaska County",3,62,320,163,157
050,19,123,"Iowa","Mahaska County",3,63,315,164,151
050,19,123,"Iowa","Mahaska County",3,64,306,162,144
050,19,123,"Iowa","Mahaska County",3,65,279,150,129
050,19,123,"Iowa","Mahaska County",3,66,264,133,131
050,19,123,"Iowa","Mahaska County",3,67,265,137,128
050,19,123,"Iowa","Mahaska County",3,68,270,132,138
050,19,123,"Iowa","Mahaska County",3,69,255,129,126
050,19,123,"Iowa","Mahaska County",3,70,242,126,116
050,19,123,"Iowa","Mahaska County",3,71,213,108,105
050,19,123,"Iowa","Mahaska County",3,72,191,89,102
050,19,123,"Iowa","Mahaska County",3,73,195,82,113
050,19,123,"Iowa","Mahaska County",3,74,197,88,109
050,19,123,"Iowa","Mahaska County",3,75,146,76,70
050,19,123,"Iowa","Mahaska County",3,76,157,88,69
050,19,123,"Iowa","Mahaska County",3,77,147,70,77
050,19,123,"Iowa","Mahaska County",3,78,144,63,81
050,19,123,"Iowa","Mahaska County",3,79,123,60,63
050,19,123,"Iowa","Mahaska County",3,80,120,51,69
050,19,123,"Iowa","Mahaska County",3,81,102,43,59
050,19,123,"Iowa","Mahaska County",3,82,96,41,55
050,19,123,"Iowa","Mahaska County",3,83,98,41,57
050,19,123,"Iowa","Mahaska County",3,84,83,39,44
050,19,123,"Iowa","Mahaska County",3,85,551,177,374
050,19,123,"Iowa","Mahaska County",4,0,227,128,99
050,19,123,"Iowa","Mahaska County",4,1,250,136,114
050,19,123,"Iowa","Mahaska County",4,2,283,142,141
050,19,123,"Iowa","Mahaska County",4,3,273,133,140
050,19,123,"Iowa","Mahaska County",4,4,286,125,161
050,19,123,"Iowa","Mahaska County",4,5,279,140,139
050,19,123,"Iowa","Mahaska County",4,6,329,169,160
050,19,123,"Iowa","Mahaska County",4,7,315,165,150
050,19,123,"Iowa","Mahaska County",4,8,303,159,144
050,19,123,"Iowa","Mahaska County",4,9,291,144,147
050,19,123,"Iowa","Mahaska County",4,10,282,144,138
050,19,123,"Iowa","Mahaska County",4,11,301,153,148
050,19,123,"Iowa","Mahaska County",4,12,278,144,134
050,19,123,"Iowa","Mahaska County",4,13,291,151,140
050,19,123,"Iowa","Mahaska County",4,14,299,156,143
050,19,123,"Iowa","Mahaska County",4,15,298,157,141
050,19,123,"Iowa","Mahaska County",4,16,295,158,137
050,19,123,"Iowa","Mahaska County",4,17,293,164,129
050,19,123,"Iowa","Mahaska County",4,18,323,190,133
050,19,123,"Iowa","Mahaska County",4,19,335,210,125
050,19,123,"Iowa","Mahaska County",4,20,303,175,128
050,19,123,"Iowa","Mahaska County",4,21,296,162,134
050,19,123,"Iowa","Mahaska County",4,22,284,157,127
050,19,123,"Iowa","Mahaska County",4,23,302,169,133
050,19,123,"Iowa","Mahaska County",4,24,237,123,114
050,19,123,"Iowa","Mahaska County",4,25,261,139,122
050,19,123,"Iowa","Mahaska County",4,26,240,130,110
050,19,123,"Iowa","Mahaska County",4,27,260,138,122
050,19,123,"Iowa","Mahaska County",4,28,258,134,124
050,19,123,"Iowa","Mahaska County",4,29,243,123,120
050,19,123,"Iowa","Mahaska County",4,30,239,128,111
050,19,123,"Iowa","Mahaska County",4,31,273,144,129
050,19,123,"Iowa","Mahaska County",4,32,261,138,123
050,19,123,"Iowa","Mahaska County",4,33,254,120,134
050,19,123,"Iowa","Mahaska County",4,34,217,110,107
050,19,123,"Iowa","Mahaska County",4,35,264,128,136
050,19,123,"Iowa","Mahaska County",4,36,270,135,135
050,19,123,"Iowa","Mahaska County",4,37,267,130,137
050,19,123,"Iowa","Mahaska County",4,38,245,128,117
050,19,123,"Iowa","Mahaska County",4,39,276,141,135
050,19,123,"Iowa","Mahaska County",4,40,278,137,141
050,19,123,"Iowa","Mahaska County",4,41,280,144,136
050,19,123,"Iowa","Mahaska County",4,42,278,149,129
050,19,123,"Iowa","Mahaska County",4,43,263,149,114
050,19,123,"Iowa","Mahaska County",4,44,271,135,136
050,19,123,"Iowa","Mahaska County",4,45,247,124,123
050,19,123,"Iowa","Mahaska County",4,46,256,124,132
050,19,123,"Iowa","Mahaska County",4,47,261,130,131
050,19,123,"Iowa","Mahaska County",4,48,237,127,110
050,19,123,"Iowa","Mahaska County",4,49,237,117,120
050,19,123,"Iowa","Mahaska County",4,50,242,133,109
050,19,123,"Iowa","Mahaska County",4,51,255,133,122
050,19,123,"Iowa","Mahaska County",4,52,256,121,135
050,19,123,"Iowa","Mahaska County",4,53,247,123,124
050,19,123,"Iowa","Mahaska County",4,54,245,130,115
050,19,123,"Iowa","Mahaska County",4,55,239,124,115
050,19,123,"Iowa","Mahaska County",4,56,236,129,107
050,19,123,"Iowa","Mahaska County",4,57,254,136,118
050,19,123,"Iowa","Mahaska County",4,58,282,154,128
050,19,123,"Iowa","Mahaska County",4,59,281,143,138
050,19,123,"Iowa","Mahaska County",4,60,287,140,147
050,19,123,"Iowa","Mahaska County",4,61,314,151,163
050,19,123,"Iowa","Mahaska County",4,62,313,161,152
050,19,123,"Iowa","Mahaska County",4,63,314,158,156
050,19,123,"Iowa","Mahaska County",4,64,306,158,148
050,19,123,"Iowa","Mahaska County",4,65,296,155,141
050,19,123,"Iowa","Mahaska County",4,66,274,148,126
050,19,123,"Iowa","Mahaska County",4,67,255,130,125
050,19,123,"Iowa","Mahaska County",4,68,253,129,124
050,19,123,"Iowa","Mahaska County",4,69,266,133,133
050,19,123,"Iowa","Mahaska County",4,70,249,125,124
050,19,123,"Iowa","Mahaska County",4,71,235,119,116
050,19,123,"Iowa","Mahaska County",4,72,202,106,96
050,19,123,"Iowa","Mahaska County",4,73,183,80,103
050,19,123,"Iowa","Mahaska County",4,74,187,79,108
050,19,123,"Iowa","Mahaska County",4,75,190,83,107
050,19,123,"Iowa","Mahaska County",4,76,144,78,66
050,19,123,"Iowa","Mahaska County",4,77,149,79,70
050,19,123,"Iowa","Mahaska County",4,78,140,66,74
050,19,123,"Iowa","Mahaska County",4,79,149,65,84
050,19,123,"Iowa","Mahaska County",4,80,115,53,62
050,19,123,"Iowa","Mahaska County",4,81,90,45,45
050,19,123,"Iowa","Mahaska County",4,82,93,36,57
050,19,123,"Iowa","Mahaska County",4,83,98,39,59
050,19,123,"Iowa","Mahaska County",4,84,90,38,52
050,19,123,"Iowa","Mahaska County",4,85,553,189,364
050,19,123,"Iowa","Mahaska County",5,0,231,131,100
050,19,123,"Iowa","Mahaska County",5,1,242,130,112
050,19,123,"Iowa","Mahaska County",5,2,243,131,112
050,19,123,"Iowa","Mahaska County",5,3,285,144,141
050,19,123,"Iowa","Mahaska County",5,4,278,135,143
050,19,123,"Iowa","Mahaska County",5,5,287,130,157
050,19,123,"Iowa","Mahaska County",5,6,289,151,138
050,19,123,"Iowa","Mahaska County",5,7,330,165,165
050,19,123,"Iowa","Mahaska County",5,8,311,174,137
050,19,123,"Iowa","Mahaska County",5,9,304,163,141
050,19,123,"Iowa","Mahaska County",5,10,286,143,143
050,19,123,"Iowa","Mahaska County",5,11,286,144,142
050,19,123,"Iowa","Mahaska County",5,12,306,156,150
050,19,123,"Iowa","Mahaska County",5,13,275,144,131
050,19,123,"Iowa","Mahaska County",5,14,283,145,138
050,19,123,"Iowa","Mahaska County",5,15,304,163,141
050,19,123,"Iowa","Mahaska County",5,16,296,153,143
050,19,123,"Iowa","Mahaska County",5,17,300,165,135
050,19,123,"Iowa","Mahaska County",5,18,305,187,118
050,19,123,"Iowa","Mahaska County",5,19,340,217,123
050,19,123,"Iowa","Mahaska County",5,20,311,184,127
050,19,123,"Iowa","Mahaska County",5,21,281,156,125
050,19,123,"Iowa","Mahaska County",5,22,288,166,122
050,19,123,"Iowa","Mahaska County",5,23,252,129,123
050,19,123,"Iowa","Mahaska County",5,24,303,173,130
050,19,123,"Iowa","Mahaska County",5,25,253,131,122
050,19,123,"Iowa","Mahaska County",5,26,256,139,117
050,19,123,"Iowa","Mahaska County",5,27,238,123,115
050,19,123,"Iowa","Mahaska County",5,28,266,136,130
050,19,123,"Iowa","Mahaska County",5,29,250,131,119
050,19,123,"Iowa","Mahaska County",5,30,243,122,121
050,19,123,"Iowa","Mahaska County",5,31,244,124,120
050,19,123,"Iowa","Mahaska County",5,32,261,136,125
050,19,123,"Iowa","Mahaska County",5,33,257,137,120
050,19,123,"Iowa","Mahaska County",5,34,261,128,133
050,19,123,"Iowa","Mahaska County",5,35,218,111,107
050,19,123,"Iowa","Mahaska County",5,36,264,127,137
050,19,123,"Iowa","Mahaska County",5,37,264,125,139
050,19,123,"Iowa","Mahaska County",5,38,266,130,136
050,19,123,"Iowa","Mahaska County",5,39,242,130,112
050,19,123,"Iowa","Mahaska County",5,40,279,138,141
050,19,123,"Iowa","Mahaska County",5,41,272,136,136
050,19,123,"Iowa","Mahaska County",5,42,285,146,139
050,19,123,"Iowa","Mahaska County",5,43,285,154,131
050,19,123,"Iowa","Mahaska County",5,44,260,152,108
050,19,123,"Iowa","Mahaska County",5,45,266,130,136
050,19,123,"Iowa","Mahaska County",5,46,245,119,126
050,19,123,"Iowa","Mahaska County",5,47,250,124,126
050,19,123,"Iowa","Mahaska County",5,48,263,130,133
050,19,123,"Iowa","Mahaska County",5,49,238,128,110
050,19,123,"Iowa","Mahaska County",5,50,232,114,118
050,19,123,"Iowa","Mahaska County",5,51,247,140,107
050,19,123,"Iowa","Mahaska County",5,52,257,128,129
050,19,123,"Iowa","Mahaska County",5,53,250,115,135
050,19,123,"Iowa","Mahaska County",5,54,250,130,120
050,19,123,"Iowa","Mahaska County",5,55,237,125,112
050,19,123,"Iowa","Mahaska County",5,56,237,121,116
050,19,123,"Iowa","Mahaska County",5,57,232,130,102
050,19,123,"Iowa","Mahaska County",5,58,252,134,118
050,19,123,"Iowa","Mahaska County",5,59,275,147,128
050,19,123,"Iowa","Mahaska County",5,60,272,139,133
050,19,123,"Iowa","Mahaska County",5,61,275,133,142
050,19,123,"Iowa","Mahaska County",5,62,305,146,159
050,19,123,"Iowa","Mahaska County",5,63,311,159,152
050,19,123,"Iowa","Mahaska County",5,64,310,155,155
050,19,123,"Iowa","Mahaska County",5,65,297,158,139
050,19,123,"Iowa","Mahaska County",5,66,285,149,136
050,19,123,"Iowa","Mahaska County",5,67,263,143,120
050,19,123,"Iowa","Mahaska County",5,68,247,125,122
050,19,123,"Iowa","Mahaska County",5,69,247,127,120
050,19,123,"Iowa","Mahaska County",5,70,254,127,127
050,19,123,"Iowa","Mahaska County",5,71,242,120,122
050,19,123,"Iowa","Mahaska County",5,72,229,118,111
050,19,123,"Iowa","Mahaska County",5,73,199,102,97
050,19,123,"Iowa","Mahaska County",5,74,176,77,99
050,19,123,"Iowa","Mahaska County",5,75,184,77,107
050,19,123,"Iowa","Mahaska County",5,76,189,84,105
050,19,123,"Iowa","Mahaska County",5,77,138,69,69
050,19,123,"Iowa","Mahaska County",5,78,137,71,66
050,19,123,"Iowa","Mahaska County",5,79,143,68,75
050,19,123,"Iowa","Mahaska County",5,80,146,58,88
050,19,123,"Iowa","Mahaska County",5,81,87,46,41
050,19,123,"Iowa","Mahaska County",5,82,83,39,44
050,19,123,"Iowa","Mahaska County",5,83,94,34,60
050,19,123,"Iowa","Mahaska County",5,84,92,36,56
050,19,123,"Iowa","Mahaska County",5,85,558,198,360
050,19,125,"Iowa","Marion County",1,0,338,174,164
050,19,125,"Iowa","Marion County",1,1,355,186,169
050,19,125,"Iowa","Marion County",1,2,366,196,170
050,19,125,"Iowa","Marion County",1,3,407,201,206
050,19,125,"Iowa","Marion County",1,4,409,200,209
050,19,125,"Iowa","Marion County",1,5,408,210,198
050,19,125,"Iowa","Marion County",1,6,410,207,203
050,19,125,"Iowa","Marion County",1,7,406,200,206
050,19,125,"Iowa","Marion County",1,8,413,205,208
050,19,125,"Iowa","Marion County",1,9,430,207,223
050,19,125,"Iowa","Marion County",1,10,478,250,228
050,19,125,"Iowa","Marion County",1,11,505,268,237
050,19,125,"Iowa","Marion County",1,12,540,285,255
050,19,125,"Iowa","Marion County",1,13,503,267,236
050,19,125,"Iowa","Marion County",1,14,481,243,238
050,19,125,"Iowa","Marion County",1,15,480,257,223
050,19,125,"Iowa","Marion County",1,16,461,250,211
050,19,125,"Iowa","Marion County",1,17,467,248,219
050,19,125,"Iowa","Marion County",1,18,498,266,232
050,19,125,"Iowa","Marion County",1,19,576,296,280
050,19,125,"Iowa","Marion County",1,20,571,298,273
050,19,125,"Iowa","Marion County",1,21,534,263,271
050,19,125,"Iowa","Marion County",1,22,469,253,216
050,19,125,"Iowa","Marion County",1,23,321,176,145
050,19,125,"Iowa","Marion County",1,24,333,176,157
050,19,125,"Iowa","Marion County",1,25,336,160,176
050,19,125,"Iowa","Marion County",1,26,371,193,178
050,19,125,"Iowa","Marion County",1,27,381,201,180
050,19,125,"Iowa","Marion County",1,28,367,196,171
050,19,125,"Iowa","Marion County",1,29,322,162,160
050,19,125,"Iowa","Marion County",1,30,320,167,153
050,19,125,"Iowa","Marion County",1,31,325,168,157
050,19,125,"Iowa","Marion County",1,32,359,193,166
050,19,125,"Iowa","Marion County",1,33,360,186,174
050,19,125,"Iowa","Marion County",1,34,362,198,164
050,19,125,"Iowa","Marion County",1,35,397,203,194
050,19,125,"Iowa","Marion County",1,36,411,219,192
050,19,125,"Iowa","Marion County",1,37,420,210,210
050,19,125,"Iowa","Marion County",1,38,414,199,215
050,19,125,"Iowa","Marion County",1,39,386,188,198
050,19,125,"Iowa","Marion County",1,40,405,215,190
050,19,125,"Iowa","Marion County",1,41,403,200,203
050,19,125,"Iowa","Marion County",1,42,430,212,218
050,19,125,"Iowa","Marion County",1,43,422,220,202
050,19,125,"Iowa","Marion County",1,44,388,203,185
050,19,125,"Iowa","Marion County",1,45,358,179,179
050,19,125,"Iowa","Marion County",1,46,337,168,169
050,19,125,"Iowa","Marion County",1,47,362,183,179
050,19,125,"Iowa","Marion County",1,48,400,202,198
050,19,125,"Iowa","Marion County",1,49,423,216,207
050,19,125,"Iowa","Marion County",1,50,391,199,192
050,19,125,"Iowa","Marion County",1,51,359,185,174
050,19,125,"Iowa","Marion County",1,52,382,190,192
050,19,125,"Iowa","Marion County",1,53,420,216,204
050,19,125,"Iowa","Marion County",1,54,423,217,206
050,19,125,"Iowa","Marion County",1,55,467,243,224
050,19,125,"Iowa","Marion County",1,56,461,240,221
050,19,125,"Iowa","Marion County",1,57,468,234,234
050,19,125,"Iowa","Marion County",1,58,493,243,250
050,19,125,"Iowa","Marion County",1,59,499,259,240
050,19,125,"Iowa","Marion County",1,60,461,248,213
050,19,125,"Iowa","Marion County",1,61,463,248,215
050,19,125,"Iowa","Marion County",1,62,453,231,222
050,19,125,"Iowa","Marion County",1,63,429,206,223
050,19,125,"Iowa","Marion County",1,64,395,190,205
050,19,125,"Iowa","Marion County",1,65,402,197,205
050,19,125,"Iowa","Marion County",1,66,403,200,203
050,19,125,"Iowa","Marion County",1,67,395,209,186
050,19,125,"Iowa","Marion County",1,68,400,199,201
050,19,125,"Iowa","Marion County",1,69,356,172,184
050,19,125,"Iowa","Marion County",1,70,335,167,168
050,19,125,"Iowa","Marion County",1,71,302,146,156
050,19,125,"Iowa","Marion County",1,72,322,151,171
050,19,125,"Iowa","Marion County",1,73,312,140,172
050,19,125,"Iowa","Marion County",1,74,235,116,119
050,19,125,"Iowa","Marion County",1,75,246,125,121
050,19,125,"Iowa","Marion County",1,76,239,111,128
050,19,125,"Iowa","Marion County",1,77,242,106,136
050,19,125,"Iowa","Marion County",1,78,204,89,115
050,19,125,"Iowa","Marion County",1,79,201,81,120
050,19,125,"Iowa","Marion County",1,80,167,75,92
050,19,125,"Iowa","Marion County",1,81,174,72,102
050,19,125,"Iowa","Marion County",1,82,166,68,98
050,19,125,"Iowa","Marion County",1,83,140,61,79
050,19,125,"Iowa","Marion County",1,84,150,59,91
050,19,125,"Iowa","Marion County",1,85,845,282,563
050,19,125,"Iowa","Marion County",2,0,342,177,165
050,19,125,"Iowa","Marion County",2,1,352,185,167
050,19,125,"Iowa","Marion County",2,2,364,193,171
050,19,125,"Iowa","Marion County",2,3,396,199,197
050,19,125,"Iowa","Marion County",2,4,409,202,207
050,19,125,"Iowa","Marion County",2,5,412,209,203
050,19,125,"Iowa","Marion County",2,6,407,207,200
050,19,125,"Iowa","Marion County",2,7,404,200,204
050,19,125,"Iowa","Marion County",2,8,409,202,207
050,19,125,"Iowa","Marion County",2,9,423,207,216
050,19,125,"Iowa","Marion County",2,10,465,240,225
050,19,125,"Iowa","Marion County",2,11,498,264,234
050,19,125,"Iowa","Marion County",2,12,534,282,252
050,19,125,"Iowa","Marion County",2,13,511,270,241
050,19,125,"Iowa","Marion County",2,14,486,249,237
050,19,125,"Iowa","Marion County",2,15,479,253,226
050,19,125,"Iowa","Marion County",2,16,463,251,212
050,19,125,"Iowa","Marion County",2,17,468,249,219
050,19,125,"Iowa","Marion County",2,18,489,261,228
050,19,125,"Iowa","Marion County",2,19,583,299,284
050,19,125,"Iowa","Marion County",2,20,574,301,273
050,19,125,"Iowa","Marion County",2,21,536,267,269
050,19,125,"Iowa","Marion County",2,22,468,251,217
050,19,125,"Iowa","Marion County",2,23,333,181,152
050,19,125,"Iowa","Marion County",2,24,330,176,154
050,19,125,"Iowa","Marion County",2,25,338,166,172
050,19,125,"Iowa","Marion County",2,26,362,185,177
050,19,125,"Iowa","Marion County",2,27,380,198,182
050,19,125,"Iowa","Marion County",2,28,372,197,175
050,19,125,"Iowa","Marion County",2,29,337,173,164
050,19,125,"Iowa","Marion County",2,30,325,169,156
050,19,125,"Iowa","Marion County",2,31,323,169,154
050,19,125,"Iowa","Marion County",2,32,350,187,163
050,19,125,"Iowa","Marion County",2,33,359,189,170
050,19,125,"Iowa","Marion County",2,34,362,195,167
050,19,125,"Iowa","Marion County",2,35,391,204,187
050,19,125,"Iowa","Marion County",2,36,403,213,190
050,19,125,"Iowa","Marion County",2,37,417,212,205
050,19,125,"Iowa","Marion County",2,38,416,202,214
050,19,125,"Iowa","Marion County",2,39,389,188,201
050,19,125,"Iowa","Marion County",2,40,400,206,194
050,19,125,"Iowa","Marion County",2,41,402,202,200
050,19,125,"Iowa","Marion County",2,42,424,209,215
050,19,125,"Iowa","Marion County",2,43,427,220,207
050,19,125,"Iowa","Marion County",2,44,389,202,187
050,19,125,"Iowa","Marion County",2,45,367,184,183
050,19,125,"Iowa","Marion County",2,46,341,170,171
050,19,125,"Iowa","Marion County",2,47,353,177,176
050,19,125,"Iowa","Marion County",2,48,391,198,193
050,19,125,"Iowa","Marion County",2,49,421,216,205
050,19,125,"Iowa","Marion County",2,50,400,203,197
050,19,125,"Iowa","Marion County",2,51,368,190,178
050,19,125,"Iowa","Marion County",2,52,374,188,186
050,19,125,"Iowa","Marion County",2,53,412,211,201
050,19,125,"Iowa","Marion County",2,54,424,219,205
050,19,125,"Iowa","Marion County",2,55,456,236,220
050,19,125,"Iowa","Marion County",2,56,465,242,223
050,19,125,"Iowa","Marion County",2,57,467,234,233
050,19,125,"Iowa","Marion County",2,58,484,240,244
050,19,125,"Iowa","Marion County",2,59,498,256,242
050,19,125,"Iowa","Marion County",2,60,461,247,214
050,19,125,"Iowa","Marion County",2,61,460,246,214
050,19,125,"Iowa","Marion County",2,62,459,237,222
050,19,125,"Iowa","Marion County",2,63,442,214,228
050,19,125,"Iowa","Marion County",2,64,398,191,207
050,19,125,"Iowa","Marion County",2,65,399,195,204
050,19,125,"Iowa","Marion County",2,66,402,200,202
050,19,125,"Iowa","Marion County",2,67,394,204,190
050,19,125,"Iowa","Marion County",2,68,397,200,197
050,19,125,"Iowa","Marion County",2,69,370,181,189
050,19,125,"Iowa","Marion County",2,70,339,169,170
050,19,125,"Iowa","Marion County",2,71,308,148,160
050,19,125,"Iowa","Marion County",2,72,309,146,163
050,19,125,"Iowa","Marion County",2,73,326,148,178
050,19,125,"Iowa","Marion County",2,74,238,115,123
050,19,125,"Iowa","Marion County",2,75,241,121,120
050,19,125,"Iowa","Marion County",2,76,237,112,125
050,19,125,"Iowa","Marion County",2,77,243,107,136
050,19,125,"Iowa","Marion County",2,78,208,90,118
050,19,125,"Iowa","Marion County",2,79,201,82,119
050,19,125,"Iowa","Marion County",2,80,175,78,97
050,19,125,"Iowa","Marion County",2,81,169,71,98
050,19,125,"Iowa","Marion County",2,82,166,68,98
050,19,125,"Iowa","Marion County",2,83,145,62,83
050,19,125,"Iowa","Marion County",2,84,145,58,87
050,19,125,"Iowa","Marion County",2,85,860,287,573
050,19,125,"Iowa","Marion County",3,0,361,180,181
050,19,125,"Iowa","Marion County",3,1,348,182,166
050,19,125,"Iowa","Marion County",3,2,350,188,162
050,19,125,"Iowa","Marion County",3,3,385,205,180
050,19,125,"Iowa","Marion County",3,4,388,193,195
050,19,125,"Iowa","Marion County",3,5,405,204,201
050,19,125,"Iowa","Marion County",3,6,417,205,212
050,19,125,"Iowa","Marion County",3,7,411,209,202
050,19,125,"Iowa","Marion County",3,8,425,213,212
050,19,125,"Iowa","Marion County",3,9,412,206,206
050,19,125,"Iowa","Marion County",3,10,444,220,224
050,19,125,"Iowa","Marion County",3,11,465,236,229
050,19,125,"Iowa","Marion County",3,12,502,265,237
050,19,125,"Iowa","Marion County",3,13,522,280,242
050,19,125,"Iowa","Marion County",3,14,515,273,242
050,19,125,"Iowa","Marion County",3,15,498,253,245
050,19,125,"Iowa","Marion County",3,16,502,267,235
050,19,125,"Iowa","Marion County",3,17,463,249,214
050,19,125,"Iowa","Marion County",3,18,477,249,228
050,19,125,"Iowa","Marion County",3,19,568,288,280
050,19,125,"Iowa","Marion County",3,20,572,297,275
050,19,125,"Iowa","Marion County",3,21,545,284,261
050,19,125,"Iowa","Marion County",3,22,490,256,234
050,19,125,"Iowa","Marion County",3,23,375,200,175
050,19,125,"Iowa","Marion County",3,24,323,179,144
050,19,125,"Iowa","Marion County",3,25,306,174,132
050,19,125,"Iowa","Marion County",3,26,339,184,155
050,19,125,"Iowa","Marion County",3,27,358,187,171
050,19,125,"Iowa","Marion County",3,28,374,185,189
050,19,125,"Iowa","Marion County",3,29,353,183,170
050,19,125,"Iowa","Marion County",3,30,343,172,171
050,19,125,"Iowa","Marion County",3,31,333,172,161
050,19,125,"Iowa","Marion County",3,32,322,169,153
050,19,125,"Iowa","Marion County",3,33,358,188,170
050,19,125,"Iowa","Marion County",3,34,366,193,173
050,19,125,"Iowa","Marion County",3,35,355,191,164
050,19,125,"Iowa","Marion County",3,36,394,201,193
050,19,125,"Iowa","Marion County",3,37,406,215,191
050,19,125,"Iowa","Marion County",3,38,422,213,209
050,19,125,"Iowa","Marion County",3,39,416,201,215
050,19,125,"Iowa","Marion County",3,40,395,190,205
050,19,125,"Iowa","Marion County",3,41,411,214,197
050,19,125,"Iowa","Marion County",3,42,405,203,202
050,19,125,"Iowa","Marion County",3,43,431,215,216
050,19,125,"Iowa","Marion County",3,44,421,216,205
050,19,125,"Iowa","Marion County",3,45,398,204,194
050,19,125,"Iowa","Marion County",3,46,353,183,170
050,19,125,"Iowa","Marion County",3,47,348,179,169
050,19,125,"Iowa","Marion County",3,48,342,179,163
050,19,125,"Iowa","Marion County",3,49,384,198,186
050,19,125,"Iowa","Marion County",3,50,413,203,210
050,19,125,"Iowa","Marion County",3,51,393,201,192
050,19,125,"Iowa","Marion County",3,52,368,193,175
050,19,125,"Iowa","Marion County",3,53,380,191,189
050,19,125,"Iowa","Marion County",3,54,412,211,201
050,19,125,"Iowa","Marion County",3,55,421,220,201
050,19,125,"Iowa","Marion County",3,56,460,238,222
050,19,125,"Iowa","Marion County",3,57,461,241,220
050,19,125,"Iowa","Marion County",3,58,479,242,237
050,19,125,"Iowa","Marion County",3,59,481,240,241
050,19,125,"Iowa","Marion County",3,60,471,240,231
050,19,125,"Iowa","Marion County",3,61,458,244,214
050,19,125,"Iowa","Marion County",3,62,457,242,215
050,19,125,"Iowa","Marion County",3,63,454,228,226
050,19,125,"Iowa","Marion County",3,64,432,214,218
050,19,125,"Iowa","Marion County",3,65,382,179,203
050,19,125,"Iowa","Marion County",3,66,396,190,206
050,19,125,"Iowa","Marion County",3,67,404,200,204
050,19,125,"Iowa","Marion County",3,68,389,202,187
050,19,125,"Iowa","Marion County",3,69,389,199,190
050,19,125,"Iowa","Marion County",3,70,362,176,186
050,19,125,"Iowa","Marion County",3,71,331,162,169
050,19,125,"Iowa","Marion County",3,72,298,139,159
050,19,125,"Iowa","Marion County",3,73,308,145,163
050,19,125,"Iowa","Marion County",3,74,327,147,180
050,19,125,"Iowa","Marion County",3,75,233,108,125
050,19,125,"Iowa","Marion County",3,76,242,118,124
050,19,125,"Iowa","Marion County",3,77,234,109,125
050,19,125,"Iowa","Marion County",3,78,232,100,132
050,19,125,"Iowa","Marion County",3,79,208,85,123
050,19,125,"Iowa","Marion County",3,80,194,81,113
050,19,125,"Iowa","Marion County",3,81,167,70,97
050,19,125,"Iowa","Marion County",3,82,166,69,97
050,19,125,"Iowa","Marion County",3,83,154,63,91
050,19,125,"Iowa","Marion County",3,84,145,64,81
050,19,125,"Iowa","Marion County",3,85,844,279,565
050,19,125,"Iowa","Marion County",4,0,354,180,174
050,19,125,"Iowa","Marion County",4,1,375,184,191
050,19,125,"Iowa","Marion County",4,2,353,181,172
050,19,125,"Iowa","Marion County",4,3,373,195,178
050,19,125,"Iowa","Marion County",4,4,381,203,178
050,19,125,"Iowa","Marion County",4,5,398,206,192
050,19,125,"Iowa","Marion County",4,6,418,211,207
050,19,125,"Iowa","Marion County",4,7,422,213,209
050,19,125,"Iowa","Marion County",4,8,426,213,213
050,19,125,"Iowa","Marion County",4,9,428,213,215
050,19,125,"Iowa","Marion County",4,10,413,202,211
050,19,125,"Iowa","Marion County",4,11,454,221,233
050,19,125,"Iowa","Marion County",4,12,473,238,235
050,19,125,"Iowa","Marion County",4,13,509,269,240
050,19,125,"Iowa","Marion County",4,14,534,291,243
050,19,125,"Iowa","Marion County",4,15,514,277,237
050,19,125,"Iowa","Marion County",4,16,492,249,243
050,19,125,"Iowa","Marion County",4,17,505,266,239
050,19,125,"Iowa","Marion County",4,18,463,249,214
050,19,125,"Iowa","Marion County",4,19,573,286,287
050,19,125,"Iowa","Marion County",4,20,563,290,273
050,19,125,"Iowa","Marion County",4,21,557,287,270
050,19,125,"Iowa","Marion County",4,22,473,260,213
050,19,125,"Iowa","Marion County",4,23,363,186,177
050,19,125,"Iowa","Marion County",4,24,384,228,156
050,19,125,"Iowa","Marion County",4,25,329,176,153
050,19,125,"Iowa","Marion County",4,26,335,195,140
050,19,125,"Iowa","Marion County",4,27,332,174,158
050,19,125,"Iowa","Marion County",4,28,369,189,180
050,19,125,"Iowa","Marion County",4,29,374,185,189
050,19,125,"Iowa","Marion County",4,30,374,196,178
050,19,125,"Iowa","Marion County",4,31,355,174,181
050,19,125,"Iowa","Marion County",4,32,352,182,170
050,19,125,"Iowa","Marion County",4,33,339,183,156
050,19,125,"Iowa","Marion County",4,34,367,188,179
050,19,125,"Iowa","Marion County",4,35,373,197,176
050,19,125,"Iowa","Marion County",4,36,376,201,175
050,19,125,"Iowa","Marion County",4,37,403,208,195
050,19,125,"Iowa","Marion County",4,38,411,222,189
050,19,125,"Iowa","Marion County",4,39,421,213,208
050,19,125,"Iowa","Marion County",4,40,437,222,215
050,19,125,"Iowa","Marion County",4,41,397,189,208
050,19,125,"Iowa","Marion County",4,42,415,214,201
050,19,125,"Iowa","Marion County",4,43,417,212,205
050,19,125,"Iowa","Marion County",4,44,426,214,212
050,19,125,"Iowa","Marion County",4,45,421,216,205
050,19,125,"Iowa","Marion County",4,46,391,206,185
050,19,125,"Iowa","Marion County",4,47,349,180,169
050,19,125,"Iowa","Marion County",4,48,350,182,168
050,19,125,"Iowa","Marion County",4,49,341,177,164
050,19,125,"Iowa","Marion County",4,50,386,199,187
050,19,125,"Iowa","Marion County",4,51,412,200,212
050,19,125,"Iowa","Marion County",4,52,384,198,186
050,19,125,"Iowa","Marion County",4,53,377,203,174
050,19,125,"Iowa","Marion County",4,54,374,184,190
050,19,125,"Iowa","Marion County",4,55,406,205,201
050,19,125,"Iowa","Marion County",4,56,429,226,203
050,19,125,"Iowa","Marion County",4,57,451,232,219
050,19,125,"Iowa","Marion County",4,58,471,247,224
050,19,125,"Iowa","Marion County",4,59,475,238,237
050,19,125,"Iowa","Marion County",4,60,464,239,225
050,19,125,"Iowa","Marion County",4,61,473,242,231
050,19,125,"Iowa","Marion County",4,62,453,239,214
050,19,125,"Iowa","Marion County",4,63,441,229,212
050,19,125,"Iowa","Marion County",4,64,441,225,216
050,19,125,"Iowa","Marion County",4,65,423,207,216
050,19,125,"Iowa","Marion County",4,66,379,176,203
050,19,125,"Iowa","Marion County",4,67,385,187,198
050,19,125,"Iowa","Marion County",4,68,394,191,203
050,19,125,"Iowa","Marion County",4,69,382,198,184
050,19,125,"Iowa","Marion County",4,70,380,194,186
050,19,125,"Iowa","Marion County",4,71,344,167,177
050,19,125,"Iowa","Marion County",4,72,338,163,175
050,19,125,"Iowa","Marion County",4,73,299,140,159
050,19,125,"Iowa","Marion County",4,74,309,146,163
050,19,125,"Iowa","Marion County",4,75,310,139,171
050,19,125,"Iowa","Marion County",4,76,223,104,119
050,19,125,"Iowa","Marion County",4,77,230,112,118
050,19,125,"Iowa","Marion County",4,78,221,102,119
050,19,125,"Iowa","Marion County",4,79,232,96,136
050,19,125,"Iowa","Marion County",4,80,196,81,115
050,19,125,"Iowa","Marion County",4,81,179,64,115
050,19,125,"Iowa","Marion County",4,82,153,65,88
050,19,125,"Iowa","Marion County",4,83,154,66,88
050,19,125,"Iowa","Marion County",4,84,161,65,96
050,19,125,"Iowa","Marion County",4,85,849,287,562
050,19,125,"Iowa","Marion County",5,0,355,184,171
050,19,125,"Iowa","Marion County",5,1,379,194,185
050,19,125,"Iowa","Marion County",5,2,379,187,192
050,19,125,"Iowa","Marion County",5,3,359,188,171
050,19,125,"Iowa","Marion County",5,4,390,204,186
050,19,125,"Iowa","Marion County",5,5,387,207,180
050,19,125,"Iowa","Marion County",5,6,418,216,202
050,19,125,"Iowa","Marion County",5,7,416,217,199
050,19,125,"Iowa","Marion County",5,8,425,215,210
050,19,125,"Iowa","Marion County",5,9,422,206,216
050,19,125,"Iowa","Marion County",5,10,438,216,222
050,19,125,"Iowa","Marion County",5,11,417,202,215
050,19,125,"Iowa","Marion County",5,12,472,230,242
050,19,125,"Iowa","Marion County",5,13,487,241,246
050,19,125,"Iowa","Marion County",5,14,520,277,243
050,19,125,"Iowa","Marion County",5,15,528,277,251
050,19,125,"Iowa","Marion County",5,16,522,281,241
050,19,125,"Iowa","Marion County",5,17,491,248,243
050,19,125,"Iowa","Marion County",5,18,500,264,236
050,19,125,"Iowa","Marion County",5,19,567,289,278
050,19,125,"Iowa","Marion County",5,20,575,301,274
050,19,125,"Iowa","Marion County",5,21,530,268,262
050,19,125,"Iowa","Marion County",5,22,500,273,227
050,19,125,"Iowa","Marion County",5,23,400,222,178
050,19,125,"Iowa","Marion County",5,24,344,179,165
050,19,125,"Iowa","Marion County",5,25,375,213,162
050,19,125,"Iowa","Marion County",5,26,334,183,151
050,19,125,"Iowa","Marion County",5,27,334,197,137
050,19,125,"Iowa","Marion County",5,28,334,168,166
050,19,125,"Iowa","Marion County",5,29,374,190,184
050,19,125,"Iowa","Marion County",5,30,379,182,197
050,19,125,"Iowa","Marion County",5,31,374,198,176
050,19,125,"Iowa","Marion County",5,32,356,170,186
050,19,125,"Iowa","Marion County",5,33,364,190,174
050,19,125,"Iowa","Marion County",5,34,351,181,170
050,19,125,"Iowa","Marion County",5,35,368,192,176
050,19,125,"Iowa","Marion County",5,36,391,211,180
050,19,125,"Iowa","Marion County",5,37,396,215,181
050,19,125,"Iowa","Marion County",5,38,415,215,200
050,19,125,"Iowa","Marion County",5,39,406,215,191
050,19,125,"Iowa","Marion County",5,40,423,210,213
050,19,125,"Iowa","Marion County",5,41,437,226,211
050,19,125,"Iowa","Marion County",5,42,411,200,211
050,19,125,"Iowa","Marion County",5,43,414,214,200
050,19,125,"Iowa","Marion County",5,44,420,217,203
050,19,125,"Iowa","Marion County",5,45,422,212,210
050,19,125,"Iowa","Marion County",5,46,412,217,195
050,19,125,"Iowa","Marion County",5,47,382,200,182
050,19,125,"Iowa","Marion County",5,48,352,184,168
050,19,125,"Iowa","Marion County",5,49,349,180,169
050,19,125,"Iowa","Marion County",5,50,338,173,165
050,19,125,"Iowa","Marion County",5,51,383,195,188
050,19,125,"Iowa","Marion County",5,52,404,199,205
050,19,125,"Iowa","Marion County",5,53,387,199,188
050,19,125,"Iowa","Marion County",5,54,382,209,173
050,19,125,"Iowa","Marion County",5,55,373,180,193
050,19,125,"Iowa","Marion County",5,56,404,204,200
050,19,125,"Iowa","Marion County",5,57,408,214,194
050,19,125,"Iowa","Marion County",5,58,451,229,222
050,19,125,"Iowa","Marion County",5,59,466,240,226
050,19,125,"Iowa","Marion County",5,60,452,226,226
050,19,125,"Iowa","Marion County",5,61,463,240,223
050,19,125,"Iowa","Marion County",5,62,468,239,229
050,19,125,"Iowa","Marion County",5,63,452,232,220
050,19,125,"Iowa","Marion County",5,64,440,232,208
050,19,125,"Iowa","Marion County",5,65,446,234,212
050,19,125,"Iowa","Marion County",5,66,414,199,215
050,19,125,"Iowa","Marion County",5,67,374,176,198
050,19,125,"Iowa","Marion County",5,68,379,179,200
050,19,125,"Iowa","Marion County",5,69,400,193,207
050,19,125,"Iowa","Marion County",5,70,382,198,184
050,19,125,"Iowa","Marion County",5,71,369,189,180
050,19,125,"Iowa","Marion County",5,72,334,160,174
050,19,125,"Iowa","Marion County",5,73,334,162,172
050,19,125,"Iowa","Marion County",5,74,294,141,153
050,19,125,"Iowa","Marion County",5,75,290,136,154
050,19,125,"Iowa","Marion County",5,76,304,136,168
050,19,125,"Iowa","Marion County",5,77,209,97,112
050,19,125,"Iowa","Marion County",5,78,219,105,114
050,19,125,"Iowa","Marion County",5,79,225,96,129
050,19,125,"Iowa","Marion County",5,80,212,89,123
050,19,125,"Iowa","Marion County",5,81,179,65,114
050,19,125,"Iowa","Marion County",5,82,165,61,104
050,19,125,"Iowa","Marion County",5,83,137,60,77
050,19,125,"Iowa","Marion County",5,84,160,68,92
050,19,125,"Iowa","Marion County",5,85,879,303,576
050,19,127,"Iowa","Marshall County",1,0,483,251,232
050,19,127,"Iowa","Marshall County",1,1,485,257,228
050,19,127,"Iowa","Marshall County",1,2,529,269,260
050,19,127,"Iowa","Marshall County",1,3,484,251,233
050,19,127,"Iowa","Marshall County",1,4,532,264,268
050,19,127,"Iowa","Marshall County",1,5,547,280,267
050,19,127,"Iowa","Marshall County",1,6,525,269,256
050,19,127,"Iowa","Marshall County",1,7,569,284,285
050,19,127,"Iowa","Marshall County",1,8,572,287,285
050,19,127,"Iowa","Marshall County",1,9,564,294,270
050,19,127,"Iowa","Marshall County",1,10,571,292,279
050,19,127,"Iowa","Marshall County",1,11,627,317,310
050,19,127,"Iowa","Marshall County",1,12,639,331,308
050,19,127,"Iowa","Marshall County",1,13,637,343,294
050,19,127,"Iowa","Marshall County",1,14,616,345,271
050,19,127,"Iowa","Marshall County",1,15,612,331,281
050,19,127,"Iowa","Marshall County",1,16,610,294,316
050,19,127,"Iowa","Marshall County",1,17,581,295,286
050,19,127,"Iowa","Marshall County",1,18,526,275,251
050,19,127,"Iowa","Marshall County",1,19,475,261,214
050,19,127,"Iowa","Marshall County",1,20,516,293,223
050,19,127,"Iowa","Marshall County",1,21,450,238,212
050,19,127,"Iowa","Marshall County",1,22,420,231,189
050,19,127,"Iowa","Marshall County",1,23,440,220,220
050,19,127,"Iowa","Marshall County",1,24,484,264,220
050,19,127,"Iowa","Marshall County",1,25,465,261,204
050,19,127,"Iowa","Marshall County",1,26,474,249,225
050,19,127,"Iowa","Marshall County",1,27,485,256,229
050,19,127,"Iowa","Marshall County",1,28,487,260,227
050,19,127,"Iowa","Marshall County",1,29,450,224,226
050,19,127,"Iowa","Marshall County",1,30,462,235,227
050,19,127,"Iowa","Marshall County",1,31,438,234,204
050,19,127,"Iowa","Marshall County",1,32,476,233,243
050,19,127,"Iowa","Marshall County",1,33,482,223,259
050,19,127,"Iowa","Marshall County",1,34,458,233,225
050,19,127,"Iowa","Marshall County",1,35,523,277,246
050,19,127,"Iowa","Marshall County",1,36,490,247,243
050,19,127,"Iowa","Marshall County",1,37,500,251,249
050,19,127,"Iowa","Marshall County",1,38,508,270,238
050,19,127,"Iowa","Marshall County",1,39,477,254,223
050,19,127,"Iowa","Marshall County",1,40,480,259,221
050,19,127,"Iowa","Marshall County",1,41,445,226,219
050,19,127,"Iowa","Marshall County",1,42,407,208,199
050,19,127,"Iowa","Marshall County",1,43,394,218,176
050,19,127,"Iowa","Marshall County",1,44,419,219,200
050,19,127,"Iowa","Marshall County",1,45,414,212,202
050,19,127,"Iowa","Marshall County",1,46,410,211,199
050,19,127,"Iowa","Marshall County",1,47,450,233,217
050,19,127,"Iowa","Marshall County",1,48,473,242,231
050,19,127,"Iowa","Marshall County",1,49,503,257,246
050,19,127,"Iowa","Marshall County",1,50,476,244,232
050,19,127,"Iowa","Marshall County",1,51,447,232,215
050,19,127,"Iowa","Marshall County",1,52,450,235,215
050,19,127,"Iowa","Marshall County",1,53,490,259,231
050,19,127,"Iowa","Marshall County",1,54,501,256,245
050,19,127,"Iowa","Marshall County",1,55,502,248,254
050,19,127,"Iowa","Marshall County",1,56,534,281,253
050,19,127,"Iowa","Marshall County",1,57,545,272,273
050,19,127,"Iowa","Marshall County",1,58,553,280,273
050,19,127,"Iowa","Marshall County",1,59,561,296,265
050,19,127,"Iowa","Marshall County",1,60,542,270,272
050,19,127,"Iowa","Marshall County",1,61,551,253,298
050,19,127,"Iowa","Marshall County",1,62,590,282,308
050,19,127,"Iowa","Marshall County",1,63,528,262,266
050,19,127,"Iowa","Marshall County",1,64,514,270,244
050,19,127,"Iowa","Marshall County",1,65,514,270,244
050,19,127,"Iowa","Marshall County",1,66,480,238,242
050,19,127,"Iowa","Marshall County",1,67,452,219,233
050,19,127,"Iowa","Marshall County",1,68,472,227,245
050,19,127,"Iowa","Marshall County",1,69,430,214,216
050,19,127,"Iowa","Marshall County",1,70,414,221,193
050,19,127,"Iowa","Marshall County",1,71,389,187,202
050,19,127,"Iowa","Marshall County",1,72,370,170,200
050,19,127,"Iowa","Marshall County",1,73,392,181,211
050,19,127,"Iowa","Marshall County",1,74,264,133,131
050,19,127,"Iowa","Marshall County",1,75,260,131,129
050,19,127,"Iowa","Marshall County",1,76,282,143,139
050,19,127,"Iowa","Marshall County",1,77,272,122,150
050,19,127,"Iowa","Marshall County",1,78,234,120,114
050,19,127,"Iowa","Marshall County",1,79,212,98,114
050,19,127,"Iowa","Marshall County",1,80,210,88,122
050,19,127,"Iowa","Marshall County",1,81,179,76,103
050,19,127,"Iowa","Marshall County",1,82,190,85,105
050,19,127,"Iowa","Marshall County",1,83,179,78,101
050,19,127,"Iowa","Marshall County",1,84,152,67,85
050,19,127,"Iowa","Marshall County",1,85,911,322,589
050,19,127,"Iowa","Marshall County",2,0,485,250,235
050,19,127,"Iowa","Marshall County",2,1,486,256,230
050,19,127,"Iowa","Marshall County",2,2,517,264,253
050,19,127,"Iowa","Marshall County",2,3,496,254,242
050,19,127,"Iowa","Marshall County",2,4,524,262,262
050,19,127,"Iowa","Marshall County",2,5,542,274,268
050,19,127,"Iowa","Marshall County",2,6,538,276,262
050,19,127,"Iowa","Marshall County",2,7,557,277,280
050,19,127,"Iowa","Marshall County",2,8,570,285,285
050,19,127,"Iowa","Marshall County",2,9,567,293,274
050,19,127,"Iowa","Marshall County",2,10,572,293,279
050,19,127,"Iowa","Marshall County",2,11,609,310,299
050,19,127,"Iowa","Marshall County",2,12,641,331,310
050,19,127,"Iowa","Marshall County",2,13,637,340,297
050,19,127,"Iowa","Marshall County",2,14,625,347,278
050,19,127,"Iowa","Marshall County",2,15,615,335,280
050,19,127,"Iowa","Marshall County",2,16,613,305,308
050,19,127,"Iowa","Marshall County",2,17,591,295,296
050,19,127,"Iowa","Marshall County",2,18,526,275,251
050,19,127,"Iowa","Marshall County",2,19,479,261,218
050,19,127,"Iowa","Marshall County",2,20,516,292,224
050,19,127,"Iowa","Marshall County",2,21,461,248,213
050,19,127,"Iowa","Marshall County",2,22,428,231,197
050,19,127,"Iowa","Marshall County",2,23,435,220,215
050,19,127,"Iowa","Marshall County",2,24,465,249,216
050,19,127,"Iowa","Marshall County",2,25,468,260,208
050,19,127,"Iowa","Marshall County",2,26,475,254,221
050,19,127,"Iowa","Marshall County",2,27,484,257,227
050,19,127,"Iowa","Marshall County",2,28,484,259,225
050,19,127,"Iowa","Marshall County",2,29,457,230,227
050,19,127,"Iowa","Marshall County",2,30,459,232,227
050,19,127,"Iowa","Marshall County",2,31,441,233,208
050,19,127,"Iowa","Marshall County",2,32,468,234,234
050,19,127,"Iowa","Marshall County",2,33,475,223,252
050,19,127,"Iowa","Marshall County",2,34,463,230,233
050,19,127,"Iowa","Marshall County",2,35,516,272,244
050,19,127,"Iowa","Marshall County",2,36,492,251,241
050,19,127,"Iowa","Marshall County",2,37,501,252,249
050,19,127,"Iowa","Marshall County",2,38,509,266,243
050,19,127,"Iowa","Marshall County",2,39,483,257,226
050,19,127,"Iowa","Marshall County",2,40,484,261,223
050,19,127,"Iowa","Marshall County",2,41,452,232,220
050,19,127,"Iowa","Marshall County",2,42,416,212,204
050,19,127,"Iowa","Marshall County",2,43,401,218,183
050,19,127,"Iowa","Marshall County",2,44,409,218,191
050,19,127,"Iowa","Marshall County",2,45,419,215,204
050,19,127,"Iowa","Marshall County",2,46,407,209,198
050,19,127,"Iowa","Marshall County",2,47,441,227,214
050,19,127,"Iowa","Marshall County",2,48,467,241,226
050,19,127,"Iowa","Marshall County",2,49,498,255,243
050,19,127,"Iowa","Marshall County",2,50,486,249,237
050,19,127,"Iowa","Marshall County",2,51,456,236,220
050,19,127,"Iowa","Marshall County",2,52,446,232,214
050,19,127,"Iowa","Marshall County",2,53,482,255,227
050,19,127,"Iowa","Marshall County",2,54,489,251,238
050,19,127,"Iowa","Marshall County",2,55,505,251,254
050,19,127,"Iowa","Marshall County",2,56,529,274,255
050,19,127,"Iowa","Marshall County",2,57,542,275,267
050,19,127,"Iowa","Marshall County",2,58,550,280,270
050,19,127,"Iowa","Marshall County",2,59,560,291,269
050,19,127,"Iowa","Marshall County",2,60,547,277,270
050,19,127,"Iowa","Marshall County",2,61,548,259,289
050,19,127,"Iowa","Marshall County",2,62,577,275,302
050,19,127,"Iowa","Marshall County",2,63,544,267,277
050,19,127,"Iowa","Marshall County",2,64,514,265,249
050,19,127,"Iowa","Marshall County",2,65,511,267,244
050,19,127,"Iowa","Marshall County",2,66,485,243,242
050,19,127,"Iowa","Marshall County",2,67,452,219,233
050,19,127,"Iowa","Marshall County",2,68,463,225,238
050,19,127,"Iowa","Marshall County",2,69,440,217,223
050,19,127,"Iowa","Marshall County",2,70,410,213,197
050,19,127,"Iowa","Marshall County",2,71,396,197,199
050,19,127,"Iowa","Marshall County",2,72,360,165,195
050,19,127,"Iowa","Marshall County",2,73,405,188,217
050,19,127,"Iowa","Marshall County",2,74,275,134,141
050,19,127,"Iowa","Marshall County",2,75,255,127,128
050,19,127,"Iowa","Marshall County",2,76,274,139,135
050,19,127,"Iowa","Marshall County",2,77,279,131,148
050,19,127,"Iowa","Marshall County",2,78,234,115,119
050,19,127,"Iowa","Marshall County",2,79,215,103,112
050,19,127,"Iowa","Marshall County",2,80,205,89,116
050,19,127,"Iowa","Marshall County",2,81,184,77,107
050,19,127,"Iowa","Marshall County",2,82,185,82,103
050,19,127,"Iowa","Marshall County",2,83,179,77,102
050,19,127,"Iowa","Marshall County",2,84,153,67,86
050,19,127,"Iowa","Marshall County",2,85,897,317,580
050,19,127,"Iowa","Marshall County",3,0,476,246,230
050,19,127,"Iowa","Marshall County",3,1,485,259,226
050,19,127,"Iowa","Marshall County",3,2,486,257,229
050,19,127,"Iowa","Marshall County",3,3,516,261,255
050,19,127,"Iowa","Marshall County",3,4,521,272,249
050,19,127,"Iowa","Marshall County",3,5,518,266,252
050,19,127,"Iowa","Marshall County",3,6,561,283,278
050,19,127,"Iowa","Marshall County",3,7,534,272,262
050,19,127,"Iowa","Marshall County",3,8,557,281,276
050,19,127,"Iowa","Marshall County",3,9,564,281,283
050,19,127,"Iowa","Marshall County",3,10,552,277,275
050,19,127,"Iowa","Marshall County",3,11,580,294,286
050,19,127,"Iowa","Marshall County",3,12,607,313,294
050,19,127,"Iowa","Marshall County",3,13,648,336,312
050,19,127,"Iowa","Marshall County",3,14,636,330,306
050,19,127,"Iowa","Marshall County",3,15,637,346,291
050,19,127,"Iowa","Marshall County",3,16,606,326,280
050,19,127,"Iowa","Marshall County",3,17,608,305,303
050,19,127,"Iowa","Marshall County",3,18,525,268,257
050,19,127,"Iowa","Marshall County",3,19,469,247,222
050,19,127,"Iowa","Marshall County",3,20,490,269,221
050,19,127,"Iowa","Marshall County",3,21,485,262,223
050,19,127,"Iowa","Marshall County",3,22,463,256,207
050,19,127,"Iowa","Marshall County",3,23,418,227,191
050,19,127,"Iowa","Marshall County",3,24,458,220,238
050,19,127,"Iowa","Marshall County",3,25,457,246,211
050,19,127,"Iowa","Marshall County",3,26,471,262,209
050,19,127,"Iowa","Marshall County",3,27,502,272,230
050,19,127,"Iowa","Marshall County",3,28,483,255,228
050,19,127,"Iowa","Marshall County",3,29,487,264,223
050,19,127,"Iowa","Marshall County",3,30,468,233,235
050,19,127,"Iowa","Marshall County",3,31,455,237,218
050,19,127,"Iowa","Marshall County",3,32,463,249,214
050,19,127,"Iowa","Marshall County",3,33,481,246,235
050,19,127,"Iowa","Marshall County",3,34,469,215,254
050,19,127,"Iowa","Marshall County",3,35,487,246,241
050,19,127,"Iowa","Marshall County",3,36,509,265,244
050,19,127,"Iowa","Marshall County",3,37,499,257,242
050,19,127,"Iowa","Marshall County",3,38,487,249,238
050,19,127,"Iowa","Marshall County",3,39,487,250,237
050,19,127,"Iowa","Marshall County",3,40,489,264,225
050,19,127,"Iowa","Marshall County",3,41,484,267,217
050,19,127,"Iowa","Marshall County",3,42,459,245,214
050,19,127,"Iowa","Marshall County",3,43,428,220,208
050,19,127,"Iowa","Marshall County",3,44,396,217,179
050,19,127,"Iowa","Marshall County",3,45,409,226,183
050,19,127,"Iowa","Marshall County",3,46,428,215,213
050,19,127,"Iowa","Marshall County",3,47,396,209,187
050,19,127,"Iowa","Marshall County",3,48,437,225,212
050,19,127,"Iowa","Marshall County",3,49,452,228,224
050,19,127,"Iowa","Marshall County",3,50,484,240,244
050,19,127,"Iowa","Marshall County",3,51,497,255,242
050,19,127,"Iowa","Marshall County",3,52,439,227,212
050,19,127,"Iowa","Marshall County",3,53,458,241,217
050,19,127,"Iowa","Marshall County",3,54,479,253,226
050,19,127,"Iowa","Marshall County",3,55,485,250,235
050,19,127,"Iowa","Marshall County",3,56,508,260,248
050,19,127,"Iowa","Marshall County",3,57,524,271,253
050,19,127,"Iowa","Marshall County",3,58,532,272,260
050,19,127,"Iowa","Marshall County",3,59,531,267,264
050,19,127,"Iowa","Marshall County",3,60,544,284,260
050,19,127,"Iowa","Marshall County",3,61,554,281,273
050,19,127,"Iowa","Marshall County",3,62,545,261,284
050,19,127,"Iowa","Marshall County",3,63,547,256,291
050,19,127,"Iowa","Marshall County",3,64,529,257,272
050,19,127,"Iowa","Marshall County",3,65,504,258,246
050,19,127,"Iowa","Marshall County",3,66,488,252,236
050,19,127,"Iowa","Marshall County",3,67,470,235,235
050,19,127,"Iowa","Marshall County",3,68,452,225,227
050,19,127,"Iowa","Marshall County",3,69,444,212,232
050,19,127,"Iowa","Marshall County",3,70,424,203,221
050,19,127,"Iowa","Marshall County",3,71,391,202,189
050,19,127,"Iowa","Marshall County",3,72,375,179,196
050,19,127,"Iowa","Marshall County",3,73,341,154,187
050,19,127,"Iowa","Marshall County",3,74,383,177,206
050,19,127,"Iowa","Marshall County",3,75,260,124,136
050,19,127,"Iowa","Marshall County",3,76,246,122,124
050,19,127,"Iowa","Marshall County",3,77,267,135,132
050,19,127,"Iowa","Marshall County",3,78,250,112,138
050,19,127,"Iowa","Marshall County",3,79,227,113,114
050,19,127,"Iowa","Marshall County",3,80,205,96,109
050,19,127,"Iowa","Marshall County",3,81,176,69,107
050,19,127,"Iowa","Marshall County",3,82,172,73,99
050,19,127,"Iowa","Marshall County",3,83,177,75,102
050,19,127,"Iowa","Marshall County",3,84,158,68,90
050,19,127,"Iowa","Marshall County",3,85,864,307,557
050,19,127,"Iowa","Marshall County",4,0,477,248,229
050,19,127,"Iowa","Marshall County",4,1,482,257,225
050,19,127,"Iowa","Marshall County",4,2,501,265,236
050,19,127,"Iowa","Marshall County",4,3,473,254,219
050,19,127,"Iowa","Marshall County",4,4,520,263,257
050,19,127,"Iowa","Marshall County",4,5,543,281,262
050,19,127,"Iowa","Marshall County",4,6,542,278,264
050,19,127,"Iowa","Marshall County",4,7,584,282,302
050,19,127,"Iowa","Marshall County",4,8,534,266,268
050,19,127,"Iowa","Marshall County",4,9,563,274,289
050,19,127,"Iowa","Marshall County",4,10,581,292,289
050,19,127,"Iowa","Marshall County",4,11,565,290,275
050,19,127,"Iowa","Marshall County",4,12,576,290,286
050,19,127,"Iowa","Marshall County",4,13,616,312,304
050,19,127,"Iowa","Marshall County",4,14,648,334,314
050,19,127,"Iowa","Marshall County",4,15,654,335,319
050,19,127,"Iowa","Marshall County",4,16,632,330,302
050,19,127,"Iowa","Marshall County",4,17,625,335,290
050,19,127,"Iowa","Marshall County",4,18,555,292,263
050,19,127,"Iowa","Marshall County",4,19,457,235,222
050,19,127,"Iowa","Marshall County",4,20,482,253,229
050,19,127,"Iowa","Marshall County",4,21,448,241,207
050,19,127,"Iowa","Marshall County",4,22,487,260,227
050,19,127,"Iowa","Marshall County",4,23,466,254,212
050,19,127,"Iowa","Marshall County",4,24,440,240,200
050,19,127,"Iowa","Marshall County",4,25,453,225,228
050,19,127,"Iowa","Marshall County",4,26,462,246,216
050,19,127,"Iowa","Marshall County",4,27,478,255,223
050,19,127,"Iowa","Marshall County",4,28,518,283,235
050,19,127,"Iowa","Marshall County",4,29,491,269,222
050,19,127,"Iowa","Marshall County",4,30,490,253,237
050,19,127,"Iowa","Marshall County",4,31,470,228,242
050,19,127,"Iowa","Marshall County",4,32,465,238,227
050,19,127,"Iowa","Marshall County",4,33,448,252,196
050,19,127,"Iowa","Marshall County",4,34,470,237,233
050,19,127,"Iowa","Marshall County",4,35,497,232,265
050,19,127,"Iowa","Marshall County",4,36,481,237,244
050,19,127,"Iowa","Marshall County",4,37,512,275,237
050,19,127,"Iowa","Marshall County",4,38,521,271,250
050,19,127,"Iowa","Marshall County",4,39,477,242,235
050,19,127,"Iowa","Marshall County",4,40,485,246,239
050,19,127,"Iowa","Marshall County",4,41,484,259,225
050,19,127,"Iowa","Marshall County",4,42,486,267,219
050,19,127,"Iowa","Marshall County",4,43,459,248,211
050,19,127,"Iowa","Marshall County",4,44,434,220,214
050,19,127,"Iowa","Marshall County",4,45,405,222,183
050,19,127,"Iowa","Marshall County",4,46,392,216,176
050,19,127,"Iowa","Marshall County",4,47,413,205,208
050,19,127,"Iowa","Marshall County",4,48,398,213,185
050,19,127,"Iowa","Marshall County",4,49,439,224,215
050,19,127,"Iowa","Marshall County",4,50,453,224,229
050,19,127,"Iowa","Marshall County",4,51,489,245,244
050,19,127,"Iowa","Marshall County",4,52,477,241,236
050,19,127,"Iowa","Marshall County",4,53,445,233,212
050,19,127,"Iowa","Marshall County",4,54,446,232,214
050,19,127,"Iowa","Marshall County",4,55,465,245,220
050,19,127,"Iowa","Marshall County",4,56,476,249,227
050,19,127,"Iowa","Marshall County",4,57,505,259,246
050,19,127,"Iowa","Marshall County",4,58,521,270,251
050,19,127,"Iowa","Marshall County",4,59,524,263,261
050,19,127,"Iowa","Marshall County",4,60,522,269,253
050,19,127,"Iowa","Marshall County",4,61,539,281,258
050,19,127,"Iowa","Marshall County",4,62,550,280,270
050,19,127,"Iowa","Marshall County",4,63,516,238,278
050,19,127,"Iowa","Marshall County",4,64,510,229,281
050,19,127,"Iowa","Marshall County",4,65,508,246,262
050,19,127,"Iowa","Marshall County",4,66,472,240,232
050,19,127,"Iowa","Marshall County",4,67,470,236,234
050,19,127,"Iowa","Marshall County",4,68,468,239,229
050,19,127,"Iowa","Marshall County",4,69,434,216,218
050,19,127,"Iowa","Marshall County",4,70,423,196,227
050,19,127,"Iowa","Marshall County",4,71,418,203,215
050,19,127,"Iowa","Marshall County",4,72,370,182,188
050,19,127,"Iowa","Marshall County",4,73,361,173,188
050,19,127,"Iowa","Marshall County",4,74,323,149,174
050,19,127,"Iowa","Marshall County",4,75,375,173,202
050,19,127,"Iowa","Marshall County",4,76,247,115,132
050,19,127,"Iowa","Marshall County",4,77,232,118,114
050,19,127,"Iowa","Marshall County",4,78,244,123,121
050,19,127,"Iowa","Marshall County",4,79,247,112,135
050,19,127,"Iowa","Marshall County",4,80,215,105,110
050,19,127,"Iowa","Marshall County",4,81,185,83,102
050,19,127,"Iowa","Marshall County",4,82,159,58,101
050,19,127,"Iowa","Marshall County",4,83,169,70,99
050,19,127,"Iowa","Marshall County",4,84,149,59,90
050,19,127,"Iowa","Marshall County",4,85,835,308,527
050,19,127,"Iowa","Marshall County",5,0,474,247,227
050,19,127,"Iowa","Marshall County",5,1,505,253,252
050,19,127,"Iowa","Marshall County",5,2,500,267,233
050,19,127,"Iowa","Marshall County",5,3,505,264,241
050,19,127,"Iowa","Marshall County",5,4,486,259,227
050,19,127,"Iowa","Marshall County",5,5,537,268,269
050,19,127,"Iowa","Marshall County",5,6,543,275,268
050,19,127,"Iowa","Marshall County",5,7,583,281,302
050,19,127,"Iowa","Marshall County",5,8,580,282,298
050,19,127,"Iowa","Marshall County",5,9,539,267,272
050,19,127,"Iowa","Marshall County",5,10,545,270,275
050,19,127,"Iowa","Marshall County",5,11,597,303,294
050,19,127,"Iowa","Marshall County",5,12,561,293,268
050,19,127,"Iowa","Marshall County",5,13,570,287,283
050,19,127,"Iowa","Marshall County",5,14,625,306,319
050,19,127,"Iowa","Marshall County",5,15,675,332,343
050,19,127,"Iowa","Marshall County",5,16,664,319,345
050,19,127,"Iowa","Marshall County",5,17,644,332,312
050,19,127,"Iowa","Marshall County",5,18,562,311,251
050,19,127,"Iowa","Marshall County",5,19,489,259,230
050,19,127,"Iowa","Marshall County",5,20,494,253,241
050,19,127,"Iowa","Marshall County",5,21,458,235,223
050,19,127,"Iowa","Marshall County",5,22,453,230,223
050,19,127,"Iowa","Marshall County",5,23,516,277,239
050,19,127,"Iowa","Marshall County",5,24,480,258,222
050,19,127,"Iowa","Marshall County",5,25,427,244,183
050,19,127,"Iowa","Marshall County",5,26,437,217,220
050,19,127,"Iowa","Marshall County",5,27,453,255,198
050,19,127,"Iowa","Marshall County",5,28,500,263,237
050,19,127,"Iowa","Marshall County",5,29,507,274,233
050,19,127,"Iowa","Marshall County",5,30,497,268,229
050,19,127,"Iowa","Marshall County",5,31,495,260,235
050,19,127,"Iowa","Marshall County",5,32,473,230,243
050,19,127,"Iowa","Marshall County",5,33,468,249,219
050,19,127,"Iowa","Marshall County",5,34,475,261,214
050,19,127,"Iowa","Marshall County",5,35,522,254,268
050,19,127,"Iowa","Marshall County",5,36,485,221,264
050,19,127,"Iowa","Marshall County",5,37,490,251,239
050,19,127,"Iowa","Marshall County",5,38,517,276,241
050,19,127,"Iowa","Marshall County",5,39,516,270,246
050,19,127,"Iowa","Marshall County",5,40,471,237,234
050,19,127,"Iowa","Marshall County",5,41,486,241,245
050,19,127,"Iowa","Marshall County",5,42,488,260,228
050,19,127,"Iowa","Marshall County",5,43,490,265,225
050,19,127,"Iowa","Marshall County",5,44,462,250,212
050,19,127,"Iowa","Marshall County",5,45,444,230,214
050,19,127,"Iowa","Marshall County",5,46,393,210,183
050,19,127,"Iowa","Marshall County",5,47,394,216,178
050,19,127,"Iowa","Marshall County",5,48,413,207,206
050,19,127,"Iowa","Marshall County",5,49,400,211,189
050,19,127,"Iowa","Marshall County",5,50,455,229,226
050,19,127,"Iowa","Marshall County",5,51,463,235,228
050,19,127,"Iowa","Marshall County",5,52,481,238,243
050,19,127,"Iowa","Marshall County",5,53,480,247,233
050,19,127,"Iowa","Marshall County",5,54,436,226,210
050,19,127,"Iowa","Marshall County",5,55,446,232,214
050,19,127,"Iowa","Marshall County",5,56,464,246,218
050,19,127,"Iowa","Marshall County",5,57,468,244,224
050,19,127,"Iowa","Marshall County",5,58,515,271,244
050,19,127,"Iowa","Marshall County",5,59,506,254,252
050,19,127,"Iowa","Marshall County",5,60,515,261,254
050,19,127,"Iowa","Marshall County",5,61,530,268,262
050,19,127,"Iowa","Marshall County",5,62,550,283,267
050,19,127,"Iowa","Marshall County",5,63,541,267,274
050,19,127,"Iowa","Marshall County",5,64,505,229,276
050,19,127,"Iowa","Marshall County",5,65,502,225,277
050,19,127,"Iowa","Marshall County",5,66,479,231,248
050,19,127,"Iowa","Marshall County",5,67,471,238,233
050,19,127,"Iowa","Marshall County",5,68,471,242,229
050,19,127,"Iowa","Marshall County",5,69,446,224,222
050,19,127,"Iowa","Marshall County",5,70,419,204,215
050,19,127,"Iowa","Marshall County",5,71,416,198,218
050,19,127,"Iowa","Marshall County",5,72,395,187,208
050,19,127,"Iowa","Marshall County",5,73,348,169,179
050,19,127,"Iowa","Marshall County",5,74,343,169,174
050,19,127,"Iowa","Marshall County",5,75,309,144,165
050,19,127,"Iowa","Marshall County",5,76,358,162,196
050,19,127,"Iowa","Marshall County",5,77,240,112,128
050,19,127,"Iowa","Marshall County",5,78,218,108,110
050,19,127,"Iowa","Marshall County",5,79,241,123,118
050,19,127,"Iowa","Marshall County",5,80,231,102,129
050,19,127,"Iowa","Marshall County",5,81,196,92,104
050,19,127,"Iowa","Marshall County",5,82,170,73,97
050,19,127,"Iowa","Marshall County",5,83,156,55,101
050,19,127,"Iowa","Marshall County",5,84,145,56,89
050,19,127,"Iowa","Marshall County",5,85,817,309,508
050,19,129,"Iowa","Mills County",1,0,131,68,63
050,19,129,"Iowa","Mills County",1,1,135,70,65
050,19,129,"Iowa","Mills County",1,2,147,80,67
050,19,129,"Iowa","Mills County",1,3,145,77,68
050,19,129,"Iowa","Mills County",1,4,171,89,82
050,19,129,"Iowa","Mills County",1,5,201,96,105
050,19,129,"Iowa","Mills County",1,6,177,96,81
050,19,129,"Iowa","Mills County",1,7,199,115,84
050,19,129,"Iowa","Mills County",1,8,192,98,94
050,19,129,"Iowa","Mills County",1,9,198,97,101
050,19,129,"Iowa","Mills County",1,10,210,95,115
050,19,129,"Iowa","Mills County",1,11,222,113,109
050,19,129,"Iowa","Mills County",1,12,215,107,108
050,19,129,"Iowa","Mills County",1,13,194,99,95
050,19,129,"Iowa","Mills County",1,14,215,117,98
050,19,129,"Iowa","Mills County",1,15,206,107,99
050,19,129,"Iowa","Mills County",1,16,223,113,110
050,19,129,"Iowa","Mills County",1,17,200,111,89
050,19,129,"Iowa","Mills County",1,18,179,100,79
050,19,129,"Iowa","Mills County",1,19,139,72,67
050,19,129,"Iowa","Mills County",1,20,130,71,59
050,19,129,"Iowa","Mills County",1,21,131,67,64
050,19,129,"Iowa","Mills County",1,22,132,61,71
050,19,129,"Iowa","Mills County",1,23,144,76,68
050,19,129,"Iowa","Mills County",1,24,154,74,80
050,19,129,"Iowa","Mills County",1,25,146,74,72
050,19,129,"Iowa","Mills County",1,26,135,72,63
050,19,129,"Iowa","Mills County",1,27,141,66,75
050,19,129,"Iowa","Mills County",1,28,141,69,72
050,19,129,"Iowa","Mills County",1,29,135,61,74
050,19,129,"Iowa","Mills County",1,30,142,67,75
050,19,129,"Iowa","Mills County",1,31,125,55,70
050,19,129,"Iowa","Mills County",1,32,131,64,67
050,19,129,"Iowa","Mills County",1,33,140,69,71
050,19,129,"Iowa","Mills County",1,34,154,75,79
050,19,129,"Iowa","Mills County",1,35,177,92,85
050,19,129,"Iowa","Mills County",1,36,170,88,82
050,19,129,"Iowa","Mills County",1,37,177,93,84
050,19,129,"Iowa","Mills County",1,38,183,94,89
050,19,129,"Iowa","Mills County",1,39,182,85,97
050,19,129,"Iowa","Mills County",1,40,177,90,87
050,19,129,"Iowa","Mills County",1,41,182,91,91
050,19,129,"Iowa","Mills County",1,42,161,76,85
050,19,129,"Iowa","Mills County",1,43,196,99,97
050,19,129,"Iowa","Mills County",1,44,195,101,94
050,19,129,"Iowa","Mills County",1,45,177,93,84
050,19,129,"Iowa","Mills County",1,46,177,103,74
050,19,129,"Iowa","Mills County",1,47,167,88,79
050,19,129,"Iowa","Mills County",1,48,198,96,102
050,19,129,"Iowa","Mills County",1,49,223,107,116
050,19,129,"Iowa","Mills County",1,50,210,106,104
050,19,129,"Iowa","Mills County",1,51,189,89,100
050,19,129,"Iowa","Mills County",1,52,188,94,94
050,19,129,"Iowa","Mills County",1,53,177,79,98
050,19,129,"Iowa","Mills County",1,54,195,88,107
050,19,129,"Iowa","Mills County",1,55,213,106,107
050,19,129,"Iowa","Mills County",1,56,210,107,103
050,19,129,"Iowa","Mills County",1,57,230,130,100
050,19,129,"Iowa","Mills County",1,58,218,110,108
050,19,129,"Iowa","Mills County",1,59,230,111,119
050,19,129,"Iowa","Mills County",1,60,241,121,120
050,19,129,"Iowa","Mills County",1,61,211,103,108
050,19,129,"Iowa","Mills County",1,62,214,109,105
050,19,129,"Iowa","Mills County",1,63,209,107,102
050,19,129,"Iowa","Mills County",1,64,213,112,101
050,19,129,"Iowa","Mills County",1,65,219,115,104
050,19,129,"Iowa","Mills County",1,66,214,104,110
050,19,129,"Iowa","Mills County",1,67,189,88,101
050,19,129,"Iowa","Mills County",1,68,194,97,97
050,19,129,"Iowa","Mills County",1,69,182,88,94
050,19,129,"Iowa","Mills County",1,70,193,93,100
050,19,129,"Iowa","Mills County",1,71,159,78,81
050,19,129,"Iowa","Mills County",1,72,166,76,90
050,19,129,"Iowa","Mills County",1,73,167,81,86
050,19,129,"Iowa","Mills County",1,74,118,60,58
050,19,129,"Iowa","Mills County",1,75,115,63,52
050,19,129,"Iowa","Mills County",1,76,94,48,46
050,19,129,"Iowa","Mills County",1,77,82,46,36
050,19,129,"Iowa","Mills County",1,78,72,35,37
050,19,129,"Iowa","Mills County",1,79,63,27,36
050,19,129,"Iowa","Mills County",1,80,69,31,38
050,19,129,"Iowa","Mills County",1,81,69,34,35
050,19,129,"Iowa","Mills County",1,82,52,29,23
050,19,129,"Iowa","Mills County",1,83,57,26,31
050,19,129,"Iowa","Mills County",1,84,51,25,26
050,19,129,"Iowa","Mills County",1,85,288,112,176
050,19,129,"Iowa","Mills County",2,0,130,69,61
050,19,129,"Iowa","Mills County",2,1,133,69,64
050,19,129,"Iowa","Mills County",2,2,143,78,65
050,19,129,"Iowa","Mills County",2,3,148,79,69
050,19,129,"Iowa","Mills County",2,4,164,85,79
050,19,129,"Iowa","Mills County",2,5,191,94,97
050,19,129,"Iowa","Mills County",2,6,186,98,88
050,19,129,"Iowa","Mills County",2,7,193,109,84
050,19,129,"Iowa","Mills County",2,8,191,100,91
050,19,129,"Iowa","Mills County",2,9,197,97,100
050,19,129,"Iowa","Mills County",2,10,206,95,111
050,19,129,"Iowa","Mills County",2,11,217,107,110
050,19,129,"Iowa","Mills County",2,12,216,109,107
050,19,129,"Iowa","Mills County",2,13,199,101,98
050,19,129,"Iowa","Mills County",2,14,209,111,98
050,19,129,"Iowa","Mills County",2,15,208,108,100
050,19,129,"Iowa","Mills County",2,16,217,110,107
050,19,129,"Iowa","Mills County",2,17,205,111,94
050,19,129,"Iowa","Mills County",2,18,172,97,75
050,19,129,"Iowa","Mills County",2,19,140,74,66
050,19,129,"Iowa","Mills County",2,20,130,70,60
050,19,129,"Iowa","Mills County",2,21,131,69,62
050,19,129,"Iowa","Mills County",2,22,132,63,69
050,19,129,"Iowa","Mills County",2,23,143,72,71
050,19,129,"Iowa","Mills County",2,24,151,75,76
050,19,129,"Iowa","Mills County",2,25,147,74,73
050,19,129,"Iowa","Mills County",2,26,135,71,64
050,19,129,"Iowa","Mills County",2,27,139,67,72
050,19,129,"Iowa","Mills County",2,28,138,67,71
050,19,129,"Iowa","Mills County",2,29,137,63,74
050,19,129,"Iowa","Mills County",2,30,140,65,75
050,19,129,"Iowa","Mills County",2,31,127,56,71
050,19,129,"Iowa","Mills County",2,32,130,62,68
050,19,129,"Iowa","Mills County",2,33,137,68,69
050,19,129,"Iowa","Mills County",2,34,150,73,77
050,19,129,"Iowa","Mills County",2,35,173,89,84
050,19,129,"Iowa","Mills County",2,36,172,90,82
050,19,129,"Iowa","Mills County",2,37,175,92,83
050,19,129,"Iowa","Mills County",2,38,182,95,87
050,19,129,"Iowa","Mills County",2,39,179,85,94
050,19,129,"Iowa","Mills County",2,40,178,89,89
050,19,129,"Iowa","Mills County",2,41,178,90,88
050,19,129,"Iowa","Mills County",2,42,168,80,88
050,19,129,"Iowa","Mills County",2,43,187,92,95
050,19,129,"Iowa","Mills County",2,44,195,101,94
050,19,129,"Iowa","Mills County",2,45,182,95,87
050,19,129,"Iowa","Mills County",2,46,178,101,77
050,19,129,"Iowa","Mills County",2,47,167,90,77
050,19,129,"Iowa","Mills County",2,48,190,94,96
050,19,129,"Iowa","Mills County",2,49,219,105,114
050,19,129,"Iowa","Mills County",2,50,210,104,106
050,19,129,"Iowa","Mills County",2,51,193,92,101
050,19,129,"Iowa","Mills County",2,52,187,92,95
050,19,129,"Iowa","Mills County",2,53,177,82,95
050,19,129,"Iowa","Mills County",2,54,190,86,104
050,19,129,"Iowa","Mills County",2,55,204,99,105
050,19,129,"Iowa","Mills County",2,56,210,105,105
050,19,129,"Iowa","Mills County",2,57,227,127,100
050,19,129,"Iowa","Mills County",2,58,215,111,104
050,19,129,"Iowa","Mills County",2,59,227,110,117
050,19,129,"Iowa","Mills County",2,60,237,117,120
050,19,129,"Iowa","Mills County",2,61,216,105,111
050,19,129,"Iowa","Mills County",2,62,212,108,104
050,19,129,"Iowa","Mills County",2,63,213,109,104
050,19,129,"Iowa","Mills County",2,64,208,108,100
050,19,129,"Iowa","Mills County",2,65,215,113,102
050,19,129,"Iowa","Mills County",2,66,211,104,107
050,19,129,"Iowa","Mills County",2,67,192,90,102
050,19,129,"Iowa","Mills County",2,68,190,94,96
050,19,129,"Iowa","Mills County",2,69,186,90,96
050,19,129,"Iowa","Mills County",2,70,187,90,97
050,19,129,"Iowa","Mills County",2,71,167,81,86
050,19,129,"Iowa","Mills County",2,72,162,76,86
050,19,129,"Iowa","Mills County",2,73,173,83,90
050,19,129,"Iowa","Mills County",2,74,121,61,60
050,19,129,"Iowa","Mills County",2,75,114,61,53
050,19,129,"Iowa","Mills County",2,76,97,51,46
050,19,129,"Iowa","Mills County",2,77,87,47,40
050,19,129,"Iowa","Mills County",2,78,72,37,35
050,19,129,"Iowa","Mills County",2,79,65,29,36
050,19,129,"Iowa","Mills County",2,80,62,27,35
050,19,129,"Iowa","Mills County",2,81,67,33,34
050,19,129,"Iowa","Mills County",2,82,55,29,26
050,19,129,"Iowa","Mills County",2,83,51,24,27
050,19,129,"Iowa","Mills County",2,84,51,25,26
050,19,129,"Iowa","Mills County",2,85,292,113,179
050,19,129,"Iowa","Mills County",3,0,135,65,70
050,19,129,"Iowa","Mills County",3,1,124,72,52
050,19,129,"Iowa","Mills County",3,2,136,66,70
050,19,129,"Iowa","Mills County",3,3,158,83,75
050,19,129,"Iowa","Mills County",3,4,159,85,74
050,19,129,"Iowa","Mills County",3,5,176,95,81
050,19,129,"Iowa","Mills County",3,6,196,99,97
050,19,129,"Iowa","Mills County",3,7,196,112,84
050,19,129,"Iowa","Mills County",3,8,193,105,88
050,19,129,"Iowa","Mills County",3,9,185,96,89
050,19,129,"Iowa","Mills County",3,10,191,90,101
050,19,129,"Iowa","Mills County",3,11,208,96,112
050,19,129,"Iowa","Mills County",3,12,214,106,108
050,19,129,"Iowa","Mills County",3,13,220,113,107
050,19,129,"Iowa","Mills County",3,14,198,100,98
050,19,129,"Iowa","Mills County",3,15,213,110,103
050,19,129,"Iowa","Mills County",3,16,205,106,99
050,19,129,"Iowa","Mills County",3,17,232,120,112
050,19,129,"Iowa","Mills County",3,18,181,102,79
050,19,129,"Iowa","Mills County",3,19,137,74,63
050,19,129,"Iowa","Mills County",3,20,144,79,65
050,19,129,"Iowa","Mills County",3,21,124,67,57
050,19,129,"Iowa","Mills County",3,22,140,80,60
050,19,129,"Iowa","Mills County",3,23,134,60,74
050,19,129,"Iowa","Mills County",3,24,138,68,70
050,19,129,"Iowa","Mills County",3,25,150,77,73
050,19,129,"Iowa","Mills County",3,26,144,75,69
050,19,129,"Iowa","Mills County",3,27,139,67,72
050,19,129,"Iowa","Mills County",3,28,131,65,66
050,19,129,"Iowa","Mills County",3,29,151,70,81
050,19,129,"Iowa","Mills County",3,30,144,67,77
050,19,129,"Iowa","Mills County",3,31,134,64,70
050,19,129,"Iowa","Mills County",3,32,139,64,75
050,19,129,"Iowa","Mills County",3,33,147,73,74
050,19,129,"Iowa","Mills County",3,34,138,65,73
050,19,129,"Iowa","Mills County",3,35,157,82,75
050,19,129,"Iowa","Mills County",3,36,185,97,88
050,19,129,"Iowa","Mills County",3,37,168,85,83
050,19,129,"Iowa","Mills County",3,38,177,92,85
050,19,129,"Iowa","Mills County",3,39,180,94,86
050,19,129,"Iowa","Mills County",3,40,181,89,92
050,19,129,"Iowa","Mills County",3,41,187,92,95
050,19,129,"Iowa","Mills County",3,42,187,95,92
050,19,129,"Iowa","Mills County",3,43,166,77,89
050,19,129,"Iowa","Mills County",3,44,194,96,98
050,19,129,"Iowa","Mills County",3,45,186,97,89
050,19,129,"Iowa","Mills County",3,46,200,107,93
050,19,129,"Iowa","Mills County",3,47,178,100,78
050,19,129,"Iowa","Mills County",3,48,164,89,75
050,19,129,"Iowa","Mills County",3,49,183,92,91
050,19,129,"Iowa","Mills County",3,50,210,102,108
050,19,129,"Iowa","Mills County",3,51,211,102,109
050,19,129,"Iowa","Mills County",3,52,199,98,101
050,19,129,"Iowa","Mills County",3,53,183,91,92
050,19,129,"Iowa","Mills County",3,54,187,82,105
050,19,129,"Iowa","Mills County",3,55,181,85,96
050,19,129,"Iowa","Mills County",3,56,206,98,108
050,19,129,"Iowa","Mills County",3,57,214,114,100
050,19,129,"Iowa","Mills County",3,58,215,116,99
050,19,129,"Iowa","Mills County",3,59,214,111,103
050,19,129,"Iowa","Mills County",3,60,224,106,118
050,19,129,"Iowa","Mills County",3,61,234,116,118
050,19,129,"Iowa","Mills County",3,62,211,105,106
050,19,129,"Iowa","Mills County",3,63,222,114,108
050,19,129,"Iowa","Mills County",3,64,213,108,105
050,19,129,"Iowa","Mills County",3,65,205,106,99
050,19,129,"Iowa","Mills County",3,66,217,109,108
050,19,129,"Iowa","Mills County",3,67,209,103,106
050,19,129,"Iowa","Mills County",3,68,183,84,99
050,19,129,"Iowa","Mills County",3,69,181,90,91
050,19,129,"Iowa","Mills County",3,70,184,90,94
050,19,129,"Iowa","Mills County",3,71,180,85,95
050,19,129,"Iowa","Mills County",3,72,159,77,82
050,19,129,"Iowa","Mills County",3,73,155,72,83
050,19,129,"Iowa","Mills County",3,74,170,82,88
050,19,129,"Iowa","Mills County",3,75,120,60,60
050,19,129,"Iowa","Mills County",3,76,107,58,49
050,19,129,"Iowa","Mills County",3,77,96,50,46
050,19,129,"Iowa","Mills County",3,78,85,46,39
050,19,129,"Iowa","Mills County",3,79,73,37,36
050,19,129,"Iowa","Mills County",3,80,59,24,35
050,19,129,"Iowa","Mills County",3,81,59,28,31
050,19,129,"Iowa","Mills County",3,82,61,27,34
050,19,129,"Iowa","Mills County",3,83,54,27,27
050,19,129,"Iowa","Mills County",3,84,47,23,24
050,19,129,"Iowa","Mills County",3,85,292,117,175
050,19,129,"Iowa","Mills County",4,0,131,66,65
050,19,129,"Iowa","Mills County",4,1,151,71,80
050,19,129,"Iowa","Mills County",4,2,137,79,58
050,19,129,"Iowa","Mills County",4,3,139,67,72
050,19,129,"Iowa","Mills County",4,4,181,100,81
050,19,129,"Iowa","Mills County",4,5,159,79,80
050,19,129,"Iowa","Mills County",4,6,177,93,84
050,19,129,"Iowa","Mills County",4,7,194,94,100
050,19,129,"Iowa","Mills County",4,8,200,120,80
050,19,129,"Iowa","Mills County",4,9,188,103,85
050,19,129,"Iowa","Mills County",4,10,192,100,92
050,19,129,"Iowa","Mills County",4,11,190,94,96
050,19,129,"Iowa","Mills County",4,12,210,102,108
050,19,129,"Iowa","Mills County",4,13,215,105,110
050,19,129,"Iowa","Mills County",4,14,221,114,107
050,19,129,"Iowa","Mills County",4,15,200,105,95
050,19,129,"Iowa","Mills County",4,16,220,111,109
050,19,129,"Iowa","Mills County",4,17,203,105,98
050,19,129,"Iowa","Mills County",4,18,187,98,89
050,19,129,"Iowa","Mills County",4,19,131,71,60
050,19,129,"Iowa","Mills County",4,20,137,80,57
050,19,129,"Iowa","Mills County",4,21,152,78,74
050,19,129,"Iowa","Mills County",4,22,124,67,57
050,19,129,"Iowa","Mills County",4,23,144,81,63
050,19,129,"Iowa","Mills County",4,24,137,59,78
050,19,129,"Iowa","Mills County",4,25,141,65,76
050,19,129,"Iowa","Mills County",4,26,136,73,63
050,19,129,"Iowa","Mills County",4,27,157,77,80
050,19,129,"Iowa","Mills County",4,28,133,65,68
050,19,129,"Iowa","Mills County",4,29,154,78,76
050,19,129,"Iowa","Mills County",4,30,153,69,84
050,19,129,"Iowa","Mills County",4,31,144,63,81
050,19,129,"Iowa","Mills County",4,32,149,71,78
050,19,129,"Iowa","Mills County",4,33,141,67,74
050,19,129,"Iowa","Mills County",4,34,156,79,77
050,19,129,"Iowa","Mills County",4,35,147,75,72
050,19,129,"Iowa","Mills County",4,36,168,91,77
050,19,129,"Iowa","Mills County",4,37,181,95,86
050,19,129,"Iowa","Mills County",4,38,175,89,86
050,19,129,"Iowa","Mills County",4,39,180,93,87
050,19,129,"Iowa","Mills County",4,40,187,102,85
050,19,129,"Iowa","Mills County",4,41,186,89,97
050,19,129,"Iowa","Mills County",4,42,195,94,101
050,19,129,"Iowa","Mills County",4,43,194,98,96
050,19,129,"Iowa","Mills County",4,44,164,79,85
050,19,129,"Iowa","Mills County",4,45,190,93,97
050,19,129,"Iowa","Mills County",4,46,186,98,88
050,19,129,"Iowa","Mills County",4,47,199,100,99
050,19,129,"Iowa","Mills County",4,48,175,100,75
050,19,129,"Iowa","Mills County",4,49,171,94,77
050,19,129,"Iowa","Mills County",4,50,188,96,92
050,19,129,"Iowa","Mills County",4,51,209,101,108
050,19,129,"Iowa","Mills County",4,52,207,98,109
050,19,129,"Iowa","Mills County",4,53,199,101,98
050,19,129,"Iowa","Mills County",4,54,185,88,97
050,19,129,"Iowa","Mills County",4,55,185,82,103
050,19,129,"Iowa","Mills County",4,56,174,79,95
050,19,129,"Iowa","Mills County",4,57,214,111,103
050,19,129,"Iowa","Mills County",4,58,208,108,100
050,19,129,"Iowa","Mills County",4,59,205,109,96
050,19,129,"Iowa","Mills County",4,60,219,116,103
050,19,129,"Iowa","Mills County",4,61,214,99,115
050,19,129,"Iowa","Mills County",4,62,234,116,118
050,19,129,"Iowa","Mills County",4,63,212,104,108
050,19,129,"Iowa","Mills County",4,64,221,113,108
050,19,129,"Iowa","Mills County",4,65,213,110,103
050,19,129,"Iowa","Mills County",4,66,194,99,95
050,19,129,"Iowa","Mills County",4,67,209,108,101
050,19,129,"Iowa","Mills County",4,68,201,92,109
050,19,129,"Iowa","Mills County",4,69,178,80,98
050,19,129,"Iowa","Mills County",4,70,176,87,89
050,19,129,"Iowa","Mills County",4,71,176,85,91
050,19,129,"Iowa","Mills County",4,72,181,85,96
050,19,129,"Iowa","Mills County",4,73,155,74,81
050,19,129,"Iowa","Mills County",4,74,150,70,80
050,19,129,"Iowa","Mills County",4,75,172,84,88
050,19,129,"Iowa","Mills County",4,76,117,59,58
050,19,129,"Iowa","Mills County",4,77,103,53,50
050,19,129,"Iowa","Mills County",4,78,93,47,46
050,19,129,"Iowa","Mills County",4,79,90,48,42
050,19,129,"Iowa","Mills County",4,80,64,31,33
050,19,129,"Iowa","Mills County",4,81,55,23,32
050,19,129,"Iowa","Mills County",4,82,52,21,31
050,19,129,"Iowa","Mills County",4,83,61,26,35
050,19,129,"Iowa","Mills County",4,84,46,24,22
050,19,129,"Iowa","Mills County",4,85,293,118,175
050,19,129,"Iowa","Mills County",5,0,123,66,57
050,19,129,"Iowa","Mills County",5,1,148,70,78
050,19,129,"Iowa","Mills County",5,2,152,70,82
050,19,129,"Iowa","Mills County",5,3,143,77,66
050,19,129,"Iowa","Mills County",5,4,150,70,80
050,19,129,"Iowa","Mills County",5,5,188,105,83
050,19,129,"Iowa","Mills County",5,6,168,86,82
050,19,129,"Iowa","Mills County",5,7,182,96,86
050,19,129,"Iowa","Mills County",5,8,204,100,104
050,19,129,"Iowa","Mills County",5,9,203,120,83
050,19,129,"Iowa","Mills County",5,10,190,101,89
050,19,129,"Iowa","Mills County",5,11,197,104,93
050,19,129,"Iowa","Mills County",5,12,198,98,100
050,19,129,"Iowa","Mills County",5,13,206,100,106
050,19,129,"Iowa","Mills County",5,14,217,109,108
050,19,129,"Iowa","Mills County",5,15,225,114,111
050,19,129,"Iowa","Mills County",5,16,203,107,96
050,19,129,"Iowa","Mills County",5,17,211,109,102
050,19,129,"Iowa","Mills County",5,18,166,88,78
050,19,129,"Iowa","Mills County",5,19,141,77,64
050,19,129,"Iowa","Mills County",5,20,137,74,63
050,19,129,"Iowa","Mills County",5,21,135,75,60
050,19,129,"Iowa","Mills County",5,22,160,84,76
050,19,129,"Iowa","Mills County",5,23,126,67,59
050,19,129,"Iowa","Mills County",5,24,154,87,67
050,19,129,"Iowa","Mills County",5,25,140,64,76
050,19,129,"Iowa","Mills County",5,26,141,68,73
050,19,129,"Iowa","Mills County",5,27,140,71,69
050,19,129,"Iowa","Mills County",5,28,154,80,74
050,19,129,"Iowa","Mills County",5,29,144,72,72
050,19,129,"Iowa","Mills County",5,30,173,85,88
050,19,129,"Iowa","Mills County",5,31,157,71,86
050,19,129,"Iowa","Mills County",5,32,149,67,82
050,19,129,"Iowa","Mills County",5,33,161,77,84
050,19,129,"Iowa","Mills County",5,34,155,71,84
050,19,129,"Iowa","Mills County",5,35,167,87,80
050,19,129,"Iowa","Mills County",5,36,149,73,76
050,19,129,"Iowa","Mills County",5,37,176,94,82
050,19,129,"Iowa","Mills County",5,38,189,101,88
050,19,129,"Iowa","Mills County",5,39,176,89,87
050,19,129,"Iowa","Mills County",5,40,198,106,92
050,19,129,"Iowa","Mills County",5,41,190,104,86
050,19,129,"Iowa","Mills County",5,42,188,90,98
050,19,129,"Iowa","Mills County",5,43,189,90,99
050,19,129,"Iowa","Mills County",5,44,198,102,96
050,19,129,"Iowa","Mills County",5,45,157,78,79
050,19,129,"Iowa","Mills County",5,46,196,96,100
050,19,129,"Iowa","Mills County",5,47,189,93,96
050,19,129,"Iowa","Mills County",5,48,199,104,95
050,19,129,"Iowa","Mills County",5,49,177,102,75
050,19,129,"Iowa","Mills County",5,50,161,93,68
050,19,129,"Iowa","Mills County",5,51,199,102,97
050,19,129,"Iowa","Mills County",5,52,212,102,110
050,19,129,"Iowa","Mills County",5,53,209,104,105
050,19,129,"Iowa","Mills County",5,54,202,94,108
050,19,129,"Iowa","Mills County",5,55,173,87,86
050,19,129,"Iowa","Mills County",5,56,176,73,103
050,19,129,"Iowa","Mills County",5,57,179,88,91
050,19,129,"Iowa","Mills County",5,58,200,99,101
050,19,129,"Iowa","Mills County",5,59,207,109,98
050,19,129,"Iowa","Mills County",5,60,207,113,94
050,19,129,"Iowa","Mills County",5,61,218,107,111
050,19,129,"Iowa","Mills County",5,62,205,98,107
050,19,129,"Iowa","Mills County",5,63,238,117,121
050,19,129,"Iowa","Mills County",5,64,209,101,108
050,19,129,"Iowa","Mills County",5,65,219,113,106
050,19,129,"Iowa","Mills County",5,66,204,107,97
050,19,129,"Iowa","Mills County",5,67,184,95,89
050,19,129,"Iowa","Mills County",5,68,202,100,102
050,19,129,"Iowa","Mills County",5,69,195,88,107
050,19,129,"Iowa","Mills County",5,70,175,79,96
050,19,129,"Iowa","Mills County",5,71,168,82,86
050,19,129,"Iowa","Mills County",5,72,178,86,92
050,19,129,"Iowa","Mills County",5,73,178,82,96
050,19,129,"Iowa","Mills County",5,74,153,72,81
050,19,129,"Iowa","Mills County",5,75,149,70,79
050,19,129,"Iowa","Mills County",5,76,167,81,86
050,19,129,"Iowa","Mills County",5,77,112,55,57
050,19,129,"Iowa","Mills County",5,78,100,53,47
050,19,129,"Iowa","Mills County",5,79,92,47,45
050,19,129,"Iowa","Mills County",5,80,79,40,39
050,19,129,"Iowa","Mills County",5,81,59,33,26
050,19,129,"Iowa","Mills County",5,82,48,16,32
050,19,129,"Iowa","Mills County",5,83,48,19,29
050,19,129,"Iowa","Mills County",5,84,53,22,31
050,19,129,"Iowa","Mills County",5,85,296,115,181
050,19,131,"Iowa","Mitchell County",1,0,126,64,62
050,19,131,"Iowa","Mitchell County",1,1,120,57,63
050,19,131,"Iowa","Mitchell County",1,2,123,61,62
050,19,131,"Iowa","Mitchell County",1,3,117,57,60
050,19,131,"Iowa","Mitchell County",1,4,144,58,86
050,19,131,"Iowa","Mitchell County",1,5,136,70,66
050,19,131,"Iowa","Mitchell County",1,6,140,69,71
050,19,131,"Iowa","Mitchell County",1,7,140,75,65
050,19,131,"Iowa","Mitchell County",1,8,132,77,55
050,19,131,"Iowa","Mitchell County",1,9,137,71,66
050,19,131,"Iowa","Mitchell County",1,10,146,78,68
050,19,131,"Iowa","Mitchell County",1,11,147,76,71
050,19,131,"Iowa","Mitchell County",1,12,160,90,70
050,19,131,"Iowa","Mitchell County",1,13,154,81,73
050,19,131,"Iowa","Mitchell County",1,14,155,84,71
050,19,131,"Iowa","Mitchell County",1,15,155,82,73
050,19,131,"Iowa","Mitchell County",1,16,153,73,80
050,19,131,"Iowa","Mitchell County",1,17,150,68,82
050,19,131,"Iowa","Mitchell County",1,18,134,70,64
050,19,131,"Iowa","Mitchell County",1,19,103,54,49
050,19,131,"Iowa","Mitchell County",1,20,111,58,53
050,19,131,"Iowa","Mitchell County",1,21,108,59,49
050,19,131,"Iowa","Mitchell County",1,22,111,59,52
050,19,131,"Iowa","Mitchell County",1,23,111,58,53
050,19,131,"Iowa","Mitchell County",1,24,108,67,41
050,19,131,"Iowa","Mitchell County",1,25,116,57,59
050,19,131,"Iowa","Mitchell County",1,26,111,63,48
050,19,131,"Iowa","Mitchell County",1,27,117,61,56
050,19,131,"Iowa","Mitchell County",1,28,115,63,52
050,19,131,"Iowa","Mitchell County",1,29,118,60,58
050,19,131,"Iowa","Mitchell County",1,30,116,58,58
050,19,131,"Iowa","Mitchell County",1,31,107,54,53
050,19,131,"Iowa","Mitchell County",1,32,95,44,51
050,19,131,"Iowa","Mitchell County",1,33,111,54,57
050,19,131,"Iowa","Mitchell County",1,34,98,51,47
050,19,131,"Iowa","Mitchell County",1,35,105,57,48
050,19,131,"Iowa","Mitchell County",1,36,115,55,60
050,19,131,"Iowa","Mitchell County",1,37,124,63,61
050,19,131,"Iowa","Mitchell County",1,38,132,65,67
050,19,131,"Iowa","Mitchell County",1,39,127,61,66
050,19,131,"Iowa","Mitchell County",1,40,114,56,58
050,19,131,"Iowa","Mitchell County",1,41,103,55,48
050,19,131,"Iowa","Mitchell County",1,42,108,61,47
050,19,131,"Iowa","Mitchell County",1,43,110,55,55
050,19,131,"Iowa","Mitchell County",1,44,99,49,50
050,19,131,"Iowa","Mitchell County",1,45,118,64,54
050,19,131,"Iowa","Mitchell County",1,46,100,54,46
050,19,131,"Iowa","Mitchell County",1,47,98,51,47
050,19,131,"Iowa","Mitchell County",1,48,114,58,56
050,19,131,"Iowa","Mitchell County",1,49,119,60,59
050,19,131,"Iowa","Mitchell County",1,50,117,60,57
050,19,131,"Iowa","Mitchell County",1,51,122,60,62
050,19,131,"Iowa","Mitchell County",1,52,118,57,61
050,19,131,"Iowa","Mitchell County",1,53,124,57,67
050,19,131,"Iowa","Mitchell County",1,54,125,56,69
050,19,131,"Iowa","Mitchell County",1,55,156,78,78
050,19,131,"Iowa","Mitchell County",1,56,177,86,91
050,19,131,"Iowa","Mitchell County",1,57,170,89,81
050,19,131,"Iowa","Mitchell County",1,58,176,95,81
050,19,131,"Iowa","Mitchell County",1,59,174,87,87
050,19,131,"Iowa","Mitchell County",1,60,158,81,77
050,19,131,"Iowa","Mitchell County",1,61,167,87,80
050,19,131,"Iowa","Mitchell County",1,62,149,81,68
050,19,131,"Iowa","Mitchell County",1,63,154,80,74
050,19,131,"Iowa","Mitchell County",1,64,150,80,70
050,19,131,"Iowa","Mitchell County",1,65,139,72,67
050,19,131,"Iowa","Mitchell County",1,66,135,73,62
050,19,131,"Iowa","Mitchell County",1,67,130,66,64
050,19,131,"Iowa","Mitchell County",1,68,123,61,62
050,19,131,"Iowa","Mitchell County",1,69,116,56,60
050,19,131,"Iowa","Mitchell County",1,70,108,54,54
050,19,131,"Iowa","Mitchell County",1,71,105,55,50
050,19,131,"Iowa","Mitchell County",1,72,95,46,49
050,19,131,"Iowa","Mitchell County",1,73,97,45,52
050,19,131,"Iowa","Mitchell County",1,74,65,27,38
050,19,131,"Iowa","Mitchell County",1,75,77,36,41
050,19,131,"Iowa","Mitchell County",1,76,80,36,44
050,19,131,"Iowa","Mitchell County",1,77,79,36,43
050,19,131,"Iowa","Mitchell County",1,78,76,34,42
050,19,131,"Iowa","Mitchell County",1,79,72,34,38
050,19,131,"Iowa","Mitchell County",1,80,60,30,30
050,19,131,"Iowa","Mitchell County",1,81,66,29,37
050,19,131,"Iowa","Mitchell County",1,82,52,23,29
050,19,131,"Iowa","Mitchell County",1,83,74,36,38
050,19,131,"Iowa","Mitchell County",1,84,56,24,32
050,19,131,"Iowa","Mitchell County",1,85,417,132,285
050,19,131,"Iowa","Mitchell County",2,0,128,63,65
050,19,131,"Iowa","Mitchell County",2,1,120,58,62
050,19,131,"Iowa","Mitchell County",2,2,122,60,62
050,19,131,"Iowa","Mitchell County",2,3,119,58,61
050,19,131,"Iowa","Mitchell County",2,4,138,59,79
050,19,131,"Iowa","Mitchell County",2,5,138,67,71
050,19,131,"Iowa","Mitchell County",2,6,142,72,70
050,19,131,"Iowa","Mitchell County",2,7,141,74,67
050,19,131,"Iowa","Mitchell County",2,8,133,76,57
050,19,131,"Iowa","Mitchell County",2,9,136,72,64
050,19,131,"Iowa","Mitchell County",2,10,144,76,68
050,19,131,"Iowa","Mitchell County",2,11,148,78,70
050,19,131,"Iowa","Mitchell County",2,12,159,87,72
050,19,131,"Iowa","Mitchell County",2,13,157,84,73
050,19,131,"Iowa","Mitchell County",2,14,154,83,71
050,19,131,"Iowa","Mitchell County",2,15,156,83,73
050,19,131,"Iowa","Mitchell County",2,16,155,75,80
050,19,131,"Iowa","Mitchell County",2,17,150,69,81
050,19,131,"Iowa","Mitchell County",2,18,130,67,63
050,19,131,"Iowa","Mitchell County",2,19,104,54,50
050,19,131,"Iowa","Mitchell County",2,20,113,58,55
050,19,131,"Iowa","Mitchell County",2,21,112,60,52
050,19,131,"Iowa","Mitchell County",2,22,111,59,52
050,19,131,"Iowa","Mitchell County",2,23,111,60,51
050,19,131,"Iowa","Mitchell County",2,24,108,65,43
050,19,131,"Iowa","Mitchell County",2,25,116,60,56
050,19,131,"Iowa","Mitchell County",2,26,114,62,52
050,19,131,"Iowa","Mitchell County",2,27,118,64,54
050,19,131,"Iowa","Mitchell County",2,28,116,63,53
050,19,131,"Iowa","Mitchell County",2,29,117,61,56
050,19,131,"Iowa","Mitchell County",2,30,115,57,58
050,19,131,"Iowa","Mitchell County",2,31,109,55,54
050,19,131,"Iowa","Mitchell County",2,32,100,48,52
050,19,131,"Iowa","Mitchell County",2,33,107,52,55
050,19,131,"Iowa","Mitchell County",2,34,101,52,49
050,19,131,"Iowa","Mitchell County",2,35,103,55,48
050,19,131,"Iowa","Mitchell County",2,36,114,56,58
050,19,131,"Iowa","Mitchell County",2,37,122,61,61
050,19,131,"Iowa","Mitchell County",2,38,133,65,68
050,19,131,"Iowa","Mitchell County",2,39,129,63,66
050,19,131,"Iowa","Mitchell County",2,40,118,58,60
050,19,131,"Iowa","Mitchell County",2,41,107,56,51
050,19,131,"Iowa","Mitchell County",2,42,106,59,47
050,19,131,"Iowa","Mitchell County",2,43,112,58,54
050,19,131,"Iowa","Mitchell County",2,44,101,50,51
050,19,131,"Iowa","Mitchell County",2,45,115,62,53
050,19,131,"Iowa","Mitchell County",2,46,104,56,48
050,19,131,"Iowa","Mitchell County",2,47,99,52,47
050,19,131,"Iowa","Mitchell County",2,48,111,56,55
050,19,131,"Iowa","Mitchell County",2,49,119,60,59
050,19,131,"Iowa","Mitchell County",2,50,119,61,58
050,19,131,"Iowa","Mitchell County",2,51,120,59,61
050,19,131,"Iowa","Mitchell County",2,52,118,57,61
050,19,131,"Iowa","Mitchell County",2,53,123,57,66
050,19,131,"Iowa","Mitchell County",2,54,125,57,68
050,19,131,"Iowa","Mitchell County",2,55,150,73,77
050,19,131,"Iowa","Mitchell County",2,56,173,84,89
050,19,131,"Iowa","Mitchell County",2,57,173,89,84
050,19,131,"Iowa","Mitchell County",2,58,174,94,80
050,19,131,"Iowa","Mitchell County",2,59,174,89,85
050,19,131,"Iowa","Mitchell County",2,60,161,82,79
050,19,131,"Iowa","Mitchell County",2,61,163,84,79
050,19,131,"Iowa","Mitchell County",2,62,152,82,70
050,19,131,"Iowa","Mitchell County",2,63,154,81,73
050,19,131,"Iowa","Mitchell County",2,64,151,80,71
050,19,131,"Iowa","Mitchell County",2,65,140,72,68
050,19,131,"Iowa","Mitchell County",2,66,135,71,64
050,19,131,"Iowa","Mitchell County",2,67,132,68,64
050,19,131,"Iowa","Mitchell County",2,68,125,62,63
050,19,131,"Iowa","Mitchell County",2,69,118,57,61
050,19,131,"Iowa","Mitchell County",2,70,110,54,56
050,19,131,"Iowa","Mitchell County",2,71,106,55,51
050,19,131,"Iowa","Mitchell County",2,72,93,45,48
050,19,131,"Iowa","Mitchell County",2,73,102,48,54
050,19,131,"Iowa","Mitchell County",2,74,67,29,38
050,19,131,"Iowa","Mitchell County",2,75,74,34,40
050,19,131,"Iowa","Mitchell County",2,76,78,35,43
050,19,131,"Iowa","Mitchell County",2,77,82,37,45
050,19,131,"Iowa","Mitchell County",2,78,74,34,40
050,19,131,"Iowa","Mitchell County",2,79,72,34,38
050,19,131,"Iowa","Mitchell County",2,80,60,31,29
050,19,131,"Iowa","Mitchell County",2,81,63,29,34
050,19,131,"Iowa","Mitchell County",2,82,54,24,30
050,19,131,"Iowa","Mitchell County",2,83,70,35,35
050,19,131,"Iowa","Mitchell County",2,84,59,25,34
050,19,131,"Iowa","Mitchell County",2,85,418,134,284
050,19,131,"Iowa","Mitchell County",3,0,127,70,57
050,19,131,"Iowa","Mitchell County",3,1,137,70,67
050,19,131,"Iowa","Mitchell County",3,2,119,54,65
050,19,131,"Iowa","Mitchell County",3,3,127,60,67
050,19,131,"Iowa","Mitchell County",3,4,116,55,61
050,19,131,"Iowa","Mitchell County",3,5,131,55,76
050,19,131,"Iowa","Mitchell County",3,6,140,65,75
050,19,131,"Iowa","Mitchell County",3,7,139,69,70
050,19,131,"Iowa","Mitchell County",3,8,142,77,65
050,19,131,"Iowa","Mitchell County",3,9,139,80,59
050,19,131,"Iowa","Mitchell County",3,10,141,75,66
050,19,131,"Iowa","Mitchell County",3,11,152,79,73
050,19,131,"Iowa","Mitchell County",3,12,151,78,73
050,19,131,"Iowa","Mitchell County",3,13,155,84,71
050,19,131,"Iowa","Mitchell County",3,14,161,84,77
050,19,131,"Iowa","Mitchell County",3,15,154,85,69
050,19,131,"Iowa","Mitchell County",3,16,159,83,76
050,19,131,"Iowa","Mitchell County",3,17,149,74,75
050,19,131,"Iowa","Mitchell County",3,18,124,60,64
050,19,131,"Iowa","Mitchell County",3,19,97,50,47
050,19,131,"Iowa","Mitchell County",3,20,112,56,56
050,19,131,"Iowa","Mitchell County",3,21,118,58,60
050,19,131,"Iowa","Mitchell County",3,22,113,59,54
050,19,131,"Iowa","Mitchell County",3,23,106,56,50
050,19,131,"Iowa","Mitchell County",3,24,110,63,47
050,19,131,"Iowa","Mitchell County",3,25,99,63,36
050,19,131,"Iowa","Mitchell County",3,26,111,58,53
050,19,131,"Iowa","Mitchell County",3,27,113,60,53
050,19,131,"Iowa","Mitchell County",3,28,122,69,53
050,19,131,"Iowa","Mitchell County",3,29,118,64,54
050,19,131,"Iowa","Mitchell County",3,30,124,65,59
050,19,131,"Iowa","Mitchell County",3,31,110,54,56
050,19,131,"Iowa","Mitchell County",3,32,112,59,53
050,19,131,"Iowa","Mitchell County",3,33,109,50,59
050,19,131,"Iowa","Mitchell County",3,34,107,53,54
050,19,131,"Iowa","Mitchell County",3,35,102,48,54
050,19,131,"Iowa","Mitchell County",3,36,109,62,47
050,19,131,"Iowa","Mitchell County",3,37,111,54,57
050,19,131,"Iowa","Mitchell County",3,38,127,63,64
050,19,131,"Iowa","Mitchell County",3,39,135,66,69
050,19,131,"Iowa","Mitchell County",3,40,137,72,65
050,19,131,"Iowa","Mitchell County",3,41,119,57,62
050,19,131,"Iowa","Mitchell County",3,42,104,54,50
050,19,131,"Iowa","Mitchell County",3,43,106,60,46
050,19,131,"Iowa","Mitchell County",3,44,109,59,50
050,19,131,"Iowa","Mitchell County",3,45,107,51,56
050,19,131,"Iowa","Mitchell County",3,46,115,60,55
050,19,131,"Iowa","Mitchell County",3,47,102,56,46
050,19,131,"Iowa","Mitchell County",3,48,102,54,48
050,19,131,"Iowa","Mitchell County",3,49,114,59,55
050,19,131,"Iowa","Mitchell County",3,50,116,62,54
050,19,131,"Iowa","Mitchell County",3,51,120,61,59
050,19,131,"Iowa","Mitchell County",3,52,117,57,60
050,19,131,"Iowa","Mitchell County",3,53,118,56,62
050,19,131,"Iowa","Mitchell County",3,54,120,57,63
050,19,131,"Iowa","Mitchell County",3,55,123,57,66
050,19,131,"Iowa","Mitchell County",3,56,150,71,79
050,19,131,"Iowa","Mitchell County",3,57,168,81,87
050,19,131,"Iowa","Mitchell County",3,58,173,87,86
050,19,131,"Iowa","Mitchell County",3,59,171,91,80
050,19,131,"Iowa","Mitchell County",3,60,176,88,88
050,19,131,"Iowa","Mitchell County",3,61,161,77,84
050,19,131,"Iowa","Mitchell County",3,62,160,84,76
050,19,131,"Iowa","Mitchell County",3,63,155,84,71
050,19,131,"Iowa","Mitchell County",3,64,159,85,74
050,19,131,"Iowa","Mitchell County",3,65,146,76,70
050,19,131,"Iowa","Mitchell County",3,66,137,69,68
050,19,131,"Iowa","Mitchell County",3,67,135,72,63
050,19,131,"Iowa","Mitchell County",3,68,126,64,62
050,19,131,"Iowa","Mitchell County",3,69,122,61,61
050,19,131,"Iowa","Mitchell County",3,70,114,53,61
050,19,131,"Iowa","Mitchell County",3,71,110,55,55
050,19,131,"Iowa","Mitchell County",3,72,97,51,46
050,19,131,"Iowa","Mitchell County",3,73,92,43,49
050,19,131,"Iowa","Mitchell County",3,74,96,46,50
050,19,131,"Iowa","Mitchell County",3,75,61,27,34
050,19,131,"Iowa","Mitchell County",3,76,72,35,37
050,19,131,"Iowa","Mitchell County",3,77,80,35,45
050,19,131,"Iowa","Mitchell County",3,78,78,37,41
050,19,131,"Iowa","Mitchell County",3,79,70,33,37
050,19,131,"Iowa","Mitchell County",3,80,69,34,35
050,19,131,"Iowa","Mitchell County",3,81,57,27,30
050,19,131,"Iowa","Mitchell County",3,82,57,26,31
050,19,131,"Iowa","Mitchell County",3,83,56,30,26
050,19,131,"Iowa","Mitchell County",3,84,59,26,33
050,19,131,"Iowa","Mitchell County",3,85,399,132,267
050,19,131,"Iowa","Mitchell County",4,0,125,62,63
050,19,131,"Iowa","Mitchell County",4,1,123,72,51
050,19,131,"Iowa","Mitchell County",4,2,141,72,69
050,19,131,"Iowa","Mitchell County",4,3,122,56,66
050,19,131,"Iowa","Mitchell County",4,4,127,65,62
050,19,131,"Iowa","Mitchell County",4,5,122,58,64
050,19,131,"Iowa","Mitchell County",4,6,130,55,75
050,19,131,"Iowa","Mitchell County",4,7,140,65,75
050,19,131,"Iowa","Mitchell County",4,8,135,69,66
050,19,131,"Iowa","Mitchell County",4,9,143,77,66
050,19,131,"Iowa","Mitchell County",4,10,137,78,59
050,19,131,"Iowa","Mitchell County",4,11,141,72,69
050,19,131,"Iowa","Mitchell County",4,12,152,80,72
050,19,131,"Iowa","Mitchell County",4,13,147,74,73
050,19,131,"Iowa","Mitchell County",4,14,154,82,72
050,19,131,"Iowa","Mitchell County",4,15,171,90,81
050,19,131,"Iowa","Mitchell County",4,16,150,85,65
050,19,131,"Iowa","Mitchell County",4,17,157,80,77
050,19,131,"Iowa","Mitchell County",4,18,121,64,57
050,19,131,"Iowa","Mitchell County",4,19,91,44,47
050,19,131,"Iowa","Mitchell County",4,20,96,53,43
050,19,131,"Iowa","Mitchell County",4,21,112,55,57
050,19,131,"Iowa","Mitchell County",4,22,116,59,57
050,19,131,"Iowa","Mitchell County",4,23,117,64,53
050,19,131,"Iowa","Mitchell County",4,24,110,58,52
050,19,131,"Iowa","Mitchell County",4,25,106,62,44
050,19,131,"Iowa","Mitchell County",4,26,95,64,31
050,19,131,"Iowa","Mitchell County",4,27,109,56,53
050,19,131,"Iowa","Mitchell County",4,28,109,57,52
050,19,131,"Iowa","Mitchell County",4,29,114,61,53
050,19,131,"Iowa","Mitchell County",4,30,120,61,59
050,19,131,"Iowa","Mitchell County",4,31,136,71,65
050,19,131,"Iowa","Mitchell County",4,32,111,55,56
050,19,131,"Iowa","Mitchell County",4,33,114,61,53
050,19,131,"Iowa","Mitchell County",4,34,120,52,68
050,19,131,"Iowa","Mitchell County",4,35,116,57,59
050,19,131,"Iowa","Mitchell County",4,36,108,55,53
050,19,131,"Iowa","Mitchell County",4,37,106,60,46
050,19,131,"Iowa","Mitchell County",4,38,109,55,54
050,19,131,"Iowa","Mitchell County",4,39,131,66,65
050,19,131,"Iowa","Mitchell County",4,40,135,65,70
050,19,131,"Iowa","Mitchell County",4,41,142,74,68
050,19,131,"Iowa","Mitchell County",4,42,119,57,62
050,19,131,"Iowa","Mitchell County",4,43,105,55,50
050,19,131,"Iowa","Mitchell County",4,44,104,58,46
050,19,131,"Iowa","Mitchell County",4,45,105,56,49
050,19,131,"Iowa","Mitchell County",4,46,105,51,54
050,19,131,"Iowa","Mitchell County",4,47,113,59,54
050,19,131,"Iowa","Mitchell County",4,48,101,56,45
050,19,131,"Iowa","Mitchell County",4,49,100,55,45
050,19,131,"Iowa","Mitchell County",4,50,119,60,59
050,19,131,"Iowa","Mitchell County",4,51,119,61,58
050,19,131,"Iowa","Mitchell County",4,52,124,62,62
050,19,131,"Iowa","Mitchell County",4,53,124,60,64
050,19,131,"Iowa","Mitchell County",4,54,118,57,61
050,19,131,"Iowa","Mitchell County",4,55,119,56,63
050,19,131,"Iowa","Mitchell County",4,56,124,59,65
050,19,131,"Iowa","Mitchell County",4,57,145,69,76
050,19,131,"Iowa","Mitchell County",4,58,172,81,91
050,19,131,"Iowa","Mitchell County",4,59,173,84,89
050,19,131,"Iowa","Mitchell County",4,60,169,89,80
050,19,131,"Iowa","Mitchell County",4,61,180,88,92
050,19,131,"Iowa","Mitchell County",4,62,155,76,79
050,19,131,"Iowa","Mitchell County",4,63,162,85,77
050,19,131,"Iowa","Mitchell County",4,64,154,85,69
050,19,131,"Iowa","Mitchell County",4,65,149,78,71
050,19,131,"Iowa","Mitchell County",4,66,144,76,68
050,19,131,"Iowa","Mitchell County",4,67,139,73,66
050,19,131,"Iowa","Mitchell County",4,68,129,67,62
050,19,131,"Iowa","Mitchell County",4,69,129,68,61
050,19,131,"Iowa","Mitchell County",4,70,117,58,59
050,19,131,"Iowa","Mitchell County",4,71,116,57,59
050,19,131,"Iowa","Mitchell County",4,72,100,49,51
050,19,131,"Iowa","Mitchell County",4,73,101,52,49
050,19,131,"Iowa","Mitchell County",4,74,89,43,46
050,19,131,"Iowa","Mitchell County",4,75,93,46,47
050,19,131,"Iowa","Mitchell County",4,76,60,27,33
050,19,131,"Iowa","Mitchell County",4,77,70,33,37
050,19,131,"Iowa","Mitchell County",4,78,76,34,42
050,19,131,"Iowa","Mitchell County",4,79,71,33,38
050,19,131,"Iowa","Mitchell County",4,80,67,34,33
050,19,131,"Iowa","Mitchell County",4,81,67,31,36
050,19,131,"Iowa","Mitchell County",4,82,51,23,28
050,19,131,"Iowa","Mitchell County",4,83,67,35,32
050,19,131,"Iowa","Mitchell County",4,84,44,17,27
050,19,131,"Iowa","Mitchell County",4,85,395,131,264
050,19,131,"Iowa","Mitchell County",5,0,127,64,63
050,19,131,"Iowa","Mitchell County",5,1,130,65,65
050,19,131,"Iowa","Mitchell County",5,2,123,74,49
050,19,131,"Iowa","Mitchell County",5,3,141,73,68
050,19,131,"Iowa","Mitchell County",5,4,124,55,69
050,19,131,"Iowa","Mitchell County",5,5,133,71,62
050,19,131,"Iowa","Mitchell County",5,6,114,59,55
050,19,131,"Iowa","Mitchell County",5,7,134,58,76
050,19,131,"Iowa","Mitchell County",5,8,142,65,77
050,19,131,"Iowa","Mitchell County",5,9,147,74,73
050,19,131,"Iowa","Mitchell County",5,10,142,77,65
050,19,131,"Iowa","Mitchell County",5,11,144,78,66
050,19,131,"Iowa","Mitchell County",5,12,145,75,70
050,19,131,"Iowa","Mitchell County",5,13,154,77,77
050,19,131,"Iowa","Mitchell County",5,14,149,79,70
050,19,131,"Iowa","Mitchell County",5,15,150,79,71
050,19,131,"Iowa","Mitchell County",5,16,168,88,80
050,19,131,"Iowa","Mitchell County",5,17,147,84,63
050,19,131,"Iowa","Mitchell County",5,18,132,69,63
050,19,131,"Iowa","Mitchell County",5,19,93,49,44
050,19,131,"Iowa","Mitchell County",5,20,97,47,50
050,19,131,"Iowa","Mitchell County",5,21,102,55,47
050,19,131,"Iowa","Mitchell County",5,22,115,59,56
050,19,131,"Iowa","Mitchell County",5,23,107,57,50
050,19,131,"Iowa","Mitchell County",5,24,102,58,44
050,19,131,"Iowa","Mitchell County",5,25,111,55,56
050,19,131,"Iowa","Mitchell County",5,26,93,54,39
050,19,131,"Iowa","Mitchell County",5,27,91,59,32
050,19,131,"Iowa","Mitchell County",5,28,107,56,51
050,19,131,"Iowa","Mitchell County",5,29,106,55,51
050,19,131,"Iowa","Mitchell County",5,30,120,64,56
050,19,131,"Iowa","Mitchell County",5,31,126,68,58
050,19,131,"Iowa","Mitchell County",5,32,132,66,66
050,19,131,"Iowa","Mitchell County",5,33,109,55,54
050,19,131,"Iowa","Mitchell County",5,34,113,58,55
050,19,131,"Iowa","Mitchell County",5,35,129,54,75
050,19,131,"Iowa","Mitchell County",5,36,121,63,58
050,19,131,"Iowa","Mitchell County",5,37,110,56,54
050,19,131,"Iowa","Mitchell County",5,38,107,62,45
050,19,131,"Iowa","Mitchell County",5,39,113,56,57
050,19,131,"Iowa","Mitchell County",5,40,131,68,63
050,19,131,"Iowa","Mitchell County",5,41,137,64,73
050,19,131,"Iowa","Mitchell County",5,42,139,71,68
050,19,131,"Iowa","Mitchell County",5,43,123,61,62
050,19,131,"Iowa","Mitchell County",5,44,105,55,50
050,19,131,"Iowa","Mitchell County",5,45,103,58,45
050,19,131,"Iowa","Mitchell County",5,46,108,55,53
050,19,131,"Iowa","Mitchell County",5,47,104,51,53
050,19,131,"Iowa","Mitchell County",5,48,116,60,56
050,19,131,"Iowa","Mitchell County",5,49,100,56,44
050,19,131,"Iowa","Mitchell County",5,50,101,57,44
050,19,131,"Iowa","Mitchell County",5,51,118,57,61
050,19,131,"Iowa","Mitchell County",5,52,121,61,60
050,19,131,"Iowa","Mitchell County",5,53,122,57,65
050,19,131,"Iowa","Mitchell County",5,54,125,62,63
050,19,131,"Iowa","Mitchell County",5,55,118,57,61
050,19,131,"Iowa","Mitchell County",5,56,122,61,61
050,19,131,"Iowa","Mitchell County",5,57,121,60,61
050,19,131,"Iowa","Mitchell County",5,58,141,69,72
050,19,131,"Iowa","Mitchell County",5,59,167,80,87
050,19,131,"Iowa","Mitchell County",5,60,170,83,87
050,19,131,"Iowa","Mitchell County",5,61,174,89,85
050,19,131,"Iowa","Mitchell County",5,62,166,86,80
050,19,131,"Iowa","Mitchell County",5,63,154,73,81
050,19,131,"Iowa","Mitchell County",5,64,162,87,75
050,19,131,"Iowa","Mitchell County",5,65,147,82,65
050,19,131,"Iowa","Mitchell County",5,66,146,76,70
050,19,131,"Iowa","Mitchell County",5,67,147,78,69
050,19,131,"Iowa","Mitchell County",5,68,134,68,66
050,19,131,"Iowa","Mitchell County",5,69,127,65,62
050,19,131,"Iowa","Mitchell County",5,70,124,64,60
050,19,131,"Iowa","Mitchell County",5,71,115,58,57
050,19,131,"Iowa","Mitchell County",5,72,105,49,56
050,19,131,"Iowa","Mitchell County",5,73,101,49,52
050,19,131,"Iowa","Mitchell County",5,74,98,52,46
050,19,131,"Iowa","Mitchell County",5,75,80,41,39
050,19,131,"Iowa","Mitchell County",5,76,92,46,46
050,19,131,"Iowa","Mitchell County",5,77,60,25,35
050,19,131,"Iowa","Mitchell County",5,78,67,31,36
050,19,131,"Iowa","Mitchell County",5,79,73,32,41
050,19,131,"Iowa","Mitchell County",5,80,67,34,33
050,19,131,"Iowa","Mitchell County",5,81,65,30,35
050,19,131,"Iowa","Mitchell County",5,82,59,25,34
050,19,131,"Iowa","Mitchell County",5,83,62,32,30
050,19,131,"Iowa","Mitchell County",5,84,56,21,35
050,19,131,"Iowa","Mitchell County",5,85,395,132,263
050,19,133,"Iowa","Monona County",1,0,93,47,46
050,19,133,"Iowa","Monona County",1,1,99,46,53
050,19,133,"Iowa","Monona County",1,2,110,57,53
050,19,133,"Iowa","Monona County",1,3,100,50,50
050,19,133,"Iowa","Monona County",1,4,117,55,62
050,19,133,"Iowa","Monona County",1,5,109,52,57
050,19,133,"Iowa","Monona County",1,6,109,48,61
050,19,133,"Iowa","Monona County",1,7,109,57,52
050,19,133,"Iowa","Monona County",1,8,92,49,43
050,19,133,"Iowa","Monona County",1,9,91,44,47
050,19,133,"Iowa","Monona County",1,10,112,56,56
050,19,133,"Iowa","Monona County",1,11,103,51,52
050,19,133,"Iowa","Monona County",1,12,108,56,52
050,19,133,"Iowa","Monona County",1,13,121,60,61
050,19,133,"Iowa","Monona County",1,14,138,73,65
050,19,133,"Iowa","Monona County",1,15,131,63,68
050,19,133,"Iowa","Monona County",1,16,125,58,67
050,19,133,"Iowa","Monona County",1,17,118,59,59
050,19,133,"Iowa","Monona County",1,18,93,58,35
050,19,133,"Iowa","Monona County",1,19,66,36,30
050,19,133,"Iowa","Monona County",1,20,77,40,37
050,19,133,"Iowa","Monona County",1,21,87,49,38
050,19,133,"Iowa","Monona County",1,22,91,47,44
050,19,133,"Iowa","Monona County",1,23,85,40,45
050,19,133,"Iowa","Monona County",1,24,93,45,48
050,19,133,"Iowa","Monona County",1,25,97,46,51
050,19,133,"Iowa","Monona County",1,26,90,45,45
050,19,133,"Iowa","Monona County",1,27,105,57,48
050,19,133,"Iowa","Monona County",1,28,101,52,49
050,19,133,"Iowa","Monona County",1,29,84,44,40
050,19,133,"Iowa","Monona County",1,30,78,41,37
050,19,133,"Iowa","Monona County",1,31,91,48,43
050,19,133,"Iowa","Monona County",1,32,80,45,35
050,19,133,"Iowa","Monona County",1,33,85,37,48
050,19,133,"Iowa","Monona County",1,34,85,36,49
050,19,133,"Iowa","Monona County",1,35,86,38,48
050,19,133,"Iowa","Monona County",1,36,96,47,49
050,19,133,"Iowa","Monona County",1,37,106,54,52
050,19,133,"Iowa","Monona County",1,38,93,50,43
050,19,133,"Iowa","Monona County",1,39,90,43,47
050,19,133,"Iowa","Monona County",1,40,94,46,48
050,19,133,"Iowa","Monona County",1,41,95,47,48
050,19,133,"Iowa","Monona County",1,42,92,43,49
050,19,133,"Iowa","Monona County",1,43,78,36,42
050,19,133,"Iowa","Monona County",1,44,88,42,46
050,19,133,"Iowa","Monona County",1,45,89,48,41
050,19,133,"Iowa","Monona County",1,46,88,43,45
050,19,133,"Iowa","Monona County",1,47,84,45,39
050,19,133,"Iowa","Monona County",1,48,97,46,51
050,19,133,"Iowa","Monona County",1,49,98,49,49
050,19,133,"Iowa","Monona County",1,50,90,50,40
050,19,133,"Iowa","Monona County",1,51,104,55,49
050,19,133,"Iowa","Monona County",1,52,93,40,53
050,19,133,"Iowa","Monona County",1,53,100,46,54
050,19,133,"Iowa","Monona County",1,54,96,41,55
050,19,133,"Iowa","Monona County",1,55,104,58,46
050,19,133,"Iowa","Monona County",1,56,123,66,57
050,19,133,"Iowa","Monona County",1,57,143,74,69
050,19,133,"Iowa","Monona County",1,58,150,75,75
050,19,133,"Iowa","Monona County",1,59,129,61,68
050,19,133,"Iowa","Monona County",1,60,136,67,69
050,19,133,"Iowa","Monona County",1,61,152,79,73
050,19,133,"Iowa","Monona County",1,62,141,68,73
050,19,133,"Iowa","Monona County",1,63,138,75,63
050,19,133,"Iowa","Monona County",1,64,129,72,57
050,19,133,"Iowa","Monona County",1,65,126,67,59
050,19,133,"Iowa","Monona County",1,66,136,68,68
050,19,133,"Iowa","Monona County",1,67,121,59,62
050,19,133,"Iowa","Monona County",1,68,117,61,56
050,19,133,"Iowa","Monona County",1,69,118,62,56
050,19,133,"Iowa","Monona County",1,70,95,48,47
050,19,133,"Iowa","Monona County",1,71,96,49,47
050,19,133,"Iowa","Monona County",1,72,94,44,50
050,19,133,"Iowa","Monona County",1,73,85,44,41
050,19,133,"Iowa","Monona County",1,74,75,35,40
050,19,133,"Iowa","Monona County",1,75,84,43,41
050,19,133,"Iowa","Monona County",1,76,86,43,43
050,19,133,"Iowa","Monona County",1,77,80,34,46
050,19,133,"Iowa","Monona County",1,78,75,34,41
050,19,133,"Iowa","Monona County",1,79,66,28,38
050,19,133,"Iowa","Monona County",1,80,61,24,37
050,19,133,"Iowa","Monona County",1,81,58,29,29
050,19,133,"Iowa","Monona County",1,82,55,25,30
050,19,133,"Iowa","Monona County",1,83,45,20,25
050,19,133,"Iowa","Monona County",1,84,55,20,35
050,19,133,"Iowa","Monona County",1,85,350,106,244
050,19,133,"Iowa","Monona County",2,0,87,41,46
050,19,133,"Iowa","Monona County",2,1,98,47,51
050,19,133,"Iowa","Monona County",2,2,104,53,51
050,19,133,"Iowa","Monona County",2,3,103,53,50
050,19,133,"Iowa","Monona County",2,4,114,56,58
050,19,133,"Iowa","Monona County",2,5,112,53,59
050,19,133,"Iowa","Monona County",2,6,110,49,61
050,19,133,"Iowa","Monona County",2,7,108,54,54
050,19,133,"Iowa","Monona County",2,8,96,51,45
050,19,133,"Iowa","Monona County",2,9,93,46,47
050,19,133,"Iowa","Monona County",2,10,108,54,54
050,19,133,"Iowa","Monona County",2,11,105,52,53
050,19,133,"Iowa","Monona County",2,12,111,56,55
050,19,133,"Iowa","Monona County",2,13,118,59,59
050,19,133,"Iowa","Monona County",2,14,135,70,65
050,19,133,"Iowa","Monona County",2,15,132,65,67
050,19,133,"Iowa","Monona County",2,16,127,60,67
050,19,133,"Iowa","Monona County",2,17,120,60,60
050,19,133,"Iowa","Monona County",2,18,94,55,39
050,19,133,"Iowa","Monona County",2,19,68,39,29
050,19,133,"Iowa","Monona County",2,20,74,40,34
050,19,133,"Iowa","Monona County",2,21,86,47,39
050,19,133,"Iowa","Monona County",2,22,92,49,43
050,19,133,"Iowa","Monona County",2,23,86,41,45
050,19,133,"Iowa","Monona County",2,24,90,45,45
050,19,133,"Iowa","Monona County",2,25,95,44,51
050,19,133,"Iowa","Monona County",2,26,92,45,47
050,19,133,"Iowa","Monona County",2,27,102,54,48
050,19,133,"Iowa","Monona County",2,28,102,53,49
050,19,133,"Iowa","Monona County",2,29,88,45,43
050,19,133,"Iowa","Monona County",2,30,83,44,39
050,19,133,"Iowa","Monona County",2,31,87,46,41
050,19,133,"Iowa","Monona County",2,32,82,45,37
050,19,133,"Iowa","Monona County",2,33,86,40,46
050,19,133,"Iowa","Monona County",2,34,85,36,49
050,19,133,"Iowa","Monona County",2,35,87,38,49
050,19,133,"Iowa","Monona County",2,36,92,45,47
050,19,133,"Iowa","Monona County",2,37,104,53,51
050,19,133,"Iowa","Monona County",2,38,96,50,46
050,19,133,"Iowa","Monona County",2,39,88,43,45
050,19,133,"Iowa","Monona County",2,40,96,47,49
050,19,133,"Iowa","Monona County",2,41,94,47,47
050,19,133,"Iowa","Monona County",2,42,92,44,48
050,19,133,"Iowa","Monona County",2,43,83,39,44
050,19,133,"Iowa","Monona County",2,44,86,41,45
050,19,133,"Iowa","Monona County",2,45,91,48,43
050,19,133,"Iowa","Monona County",2,46,89,45,44
050,19,133,"Iowa","Monona County",2,47,85,45,40
050,19,133,"Iowa","Monona County",2,48,93,45,48
050,19,133,"Iowa","Monona County",2,49,100,49,51
050,19,133,"Iowa","Monona County",2,50,95,51,44
050,19,133,"Iowa","Monona County",2,51,101,54,47
050,19,133,"Iowa","Monona County",2,52,93,43,50
050,19,133,"Iowa","Monona County",2,53,97,43,54
050,19,133,"Iowa","Monona County",2,54,98,43,55
050,19,133,"Iowa","Monona County",2,55,102,54,48
050,19,133,"Iowa","Monona County",2,56,117,63,54
050,19,133,"Iowa","Monona County",2,57,137,72,65
050,19,133,"Iowa","Monona County",2,58,148,74,74
050,19,133,"Iowa","Monona County",2,59,136,65,71
050,19,133,"Iowa","Monona County",2,60,134,66,68
050,19,133,"Iowa","Monona County",2,61,148,75,73
050,19,133,"Iowa","Monona County",2,62,144,71,73
050,19,133,"Iowa","Monona County",2,63,139,75,64
050,19,133,"Iowa","Monona County",2,64,128,70,58
050,19,133,"Iowa","Monona County",2,65,126,67,59
050,19,133,"Iowa","Monona County",2,66,132,66,66
050,19,133,"Iowa","Monona County",2,67,122,61,61
050,19,133,"Iowa","Monona County",2,68,117,60,57
050,19,133,"Iowa","Monona County",2,69,120,63,57
050,19,133,"Iowa","Monona County",2,70,100,51,49
050,19,133,"Iowa","Monona County",2,71,95,48,47
050,19,133,"Iowa","Monona County",2,72,91,43,48
050,19,133,"Iowa","Monona County",2,73,90,46,44
050,19,133,"Iowa","Monona County",2,74,74,36,38
050,19,133,"Iowa","Monona County",2,75,82,42,40
050,19,133,"Iowa","Monona County",2,76,81,41,40
050,19,133,"Iowa","Monona County",2,77,81,36,45
050,19,133,"Iowa","Monona County",2,78,74,33,41
050,19,133,"Iowa","Monona County",2,79,66,29,37
050,19,133,"Iowa","Monona County",2,80,61,25,36
050,19,133,"Iowa","Monona County",2,81,59,28,31
050,19,133,"Iowa","Monona County",2,82,56,26,30
050,19,133,"Iowa","Monona County",2,83,45,21,24
050,19,133,"Iowa","Monona County",2,84,52,19,33
050,19,133,"Iowa","Monona County",2,85,352,104,248
050,19,133,"Iowa","Monona County",3,0,102,54,48
050,19,133,"Iowa","Monona County",3,1,92,46,46
050,19,133,"Iowa","Monona County",3,2,106,51,55
050,19,133,"Iowa","Monona County",3,3,97,46,51
050,19,133,"Iowa","Monona County",3,4,103,56,47
050,19,133,"Iowa","Monona County",3,5,111,58,53
050,19,133,"Iowa","Monona County",3,6,109,51,58
050,19,133,"Iowa","Monona County",3,7,108,46,62
050,19,133,"Iowa","Monona County",3,8,108,54,54
050,19,133,"Iowa","Monona County",3,9,88,48,40
050,19,133,"Iowa","Monona County",3,10,91,41,50
050,19,133,"Iowa","Monona County",3,11,108,52,56
050,19,133,"Iowa","Monona County",3,12,97,48,49
050,19,133,"Iowa","Monona County",3,13,102,52,50
050,19,133,"Iowa","Monona County",3,14,115,59,56
050,19,133,"Iowa","Monona County",3,15,129,71,58
050,19,133,"Iowa","Monona County",3,16,135,71,64
050,19,133,"Iowa","Monona County",3,17,128,58,70
050,19,133,"Iowa","Monona County",3,18,101,48,53
050,19,133,"Iowa","Monona County",3,19,76,44,32
050,19,133,"Iowa","Monona County",3,20,68,40,28
050,19,133,"Iowa","Monona County",3,21,80,44,36
050,19,133,"Iowa","Monona County",3,22,91,47,44
050,19,133,"Iowa","Monona County",3,23,84,45,39
050,19,133,"Iowa","Monona County",3,24,87,41,46
050,19,133,"Iowa","Monona County",3,25,93,50,43
050,19,133,"Iowa","Monona County",3,26,98,46,52
050,19,133,"Iowa","Monona County",3,27,100,50,50
050,19,133,"Iowa","Monona County",3,28,97,53,44
050,19,133,"Iowa","Monona County",3,29,109,55,54
050,19,133,"Iowa","Monona County",3,30,89,45,44
050,19,133,"Iowa","Monona County",3,31,89,47,42
050,19,133,"Iowa","Monona County",3,32,83,43,40
050,19,133,"Iowa","Monona County",3,33,84,45,39
050,19,133,"Iowa","Monona County",3,34,95,43,52
050,19,133,"Iowa","Monona County",3,35,86,36,50
050,19,133,"Iowa","Monona County",3,36,82,35,47
050,19,133,"Iowa","Monona County",3,37,91,46,45
050,19,133,"Iowa","Monona County",3,38,101,50,51
050,19,133,"Iowa","Monona County",3,39,89,47,42
050,19,133,"Iowa","Monona County",3,40,89,42,47
050,19,133,"Iowa","Monona County",3,41,98,50,48
050,19,133,"Iowa","Monona County",3,42,92,48,44
050,19,133,"Iowa","Monona County",3,43,93,45,48
050,19,133,"Iowa","Monona County",3,44,81,39,42
050,19,133,"Iowa","Monona County",3,45,72,31,41
050,19,133,"Iowa","Monona County",3,46,88,48,40
050,19,133,"Iowa","Monona County",3,47,90,47,43
050,19,133,"Iowa","Monona County",3,48,85,44,41
050,19,133,"Iowa","Monona County",3,49,90,44,46
050,19,133,"Iowa","Monona County",3,50,99,48,51
050,19,133,"Iowa","Monona County",3,51,92,49,43
050,19,133,"Iowa","Monona County",3,52,101,55,46
050,19,133,"Iowa","Monona County",3,53,99,47,52
050,19,133,"Iowa","Monona County",3,54,98,41,57
050,19,133,"Iowa","Monona County",3,55,103,45,58
050,19,133,"Iowa","Monona County",3,56,98,52,46
050,19,133,"Iowa","Monona County",3,57,114,61,53
050,19,133,"Iowa","Monona County",3,58,132,68,64
050,19,133,"Iowa","Monona County",3,59,144,71,73
050,19,133,"Iowa","Monona County",3,60,135,65,70
050,19,133,"Iowa","Monona County",3,61,135,66,69
050,19,133,"Iowa","Monona County",3,62,146,73,73
050,19,133,"Iowa","Monona County",3,63,144,71,73
050,19,133,"Iowa","Monona County",3,64,138,74,64
050,19,133,"Iowa","Monona County",3,65,128,69,59
050,19,133,"Iowa","Monona County",3,66,119,64,55
050,19,133,"Iowa","Monona County",3,67,123,63,60
050,19,133,"Iowa","Monona County",3,68,113,54,59
050,19,133,"Iowa","Monona County",3,69,123,61,62
050,19,133,"Iowa","Monona County",3,70,116,62,54
050,19,133,"Iowa","Monona County",3,71,95,50,45
050,19,133,"Iowa","Monona County",3,72,91,43,48
050,19,133,"Iowa","Monona County",3,73,82,37,45
050,19,133,"Iowa","Monona County",3,74,89,45,44
050,19,133,"Iowa","Monona County",3,75,72,37,35
050,19,133,"Iowa","Monona County",3,76,71,36,35
050,19,133,"Iowa","Monona County",3,77,73,37,36
050,19,133,"Iowa","Monona County",3,78,80,34,46
050,19,133,"Iowa","Monona County",3,79,65,28,37
050,19,133,"Iowa","Monona County",3,80,63,27,36
050,19,133,"Iowa","Monona County",3,81,57,24,33
050,19,133,"Iowa","Monona County",3,82,56,23,33
050,19,133,"Iowa","Monona County",3,83,47,23,24
050,19,133,"Iowa","Monona County",3,84,44,15,29
050,19,133,"Iowa","Monona County",3,85,333,98,235
050,19,133,"Iowa","Monona County",4,0,93,46,47
050,19,133,"Iowa","Monona County",4,1,103,53,50
050,19,133,"Iowa","Monona County",4,2,85,45,40
050,19,133,"Iowa","Monona County",4,3,106,56,50
050,19,133,"Iowa","Monona County",4,4,101,49,52
050,19,133,"Iowa","Monona County",4,5,103,52,51
050,19,133,"Iowa","Monona County",4,6,109,56,53
050,19,133,"Iowa","Monona County",4,7,108,56,52
050,19,133,"Iowa","Monona County",4,8,105,48,57
050,19,133,"Iowa","Monona County",4,9,116,58,58
050,19,133,"Iowa","Monona County",4,10,92,47,45
050,19,133,"Iowa","Monona County",4,11,88,43,45
050,19,133,"Iowa","Monona County",4,12,109,51,58
050,19,133,"Iowa","Monona County",4,13,104,51,53
050,19,133,"Iowa","Monona County",4,14,110,58,52
050,19,133,"Iowa","Monona County",4,15,117,58,59
050,19,133,"Iowa","Monona County",4,16,131,71,60
050,19,133,"Iowa","Monona County",4,17,130,66,64
050,19,133,"Iowa","Monona County",4,18,101,49,52
050,19,133,"Iowa","Monona County",4,19,75,39,36
050,19,133,"Iowa","Monona County",4,20,73,45,28
050,19,133,"Iowa","Monona County",4,21,67,38,29
050,19,133,"Iowa","Monona County",4,22,83,47,36
050,19,133,"Iowa","Monona County",4,23,92,50,42
050,19,133,"Iowa","Monona County",4,24,87,45,42
050,19,133,"Iowa","Monona County",4,25,78,36,42
050,19,133,"Iowa","Monona County",4,26,88,48,40
050,19,133,"Iowa","Monona County",4,27,93,42,51
050,19,133,"Iowa","Monona County",4,28,95,51,44
050,19,133,"Iowa","Monona County",4,29,86,44,42
050,19,133,"Iowa","Monona County",4,30,111,52,59
050,19,133,"Iowa","Monona County",4,31,87,45,42
050,19,133,"Iowa","Monona County",4,32,91,50,41
050,19,133,"Iowa","Monona County",4,33,80,42,38
050,19,133,"Iowa","Monona County",4,34,82,43,39
050,19,133,"Iowa","Monona County",4,35,96,47,49
050,19,133,"Iowa","Monona County",4,36,87,36,51
050,19,133,"Iowa","Monona County",4,37,83,36,47
050,19,133,"Iowa","Monona County",4,38,101,55,46
050,19,133,"Iowa","Monona County",4,39,105,51,54
050,19,133,"Iowa","Monona County",4,40,88,45,43
050,19,133,"Iowa","Monona County",4,41,95,46,49
050,19,133,"Iowa","Monona County",4,42,98,49,49
050,19,133,"Iowa","Monona County",4,43,97,49,48
050,19,133,"Iowa","Monona County",4,44,82,38,44
050,19,133,"Iowa","Monona County",4,45,83,41,42
050,19,133,"Iowa","Monona County",4,46,74,32,42
050,19,133,"Iowa","Monona County",4,47,86,46,40
050,19,133,"Iowa","Monona County",4,48,95,49,46
050,19,133,"Iowa","Monona County",4,49,84,44,40
050,19,133,"Iowa","Monona County",4,50,93,46,47
050,19,133,"Iowa","Monona County",4,51,107,51,56
050,19,133,"Iowa","Monona County",4,52,95,50,45
050,19,133,"Iowa","Monona County",4,53,101,56,45
050,19,133,"Iowa","Monona County",4,54,95,45,50
050,19,133,"Iowa","Monona County",4,55,99,43,56
050,19,133,"Iowa","Monona County",4,56,102,45,57
050,19,133,"Iowa","Monona County",4,57,96,50,46
050,19,133,"Iowa","Monona County",4,58,113,61,52
050,19,133,"Iowa","Monona County",4,59,125,62,63
050,19,133,"Iowa","Monona County",4,60,145,72,73
050,19,133,"Iowa","Monona County",4,61,138,65,73
050,19,133,"Iowa","Monona County",4,62,128,60,68
050,19,133,"Iowa","Monona County",4,63,145,73,72
050,19,133,"Iowa","Monona County",4,64,142,70,72
050,19,133,"Iowa","Monona County",4,65,139,73,66
050,19,133,"Iowa","Monona County",4,66,125,69,56
050,19,133,"Iowa","Monona County",4,67,114,63,51
050,19,133,"Iowa","Monona County",4,68,118,61,57
050,19,133,"Iowa","Monona County",4,69,115,55,60
050,19,133,"Iowa","Monona County",4,70,119,58,61
050,19,133,"Iowa","Monona County",4,71,113,59,54
050,19,133,"Iowa","Monona County",4,72,94,46,48
050,19,133,"Iowa","Monona County",4,73,84,38,46
050,19,133,"Iowa","Monona County",4,74,84,38,46
050,19,133,"Iowa","Monona County",4,75,86,46,40
050,19,133,"Iowa","Monona County",4,76,69,34,35
050,19,133,"Iowa","Monona County",4,77,62,29,33
050,19,133,"Iowa","Monona County",4,78,75,39,36
050,19,133,"Iowa","Monona County",4,79,70,28,42
050,19,133,"Iowa","Monona County",4,80,61,27,34
050,19,133,"Iowa","Monona County",4,81,56,25,31
050,19,133,"Iowa","Monona County",4,82,56,22,34
050,19,133,"Iowa","Monona County",4,83,43,19,24
050,19,133,"Iowa","Monona County",4,84,46,17,29
050,19,133,"Iowa","Monona County",4,85,320,93,227
050,19,133,"Iowa","Monona County",5,0,92,46,46
050,19,133,"Iowa","Monona County",5,1,99,48,51
050,19,133,"Iowa","Monona County",5,2,103,53,50
050,19,133,"Iowa","Monona County",5,3,85,44,41
050,19,133,"Iowa","Monona County",5,4,109,56,53
050,19,133,"Iowa","Monona County",5,5,107,53,54
050,19,133,"Iowa","Monona County",5,6,104,51,53
050,19,133,"Iowa","Monona County",5,7,108,54,54
050,19,133,"Iowa","Monona County",5,8,114,57,57
050,19,133,"Iowa","Monona County",5,9,106,49,57
050,19,133,"Iowa","Monona County",5,10,114,49,65
050,19,133,"Iowa","Monona County",5,11,99,49,50
050,19,133,"Iowa","Monona County",5,12,88,42,46
050,19,133,"Iowa","Monona County",5,13,109,50,59
050,19,133,"Iowa","Monona County",5,14,104,52,52
050,19,133,"Iowa","Monona County",5,15,111,59,52
050,19,133,"Iowa","Monona County",5,16,115,61,54
050,19,133,"Iowa","Monona County",5,17,131,74,57
050,19,133,"Iowa","Monona County",5,18,112,61,51
050,19,133,"Iowa","Monona County",5,19,86,42,44
050,19,133,"Iowa","Monona County",5,20,80,39,41
050,19,133,"Iowa","Monona County",5,21,73,45,28
050,19,133,"Iowa","Monona County",5,22,69,38,31
050,19,133,"Iowa","Monona County",5,23,87,53,34
050,19,133,"Iowa","Monona County",5,24,95,53,42
050,19,133,"Iowa","Monona County",5,25,86,47,39
050,19,133,"Iowa","Monona County",5,26,78,36,42
050,19,133,"Iowa","Monona County",5,27,91,49,42
050,19,133,"Iowa","Monona County",5,28,85,36,49
050,19,133,"Iowa","Monona County",5,29,97,51,46
050,19,133,"Iowa","Monona County",5,30,87,47,40
050,19,133,"Iowa","Monona County",5,31,111,55,56
050,19,133,"Iowa","Monona County",5,32,94,52,42
050,19,133,"Iowa","Monona County",5,33,96,49,47
050,19,133,"Iowa","Monona County",5,34,83,44,39
050,19,133,"Iowa","Monona County",5,35,90,49,41
050,19,133,"Iowa","Monona County",5,36,103,49,54
050,19,133,"Iowa","Monona County",5,37,86,36,50
050,19,133,"Iowa","Monona County",5,38,86,38,48
050,19,133,"Iowa","Monona County",5,39,102,54,48
050,19,133,"Iowa","Monona County",5,40,107,52,55
050,19,133,"Iowa","Monona County",5,41,91,48,43
050,19,133,"Iowa","Monona County",5,42,94,47,47
050,19,133,"Iowa","Monona County",5,43,108,54,54
050,19,133,"Iowa","Monona County",5,44,93,48,45
050,19,133,"Iowa","Monona County",5,45,83,39,44
050,19,133,"Iowa","Monona County",5,46,80,39,41
050,19,133,"Iowa","Monona County",5,47,74,32,42
050,19,133,"Iowa","Monona County",5,48,84,46,38
050,19,133,"Iowa","Monona County",5,49,93,47,46
050,19,133,"Iowa","Monona County",5,50,86,44,42
050,19,133,"Iowa","Monona County",5,51,92,45,47
050,19,133,"Iowa","Monona County",5,52,105,52,53
050,19,133,"Iowa","Monona County",5,53,101,52,49
050,19,133,"Iowa","Monona County",5,54,99,53,46
050,19,133,"Iowa","Monona County",5,55,95,45,50
050,19,133,"Iowa","Monona County",5,56,100,43,57
050,19,133,"Iowa","Monona County",5,57,100,44,56
050,19,133,"Iowa","Monona County",5,58,96,53,43
050,19,133,"Iowa","Monona County",5,59,108,57,51
050,19,133,"Iowa","Monona County",5,60,127,61,66
050,19,133,"Iowa","Monona County",5,61,144,71,73
050,19,133,"Iowa","Monona County",5,62,135,64,71
050,19,133,"Iowa","Monona County",5,63,127,59,68
050,19,133,"Iowa","Monona County",5,64,143,72,71
050,19,133,"Iowa","Monona County",5,65,143,69,74
050,19,133,"Iowa","Monona County",5,66,137,68,69
050,19,133,"Iowa","Monona County",5,67,114,63,51
050,19,133,"Iowa","Monona County",5,68,109,62,47
050,19,133,"Iowa","Monona County",5,69,116,60,56
050,19,133,"Iowa","Monona County",5,70,110,49,61
050,19,133,"Iowa","Monona County",5,71,116,56,60
050,19,133,"Iowa","Monona County",5,72,109,56,53
050,19,133,"Iowa","Monona County",5,73,91,44,47
050,19,133,"Iowa","Monona County",5,74,85,40,45
050,19,133,"Iowa","Monona County",5,75,85,39,46
050,19,133,"Iowa","Monona County",5,76,76,40,36
050,19,133,"Iowa","Monona County",5,77,58,27,31
050,19,133,"Iowa","Monona County",5,78,64,30,34
050,19,133,"Iowa","Monona County",5,79,66,33,33
050,19,133,"Iowa","Monona County",5,80,63,24,39
050,19,133,"Iowa","Monona County",5,81,57,27,30
050,19,133,"Iowa","Monona County",5,82,54,22,32
050,19,133,"Iowa","Monona County",5,83,47,17,30
050,19,133,"Iowa","Monona County",5,84,42,14,28
050,19,133,"Iowa","Monona County",5,85,311,93,218
050,19,135,"Iowa","Monroe County",1,0,84,43,41
050,19,135,"Iowa","Monroe County",1,1,95,48,47
050,19,135,"Iowa","Monroe County",1,2,90,41,49
050,19,135,"Iowa","Monroe County",1,3,78,43,35
050,19,135,"Iowa","Monroe County",1,4,95,51,44
050,19,135,"Iowa","Monroe County",1,5,87,41,46
050,19,135,"Iowa","Monroe County",1,6,76,34,42
050,19,135,"Iowa","Monroe County",1,7,88,41,47
050,19,135,"Iowa","Monroe County",1,8,84,42,42
050,19,135,"Iowa","Monroe County",1,9,101,51,50
050,19,135,"Iowa","Monroe County",1,10,99,50,49
050,19,135,"Iowa","Monroe County",1,11,110,57,53
050,19,135,"Iowa","Monroe County",1,12,119,58,61
050,19,135,"Iowa","Monroe County",1,13,123,64,59
050,19,135,"Iowa","Monroe County",1,14,108,51,57
050,19,135,"Iowa","Monroe County",1,15,105,53,52
050,19,135,"Iowa","Monroe County",1,16,122,67,55
050,19,135,"Iowa","Monroe County",1,17,110,59,51
050,19,135,"Iowa","Monroe County",1,18,88,43,45
050,19,135,"Iowa","Monroe County",1,19,70,38,32
050,19,135,"Iowa","Monroe County",1,20,75,47,28
050,19,135,"Iowa","Monroe County",1,21,78,45,33
050,19,135,"Iowa","Monroe County",1,22,84,44,40
050,19,135,"Iowa","Monroe County",1,23,90,45,45
050,19,135,"Iowa","Monroe County",1,24,93,48,45
050,19,135,"Iowa","Monroe County",1,25,87,40,47
050,19,135,"Iowa","Monroe County",1,26,69,34,35
050,19,135,"Iowa","Monroe County",1,27,86,40,46
050,19,135,"Iowa","Monroe County",1,28,83,47,36
050,19,135,"Iowa","Monroe County",1,29,77,42,35
050,19,135,"Iowa","Monroe County",1,30,76,35,41
050,19,135,"Iowa","Monroe County",1,31,68,35,33
050,19,135,"Iowa","Monroe County",1,32,86,49,37
050,19,135,"Iowa","Monroe County",1,33,79,39,40
050,19,135,"Iowa","Monroe County",1,34,72,38,34
050,19,135,"Iowa","Monroe County",1,35,83,42,41
050,19,135,"Iowa","Monroe County",1,36,88,42,46
050,19,135,"Iowa","Monroe County",1,37,91,46,45
050,19,135,"Iowa","Monroe County",1,38,95,53,42
050,19,135,"Iowa","Monroe County",1,39,98,55,43
050,19,135,"Iowa","Monroe County",1,40,97,49,48
050,19,135,"Iowa","Monroe County",1,41,94,53,41
050,19,135,"Iowa","Monroe County",1,42,78,34,44
050,19,135,"Iowa","Monroe County",1,43,81,34,47
050,19,135,"Iowa","Monroe County",1,44,88,42,46
050,19,135,"Iowa","Monroe County",1,45,80,40,40
050,19,135,"Iowa","Monroe County",1,46,72,36,36
050,19,135,"Iowa","Monroe County",1,47,81,47,34
050,19,135,"Iowa","Monroe County",1,48,89,42,47
050,19,135,"Iowa","Monroe County",1,49,112,56,56
050,19,135,"Iowa","Monroe County",1,50,100,55,45
050,19,135,"Iowa","Monroe County",1,51,95,51,44
050,19,135,"Iowa","Monroe County",1,52,100,54,46
050,19,135,"Iowa","Monroe County",1,53,100,52,48
050,19,135,"Iowa","Monroe County",1,54,102,49,53
050,19,135,"Iowa","Monroe County",1,55,98,44,54
050,19,135,"Iowa","Monroe County",1,56,106,54,52
050,19,135,"Iowa","Monroe County",1,57,111,51,60
050,19,135,"Iowa","Monroe County",1,58,113,51,62
050,19,135,"Iowa","Monroe County",1,59,120,57,63
050,19,135,"Iowa","Monroe County",1,60,108,54,54
050,19,135,"Iowa","Monroe County",1,61,113,55,58
050,19,135,"Iowa","Monroe County",1,62,128,66,62
050,19,135,"Iowa","Monroe County",1,63,106,58,48
050,19,135,"Iowa","Monroe County",1,64,101,48,53
050,19,135,"Iowa","Monroe County",1,65,112,58,54
050,19,135,"Iowa","Monroe County",1,66,90,48,42
050,19,135,"Iowa","Monroe County",1,67,98,53,45
050,19,135,"Iowa","Monroe County",1,68,102,58,44
050,19,135,"Iowa","Monroe County",1,69,87,43,44
050,19,135,"Iowa","Monroe County",1,70,78,33,45
050,19,135,"Iowa","Monroe County",1,71,87,36,51
050,19,135,"Iowa","Monroe County",1,72,76,31,45
050,19,135,"Iowa","Monroe County",1,73,92,44,48
050,19,135,"Iowa","Monroe County",1,74,63,26,37
050,19,135,"Iowa","Monroe County",1,75,63,29,34
050,19,135,"Iowa","Monroe County",1,76,59,30,29
050,19,135,"Iowa","Monroe County",1,77,50,25,25
050,19,135,"Iowa","Monroe County",1,78,51,26,25
050,19,135,"Iowa","Monroe County",1,79,43,21,22
050,19,135,"Iowa","Monroe County",1,80,49,19,30
050,19,135,"Iowa","Monroe County",1,81,37,12,25
050,19,135,"Iowa","Monroe County",1,82,42,21,21
050,19,135,"Iowa","Monroe County",1,83,35,17,18
050,19,135,"Iowa","Monroe County",1,84,34,18,16
050,19,135,"Iowa","Monroe County",1,85,159,51,108
050,19,135,"Iowa","Monroe County",2,0,93,48,45
050,19,135,"Iowa","Monroe County",2,1,93,47,46
050,19,135,"Iowa","Monroe County",2,2,92,43,49
050,19,135,"Iowa","Monroe County",2,3,83,44,39
050,19,135,"Iowa","Monroe County",2,4,92,50,42
050,19,135,"Iowa","Monroe County",2,5,88,43,45
050,19,135,"Iowa","Monroe County",2,6,81,36,45
050,19,135,"Iowa","Monroe County",2,7,85,39,46
050,19,135,"Iowa","Monroe County",2,8,85,41,44
050,19,135,"Iowa","Monroe County",2,9,96,50,46
050,19,135,"Iowa","Monroe County",2,10,100,51,49
050,19,135,"Iowa","Monroe County",2,11,108,56,52
050,19,135,"Iowa","Monroe County",2,12,118,59,59
050,19,135,"Iowa","Monroe County",2,13,122,62,60
050,19,135,"Iowa","Monroe County",2,14,112,54,58
050,19,135,"Iowa","Monroe County",2,15,106,53,53
050,19,135,"Iowa","Monroe County",2,16,118,63,55
050,19,135,"Iowa","Monroe County",2,17,113,61,52
050,19,135,"Iowa","Monroe County",2,18,88,45,43
050,19,135,"Iowa","Monroe County",2,19,71,38,33
050,19,135,"Iowa","Monroe County",2,20,76,45,31
050,19,135,"Iowa","Monroe County",2,21,78,46,32
050,19,135,"Iowa","Monroe County",2,22,86,46,40
050,19,135,"Iowa","Monroe County",2,23,91,46,45
050,19,135,"Iowa","Monroe County",2,24,93,48,45
050,19,135,"Iowa","Monroe County",2,25,87,41,46
050,19,135,"Iowa","Monroe County",2,26,76,37,39
050,19,135,"Iowa","Monroe County",2,27,83,39,44
050,19,135,"Iowa","Monroe County",2,28,84,46,38
050,19,135,"Iowa","Monroe County",2,29,80,44,36
050,19,135,"Iowa","Monroe County",2,30,78,37,41
050,19,135,"Iowa","Monroe County",2,31,71,37,34
050,19,135,"Iowa","Monroe County",2,32,82,46,36
050,19,135,"Iowa","Monroe County",2,33,82,42,40
050,19,135,"Iowa","Monroe County",2,34,76,39,37
050,19,135,"Iowa","Monroe County",2,35,81,41,40
050,19,135,"Iowa","Monroe County",2,36,87,42,45
050,19,135,"Iowa","Monroe County",2,37,90,45,45
050,19,135,"Iowa","Monroe County",2,38,96,53,43
050,19,135,"Iowa","Monroe County",2,39,97,54,43
050,19,135,"Iowa","Monroe County",2,40,99,52,47
050,19,135,"Iowa","Monroe County",2,41,93,51,42
050,19,135,"Iowa","Monroe County",2,42,82,39,43
050,19,135,"Iowa","Monroe County",2,43,81,35,46
050,19,135,"Iowa","Monroe County",2,44,85,39,46
050,19,135,"Iowa","Monroe County",2,45,81,40,41
050,19,135,"Iowa","Monroe County",2,46,73,37,36
050,19,135,"Iowa","Monroe County",2,47,78,44,34
050,19,135,"Iowa","Monroe County",2,48,87,43,44
050,19,135,"Iowa","Monroe County",2,49,106,53,53
050,19,135,"Iowa","Monroe County",2,50,103,55,48
050,19,135,"Iowa","Monroe County",2,51,97,52,45
050,19,135,"Iowa","Monroe County",2,52,99,53,46
050,19,135,"Iowa","Monroe County",2,53,100,53,47
050,19,135,"Iowa","Monroe County",2,54,102,50,52
050,19,135,"Iowa","Monroe County",2,55,99,45,54
050,19,135,"Iowa","Monroe County",2,56,104,52,52
050,19,135,"Iowa","Monroe County",2,57,111,52,59
050,19,135,"Iowa","Monroe County",2,58,112,51,61
050,19,135,"Iowa","Monroe County",2,59,120,56,64
050,19,135,"Iowa","Monroe County",2,60,110,54,56
050,19,135,"Iowa","Monroe County",2,61,111,55,56
050,19,135,"Iowa","Monroe County",2,62,125,63,62
050,19,135,"Iowa","Monroe County",2,63,112,61,51
050,19,135,"Iowa","Monroe County",2,64,99,49,50
050,19,135,"Iowa","Monroe County",2,65,108,55,53
050,19,135,"Iowa","Monroe County",2,66,96,50,46
050,19,135,"Iowa","Monroe County",2,67,97,52,45
050,19,135,"Iowa","Monroe County",2,68,96,52,44
050,19,135,"Iowa","Monroe County",2,69,91,47,44
050,19,135,"Iowa","Monroe County",2,70,79,34,45
050,19,135,"Iowa","Monroe County",2,71,83,34,49
050,19,135,"Iowa","Monroe County",2,72,78,32,46
050,19,135,"Iowa","Monroe County",2,73,92,42,50
050,19,135,"Iowa","Monroe County",2,74,65,29,36
050,19,135,"Iowa","Monroe County",2,75,62,28,34
050,19,135,"Iowa","Monroe County",2,76,58,29,29
050,19,135,"Iowa","Monroe County",2,77,54,27,27
050,19,135,"Iowa","Monroe County",2,78,48,25,23
050,19,135,"Iowa","Monroe County",2,79,45,22,23
050,19,135,"Iowa","Monroe County",2,80,48,20,28
050,19,135,"Iowa","Monroe County",2,81,38,14,24
050,19,135,"Iowa","Monroe County",2,82,40,19,21
050,19,135,"Iowa","Monroe County",2,83,37,18,19
050,19,135,"Iowa","Monroe County",2,84,33,16,17
050,19,135,"Iowa","Monroe County",2,85,158,50,108
050,19,135,"Iowa","Monroe County",3,0,74,43,31
050,19,135,"Iowa","Monroe County",3,1,96,47,49
050,19,135,"Iowa","Monroe County",3,2,91,44,47
050,19,135,"Iowa","Monroe County",3,3,90,45,45
050,19,135,"Iowa","Monroe County",3,4,87,44,43
050,19,135,"Iowa","Monroe County",3,5,94,51,43
050,19,135,"Iowa","Monroe County",3,6,89,43,46
050,19,135,"Iowa","Monroe County",3,7,88,41,47
050,19,135,"Iowa","Monroe County",3,8,88,41,47
050,19,135,"Iowa","Monroe County",3,9,84,43,41
050,19,135,"Iowa","Monroe County",3,10,98,53,45
050,19,135,"Iowa","Monroe County",3,11,102,52,50
050,19,135,"Iowa","Monroe County",3,12,116,63,53
050,19,135,"Iowa","Monroe County",3,13,114,60,54
050,19,135,"Iowa","Monroe County",3,14,127,67,60
050,19,135,"Iowa","Monroe County",3,15,117,61,56
050,19,135,"Iowa","Monroe County",3,16,101,49,52
050,19,135,"Iowa","Monroe County",3,17,117,61,56
050,19,135,"Iowa","Monroe County",3,18,94,53,41
050,19,135,"Iowa","Monroe County",3,19,64,31,33
050,19,135,"Iowa","Monroe County",3,20,75,36,39
050,19,135,"Iowa","Monroe County",3,21,78,46,32
050,19,135,"Iowa","Monroe County",3,22,80,46,34
050,19,135,"Iowa","Monroe County",3,23,93,52,41
050,19,135,"Iowa","Monroe County",3,24,88,46,42
050,19,135,"Iowa","Monroe County",3,25,90,46,44
050,19,135,"Iowa","Monroe County",3,26,85,43,42
050,19,135,"Iowa","Monroe County",3,27,78,40,38
050,19,135,"Iowa","Monroe County",3,28,86,38,48
050,19,135,"Iowa","Monroe County",3,29,88,47,41
050,19,135,"Iowa","Monroe County",3,30,79,44,35
050,19,135,"Iowa","Monroe County",3,31,82,37,45
050,19,135,"Iowa","Monroe County",3,32,71,38,33
050,19,135,"Iowa","Monroe County",3,33,85,45,40
050,19,135,"Iowa","Monroe County",3,34,81,41,40
050,19,135,"Iowa","Monroe County",3,35,77,40,37
050,19,135,"Iowa","Monroe County",3,36,84,41,43
050,19,135,"Iowa","Monroe County",3,37,87,43,44
050,19,135,"Iowa","Monroe County",3,38,86,42,44
050,19,135,"Iowa","Monroe County",3,39,101,53,48
050,19,135,"Iowa","Monroe County",3,40,99,54,45
050,19,135,"Iowa","Monroe County",3,41,101,56,45
050,19,135,"Iowa","Monroe County",3,42,96,51,45
050,19,135,"Iowa","Monroe County",3,43,85,40,45
050,19,135,"Iowa","Monroe County",3,44,83,38,45
050,19,135,"Iowa","Monroe County",3,45,77,35,42
050,19,135,"Iowa","Monroe County",3,46,81,41,40
050,19,135,"Iowa","Monroe County",3,47,71,35,36
050,19,135,"Iowa","Monroe County",3,48,80,45,35
050,19,135,"Iowa","Monroe County",3,49,89,45,44
050,19,135,"Iowa","Monroe County",3,50,102,50,52
050,19,135,"Iowa","Monroe County",3,51,106,57,49
050,19,135,"Iowa","Monroe County",3,52,95,48,47
050,19,135,"Iowa","Monroe County",3,53,101,54,47
050,19,135,"Iowa","Monroe County",3,54,104,57,47
050,19,135,"Iowa","Monroe County",3,55,101,49,52
050,19,135,"Iowa","Monroe County",3,56,100,46,54
050,19,135,"Iowa","Monroe County",3,57,102,51,51
050,19,135,"Iowa","Monroe County",3,58,112,53,59
050,19,135,"Iowa","Monroe County",3,59,111,51,60
050,19,135,"Iowa","Monroe County",3,60,126,59,67
050,19,135,"Iowa","Monroe County",3,61,110,52,58
050,19,135,"Iowa","Monroe County",3,62,112,56,56
050,19,135,"Iowa","Monroe County",3,63,126,63,63
050,19,135,"Iowa","Monroe County",3,64,107,58,49
050,19,135,"Iowa","Monroe County",3,65,99,49,50
050,19,135,"Iowa","Monroe County",3,66,107,58,49
050,19,135,"Iowa","Monroe County",3,67,91,48,43
050,19,135,"Iowa","Monroe County",3,68,92,48,44
050,19,135,"Iowa","Monroe County",3,69,94,53,41
050,19,135,"Iowa","Monroe County",3,70,88,42,46
050,19,135,"Iowa","Monroe County",3,71,75,31,44
050,19,135,"Iowa","Monroe County",3,72,80,33,47
050,19,135,"Iowa","Monroe County",3,73,75,31,44
050,19,135,"Iowa","Monroe County",3,74,88,40,48
050,19,135,"Iowa","Monroe County",3,75,61,25,36
050,19,135,"Iowa","Monroe County",3,76,56,27,29
050,19,135,"Iowa","Monroe County",3,77,53,25,28
050,19,135,"Iowa","Monroe County",3,78,49,19,30
050,19,135,"Iowa","Monroe County",3,79,48,24,24
050,19,135,"Iowa","Monroe County",3,80,45,22,23
050,19,135,"Iowa","Monroe County",3,81,45,20,25
050,19,135,"Iowa","Monroe County",3,82,31,12,19
050,19,135,"Iowa","Monroe County",3,83,36,17,19
050,19,135,"Iowa","Monroe County",3,84,31,15,16
050,19,135,"Iowa","Monroe County",3,85,155,53,102
050,19,135,"Iowa","Monroe County",4,0,82,46,36
050,19,135,"Iowa","Monroe County",4,1,73,44,29
050,19,135,"Iowa","Monroe County",4,2,94,43,51
050,19,135,"Iowa","Monroe County",4,3,93,46,47
050,19,135,"Iowa","Monroe County",4,4,90,48,42
050,19,135,"Iowa","Monroe County",4,5,90,46,44
050,19,135,"Iowa","Monroe County",4,6,92,53,39
050,19,135,"Iowa","Monroe County",4,7,84,44,40
050,19,135,"Iowa","Monroe County",4,8,96,43,53
050,19,135,"Iowa","Monroe County",4,9,84,38,46
050,19,135,"Iowa","Monroe County",4,10,81,39,42
050,19,135,"Iowa","Monroe County",4,11,96,52,44
050,19,135,"Iowa","Monroe County",4,12,94,50,44
050,19,135,"Iowa","Monroe County",4,13,112,57,55
050,19,135,"Iowa","Monroe County",4,14,119,63,56
050,19,135,"Iowa","Monroe County",4,15,127,64,63
050,19,135,"Iowa","Monroe County",4,16,115,58,57
050,19,135,"Iowa","Monroe County",4,17,105,52,53
050,19,135,"Iowa","Monroe County",4,18,101,55,46
050,19,135,"Iowa","Monroe County",4,19,77,46,31
050,19,135,"Iowa","Monroe County",4,20,66,33,33
050,19,135,"Iowa","Monroe County",4,21,76,36,40
050,19,135,"Iowa","Monroe County",4,22,90,50,40
050,19,135,"Iowa","Monroe County",4,23,88,51,37
050,19,135,"Iowa","Monroe County",4,24,91,51,40
050,19,135,"Iowa","Monroe County",4,25,86,47,39
050,19,135,"Iowa","Monroe County",4,26,86,47,39
050,19,135,"Iowa","Monroe County",4,27,82,41,41
050,19,135,"Iowa","Monroe County",4,28,77,39,38
050,19,135,"Iowa","Monroe County",4,29,84,37,47
050,19,135,"Iowa","Monroe County",4,30,90,50,40
050,19,135,"Iowa","Monroe County",4,31,78,42,36
050,19,135,"Iowa","Monroe County",4,32,80,35,45
050,19,135,"Iowa","Monroe County",4,33,77,41,36
050,19,135,"Iowa","Monroe County",4,34,83,45,38
050,19,135,"Iowa","Monroe County",4,35,78,38,40
050,19,135,"Iowa","Monroe County",4,36,66,33,33
050,19,135,"Iowa","Monroe County",4,37,78,38,40
050,19,135,"Iowa","Monroe County",4,38,89,44,45
050,19,135,"Iowa","Monroe County",4,39,87,42,45
050,19,135,"Iowa","Monroe County",4,40,100,53,47
050,19,135,"Iowa","Monroe County",4,41,101,54,47
050,19,135,"Iowa","Monroe County",4,42,102,56,46
050,19,135,"Iowa","Monroe County",4,43,98,52,46
050,19,135,"Iowa","Monroe County",4,44,85,39,46
050,19,135,"Iowa","Monroe County",4,45,80,36,44
050,19,135,"Iowa","Monroe County",4,46,74,35,39
050,19,135,"Iowa","Monroe County",4,47,80,43,37
050,19,135,"Iowa","Monroe County",4,48,73,36,37
050,19,135,"Iowa","Monroe County",4,49,78,43,35
050,19,135,"Iowa","Monroe County",4,50,89,46,43
050,19,135,"Iowa","Monroe County",4,51,102,48,54
050,19,135,"Iowa","Monroe County",4,52,107,56,51
050,19,135,"Iowa","Monroe County",4,53,95,51,44
050,19,135,"Iowa","Monroe County",4,54,102,55,47
050,19,135,"Iowa","Monroe County",4,55,103,56,47
050,19,135,"Iowa","Monroe County",4,56,98,48,50
050,19,135,"Iowa","Monroe County",4,57,95,43,52
050,19,135,"Iowa","Monroe County",4,58,104,49,55
050,19,135,"Iowa","Monroe County",4,59,118,59,59
050,19,135,"Iowa","Monroe County",4,60,110,51,59
050,19,135,"Iowa","Monroe County",4,61,127,58,69
050,19,135,"Iowa","Monroe County",4,62,107,53,54
050,19,135,"Iowa","Monroe County",4,63,116,57,59
050,19,135,"Iowa","Monroe County",4,64,126,64,62
050,19,135,"Iowa","Monroe County",4,65,102,57,45
050,19,135,"Iowa","Monroe County",4,66,98,49,49
050,19,135,"Iowa","Monroe County",4,67,104,57,47
050,19,135,"Iowa","Monroe County",4,68,87,44,43
050,19,135,"Iowa","Monroe County",4,69,86,46,40
050,19,135,"Iowa","Monroe County",4,70,93,52,41
050,19,135,"Iowa","Monroe County",4,71,84,42,42
050,19,135,"Iowa","Monroe County",4,72,76,32,44
050,19,135,"Iowa","Monroe County",4,73,82,36,46
050,19,135,"Iowa","Monroe County",4,74,72,28,44
050,19,135,"Iowa","Monroe County",4,75,87,41,46
050,19,135,"Iowa","Monroe County",4,76,57,23,34
050,19,135,"Iowa","Monroe County",4,77,53,26,27
050,19,135,"Iowa","Monroe County",4,78,49,22,27
050,19,135,"Iowa","Monroe County",4,79,48,18,30
050,19,135,"Iowa","Monroe County",4,80,47,25,22
050,19,135,"Iowa","Monroe County",4,81,44,21,23
050,19,135,"Iowa","Monroe County",4,82,37,18,19
050,19,135,"Iowa","Monroe County",4,83,27,10,17
050,19,135,"Iowa","Monroe County",4,84,31,16,15
050,19,135,"Iowa","Monroe County",4,85,159,58,101
050,19,135,"Iowa","Monroe County",5,0,83,46,37
050,19,135,"Iowa","Monroe County",5,1,89,46,43
050,19,135,"Iowa","Monroe County",5,2,74,40,34
050,19,135,"Iowa","Monroe County",5,3,97,43,54
050,19,135,"Iowa","Monroe County",5,4,91,46,45
050,19,135,"Iowa","Monroe County",5,5,90,47,43
050,19,135,"Iowa","Monroe County",5,6,91,43,48
050,19,135,"Iowa","Monroe County",5,7,92,52,40
050,19,135,"Iowa","Monroe County",5,8,85,45,40
050,19,135,"Iowa","Monroe County",5,9,100,45,55
050,19,135,"Iowa","Monroe County",5,10,90,40,50
050,19,135,"Iowa","Monroe County",5,11,83,40,43
050,19,135,"Iowa","Monroe County",5,12,95,52,43
050,19,135,"Iowa","Monroe County",5,13,93,49,44
050,19,135,"Iowa","Monroe County",5,14,107,55,52
050,19,135,"Iowa","Monroe County",5,15,117,63,54
050,19,135,"Iowa","Monroe County",5,16,127,66,61
050,19,135,"Iowa","Monroe County",5,17,110,55,55
050,19,135,"Iowa","Monroe County",5,18,85,42,43
050,19,135,"Iowa","Monroe County",5,19,83,42,41
050,19,135,"Iowa","Monroe County",5,20,89,50,39
050,19,135,"Iowa","Monroe County",5,21,76,37,39
050,19,135,"Iowa","Monroe County",5,22,77,36,41
050,19,135,"Iowa","Monroe County",5,23,93,52,41
050,19,135,"Iowa","Monroe County",5,24,87,46,41
050,19,135,"Iowa","Monroe County",5,25,89,50,39
050,19,135,"Iowa","Monroe County",5,26,77,39,38
050,19,135,"Iowa","Monroe County",5,27,84,50,34
050,19,135,"Iowa","Monroe County",5,28,82,40,42
050,19,135,"Iowa","Monroe County",5,29,76,38,38
050,19,135,"Iowa","Monroe County",5,30,90,39,51
050,19,135,"Iowa","Monroe County",5,31,91,49,42
050,19,135,"Iowa","Monroe County",5,32,76,41,35
050,19,135,"Iowa","Monroe County",5,33,80,35,45
050,19,135,"Iowa","Monroe County",5,34,72,35,37
050,19,135,"Iowa","Monroe County",5,35,89,49,40
050,19,135,"Iowa","Monroe County",5,36,79,38,41
050,19,135,"Iowa","Monroe County",5,37,66,34,32
050,19,135,"Iowa","Monroe County",5,38,73,34,39
050,19,135,"Iowa","Monroe County",5,39,86,43,43
050,19,135,"Iowa","Monroe County",5,40,86,42,44
050,19,135,"Iowa","Monroe County",5,41,97,53,44
050,19,135,"Iowa","Monroe County",5,42,96,52,44
050,19,135,"Iowa","Monroe County",5,43,102,58,44
050,19,135,"Iowa","Monroe County",5,44,97,51,46
050,19,135,"Iowa","Monroe County",5,45,82,39,43
050,19,135,"Iowa","Monroe County",5,46,84,36,48
050,19,135,"Iowa","Monroe County",5,47,76,36,40
050,19,135,"Iowa","Monroe County",5,48,78,44,34
050,19,135,"Iowa","Monroe County",5,49,76,36,40
050,19,135,"Iowa","Monroe County",5,50,79,44,35
050,19,135,"Iowa","Monroe County",5,51,87,47,40
050,19,135,"Iowa","Monroe County",5,52,101,47,54
050,19,135,"Iowa","Monroe County",5,53,107,58,49
050,19,135,"Iowa","Monroe County",5,54,95,51,44
050,19,135,"Iowa","Monroe County",5,55,102,55,47
050,19,135,"Iowa","Monroe County",5,56,106,60,46
050,19,135,"Iowa","Monroe County",5,57,100,51,49
050,19,135,"Iowa","Monroe County",5,58,93,41,52
050,19,135,"Iowa","Monroe County",5,59,107,52,55
050,19,135,"Iowa","Monroe County",5,60,117,59,58
050,19,135,"Iowa","Monroe County",5,61,115,56,59
050,19,135,"Iowa","Monroe County",5,62,125,57,68
050,19,135,"Iowa","Monroe County",5,63,115,56,59
050,19,135,"Iowa","Monroe County",5,64,114,58,56
050,19,135,"Iowa","Monroe County",5,65,120,58,62
050,19,135,"Iowa","Monroe County",5,66,99,56,43
050,19,135,"Iowa","Monroe County",5,67,104,54,50
050,19,135,"Iowa","Monroe County",5,68,100,52,48
050,19,135,"Iowa","Monroe County",5,69,83,43,40
050,19,135,"Iowa","Monroe County",5,70,83,42,41
050,19,135,"Iowa","Monroe County",5,71,87,49,38
050,19,135,"Iowa","Monroe County",5,72,82,42,40
050,19,135,"Iowa","Monroe County",5,73,77,32,45
050,19,135,"Iowa","Monroe County",5,74,80,35,45
050,19,135,"Iowa","Monroe County",5,75,67,26,41
050,19,135,"Iowa","Monroe County",5,76,81,41,40
050,19,135,"Iowa","Monroe County",5,77,54,23,31
050,19,135,"Iowa","Monroe County",5,78,46,24,22
050,19,135,"Iowa","Monroe County",5,79,48,21,27
050,19,135,"Iowa","Monroe County",5,80,46,18,28
050,19,135,"Iowa","Monroe County",5,81,45,24,21
050,19,135,"Iowa","Monroe County",5,82,34,19,15
050,19,135,"Iowa","Monroe County",5,83,34,16,18
050,19,135,"Iowa","Monroe County",5,84,20,8,12
050,19,135,"Iowa","Monroe County",5,85,163,63,100
050,19,137,"Iowa","Montgomery County",1,0,106,54,52
050,19,137,"Iowa","Montgomery County",1,1,113,59,54
050,19,137,"Iowa","Montgomery County",1,2,136,71,65
050,19,137,"Iowa","Montgomery County",1,3,139,73,66
050,19,137,"Iowa","Montgomery County",1,4,136,64,72
050,19,137,"Iowa","Montgomery County",1,5,134,68,66
050,19,137,"Iowa","Montgomery County",1,6,120,51,69
050,19,137,"Iowa","Montgomery County",1,7,108,50,58
050,19,137,"Iowa","Montgomery County",1,8,135,62,73
050,19,137,"Iowa","Montgomery County",1,9,114,58,56
050,19,137,"Iowa","Montgomery County",1,10,126,62,64
050,19,137,"Iowa","Montgomery County",1,11,131,61,70
050,19,137,"Iowa","Montgomery County",1,12,143,75,68
050,19,137,"Iowa","Montgomery County",1,13,156,82,74
050,19,137,"Iowa","Montgomery County",1,14,132,67,65
050,19,137,"Iowa","Montgomery County",1,15,138,74,64
050,19,137,"Iowa","Montgomery County",1,16,139,66,73
050,19,137,"Iowa","Montgomery County",1,17,148,80,68
050,19,137,"Iowa","Montgomery County",1,18,118,61,57
050,19,137,"Iowa","Montgomery County",1,19,93,50,43
050,19,137,"Iowa","Montgomery County",1,20,103,58,45
050,19,137,"Iowa","Montgomery County",1,21,113,56,57
050,19,137,"Iowa","Montgomery County",1,22,105,52,53
050,19,137,"Iowa","Montgomery County",1,23,110,49,61
050,19,137,"Iowa","Montgomery County",1,24,121,59,62
050,19,137,"Iowa","Montgomery County",1,25,116,61,55
050,19,137,"Iowa","Montgomery County",1,26,110,58,52
050,19,137,"Iowa","Montgomery County",1,27,95,48,47
050,19,137,"Iowa","Montgomery County",1,28,105,53,52
050,19,137,"Iowa","Montgomery County",1,29,114,58,56
050,19,137,"Iowa","Montgomery County",1,30,106,60,46
050,19,137,"Iowa","Montgomery County",1,31,111,60,51
050,19,137,"Iowa","Montgomery County",1,32,97,51,46
050,19,137,"Iowa","Montgomery County",1,33,104,51,53
050,19,137,"Iowa","Montgomery County",1,34,95,49,46
050,19,137,"Iowa","Montgomery County",1,35,110,54,56
050,19,137,"Iowa","Montgomery County",1,36,110,55,55
050,19,137,"Iowa","Montgomery County",1,37,111,63,48
050,19,137,"Iowa","Montgomery County",1,38,100,45,55
050,19,137,"Iowa","Montgomery County",1,39,109,58,51
050,19,137,"Iowa","Montgomery County",1,40,116,51,65
050,19,137,"Iowa","Montgomery County",1,41,112,54,58
050,19,137,"Iowa","Montgomery County",1,42,114,62,52
050,19,137,"Iowa","Montgomery County",1,43,112,62,50
050,19,137,"Iowa","Montgomery County",1,44,111,52,59
050,19,137,"Iowa","Montgomery County",1,45,121,58,63
050,19,137,"Iowa","Montgomery County",1,46,101,47,54
050,19,137,"Iowa","Montgomery County",1,47,114,55,59
050,19,137,"Iowa","Montgomery County",1,48,138,68,70
050,19,137,"Iowa","Montgomery County",1,49,134,70,64
050,19,137,"Iowa","Montgomery County",1,50,127,63,64
050,19,137,"Iowa","Montgomery County",1,51,121,63,58
050,19,137,"Iowa","Montgomery County",1,52,123,62,61
050,19,137,"Iowa","Montgomery County",1,53,122,66,56
050,19,137,"Iowa","Montgomery County",1,54,131,64,67
050,19,137,"Iowa","Montgomery County",1,55,145,70,75
050,19,137,"Iowa","Montgomery County",1,56,141,70,71
050,19,137,"Iowa","Montgomery County",1,57,149,75,74
050,19,137,"Iowa","Montgomery County",1,58,157,69,88
050,19,137,"Iowa","Montgomery County",1,59,164,78,86
050,19,137,"Iowa","Montgomery County",1,60,172,92,80
050,19,137,"Iowa","Montgomery County",1,61,164,88,76
050,19,137,"Iowa","Montgomery County",1,62,169,84,85
050,19,137,"Iowa","Montgomery County",1,63,173,97,76
050,19,137,"Iowa","Montgomery County",1,64,174,85,89
050,19,137,"Iowa","Montgomery County",1,65,163,75,88
050,19,137,"Iowa","Montgomery County",1,66,136,73,63
050,19,137,"Iowa","Montgomery County",1,67,133,71,62
050,19,137,"Iowa","Montgomery County",1,68,149,74,75
050,19,137,"Iowa","Montgomery County",1,69,128,69,59
050,19,137,"Iowa","Montgomery County",1,70,116,58,58
050,19,137,"Iowa","Montgomery County",1,71,108,48,60
050,19,137,"Iowa","Montgomery County",1,72,126,63,63
050,19,137,"Iowa","Montgomery County",1,73,108,55,53
050,19,137,"Iowa","Montgomery County",1,74,81,40,41
050,19,137,"Iowa","Montgomery County",1,75,80,38,42
050,19,137,"Iowa","Montgomery County",1,76,61,27,34
050,19,137,"Iowa","Montgomery County",1,77,84,34,50
050,19,137,"Iowa","Montgomery County",1,78,73,31,42
050,19,137,"Iowa","Montgomery County",1,79,75,30,45
050,19,137,"Iowa","Montgomery County",1,80,72,32,40
050,19,137,"Iowa","Montgomery County",1,81,51,17,34
050,19,137,"Iowa","Montgomery County",1,82,52,21,31
050,19,137,"Iowa","Montgomery County",1,83,47,16,31
050,19,137,"Iowa","Montgomery County",1,84,42,19,23
050,19,137,"Iowa","Montgomery County",1,85,329,101,228
050,19,137,"Iowa","Montgomery County",2,0,106,56,50
050,19,137,"Iowa","Montgomery County",2,1,110,58,52
050,19,137,"Iowa","Montgomery County",2,2,131,69,62
050,19,137,"Iowa","Montgomery County",2,3,137,73,64
050,19,137,"Iowa","Montgomery County",2,4,140,68,72
050,19,137,"Iowa","Montgomery County",2,5,133,67,66
050,19,137,"Iowa","Montgomery County",2,6,125,56,69
050,19,137,"Iowa","Montgomery County",2,7,111,51,60
050,19,137,"Iowa","Montgomery County",2,8,131,61,70
050,19,137,"Iowa","Montgomery County",2,9,119,59,60
050,19,137,"Iowa","Montgomery County",2,10,124,61,63
050,19,137,"Iowa","Montgomery County",2,11,129,61,68
050,19,137,"Iowa","Montgomery County",2,12,141,72,69
050,19,137,"Iowa","Montgomery County",2,13,151,79,72
050,19,137,"Iowa","Montgomery County",2,14,137,70,67
050,19,137,"Iowa","Montgomery County",2,15,138,73,65
050,19,137,"Iowa","Montgomery County",2,16,142,69,73
050,19,137,"Iowa","Montgomery County",2,17,145,76,69
050,19,137,"Iowa","Montgomery County",2,18,118,63,55
050,19,137,"Iowa","Montgomery County",2,19,92,49,43
050,19,137,"Iowa","Montgomery County",2,20,103,57,46
050,19,137,"Iowa","Montgomery County",2,21,111,56,55
050,19,137,"Iowa","Montgomery County",2,22,107,52,55
050,19,137,"Iowa","Montgomery County",2,23,112,52,60
050,19,137,"Iowa","Montgomery County",2,24,119,57,62
050,19,137,"Iowa","Montgomery County",2,25,118,61,57
050,19,137,"Iowa","Montgomery County",2,26,111,59,52
050,19,137,"Iowa","Montgomery County",2,27,100,52,48
050,19,137,"Iowa","Montgomery County",2,28,105,53,52
050,19,137,"Iowa","Montgomery County",2,29,112,57,55
050,19,137,"Iowa","Montgomery County",2,30,111,62,49
050,19,137,"Iowa","Montgomery County",2,31,107,58,49
050,19,137,"Iowa","Montgomery County",2,32,100,53,47
050,19,137,"Iowa","Montgomery County",2,33,102,50,52
050,19,137,"Iowa","Montgomery County",2,34,100,51,49
050,19,137,"Iowa","Montgomery County",2,35,109,54,55
050,19,137,"Iowa","Montgomery County",2,36,106,53,53
050,19,137,"Iowa","Montgomery County",2,37,111,62,49
050,19,137,"Iowa","Montgomery County",2,38,105,51,54
050,19,137,"Iowa","Montgomery County",2,39,106,55,51
050,19,137,"Iowa","Montgomery County",2,40,114,53,61
050,19,137,"Iowa","Montgomery County",2,41,112,53,59
050,19,137,"Iowa","Montgomery County",2,42,112,60,52
050,19,137,"Iowa","Montgomery County",2,43,114,62,52
050,19,137,"Iowa","Montgomery County",2,44,112,55,57
050,19,137,"Iowa","Montgomery County",2,45,119,57,62
050,19,137,"Iowa","Montgomery County",2,46,105,49,56
050,19,137,"Iowa","Montgomery County",2,47,110,53,57
050,19,137,"Iowa","Montgomery County",2,48,134,66,68
050,19,137,"Iowa","Montgomery County",2,49,136,71,65
050,19,137,"Iowa","Montgomery County",2,50,129,65,64
050,19,137,"Iowa","Montgomery County",2,51,122,62,60
050,19,137,"Iowa","Montgomery County",2,52,121,61,60
050,19,137,"Iowa","Montgomery County",2,53,122,65,57
050,19,137,"Iowa","Montgomery County",2,54,129,65,64
050,19,137,"Iowa","Montgomery County",2,55,141,68,73
050,19,137,"Iowa","Montgomery County",2,56,140,68,72
050,19,137,"Iowa","Montgomery County",2,57,148,74,74
050,19,137,"Iowa","Montgomery County",2,58,152,69,83
050,19,137,"Iowa","Montgomery County",2,59,163,77,86
050,19,137,"Iowa","Montgomery County",2,60,170,88,82
050,19,137,"Iowa","Montgomery County",2,61,166,89,77
050,19,137,"Iowa","Montgomery County",2,62,169,86,83
050,19,137,"Iowa","Montgomery County",2,63,174,95,79
050,19,137,"Iowa","Montgomery County",2,64,172,87,85
050,19,137,"Iowa","Montgomery County",2,65,166,77,89
050,19,137,"Iowa","Montgomery County",2,66,143,73,70
050,19,137,"Iowa","Montgomery County",2,67,135,72,63
050,19,137,"Iowa","Montgomery County",2,68,144,73,71
050,19,137,"Iowa","Montgomery County",2,69,134,71,63
050,19,137,"Iowa","Montgomery County",2,70,118,60,58
050,19,137,"Iowa","Montgomery County",2,71,111,51,60
050,19,137,"Iowa","Montgomery County",2,72,120,58,62
050,19,137,"Iowa","Montgomery County",2,73,118,60,58
050,19,137,"Iowa","Montgomery County",2,74,81,40,41
050,19,137,"Iowa","Montgomery County",2,75,77,38,39
050,19,137,"Iowa","Montgomery County",2,76,66,30,36
050,19,137,"Iowa","Montgomery County",2,77,81,33,48
050,19,137,"Iowa","Montgomery County",2,78,73,31,42
050,19,137,"Iowa","Montgomery County",2,79,74,30,44
050,19,137,"Iowa","Montgomery County",2,80,71,31,40
050,19,137,"Iowa","Montgomery County",2,81,55,20,35
050,19,137,"Iowa","Montgomery County",2,82,51,20,31
050,19,137,"Iowa","Montgomery County",2,83,48,17,31
050,19,137,"Iowa","Montgomery County",2,84,42,18,24
050,19,137,"Iowa","Montgomery County",2,85,324,98,226
050,19,137,"Iowa","Montgomery County",3,0,102,53,49
050,19,137,"Iowa","Montgomery County",3,1,114,61,53
050,19,137,"Iowa","Montgomery County",3,2,106,53,53
050,19,137,"Iowa","Montgomery County",3,3,136,73,63
050,19,137,"Iowa","Montgomery County",3,4,144,76,68
050,19,137,"Iowa","Montgomery County",3,5,138,65,73
050,19,137,"Iowa","Montgomery County",3,6,130,60,70
050,19,137,"Iowa","Montgomery County",3,7,121,56,65
050,19,137,"Iowa","Montgomery County",3,8,124,64,60
050,19,137,"Iowa","Montgomery County",3,9,134,58,76
050,19,137,"Iowa","Montgomery County",3,10,121,61,60
050,19,137,"Iowa","Montgomery County",3,11,120,61,59
050,19,137,"Iowa","Montgomery County",3,12,144,75,69
050,19,137,"Iowa","Montgomery County",3,13,143,68,75
050,19,137,"Iowa","Montgomery County",3,14,160,83,77
050,19,137,"Iowa","Montgomery County",3,15,136,72,64
050,19,137,"Iowa","Montgomery County",3,16,136,70,66
050,19,137,"Iowa","Montgomery County",3,17,142,69,73
050,19,137,"Iowa","Montgomery County",3,18,125,66,59
050,19,137,"Iowa","Montgomery County",3,19,99,54,45
050,19,137,"Iowa","Montgomery County",3,20,100,52,48
050,19,137,"Iowa","Montgomery County",3,21,110,62,48
050,19,137,"Iowa","Montgomery County",3,22,114,61,53
050,19,137,"Iowa","Montgomery County",3,23,107,59,48
050,19,137,"Iowa","Montgomery County",3,24,113,53,60
050,19,137,"Iowa","Montgomery County",3,25,110,55,55
050,19,137,"Iowa","Montgomery County",3,26,127,65,62
050,19,137,"Iowa","Montgomery County",3,27,106,52,54
050,19,137,"Iowa","Montgomery County",3,28,106,55,51
050,19,137,"Iowa","Montgomery County",3,29,111,57,54
050,19,137,"Iowa","Montgomery County",3,30,112,56,56
050,19,137,"Iowa","Montgomery County",3,31,121,67,54
050,19,137,"Iowa","Montgomery County",3,32,111,57,54
050,19,137,"Iowa","Montgomery County",3,33,111,60,51
050,19,137,"Iowa","Montgomery County",3,34,95,44,51
050,19,137,"Iowa","Montgomery County",3,35,110,58,52
050,19,137,"Iowa","Montgomery County",3,36,103,50,53
050,19,137,"Iowa","Montgomery County",3,37,106,54,52
050,19,137,"Iowa","Montgomery County",3,38,111,63,48
050,19,137,"Iowa","Montgomery County",3,39,110,54,56
050,19,137,"Iowa","Montgomery County",3,40,113,59,54
050,19,137,"Iowa","Montgomery County",3,41,109,50,59
050,19,137,"Iowa","Montgomery County",3,42,110,55,55
050,19,137,"Iowa","Montgomery County",3,43,122,66,56
050,19,137,"Iowa","Montgomery County",3,44,114,62,52
050,19,137,"Iowa","Montgomery County",3,45,112,55,57
050,19,137,"Iowa","Montgomery County",3,46,122,59,63
050,19,137,"Iowa","Montgomery County",3,47,107,50,57
050,19,137,"Iowa","Montgomery County",3,48,109,53,56
050,19,137,"Iowa","Montgomery County",3,49,132,67,65
050,19,137,"Iowa","Montgomery County",3,50,137,69,68
050,19,137,"Iowa","Montgomery County",3,51,128,65,63
050,19,137,"Iowa","Montgomery County",3,52,119,57,62
050,19,137,"Iowa","Montgomery County",3,53,119,61,58
050,19,137,"Iowa","Montgomery County",3,54,112,62,50
050,19,137,"Iowa","Montgomery County",3,55,124,63,61
050,19,137,"Iowa","Montgomery County",3,56,135,64,71
050,19,137,"Iowa","Montgomery County",3,57,140,67,73
050,19,137,"Iowa","Montgomery County",3,58,151,74,77
050,19,137,"Iowa","Montgomery County",3,59,156,71,85
050,19,137,"Iowa","Montgomery County",3,60,164,78,86
050,19,137,"Iowa","Montgomery County",3,61,161,85,76
050,19,137,"Iowa","Montgomery County",3,62,162,86,76
050,19,137,"Iowa","Montgomery County",3,63,166,88,78
050,19,137,"Iowa","Montgomery County",3,64,170,93,77
050,19,137,"Iowa","Montgomery County",3,65,165,81,84
050,19,137,"Iowa","Montgomery County",3,66,161,74,87
050,19,137,"Iowa","Montgomery County",3,67,134,69,65
050,19,137,"Iowa","Montgomery County",3,68,132,70,62
050,19,137,"Iowa","Montgomery County",3,69,134,68,66
050,19,137,"Iowa","Montgomery County",3,70,124,65,59
050,19,137,"Iowa","Montgomery County",3,71,117,59,58
050,19,137,"Iowa","Montgomery County",3,72,108,50,58
050,19,137,"Iowa","Montgomery County",3,73,114,54,60
050,19,137,"Iowa","Montgomery County",3,74,107,51,56
050,19,137,"Iowa","Montgomery County",3,75,79,40,39
050,19,137,"Iowa","Montgomery County",3,76,76,39,37
050,19,137,"Iowa","Montgomery County",3,77,67,27,40
050,19,137,"Iowa","Montgomery County",3,78,75,31,44
050,19,137,"Iowa","Montgomery County",3,79,75,29,46
050,19,137,"Iowa","Montgomery County",3,80,71,28,43
050,19,137,"Iowa","Montgomery County",3,81,71,31,40
050,19,137,"Iowa","Montgomery County",3,82,49,17,32
050,19,137,"Iowa","Montgomery County",3,83,51,21,30
050,19,137,"Iowa","Montgomery County",3,84,42,15,27
050,19,137,"Iowa","Montgomery County",3,85,301,86,215
050,19,137,"Iowa","Montgomery County",4,0,105,57,48
050,19,137,"Iowa","Montgomery County",4,1,103,54,49
050,19,137,"Iowa","Montgomery County",4,2,120,66,54
050,19,137,"Iowa","Montgomery County",4,3,104,47,57
050,19,137,"Iowa","Montgomery County",4,4,127,73,54
050,19,137,"Iowa","Montgomery County",4,5,144,75,69
050,19,137,"Iowa","Montgomery County",4,6,134,62,72
050,19,137,"Iowa","Montgomery County",4,7,131,61,70
050,19,137,"Iowa","Montgomery County",4,8,121,53,68
050,19,137,"Iowa","Montgomery County",4,9,113,59,54
050,19,137,"Iowa","Montgomery County",4,10,135,58,77
050,19,137,"Iowa","Montgomery County",4,11,128,71,57
050,19,137,"Iowa","Montgomery County",4,12,129,63,66
050,19,137,"Iowa","Montgomery County",4,13,146,71,75
050,19,137,"Iowa","Montgomery County",4,14,150,70,80
050,19,137,"Iowa","Montgomery County",4,15,155,80,75
050,19,137,"Iowa","Montgomery County",4,16,138,73,65
050,19,137,"Iowa","Montgomery County",4,17,130,68,62
050,19,137,"Iowa","Montgomery County",4,18,112,55,57
050,19,137,"Iowa","Montgomery County",4,19,94,49,45
050,19,137,"Iowa","Montgomery County",4,20,107,58,49
050,19,137,"Iowa","Montgomery County",4,21,106,55,51
050,19,137,"Iowa","Montgomery County",4,22,109,64,45
050,19,137,"Iowa","Montgomery County",4,23,108,53,55
050,19,137,"Iowa","Montgomery County",4,24,105,59,46
050,19,137,"Iowa","Montgomery County",4,25,112,50,62
050,19,137,"Iowa","Montgomery County",4,26,111,53,58
050,19,137,"Iowa","Montgomery County",4,27,137,71,66
050,19,137,"Iowa","Montgomery County",4,28,108,58,50
050,19,137,"Iowa","Montgomery County",4,29,102,55,47
050,19,137,"Iowa","Montgomery County",4,30,108,52,56
050,19,137,"Iowa","Montgomery County",4,31,115,61,54
050,19,137,"Iowa","Montgomery County",4,32,119,62,57
050,19,137,"Iowa","Montgomery County",4,33,117,60,57
050,19,137,"Iowa","Montgomery County",4,34,108,59,49
050,19,137,"Iowa","Montgomery County",4,35,96,44,52
050,19,137,"Iowa","Montgomery County",4,36,113,58,55
050,19,137,"Iowa","Montgomery County",4,37,106,54,52
050,19,137,"Iowa","Montgomery County",4,38,104,54,50
050,19,137,"Iowa","Montgomery County",4,39,111,62,49
050,19,137,"Iowa","Montgomery County",4,40,116,56,60
050,19,137,"Iowa","Montgomery County",4,41,106,53,53
050,19,137,"Iowa","Montgomery County",4,42,112,52,60
050,19,137,"Iowa","Montgomery County",4,43,117,61,56
050,19,137,"Iowa","Montgomery County",4,44,121,66,55
050,19,137,"Iowa","Montgomery County",4,45,109,62,47
050,19,137,"Iowa","Montgomery County",4,46,115,57,58
050,19,137,"Iowa","Montgomery County",4,47,123,59,64
050,19,137,"Iowa","Montgomery County",4,48,106,51,55
050,19,137,"Iowa","Montgomery County",4,49,117,54,63
050,19,137,"Iowa","Montgomery County",4,50,130,65,65
050,19,137,"Iowa","Montgomery County",4,51,133,67,66
050,19,137,"Iowa","Montgomery County",4,52,123,64,59
050,19,137,"Iowa","Montgomery County",4,53,120,55,65
050,19,137,"Iowa","Montgomery County",4,54,119,62,57
050,19,137,"Iowa","Montgomery County",4,55,113,61,52
050,19,137,"Iowa","Montgomery County",4,56,122,62,60
050,19,137,"Iowa","Montgomery County",4,57,131,61,70
050,19,137,"Iowa","Montgomery County",4,58,141,69,72
050,19,137,"Iowa","Montgomery County",4,59,149,72,77
050,19,137,"Iowa","Montgomery County",4,60,146,62,84
050,19,137,"Iowa","Montgomery County",4,61,161,76,85
050,19,137,"Iowa","Montgomery County",4,62,162,89,73
050,19,137,"Iowa","Montgomery County",4,63,161,86,75
050,19,137,"Iowa","Montgomery County",4,64,162,86,76
050,19,137,"Iowa","Montgomery County",4,65,163,90,73
050,19,137,"Iowa","Montgomery County",4,66,157,77,80
050,19,137,"Iowa","Montgomery County",4,67,153,72,81
050,19,137,"Iowa","Montgomery County",4,68,128,67,61
050,19,137,"Iowa","Montgomery County",4,69,123,65,58
050,19,137,"Iowa","Montgomery County",4,70,127,65,62
050,19,137,"Iowa","Montgomery County",4,71,122,64,58
050,19,137,"Iowa","Montgomery County",4,72,115,58,57
050,19,137,"Iowa","Montgomery County",4,73,103,48,55
050,19,137,"Iowa","Montgomery County",4,74,111,51,60
050,19,137,"Iowa","Montgomery County",4,75,104,49,55
050,19,137,"Iowa","Montgomery County",4,76,75,38,37
050,19,137,"Iowa","Montgomery County",4,77,74,33,41
050,19,137,"Iowa","Montgomery County",4,78,59,25,34
050,19,137,"Iowa","Montgomery County",4,79,76,31,45
050,19,137,"Iowa","Montgomery County",4,80,71,27,44
050,19,137,"Iowa","Montgomery County",4,81,70,27,43
050,19,137,"Iowa","Montgomery County",4,82,64,28,36
050,19,137,"Iowa","Montgomery County",4,83,48,15,33
050,19,137,"Iowa","Montgomery County",4,84,44,20,24
050,19,137,"Iowa","Montgomery County",4,85,287,78,209
050,19,137,"Iowa","Montgomery County",5,0,98,54,44
050,19,137,"Iowa","Montgomery County",5,1,105,55,50
050,19,137,"Iowa","Montgomery County",5,2,110,59,51
050,19,137,"Iowa","Montgomery County",5,3,124,71,53
050,19,137,"Iowa","Montgomery County",5,4,107,50,57
050,19,137,"Iowa","Montgomery County",5,5,132,72,60
050,19,137,"Iowa","Montgomery County",5,6,142,72,70
050,19,137,"Iowa","Montgomery County",5,7,123,53,70
050,19,137,"Iowa","Montgomery County",5,8,124,60,64
050,19,137,"Iowa","Montgomery County",5,9,126,58,68
050,19,137,"Iowa","Montgomery County",5,10,115,61,54
050,19,137,"Iowa","Montgomery County",5,11,131,60,71
050,19,137,"Iowa","Montgomery County",5,12,123,70,53
050,19,137,"Iowa","Montgomery County",5,13,127,63,64
050,19,137,"Iowa","Montgomery County",5,14,144,71,73
050,19,137,"Iowa","Montgomery County",5,15,145,66,79
050,19,137,"Iowa","Montgomery County",5,16,155,80,75
050,19,137,"Iowa","Montgomery County",5,17,135,69,66
050,19,137,"Iowa","Montgomery County",5,18,105,55,50
050,19,137,"Iowa","Montgomery County",5,19,86,45,41
050,19,137,"Iowa","Montgomery County",5,20,97,54,43
050,19,137,"Iowa","Montgomery County",5,21,108,54,54
050,19,137,"Iowa","Montgomery County",5,22,105,53,52
050,19,137,"Iowa","Montgomery County",5,23,116,67,49
050,19,137,"Iowa","Montgomery County",5,24,112,53,59
050,19,137,"Iowa","Montgomery County",5,25,112,63,49
050,19,137,"Iowa","Montgomery County",5,26,114,50,64
050,19,137,"Iowa","Montgomery County",5,27,106,53,53
050,19,137,"Iowa","Montgomery County",5,28,134,64,70
050,19,137,"Iowa","Montgomery County",5,29,107,60,47
050,19,137,"Iowa","Montgomery County",5,30,114,59,55
050,19,137,"Iowa","Montgomery County",5,31,104,45,59
050,19,137,"Iowa","Montgomery County",5,32,117,62,55
050,19,137,"Iowa","Montgomery County",5,33,119,65,54
050,19,137,"Iowa","Montgomery County",5,34,116,57,59
050,19,137,"Iowa","Montgomery County",5,35,106,58,48
050,19,137,"Iowa","Montgomery County",5,36,102,50,52
050,19,137,"Iowa","Montgomery County",5,37,118,61,57
050,19,137,"Iowa","Montgomery County",5,38,112,59,53
050,19,137,"Iowa","Montgomery County",5,39,103,53,50
050,19,137,"Iowa","Montgomery County",5,40,109,65,44
050,19,137,"Iowa","Montgomery County",5,41,109,53,56
050,19,137,"Iowa","Montgomery County",5,42,114,57,57
050,19,137,"Iowa","Montgomery County",5,43,106,48,58
050,19,137,"Iowa","Montgomery County",5,44,120,61,59
050,19,137,"Iowa","Montgomery County",5,45,115,61,54
050,19,137,"Iowa","Montgomery County",5,46,107,59,48
050,19,137,"Iowa","Montgomery County",5,47,114,52,62
050,19,137,"Iowa","Montgomery County",5,48,117,54,63
050,19,137,"Iowa","Montgomery County",5,49,103,50,53
050,19,137,"Iowa","Montgomery County",5,50,114,54,60
050,19,137,"Iowa","Montgomery County",5,51,131,65,66
050,19,137,"Iowa","Montgomery County",5,52,136,69,67
050,19,137,"Iowa","Montgomery County",5,53,129,63,66
050,19,137,"Iowa","Montgomery County",5,54,115,53,62
050,19,137,"Iowa","Montgomery County",5,55,116,59,57
050,19,137,"Iowa","Montgomery County",5,56,112,63,49
050,19,137,"Iowa","Montgomery County",5,57,125,64,61
050,19,137,"Iowa","Montgomery County",5,58,131,58,73
050,19,137,"Iowa","Montgomery County",5,59,142,70,72
050,19,137,"Iowa","Montgomery County",5,60,143,67,76
050,19,137,"Iowa","Montgomery County",5,61,148,62,86
050,19,137,"Iowa","Montgomery County",5,62,158,74,84
050,19,137,"Iowa","Montgomery County",5,63,163,89,74
050,19,137,"Iowa","Montgomery County",5,64,150,79,71
050,19,137,"Iowa","Montgomery County",5,65,160,86,74
050,19,137,"Iowa","Montgomery County",5,66,159,86,73
050,19,137,"Iowa","Montgomery County",5,67,161,81,80
050,19,137,"Iowa","Montgomery County",5,68,142,66,76
050,19,137,"Iowa","Montgomery County",5,69,124,65,59
050,19,137,"Iowa","Montgomery County",5,70,116,62,54
050,19,137,"Iowa","Montgomery County",5,71,131,67,64
050,19,137,"Iowa","Montgomery County",5,72,124,65,59
050,19,137,"Iowa","Montgomery County",5,73,109,53,56
050,19,137,"Iowa","Montgomery County",5,74,101,45,56
050,19,137,"Iowa","Montgomery County",5,75,107,50,57
050,19,137,"Iowa","Montgomery County",5,76,100,48,52
050,19,137,"Iowa","Montgomery County",5,77,74,34,40
050,19,137,"Iowa","Montgomery County",5,78,66,31,35
050,19,137,"Iowa","Montgomery County",5,79,62,26,36
050,19,137,"Iowa","Montgomery County",5,80,69,27,42
050,19,137,"Iowa","Montgomery County",5,81,74,25,49
050,19,137,"Iowa","Montgomery County",5,82,64,27,37
050,19,137,"Iowa","Montgomery County",5,83,64,27,37
050,19,137,"Iowa","Montgomery County",5,84,40,12,28
050,19,137,"Iowa","Montgomery County",5,85,286,81,205
050,19,139,"Iowa","Muscatine County",1,0,514,263,251
050,19,139,"Iowa","Muscatine County",1,1,513,266,247
050,19,139,"Iowa","Muscatine County",1,2,545,267,278
050,19,139,"Iowa","Muscatine County",1,3,558,275,283
050,19,139,"Iowa","Muscatine County",1,4,555,291,264
050,19,139,"Iowa","Muscatine County",1,5,573,301,272
050,19,139,"Iowa","Muscatine County",1,6,604,306,298
050,19,139,"Iowa","Muscatine County",1,7,569,299,270
050,19,139,"Iowa","Muscatine County",1,8,575,303,272
050,19,139,"Iowa","Muscatine County",1,9,581,291,290
050,19,139,"Iowa","Muscatine County",1,10,642,324,318
050,19,139,"Iowa","Muscatine County",1,11,657,330,327
050,19,139,"Iowa","Muscatine County",1,12,680,346,334
050,19,139,"Iowa","Muscatine County",1,13,644,320,324
050,19,139,"Iowa","Muscatine County",1,14,610,308,302
050,19,139,"Iowa","Muscatine County",1,15,586,303,283
050,19,139,"Iowa","Muscatine County",1,16,630,314,316
050,19,139,"Iowa","Muscatine County",1,17,628,308,320
050,19,139,"Iowa","Muscatine County",1,18,562,298,264
050,19,139,"Iowa","Muscatine County",1,19,477,240,237
050,19,139,"Iowa","Muscatine County",1,20,495,248,247
050,19,139,"Iowa","Muscatine County",1,21,489,255,234
050,19,139,"Iowa","Muscatine County",1,22,492,252,240
050,19,139,"Iowa","Muscatine County",1,23,489,253,236
050,19,139,"Iowa","Muscatine County",1,24,489,255,234
050,19,139,"Iowa","Muscatine County",1,25,535,280,255
050,19,139,"Iowa","Muscatine County",1,26,549,294,255
050,19,139,"Iowa","Muscatine County",1,27,540,287,253
050,19,139,"Iowa","Muscatine County",1,28,561,280,281
050,19,139,"Iowa","Muscatine County",1,29,583,294,289
050,19,139,"Iowa","Muscatine County",1,30,572,285,287
050,19,139,"Iowa","Muscatine County",1,31,515,273,242
050,19,139,"Iowa","Muscatine County",1,32,475,260,215
050,19,139,"Iowa","Muscatine County",1,33,526,272,254
050,19,139,"Iowa","Muscatine County",1,34,533,284,249
050,19,139,"Iowa","Muscatine County",1,35,511,266,245
050,19,139,"Iowa","Muscatine County",1,36,511,278,233
050,19,139,"Iowa","Muscatine County",1,37,538,263,275
050,19,139,"Iowa","Muscatine County",1,38,580,294,286
050,19,139,"Iowa","Muscatine County",1,39,564,285,279
050,19,139,"Iowa","Muscatine County",1,40,551,283,268
050,19,139,"Iowa","Muscatine County",1,41,505,260,245
050,19,139,"Iowa","Muscatine County",1,42,529,280,249
050,19,139,"Iowa","Muscatine County",1,43,490,251,239
050,19,139,"Iowa","Muscatine County",1,44,484,246,238
050,19,139,"Iowa","Muscatine County",1,45,486,243,243
050,19,139,"Iowa","Muscatine County",1,46,466,245,221
050,19,139,"Iowa","Muscatine County",1,47,498,259,239
050,19,139,"Iowa","Muscatine County",1,48,528,269,259
050,19,139,"Iowa","Muscatine County",1,49,562,283,279
050,19,139,"Iowa","Muscatine County",1,50,506,247,259
050,19,139,"Iowa","Muscatine County",1,51,538,262,276
050,19,139,"Iowa","Muscatine County",1,52,522,251,271
050,19,139,"Iowa","Muscatine County",1,53,547,285,262
050,19,139,"Iowa","Muscatine County",1,54,520,272,248
050,19,139,"Iowa","Muscatine County",1,55,555,290,265
050,19,139,"Iowa","Muscatine County",1,56,562,280,282
050,19,139,"Iowa","Muscatine County",1,57,598,304,294
050,19,139,"Iowa","Muscatine County",1,58,615,319,296
050,19,139,"Iowa","Muscatine County",1,59,604,307,297
050,19,139,"Iowa","Muscatine County",1,60,586,296,290
050,19,139,"Iowa","Muscatine County",1,61,592,310,282
050,19,139,"Iowa","Muscatine County",1,62,586,292,294
050,19,139,"Iowa","Muscatine County",1,63,551,278,273
050,19,139,"Iowa","Muscatine County",1,64,551,275,276
050,19,139,"Iowa","Muscatine County",1,65,545,284,261
050,19,139,"Iowa","Muscatine County",1,66,510,252,258
050,19,139,"Iowa","Muscatine County",1,67,472,227,245
050,19,139,"Iowa","Muscatine County",1,68,451,208,243
050,19,139,"Iowa","Muscatine County",1,69,453,223,230
050,19,139,"Iowa","Muscatine County",1,70,440,214,226
050,19,139,"Iowa","Muscatine County",1,71,448,207,241
050,19,139,"Iowa","Muscatine County",1,72,442,210,232
050,19,139,"Iowa","Muscatine County",1,73,425,213,212
050,19,139,"Iowa","Muscatine County",1,74,300,148,152
050,19,139,"Iowa","Muscatine County",1,75,279,143,136
050,19,139,"Iowa","Muscatine County",1,76,281,137,144
050,19,139,"Iowa","Muscatine County",1,77,281,120,161
050,19,139,"Iowa","Muscatine County",1,78,247,112,135
050,19,139,"Iowa","Muscatine County",1,79,205,82,123
050,19,139,"Iowa","Muscatine County",1,80,188,74,114
050,19,139,"Iowa","Muscatine County",1,81,195,96,99
050,19,139,"Iowa","Muscatine County",1,82,163,73,90
050,19,139,"Iowa","Muscatine County",1,83,145,62,83
050,19,139,"Iowa","Muscatine County",1,84,128,49,79
050,19,139,"Iowa","Muscatine County",1,85,860,281,579
050,19,139,"Iowa","Muscatine County",2,0,488,261,227
050,19,139,"Iowa","Muscatine County",2,1,511,265,246
050,19,139,"Iowa","Muscatine County",2,2,536,267,269
050,19,139,"Iowa","Muscatine County",2,3,555,275,280
050,19,139,"Iowa","Muscatine County",2,4,558,288,270
050,19,139,"Iowa","Muscatine County",2,5,571,300,271
050,19,139,"Iowa","Muscatine County",2,6,598,308,290
050,19,139,"Iowa","Muscatine County",2,7,579,301,278
050,19,139,"Iowa","Muscatine County",2,8,570,297,273
050,19,139,"Iowa","Muscatine County",2,9,579,292,287
050,19,139,"Iowa","Muscatine County",2,10,629,316,313
050,19,139,"Iowa","Muscatine County",2,11,648,325,323
050,19,139,"Iowa","Muscatine County",2,12,671,340,331
050,19,139,"Iowa","Muscatine County",2,13,649,324,325
050,19,139,"Iowa","Muscatine County",2,14,615,308,307
050,19,139,"Iowa","Muscatine County",2,15,590,302,288
050,19,139,"Iowa","Muscatine County",2,16,622,313,309
050,19,139,"Iowa","Muscatine County",2,17,630,312,318
050,19,139,"Iowa","Muscatine County",2,18,556,289,267
050,19,139,"Iowa","Muscatine County",2,19,480,246,234
050,19,139,"Iowa","Muscatine County",2,20,497,249,248
050,19,139,"Iowa","Muscatine County",2,21,493,254,239
050,19,139,"Iowa","Muscatine County",2,22,495,252,243
050,19,139,"Iowa","Muscatine County",2,23,492,254,238
050,19,139,"Iowa","Muscatine County",2,24,496,258,238
050,19,139,"Iowa","Muscatine County",2,25,521,272,249
050,19,139,"Iowa","Muscatine County",2,26,542,288,254
050,19,139,"Iowa","Muscatine County",2,27,535,285,250
050,19,139,"Iowa","Muscatine County",2,28,555,282,273
050,19,139,"Iowa","Muscatine County",2,29,580,290,290
050,19,139,"Iowa","Muscatine County",2,30,577,288,289
050,19,139,"Iowa","Muscatine County",2,31,522,272,250
050,19,139,"Iowa","Muscatine County",2,32,484,264,220
050,19,139,"Iowa","Muscatine County",2,33,511,269,242
050,19,139,"Iowa","Muscatine County",2,34,531,282,249
050,19,139,"Iowa","Muscatine County",2,35,515,269,246
050,19,139,"Iowa","Muscatine County",2,36,503,270,233
050,19,139,"Iowa","Muscatine County",2,37,535,269,266
050,19,139,"Iowa","Muscatine County",2,38,572,288,284
050,19,139,"Iowa","Muscatine County",2,39,564,284,280
050,19,139,"Iowa","Muscatine County",2,40,555,285,270
050,19,139,"Iowa","Muscatine County",2,41,518,267,251
050,19,139,"Iowa","Muscatine County",2,42,522,274,248
050,19,139,"Iowa","Muscatine County",2,43,505,261,244
050,19,139,"Iowa","Muscatine County",2,44,482,245,237
050,19,139,"Iowa","Muscatine County",2,45,490,247,243
050,19,139,"Iowa","Muscatine County",2,46,472,245,227
050,19,139,"Iowa","Muscatine County",2,47,487,253,234
050,19,139,"Iowa","Muscatine County",2,48,520,266,254
050,19,139,"Iowa","Muscatine County",2,49,555,280,275
050,19,139,"Iowa","Muscatine County",2,50,518,255,263
050,19,139,"Iowa","Muscatine County",2,51,531,260,271
050,19,139,"Iowa","Muscatine County",2,52,526,255,271
050,19,139,"Iowa","Muscatine County",2,53,541,276,265
050,19,139,"Iowa","Muscatine County",2,54,520,273,247
050,19,139,"Iowa","Muscatine County",2,55,543,283,260
050,19,139,"Iowa","Muscatine County",2,56,564,284,280
050,19,139,"Iowa","Muscatine County",2,57,589,299,290
050,19,139,"Iowa","Muscatine County",2,58,608,315,293
050,19,139,"Iowa","Muscatine County",2,59,607,310,297
050,19,139,"Iowa","Muscatine County",2,60,587,296,291
050,19,139,"Iowa","Muscatine County",2,61,584,301,283
050,19,139,"Iowa","Muscatine County",2,62,581,294,287
050,19,139,"Iowa","Muscatine County",2,63,558,281,277
050,19,139,"Iowa","Muscatine County",2,64,544,272,272
050,19,139,"Iowa","Muscatine County",2,65,541,279,262
050,19,139,"Iowa","Muscatine County",2,66,517,259,258
050,19,139,"Iowa","Muscatine County",2,67,478,230,248
050,19,139,"Iowa","Muscatine County",2,68,451,209,242
050,19,139,"Iowa","Muscatine County",2,69,450,218,232
050,19,139,"Iowa","Muscatine County",2,70,439,213,226
050,19,139,"Iowa","Muscatine County",2,71,443,208,235
050,19,139,"Iowa","Muscatine County",2,72,434,204,230
050,19,139,"Iowa","Muscatine County",2,73,447,220,227
050,19,139,"Iowa","Muscatine County",2,74,313,154,159
050,19,139,"Iowa","Muscatine County",2,75,279,142,137
050,19,139,"Iowa","Muscatine County",2,76,274,134,140
050,19,139,"Iowa","Muscatine County",2,77,282,125,157
050,19,139,"Iowa","Muscatine County",2,78,246,109,137
050,19,139,"Iowa","Muscatine County",2,79,208,84,124
050,19,139,"Iowa","Muscatine County",2,80,190,76,114
050,19,139,"Iowa","Muscatine County",2,81,188,89,99
050,19,139,"Iowa","Muscatine County",2,82,169,76,93
050,19,139,"Iowa","Muscatine County",2,83,146,63,83
050,19,139,"Iowa","Muscatine County",2,84,132,51,81
050,19,139,"Iowa","Muscatine County",2,85,854,281,573
050,19,139,"Iowa","Muscatine County",3,0,450,224,226
050,19,139,"Iowa","Muscatine County",3,1,474,255,219
050,19,139,"Iowa","Muscatine County",3,2,500,256,244
050,19,139,"Iowa","Muscatine County",3,3,538,269,269
050,19,139,"Iowa","Muscatine County",3,4,524,261,263
050,19,139,"Iowa","Muscatine County",3,5,562,286,276
050,19,139,"Iowa","Muscatine County",3,6,551,287,264
050,19,139,"Iowa","Muscatine County",3,7,590,305,285
050,19,139,"Iowa","Muscatine County",3,8,568,294,274
050,19,139,"Iowa","Muscatine County",3,9,565,297,268
050,19,139,"Iowa","Muscatine County",3,10,555,278,277
050,19,139,"Iowa","Muscatine County",3,11,622,318,304
050,19,139,"Iowa","Muscatine County",3,12,642,324,318
050,19,139,"Iowa","Muscatine County",3,13,653,331,322
050,19,139,"Iowa","Muscatine County",3,14,658,337,321
050,19,139,"Iowa","Muscatine County",3,15,619,314,305
050,19,139,"Iowa","Muscatine County",3,16,601,305,296
050,19,139,"Iowa","Muscatine County",3,17,628,322,306
050,19,139,"Iowa","Muscatine County",3,18,556,281,275
050,19,139,"Iowa","Muscatine County",3,19,473,253,220
050,19,139,"Iowa","Muscatine County",3,20,482,255,227
050,19,139,"Iowa","Muscatine County",3,21,522,252,270
050,19,139,"Iowa","Muscatine County",3,22,492,243,249
050,19,139,"Iowa","Muscatine County",3,23,499,265,234
050,19,139,"Iowa","Muscatine County",3,24,496,255,241
050,19,139,"Iowa","Muscatine County",3,25,484,256,228
050,19,139,"Iowa","Muscatine County",3,26,513,271,242
050,19,139,"Iowa","Muscatine County",3,27,531,277,254
050,19,139,"Iowa","Muscatine County",3,28,517,268,249
050,19,139,"Iowa","Muscatine County",3,29,552,279,273
050,19,139,"Iowa","Muscatine County",3,30,594,293,301
050,19,139,"Iowa","Muscatine County",3,31,557,286,271
050,19,139,"Iowa","Muscatine County",3,32,532,278,254
050,19,139,"Iowa","Muscatine County",3,33,486,263,223
050,19,139,"Iowa","Muscatine County",3,34,508,268,240
050,19,139,"Iowa","Muscatine County",3,35,529,281,248
050,19,139,"Iowa","Muscatine County",3,36,512,270,242
050,19,139,"Iowa","Muscatine County",3,37,497,271,226
050,19,139,"Iowa","Muscatine County",3,38,545,273,272
050,19,139,"Iowa","Muscatine County",3,39,566,280,286
050,19,139,"Iowa","Muscatine County",3,40,555,276,279
050,19,139,"Iowa","Muscatine County",3,41,557,281,276
050,19,139,"Iowa","Muscatine County",3,42,507,266,241
050,19,139,"Iowa","Muscatine County",3,43,506,270,236
050,19,139,"Iowa","Muscatine County",3,44,485,250,235
050,19,139,"Iowa","Muscatine County",3,45,474,244,230
050,19,139,"Iowa","Muscatine County",3,46,485,247,238
050,19,139,"Iowa","Muscatine County",3,47,472,247,225
050,19,139,"Iowa","Muscatine County",3,48,495,257,238
050,19,139,"Iowa","Muscatine County",3,49,512,263,249
050,19,139,"Iowa","Muscatine County",3,50,535,263,272
050,19,139,"Iowa","Muscatine County",3,51,507,247,260
050,19,139,"Iowa","Muscatine County",3,52,523,259,264
050,19,139,"Iowa","Muscatine County",3,53,521,254,267
050,19,139,"Iowa","Muscatine County",3,54,521,266,255
050,19,139,"Iowa","Muscatine County",3,55,513,263,250
050,19,139,"Iowa","Muscatine County",3,56,559,291,268
050,19,139,"Iowa","Muscatine County",3,57,558,278,280
050,19,139,"Iowa","Muscatine County",3,58,591,296,295
050,19,139,"Iowa","Muscatine County",3,59,599,311,288
050,19,139,"Iowa","Muscatine County",3,60,596,301,295
050,19,139,"Iowa","Muscatine County",3,61,568,287,281
050,19,139,"Iowa","Muscatine County",3,62,580,297,283
050,19,139,"Iowa","Muscatine County",3,63,570,287,283
050,19,139,"Iowa","Muscatine County",3,64,543,271,272
050,19,139,"Iowa","Muscatine County",3,65,526,263,263
050,19,139,"Iowa","Muscatine County",3,66,533,270,263
050,19,139,"Iowa","Muscatine County",3,67,504,251,253
050,19,139,"Iowa","Muscatine County",3,68,461,221,240
050,19,139,"Iowa","Muscatine County",3,69,438,203,235
050,19,139,"Iowa","Muscatine County",3,70,432,208,224
050,19,139,"Iowa","Muscatine County",3,71,434,211,223
050,19,139,"Iowa","Muscatine County",3,72,430,209,221
050,19,139,"Iowa","Muscatine County",3,73,418,198,220
050,19,139,"Iowa","Muscatine County",3,74,436,211,225
050,19,139,"Iowa","Muscatine County",3,75,292,144,148
050,19,139,"Iowa","Muscatine County",3,76,269,139,130
050,19,139,"Iowa","Muscatine County",3,77,257,127,130
050,19,139,"Iowa","Muscatine County",3,78,257,109,148
050,19,139,"Iowa","Muscatine County",3,79,229,100,129
050,19,139,"Iowa","Muscatine County",3,80,207,82,125
050,19,139,"Iowa","Muscatine County",3,81,165,68,97
050,19,139,"Iowa","Muscatine County",3,82,178,82,96
050,19,139,"Iowa","Muscatine County",3,83,156,74,82
050,19,139,"Iowa","Muscatine County",3,84,131,54,77
050,19,139,"Iowa","Muscatine County",3,85,846,277,569
050,19,139,"Iowa","Muscatine County",4,0,465,226,239
050,19,139,"Iowa","Muscatine County",4,1,445,222,223
050,19,139,"Iowa","Muscatine County",4,2,469,249,220
050,19,139,"Iowa","Muscatine County",4,3,506,257,249
050,19,139,"Iowa","Muscatine County",4,4,536,259,277
050,19,139,"Iowa","Muscatine County",4,5,524,259,265
050,19,139,"Iowa","Muscatine County",4,6,548,285,263
050,19,139,"Iowa","Muscatine County",4,7,563,292,271
050,19,139,"Iowa","Muscatine County",4,8,609,311,298
050,19,139,"Iowa","Muscatine County",4,9,563,287,276
050,19,139,"Iowa","Muscatine County",4,10,558,292,266
050,19,139,"Iowa","Muscatine County",4,11,572,287,285
050,19,139,"Iowa","Muscatine County",4,12,622,313,309
050,19,139,"Iowa","Muscatine County",4,13,634,320,314
050,19,139,"Iowa","Muscatine County",4,14,674,337,337
050,19,139,"Iowa","Muscatine County",4,15,649,337,312
050,19,139,"Iowa","Muscatine County",4,16,619,305,314
050,19,139,"Iowa","Muscatine County",4,17,590,296,294
050,19,139,"Iowa","Muscatine County",4,18,530,280,250
050,19,139,"Iowa","Muscatine County",4,19,449,231,218
050,19,139,"Iowa","Muscatine County",4,20,499,256,243
050,19,139,"Iowa","Muscatine County",4,21,508,265,243
050,19,139,"Iowa","Muscatine County",4,22,515,241,274
050,19,139,"Iowa","Muscatine County",4,23,484,249,235
050,19,139,"Iowa","Muscatine County",4,24,504,264,240
050,19,139,"Iowa","Muscatine County",4,25,470,245,225
050,19,139,"Iowa","Muscatine County",4,26,444,243,201
050,19,139,"Iowa","Muscatine County",4,27,483,261,222
050,19,139,"Iowa","Muscatine County",4,28,519,272,247
050,19,139,"Iowa","Muscatine County",4,29,497,255,242
050,19,139,"Iowa","Muscatine County",4,30,543,270,273
050,19,139,"Iowa","Muscatine County",4,31,575,277,298
050,19,139,"Iowa","Muscatine County",4,32,546,287,259
050,19,139,"Iowa","Muscatine County",4,33,553,298,255
050,19,139,"Iowa","Muscatine County",4,34,484,264,220
050,19,139,"Iowa","Muscatine County",4,35,511,261,250
050,19,139,"Iowa","Muscatine County",4,36,537,281,256
050,19,139,"Iowa","Muscatine County",4,37,517,286,231
050,19,139,"Iowa","Muscatine County",4,38,503,274,229
050,19,139,"Iowa","Muscatine County",4,39,546,273,273
050,19,139,"Iowa","Muscatine County",4,40,557,274,283
050,19,139,"Iowa","Muscatine County",4,41,547,274,273
050,19,139,"Iowa","Muscatine County",4,42,544,273,271
050,19,139,"Iowa","Muscatine County",4,43,504,267,237
050,19,139,"Iowa","Muscatine County",4,44,504,273,231
050,19,139,"Iowa","Muscatine County",4,45,493,255,238
050,19,139,"Iowa","Muscatine County",4,46,465,237,228
050,19,139,"Iowa","Muscatine County",4,47,496,249,247
050,19,139,"Iowa","Muscatine County",4,48,464,239,225
050,19,139,"Iowa","Muscatine County",4,49,495,255,240
050,19,139,"Iowa","Muscatine County",4,50,509,260,249
050,19,139,"Iowa","Muscatine County",4,51,540,268,272
050,19,139,"Iowa","Muscatine County",4,52,512,250,262
050,19,139,"Iowa","Muscatine County",4,53,535,261,274
050,19,139,"Iowa","Muscatine County",4,54,560,253,307
050,19,139,"Iowa","Muscatine County",4,55,506,255,251
050,19,139,"Iowa","Muscatine County",4,56,515,264,251
050,19,139,"Iowa","Muscatine County",4,57,552,288,264
050,19,139,"Iowa","Muscatine County",4,58,558,279,279
050,19,139,"Iowa","Muscatine County",4,59,586,295,291
050,19,139,"Iowa","Muscatine County",4,60,589,308,281
050,19,139,"Iowa","Muscatine County",4,61,585,295,290
050,19,139,"Iowa","Muscatine County",4,62,554,273,281
050,19,139,"Iowa","Muscatine County",4,63,570,293,277
050,19,139,"Iowa","Muscatine County",4,64,557,277,280
050,19,139,"Iowa","Muscatine County",4,65,530,266,264
050,19,139,"Iowa","Muscatine County",4,66,522,260,262
050,19,139,"Iowa","Muscatine County",4,67,515,258,257
050,19,139,"Iowa","Muscatine County",4,68,494,245,249
050,19,139,"Iowa","Muscatine County",4,69,456,218,238
050,19,139,"Iowa","Muscatine County",4,70,412,191,221
050,19,139,"Iowa","Muscatine County",4,71,412,201,211
050,19,139,"Iowa","Muscatine County",4,72,426,211,215
050,19,139,"Iowa","Muscatine County",4,73,416,202,214
050,19,139,"Iowa","Muscatine County",4,74,417,187,230
050,19,139,"Iowa","Muscatine County",4,75,413,202,211
050,19,139,"Iowa","Muscatine County",4,76,289,143,146
050,19,139,"Iowa","Muscatine County",4,77,250,123,127
050,19,139,"Iowa","Muscatine County",4,78,240,117,123
050,19,139,"Iowa","Muscatine County",4,79,240,101,139
050,19,139,"Iowa","Muscatine County",4,80,232,101,131
050,19,139,"Iowa","Muscatine County",4,81,181,77,104
050,19,139,"Iowa","Muscatine County",4,82,158,60,98
050,19,139,"Iowa","Muscatine County",4,83,153,71,82
050,19,139,"Iowa","Muscatine County",4,84,143,66,77
050,19,139,"Iowa","Muscatine County",4,85,836,276,560
050,19,139,"Iowa","Muscatine County",5,0,466,226,240
050,19,139,"Iowa","Muscatine County",5,1,471,233,238
050,19,139,"Iowa","Muscatine County",5,2,435,218,217
050,19,139,"Iowa","Muscatine County",5,3,469,251,218
050,19,139,"Iowa","Muscatine County",5,4,486,246,240
050,19,139,"Iowa","Muscatine County",5,5,526,252,274
050,19,139,"Iowa","Muscatine County",5,6,525,263,262
050,19,139,"Iowa","Muscatine County",5,7,542,284,258
050,19,139,"Iowa","Muscatine County",5,8,558,294,264
050,19,139,"Iowa","Muscatine County",5,9,609,313,296
050,19,139,"Iowa","Muscatine County",5,10,543,276,267
050,19,139,"Iowa","Muscatine County",5,11,575,301,274
050,19,139,"Iowa","Muscatine County",5,12,560,285,275
050,19,139,"Iowa","Muscatine County",5,13,620,315,305
050,19,139,"Iowa","Muscatine County",5,14,639,323,316
050,19,139,"Iowa","Muscatine County",5,15,653,330,323
050,19,139,"Iowa","Muscatine County",5,16,647,335,312
050,19,139,"Iowa","Muscatine County",5,17,620,312,308
050,19,139,"Iowa","Muscatine County",5,18,518,272,246
050,19,139,"Iowa","Muscatine County",5,19,442,238,204
050,19,139,"Iowa","Muscatine County",5,20,482,242,240
050,19,139,"Iowa","Muscatine County",5,21,518,272,246
050,19,139,"Iowa","Muscatine County",5,22,524,270,254
050,19,139,"Iowa","Muscatine County",5,23,518,247,271
050,19,139,"Iowa","Muscatine County",5,24,496,268,228
050,19,139,"Iowa","Muscatine County",5,25,494,262,232
050,19,139,"Iowa","Muscatine County",5,26,458,242,216
050,19,139,"Iowa","Muscatine County",5,27,437,243,194
050,19,139,"Iowa","Muscatine County",5,28,480,258,222
050,19,139,"Iowa","Muscatine County",5,29,520,266,254
050,19,139,"Iowa","Muscatine County",5,30,489,254,235
050,19,139,"Iowa","Muscatine County",5,31,534,278,256
050,19,139,"Iowa","Muscatine County",5,32,560,275,285
050,19,139,"Iowa","Muscatine County",5,33,540,284,256
050,19,139,"Iowa","Muscatine County",5,34,548,297,251
050,19,139,"Iowa","Muscatine County",5,35,469,244,225
050,19,139,"Iowa","Muscatine County",5,36,518,255,263
050,19,139,"Iowa","Muscatine County",5,37,536,283,253
050,19,139,"Iowa","Muscatine County",5,38,514,286,228
050,19,139,"Iowa","Muscatine County",5,39,493,261,232
050,19,139,"Iowa","Muscatine County",5,40,544,273,271
050,19,139,"Iowa","Muscatine County",5,41,556,268,288
050,19,139,"Iowa","Muscatine County",5,42,556,281,275
050,19,139,"Iowa","Muscatine County",5,43,544,274,270
050,19,139,"Iowa","Muscatine County",5,44,507,269,238
050,19,139,"Iowa","Muscatine County",5,45,505,269,236
050,19,139,"Iowa","Muscatine County",5,46,497,261,236
050,19,139,"Iowa","Muscatine County",5,47,456,233,223
050,19,139,"Iowa","Muscatine County",5,48,502,254,248
050,19,139,"Iowa","Muscatine County",5,49,462,238,224
050,19,139,"Iowa","Muscatine County",5,50,479,252,227
050,19,139,"Iowa","Muscatine County",5,51,503,260,243
050,19,139,"Iowa","Muscatine County",5,52,536,267,269
050,19,139,"Iowa","Muscatine County",5,53,535,253,282
050,19,139,"Iowa","Muscatine County",5,54,594,261,333
050,19,139,"Iowa","Muscatine County",5,55,553,243,310
050,19,139,"Iowa","Muscatine County",5,56,506,260,246
050,19,139,"Iowa","Muscatine County",5,57,516,264,252
050,19,139,"Iowa","Muscatine County",5,58,554,287,267
050,19,139,"Iowa","Muscatine County",5,59,551,276,275
050,19,139,"Iowa","Muscatine County",5,60,584,298,286
050,19,139,"Iowa","Muscatine County",5,61,584,304,280
050,19,139,"Iowa","Muscatine County",5,62,570,288,282
050,19,139,"Iowa","Muscatine County",5,63,537,264,273
050,19,139,"Iowa","Muscatine County",5,64,562,287,275
050,19,139,"Iowa","Muscatine County",5,65,540,268,272
050,19,139,"Iowa","Muscatine County",5,66,520,257,263
050,19,139,"Iowa","Muscatine County",5,67,511,248,263
050,19,139,"Iowa","Muscatine County",5,68,499,250,249
050,19,139,"Iowa","Muscatine County",5,69,484,241,243
050,19,139,"Iowa","Muscatine County",5,70,437,207,230
050,19,139,"Iowa","Muscatine County",5,71,397,188,209
050,19,139,"Iowa","Muscatine County",5,72,408,198,210
050,19,139,"Iowa","Muscatine County",5,73,410,206,204
050,19,139,"Iowa","Muscatine County",5,74,409,193,216
050,19,139,"Iowa","Muscatine County",5,75,405,180,225
050,19,139,"Iowa","Muscatine County",5,76,402,201,201
050,19,139,"Iowa","Muscatine County",5,77,273,133,140
050,19,139,"Iowa","Muscatine County",5,78,227,109,118
050,19,139,"Iowa","Muscatine County",5,79,231,113,118
050,19,139,"Iowa","Muscatine County",5,80,243,101,142
050,19,139,"Iowa","Muscatine County",5,81,207,96,111
050,19,139,"Iowa","Muscatine County",5,82,172,68,104
050,19,139,"Iowa","Muscatine County",5,83,137,53,84
050,19,139,"Iowa","Muscatine County",5,84,137,64,73
050,19,139,"Iowa","Muscatine County",5,85,844,283,561
050,19,141,"Iowa","O'Brien County",1,0,166,86,80
050,19,141,"Iowa","O'Brien County",1,1,172,93,79
050,19,141,"Iowa","O'Brien County",1,2,190,108,82
050,19,141,"Iowa","O'Brien County",1,3,168,84,84
050,19,141,"Iowa","O'Brien County",1,4,186,92,94
050,19,141,"Iowa","O'Brien County",1,5,188,95,93
050,19,141,"Iowa","O'Brien County",1,6,189,97,92
050,19,141,"Iowa","O'Brien County",1,7,181,101,80
050,19,141,"Iowa","O'Brien County",1,8,158,87,71
050,19,141,"Iowa","O'Brien County",1,9,165,78,87
050,19,141,"Iowa","O'Brien County",1,10,227,112,115
050,19,141,"Iowa","O'Brien County",1,11,217,107,110
050,19,141,"Iowa","O'Brien County",1,12,201,100,101
050,19,141,"Iowa","O'Brien County",1,13,187,100,87
050,19,141,"Iowa","O'Brien County",1,14,213,117,96
050,19,141,"Iowa","O'Brien County",1,15,219,116,103
050,19,141,"Iowa","O'Brien County",1,16,195,101,94
050,19,141,"Iowa","O'Brien County",1,17,195,109,86
050,19,141,"Iowa","O'Brien County",1,18,164,85,79
050,19,141,"Iowa","O'Brien County",1,19,144,74,70
050,19,141,"Iowa","O'Brien County",1,20,152,80,72
050,19,141,"Iowa","O'Brien County",1,21,141,78,63
050,19,141,"Iowa","O'Brien County",1,22,153,86,67
050,19,141,"Iowa","O'Brien County",1,23,150,86,64
050,19,141,"Iowa","O'Brien County",1,24,158,81,77
050,19,141,"Iowa","O'Brien County",1,25,168,85,83
050,19,141,"Iowa","O'Brien County",1,26,166,95,71
050,19,141,"Iowa","O'Brien County",1,27,165,89,76
050,19,141,"Iowa","O'Brien County",1,28,159,83,76
050,19,141,"Iowa","O'Brien County",1,29,151,82,69
050,19,141,"Iowa","O'Brien County",1,30,157,85,72
050,19,141,"Iowa","O'Brien County",1,31,142,69,73
050,19,141,"Iowa","O'Brien County",1,32,145,80,65
050,19,141,"Iowa","O'Brien County",1,33,152,88,64
050,19,141,"Iowa","O'Brien County",1,34,160,87,73
050,19,141,"Iowa","O'Brien County",1,35,152,80,72
050,19,141,"Iowa","O'Brien County",1,36,167,92,75
050,19,141,"Iowa","O'Brien County",1,37,178,101,77
050,19,141,"Iowa","O'Brien County",1,38,162,93,69
050,19,141,"Iowa","O'Brien County",1,39,164,95,69
050,19,141,"Iowa","O'Brien County",1,40,182,100,82
050,19,141,"Iowa","O'Brien County",1,41,162,80,82
050,19,141,"Iowa","O'Brien County",1,42,168,79,89
050,19,141,"Iowa","O'Brien County",1,43,182,94,88
050,19,141,"Iowa","O'Brien County",1,44,153,73,80
050,19,141,"Iowa","O'Brien County",1,45,133,71,62
050,19,141,"Iowa","O'Brien County",1,46,127,59,68
050,19,141,"Iowa","O'Brien County",1,47,130,69,61
050,19,141,"Iowa","O'Brien County",1,48,145,75,70
050,19,141,"Iowa","O'Brien County",1,49,143,70,73
050,19,141,"Iowa","O'Brien County",1,50,150,81,69
050,19,141,"Iowa","O'Brien County",1,51,165,97,68
050,19,141,"Iowa","O'Brien County",1,52,154,82,72
050,19,141,"Iowa","O'Brien County",1,53,148,79,69
050,19,141,"Iowa","O'Brien County",1,54,153,80,73
050,19,141,"Iowa","O'Brien County",1,55,162,84,78
050,19,141,"Iowa","O'Brien County",1,56,165,73,92
050,19,141,"Iowa","O'Brien County",1,57,204,92,112
050,19,141,"Iowa","O'Brien County",1,58,221,111,110
050,19,141,"Iowa","O'Brien County",1,59,225,111,114
050,19,141,"Iowa","O'Brien County",1,60,204,112,92
050,19,141,"Iowa","O'Brien County",1,61,196,100,96
050,19,141,"Iowa","O'Brien County",1,62,208,111,97
050,19,141,"Iowa","O'Brien County",1,63,204,104,100
050,19,141,"Iowa","O'Brien County",1,64,203,106,97
050,19,141,"Iowa","O'Brien County",1,65,209,110,99
050,19,141,"Iowa","O'Brien County",1,66,198,97,101
050,19,141,"Iowa","O'Brien County",1,67,181,89,92
050,19,141,"Iowa","O'Brien County",1,68,176,89,87
050,19,141,"Iowa","O'Brien County",1,69,146,73,73
050,19,141,"Iowa","O'Brien County",1,70,138,68,70
050,19,141,"Iowa","O'Brien County",1,71,131,70,61
050,19,141,"Iowa","O'Brien County",1,72,134,70,64
050,19,141,"Iowa","O'Brien County",1,73,126,62,64
050,19,141,"Iowa","O'Brien County",1,74,100,47,53
050,19,141,"Iowa","O'Brien County",1,75,105,50,55
050,19,141,"Iowa","O'Brien County",1,76,101,45,56
050,19,141,"Iowa","O'Brien County",1,77,103,49,54
050,19,141,"Iowa","O'Brien County",1,78,86,35,51
050,19,141,"Iowa","O'Brien County",1,79,92,47,45
050,19,141,"Iowa","O'Brien County",1,80,82,35,47
050,19,141,"Iowa","O'Brien County",1,81,70,27,43
050,19,141,"Iowa","O'Brien County",1,82,80,31,49
050,19,141,"Iowa","O'Brien County",1,83,78,31,47
050,19,141,"Iowa","O'Brien County",1,84,84,28,56
050,19,141,"Iowa","O'Brien County",1,85,607,189,418
050,19,141,"Iowa","O'Brien County",2,0,168,93,75
050,19,141,"Iowa","O'Brien County",2,1,172,92,80
050,19,141,"Iowa","O'Brien County",2,2,182,101,81
050,19,141,"Iowa","O'Brien County",2,3,172,90,82
050,19,141,"Iowa","O'Brien County",2,4,182,89,93
050,19,141,"Iowa","O'Brien County",2,5,189,95,94
050,19,141,"Iowa","O'Brien County",2,6,191,97,94
050,19,141,"Iowa","O'Brien County",2,7,182,99,83
050,19,141,"Iowa","O'Brien County",2,8,164,89,75
050,19,141,"Iowa","O'Brien County",2,9,164,81,83
050,19,141,"Iowa","O'Brien County",2,10,212,103,109
050,19,141,"Iowa","O'Brien County",2,11,216,106,110
050,19,141,"Iowa","O'Brien County",2,12,202,101,101
050,19,141,"Iowa","O'Brien County",2,13,189,100,89
050,19,141,"Iowa","O'Brien County",2,14,209,114,95
050,19,141,"Iowa","O'Brien County",2,15,218,117,101
050,19,141,"Iowa","O'Brien County",2,16,201,105,96
050,19,141,"Iowa","O'Brien County",2,17,195,107,88
050,19,141,"Iowa","O'Brien County",2,18,165,87,78
050,19,141,"Iowa","O'Brien County",2,19,142,72,70
050,19,141,"Iowa","O'Brien County",2,20,154,81,73
050,19,141,"Iowa","O'Brien County",2,21,147,81,66
050,19,141,"Iowa","O'Brien County",2,22,150,84,66
050,19,141,"Iowa","O'Brien County",2,23,152,88,64
050,19,141,"Iowa","O'Brien County",2,24,158,82,76
050,19,141,"Iowa","O'Brien County",2,25,166,85,81
050,19,141,"Iowa","O'Brien County",2,26,165,92,73
050,19,141,"Iowa","O'Brien County",2,27,165,90,75
050,19,141,"Iowa","O'Brien County",2,28,162,87,75
050,19,141,"Iowa","O'Brien County",2,29,152,81,71
050,19,141,"Iowa","O'Brien County",2,30,158,85,73
050,19,141,"Iowa","O'Brien County",2,31,145,72,73
050,19,141,"Iowa","O'Brien County",2,32,146,79,67
050,19,141,"Iowa","O'Brien County",2,33,148,84,64
050,19,141,"Iowa","O'Brien County",2,34,156,86,70
050,19,141,"Iowa","O'Brien County",2,35,156,83,73
050,19,141,"Iowa","O'Brien County",2,36,163,90,73
050,19,141,"Iowa","O'Brien County",2,37,174,97,77
050,19,141,"Iowa","O'Brien County",2,38,164,93,71
050,19,141,"Iowa","O'Brien County",2,39,161,93,68
050,19,141,"Iowa","O'Brien County",2,40,180,99,81
050,19,141,"Iowa","O'Brien County",2,41,167,85,82
050,19,141,"Iowa","O'Brien County",2,42,166,79,87
050,19,141,"Iowa","O'Brien County",2,43,182,93,89
050,19,141,"Iowa","O'Brien County",2,44,155,76,79
050,19,141,"Iowa","O'Brien County",2,45,137,71,66
050,19,141,"Iowa","O'Brien County",2,46,129,61,68
050,19,141,"Iowa","O'Brien County",2,47,131,68,63
050,19,141,"Iowa","O'Brien County",2,48,142,73,69
050,19,141,"Iowa","O'Brien County",2,49,144,72,72
050,19,141,"Iowa","O'Brien County",2,50,147,79,68
050,19,141,"Iowa","O'Brien County",2,51,163,94,69
050,19,141,"Iowa","O'Brien County",2,52,152,81,71
050,19,141,"Iowa","O'Brien County",2,53,151,81,70
050,19,141,"Iowa","O'Brien County",2,54,152,81,71
050,19,141,"Iowa","O'Brien County",2,55,157,81,76
050,19,141,"Iowa","O'Brien County",2,56,163,75,88
050,19,141,"Iowa","O'Brien County",2,57,192,88,104
050,19,141,"Iowa","O'Brien County",2,58,217,107,110
050,19,141,"Iowa","O'Brien County",2,59,224,112,112
050,19,141,"Iowa","O'Brien County",2,60,206,110,96
050,19,141,"Iowa","O'Brien County",2,61,194,100,94
050,19,141,"Iowa","O'Brien County",2,62,204,108,96
050,19,141,"Iowa","O'Brien County",2,63,206,106,100
050,19,141,"Iowa","O'Brien County",2,64,201,103,98
050,19,141,"Iowa","O'Brien County",2,65,207,109,98
050,19,141,"Iowa","O'Brien County",2,66,202,102,100
050,19,141,"Iowa","O'Brien County",2,67,180,89,91
050,19,141,"Iowa","O'Brien County",2,68,174,87,87
050,19,141,"Iowa","O'Brien County",2,69,154,77,77
050,19,141,"Iowa","O'Brien County",2,70,139,68,71
050,19,141,"Iowa","O'Brien County",2,71,132,70,62
050,19,141,"Iowa","O'Brien County",2,72,130,69,61
050,19,141,"Iowa","O'Brien County",2,73,135,67,68
050,19,141,"Iowa","O'Brien County",2,74,99,48,51
050,19,141,"Iowa","O'Brien County",2,75,102,47,55
050,19,141,"Iowa","O'Brien County",2,76,99,45,54
050,19,141,"Iowa","O'Brien County",2,77,105,49,56
050,19,141,"Iowa","O'Brien County",2,78,88,37,51
050,19,141,"Iowa","O'Brien County",2,79,89,45,44
050,19,141,"Iowa","O'Brien County",2,80,86,38,48
050,19,141,"Iowa","O'Brien County",2,81,69,27,42
050,19,141,"Iowa","O'Brien County",2,82,78,29,49
050,19,141,"Iowa","O'Brien County",2,83,77,31,46
050,19,141,"Iowa","O'Brien County",2,84,82,26,56
050,19,141,"Iowa","O'Brien County",2,85,604,188,416
050,19,141,"Iowa","O'Brien County",3,0,176,92,84
050,19,141,"Iowa","O'Brien County",3,1,162,100,62
050,19,141,"Iowa","O'Brien County",3,2,192,102,90
050,19,141,"Iowa","O'Brien County",3,3,183,108,75
050,19,141,"Iowa","O'Brien County",3,4,179,95,84
050,19,141,"Iowa","O'Brien County",3,5,177,90,87
050,19,141,"Iowa","O'Brien County",3,6,186,98,88
050,19,141,"Iowa","O'Brien County",3,7,182,91,91
050,19,141,"Iowa","O'Brien County",3,8,187,100,87
050,19,141,"Iowa","O'Brien County",3,9,160,88,72
050,19,141,"Iowa","O'Brien County",3,10,162,80,82
050,19,141,"Iowa","O'Brien County",3,11,216,103,113
050,19,141,"Iowa","O'Brien County",3,12,225,116,109
050,19,141,"Iowa","O'Brien County",3,13,200,96,104
050,19,141,"Iowa","O'Brien County",3,14,194,105,89
050,19,141,"Iowa","O'Brien County",3,15,205,110,95
050,19,141,"Iowa","O'Brien County",3,16,208,108,100
050,19,141,"Iowa","O'Brien County",3,17,198,101,97
050,19,141,"Iowa","O'Brien County",3,18,164,92,72
050,19,141,"Iowa","O'Brien County",3,19,144,78,66
050,19,141,"Iowa","O'Brien County",3,20,158,78,80
050,19,141,"Iowa","O'Brien County",3,21,159,83,76
050,19,141,"Iowa","O'Brien County",3,22,166,96,70
050,19,141,"Iowa","O'Brien County",3,23,159,91,68
050,19,141,"Iowa","O'Brien County",3,24,147,85,62
050,19,141,"Iowa","O'Brien County",3,25,164,80,84
050,19,141,"Iowa","O'Brien County",3,26,160,86,74
050,19,141,"Iowa","O'Brien County",3,27,190,102,88
050,19,141,"Iowa","O'Brien County",3,28,167,92,75
050,19,141,"Iowa","O'Brien County",3,29,154,77,77
050,19,141,"Iowa","O'Brien County",3,30,152,82,70
050,19,141,"Iowa","O'Brien County",3,31,151,85,66
050,19,141,"Iowa","O'Brien County",3,32,151,79,72
050,19,141,"Iowa","O'Brien County",3,33,139,72,67
050,19,141,"Iowa","O'Brien County",3,34,132,72,60
050,19,141,"Iowa","O'Brien County",3,35,167,91,76
050,19,141,"Iowa","O'Brien County",3,36,154,86,68
050,19,141,"Iowa","O'Brien County",3,37,159,84,75
050,19,141,"Iowa","O'Brien County",3,38,174,94,80
050,19,141,"Iowa","O'Brien County",3,39,163,91,72
050,19,141,"Iowa","O'Brien County",3,40,164,99,65
050,19,141,"Iowa","O'Brien County",3,41,183,98,85
050,19,141,"Iowa","O'Brien County",3,42,178,84,94
050,19,141,"Iowa","O'Brien County",3,43,163,85,78
050,19,141,"Iowa","O'Brien County",3,44,176,89,87
050,19,141,"Iowa","O'Brien County",3,45,153,73,80
050,19,141,"Iowa","O'Brien County",3,46,139,70,69
050,19,141,"Iowa","O'Brien County",3,47,130,63,67
050,19,141,"Iowa","O'Brien County",3,48,128,68,60
050,19,141,"Iowa","O'Brien County",3,49,134,68,66
050,19,141,"Iowa","O'Brien County",3,50,139,74,65
050,19,141,"Iowa","O'Brien County",3,51,157,87,70
050,19,141,"Iowa","O'Brien County",3,52,157,83,74
050,19,141,"Iowa","O'Brien County",3,53,154,85,69
050,19,141,"Iowa","O'Brien County",3,54,148,81,67
050,19,141,"Iowa","O'Brien County",3,55,151,79,72
050,19,141,"Iowa","O'Brien County",3,56,151,77,74
050,19,141,"Iowa","O'Brien County",3,57,160,75,85
050,19,141,"Iowa","O'Brien County",3,58,185,85,100
050,19,141,"Iowa","O'Brien County",3,59,213,105,108
050,19,141,"Iowa","O'Brien County",3,60,213,110,103
050,19,141,"Iowa","O'Brien County",3,61,200,105,95
050,19,141,"Iowa","O'Brien County",3,62,192,96,96
050,19,141,"Iowa","O'Brien County",3,63,205,108,97
050,19,141,"Iowa","O'Brien County",3,64,197,101,96
050,19,141,"Iowa","O'Brien County",3,65,198,98,100
050,19,141,"Iowa","O'Brien County",3,66,201,107,94
050,19,141,"Iowa","O'Brien County",3,67,184,91,93
050,19,141,"Iowa","O'Brien County",3,68,175,82,93
050,19,141,"Iowa","O'Brien County",3,69,168,86,82
050,19,141,"Iowa","O'Brien County",3,70,153,74,79
050,19,141,"Iowa","O'Brien County",3,71,135,67,68
050,19,141,"Iowa","O'Brien County",3,72,127,68,59
050,19,141,"Iowa","O'Brien County",3,73,131,67,64
050,19,141,"Iowa","O'Brien County",3,74,125,63,62
050,19,141,"Iowa","O'Brien County",3,75,90,42,48
050,19,141,"Iowa","O'Brien County",3,76,94,42,52
050,19,141,"Iowa","O'Brien County",3,77,98,47,51
050,19,141,"Iowa","O'Brien County",3,78,94,42,52
050,19,141,"Iowa","O'Brien County",3,79,86,40,46
050,19,141,"Iowa","O'Brien County",3,80,91,41,50
050,19,141,"Iowa","O'Brien County",3,81,70,31,39
050,19,141,"Iowa","O'Brien County",3,82,70,25,45
050,19,141,"Iowa","O'Brien County",3,83,68,26,42
050,19,141,"Iowa","O'Brien County",3,84,73,22,51
050,19,141,"Iowa","O'Brien County",3,85,577,177,400
050,19,141,"Iowa","O'Brien County",4,0,189,104,85
050,19,141,"Iowa","O'Brien County",4,1,180,91,89
050,19,141,"Iowa","O'Brien County",4,2,174,104,70
050,19,141,"Iowa","O'Brien County",4,3,190,99,91
050,19,141,"Iowa","O'Brien County",4,4,181,107,74
050,19,141,"Iowa","O'Brien County",4,5,196,110,86
050,19,141,"Iowa","O'Brien County",4,6,190,100,90
050,19,141,"Iowa","O'Brien County",4,7,190,100,90
050,19,141,"Iowa","O'Brien County",4,8,191,94,97
050,19,141,"Iowa","O'Brien County",4,9,201,112,89
050,19,141,"Iowa","O'Brien County",4,10,162,89,73
050,19,141,"Iowa","O'Brien County",4,11,164,77,87
050,19,141,"Iowa","O'Brien County",4,12,209,100,109
050,19,141,"Iowa","O'Brien County",4,13,221,110,111
050,19,141,"Iowa","O'Brien County",4,14,197,97,100
050,19,141,"Iowa","O'Brien County",4,15,208,116,92
050,19,141,"Iowa","O'Brien County",4,16,205,112,93
050,19,141,"Iowa","O'Brien County",4,17,211,114,97
050,19,141,"Iowa","O'Brien County",4,18,176,90,86
050,19,141,"Iowa","O'Brien County",4,19,126,71,55
050,19,141,"Iowa","O'Brien County",4,20,147,79,68
050,19,141,"Iowa","O'Brien County",4,21,158,83,75
050,19,141,"Iowa","O'Brien County",4,22,159,84,75
050,19,141,"Iowa","O'Brien County",4,23,170,105,65
050,19,141,"Iowa","O'Brien County",4,24,164,88,76
050,19,141,"Iowa","O'Brien County",4,25,162,93,69
050,19,141,"Iowa","O'Brien County",4,26,157,77,80
050,19,141,"Iowa","O'Brien County",4,27,154,86,68
050,19,141,"Iowa","O'Brien County",4,28,188,100,88
050,19,141,"Iowa","O'Brien County",4,29,155,81,74
050,19,141,"Iowa","O'Brien County",4,30,161,76,85
050,19,141,"Iowa","O'Brien County",4,31,150,79,71
050,19,141,"Iowa","O'Brien County",4,32,159,90,69
050,19,141,"Iowa","O'Brien County",4,33,150,82,68
050,19,141,"Iowa","O'Brien County",4,34,155,80,75
050,19,141,"Iowa","O'Brien County",4,35,139,80,59
050,19,141,"Iowa","O'Brien County",4,36,169,91,78
050,19,141,"Iowa","O'Brien County",4,37,149,79,70
050,19,141,"Iowa","O'Brien County",4,38,154,79,75
050,19,141,"Iowa","O'Brien County",4,39,181,100,81
050,19,141,"Iowa","O'Brien County",4,40,174,96,78
050,19,141,"Iowa","O'Brien County",4,41,157,94,63
050,19,141,"Iowa","O'Brien County",4,42,186,98,88
050,19,141,"Iowa","O'Brien County",4,43,175,90,85
050,19,141,"Iowa","O'Brien County",4,44,157,81,76
050,19,141,"Iowa","O'Brien County",4,45,178,90,88
050,19,141,"Iowa","O'Brien County",4,46,155,73,82
050,19,141,"Iowa","O'Brien County",4,47,141,71,70
050,19,141,"Iowa","O'Brien County",4,48,136,66,70
050,19,141,"Iowa","O'Brien County",4,49,125,64,61
050,19,141,"Iowa","O'Brien County",4,50,133,73,60
050,19,141,"Iowa","O'Brien County",4,51,152,83,69
050,19,141,"Iowa","O'Brien County",4,52,145,72,73
050,19,141,"Iowa","O'Brien County",4,53,159,84,75
050,19,141,"Iowa","O'Brien County",4,54,144,78,66
050,19,141,"Iowa","O'Brien County",4,55,153,84,69
050,19,141,"Iowa","O'Brien County",4,56,139,71,68
050,19,141,"Iowa","O'Brien County",4,57,146,75,71
050,19,141,"Iowa","O'Brien County",4,58,163,78,85
050,19,141,"Iowa","O'Brien County",4,59,182,85,97
050,19,141,"Iowa","O'Brien County",4,60,211,106,105
050,19,141,"Iowa","O'Brien County",4,61,203,102,101
050,19,141,"Iowa","O'Brien County",4,62,193,102,91
050,19,141,"Iowa","O'Brien County",4,63,198,98,100
050,19,141,"Iowa","O'Brien County",4,64,205,105,100
050,19,141,"Iowa","O'Brien County",4,65,196,98,98
050,19,141,"Iowa","O'Brien County",4,66,206,102,104
050,19,141,"Iowa","O'Brien County",4,67,197,107,90
050,19,141,"Iowa","O'Brien County",4,68,179,85,94
050,19,141,"Iowa","O'Brien County",4,69,173,81,92
050,19,141,"Iowa","O'Brien County",4,70,171,84,87
050,19,141,"Iowa","O'Brien County",4,71,145,74,71
050,19,141,"Iowa","O'Brien County",4,72,133,69,64
050,19,141,"Iowa","O'Brien County",4,73,125,66,59
050,19,141,"Iowa","O'Brien County",4,74,123,63,60
050,19,141,"Iowa","O'Brien County",4,75,115,58,57
050,19,141,"Iowa","O'Brien County",4,76,85,39,46
050,19,141,"Iowa","O'Brien County",4,77,100,48,52
050,19,141,"Iowa","O'Brien County",4,78,87,39,48
050,19,141,"Iowa","O'Brien County",4,79,89,41,48
050,19,141,"Iowa","O'Brien County",4,80,86,37,49
050,19,141,"Iowa","O'Brien County",4,81,80,38,42
050,19,141,"Iowa","O'Brien County",4,82,67,29,38
050,19,141,"Iowa","O'Brien County",4,83,59,23,36
050,19,141,"Iowa","O'Brien County",4,84,72,21,51
050,19,141,"Iowa","O'Brien County",4,85,545,164,381
050,19,141,"Iowa","O'Brien County",5,0,182,99,83
050,19,141,"Iowa","O'Brien County",5,1,199,107,92
050,19,141,"Iowa","O'Brien County",5,2,185,95,90
050,19,141,"Iowa","O'Brien County",5,3,177,103,74
050,19,141,"Iowa","O'Brien County",5,4,192,97,95
050,19,141,"Iowa","O'Brien County",5,5,185,108,77
050,19,141,"Iowa","O'Brien County",5,6,195,107,88
050,19,141,"Iowa","O'Brien County",5,7,191,100,91
050,19,141,"Iowa","O'Brien County",5,8,190,102,88
050,19,141,"Iowa","O'Brien County",5,9,187,93,94
050,19,141,"Iowa","O'Brien County",5,10,204,112,92
050,19,141,"Iowa","O'Brien County",5,11,159,88,71
050,19,141,"Iowa","O'Brien County",5,12,160,79,81
050,19,141,"Iowa","O'Brien County",5,13,207,98,109
050,19,141,"Iowa","O'Brien County",5,14,218,111,107
050,19,141,"Iowa","O'Brien County",5,15,202,92,110
050,19,141,"Iowa","O'Brien County",5,16,200,109,91
050,19,141,"Iowa","O'Brien County",5,17,210,118,92
050,19,141,"Iowa","O'Brien County",5,18,173,95,78
050,19,141,"Iowa","O'Brien County",5,19,136,72,64
050,19,141,"Iowa","O'Brien County",5,20,143,77,66
050,19,141,"Iowa","O'Brien County",5,21,149,76,73
050,19,141,"Iowa","O'Brien County",5,22,159,85,74
050,19,141,"Iowa","O'Brien County",5,23,168,84,84
050,19,141,"Iowa","O'Brien County",5,24,174,95,79
050,19,141,"Iowa","O'Brien County",5,25,165,85,80
050,19,141,"Iowa","O'Brien County",5,26,159,83,76
050,19,141,"Iowa","O'Brien County",5,27,164,86,78
050,19,141,"Iowa","O'Brien County",5,28,153,84,69
050,19,141,"Iowa","O'Brien County",5,29,178,90,88
050,19,141,"Iowa","O'Brien County",5,30,157,79,78
050,19,141,"Iowa","O'Brien County",5,31,173,82,91
050,19,141,"Iowa","O'Brien County",5,32,168,91,77
050,19,141,"Iowa","O'Brien County",5,33,167,94,73
050,19,141,"Iowa","O'Brien County",5,34,159,86,73
050,19,141,"Iowa","O'Brien County",5,35,159,83,76
050,19,141,"Iowa","O'Brien County",5,36,146,83,63
050,19,141,"Iowa","O'Brien County",5,37,168,91,77
050,19,141,"Iowa","O'Brien County",5,38,151,80,71
050,19,141,"Iowa","O'Brien County",5,39,156,80,76
050,19,141,"Iowa","O'Brien County",5,40,181,102,79
050,19,141,"Iowa","O'Brien County",5,41,180,100,80
050,19,141,"Iowa","O'Brien County",5,42,157,89,68
050,19,141,"Iowa","O'Brien County",5,43,184,102,82
050,19,141,"Iowa","O'Brien County",5,44,162,78,84
050,19,141,"Iowa","O'Brien County",5,45,156,78,78
050,19,141,"Iowa","O'Brien County",5,46,180,92,88
050,19,141,"Iowa","O'Brien County",5,47,152,72,80
050,19,141,"Iowa","O'Brien County",5,48,131,64,67
050,19,141,"Iowa","O'Brien County",5,49,136,64,72
050,19,141,"Iowa","O'Brien County",5,50,125,68,57
050,19,141,"Iowa","O'Brien County",5,51,140,79,61
050,19,141,"Iowa","O'Brien County",5,52,144,70,74
050,19,141,"Iowa","O'Brien County",5,53,151,79,72
050,19,141,"Iowa","O'Brien County",5,54,163,90,73
050,19,141,"Iowa","O'Brien County",5,55,143,76,67
050,19,141,"Iowa","O'Brien County",5,56,143,77,66
050,19,141,"Iowa","O'Brien County",5,57,140,72,68
050,19,141,"Iowa","O'Brien County",5,58,143,74,69
050,19,141,"Iowa","O'Brien County",5,59,169,80,89
050,19,141,"Iowa","O'Brien County",5,60,174,81,93
050,19,141,"Iowa","O'Brien County",5,61,204,100,104
050,19,141,"Iowa","O'Brien County",5,62,198,99,99
050,19,141,"Iowa","O'Brien County",5,63,191,105,86
050,19,141,"Iowa","O'Brien County",5,64,195,95,100
050,19,141,"Iowa","O'Brien County",5,65,203,102,101
050,19,141,"Iowa","O'Brien County",5,66,193,100,93
050,19,141,"Iowa","O'Brien County",5,67,200,102,98
050,19,141,"Iowa","O'Brien County",5,68,192,102,90
050,19,141,"Iowa","O'Brien County",5,69,180,86,94
050,19,141,"Iowa","O'Brien County",5,70,175,78,97
050,19,141,"Iowa","O'Brien County",5,71,160,80,80
050,19,141,"Iowa","O'Brien County",5,72,140,71,69
050,19,141,"Iowa","O'Brien County",5,73,128,63,65
050,19,141,"Iowa","O'Brien County",5,74,115,62,53
050,19,141,"Iowa","O'Brien County",5,75,113,58,55
050,19,141,"Iowa","O'Brien County",5,76,106,53,53
050,19,141,"Iowa","O'Brien County",5,77,85,41,44
050,19,141,"Iowa","O'Brien County",5,78,87,39,48
050,19,141,"Iowa","O'Brien County",5,79,85,40,45
050,19,141,"Iowa","O'Brien County",5,80,87,36,51
050,19,141,"Iowa","O'Brien County",5,81,75,33,42
050,19,141,"Iowa","O'Brien County",5,82,79,35,44
050,19,141,"Iowa","O'Brien County",5,83,55,27,28
050,19,141,"Iowa","O'Brien County",5,84,54,18,36
050,19,141,"Iowa","O'Brien County",5,85,490,150,340
050,19,143,"Iowa","Osceola County",1,0,66,34,32
050,19,143,"Iowa","Osceola County",1,1,78,33,45
050,19,143,"Iowa","Osceola County",1,2,70,33,37
050,19,143,"Iowa","Osceola County",1,3,70,42,28
050,19,143,"Iowa","Osceola County",1,4,68,33,35
050,19,143,"Iowa","Osceola County",1,5,82,36,46
050,19,143,"Iowa","Osceola County",1,6,77,38,39
050,19,143,"Iowa","Osceola County",1,7,84,44,40
050,19,143,"Iowa","Osceola County",1,8,71,38,33
050,19,143,"Iowa","Osceola County",1,9,81,48,33
050,19,143,"Iowa","Osceola County",1,10,89,42,47
050,19,143,"Iowa","Osceola County",1,11,88,48,40
050,19,143,"Iowa","Osceola County",1,12,99,54,45
050,19,143,"Iowa","Osceola County",1,13,94,50,44
050,19,143,"Iowa","Osceola County",1,14,92,46,46
050,19,143,"Iowa","Osceola County",1,15,97,50,47
050,19,143,"Iowa","Osceola County",1,16,82,44,38
050,19,143,"Iowa","Osceola County",1,17,84,45,39
050,19,143,"Iowa","Osceola County",1,18,74,45,29
050,19,143,"Iowa","Osceola County",1,19,55,35,20
050,19,143,"Iowa","Osceola County",1,20,50,27,23
050,19,143,"Iowa","Osceola County",1,21,63,33,30
050,19,143,"Iowa","Osceola County",1,22,61,31,30
050,19,143,"Iowa","Osceola County",1,23,57,32,25
050,19,143,"Iowa","Osceola County",1,24,56,27,29
050,19,143,"Iowa","Osceola County",1,25,59,31,28
050,19,143,"Iowa","Osceola County",1,26,56,33,23
050,19,143,"Iowa","Osceola County",1,27,69,36,33
050,19,143,"Iowa","Osceola County",1,28,61,34,27
050,19,143,"Iowa","Osceola County",1,29,61,34,27
050,19,143,"Iowa","Osceola County",1,30,75,42,33
050,19,143,"Iowa","Osceola County",1,31,61,31,30
050,19,143,"Iowa","Osceola County",1,32,61,35,26
050,19,143,"Iowa","Osceola County",1,33,56,36,20
050,19,143,"Iowa","Osceola County",1,34,67,36,31
050,19,143,"Iowa","Osceola County",1,35,65,35,30
050,19,143,"Iowa","Osceola County",1,36,59,33,26
050,19,143,"Iowa","Osceola County",1,37,68,40,28
050,19,143,"Iowa","Osceola County",1,38,80,43,37
050,19,143,"Iowa","Osceola County",1,39,74,36,38
050,19,143,"Iowa","Osceola County",1,40,70,33,37
050,19,143,"Iowa","Osceola County",1,41,65,32,33
050,19,143,"Iowa","Osceola County",1,42,58,26,32
050,19,143,"Iowa","Osceola County",1,43,68,31,37
050,19,143,"Iowa","Osceola County",1,44,62,36,26
050,19,143,"Iowa","Osceola County",1,45,64,39,25
050,19,143,"Iowa","Osceola County",1,46,50,24,26
050,19,143,"Iowa","Osceola County",1,47,59,28,31
050,19,143,"Iowa","Osceola County",1,48,66,35,31
050,19,143,"Iowa","Osceola County",1,49,74,40,34
050,19,143,"Iowa","Osceola County",1,50,72,39,33
050,19,143,"Iowa","Osceola County",1,51,73,38,35
050,19,143,"Iowa","Osceola County",1,52,76,43,33
050,19,143,"Iowa","Osceola County",1,53,74,34,40
050,19,143,"Iowa","Osceola County",1,54,67,30,37
050,19,143,"Iowa","Osceola County",1,55,78,39,39
050,19,143,"Iowa","Osceola County",1,56,87,46,41
050,19,143,"Iowa","Osceola County",1,57,96,52,44
050,19,143,"Iowa","Osceola County",1,58,99,49,50
050,19,143,"Iowa","Osceola County",1,59,98,51,47
050,19,143,"Iowa","Osceola County",1,60,109,58,51
050,19,143,"Iowa","Osceola County",1,61,104,49,55
050,19,143,"Iowa","Osceola County",1,62,99,55,44
050,19,143,"Iowa","Osceola County",1,63,105,58,47
050,19,143,"Iowa","Osceola County",1,64,103,55,48
050,19,143,"Iowa","Osceola County",1,65,96,52,44
050,19,143,"Iowa","Osceola County",1,66,90,47,43
050,19,143,"Iowa","Osceola County",1,67,81,44,37
050,19,143,"Iowa","Osceola County",1,68,71,37,34
050,19,143,"Iowa","Osceola County",1,69,66,31,35
050,19,143,"Iowa","Osceola County",1,70,57,28,29
050,19,143,"Iowa","Osceola County",1,71,57,32,25
050,19,143,"Iowa","Osceola County",1,72,69,36,33
050,19,143,"Iowa","Osceola County",1,73,70,37,33
050,19,143,"Iowa","Osceola County",1,74,42,24,18
050,19,143,"Iowa","Osceola County",1,75,52,25,27
050,19,143,"Iowa","Osceola County",1,76,53,20,33
050,19,143,"Iowa","Osceola County",1,77,54,22,32
050,19,143,"Iowa","Osceola County",1,78,49,22,27
050,19,143,"Iowa","Osceola County",1,79,40,14,26
050,19,143,"Iowa","Osceola County",1,80,36,18,18
050,19,143,"Iowa","Osceola County",1,81,47,24,23
050,19,143,"Iowa","Osceola County",1,82,43,22,21
050,19,143,"Iowa","Osceola County",1,83,27,13,14
050,19,143,"Iowa","Osceola County",1,84,28,6,22
050,19,143,"Iowa","Osceola County",1,85,227,82,145
050,19,143,"Iowa","Osceola County",2,0,68,36,32
050,19,143,"Iowa","Osceola County",2,1,75,33,42
050,19,143,"Iowa","Osceola County",2,2,73,34,39
050,19,143,"Iowa","Osceola County",2,3,69,39,30
050,19,143,"Iowa","Osceola County",2,4,69,35,34
050,19,143,"Iowa","Osceola County",2,5,76,34,42
050,19,143,"Iowa","Osceola County",2,6,81,39,42
050,19,143,"Iowa","Osceola County",2,7,81,42,39
050,19,143,"Iowa","Osceola County",2,8,74,40,34
050,19,143,"Iowa","Osceola County",2,9,80,46,34
050,19,143,"Iowa","Osceola County",2,10,86,43,43
050,19,143,"Iowa","Osceola County",2,11,88,46,42
050,19,143,"Iowa","Osceola County",2,12,98,53,45
050,19,143,"Iowa","Osceola County",2,13,94,50,44
050,19,143,"Iowa","Osceola County",2,14,90,45,45
050,19,143,"Iowa","Osceola County",2,15,95,48,47
050,19,143,"Iowa","Osceola County",2,16,86,45,41
050,19,143,"Iowa","Osceola County",2,17,84,45,39
050,19,143,"Iowa","Osceola County",2,18,74,44,30
050,19,143,"Iowa","Osceola County",2,19,56,35,21
050,19,143,"Iowa","Osceola County",2,20,53,29,24
050,19,143,"Iowa","Osceola County",2,21,61,32,29
050,19,143,"Iowa","Osceola County",2,22,62,32,30
050,19,143,"Iowa","Osceola County",2,23,59,33,26
050,19,143,"Iowa","Osceola County",2,24,57,28,29
050,19,143,"Iowa","Osceola County",2,25,56,29,27
050,19,143,"Iowa","Osceola County",2,26,60,33,27
050,19,143,"Iowa","Osceola County",2,27,67,36,31
050,19,143,"Iowa","Osceola County",2,28,64,35,29
050,19,143,"Iowa","Osceola County",2,29,63,35,28
050,19,143,"Iowa","Osceola County",2,30,74,42,32
050,19,143,"Iowa","Osceola County",2,31,63,33,30
050,19,143,"Iowa","Osceola County",2,32,61,34,27
050,19,143,"Iowa","Osceola County",2,33,55,34,21
050,19,143,"Iowa","Osceola County",2,34,65,36,29
050,19,143,"Iowa","Osceola County",2,35,66,35,31
050,19,143,"Iowa","Osceola County",2,36,60,33,27
050,19,143,"Iowa","Osceola County",2,37,65,37,28
050,19,143,"Iowa","Osceola County",2,38,80,44,36
050,19,143,"Iowa","Osceola County",2,39,76,37,39
050,19,143,"Iowa","Osceola County",2,40,71,34,37
050,19,143,"Iowa","Osceola County",2,41,66,31,35
050,19,143,"Iowa","Osceola County",2,42,59,28,31
050,19,143,"Iowa","Osceola County",2,43,65,30,35
050,19,143,"Iowa","Osceola County",2,44,63,34,29
050,19,143,"Iowa","Osceola County",2,45,63,37,26
050,19,143,"Iowa","Osceola County",2,46,53,27,26
050,19,143,"Iowa","Osceola County",2,47,56,27,29
050,19,143,"Iowa","Osceola County",2,48,63,32,31
050,19,143,"Iowa","Osceola County",2,49,72,38,34
050,19,143,"Iowa","Osceola County",2,50,73,40,33
050,19,143,"Iowa","Osceola County",2,51,72,38,34
050,19,143,"Iowa","Osceola County",2,52,74,40,34
050,19,143,"Iowa","Osceola County",2,53,76,37,39
050,19,143,"Iowa","Osceola County",2,54,69,31,38
050,19,143,"Iowa","Osceola County",2,55,76,37,39
050,19,143,"Iowa","Osceola County",2,56,86,45,41
050,19,143,"Iowa","Osceola County",2,57,93,50,43
050,19,143,"Iowa","Osceola County",2,58,100,51,49
050,19,143,"Iowa","Osceola County",2,59,99,50,49
050,19,143,"Iowa","Osceola County",2,60,105,56,49
050,19,143,"Iowa","Osceola County",2,61,102,50,52
050,19,143,"Iowa","Osceola County",2,62,102,55,47
050,19,143,"Iowa","Osceola County",2,63,104,57,47
050,19,143,"Iowa","Osceola County",2,64,102,55,47
050,19,143,"Iowa","Osceola County",2,65,98,53,45
050,19,143,"Iowa","Osceola County",2,66,92,49,43
050,19,143,"Iowa","Osceola County",2,67,83,45,38
050,19,143,"Iowa","Osceola County",2,68,73,38,35
050,19,143,"Iowa","Osceola County",2,69,67,32,35
050,19,143,"Iowa","Osceola County",2,70,59,29,30
050,19,143,"Iowa","Osceola County",2,71,56,31,25
050,19,143,"Iowa","Osceola County",2,72,66,35,31
050,19,143,"Iowa","Osceola County",2,73,74,39,35
050,19,143,"Iowa","Osceola County",2,74,46,25,21
050,19,143,"Iowa","Osceola County",2,75,49,24,25
050,19,143,"Iowa","Osceola County",2,76,50,20,30
050,19,143,"Iowa","Osceola County",2,77,55,22,33
050,19,143,"Iowa","Osceola County",2,78,49,21,28
050,19,143,"Iowa","Osceola County",2,79,43,16,27
050,19,143,"Iowa","Osceola County",2,80,36,17,19
050,19,143,"Iowa","Osceola County",2,81,45,23,22
050,19,143,"Iowa","Osceola County",2,82,43,22,21
050,19,143,"Iowa","Osceola County",2,83,30,15,15
050,19,143,"Iowa","Osceola County",2,84,28,8,20
050,19,143,"Iowa","Osceola County",2,85,228,82,146
050,19,143,"Iowa","Osceola County",3,0,65,29,36
050,19,143,"Iowa","Osceola County",3,1,79,41,38
050,19,143,"Iowa","Osceola County",3,2,82,40,42
050,19,143,"Iowa","Osceola County",3,3,71,35,36
050,19,143,"Iowa","Osceola County",3,4,74,39,35
050,19,143,"Iowa","Osceola County",3,5,73,37,36
050,19,143,"Iowa","Osceola County",3,6,82,38,44
050,19,143,"Iowa","Osceola County",3,7,83,37,46
050,19,143,"Iowa","Osceola County",3,8,82,40,42
050,19,143,"Iowa","Osceola County",3,9,73,39,34
050,19,143,"Iowa","Osceola County",3,10,79,39,40
050,19,143,"Iowa","Osceola County",3,11,79,41,38
050,19,143,"Iowa","Osceola County",3,12,83,43,40
050,19,143,"Iowa","Osceola County",3,13,95,49,46
050,19,143,"Iowa","Osceola County",3,14,89,48,41
050,19,143,"Iowa","Osceola County",3,15,93,46,47
050,19,143,"Iowa","Osceola County",3,16,96,48,48
050,19,143,"Iowa","Osceola County",3,17,80,42,38
050,19,143,"Iowa","Osceola County",3,18,70,38,32
050,19,143,"Iowa","Osceola County",3,19,68,41,27
050,19,143,"Iowa","Osceola County",3,20,56,36,20
050,19,143,"Iowa","Osceola County",3,21,56,32,24
050,19,143,"Iowa","Osceola County",3,22,53,29,24
050,19,143,"Iowa","Osceola County",3,23,66,31,35
050,19,143,"Iowa","Osceola County",3,24,57,29,28
050,19,143,"Iowa","Osceola County",3,25,52,21,31
050,19,143,"Iowa","Osceola County",3,26,57,29,28
050,19,143,"Iowa","Osceola County",3,27,64,35,29
050,19,143,"Iowa","Osceola County",3,28,71,40,31
050,19,143,"Iowa","Osceola County",3,29,68,37,31
050,19,143,"Iowa","Osceola County",3,30,67,39,28
050,19,143,"Iowa","Osceola County",3,31,71,39,32
050,19,143,"Iowa","Osceola County",3,32,64,36,28
050,19,143,"Iowa","Osceola County",3,33,62,36,26
050,19,143,"Iowa","Osceola County",3,34,60,33,27
050,19,143,"Iowa","Osceola County",3,35,67,36,31
050,19,143,"Iowa","Osceola County",3,36,62,34,28
050,19,143,"Iowa","Osceola County",3,37,69,42,27
050,19,143,"Iowa","Osceola County",3,38,70,42,28
050,19,143,"Iowa","Osceola County",3,39,76,40,36
050,19,143,"Iowa","Osceola County",3,40,72,35,37
050,19,143,"Iowa","Osceola County",3,41,67,32,35
050,19,143,"Iowa","Osceola County",3,42,69,34,35
050,19,143,"Iowa","Osceola County",3,43,61,29,32
050,19,143,"Iowa","Osceola County",3,44,65,28,37
050,19,143,"Iowa","Osceola County",3,45,56,30,26
050,19,143,"Iowa","Osceola County",3,46,64,38,26
050,19,143,"Iowa","Osceola County",3,47,55,27,28
050,19,143,"Iowa","Osceola County",3,48,55,27,28
050,19,143,"Iowa","Osceola County",3,49,65,34,31
050,19,143,"Iowa","Osceola County",3,50,76,40,36
050,19,143,"Iowa","Osceola County",3,51,73,41,32
050,19,143,"Iowa","Osceola County",3,52,71,38,33
050,19,143,"Iowa","Osceola County",3,53,75,43,32
050,19,143,"Iowa","Osceola County",3,54,78,39,39
050,19,143,"Iowa","Osceola County",3,55,64,30,34
050,19,143,"Iowa","Osceola County",3,56,80,38,42
050,19,143,"Iowa","Osceola County",3,57,86,45,41
050,19,143,"Iowa","Osceola County",3,58,93,50,43
050,19,143,"Iowa","Osceola County",3,59,98,50,48
050,19,143,"Iowa","Osceola County",3,60,99,50,49
050,19,143,"Iowa","Osceola County",3,61,97,53,44
050,19,143,"Iowa","Osceola County",3,62,95,46,49
050,19,143,"Iowa","Osceola County",3,63,98,53,45
050,19,143,"Iowa","Osceola County",3,64,101,54,47
050,19,143,"Iowa","Osceola County",3,65,104,56,48
050,19,143,"Iowa","Osceola County",3,66,94,52,42
050,19,143,"Iowa","Osceola County",3,67,87,47,40
050,19,143,"Iowa","Osceola County",3,68,82,44,38
050,19,143,"Iowa","Osceola County",3,69,69,34,35
050,19,143,"Iowa","Osceola County",3,70,65,31,34
050,19,143,"Iowa","Osceola County",3,71,60,29,31
050,19,143,"Iowa","Osceola County",3,72,51,28,23
050,19,143,"Iowa","Osceola County",3,73,66,34,32
050,19,143,"Iowa","Osceola County",3,74,74,39,35
050,19,143,"Iowa","Osceola County",3,75,44,22,22
050,19,143,"Iowa","Osceola County",3,76,47,23,24
050,19,143,"Iowa","Osceola County",3,77,46,19,27
050,19,143,"Iowa","Osceola County",3,78,52,20,32
050,19,143,"Iowa","Osceola County",3,79,50,20,30
050,19,143,"Iowa","Osceola County",3,80,40,18,22
050,19,143,"Iowa","Osceola County",3,81,33,16,17
050,19,143,"Iowa","Osceola County",3,82,43,21,22
050,19,143,"Iowa","Osceola County",3,83,40,21,19
050,19,143,"Iowa","Osceola County",3,84,26,14,12
050,19,143,"Iowa","Osceola County",3,85,220,70,150
050,19,143,"Iowa","Osceola County",4,0,71,30,41
050,19,143,"Iowa","Osceola County",4,1,63,27,36
050,19,143,"Iowa","Osceola County",4,2,77,39,38
050,19,143,"Iowa","Osceola County",4,3,85,43,42
050,19,143,"Iowa","Osceola County",4,4,72,37,35
050,19,143,"Iowa","Osceola County",4,5,69,38,31
050,19,143,"Iowa","Osceola County",4,6,77,36,41
050,19,143,"Iowa","Osceola County",4,7,80,37,43
050,19,143,"Iowa","Osceola County",4,8,76,40,36
050,19,143,"Iowa","Osceola County",4,9,82,39,43
050,19,143,"Iowa","Osceola County",4,10,75,39,36
050,19,143,"Iowa","Osceola County",4,11,78,41,37
050,19,143,"Iowa","Osceola County",4,12,78,38,40
050,19,143,"Iowa","Osceola County",4,13,87,48,39
050,19,143,"Iowa","Osceola County",4,14,89,48,41
050,19,143,"Iowa","Osceola County",4,15,86,50,36
050,19,143,"Iowa","Osceola County",4,16,91,45,46
050,19,143,"Iowa","Osceola County",4,17,95,45,50
050,19,143,"Iowa","Osceola County",4,18,65,35,30
050,19,143,"Iowa","Osceola County",4,19,55,30,25
050,19,143,"Iowa","Osceola County",4,20,62,40,22
050,19,143,"Iowa","Osceola County",4,21,51,34,17
050,19,143,"Iowa","Osceola County",4,22,54,32,22
050,19,143,"Iowa","Osceola County",4,23,53,27,26
050,19,143,"Iowa","Osceola County",4,24,59,29,30
050,19,143,"Iowa","Osceola County",4,25,54,31,23
050,19,143,"Iowa","Osceola County",4,26,54,26,28
050,19,143,"Iowa","Osceola County",4,27,67,32,35
050,19,143,"Iowa","Osceola County",4,28,71,39,32
050,19,143,"Iowa","Osceola County",4,29,73,43,30
050,19,143,"Iowa","Osceola County",4,30,67,36,31
050,19,143,"Iowa","Osceola County",4,31,68,36,32
050,19,143,"Iowa","Osceola County",4,32,69,38,31
050,19,143,"Iowa","Osceola County",4,33,61,33,28
050,19,143,"Iowa","Osceola County",4,34,62,38,24
050,19,143,"Iowa","Osceola County",4,35,56,29,27
050,19,143,"Iowa","Osceola County",4,36,67,37,30
050,19,143,"Iowa","Osceola County",4,37,63,36,27
050,19,143,"Iowa","Osceola County",4,38,61,38,23
050,19,143,"Iowa","Osceola County",4,39,65,38,27
050,19,143,"Iowa","Osceola County",4,40,76,43,33
050,19,143,"Iowa","Osceola County",4,41,73,35,38
050,19,143,"Iowa","Osceola County",4,42,66,33,33
050,19,143,"Iowa","Osceola County",4,43,68,34,34
050,19,143,"Iowa","Osceola County",4,44,59,26,33
050,19,143,"Iowa","Osceola County",4,45,63,29,34
050,19,143,"Iowa","Osceola County",4,46,54,28,26
050,19,143,"Iowa","Osceola County",4,47,67,40,27
050,19,143,"Iowa","Osceola County",4,48,55,27,28
050,19,143,"Iowa","Osceola County",4,49,54,26,28
050,19,143,"Iowa","Osceola County",4,50,71,36,35
050,19,143,"Iowa","Osceola County",4,51,72,37,35
050,19,143,"Iowa","Osceola County",4,52,72,41,31
050,19,143,"Iowa","Osceola County",4,53,75,42,33
050,19,143,"Iowa","Osceola County",4,54,76,44,32
050,19,143,"Iowa","Osceola County",4,55,77,40,37
050,19,143,"Iowa","Osceola County",4,56,64,30,34
050,19,143,"Iowa","Osceola County",4,57,82,38,44
050,19,143,"Iowa","Osceola County",4,58,84,44,40
050,19,143,"Iowa","Osceola County",4,59,95,51,44
050,19,143,"Iowa","Osceola County",4,60,97,47,50
050,19,143,"Iowa","Osceola County",4,61,99,49,50
050,19,143,"Iowa","Osceola County",4,62,91,51,40
050,19,143,"Iowa","Osceola County",4,63,98,47,51
050,19,143,"Iowa","Osceola County",4,64,97,53,44
050,19,143,"Iowa","Osceola County",4,65,98,51,47
050,19,143,"Iowa","Osceola County",4,66,96,51,45
050,19,143,"Iowa","Osceola County",4,67,90,50,40
050,19,143,"Iowa","Osceola County",4,68,87,46,41
050,19,143,"Iowa","Osceola County",4,69,77,43,34
050,19,143,"Iowa","Osceola County",4,70,63,29,34
050,19,143,"Iowa","Osceola County",4,71,65,31,34
050,19,143,"Iowa","Osceola County",4,72,58,28,30
050,19,143,"Iowa","Osceola County",4,73,53,28,25
050,19,143,"Iowa","Osceola County",4,74,62,30,32
050,19,143,"Iowa","Osceola County",4,75,73,37,36
050,19,143,"Iowa","Osceola County",4,76,40,19,21
050,19,143,"Iowa","Osceola County",4,77,45,23,22
050,19,143,"Iowa","Osceola County",4,78,42,16,26
050,19,143,"Iowa","Osceola County",4,79,51,18,33
050,19,143,"Iowa","Osceola County",4,80,48,21,27
050,19,143,"Iowa","Osceola County",4,81,37,16,21
050,19,143,"Iowa","Osceola County",4,82,31,14,17
050,19,143,"Iowa","Osceola County",4,83,39,20,19
050,19,143,"Iowa","Osceola County",4,84,38,20,18
050,19,143,"Iowa","Osceola County",4,85,206,67,139
050,19,143,"Iowa","Osceola County",5,0,59,27,32
050,19,143,"Iowa","Osceola County",5,1,64,27,37
050,19,143,"Iowa","Osceola County",5,2,57,21,36
050,19,143,"Iowa","Osceola County",5,3,76,42,34
050,19,143,"Iowa","Osceola County",5,4,80,43,37
050,19,143,"Iowa","Osceola County",5,5,70,33,37
050,19,143,"Iowa","Osceola County",5,6,71,41,30
050,19,143,"Iowa","Osceola County",5,7,70,31,39
050,19,143,"Iowa","Osceola County",5,8,72,31,41
050,19,143,"Iowa","Osceola County",5,9,79,44,35
050,19,143,"Iowa","Osceola County",5,10,74,35,39
050,19,143,"Iowa","Osceola County",5,11,78,40,38
050,19,143,"Iowa","Osceola County",5,12,75,39,36
050,19,143,"Iowa","Osceola County",5,13,75,37,38
050,19,143,"Iowa","Osceola County",5,14,85,43,42
050,19,143,"Iowa","Osceola County",5,15,79,43,36
050,19,143,"Iowa","Osceola County",5,16,83,48,35
050,19,143,"Iowa","Osceola County",5,17,88,45,43
050,19,143,"Iowa","Osceola County",5,18,82,42,40
050,19,143,"Iowa","Osceola County",5,19,57,30,27
050,19,143,"Iowa","Osceola County",5,20,55,31,24
050,19,143,"Iowa","Osceola County",5,21,66,41,25
050,19,143,"Iowa","Osceola County",5,22,55,39,16
050,19,143,"Iowa","Osceola County",5,23,71,44,27
050,19,143,"Iowa","Osceola County",5,24,52,29,23
050,19,143,"Iowa","Osceola County",5,25,61,32,29
050,19,143,"Iowa","Osceola County",5,26,56,33,23
050,19,143,"Iowa","Osceola County",5,27,55,29,26
050,19,143,"Iowa","Osceola County",5,28,63,30,33
050,19,143,"Iowa","Osceola County",5,29,73,43,30
050,19,143,"Iowa","Osceola County",5,30,74,46,28
050,19,143,"Iowa","Osceola County",5,31,63,32,31
050,19,143,"Iowa","Osceola County",5,32,61,31,30
050,19,143,"Iowa","Osceola County",5,33,69,35,34
050,19,143,"Iowa","Osceola County",5,34,58,30,28
050,19,143,"Iowa","Osceola County",5,35,56,34,22
050,19,143,"Iowa","Osceola County",5,36,53,26,27
050,19,143,"Iowa","Osceola County",5,37,66,37,29
050,19,143,"Iowa","Osceola County",5,38,62,34,28
050,19,143,"Iowa","Osceola County",5,39,56,34,22
050,19,143,"Iowa","Osceola County",5,40,68,40,28
050,19,143,"Iowa","Osceola County",5,41,77,45,32
050,19,143,"Iowa","Osceola County",5,42,67,31,36
050,19,143,"Iowa","Osceola County",5,43,67,33,34
050,19,143,"Iowa","Osceola County",5,44,66,32,34
050,19,143,"Iowa","Osceola County",5,45,59,26,33
050,19,143,"Iowa","Osceola County",5,46,65,31,34
050,19,143,"Iowa","Osceola County",5,47,58,30,28
050,19,143,"Iowa","Osceola County",5,48,66,39,27
050,19,143,"Iowa","Osceola County",5,49,53,25,28
050,19,143,"Iowa","Osceola County",5,50,58,29,29
050,19,143,"Iowa","Osceola County",5,51,67,35,32
050,19,143,"Iowa","Osceola County",5,52,73,37,36
050,19,143,"Iowa","Osceola County",5,53,70,39,31
050,19,143,"Iowa","Osceola County",5,54,77,44,33
050,19,143,"Iowa","Osceola County",5,55,75,45,30
050,19,143,"Iowa","Osceola County",5,56,76,40,36
050,19,143,"Iowa","Osceola County",5,57,65,30,35
050,19,143,"Iowa","Osceola County",5,58,85,39,46
050,19,143,"Iowa","Osceola County",5,59,84,45,39
050,19,143,"Iowa","Osceola County",5,60,94,50,44
050,19,143,"Iowa","Osceola County",5,61,95,47,48
050,19,143,"Iowa","Osceola County",5,62,100,50,50
050,19,143,"Iowa","Osceola County",5,63,88,51,37
050,19,143,"Iowa","Osceola County",5,64,96,46,50
050,19,143,"Iowa","Osceola County",5,65,92,51,41
050,19,143,"Iowa","Osceola County",5,66,97,47,50
050,19,143,"Iowa","Osceola County",5,67,88,47,41
050,19,143,"Iowa","Osceola County",5,68,88,49,39
050,19,143,"Iowa","Osceola County",5,69,85,45,40
050,19,143,"Iowa","Osceola County",5,70,74,42,32
050,19,143,"Iowa","Osceola County",5,71,64,29,35
050,19,143,"Iowa","Osceola County",5,72,62,29,33
050,19,143,"Iowa","Osceola County",5,73,55,28,27
050,19,143,"Iowa","Osceola County",5,74,53,27,26
050,19,143,"Iowa","Osceola County",5,75,62,29,33
050,19,143,"Iowa","Osceola County",5,76,70,35,35
050,19,143,"Iowa","Osceola County",5,77,39,19,20
050,19,143,"Iowa","Osceola County",5,78,41,21,20
050,19,143,"Iowa","Osceola County",5,79,40,13,27
050,19,143,"Iowa","Osceola County",5,80,49,19,30
050,19,143,"Iowa","Osceola County",5,81,49,22,27
050,19,143,"Iowa","Osceola County",5,82,34,15,19
050,19,143,"Iowa","Osceola County",5,83,28,13,15
050,19,143,"Iowa","Osceola County",5,84,36,17,19
050,19,143,"Iowa","Osceola County",5,85,224,75,149
050,19,145,"Iowa","Page County",1,0,132,66,66
050,19,145,"Iowa","Page County",1,1,140,65,75
050,19,145,"Iowa","Page County",1,2,135,77,58
050,19,145,"Iowa","Page County",1,3,161,79,82
050,19,145,"Iowa","Page County",1,4,156,84,72
050,19,145,"Iowa","Page County",1,5,147,76,71
050,19,145,"Iowa","Page County",1,6,151,84,67
050,19,145,"Iowa","Page County",1,7,142,81,61
050,19,145,"Iowa","Page County",1,8,151,75,76
050,19,145,"Iowa","Page County",1,9,148,70,78
050,19,145,"Iowa","Page County",1,10,160,80,80
050,19,145,"Iowa","Page County",1,11,170,83,87
050,19,145,"Iowa","Page County",1,12,161,83,78
050,19,145,"Iowa","Page County",1,13,168,93,75
050,19,145,"Iowa","Page County",1,14,168,97,71
050,19,145,"Iowa","Page County",1,15,160,87,73
050,19,145,"Iowa","Page County",1,16,173,100,73
050,19,145,"Iowa","Page County",1,17,156,96,60
050,19,145,"Iowa","Page County",1,18,138,73,65
050,19,145,"Iowa","Page County",1,19,111,66,45
050,19,145,"Iowa","Page County",1,20,121,63,58
050,19,145,"Iowa","Page County",1,21,154,90,64
050,19,145,"Iowa","Page County",1,22,166,95,71
050,19,145,"Iowa","Page County",1,23,174,108,66
050,19,145,"Iowa","Page County",1,24,174,110,64
050,19,145,"Iowa","Page County",1,25,171,95,76
050,19,145,"Iowa","Page County",1,26,181,97,84
050,19,145,"Iowa","Page County",1,27,197,104,93
050,19,145,"Iowa","Page County",1,28,187,108,79
050,19,145,"Iowa","Page County",1,29,199,115,84
050,19,145,"Iowa","Page County",1,30,193,112,81
050,19,145,"Iowa","Page County",1,31,192,118,74
050,19,145,"Iowa","Page County",1,32,178,104,74
050,19,145,"Iowa","Page County",1,33,169,100,69
050,19,145,"Iowa","Page County",1,34,174,103,71
050,19,145,"Iowa","Page County",1,35,178,103,75
050,19,145,"Iowa","Page County",1,36,188,111,77
050,19,145,"Iowa","Page County",1,37,181,93,88
050,19,145,"Iowa","Page County",1,38,214,110,104
050,19,145,"Iowa","Page County",1,39,217,122,95
050,19,145,"Iowa","Page County",1,40,189,104,85
050,19,145,"Iowa","Page County",1,41,204,127,77
050,19,145,"Iowa","Page County",1,42,217,123,94
050,19,145,"Iowa","Page County",1,43,192,117,75
050,19,145,"Iowa","Page County",1,44,188,120,68
050,19,145,"Iowa","Page County",1,45,183,106,77
050,19,145,"Iowa","Page County",1,46,188,108,80
050,19,145,"Iowa","Page County",1,47,185,105,80
050,19,145,"Iowa","Page County",1,48,190,108,82
050,19,145,"Iowa","Page County",1,49,227,127,100
050,19,145,"Iowa","Page County",1,50,190,108,82
050,19,145,"Iowa","Page County",1,51,181,102,79
050,19,145,"Iowa","Page County",1,52,153,90,63
050,19,145,"Iowa","Page County",1,53,153,89,64
050,19,145,"Iowa","Page County",1,54,179,93,86
050,19,145,"Iowa","Page County",1,55,189,87,102
050,19,145,"Iowa","Page County",1,56,206,96,110
050,19,145,"Iowa","Page County",1,57,210,106,104
050,19,145,"Iowa","Page County",1,58,234,128,106
050,19,145,"Iowa","Page County",1,59,242,124,118
050,19,145,"Iowa","Page County",1,60,228,120,108
050,19,145,"Iowa","Page County",1,61,227,112,115
050,19,145,"Iowa","Page County",1,62,220,107,113
050,19,145,"Iowa","Page County",1,63,245,113,132
050,19,145,"Iowa","Page County",1,64,248,125,123
050,19,145,"Iowa","Page County",1,65,247,118,129
050,19,145,"Iowa","Page County",1,66,234,115,119
050,19,145,"Iowa","Page County",1,67,229,120,109
050,19,145,"Iowa","Page County",1,68,219,108,111
050,19,145,"Iowa","Page County",1,69,207,103,104
050,19,145,"Iowa","Page County",1,70,185,101,84
050,19,145,"Iowa","Page County",1,71,177,92,85
050,19,145,"Iowa","Page County",1,72,179,82,97
050,19,145,"Iowa","Page County",1,73,171,83,88
050,19,145,"Iowa","Page County",1,74,127,65,62
050,19,145,"Iowa","Page County",1,75,139,64,75
050,19,145,"Iowa","Page County",1,76,131,60,71
050,19,145,"Iowa","Page County",1,77,120,55,65
050,19,145,"Iowa","Page County",1,78,114,48,66
050,19,145,"Iowa","Page County",1,79,99,41,58
050,19,145,"Iowa","Page County",1,80,105,48,57
050,19,145,"Iowa","Page County",1,81,93,48,45
050,19,145,"Iowa","Page County",1,82,82,40,42
050,19,145,"Iowa","Page County",1,83,73,30,43
050,19,145,"Iowa","Page County",1,84,88,36,52
050,19,145,"Iowa","Page County",1,85,484,152,332
050,19,145,"Iowa","Page County",2,0,130,66,64
050,19,145,"Iowa","Page County",2,1,136,64,72
050,19,145,"Iowa","Page County",2,2,136,73,63
050,19,145,"Iowa","Page County",2,3,153,78,75
050,19,145,"Iowa","Page County",2,4,156,82,74
050,19,145,"Iowa","Page County",2,5,152,79,73
050,19,145,"Iowa","Page County",2,6,150,82,68
050,19,145,"Iowa","Page County",2,7,143,81,62
050,19,145,"Iowa","Page County",2,8,150,76,74
050,19,145,"Iowa","Page County",2,9,149,72,77
050,19,145,"Iowa","Page County",2,10,157,76,81
050,19,145,"Iowa","Page County",2,11,167,82,85
050,19,145,"Iowa","Page County",2,12,167,84,83
050,19,145,"Iowa","Page County",2,13,168,92,76
050,19,145,"Iowa","Page County",2,14,168,96,72
050,19,145,"Iowa","Page County",2,15,163,90,73
050,19,145,"Iowa","Page County",2,16,172,99,73
050,19,145,"Iowa","Page County",2,17,162,98,64
050,19,145,"Iowa","Page County",2,18,134,74,60
050,19,145,"Iowa","Page County",2,19,113,66,47
050,19,145,"Iowa","Page County",2,20,121,65,56
050,19,145,"Iowa","Page County",2,21,151,87,64
050,19,145,"Iowa","Page County",2,22,164,94,70
050,19,145,"Iowa","Page County",2,23,173,105,68
050,19,145,"Iowa","Page County",2,24,173,109,64
050,19,145,"Iowa","Page County",2,25,169,97,72
050,19,145,"Iowa","Page County",2,26,177,95,82
050,19,145,"Iowa","Page County",2,27,193,103,90
050,19,145,"Iowa","Page County",2,28,189,107,82
050,19,145,"Iowa","Page County",2,29,199,116,83
050,19,145,"Iowa","Page County",2,30,194,112,82
050,19,145,"Iowa","Page County",2,31,191,117,74
050,19,145,"Iowa","Page County",2,32,178,102,76
050,19,145,"Iowa","Page County",2,33,170,100,70
050,19,145,"Iowa","Page County",2,34,173,103,70
050,19,145,"Iowa","Page County",2,35,175,101,74
050,19,145,"Iowa","Page County",2,36,191,115,76
050,19,145,"Iowa","Page County",2,37,180,94,86
050,19,145,"Iowa","Page County",2,38,212,109,103
050,19,145,"Iowa","Page County",2,39,219,124,95
050,19,145,"Iowa","Page County",2,40,195,107,88
050,19,145,"Iowa","Page County",2,41,203,125,78
050,19,145,"Iowa","Page County",2,42,210,120,90
050,19,145,"Iowa","Page County",2,43,198,118,80
050,19,145,"Iowa","Page County",2,44,190,120,70
050,19,145,"Iowa","Page County",2,45,183,108,75
050,19,145,"Iowa","Page County",2,46,187,108,79
050,19,145,"Iowa","Page County",2,47,184,105,79
050,19,145,"Iowa","Page County",2,48,188,106,82
050,19,145,"Iowa","Page County",2,49,224,126,98
050,19,145,"Iowa","Page County",2,50,197,111,86
050,19,145,"Iowa","Page County",2,51,183,102,81
050,19,145,"Iowa","Page County",2,52,157,90,67
050,19,145,"Iowa","Page County",2,53,152,88,64
050,19,145,"Iowa","Page County",2,54,174,92,82
050,19,145,"Iowa","Page County",2,55,186,87,99
050,19,145,"Iowa","Page County",2,56,203,95,108
050,19,145,"Iowa","Page County",2,57,211,105,106
050,19,145,"Iowa","Page County",2,58,230,124,106
050,19,145,"Iowa","Page County",2,59,239,124,115
050,19,145,"Iowa","Page County",2,60,231,122,109
050,19,145,"Iowa","Page County",2,61,225,111,114
050,19,145,"Iowa","Page County",2,62,218,107,111
050,19,145,"Iowa","Page County",2,63,242,113,129
050,19,145,"Iowa","Page County",2,64,243,119,124
050,19,145,"Iowa","Page County",2,65,247,121,126
050,19,145,"Iowa","Page County",2,66,237,115,122
050,19,145,"Iowa","Page County",2,67,228,119,109
050,19,145,"Iowa","Page County",2,68,218,109,109
050,19,145,"Iowa","Page County",2,69,209,105,104
050,19,145,"Iowa","Page County",2,70,189,101,88
050,19,145,"Iowa","Page County",2,71,180,94,86
050,19,145,"Iowa","Page County",2,72,173,81,92
050,19,145,"Iowa","Page County",2,73,180,88,92
050,19,145,"Iowa","Page County",2,74,127,63,64
050,19,145,"Iowa","Page County",2,75,135,63,72
050,19,145,"Iowa","Page County",2,76,131,60,71
050,19,145,"Iowa","Page County",2,77,124,57,67
050,19,145,"Iowa","Page County",2,78,114,48,66
050,19,145,"Iowa","Page County",2,79,102,43,59
050,19,145,"Iowa","Page County",2,80,104,46,58
050,19,145,"Iowa","Page County",2,81,94,47,47
050,19,145,"Iowa","Page County",2,82,82,40,42
050,19,145,"Iowa","Page County",2,83,75,32,43
050,19,145,"Iowa","Page County",2,84,85,35,50
050,19,145,"Iowa","Page County",2,85,485,150,335
050,19,145,"Iowa","Page County",3,0,135,74,61
050,19,145,"Iowa","Page County",3,1,129,64,65
050,19,145,"Iowa","Page County",3,2,130,59,71
050,19,145,"Iowa","Page County",3,3,139,77,62
050,19,145,"Iowa","Page County",3,4,142,75,67
050,19,145,"Iowa","Page County",3,5,162,83,79
050,19,145,"Iowa","Page County",3,6,153,76,77
050,19,145,"Iowa","Page County",3,7,159,90,69
050,19,145,"Iowa","Page County",3,8,136,77,59
050,19,145,"Iowa","Page County",3,9,148,73,75
050,19,145,"Iowa","Page County",3,10,142,70,72
050,19,145,"Iowa","Page County",3,11,154,76,78
050,19,145,"Iowa","Page County",3,12,164,82,82
050,19,145,"Iowa","Page County",3,13,171,87,84
050,19,145,"Iowa","Page County",3,14,169,100,69
050,19,145,"Iowa","Page County",3,15,181,108,73
050,19,145,"Iowa","Page County",3,16,172,101,71
050,19,145,"Iowa","Page County",3,17,170,95,75
050,19,145,"Iowa","Page County",3,18,128,81,47
050,19,145,"Iowa","Page County",3,19,126,79,47
050,19,145,"Iowa","Page County",3,20,126,71,55
050,19,145,"Iowa","Page County",3,21,139,80,59
050,19,145,"Iowa","Page County",3,22,156,97,59
050,19,145,"Iowa","Page County",3,23,181,110,71
050,19,145,"Iowa","Page County",3,24,186,117,69
050,19,145,"Iowa","Page County",3,25,175,111,64
050,19,145,"Iowa","Page County",3,26,183,102,81
050,19,145,"Iowa","Page County",3,27,190,107,83
050,19,145,"Iowa","Page County",3,28,192,107,85
050,19,145,"Iowa","Page County",3,29,204,122,82
050,19,145,"Iowa","Page County",3,30,200,114,86
050,19,145,"Iowa","Page County",3,31,204,122,82
050,19,145,"Iowa","Page County",3,32,176,96,80
050,19,145,"Iowa","Page County",3,33,169,98,71
050,19,145,"Iowa","Page County",3,34,181,110,71
050,19,145,"Iowa","Page County",3,35,174,102,72
050,19,145,"Iowa","Page County",3,36,207,128,79
050,19,145,"Iowa","Page County",3,37,171,100,71
050,19,145,"Iowa","Page County",3,38,190,100,90
050,19,145,"Iowa","Page County",3,39,228,134,94
050,19,145,"Iowa","Page County",3,40,208,115,93
050,19,145,"Iowa","Page County",3,41,209,126,83
050,19,145,"Iowa","Page County",3,42,188,110,78
050,19,145,"Iowa","Page County",3,43,205,116,89
050,19,145,"Iowa","Page County",3,44,192,117,75
050,19,145,"Iowa","Page County",3,45,189,120,69
050,19,145,"Iowa","Page County",3,46,184,108,76
050,19,145,"Iowa","Page County",3,47,179,105,74
050,19,145,"Iowa","Page County",3,48,181,98,83
050,19,145,"Iowa","Page County",3,49,203,117,86
050,19,145,"Iowa","Page County",3,50,217,120,97
050,19,145,"Iowa","Page County",3,51,206,115,91
050,19,145,"Iowa","Page County",3,52,172,98,74
050,19,145,"Iowa","Page County",3,53,156,90,66
050,19,145,"Iowa","Page County",3,54,159,97,62
050,19,145,"Iowa","Page County",3,55,165,85,80
050,19,145,"Iowa","Page County",3,56,193,94,99
050,19,145,"Iowa","Page County",3,57,204,92,112
050,19,145,"Iowa","Page County",3,58,217,111,106
050,19,145,"Iowa","Page County",3,59,223,116,107
050,19,145,"Iowa","Page County",3,60,239,127,112
050,19,145,"Iowa","Page County",3,61,233,123,110
050,19,145,"Iowa","Page County",3,62,219,109,110
050,19,145,"Iowa","Page County",3,63,215,102,113
050,19,145,"Iowa","Page County",3,64,236,106,130
050,19,145,"Iowa","Page County",3,65,241,123,118
050,19,145,"Iowa","Page County",3,66,242,114,128
050,19,145,"Iowa","Page County",3,67,229,115,114
050,19,145,"Iowa","Page County",3,68,228,117,111
050,19,145,"Iowa","Page County",3,69,213,104,109
050,19,145,"Iowa","Page County",3,70,199,99,100
050,19,145,"Iowa","Page County",3,71,191,104,87
050,19,145,"Iowa","Page County",3,72,180,91,89
050,19,145,"Iowa","Page County",3,73,164,76,88
050,19,145,"Iowa","Page County",3,74,182,93,89
050,19,145,"Iowa","Page County",3,75,125,59,66
050,19,145,"Iowa","Page County",3,76,127,56,71
050,19,145,"Iowa","Page County",3,77,124,56,68
050,19,145,"Iowa","Page County",3,78,122,54,68
050,19,145,"Iowa","Page County",3,79,100,41,59
050,19,145,"Iowa","Page County",3,80,95,40,55
050,19,145,"Iowa","Page County",3,81,94,40,54
050,19,145,"Iowa","Page County",3,82,90,46,44
050,19,145,"Iowa","Page County",3,83,74,32,42
050,19,145,"Iowa","Page County",3,84,74,31,43
050,19,145,"Iowa","Page County",3,85,492,148,344
050,19,145,"Iowa","Page County",4,0,134,78,56
050,19,145,"Iowa","Page County",4,1,135,81,54
050,19,145,"Iowa","Page County",4,2,138,67,71
050,19,145,"Iowa","Page County",4,3,125,57,68
050,19,145,"Iowa","Page County",4,4,131,68,63
050,19,145,"Iowa","Page County",4,5,144,75,69
050,19,145,"Iowa","Page County",4,6,159,82,77
050,19,145,"Iowa","Page County",4,7,143,73,70
050,19,145,"Iowa","Page County",4,8,149,84,65
050,19,145,"Iowa","Page County",4,9,149,81,68
050,19,145,"Iowa","Page County",4,10,146,70,76
050,19,145,"Iowa","Page County",4,11,149,74,75
050,19,145,"Iowa","Page County",4,12,159,84,75
050,19,145,"Iowa","Page County",4,13,155,77,78
050,19,145,"Iowa","Page County",4,14,169,81,88
050,19,145,"Iowa","Page County",4,15,179,104,75
050,19,145,"Iowa","Page County",4,16,185,116,69
050,19,145,"Iowa","Page County",4,17,176,107,69
050,19,145,"Iowa","Page County",4,18,130,73,57
050,19,145,"Iowa","Page County",4,19,112,73,39
050,19,145,"Iowa","Page County",4,20,120,74,46
050,19,145,"Iowa","Page County",4,21,134,82,52
050,19,145,"Iowa","Page County",4,22,145,82,63
050,19,145,"Iowa","Page County",4,23,174,108,66
050,19,145,"Iowa","Page County",4,24,192,114,78
050,19,145,"Iowa","Page County",4,25,181,113,68
050,19,145,"Iowa","Page County",4,26,175,106,69
050,19,145,"Iowa","Page County",4,27,181,109,72
050,19,145,"Iowa","Page County",4,28,184,105,79
050,19,145,"Iowa","Page County",4,29,201,113,88
050,19,145,"Iowa","Page County",4,30,199,121,78
050,19,145,"Iowa","Page County",4,31,211,121,90
050,19,145,"Iowa","Page County",4,32,187,109,78
050,19,145,"Iowa","Page County",4,33,178,100,78
050,19,145,"Iowa","Page County",4,34,188,114,74
050,19,145,"Iowa","Page County",4,35,175,102,73
050,19,145,"Iowa","Page County",4,36,199,124,75
050,19,145,"Iowa","Page County",4,37,190,109,81
050,19,145,"Iowa","Page County",4,38,178,102,76
050,19,145,"Iowa","Page County",4,39,208,118,90
050,19,145,"Iowa","Page County",4,40,224,124,100
050,19,145,"Iowa","Page County",4,41,220,131,89
050,19,145,"Iowa","Page County",4,42,202,114,88
050,19,145,"Iowa","Page County",4,43,182,108,74
050,19,145,"Iowa","Page County",4,44,206,122,84
050,19,145,"Iowa","Page County",4,45,193,118,75
050,19,145,"Iowa","Page County",4,46,189,119,70
050,19,145,"Iowa","Page County",4,47,180,102,78
050,19,145,"Iowa","Page County",4,48,178,102,76
050,19,145,"Iowa","Page County",4,49,193,107,86
050,19,145,"Iowa","Page County",4,50,204,121,83
050,19,145,"Iowa","Page County",4,51,235,127,108
050,19,145,"Iowa","Page County",4,52,196,108,88
050,19,145,"Iowa","Page County",4,53,168,94,74
050,19,145,"Iowa","Page County",4,54,160,96,64
050,19,145,"Iowa","Page County",4,55,150,88,62
050,19,145,"Iowa","Page County",4,56,173,91,82
050,19,145,"Iowa","Page County",4,57,196,94,102
050,19,145,"Iowa","Page County",4,58,210,97,113
050,19,145,"Iowa","Page County",4,59,211,111,100
050,19,145,"Iowa","Page County",4,60,221,116,105
050,19,145,"Iowa","Page County",4,61,231,118,113
050,19,145,"Iowa","Page County",4,62,223,117,106
050,19,145,"Iowa","Page County",4,63,219,112,107
050,19,145,"Iowa","Page County",4,64,210,94,116
050,19,145,"Iowa","Page County",4,65,231,109,122
050,19,145,"Iowa","Page County",4,66,242,121,121
050,19,145,"Iowa","Page County",4,67,235,113,122
050,19,145,"Iowa","Page County",4,68,227,110,117
050,19,145,"Iowa","Page County",4,69,219,116,103
050,19,145,"Iowa","Page County",4,70,205,101,104
050,19,145,"Iowa","Page County",4,71,192,96,96
050,19,145,"Iowa","Page County",4,72,193,104,89
050,19,145,"Iowa","Page County",4,73,167,84,83
050,19,145,"Iowa","Page County",4,74,157,76,81
050,19,145,"Iowa","Page County",4,75,181,91,90
050,19,145,"Iowa","Page County",4,76,122,57,65
050,19,145,"Iowa","Page County",4,77,126,57,69
050,19,145,"Iowa","Page County",4,78,120,53,67
050,19,145,"Iowa","Page County",4,79,116,50,66
050,19,145,"Iowa","Page County",4,80,93,38,55
050,19,145,"Iowa","Page County",4,81,92,39,53
050,19,145,"Iowa","Page County",4,82,91,39,52
050,19,145,"Iowa","Page County",4,83,80,38,42
050,19,145,"Iowa","Page County",4,84,77,32,45
050,19,145,"Iowa","Page County",4,85,469,151,318
050,19,145,"Iowa","Page County",5,0,132,77,55
050,19,145,"Iowa","Page County",5,1,142,86,56
050,19,145,"Iowa","Page County",5,2,128,76,52
050,19,145,"Iowa","Page County",5,3,136,66,70
050,19,145,"Iowa","Page County",5,4,129,61,68
050,19,145,"Iowa","Page County",5,5,123,61,62
050,19,145,"Iowa","Page County",5,6,150,76,74
050,19,145,"Iowa","Page County",5,7,163,83,80
050,19,145,"Iowa","Page County",5,8,141,71,70
050,19,145,"Iowa","Page County",5,9,155,86,69
050,19,145,"Iowa","Page County",5,10,143,81,62
050,19,145,"Iowa","Page County",5,11,140,70,70
050,19,145,"Iowa","Page County",5,12,153,78,75
050,19,145,"Iowa","Page County",5,13,163,90,73
050,19,145,"Iowa","Page County",5,14,167,84,83
050,19,145,"Iowa","Page County",5,15,176,86,90
050,19,145,"Iowa","Page County",5,16,187,107,80
050,19,145,"Iowa","Page County",5,17,181,111,70
050,19,145,"Iowa","Page County",5,18,137,81,56
050,19,145,"Iowa","Page County",5,19,112,67,45
050,19,145,"Iowa","Page County",5,20,118,70,48
050,19,145,"Iowa","Page County",5,21,131,86,45
050,19,145,"Iowa","Page County",5,22,138,82,56
050,19,145,"Iowa","Page County",5,23,149,86,63
050,19,145,"Iowa","Page County",5,24,169,106,63
050,19,145,"Iowa","Page County",5,25,175,100,75
050,19,145,"Iowa","Page County",5,26,175,110,65
050,19,145,"Iowa","Page County",5,27,171,105,66
050,19,145,"Iowa","Page County",5,28,184,108,76
050,19,145,"Iowa","Page County",5,29,191,113,78
050,19,145,"Iowa","Page County",5,30,197,105,92
050,19,145,"Iowa","Page County",5,31,206,131,75
050,19,145,"Iowa","Page County",5,32,201,104,97
050,19,145,"Iowa","Page County",5,33,195,114,81
050,19,145,"Iowa","Page County",5,34,182,101,81
050,19,145,"Iowa","Page County",5,35,178,104,74
050,19,145,"Iowa","Page County",5,36,202,120,82
050,19,145,"Iowa","Page County",5,37,180,103,77
050,19,145,"Iowa","Page County",5,38,196,109,87
050,19,145,"Iowa","Page County",5,39,187,112,75
050,19,145,"Iowa","Page County",5,40,194,105,89
050,19,145,"Iowa","Page County",5,41,235,131,104
050,19,145,"Iowa","Page County",5,42,208,118,90
050,19,145,"Iowa","Page County",5,43,207,115,92
050,19,145,"Iowa","Page County",5,44,172,103,69
050,19,145,"Iowa","Page County",5,45,202,120,82
050,19,145,"Iowa","Page County",5,46,188,114,74
050,19,145,"Iowa","Page County",5,47,181,119,62
050,19,145,"Iowa","Page County",5,48,173,94,79
050,19,145,"Iowa","Page County",5,49,193,111,82
050,19,145,"Iowa","Page County",5,50,186,96,90
050,19,145,"Iowa","Page County",5,51,198,119,79
050,19,145,"Iowa","Page County",5,52,210,112,98
050,19,145,"Iowa","Page County",5,53,184,104,80
050,19,145,"Iowa","Page County",5,54,167,92,75
050,19,145,"Iowa","Page County",5,55,147,83,64
050,19,145,"Iowa","Page County",5,56,152,93,59
050,19,145,"Iowa","Page County",5,57,163,82,81
050,19,145,"Iowa","Page County",5,58,199,98,101
050,19,145,"Iowa","Page County",5,59,197,87,110
050,19,145,"Iowa","Page County",5,60,207,110,97
050,19,145,"Iowa","Page County",5,61,230,117,113
050,19,145,"Iowa","Page County",5,62,228,114,114
050,19,145,"Iowa","Page County",5,63,214,108,106
050,19,145,"Iowa","Page County",5,64,219,111,108
050,19,145,"Iowa","Page County",5,65,207,94,113
050,19,145,"Iowa","Page County",5,66,230,104,126
050,19,145,"Iowa","Page County",5,67,239,122,117
050,19,145,"Iowa","Page County",5,68,235,112,123
050,19,145,"Iowa","Page County",5,69,222,106,116
050,19,145,"Iowa","Page County",5,70,223,114,109
050,19,145,"Iowa","Page County",5,71,203,98,105
050,19,145,"Iowa","Page County",5,72,197,97,100
050,19,145,"Iowa","Page County",5,73,183,97,86
050,19,145,"Iowa","Page County",5,74,163,83,80
050,19,145,"Iowa","Page County",5,75,155,75,80
050,19,145,"Iowa","Page County",5,76,174,87,87
050,19,145,"Iowa","Page County",5,77,119,56,63
050,19,145,"Iowa","Page County",5,78,125,53,72
050,19,145,"Iowa","Page County",5,79,110,48,62
050,19,145,"Iowa","Page County",5,80,110,48,62
050,19,145,"Iowa","Page County",5,81,81,33,48
050,19,145,"Iowa","Page County",5,82,87,38,49
050,19,145,"Iowa","Page County",5,83,80,30,50
050,19,145,"Iowa","Page County",5,84,79,37,42
050,19,145,"Iowa","Page County",5,85,455,153,302
050,19,147,"Iowa","Palo Alto County",1,0,100,53,47
050,19,147,"Iowa","Palo Alto County",1,1,102,60,42
050,19,147,"Iowa","Palo Alto County",1,2,117,59,58
050,19,147,"Iowa","Palo Alto County",1,3,114,53,61
050,19,147,"Iowa","Palo Alto County",1,4,117,65,52
050,19,147,"Iowa","Palo Alto County",1,5,104,61,43
050,19,147,"Iowa","Palo Alto County",1,6,113,55,58
050,19,147,"Iowa","Palo Alto County",1,7,93,40,53
050,19,147,"Iowa","Palo Alto County",1,8,106,45,61
050,19,147,"Iowa","Palo Alto County",1,9,112,58,54
050,19,147,"Iowa","Palo Alto County",1,10,113,56,57
050,19,147,"Iowa","Palo Alto County",1,11,137,69,68
050,19,147,"Iowa","Palo Alto County",1,12,129,61,68
050,19,147,"Iowa","Palo Alto County",1,13,133,72,61
050,19,147,"Iowa","Palo Alto County",1,14,128,66,62
050,19,147,"Iowa","Palo Alto County",1,15,124,65,59
050,19,147,"Iowa","Palo Alto County",1,16,120,68,52
050,19,147,"Iowa","Palo Alto County",1,17,131,69,62
050,19,147,"Iowa","Palo Alto County",1,18,115,64,51
050,19,147,"Iowa","Palo Alto County",1,19,117,70,47
050,19,147,"Iowa","Palo Alto County",1,20,117,64,53
050,19,147,"Iowa","Palo Alto County",1,21,85,50,35
050,19,147,"Iowa","Palo Alto County",1,22,79,42,37
050,19,147,"Iowa","Palo Alto County",1,23,94,49,45
050,19,147,"Iowa","Palo Alto County",1,24,124,60,64
050,19,147,"Iowa","Palo Alto County",1,25,92,50,42
050,19,147,"Iowa","Palo Alto County",1,26,102,58,44
050,19,147,"Iowa","Palo Alto County",1,27,111,53,58
050,19,147,"Iowa","Palo Alto County",1,28,102,51,51
050,19,147,"Iowa","Palo Alto County",1,29,98,50,48
050,19,147,"Iowa","Palo Alto County",1,30,95,50,45
050,19,147,"Iowa","Palo Alto County",1,31,107,54,53
050,19,147,"Iowa","Palo Alto County",1,32,81,50,31
050,19,147,"Iowa","Palo Alto County",1,33,95,51,44
050,19,147,"Iowa","Palo Alto County",1,34,108,59,49
050,19,147,"Iowa","Palo Alto County",1,35,93,54,39
050,19,147,"Iowa","Palo Alto County",1,36,114,61,53
050,19,147,"Iowa","Palo Alto County",1,37,128,70,58
050,19,147,"Iowa","Palo Alto County",1,38,121,69,52
050,19,147,"Iowa","Palo Alto County",1,39,100,48,52
050,19,147,"Iowa","Palo Alto County",1,40,96,46,50
050,19,147,"Iowa","Palo Alto County",1,41,90,44,46
050,19,147,"Iowa","Palo Alto County",1,42,89,50,39
050,19,147,"Iowa","Palo Alto County",1,43,91,50,41
050,19,147,"Iowa","Palo Alto County",1,44,84,42,42
050,19,147,"Iowa","Palo Alto County",1,45,93,46,47
050,19,147,"Iowa","Palo Alto County",1,46,86,41,45
050,19,147,"Iowa","Palo Alto County",1,47,98,45,53
050,19,147,"Iowa","Palo Alto County",1,48,102,49,53
050,19,147,"Iowa","Palo Alto County",1,49,94,47,47
050,19,147,"Iowa","Palo Alto County",1,50,92,48,44
050,19,147,"Iowa","Palo Alto County",1,51,94,49,45
050,19,147,"Iowa","Palo Alto County",1,52,84,39,45
050,19,147,"Iowa","Palo Alto County",1,53,90,39,51
050,19,147,"Iowa","Palo Alto County",1,54,98,48,50
050,19,147,"Iowa","Palo Alto County",1,55,119,59,60
050,19,147,"Iowa","Palo Alto County",1,56,122,68,54
050,19,147,"Iowa","Palo Alto County",1,57,118,66,52
050,19,147,"Iowa","Palo Alto County",1,58,128,62,66
050,19,147,"Iowa","Palo Alto County",1,59,140,71,69
050,19,147,"Iowa","Palo Alto County",1,60,134,75,59
050,19,147,"Iowa","Palo Alto County",1,61,140,73,67
050,19,147,"Iowa","Palo Alto County",1,62,134,66,68
050,19,147,"Iowa","Palo Alto County",1,63,137,74,63
050,19,147,"Iowa","Palo Alto County",1,64,134,65,69
050,19,147,"Iowa","Palo Alto County",1,65,131,60,71
050,19,147,"Iowa","Palo Alto County",1,66,123,71,52
050,19,147,"Iowa","Palo Alto County",1,67,117,62,55
050,19,147,"Iowa","Palo Alto County",1,68,114,52,62
050,19,147,"Iowa","Palo Alto County",1,69,104,52,52
050,19,147,"Iowa","Palo Alto County",1,70,107,54,53
050,19,147,"Iowa","Palo Alto County",1,71,96,51,45
050,19,147,"Iowa","Palo Alto County",1,72,99,53,46
050,19,147,"Iowa","Palo Alto County",1,73,82,37,45
050,19,147,"Iowa","Palo Alto County",1,74,62,25,37
050,19,147,"Iowa","Palo Alto County",1,75,65,28,37
050,19,147,"Iowa","Palo Alto County",1,76,71,36,35
050,19,147,"Iowa","Palo Alto County",1,77,60,30,30
050,19,147,"Iowa","Palo Alto County",1,78,53,28,25
050,19,147,"Iowa","Palo Alto County",1,79,70,32,38
050,19,147,"Iowa","Palo Alto County",1,80,46,18,28
050,19,147,"Iowa","Palo Alto County",1,81,51,17,34
050,19,147,"Iowa","Palo Alto County",1,82,50,15,35
050,19,147,"Iowa","Palo Alto County",1,83,43,15,28
050,19,147,"Iowa","Palo Alto County",1,84,48,18,30
050,19,147,"Iowa","Palo Alto County",1,85,344,108,236
050,19,147,"Iowa","Palo Alto County",2,0,96,50,46
050,19,147,"Iowa","Palo Alto County",2,1,100,58,42
050,19,147,"Iowa","Palo Alto County",2,2,114,60,54
050,19,147,"Iowa","Palo Alto County",2,3,116,56,60
050,19,147,"Iowa","Palo Alto County",2,4,116,61,55
050,19,147,"Iowa","Palo Alto County",2,5,104,60,44
050,19,147,"Iowa","Palo Alto County",2,6,109,56,53
050,19,147,"Iowa","Palo Alto County",2,7,99,45,54
050,19,147,"Iowa","Palo Alto County",2,8,104,45,59
050,19,147,"Iowa","Palo Alto County",2,9,112,56,56
050,19,147,"Iowa","Palo Alto County",2,10,114,57,57
050,19,147,"Iowa","Palo Alto County",2,11,129,64,65
050,19,147,"Iowa","Palo Alto County",2,12,133,63,70
050,19,147,"Iowa","Palo Alto County",2,13,131,69,62
050,19,147,"Iowa","Palo Alto County",2,14,129,67,62
050,19,147,"Iowa","Palo Alto County",2,15,124,65,59
050,19,147,"Iowa","Palo Alto County",2,16,122,67,55
050,19,147,"Iowa","Palo Alto County",2,17,129,69,60
050,19,147,"Iowa","Palo Alto County",2,18,117,64,53
050,19,147,"Iowa","Palo Alto County",2,19,122,73,49
050,19,147,"Iowa","Palo Alto County",2,20,115,63,52
050,19,147,"Iowa","Palo Alto County",2,21,86,50,36
050,19,147,"Iowa","Palo Alto County",2,22,77,42,35
050,19,147,"Iowa","Palo Alto County",2,23,93,48,45
050,19,147,"Iowa","Palo Alto County",2,24,114,56,58
050,19,147,"Iowa","Palo Alto County",2,25,101,54,47
050,19,147,"Iowa","Palo Alto County",2,26,101,57,44
050,19,147,"Iowa","Palo Alto County",2,27,107,53,54
050,19,147,"Iowa","Palo Alto County",2,28,103,51,52
050,19,147,"Iowa","Palo Alto County",2,29,101,52,49
050,19,147,"Iowa","Palo Alto County",2,30,96,50,46
050,19,147,"Iowa","Palo Alto County",2,31,104,54,50
050,19,147,"Iowa","Palo Alto County",2,32,87,51,36
050,19,147,"Iowa","Palo Alto County",2,33,92,51,41
050,19,147,"Iowa","Palo Alto County",2,34,105,56,49
050,19,147,"Iowa","Palo Alto County",2,35,99,57,42
050,19,147,"Iowa","Palo Alto County",2,36,110,60,50
050,19,147,"Iowa","Palo Alto County",2,37,126,68,58
050,19,147,"Iowa","Palo Alto County",2,38,123,69,54
050,19,147,"Iowa","Palo Alto County",2,39,105,53,52
050,19,147,"Iowa","Palo Alto County",2,40,96,46,50
050,19,147,"Iowa","Palo Alto County",2,41,91,44,47
050,19,147,"Iowa","Palo Alto County",2,42,89,48,41
050,19,147,"Iowa","Palo Alto County",2,43,91,50,41
050,19,147,"Iowa","Palo Alto County",2,44,86,44,42
050,19,147,"Iowa","Palo Alto County",2,45,91,45,46
050,19,147,"Iowa","Palo Alto County",2,46,88,42,46
050,19,147,"Iowa","Palo Alto County",2,47,96,45,51
050,19,147,"Iowa","Palo Alto County",2,48,101,48,53
050,19,147,"Iowa","Palo Alto County",2,49,96,47,49
050,19,147,"Iowa","Palo Alto County",2,50,92,48,44
050,19,147,"Iowa","Palo Alto County",2,51,93,48,45
050,19,147,"Iowa","Palo Alto County",2,52,86,41,45
050,19,147,"Iowa","Palo Alto County",2,53,88,38,50
050,19,147,"Iowa","Palo Alto County",2,54,96,46,50
050,19,147,"Iowa","Palo Alto County",2,55,113,55,58
050,19,147,"Iowa","Palo Alto County",2,56,122,67,55
050,19,147,"Iowa","Palo Alto County",2,57,119,67,52
050,19,147,"Iowa","Palo Alto County",2,58,126,63,63
050,19,147,"Iowa","Palo Alto County",2,59,137,69,68
050,19,147,"Iowa","Palo Alto County",2,60,133,73,60
050,19,147,"Iowa","Palo Alto County",2,61,137,72,65
050,19,147,"Iowa","Palo Alto County",2,62,135,67,68
050,19,147,"Iowa","Palo Alto County",2,63,138,74,64
050,19,147,"Iowa","Palo Alto County",2,64,134,67,67
050,19,147,"Iowa","Palo Alto County",2,65,133,62,71
050,19,147,"Iowa","Palo Alto County",2,66,124,68,56
050,19,147,"Iowa","Palo Alto County",2,67,118,63,55
050,19,147,"Iowa","Palo Alto County",2,68,112,54,58
050,19,147,"Iowa","Palo Alto County",2,69,108,53,55
050,19,147,"Iowa","Palo Alto County",2,70,106,53,53
050,19,147,"Iowa","Palo Alto County",2,71,99,52,47
050,19,147,"Iowa","Palo Alto County",2,72,96,52,44
050,19,147,"Iowa","Palo Alto County",2,73,89,42,47
050,19,147,"Iowa","Palo Alto County",2,74,62,26,36
050,19,147,"Iowa","Palo Alto County",2,75,65,28,37
050,19,147,"Iowa","Palo Alto County",2,76,68,33,35
050,19,147,"Iowa","Palo Alto County",2,77,60,29,31
050,19,147,"Iowa","Palo Alto County",2,78,55,28,27
050,19,147,"Iowa","Palo Alto County",2,79,68,32,36
050,19,147,"Iowa","Palo Alto County",2,80,49,21,28
050,19,147,"Iowa","Palo Alto County",2,81,50,17,33
050,19,147,"Iowa","Palo Alto County",2,82,50,15,35
050,19,147,"Iowa","Palo Alto County",2,83,44,15,29
050,19,147,"Iowa","Palo Alto County",2,84,48,18,30
050,19,147,"Iowa","Palo Alto County",2,85,343,108,235
050,19,147,"Iowa","Palo Alto County",3,0,119,56,63
050,19,147,"Iowa","Palo Alto County",3,1,95,48,47
050,19,147,"Iowa","Palo Alto County",3,2,105,56,49
050,19,147,"Iowa","Palo Alto County",3,3,107,56,51
050,19,147,"Iowa","Palo Alto County",3,4,118,58,60
050,19,147,"Iowa","Palo Alto County",3,5,110,57,53
050,19,147,"Iowa","Palo Alto County",3,6,102,60,42
050,19,147,"Iowa","Palo Alto County",3,7,106,56,50
050,19,147,"Iowa","Palo Alto County",3,8,97,45,52
050,19,147,"Iowa","Palo Alto County",3,9,91,36,55
050,19,147,"Iowa","Palo Alto County",3,10,111,54,57
050,19,147,"Iowa","Palo Alto County",3,11,113,58,55
050,19,147,"Iowa","Palo Alto County",3,12,131,66,65
050,19,147,"Iowa","Palo Alto County",3,13,136,69,67
050,19,147,"Iowa","Palo Alto County",3,14,141,74,67
050,19,147,"Iowa","Palo Alto County",3,15,129,67,62
050,19,147,"Iowa","Palo Alto County",3,16,133,71,62
050,19,147,"Iowa","Palo Alto County",3,17,124,68,56
050,19,147,"Iowa","Palo Alto County",3,18,118,64,54
050,19,147,"Iowa","Palo Alto County",3,19,117,66,51
050,19,147,"Iowa","Palo Alto County",3,20,122,67,55
050,19,147,"Iowa","Palo Alto County",3,21,104,57,47
050,19,147,"Iowa","Palo Alto County",3,22,80,50,30
050,19,147,"Iowa","Palo Alto County",3,23,86,47,39
050,19,147,"Iowa","Palo Alto County",3,24,81,44,37
050,19,147,"Iowa","Palo Alto County",3,25,107,53,54
050,19,147,"Iowa","Palo Alto County",3,26,101,51,50
050,19,147,"Iowa","Palo Alto County",3,27,91,52,39
050,19,147,"Iowa","Palo Alto County",3,28,106,52,54
050,19,147,"Iowa","Palo Alto County",3,29,92,44,48
050,19,147,"Iowa","Palo Alto County",3,30,106,55,51
050,19,147,"Iowa","Palo Alto County",3,31,99,52,47
050,19,147,"Iowa","Palo Alto County",3,32,101,51,50
050,19,147,"Iowa","Palo Alto County",3,33,87,53,34
050,19,147,"Iowa","Palo Alto County",3,34,89,49,40
050,19,147,"Iowa","Palo Alto County",3,35,107,59,48
050,19,147,"Iowa","Palo Alto County",3,36,95,53,42
050,19,147,"Iowa","Palo Alto County",3,37,105,57,48
050,19,147,"Iowa","Palo Alto County",3,38,124,60,64
050,19,147,"Iowa","Palo Alto County",3,39,120,69,51
050,19,147,"Iowa","Palo Alto County",3,40,105,49,56
050,19,147,"Iowa","Palo Alto County",3,41,89,42,47
050,19,147,"Iowa","Palo Alto County",3,42,94,47,47
050,19,147,"Iowa","Palo Alto County",3,43,89,47,42
050,19,147,"Iowa","Palo Alto County",3,44,94,53,41
050,19,147,"Iowa","Palo Alto County",3,45,87,46,41
050,19,147,"Iowa","Palo Alto County",3,46,94,46,48
050,19,147,"Iowa","Palo Alto County",3,47,86,42,44
050,19,147,"Iowa","Palo Alto County",3,48,96,45,51
050,19,147,"Iowa","Palo Alto County",3,49,97,47,50
050,19,147,"Iowa","Palo Alto County",3,50,95,47,48
050,19,147,"Iowa","Palo Alto County",3,51,89,45,44
050,19,147,"Iowa","Palo Alto County",3,52,91,47,44
050,19,147,"Iowa","Palo Alto County",3,53,91,42,49
050,19,147,"Iowa","Palo Alto County",3,54,89,40,49
050,19,147,"Iowa","Palo Alto County",3,55,95,45,50
050,19,147,"Iowa","Palo Alto County",3,56,112,58,54
050,19,147,"Iowa","Palo Alto County",3,57,118,64,54
050,19,147,"Iowa","Palo Alto County",3,58,121,65,56
050,19,147,"Iowa","Palo Alto County",3,59,126,63,63
050,19,147,"Iowa","Palo Alto County",3,60,133,66,67
050,19,147,"Iowa","Palo Alto County",3,61,140,76,64
050,19,147,"Iowa","Palo Alto County",3,62,135,71,64
050,19,147,"Iowa","Palo Alto County",3,63,137,69,68
050,19,147,"Iowa","Palo Alto County",3,64,133,72,61
050,19,147,"Iowa","Palo Alto County",3,65,132,61,71
050,19,147,"Iowa","Palo Alto County",3,66,135,64,71
050,19,147,"Iowa","Palo Alto County",3,67,126,67,59
050,19,147,"Iowa","Palo Alto County",3,68,111,60,51
050,19,147,"Iowa","Palo Alto County",3,69,114,56,58
050,19,147,"Iowa","Palo Alto County",3,70,105,50,55
050,19,147,"Iowa","Palo Alto County",3,71,102,48,54
050,19,147,"Iowa","Palo Alto County",3,72,98,51,47
050,19,147,"Iowa","Palo Alto County",3,73,91,49,42
050,19,147,"Iowa","Palo Alto County",3,74,89,41,48
050,19,147,"Iowa","Palo Alto County",3,75,58,26,32
050,19,147,"Iowa","Palo Alto County",3,76,61,26,35
050,19,147,"Iowa","Palo Alto County",3,77,60,29,31
050,19,147,"Iowa","Palo Alto County",3,78,56,25,31
050,19,147,"Iowa","Palo Alto County",3,79,61,30,31
050,19,147,"Iowa","Palo Alto County",3,80,61,31,30
050,19,147,"Iowa","Palo Alto County",3,81,46,18,28
050,19,147,"Iowa","Palo Alto County",3,82,49,17,32
050,19,147,"Iowa","Palo Alto County",3,83,45,15,30
050,19,147,"Iowa","Palo Alto County",3,84,40,16,24
050,19,147,"Iowa","Palo Alto County",3,85,341,104,237
050,19,147,"Iowa","Palo Alto County",4,0,112,53,59
050,19,147,"Iowa","Palo Alto County",4,1,113,53,60
050,19,147,"Iowa","Palo Alto County",4,2,95,49,46
050,19,147,"Iowa","Palo Alto County",4,3,91,49,42
050,19,147,"Iowa","Palo Alto County",4,4,102,54,48
050,19,147,"Iowa","Palo Alto County",4,5,114,54,60
050,19,147,"Iowa","Palo Alto County",4,6,111,56,55
050,19,147,"Iowa","Palo Alto County",4,7,96,57,39
050,19,147,"Iowa","Palo Alto County",4,8,104,54,50
050,19,147,"Iowa","Palo Alto County",4,9,97,44,53
050,19,147,"Iowa","Palo Alto County",4,10,96,41,55
050,19,147,"Iowa","Palo Alto County",4,11,116,60,56
050,19,147,"Iowa","Palo Alto County",4,12,118,61,57
050,19,147,"Iowa","Palo Alto County",4,13,134,62,72
050,19,147,"Iowa","Palo Alto County",4,14,131,66,65
050,19,147,"Iowa","Palo Alto County",4,15,132,68,64
050,19,147,"Iowa","Palo Alto County",4,16,124,66,58
050,19,147,"Iowa","Palo Alto County",4,17,129,68,61
050,19,147,"Iowa","Palo Alto County",4,18,114,64,50
050,19,147,"Iowa","Palo Alto County",4,19,122,70,52
050,19,147,"Iowa","Palo Alto County",4,20,115,64,51
050,19,147,"Iowa","Palo Alto County",4,21,97,57,40
050,19,147,"Iowa","Palo Alto County",4,22,98,54,44
050,19,147,"Iowa","Palo Alto County",4,23,92,55,37
050,19,147,"Iowa","Palo Alto County",4,24,80,42,38
050,19,147,"Iowa","Palo Alto County",4,25,77,48,29
050,19,147,"Iowa","Palo Alto County",4,26,99,50,49
050,19,147,"Iowa","Palo Alto County",4,27,103,54,49
050,19,147,"Iowa","Palo Alto County",4,28,90,52,38
050,19,147,"Iowa","Palo Alto County",4,29,96,48,48
050,19,147,"Iowa","Palo Alto County",4,30,87,40,47
050,19,147,"Iowa","Palo Alto County",4,31,106,58,48
050,19,147,"Iowa","Palo Alto County",4,32,99,53,46
050,19,147,"Iowa","Palo Alto County",4,33,98,48,50
050,19,147,"Iowa","Palo Alto County",4,34,81,46,35
050,19,147,"Iowa","Palo Alto County",4,35,89,51,38
050,19,147,"Iowa","Palo Alto County",4,36,105,55,50
050,19,147,"Iowa","Palo Alto County",4,37,91,49,42
050,19,147,"Iowa","Palo Alto County",4,38,104,57,47
050,19,147,"Iowa","Palo Alto County",4,39,125,63,62
050,19,147,"Iowa","Palo Alto County",4,40,117,66,51
050,19,147,"Iowa","Palo Alto County",4,41,104,49,55
050,19,147,"Iowa","Palo Alto County",4,42,86,42,44
050,19,147,"Iowa","Palo Alto County",4,43,100,51,49
050,19,147,"Iowa","Palo Alto County",4,44,88,46,42
050,19,147,"Iowa","Palo Alto County",4,45,94,50,44
050,19,147,"Iowa","Palo Alto County",4,46,89,46,43
050,19,147,"Iowa","Palo Alto County",4,47,92,45,47
050,19,147,"Iowa","Palo Alto County",4,48,86,42,44
050,19,147,"Iowa","Palo Alto County",4,49,90,45,45
050,19,147,"Iowa","Palo Alto County",4,50,98,46,52
050,19,147,"Iowa","Palo Alto County",4,51,88,45,43
050,19,147,"Iowa","Palo Alto County",4,52,86,42,44
050,19,147,"Iowa","Palo Alto County",4,53,90,47,43
050,19,147,"Iowa","Palo Alto County",4,54,92,42,50
050,19,147,"Iowa","Palo Alto County",4,55,84,35,49
050,19,147,"Iowa","Palo Alto County",4,56,93,44,49
050,19,147,"Iowa","Palo Alto County",4,57,113,58,55
050,19,147,"Iowa","Palo Alto County",4,58,114,63,51
050,19,147,"Iowa","Palo Alto County",4,59,119,65,54
050,19,147,"Iowa","Palo Alto County",4,60,124,62,62
050,19,147,"Iowa","Palo Alto County",4,61,132,65,67
050,19,147,"Iowa","Palo Alto County",4,62,143,78,65
050,19,147,"Iowa","Palo Alto County",4,63,139,74,65
050,19,147,"Iowa","Palo Alto County",4,64,134,67,67
050,19,147,"Iowa","Palo Alto County",4,65,125,65,60
050,19,147,"Iowa","Palo Alto County",4,66,128,60,68
050,19,147,"Iowa","Palo Alto County",4,67,134,60,74
050,19,147,"Iowa","Palo Alto County",4,68,127,69,58
050,19,147,"Iowa","Palo Alto County",4,69,113,62,51
050,19,147,"Iowa","Palo Alto County",4,70,111,55,56
050,19,147,"Iowa","Palo Alto County",4,71,99,47,52
050,19,147,"Iowa","Palo Alto County",4,72,103,48,55
050,19,147,"Iowa","Palo Alto County",4,73,91,49,42
050,19,147,"Iowa","Palo Alto County",4,74,92,48,44
050,19,147,"Iowa","Palo Alto County",4,75,83,40,43
050,19,147,"Iowa","Palo Alto County",4,76,56,24,32
050,19,147,"Iowa","Palo Alto County",4,77,60,24,36
050,19,147,"Iowa","Palo Alto County",4,78,62,27,35
050,19,147,"Iowa","Palo Alto County",4,79,60,25,35
050,19,147,"Iowa","Palo Alto County",4,80,54,28,26
050,19,147,"Iowa","Palo Alto County",4,81,56,25,31
050,19,147,"Iowa","Palo Alto County",4,82,45,18,27
050,19,147,"Iowa","Palo Alto County",4,83,42,15,27
050,19,147,"Iowa","Palo Alto County",4,84,46,17,29
050,19,147,"Iowa","Palo Alto County",4,85,325,97,228
050,19,147,"Iowa","Palo Alto County",5,0,112,53,59
050,19,147,"Iowa","Palo Alto County",5,1,107,48,59
050,19,147,"Iowa","Palo Alto County",5,2,125,59,66
050,19,147,"Iowa","Palo Alto County",5,3,99,46,53
050,19,147,"Iowa","Palo Alto County",5,4,97,49,48
050,19,147,"Iowa","Palo Alto County",5,5,99,53,46
050,19,147,"Iowa","Palo Alto County",5,6,116,53,63
050,19,147,"Iowa","Palo Alto County",5,7,111,55,56
050,19,147,"Iowa","Palo Alto County",5,8,103,61,42
050,19,147,"Iowa","Palo Alto County",5,9,102,53,49
050,19,147,"Iowa","Palo Alto County",5,10,100,48,52
050,19,147,"Iowa","Palo Alto County",5,11,107,49,58
050,19,147,"Iowa","Palo Alto County",5,12,117,58,59
050,19,147,"Iowa","Palo Alto County",5,13,116,58,58
050,19,147,"Iowa","Palo Alto County",5,14,126,59,67
050,19,147,"Iowa","Palo Alto County",5,15,131,67,64
050,19,147,"Iowa","Palo Alto County",5,16,133,69,64
050,19,147,"Iowa","Palo Alto County",5,17,130,71,59
050,19,147,"Iowa","Palo Alto County",5,18,122,68,54
050,19,147,"Iowa","Palo Alto County",5,19,128,75,53
050,19,147,"Iowa","Palo Alto County",5,20,116,60,56
050,19,147,"Iowa","Palo Alto County",5,21,98,54,44
050,19,147,"Iowa","Palo Alto County",5,22,96,49,47
050,19,147,"Iowa","Palo Alto County",5,23,92,53,39
050,19,147,"Iowa","Palo Alto County",5,24,92,57,35
050,19,147,"Iowa","Palo Alto County",5,25,79,45,34
050,19,147,"Iowa","Palo Alto County",5,26,83,50,33
050,19,147,"Iowa","Palo Alto County",5,27,88,41,47
050,19,147,"Iowa","Palo Alto County",5,28,98,51,47
050,19,147,"Iowa","Palo Alto County",5,29,92,51,41
050,19,147,"Iowa","Palo Alto County",5,30,103,55,48
050,19,147,"Iowa","Palo Alto County",5,31,94,44,50
050,19,147,"Iowa","Palo Alto County",5,32,101,58,43
050,19,147,"Iowa","Palo Alto County",5,33,93,46,47
050,19,147,"Iowa","Palo Alto County",5,34,93,45,48
050,19,147,"Iowa","Palo Alto County",5,35,89,48,41
050,19,147,"Iowa","Palo Alto County",5,36,92,54,38
050,19,147,"Iowa","Palo Alto County",5,37,109,58,51
050,19,147,"Iowa","Palo Alto County",5,38,91,47,44
050,19,147,"Iowa","Palo Alto County",5,39,108,61,47
050,19,147,"Iowa","Palo Alto County",5,40,126,61,65
050,19,147,"Iowa","Palo Alto County",5,41,116,68,48
050,19,147,"Iowa","Palo Alto County",5,42,103,48,55
050,19,147,"Iowa","Palo Alto County",5,43,87,42,45
050,19,147,"Iowa","Palo Alto County",5,44,99,51,48
050,19,147,"Iowa","Palo Alto County",5,45,90,48,42
050,19,147,"Iowa","Palo Alto County",5,46,96,50,46
050,19,147,"Iowa","Palo Alto County",5,47,93,49,44
050,19,147,"Iowa","Palo Alto County",5,48,88,44,44
050,19,147,"Iowa","Palo Alto County",5,49,93,47,46
050,19,147,"Iowa","Palo Alto County",5,50,93,48,45
050,19,147,"Iowa","Palo Alto County",5,51,98,47,51
050,19,147,"Iowa","Palo Alto County",5,52,88,47,41
050,19,147,"Iowa","Palo Alto County",5,53,91,43,48
050,19,147,"Iowa","Palo Alto County",5,54,87,46,41
050,19,147,"Iowa","Palo Alto County",5,55,87,40,47
050,19,147,"Iowa","Palo Alto County",5,56,86,37,49
050,19,147,"Iowa","Palo Alto County",5,57,92,47,45
050,19,147,"Iowa","Palo Alto County",5,58,113,58,55
050,19,147,"Iowa","Palo Alto County",5,59,111,60,51
050,19,147,"Iowa","Palo Alto County",5,60,117,62,55
050,19,147,"Iowa","Palo Alto County",5,61,126,62,64
050,19,147,"Iowa","Palo Alto County",5,62,130,64,66
050,19,147,"Iowa","Palo Alto County",5,63,146,77,69
050,19,147,"Iowa","Palo Alto County",5,64,136,71,65
050,19,147,"Iowa","Palo Alto County",5,65,133,64,69
050,19,147,"Iowa","Palo Alto County",5,66,121,64,57
050,19,147,"Iowa","Palo Alto County",5,67,125,57,68
050,19,147,"Iowa","Palo Alto County",5,68,131,58,73
050,19,147,"Iowa","Palo Alto County",5,69,123,70,53
050,19,147,"Iowa","Palo Alto County",5,70,108,57,51
050,19,147,"Iowa","Palo Alto County",5,71,107,52,55
050,19,147,"Iowa","Palo Alto County",5,72,96,46,50
050,19,147,"Iowa","Palo Alto County",5,73,88,40,48
050,19,147,"Iowa","Palo Alto County",5,74,90,46,44
050,19,147,"Iowa","Palo Alto County",5,75,90,49,41
050,19,147,"Iowa","Palo Alto County",5,76,79,37,42
050,19,147,"Iowa","Palo Alto County",5,77,53,24,29
050,19,147,"Iowa","Palo Alto County",5,78,60,23,37
050,19,147,"Iowa","Palo Alto County",5,79,69,28,41
050,19,147,"Iowa","Palo Alto County",5,80,50,23,27
050,19,147,"Iowa","Palo Alto County",5,81,50,24,26
050,19,147,"Iowa","Palo Alto County",5,82,53,23,30
050,19,147,"Iowa","Palo Alto County",5,83,37,17,20
050,19,147,"Iowa","Palo Alto County",5,84,45,17,28
050,19,147,"Iowa","Palo Alto County",5,85,322,94,228
050,19,149,"Iowa","Plymouth County",1,0,276,142,134
050,19,149,"Iowa","Plymouth County",1,1,287,146,141
050,19,149,"Iowa","Plymouth County",1,2,319,161,158
050,19,149,"Iowa","Plymouth County",1,3,325,168,157
050,19,149,"Iowa","Plymouth County",1,4,366,191,175
050,19,149,"Iowa","Plymouth County",1,5,378,207,171
050,19,149,"Iowa","Plymouth County",1,6,355,169,186
050,19,149,"Iowa","Plymouth County",1,7,344,165,179
050,19,149,"Iowa","Plymouth County",1,8,344,165,179
050,19,149,"Iowa","Plymouth County",1,9,350,187,163
050,19,149,"Iowa","Plymouth County",1,10,357,180,177
050,19,149,"Iowa","Plymouth County",1,11,388,206,182
050,19,149,"Iowa","Plymouth County",1,12,412,210,202
050,19,149,"Iowa","Plymouth County",1,13,409,202,207
050,19,149,"Iowa","Plymouth County",1,14,406,210,196
050,19,149,"Iowa","Plymouth County",1,15,380,190,190
050,19,149,"Iowa","Plymouth County",1,16,374,197,177
050,19,149,"Iowa","Plymouth County",1,17,394,212,182
050,19,149,"Iowa","Plymouth County",1,18,313,181,132
050,19,149,"Iowa","Plymouth County",1,19,247,140,107
050,19,149,"Iowa","Plymouth County",1,20,259,133,126
050,19,149,"Iowa","Plymouth County",1,21,270,133,137
050,19,149,"Iowa","Plymouth County",1,22,294,153,141
050,19,149,"Iowa","Plymouth County",1,23,321,167,154
050,19,149,"Iowa","Plymouth County",1,24,287,146,141
050,19,149,"Iowa","Plymouth County",1,25,257,132,125
050,19,149,"Iowa","Plymouth County",1,26,255,139,116
050,19,149,"Iowa","Plymouth County",1,27,266,147,119
050,19,149,"Iowa","Plymouth County",1,28,289,143,146
050,19,149,"Iowa","Plymouth County",1,29,278,143,135
050,19,149,"Iowa","Plymouth County",1,30,268,137,131
050,19,149,"Iowa","Plymouth County",1,31,258,139,119
050,19,149,"Iowa","Plymouth County",1,32,277,149,128
050,19,149,"Iowa","Plymouth County",1,33,266,137,129
050,19,149,"Iowa","Plymouth County",1,34,286,148,138
050,19,149,"Iowa","Plymouth County",1,35,313,155,158
050,19,149,"Iowa","Plymouth County",1,36,295,143,152
050,19,149,"Iowa","Plymouth County",1,37,305,163,142
050,19,149,"Iowa","Plymouth County",1,38,332,169,163
050,19,149,"Iowa","Plymouth County",1,39,346,170,176
050,19,149,"Iowa","Plymouth County",1,40,334,165,169
050,19,149,"Iowa","Plymouth County",1,41,338,174,164
050,19,149,"Iowa","Plymouth County",1,42,316,175,141
050,19,149,"Iowa","Plymouth County",1,43,315,155,160
050,19,149,"Iowa","Plymouth County",1,44,292,159,133
050,19,149,"Iowa","Plymouth County",1,45,278,144,134
050,19,149,"Iowa","Plymouth County",1,46,274,141,133
050,19,149,"Iowa","Plymouth County",1,47,260,130,130
050,19,149,"Iowa","Plymouth County",1,48,291,139,152
050,19,149,"Iowa","Plymouth County",1,49,335,164,171
050,19,149,"Iowa","Plymouth County",1,50,323,166,157
050,19,149,"Iowa","Plymouth County",1,51,311,175,136
050,19,149,"Iowa","Plymouth County",1,52,300,162,138
050,19,149,"Iowa","Plymouth County",1,53,297,156,141
050,19,149,"Iowa","Plymouth County",1,54,320,167,153
050,19,149,"Iowa","Plymouth County",1,55,330,167,163
050,19,149,"Iowa","Plymouth County",1,56,329,154,175
050,19,149,"Iowa","Plymouth County",1,57,343,160,183
050,19,149,"Iowa","Plymouth County",1,58,383,194,189
050,19,149,"Iowa","Plymouth County",1,59,387,208,179
050,19,149,"Iowa","Plymouth County",1,60,379,193,186
050,19,149,"Iowa","Plymouth County",1,61,367,190,177
050,19,149,"Iowa","Plymouth County",1,62,368,190,178
050,19,149,"Iowa","Plymouth County",1,63,344,170,174
050,19,149,"Iowa","Plymouth County",1,64,355,180,175
050,19,149,"Iowa","Plymouth County",1,65,350,177,173
050,19,149,"Iowa","Plymouth County",1,66,313,154,159
050,19,149,"Iowa","Plymouth County",1,67,299,147,152
050,19,149,"Iowa","Plymouth County",1,68,302,151,151
050,19,149,"Iowa","Plymouth County",1,69,290,150,140
050,19,149,"Iowa","Plymouth County",1,70,266,135,131
050,19,149,"Iowa","Plymouth County",1,71,247,115,132
050,19,149,"Iowa","Plymouth County",1,72,251,125,126
050,19,149,"Iowa","Plymouth County",1,73,239,121,118
050,19,149,"Iowa","Plymouth County",1,74,160,77,83
050,19,149,"Iowa","Plymouth County",1,75,176,85,91
050,19,149,"Iowa","Plymouth County",1,76,180,88,92
050,19,149,"Iowa","Plymouth County",1,77,179,88,91
050,19,149,"Iowa","Plymouth County",1,78,162,75,87
050,19,149,"Iowa","Plymouth County",1,79,141,63,78
050,19,149,"Iowa","Plymouth County",1,80,118,49,69
050,19,149,"Iowa","Plymouth County",1,81,125,55,70
050,19,149,"Iowa","Plymouth County",1,82,111,44,67
050,19,149,"Iowa","Plymouth County",1,83,103,49,54
050,19,149,"Iowa","Plymouth County",1,84,96,46,50
050,19,149,"Iowa","Plymouth County",1,85,676,224,452
050,19,149,"Iowa","Plymouth County",2,0,270,139,131
050,19,149,"Iowa","Plymouth County",2,1,286,145,141
050,19,149,"Iowa","Plymouth County",2,2,313,159,154
050,19,149,"Iowa","Plymouth County",2,3,324,168,156
050,19,149,"Iowa","Plymouth County",2,4,359,188,171
050,19,149,"Iowa","Plymouth County",2,5,376,203,173
050,19,149,"Iowa","Plymouth County",2,6,362,179,183
050,19,149,"Iowa","Plymouth County",2,7,345,165,180
050,19,149,"Iowa","Plymouth County",2,8,343,164,179
050,19,149,"Iowa","Plymouth County",2,9,348,182,166
050,19,149,"Iowa","Plymouth County",2,10,355,181,174
050,19,149,"Iowa","Plymouth County",2,11,378,198,180
050,19,149,"Iowa","Plymouth County",2,12,406,209,197
050,19,149,"Iowa","Plymouth County",2,13,412,205,207
050,19,149,"Iowa","Plymouth County",2,14,408,208,200
050,19,149,"Iowa","Plymouth County",2,15,385,196,189
050,19,149,"Iowa","Plymouth County",2,16,376,195,181
050,19,149,"Iowa","Plymouth County",2,17,389,208,181
050,19,149,"Iowa","Plymouth County",2,18,316,182,134
050,19,149,"Iowa","Plymouth County",2,19,248,142,106
050,19,149,"Iowa","Plymouth County",2,20,263,138,125
050,19,149,"Iowa","Plymouth County",2,21,270,134,136
050,19,149,"Iowa","Plymouth County",2,22,289,150,139
050,19,149,"Iowa","Plymouth County",2,23,317,165,152
050,19,149,"Iowa","Plymouth County",2,24,292,149,143
050,19,149,"Iowa","Plymouth County",2,25,264,136,128
050,19,149,"Iowa","Plymouth County",2,26,258,139,119
050,19,149,"Iowa","Plymouth County",2,27,265,144,121
050,19,149,"Iowa","Plymouth County",2,28,288,147,141
050,19,149,"Iowa","Plymouth County",2,29,283,144,139
050,19,149,"Iowa","Plymouth County",2,30,275,141,134
050,19,149,"Iowa","Plymouth County",2,31,258,137,121
050,19,149,"Iowa","Plymouth County",2,32,271,145,126
050,19,149,"Iowa","Plymouth County",2,33,270,142,128
050,19,149,"Iowa","Plymouth County",2,34,285,149,136
050,19,149,"Iowa","Plymouth County",2,35,309,156,153
050,19,149,"Iowa","Plymouth County",2,36,302,149,153
050,19,149,"Iowa","Plymouth County",2,37,306,161,145
050,19,149,"Iowa","Plymouth County",2,38,329,169,160
050,19,149,"Iowa","Plymouth County",2,39,343,170,173
050,19,149,"Iowa","Plymouth County",2,40,340,167,173
050,19,149,"Iowa","Plymouth County",2,41,336,172,164
050,19,149,"Iowa","Plymouth County",2,42,319,173,146
050,19,149,"Iowa","Plymouth County",2,43,317,162,155
050,19,149,"Iowa","Plymouth County",2,44,293,155,138
050,19,149,"Iowa","Plymouth County",2,45,283,148,135
050,19,149,"Iowa","Plymouth County",2,46,274,140,134
050,19,149,"Iowa","Plymouth County",2,47,263,132,131
050,19,149,"Iowa","Plymouth County",2,48,284,138,146
050,19,149,"Iowa","Plymouth County",2,49,326,158,168
050,19,149,"Iowa","Plymouth County",2,50,323,164,159
050,19,149,"Iowa","Plymouth County",2,51,308,169,139
050,19,149,"Iowa","Plymouth County",2,52,298,163,135
050,19,149,"Iowa","Plymouth County",2,53,295,155,140
050,19,149,"Iowa","Plymouth County",2,54,312,165,147
050,19,149,"Iowa","Plymouth County",2,55,329,168,161
050,19,149,"Iowa","Plymouth County",2,56,328,158,170
050,19,149,"Iowa","Plymouth County",2,57,338,158,180
050,19,149,"Iowa","Plymouth County",2,58,373,185,188
050,19,149,"Iowa","Plymouth County",2,59,389,207,182
050,19,149,"Iowa","Plymouth County",2,60,378,196,182
050,19,149,"Iowa","Plymouth County",2,61,369,190,179
050,19,149,"Iowa","Plymouth County",2,62,366,189,177
050,19,149,"Iowa","Plymouth County",2,63,356,178,178
050,19,149,"Iowa","Plymouth County",2,64,349,177,172
050,19,149,"Iowa","Plymouth County",2,65,353,177,176
050,19,149,"Iowa","Plymouth County",2,66,324,159,165
050,19,149,"Iowa","Plymouth County",2,67,300,148,152
050,19,149,"Iowa","Plymouth County",2,68,298,149,149
050,19,149,"Iowa","Plymouth County",2,69,296,152,144
050,19,149,"Iowa","Plymouth County",2,70,271,138,133
050,19,149,"Iowa","Plymouth County",2,71,247,116,131
050,19,149,"Iowa","Plymouth County",2,72,244,119,125
050,19,149,"Iowa","Plymouth County",2,73,252,128,124
050,19,149,"Iowa","Plymouth County",2,74,166,81,85
050,19,149,"Iowa","Plymouth County",2,75,172,82,90
050,19,149,"Iowa","Plymouth County",2,76,179,87,92
050,19,149,"Iowa","Plymouth County",2,77,182,89,93
050,19,149,"Iowa","Plymouth County",2,78,160,76,84
050,19,149,"Iowa","Plymouth County",2,79,143,65,78
050,19,149,"Iowa","Plymouth County",2,80,122,51,71
050,19,149,"Iowa","Plymouth County",2,81,122,54,68
050,19,149,"Iowa","Plymouth County",2,82,115,46,69
050,19,149,"Iowa","Plymouth County",2,83,103,47,56
050,19,149,"Iowa","Plymouth County",2,84,94,46,48
050,19,149,"Iowa","Plymouth County",2,85,667,223,444
050,19,149,"Iowa","Plymouth County",3,0,292,146,146
050,19,149,"Iowa","Plymouth County",3,1,287,159,128
050,19,149,"Iowa","Plymouth County",3,2,294,147,147
050,19,149,"Iowa","Plymouth County",3,3,331,168,163
050,19,149,"Iowa","Plymouth County",3,4,329,172,157
050,19,149,"Iowa","Plymouth County",3,5,363,192,171
050,19,149,"Iowa","Plymouth County",3,6,378,203,175
050,19,149,"Iowa","Plymouth County",3,7,361,172,189
050,19,149,"Iowa","Plymouth County",3,8,350,169,181
050,19,149,"Iowa","Plymouth County",3,9,350,172,178
050,19,149,"Iowa","Plymouth County",3,10,363,198,165
050,19,149,"Iowa","Plymouth County",3,11,370,194,176
050,19,149,"Iowa","Plymouth County",3,12,379,202,177
050,19,149,"Iowa","Plymouth County",3,13,411,211,200
050,19,149,"Iowa","Plymouth County",3,14,410,207,203
050,19,149,"Iowa","Plymouth County",3,15,411,210,201
050,19,149,"Iowa","Plymouth County",3,16,384,193,191
050,19,149,"Iowa","Plymouth County",3,17,373,196,177
050,19,149,"Iowa","Plymouth County",3,18,333,187,146
050,19,149,"Iowa","Plymouth County",3,19,253,139,114
050,19,149,"Iowa","Plymouth County",3,20,255,146,109
050,19,149,"Iowa","Plymouth County",3,21,280,146,134
050,19,149,"Iowa","Plymouth County",3,22,281,146,135
050,19,149,"Iowa","Plymouth County",3,23,277,140,137
050,19,149,"Iowa","Plymouth County",3,24,299,160,139
050,19,149,"Iowa","Plymouth County",3,25,275,140,135
050,19,149,"Iowa","Plymouth County",3,26,251,129,122
050,19,149,"Iowa","Plymouth County",3,27,265,135,130
050,19,149,"Iowa","Plymouth County",3,28,261,139,122
050,19,149,"Iowa","Plymouth County",3,29,294,154,140
050,19,149,"Iowa","Plymouth County",3,30,289,147,142
050,19,149,"Iowa","Plymouth County",3,31,270,137,133
050,19,149,"Iowa","Plymouth County",3,32,257,134,123
050,19,149,"Iowa","Plymouth County",3,33,275,147,128
050,19,149,"Iowa","Plymouth County",3,34,297,151,146
050,19,149,"Iowa","Plymouth County",3,35,285,147,138
050,19,149,"Iowa","Plymouth County",3,36,311,156,155
050,19,149,"Iowa","Plymouth County",3,37,312,161,151
050,19,149,"Iowa","Plymouth County",3,38,308,165,143
050,19,149,"Iowa","Plymouth County",3,39,328,162,166
050,19,149,"Iowa","Plymouth County",3,40,349,169,180
050,19,149,"Iowa","Plymouth County",3,41,353,178,175
050,19,149,"Iowa","Plymouth County",3,42,326,165,161
050,19,149,"Iowa","Plymouth County",3,43,334,182,152
050,19,149,"Iowa","Plymouth County",3,44,318,167,151
050,19,149,"Iowa","Plymouth County",3,45,284,153,131
050,19,149,"Iowa","Plymouth County",3,46,278,143,135
050,19,149,"Iowa","Plymouth County",3,47,272,140,132
050,19,149,"Iowa","Plymouth County",3,48,267,139,128
050,19,149,"Iowa","Plymouth County",3,49,283,137,146
050,19,149,"Iowa","Plymouth County",3,50,330,161,169
050,19,149,"Iowa","Plymouth County",3,51,326,164,162
050,19,149,"Iowa","Plymouth County",3,52,304,170,134
050,19,149,"Iowa","Plymouth County",3,53,288,157,131
050,19,149,"Iowa","Plymouth County",3,54,302,161,141
050,19,149,"Iowa","Plymouth County",3,55,319,164,155
050,19,149,"Iowa","Plymouth County",3,56,327,171,156
050,19,149,"Iowa","Plymouth County",3,57,321,150,171
050,19,149,"Iowa","Plymouth County",3,58,332,153,179
050,19,149,"Iowa","Plymouth County",3,59,368,182,186
050,19,149,"Iowa","Plymouth County",3,60,387,205,182
050,19,149,"Iowa","Plymouth County",3,61,383,201,182
050,19,149,"Iowa","Plymouth County",3,62,360,186,174
050,19,149,"Iowa","Plymouth County",3,63,365,185,180
050,19,149,"Iowa","Plymouth County",3,64,362,179,183
050,19,149,"Iowa","Plymouth County",3,65,340,174,166
050,19,149,"Iowa","Plymouth County",3,66,349,175,174
050,19,149,"Iowa","Plymouth County",3,67,309,152,157
050,19,149,"Iowa","Plymouth County",3,68,294,147,147
050,19,149,"Iowa","Plymouth County",3,69,296,146,150
050,19,149,"Iowa","Plymouth County",3,70,286,148,138
050,19,149,"Iowa","Plymouth County",3,71,265,132,133
050,19,149,"Iowa","Plymouth County",3,72,244,114,130
050,19,149,"Iowa","Plymouth County",3,73,243,117,126
050,19,149,"Iowa","Plymouth County",3,74,239,122,117
050,19,149,"Iowa","Plymouth County",3,75,157,76,81
050,19,149,"Iowa","Plymouth County",3,76,174,82,92
050,19,149,"Iowa","Plymouth County",3,77,167,81,86
050,19,149,"Iowa","Plymouth County",3,78,173,82,91
050,19,149,"Iowa","Plymouth County",3,79,151,71,80
050,19,149,"Iowa","Plymouth County",3,80,132,61,71
050,19,149,"Iowa","Plymouth County",3,81,114,50,64
050,19,149,"Iowa","Plymouth County",3,82,116,51,65
050,19,149,"Iowa","Plymouth County",3,83,107,45,62
050,19,149,"Iowa","Plymouth County",3,84,89,40,49
050,19,149,"Iowa","Plymouth County",3,85,656,231,425
050,19,149,"Iowa","Plymouth County",4,0,306,160,146
050,19,149,"Iowa","Plymouth County",4,1,310,160,150
050,19,149,"Iowa","Plymouth County",4,2,286,162,124
050,19,149,"Iowa","Plymouth County",4,3,294,146,148
050,19,149,"Iowa","Plymouth County",4,4,324,167,157
050,19,149,"Iowa","Plymouth County",4,5,323,164,159
050,19,149,"Iowa","Plymouth County",4,6,375,198,177
050,19,149,"Iowa","Plymouth County",4,7,385,203,182
050,19,149,"Iowa","Plymouth County",4,8,363,177,186
050,19,149,"Iowa","Plymouth County",4,9,350,171,179
050,19,149,"Iowa","Plymouth County",4,10,349,176,173
050,19,149,"Iowa","Plymouth County",4,11,357,190,167
050,19,149,"Iowa","Plymouth County",4,12,369,195,174
050,19,149,"Iowa","Plymouth County",4,13,391,216,175
050,19,149,"Iowa","Plymouth County",4,14,402,210,192
050,19,149,"Iowa","Plymouth County",4,15,423,211,212
050,19,149,"Iowa","Plymouth County",4,16,403,207,196
050,19,149,"Iowa","Plymouth County",4,17,391,195,196
050,19,149,"Iowa","Plymouth County",4,18,319,176,143
050,19,149,"Iowa","Plymouth County",4,19,262,150,112
050,19,149,"Iowa","Plymouth County",4,20,267,155,112
050,19,149,"Iowa","Plymouth County",4,21,258,146,112
050,19,149,"Iowa","Plymouth County",4,22,288,154,134
050,19,149,"Iowa","Plymouth County",4,23,277,138,139
050,19,149,"Iowa","Plymouth County",4,24,258,138,120
050,19,149,"Iowa","Plymouth County",4,25,291,150,141
050,19,149,"Iowa","Plymouth County",4,26,272,136,136
050,19,149,"Iowa","Plymouth County",4,27,251,132,119
050,19,149,"Iowa","Plymouth County",4,28,268,136,132
050,19,149,"Iowa","Plymouth County",4,29,259,136,123
050,19,149,"Iowa","Plymouth County",4,30,287,146,141
050,19,149,"Iowa","Plymouth County",4,31,291,135,156
050,19,149,"Iowa","Plymouth County",4,32,286,141,145
050,19,149,"Iowa","Plymouth County",4,33,264,139,125
050,19,149,"Iowa","Plymouth County",4,34,278,147,131
050,19,149,"Iowa","Plymouth County",4,35,295,149,146
050,19,149,"Iowa","Plymouth County",4,36,290,150,140
050,19,149,"Iowa","Plymouth County",4,37,301,148,153
050,19,149,"Iowa","Plymouth County",4,38,316,162,154
050,19,149,"Iowa","Plymouth County",4,39,298,156,142
050,19,149,"Iowa","Plymouth County",4,40,334,168,166
050,19,149,"Iowa","Plymouth County",4,41,355,177,178
050,19,149,"Iowa","Plymouth County",4,42,361,182,179
050,19,149,"Iowa","Plymouth County",4,43,328,167,161
050,19,149,"Iowa","Plymouth County",4,44,332,186,146
050,19,149,"Iowa","Plymouth County",4,45,308,162,146
050,19,149,"Iowa","Plymouth County",4,46,290,156,134
050,19,149,"Iowa","Plymouth County",4,47,282,147,135
050,19,149,"Iowa","Plymouth County",4,48,267,142,125
050,19,149,"Iowa","Plymouth County",4,49,273,140,133
050,19,149,"Iowa","Plymouth County",4,50,281,136,145
050,19,149,"Iowa","Plymouth County",4,51,329,160,169
050,19,149,"Iowa","Plymouth County",4,52,330,163,167
050,19,149,"Iowa","Plymouth County",4,53,301,165,136
050,19,149,"Iowa","Plymouth County",4,54,281,156,125
050,19,149,"Iowa","Plymouth County",4,55,310,165,145
050,19,149,"Iowa","Plymouth County",4,56,321,171,150
050,19,149,"Iowa","Plymouth County",4,57,333,174,159
050,19,149,"Iowa","Plymouth County",4,58,323,150,173
050,19,149,"Iowa","Plymouth County",4,59,334,156,178
050,19,149,"Iowa","Plymouth County",4,60,360,177,183
050,19,149,"Iowa","Plymouth County",4,61,389,206,183
050,19,149,"Iowa","Plymouth County",4,62,381,202,179
050,19,149,"Iowa","Plymouth County",4,63,364,184,180
050,19,149,"Iowa","Plymouth County",4,64,358,182,176
050,19,149,"Iowa","Plymouth County",4,65,355,175,180
050,19,149,"Iowa","Plymouth County",4,66,336,168,168
050,19,149,"Iowa","Plymouth County",4,67,333,168,165
050,19,149,"Iowa","Plymouth County",4,68,297,147,150
050,19,149,"Iowa","Plymouth County",4,69,292,144,148
050,19,149,"Iowa","Plymouth County",4,70,289,147,142
050,19,149,"Iowa","Plymouth County",4,71,280,145,135
050,19,149,"Iowa","Plymouth County",4,72,264,129,135
050,19,149,"Iowa","Plymouth County",4,73,246,115,131
050,19,149,"Iowa","Plymouth County",4,74,238,116,122
050,19,149,"Iowa","Plymouth County",4,75,233,119,114
050,19,149,"Iowa","Plymouth County",4,76,158,74,84
050,19,149,"Iowa","Plymouth County",4,77,172,80,92
050,19,149,"Iowa","Plymouth County",4,78,163,78,85
050,19,149,"Iowa","Plymouth County",4,79,167,75,92
050,19,149,"Iowa","Plymouth County",4,80,137,64,73
050,19,149,"Iowa","Plymouth County",4,81,118,54,64
050,19,149,"Iowa","Plymouth County",4,82,110,43,67
050,19,149,"Iowa","Plymouth County",4,83,108,47,61
050,19,149,"Iowa","Plymouth County",4,84,94,41,53
050,19,149,"Iowa","Plymouth County",4,85,630,228,402
050,19,149,"Iowa","Plymouth County",5,0,305,157,148
050,19,149,"Iowa","Plymouth County",5,1,303,148,155
050,19,149,"Iowa","Plymouth County",5,2,321,164,157
050,19,149,"Iowa","Plymouth County",5,3,298,167,131
050,19,149,"Iowa","Plymouth County",5,4,312,155,157
050,19,149,"Iowa","Plymouth County",5,5,324,166,158
050,19,149,"Iowa","Plymouth County",5,6,335,174,161
050,19,149,"Iowa","Plymouth County",5,7,377,200,177
050,19,149,"Iowa","Plymouth County",5,8,385,201,184
050,19,149,"Iowa","Plymouth County",5,9,365,176,189
050,19,149,"Iowa","Plymouth County",5,10,357,171,186
050,19,149,"Iowa","Plymouth County",5,11,355,179,176
050,19,149,"Iowa","Plymouth County",5,12,358,196,162
050,19,149,"Iowa","Plymouth County",5,13,360,193,167
050,19,149,"Iowa","Plymouth County",5,14,388,214,174
050,19,149,"Iowa","Plymouth County",5,15,399,206,193
050,19,149,"Iowa","Plymouth County",5,16,418,209,209
050,19,149,"Iowa","Plymouth County",5,17,397,207,190
050,19,149,"Iowa","Plymouth County",5,18,330,181,149
050,19,149,"Iowa","Plymouth County",5,19,251,140,111
050,19,149,"Iowa","Plymouth County",5,20,279,160,119
050,19,149,"Iowa","Plymouth County",5,21,283,160,123
050,19,149,"Iowa","Plymouth County",5,22,268,150,118
050,19,149,"Iowa","Plymouth County",5,23,282,151,131
050,19,149,"Iowa","Plymouth County",5,24,271,143,128
050,19,149,"Iowa","Plymouth County",5,25,257,140,117
050,19,149,"Iowa","Plymouth County",5,26,284,139,145
050,19,149,"Iowa","Plymouth County",5,27,268,131,137
050,19,149,"Iowa","Plymouth County",5,28,260,133,127
050,19,149,"Iowa","Plymouth County",5,29,274,137,137
050,19,149,"Iowa","Plymouth County",5,30,269,144,125
050,19,149,"Iowa","Plymouth County",5,31,296,144,152
050,19,149,"Iowa","Plymouth County",5,32,297,135,162
050,19,149,"Iowa","Plymouth County",5,33,294,147,147
050,19,149,"Iowa","Plymouth County",5,34,257,130,127
050,19,149,"Iowa","Plymouth County",5,35,286,157,129
050,19,149,"Iowa","Plymouth County",5,36,297,143,154
050,19,149,"Iowa","Plymouth County",5,37,280,134,146
050,19,149,"Iowa","Plymouth County",5,38,308,154,154
050,19,149,"Iowa","Plymouth County",5,39,310,156,154
050,19,149,"Iowa","Plymouth County",5,40,302,158,144
050,19,149,"Iowa","Plymouth County",5,41,337,173,164
050,19,149,"Iowa","Plymouth County",5,42,355,182,173
050,19,149,"Iowa","Plymouth County",5,43,357,181,176
050,19,149,"Iowa","Plymouth County",5,44,326,167,159
050,19,149,"Iowa","Plymouth County",5,45,336,187,149
050,19,149,"Iowa","Plymouth County",5,46,303,157,146
050,19,149,"Iowa","Plymouth County",5,47,289,151,138
050,19,149,"Iowa","Plymouth County",5,48,290,156,134
050,19,149,"Iowa","Plymouth County",5,49,274,143,131
050,19,149,"Iowa","Plymouth County",5,50,266,136,130
050,19,149,"Iowa","Plymouth County",5,51,278,137,141
050,19,149,"Iowa","Plymouth County",5,52,332,167,165
050,19,149,"Iowa","Plymouth County",5,53,325,158,167
050,19,149,"Iowa","Plymouth County",5,54,298,163,135
050,19,149,"Iowa","Plymouth County",5,55,280,154,126
050,19,149,"Iowa","Plymouth County",5,56,292,161,131
050,19,149,"Iowa","Plymouth County",5,57,318,171,147
050,19,149,"Iowa","Plymouth County",5,58,337,176,161
050,19,149,"Iowa","Plymouth County",5,59,318,149,169
050,19,149,"Iowa","Plymouth County",5,60,327,150,177
050,19,149,"Iowa","Plymouth County",5,61,369,180,189
050,19,149,"Iowa","Plymouth County",5,62,374,197,177
050,19,149,"Iowa","Plymouth County",5,63,381,201,180
050,19,149,"Iowa","Plymouth County",5,64,362,182,180
050,19,149,"Iowa","Plymouth County",5,65,351,178,173
050,19,149,"Iowa","Plymouth County",5,66,349,170,179
050,19,149,"Iowa","Plymouth County",5,67,325,158,167
050,19,149,"Iowa","Plymouth County",5,68,327,163,164
050,19,149,"Iowa","Plymouth County",5,69,297,142,155
050,19,149,"Iowa","Plymouth County",5,70,291,142,149
050,19,149,"Iowa","Plymouth County",5,71,282,143,139
050,19,149,"Iowa","Plymouth County",5,72,275,141,134
050,19,149,"Iowa","Plymouth County",5,73,259,125,134
050,19,149,"Iowa","Plymouth County",5,74,243,115,128
050,19,149,"Iowa","Plymouth County",5,75,233,114,119
050,19,149,"Iowa","Plymouth County",5,76,234,117,117
050,19,149,"Iowa","Plymouth County",5,77,154,73,81
050,19,149,"Iowa","Plymouth County",5,78,166,74,92
050,19,149,"Iowa","Plymouth County",5,79,155,72,83
050,19,149,"Iowa","Plymouth County",5,80,154,69,85
050,19,149,"Iowa","Plymouth County",5,81,124,58,66
050,19,149,"Iowa","Plymouth County",5,82,114,47,67
050,19,149,"Iowa","Plymouth County",5,83,102,43,59
050,19,149,"Iowa","Plymouth County",5,84,93,43,50
050,19,149,"Iowa","Plymouth County",5,85,610,222,388
050,19,151,"Iowa","Pocahontas County",1,0,77,39,38
050,19,151,"Iowa","Pocahontas County",1,1,84,43,41
050,19,151,"Iowa","Pocahontas County",1,2,90,44,46
050,19,151,"Iowa","Pocahontas County",1,3,87,49,38
050,19,151,"Iowa","Pocahontas County",1,4,86,45,41
050,19,151,"Iowa","Pocahontas County",1,5,88,44,44
050,19,151,"Iowa","Pocahontas County",1,6,87,45,42
050,19,151,"Iowa","Pocahontas County",1,7,99,48,51
050,19,151,"Iowa","Pocahontas County",1,8,71,31,40
050,19,151,"Iowa","Pocahontas County",1,9,82,34,48
050,19,151,"Iowa","Pocahontas County",1,10,94,42,52
050,19,151,"Iowa","Pocahontas County",1,11,96,42,54
050,19,151,"Iowa","Pocahontas County",1,12,107,53,54
050,19,151,"Iowa","Pocahontas County",1,13,100,53,47
050,19,151,"Iowa","Pocahontas County",1,14,96,45,51
050,19,151,"Iowa","Pocahontas County",1,15,105,50,55
050,19,151,"Iowa","Pocahontas County",1,16,94,45,49
050,19,151,"Iowa","Pocahontas County",1,17,95,43,52
050,19,151,"Iowa","Pocahontas County",1,18,76,42,34
050,19,151,"Iowa","Pocahontas County",1,19,63,39,24
050,19,151,"Iowa","Pocahontas County",1,20,63,35,28
050,19,151,"Iowa","Pocahontas County",1,21,67,31,36
050,19,151,"Iowa","Pocahontas County",1,22,67,37,30
050,19,151,"Iowa","Pocahontas County",1,23,57,31,26
050,19,151,"Iowa","Pocahontas County",1,24,55,30,25
050,19,151,"Iowa","Pocahontas County",1,25,60,30,30
050,19,151,"Iowa","Pocahontas County",1,26,64,31,33
050,19,151,"Iowa","Pocahontas County",1,27,77,43,34
050,19,151,"Iowa","Pocahontas County",1,28,66,36,30
050,19,151,"Iowa","Pocahontas County",1,29,72,32,40
050,19,151,"Iowa","Pocahontas County",1,30,82,39,43
050,19,151,"Iowa","Pocahontas County",1,31,65,36,29
050,19,151,"Iowa","Pocahontas County",1,32,70,38,32
050,19,151,"Iowa","Pocahontas County",1,33,65,33,32
050,19,151,"Iowa","Pocahontas County",1,34,71,39,32
050,19,151,"Iowa","Pocahontas County",1,35,74,42,32
050,19,151,"Iowa","Pocahontas County",1,36,84,37,47
050,19,151,"Iowa","Pocahontas County",1,37,81,40,41
050,19,151,"Iowa","Pocahontas County",1,38,73,41,32
050,19,151,"Iowa","Pocahontas County",1,39,73,37,36
050,19,151,"Iowa","Pocahontas County",1,40,70,38,32
050,19,151,"Iowa","Pocahontas County",1,41,82,39,43
050,19,151,"Iowa","Pocahontas County",1,42,68,37,31
050,19,151,"Iowa","Pocahontas County",1,43,74,42,32
050,19,151,"Iowa","Pocahontas County",1,44,75,41,34
050,19,151,"Iowa","Pocahontas County",1,45,69,40,29
050,19,151,"Iowa","Pocahontas County",1,46,59,33,26
050,19,151,"Iowa","Pocahontas County",1,47,50,29,21
050,19,151,"Iowa","Pocahontas County",1,48,66,34,32
050,19,151,"Iowa","Pocahontas County",1,49,82,43,39
050,19,151,"Iowa","Pocahontas County",1,50,65,33,32
050,19,151,"Iowa","Pocahontas County",1,51,75,37,38
050,19,151,"Iowa","Pocahontas County",1,52,66,30,36
050,19,151,"Iowa","Pocahontas County",1,53,89,46,43
050,19,151,"Iowa","Pocahontas County",1,54,88,46,42
050,19,151,"Iowa","Pocahontas County",1,55,96,48,48
050,19,151,"Iowa","Pocahontas County",1,56,120,61,59
050,19,151,"Iowa","Pocahontas County",1,57,119,58,61
050,19,151,"Iowa","Pocahontas County",1,58,122,61,61
050,19,151,"Iowa","Pocahontas County",1,59,127,62,65
050,19,151,"Iowa","Pocahontas County",1,60,118,61,57
050,19,151,"Iowa","Pocahontas County",1,61,123,62,61
050,19,151,"Iowa","Pocahontas County",1,62,122,62,60
050,19,151,"Iowa","Pocahontas County",1,63,127,80,47
050,19,151,"Iowa","Pocahontas County",1,64,119,63,56
050,19,151,"Iowa","Pocahontas County",1,65,114,61,53
050,19,151,"Iowa","Pocahontas County",1,66,104,51,53
050,19,151,"Iowa","Pocahontas County",1,67,96,49,47
050,19,151,"Iowa","Pocahontas County",1,68,89,45,44
050,19,151,"Iowa","Pocahontas County",1,69,89,47,42
050,19,151,"Iowa","Pocahontas County",1,70,90,41,49
050,19,151,"Iowa","Pocahontas County",1,71,77,45,32
050,19,151,"Iowa","Pocahontas County",1,72,70,44,26
050,19,151,"Iowa","Pocahontas County",1,73,75,36,39
050,19,151,"Iowa","Pocahontas County",1,74,73,36,37
050,19,151,"Iowa","Pocahontas County",1,75,62,31,31
050,19,151,"Iowa","Pocahontas County",1,76,58,25,33
050,19,151,"Iowa","Pocahontas County",1,77,60,26,34
050,19,151,"Iowa","Pocahontas County",1,78,51,22,29
050,19,151,"Iowa","Pocahontas County",1,79,48,20,28
050,19,151,"Iowa","Pocahontas County",1,80,57,22,35
050,19,151,"Iowa","Pocahontas County",1,81,53,19,34
050,19,151,"Iowa","Pocahontas County",1,82,48,23,25
050,19,151,"Iowa","Pocahontas County",1,83,44,24,20
050,19,151,"Iowa","Pocahontas County",1,84,43,19,24
050,19,151,"Iowa","Pocahontas County",1,85,240,80,160
050,19,151,"Iowa","Pocahontas County",2,0,78,40,38
050,19,151,"Iowa","Pocahontas County",2,1,83,42,41
050,19,151,"Iowa","Pocahontas County",2,2,89,45,44
050,19,151,"Iowa","Pocahontas County",2,3,88,48,40
050,19,151,"Iowa","Pocahontas County",2,4,87,47,40
050,19,151,"Iowa","Pocahontas County",2,5,88,43,45
050,19,151,"Iowa","Pocahontas County",2,6,87,44,43
050,19,151,"Iowa","Pocahontas County",2,7,98,49,49
050,19,151,"Iowa","Pocahontas County",2,8,78,36,42
050,19,151,"Iowa","Pocahontas County",2,9,79,32,47
050,19,151,"Iowa","Pocahontas County",2,10,91,40,51
050,19,151,"Iowa","Pocahontas County",2,11,95,42,53
050,19,151,"Iowa","Pocahontas County",2,12,107,51,56
050,19,151,"Iowa","Pocahontas County",2,13,102,54,48
050,19,151,"Iowa","Pocahontas County",2,14,96,46,50
050,19,151,"Iowa","Pocahontas County",2,15,103,49,54
050,19,151,"Iowa","Pocahontas County",2,16,96,45,51
050,19,151,"Iowa","Pocahontas County",2,17,94,43,51
050,19,151,"Iowa","Pocahontas County",2,18,74,39,35
050,19,151,"Iowa","Pocahontas County",2,19,61,38,23
050,19,151,"Iowa","Pocahontas County",2,20,66,38,28
050,19,151,"Iowa","Pocahontas County",2,21,69,33,36
050,19,151,"Iowa","Pocahontas County",2,22,66,34,32
050,19,151,"Iowa","Pocahontas County",2,23,58,31,27
050,19,151,"Iowa","Pocahontas County",2,24,54,29,25
050,19,151,"Iowa","Pocahontas County",2,25,59,30,29
050,19,151,"Iowa","Pocahontas County",2,26,65,32,33
050,19,151,"Iowa","Pocahontas County",2,27,72,38,34
050,19,151,"Iowa","Pocahontas County",2,28,69,38,31
050,19,151,"Iowa","Pocahontas County",2,29,73,34,39
050,19,151,"Iowa","Pocahontas County",2,30,82,39,43
050,19,151,"Iowa","Pocahontas County",2,31,69,37,32
050,19,151,"Iowa","Pocahontas County",2,32,71,39,32
050,19,151,"Iowa","Pocahontas County",2,33,66,34,32
050,19,151,"Iowa","Pocahontas County",2,34,70,38,32
050,19,151,"Iowa","Pocahontas County",2,35,75,42,33
050,19,151,"Iowa","Pocahontas County",2,36,82,39,43
050,19,151,"Iowa","Pocahontas County",2,37,81,40,41
050,19,151,"Iowa","Pocahontas County",2,38,75,42,33
050,19,151,"Iowa","Pocahontas County",2,39,72,38,34
050,19,151,"Iowa","Pocahontas County",2,40,71,38,33
050,19,151,"Iowa","Pocahontas County",2,41,79,38,41
050,19,151,"Iowa","Pocahontas County",2,42,69,36,33
050,19,151,"Iowa","Pocahontas County",2,43,72,40,32
050,19,151,"Iowa","Pocahontas County",2,44,73,40,33
050,19,151,"Iowa","Pocahontas County",2,45,71,41,30
050,19,151,"Iowa","Pocahontas County",2,46,60,34,26
050,19,151,"Iowa","Pocahontas County",2,47,51,30,21
050,19,151,"Iowa","Pocahontas County",2,48,62,33,29
050,19,151,"Iowa","Pocahontas County",2,49,78,41,37
050,19,151,"Iowa","Pocahontas County",2,50,69,36,33
050,19,151,"Iowa","Pocahontas County",2,51,75,37,38
050,19,151,"Iowa","Pocahontas County",2,52,67,31,36
050,19,151,"Iowa","Pocahontas County",2,53,81,41,40
050,19,151,"Iowa","Pocahontas County",2,54,88,46,42
050,19,151,"Iowa","Pocahontas County",2,55,95,48,47
050,19,151,"Iowa","Pocahontas County",2,56,114,58,56
050,19,151,"Iowa","Pocahontas County",2,57,120,59,61
050,19,151,"Iowa","Pocahontas County",2,58,122,62,60
050,19,151,"Iowa","Pocahontas County",2,59,125,62,63
050,19,151,"Iowa","Pocahontas County",2,60,121,62,59
050,19,151,"Iowa","Pocahontas County",2,61,121,62,59
050,19,151,"Iowa","Pocahontas County",2,62,123,63,60
050,19,151,"Iowa","Pocahontas County",2,63,127,76,51
050,19,151,"Iowa","Pocahontas County",2,64,120,66,54
050,19,151,"Iowa","Pocahontas County",2,65,115,61,54
050,19,151,"Iowa","Pocahontas County",2,66,105,53,52
050,19,151,"Iowa","Pocahontas County",2,67,97,49,48
050,19,151,"Iowa","Pocahontas County",2,68,88,45,43
050,19,151,"Iowa","Pocahontas County",2,69,89,46,43
050,19,151,"Iowa","Pocahontas County",2,70,90,43,47
050,19,151,"Iowa","Pocahontas County",2,71,79,44,35
050,19,151,"Iowa","Pocahontas County",2,72,70,43,27
050,19,151,"Iowa","Pocahontas County",2,73,77,41,36
050,19,151,"Iowa","Pocahontas County",2,74,68,33,35
050,19,151,"Iowa","Pocahontas County",2,75,65,32,33
050,19,151,"Iowa","Pocahontas County",2,76,59,26,33
050,19,151,"Iowa","Pocahontas County",2,77,62,27,35
050,19,151,"Iowa","Pocahontas County",2,78,51,22,29
050,19,151,"Iowa","Pocahontas County",2,79,47,19,28
050,19,151,"Iowa","Pocahontas County",2,80,53,21,32
050,19,151,"Iowa","Pocahontas County",2,81,54,19,35
050,19,151,"Iowa","Pocahontas County",2,82,48,22,26
050,19,151,"Iowa","Pocahontas County",2,83,42,22,20
050,19,151,"Iowa","Pocahontas County",2,84,43,20,23
050,19,151,"Iowa","Pocahontas County",2,85,241,82,159
050,19,151,"Iowa","Pocahontas County",3,0,72,34,38
050,19,151,"Iowa","Pocahontas County",3,1,88,36,52
050,19,151,"Iowa","Pocahontas County",3,2,83,41,42
050,19,151,"Iowa","Pocahontas County",3,3,95,47,48
050,19,151,"Iowa","Pocahontas County",3,4,98,49,49
050,19,151,"Iowa","Pocahontas County",3,5,83,47,36
050,19,151,"Iowa","Pocahontas County",3,6,82,42,40
050,19,151,"Iowa","Pocahontas County",3,7,89,44,45
050,19,151,"Iowa","Pocahontas County",3,8,105,55,50
050,19,151,"Iowa","Pocahontas County",3,9,76,35,41
050,19,151,"Iowa","Pocahontas County",3,10,79,33,46
050,19,151,"Iowa","Pocahontas County",3,11,88,40,48
050,19,151,"Iowa","Pocahontas County",3,12,90,42,48
050,19,151,"Iowa","Pocahontas County",3,13,98,47,51
050,19,151,"Iowa","Pocahontas County",3,14,97,55,42
050,19,151,"Iowa","Pocahontas County",3,15,95,43,52
050,19,151,"Iowa","Pocahontas County",3,16,103,49,54
050,19,151,"Iowa","Pocahontas County",3,17,96,46,50
050,19,151,"Iowa","Pocahontas County",3,18,87,40,47
050,19,151,"Iowa","Pocahontas County",3,19,61,31,30
050,19,151,"Iowa","Pocahontas County",3,20,67,42,25
050,19,151,"Iowa","Pocahontas County",3,21,64,36,28
050,19,151,"Iowa","Pocahontas County",3,22,65,31,34
050,19,151,"Iowa","Pocahontas County",3,23,66,36,30
050,19,151,"Iowa","Pocahontas County",3,24,61,29,32
050,19,151,"Iowa","Pocahontas County",3,25,61,33,28
050,19,151,"Iowa","Pocahontas County",3,26,60,36,24
050,19,151,"Iowa","Pocahontas County",3,27,63,32,31
050,19,151,"Iowa","Pocahontas County",3,28,77,39,38
050,19,151,"Iowa","Pocahontas County",3,29,79,44,35
050,19,151,"Iowa","Pocahontas County",3,30,80,39,41
050,19,151,"Iowa","Pocahontas County",3,31,84,40,44
050,19,151,"Iowa","Pocahontas County",3,32,67,39,28
050,19,151,"Iowa","Pocahontas County",3,33,68,37,31
050,19,151,"Iowa","Pocahontas County",3,34,63,31,32
050,19,151,"Iowa","Pocahontas County",3,35,69,37,32
050,19,151,"Iowa","Pocahontas County",3,36,68,38,30
050,19,151,"Iowa","Pocahontas County",3,37,81,40,41
050,19,151,"Iowa","Pocahontas County",3,38,82,42,40
050,19,151,"Iowa","Pocahontas County",3,39,76,40,36
050,19,151,"Iowa","Pocahontas County",3,40,74,39,35
050,19,151,"Iowa","Pocahontas County",3,41,69,36,33
050,19,151,"Iowa","Pocahontas County",3,42,76,37,39
050,19,151,"Iowa","Pocahontas County",3,43,71,36,35
050,19,151,"Iowa","Pocahontas County",3,44,74,40,34
050,19,151,"Iowa","Pocahontas County",3,45,66,37,29
050,19,151,"Iowa","Pocahontas County",3,46,72,42,30
050,19,151,"Iowa","Pocahontas County",3,47,57,32,25
050,19,151,"Iowa","Pocahontas County",3,48,52,28,24
050,19,151,"Iowa","Pocahontas County",3,49,68,35,33
050,19,151,"Iowa","Pocahontas County",3,50,76,41,35
050,19,151,"Iowa","Pocahontas County",3,51,72,39,33
050,19,151,"Iowa","Pocahontas County",3,52,76,36,40
050,19,151,"Iowa","Pocahontas County",3,53,65,32,33
050,19,151,"Iowa","Pocahontas County",3,54,88,44,44
050,19,151,"Iowa","Pocahontas County",3,55,91,49,42
050,19,151,"Iowa","Pocahontas County",3,56,94,46,48
050,19,151,"Iowa","Pocahontas County",3,57,111,56,55
050,19,151,"Iowa","Pocahontas County",3,58,118,57,61
050,19,151,"Iowa","Pocahontas County",3,59,120,59,61
050,19,151,"Iowa","Pocahontas County",3,60,129,64,65
050,19,151,"Iowa","Pocahontas County",3,61,119,60,59
050,19,151,"Iowa","Pocahontas County",3,62,125,62,63
050,19,151,"Iowa","Pocahontas County",3,63,114,60,54
050,19,151,"Iowa","Pocahontas County",3,64,130,78,52
050,19,151,"Iowa","Pocahontas County",3,65,121,64,57
050,19,151,"Iowa","Pocahontas County",3,66,113,59,54
050,19,151,"Iowa","Pocahontas County",3,67,105,53,52
050,19,151,"Iowa","Pocahontas County",3,68,92,44,48
050,19,151,"Iowa","Pocahontas County",3,69,82,40,42
050,19,151,"Iowa","Pocahontas County",3,70,85,43,42
050,19,151,"Iowa","Pocahontas County",3,71,87,41,46
050,19,151,"Iowa","Pocahontas County",3,72,76,39,37
050,19,151,"Iowa","Pocahontas County",3,73,68,42,26
050,19,151,"Iowa","Pocahontas County",3,74,73,38,35
050,19,151,"Iowa","Pocahontas County",3,75,65,31,34
050,19,151,"Iowa","Pocahontas County",3,76,61,29,32
050,19,151,"Iowa","Pocahontas County",3,77,60,26,34
050,19,151,"Iowa","Pocahontas County",3,78,59,26,33
050,19,151,"Iowa","Pocahontas County",3,79,49,21,28
050,19,151,"Iowa","Pocahontas County",3,80,43,16,27
050,19,151,"Iowa","Pocahontas County",3,81,51,18,33
050,19,151,"Iowa","Pocahontas County",3,82,50,15,35
050,19,151,"Iowa","Pocahontas County",3,83,42,19,23
050,19,151,"Iowa","Pocahontas County",3,84,41,20,21
050,19,151,"Iowa","Pocahontas County",3,85,243,80,163
050,19,151,"Iowa","Pocahontas County",4,0,78,35,43
050,19,151,"Iowa","Pocahontas County",4,1,84,38,46
050,19,151,"Iowa","Pocahontas County",4,2,87,35,52
050,19,151,"Iowa","Pocahontas County",4,3,90,43,47
050,19,151,"Iowa","Pocahontas County",4,4,104,52,52
050,19,151,"Iowa","Pocahontas County",4,5,84,47,37
050,19,151,"Iowa","Pocahontas County",4,6,86,47,39
050,19,151,"Iowa","Pocahontas County",4,7,89,44,45
050,19,151,"Iowa","Pocahontas County",4,8,88,42,46
050,19,151,"Iowa","Pocahontas County",4,9,106,55,51
050,19,151,"Iowa","Pocahontas County",4,10,78,35,43
050,19,151,"Iowa","Pocahontas County",4,11,92,45,47
050,19,151,"Iowa","Pocahontas County",4,12,92,43,49
050,19,151,"Iowa","Pocahontas County",4,13,89,42,47
050,19,151,"Iowa","Pocahontas County",4,14,97,50,47
050,19,151,"Iowa","Pocahontas County",4,15,97,55,42
050,19,151,"Iowa","Pocahontas County",4,16,99,46,53
050,19,151,"Iowa","Pocahontas County",4,17,108,53,55
050,19,151,"Iowa","Pocahontas County",4,18,87,44,43
050,19,151,"Iowa","Pocahontas County",4,19,66,29,37
050,19,151,"Iowa","Pocahontas County",4,20,75,36,39
050,19,151,"Iowa","Pocahontas County",4,21,71,44,27
050,19,151,"Iowa","Pocahontas County",4,22,62,33,29
050,19,151,"Iowa","Pocahontas County",4,23,68,35,33
050,19,151,"Iowa","Pocahontas County",4,24,61,34,27
050,19,151,"Iowa","Pocahontas County",4,25,61,30,31
050,19,151,"Iowa","Pocahontas County",4,26,60,35,25
050,19,151,"Iowa","Pocahontas County",4,27,57,31,26
050,19,151,"Iowa","Pocahontas County",4,28,69,32,37
050,19,151,"Iowa","Pocahontas County",4,29,77,37,40
050,19,151,"Iowa","Pocahontas County",4,30,78,41,37
050,19,151,"Iowa","Pocahontas County",4,31,79,39,40
050,19,151,"Iowa","Pocahontas County",4,32,86,40,46
050,19,151,"Iowa","Pocahontas County",4,33,69,42,27
050,19,151,"Iowa","Pocahontas County",4,34,77,42,35
050,19,151,"Iowa","Pocahontas County",4,35,72,37,35
050,19,151,"Iowa","Pocahontas County",4,36,73,38,35
050,19,151,"Iowa","Pocahontas County",4,37,67,38,29
050,19,151,"Iowa","Pocahontas County",4,38,79,39,40
050,19,151,"Iowa","Pocahontas County",4,39,76,36,40
050,19,151,"Iowa","Pocahontas County",4,40,80,43,37
050,19,151,"Iowa","Pocahontas County",4,41,73,38,35
050,19,151,"Iowa","Pocahontas County",4,42,76,40,36
050,19,151,"Iowa","Pocahontas County",4,43,66,30,36
050,19,151,"Iowa","Pocahontas County",4,44,66,36,30
050,19,151,"Iowa","Pocahontas County",4,45,76,39,37
050,19,151,"Iowa","Pocahontas County",4,46,69,37,32
050,19,151,"Iowa","Pocahontas County",4,47,71,41,30
050,19,151,"Iowa","Pocahontas County",4,48,57,31,26
050,19,151,"Iowa","Pocahontas County",4,49,52,28,24
050,19,151,"Iowa","Pocahontas County",4,50,59,30,29
050,19,151,"Iowa","Pocahontas County",4,51,83,46,37
050,19,151,"Iowa","Pocahontas County",4,52,69,36,33
050,19,151,"Iowa","Pocahontas County",4,53,80,37,43
050,19,151,"Iowa","Pocahontas County",4,54,66,33,33
050,19,151,"Iowa","Pocahontas County",4,55,91,44,47
050,19,151,"Iowa","Pocahontas County",4,56,84,47,37
050,19,151,"Iowa","Pocahontas County",4,57,96,45,51
050,19,151,"Iowa","Pocahontas County",4,58,112,59,53
050,19,151,"Iowa","Pocahontas County",4,59,113,54,59
050,19,151,"Iowa","Pocahontas County",4,60,120,59,61
050,19,151,"Iowa","Pocahontas County",4,61,128,63,65
050,19,151,"Iowa","Pocahontas County",4,62,127,65,62
050,19,151,"Iowa","Pocahontas County",4,63,122,61,61
050,19,151,"Iowa","Pocahontas County",4,64,116,61,55
050,19,151,"Iowa","Pocahontas County",4,65,128,80,48
050,19,151,"Iowa","Pocahontas County",4,66,121,65,56
050,19,151,"Iowa","Pocahontas County",4,67,110,58,52
050,19,151,"Iowa","Pocahontas County",4,68,97,46,51
050,19,151,"Iowa","Pocahontas County",4,69,94,45,49
050,19,151,"Iowa","Pocahontas County",4,70,81,41,40
050,19,151,"Iowa","Pocahontas County",4,71,82,39,43
050,19,151,"Iowa","Pocahontas County",4,72,87,41,46
050,19,151,"Iowa","Pocahontas County",4,73,75,40,35
050,19,151,"Iowa","Pocahontas County",4,74,62,41,21
050,19,151,"Iowa","Pocahontas County",4,75,71,37,34
050,19,151,"Iowa","Pocahontas County",4,76,61,29,32
050,19,151,"Iowa","Pocahontas County",4,77,61,29,32
050,19,151,"Iowa","Pocahontas County",4,78,62,28,34
050,19,151,"Iowa","Pocahontas County",4,79,57,25,32
050,19,151,"Iowa","Pocahontas County",4,80,45,18,27
050,19,151,"Iowa","Pocahontas County",4,81,41,15,26
050,19,151,"Iowa","Pocahontas County",4,82,46,13,33
050,19,151,"Iowa","Pocahontas County",4,83,41,12,29
050,19,151,"Iowa","Pocahontas County",4,84,36,13,23
050,19,151,"Iowa","Pocahontas County",4,85,245,84,161
050,19,151,"Iowa","Pocahontas County",5,0,78,35,43
050,19,151,"Iowa","Pocahontas County",5,1,77,34,43
050,19,151,"Iowa","Pocahontas County",5,2,77,36,41
050,19,151,"Iowa","Pocahontas County",5,3,83,36,47
050,19,151,"Iowa","Pocahontas County",5,4,92,43,49
050,19,151,"Iowa","Pocahontas County",5,5,106,54,52
050,19,151,"Iowa","Pocahontas County",5,6,84,45,39
050,19,151,"Iowa","Pocahontas County",5,7,89,49,40
050,19,151,"Iowa","Pocahontas County",5,8,92,47,45
050,19,151,"Iowa","Pocahontas County",5,9,93,42,51
050,19,151,"Iowa","Pocahontas County",5,10,104,55,49
050,19,151,"Iowa","Pocahontas County",5,11,77,37,40
050,19,151,"Iowa","Pocahontas County",5,12,89,42,47
050,19,151,"Iowa","Pocahontas County",5,13,86,38,48
050,19,151,"Iowa","Pocahontas County",5,14,95,43,52
050,19,151,"Iowa","Pocahontas County",5,15,96,51,45
050,19,151,"Iowa","Pocahontas County",5,16,94,54,40
050,19,151,"Iowa","Pocahontas County",5,17,102,44,58
050,19,151,"Iowa","Pocahontas County",5,18,96,50,46
050,19,151,"Iowa","Pocahontas County",5,19,63,30,33
050,19,151,"Iowa","Pocahontas County",5,20,71,31,40
050,19,151,"Iowa","Pocahontas County",5,21,68,30,38
050,19,151,"Iowa","Pocahontas County",5,22,67,40,27
050,19,151,"Iowa","Pocahontas County",5,23,65,31,34
050,19,151,"Iowa","Pocahontas County",5,24,64,33,31
050,19,151,"Iowa","Pocahontas County",5,25,60,37,23
050,19,151,"Iowa","Pocahontas County",5,26,71,35,36
050,19,151,"Iowa","Pocahontas County",5,27,60,30,30
050,19,151,"Iowa","Pocahontas County",5,28,55,31,24
050,19,151,"Iowa","Pocahontas County",5,29,65,32,33
050,19,151,"Iowa","Pocahontas County",5,30,74,37,37
050,19,151,"Iowa","Pocahontas County",5,31,72,41,31
050,19,151,"Iowa","Pocahontas County",5,32,77,35,42
050,19,151,"Iowa","Pocahontas County",5,33,82,39,43
050,19,151,"Iowa","Pocahontas County",5,34,70,44,26
050,19,151,"Iowa","Pocahontas County",5,35,78,39,39
050,19,151,"Iowa","Pocahontas County",5,36,69,32,37
050,19,151,"Iowa","Pocahontas County",5,37,76,39,37
050,19,151,"Iowa","Pocahontas County",5,38,68,39,29
050,19,151,"Iowa","Pocahontas County",5,39,76,37,39
050,19,151,"Iowa","Pocahontas County",5,40,73,35,38
050,19,151,"Iowa","Pocahontas County",5,41,79,41,38
050,19,151,"Iowa","Pocahontas County",5,42,68,36,32
050,19,151,"Iowa","Pocahontas County",5,43,73,42,31
050,19,151,"Iowa","Pocahontas County",5,44,65,29,36
050,19,151,"Iowa","Pocahontas County",5,45,66,36,30
050,19,151,"Iowa","Pocahontas County",5,46,76,40,36
050,19,151,"Iowa","Pocahontas County",5,47,66,34,32
050,19,151,"Iowa","Pocahontas County",5,48,70,41,29
050,19,151,"Iowa","Pocahontas County",5,49,60,34,26
050,19,151,"Iowa","Pocahontas County",5,50,53,27,26
050,19,151,"Iowa","Pocahontas County",5,51,59,32,27
050,19,151,"Iowa","Pocahontas County",5,52,80,42,38
050,19,151,"Iowa","Pocahontas County",5,53,68,38,30
050,19,151,"Iowa","Pocahontas County",5,54,76,31,45
050,19,151,"Iowa","Pocahontas County",5,55,67,34,33
050,19,151,"Iowa","Pocahontas County",5,56,97,50,47
050,19,151,"Iowa","Pocahontas County",5,57,81,44,37
050,19,151,"Iowa","Pocahontas County",5,58,95,43,52
050,19,151,"Iowa","Pocahontas County",5,59,112,59,53
050,19,151,"Iowa","Pocahontas County",5,60,112,54,58
050,19,151,"Iowa","Pocahontas County",5,61,120,58,62
050,19,151,"Iowa","Pocahontas County",5,62,132,64,68
050,19,151,"Iowa","Pocahontas County",5,63,122,63,59
050,19,151,"Iowa","Pocahontas County",5,64,125,63,62
050,19,151,"Iowa","Pocahontas County",5,65,118,63,55
050,19,151,"Iowa","Pocahontas County",5,66,130,81,49
050,19,151,"Iowa","Pocahontas County",5,67,117,61,56
050,19,151,"Iowa","Pocahontas County",5,68,103,52,51
050,19,151,"Iowa","Pocahontas County",5,69,99,46,53
050,19,151,"Iowa","Pocahontas County",5,70,88,44,44
050,19,151,"Iowa","Pocahontas County",5,71,76,37,39
050,19,151,"Iowa","Pocahontas County",5,72,79,37,42
050,19,151,"Iowa","Pocahontas County",5,73,89,42,47
050,19,151,"Iowa","Pocahontas County",5,74,71,38,33
050,19,151,"Iowa","Pocahontas County",5,75,63,42,21
050,19,151,"Iowa","Pocahontas County",5,76,64,31,33
050,19,151,"Iowa","Pocahontas County",5,77,63,30,33
050,19,151,"Iowa","Pocahontas County",5,78,55,28,27
050,19,151,"Iowa","Pocahontas County",5,79,61,27,34
050,19,151,"Iowa","Pocahontas County",5,80,50,20,30
050,19,151,"Iowa","Pocahontas County",5,81,42,16,26
050,19,151,"Iowa","Pocahontas County",5,82,35,11,24
050,19,151,"Iowa","Pocahontas County",5,83,40,11,29
050,19,151,"Iowa","Pocahontas County",5,84,39,10,29
050,19,151,"Iowa","Pocahontas County",5,85,238,80,158
050,19,153,"Iowa","Polk County",1,0,6485,3306,3179
050,19,153,"Iowa","Polk County",1,1,6561,3284,3277
050,19,153,"Iowa","Polk County",1,2,6737,3423,3314
050,19,153,"Iowa","Polk County",1,3,7024,3543,3481
050,19,153,"Iowa","Polk County",1,4,7034,3657,3377
050,19,153,"Iowa","Polk County",1,5,6920,3569,3351
050,19,153,"Iowa","Polk County",1,6,6816,3431,3385
050,19,153,"Iowa","Polk County",1,7,6751,3383,3368
050,19,153,"Iowa","Polk County",1,8,6638,3391,3247
050,19,153,"Iowa","Polk County",1,9,6640,3385,3255
050,19,153,"Iowa","Polk County",1,10,6889,3509,3380
050,19,153,"Iowa","Polk County",1,11,7099,3646,3453
050,19,153,"Iowa","Polk County",1,12,7276,3711,3565
050,19,153,"Iowa","Polk County",1,13,7334,3770,3564
050,19,153,"Iowa","Polk County",1,14,7023,3543,3480
050,19,153,"Iowa","Polk County",1,15,6796,3429,3367
050,19,153,"Iowa","Polk County",1,16,6833,3444,3389
050,19,153,"Iowa","Polk County",1,17,6608,3332,3276
050,19,153,"Iowa","Polk County",1,18,5904,3018,2886
050,19,153,"Iowa","Polk County",1,19,5726,2845,2881
050,19,153,"Iowa","Polk County",1,20,5891,2921,2970
050,19,153,"Iowa","Polk County",1,21,5579,2735,2844
050,19,153,"Iowa","Polk County",1,22,5936,2880,3056
050,19,153,"Iowa","Polk County",1,23,6436,3182,3254
050,19,153,"Iowa","Polk County",1,24,6946,3512,3434
050,19,153,"Iowa","Polk County",1,25,7147,3665,3482
050,19,153,"Iowa","Polk County",1,26,7333,3714,3619
050,19,153,"Iowa","Polk County",1,27,7641,3826,3815
050,19,153,"Iowa","Polk County",1,28,7820,3874,3946
050,19,153,"Iowa","Polk County",1,29,7689,3838,3851
050,19,153,"Iowa","Polk County",1,30,7672,3899,3773
050,19,153,"Iowa","Polk County",1,31,7258,3686,3572
050,19,153,"Iowa","Polk County",1,32,7080,3547,3533
050,19,153,"Iowa","Polk County",1,33,7246,3660,3586
050,19,153,"Iowa","Polk County",1,34,7475,3814,3661
050,19,153,"Iowa","Polk County",1,35,7607,3948,3659
050,19,153,"Iowa","Polk County",1,36,7341,3772,3569
050,19,153,"Iowa","Polk County",1,37,7427,3790,3637
050,19,153,"Iowa","Polk County",1,38,7370,3785,3585
050,19,153,"Iowa","Polk County",1,39,7210,3643,3567
050,19,153,"Iowa","Polk County",1,40,7129,3602,3527
050,19,153,"Iowa","Polk County",1,41,6705,3409,3296
050,19,153,"Iowa","Polk County",1,42,6332,3230,3102
050,19,153,"Iowa","Polk County",1,43,6094,3118,2976
050,19,153,"Iowa","Polk County",1,44,5994,3013,2981
050,19,153,"Iowa","Polk County",1,45,6097,3086,3011
050,19,153,"Iowa","Polk County",1,46,5675,2869,2806
050,19,153,"Iowa","Polk County",1,47,5679,2857,2822
050,19,153,"Iowa","Polk County",1,48,6043,3061,2982
050,19,153,"Iowa","Polk County",1,49,6491,3256,3235
050,19,153,"Iowa","Polk County",1,50,6339,3243,3096
050,19,153,"Iowa","Polk County",1,51,6116,3130,2986
050,19,153,"Iowa","Polk County",1,52,5744,2929,2815
050,19,153,"Iowa","Polk County",1,53,5723,2849,2874
050,19,153,"Iowa","Polk County",1,54,5728,2842,2886
050,19,153,"Iowa","Polk County",1,55,5993,3042,2951
050,19,153,"Iowa","Polk County",1,56,6009,3040,2969
050,19,153,"Iowa","Polk County",1,57,6096,3015,3081
050,19,153,"Iowa","Polk County",1,58,6147,3053,3094
050,19,153,"Iowa","Polk County",1,59,6172,3002,3170
050,19,153,"Iowa","Polk County",1,60,6003,2946,3057
050,19,153,"Iowa","Polk County",1,61,5628,2771,2857
050,19,153,"Iowa","Polk County",1,62,5464,2632,2832
050,19,153,"Iowa","Polk County",1,63,5206,2482,2724
050,19,153,"Iowa","Polk County",1,64,5193,2497,2696
050,19,153,"Iowa","Polk County",1,65,5057,2430,2627
050,19,153,"Iowa","Polk County",1,66,4759,2275,2484
050,19,153,"Iowa","Polk County",1,67,4554,2164,2390
050,19,153,"Iowa","Polk County",1,68,4485,2129,2356
050,19,153,"Iowa","Polk County",1,69,4096,1882,2214
050,19,153,"Iowa","Polk County",1,70,3913,1819,2094
050,19,153,"Iowa","Polk County",1,71,3725,1728,1997
050,19,153,"Iowa","Polk County",1,72,3662,1688,1974
050,19,153,"Iowa","Polk County",1,73,3655,1725,1930
050,19,153,"Iowa","Polk County",1,74,2488,1116,1372
050,19,153,"Iowa","Polk County",1,75,2353,1044,1309
050,19,153,"Iowa","Polk County",1,76,2307,1020,1287
050,19,153,"Iowa","Polk County",1,77,2300,1033,1267
050,19,153,"Iowa","Polk County",1,78,1872,812,1060
050,19,153,"Iowa","Polk County",1,79,1729,751,978
050,19,153,"Iowa","Polk County",1,80,1652,711,941
050,19,153,"Iowa","Polk County",1,81,1517,624,893
050,19,153,"Iowa","Polk County",1,82,1348,528,820
050,19,153,"Iowa","Polk County",1,83,1243,498,745
050,19,153,"Iowa","Polk County",1,84,1123,422,701
050,19,153,"Iowa","Polk County",1,85,7574,2489,5085
050,19,153,"Iowa","Polk County",2,0,6398,3227,3171
050,19,153,"Iowa","Polk County",2,1,6550,3292,3258
050,19,153,"Iowa","Polk County",2,2,6695,3396,3299
050,19,153,"Iowa","Polk County",2,3,6916,3503,3413
050,19,153,"Iowa","Polk County",2,4,7041,3638,3403
050,19,153,"Iowa","Polk County",2,5,6956,3590,3366
050,19,153,"Iowa","Polk County",2,6,6842,3465,3377
050,19,153,"Iowa","Polk County",2,7,6757,3389,3368
050,19,153,"Iowa","Polk County",2,8,6648,3379,3269
050,19,153,"Iowa","Polk County",2,9,6634,3387,3247
050,19,153,"Iowa","Polk County",2,10,6823,3478,3345
050,19,153,"Iowa","Polk County",2,11,7013,3588,3425
050,19,153,"Iowa","Polk County",2,12,7259,3706,3553
050,19,153,"Iowa","Polk County",2,13,7305,3740,3565
050,19,153,"Iowa","Polk County",2,14,7088,3593,3495
050,19,153,"Iowa","Polk County",2,15,6848,3456,3392
050,19,153,"Iowa","Polk County",2,16,6831,3445,3386
050,19,153,"Iowa","Polk County",2,17,6671,3358,3313
050,19,153,"Iowa","Polk County",2,18,5941,3027,2914
050,19,153,"Iowa","Polk County",2,19,5755,2860,2895
050,19,153,"Iowa","Polk County",2,20,5958,2952,3006
050,19,153,"Iowa","Polk County",2,21,5628,2762,2866
050,19,153,"Iowa","Polk County",2,22,5968,2903,3065
050,19,153,"Iowa","Polk County",2,23,6458,3190,3268
050,19,153,"Iowa","Polk County",2,24,6906,3488,3418
050,19,153,"Iowa","Polk County",2,25,7145,3664,3481
050,19,153,"Iowa","Polk County",2,26,7335,3730,3605
050,19,153,"Iowa","Polk County",2,27,7561,3796,3765
050,19,153,"Iowa","Polk County",2,28,7793,3879,3914
050,19,153,"Iowa","Polk County",2,29,7723,3846,3877
050,19,153,"Iowa","Polk County",2,30,7701,3897,3804
050,19,153,"Iowa","Polk County",2,31,7328,3723,3605
050,19,153,"Iowa","Polk County",2,32,7115,3573,3542
050,19,153,"Iowa","Polk County",2,33,7187,3630,3557
050,19,153,"Iowa","Polk County",2,34,7418,3775,3643
050,19,153,"Iowa","Polk County",2,35,7617,3940,3677
050,19,153,"Iowa","Polk County",2,36,7350,3790,3560
050,19,153,"Iowa","Polk County",2,37,7421,3798,3623
050,19,153,"Iowa","Polk County",2,38,7404,3796,3608
050,19,153,"Iowa","Polk County",2,39,7222,3659,3563
050,19,153,"Iowa","Polk County",2,40,7179,3632,3547
050,19,153,"Iowa","Polk County",2,41,6777,3437,3340
050,19,153,"Iowa","Polk County",2,42,6389,3254,3135
050,19,153,"Iowa","Polk County",2,43,6188,3162,3026
050,19,153,"Iowa","Polk County",2,44,5956,3002,2954
050,19,153,"Iowa","Polk County",2,45,6102,3080,3022
050,19,153,"Iowa","Polk County",2,46,5758,2912,2846
050,19,153,"Iowa","Polk County",2,47,5649,2841,2808
050,19,153,"Iowa","Polk County",2,48,5939,2999,2940
050,19,153,"Iowa","Polk County",2,49,6404,3222,3182
050,19,153,"Iowa","Polk County",2,50,6381,3249,3132
050,19,153,"Iowa","Polk County",2,51,6137,3141,2996
050,19,153,"Iowa","Polk County",2,52,5803,2958,2845
050,19,153,"Iowa","Polk County",2,53,5728,2869,2859
050,19,153,"Iowa","Polk County",2,54,5699,2829,2870
050,19,153,"Iowa","Polk County",2,55,5897,2974,2923
050,19,153,"Iowa","Polk County",2,56,6013,3041,2972
050,19,153,"Iowa","Polk County",2,57,6073,3014,3059
050,19,153,"Iowa","Polk County",2,58,6111,3030,3081
050,19,153,"Iowa","Polk County",2,59,6187,3022,3165
050,19,153,"Iowa","Polk County",2,60,6007,2941,3066
050,19,153,"Iowa","Polk County",2,61,5700,2805,2895
050,19,153,"Iowa","Polk County",2,62,5465,2644,2821
050,19,153,"Iowa","Polk County",2,63,5286,2523,2763
050,19,153,"Iowa","Polk County",2,64,5142,2470,2672
050,19,153,"Iowa","Polk County",2,65,5064,2429,2635
050,19,153,"Iowa","Polk County",2,66,4823,2306,2517
050,19,153,"Iowa","Polk County",2,67,4572,2176,2396
050,19,153,"Iowa","Polk County",2,68,4465,2126,2339
050,19,153,"Iowa","Polk County",2,69,4180,1939,2241
050,19,153,"Iowa","Polk County",2,70,3906,1813,2093
050,19,153,"Iowa","Polk County",2,71,3762,1740,2022
050,19,153,"Iowa","Polk County",2,72,3597,1656,1941
050,19,153,"Iowa","Polk County",2,73,3816,1790,2026
050,19,153,"Iowa","Polk County",2,74,2585,1171,1414
050,19,153,"Iowa","Polk County",2,75,2361,1048,1313
050,19,153,"Iowa","Polk County",2,76,2273,1011,1262
050,19,153,"Iowa","Polk County",2,77,2326,1037,1289
050,19,153,"Iowa","Polk County",2,78,1917,841,1076
050,19,153,"Iowa","Polk County",2,79,1735,756,979
050,19,153,"Iowa","Polk County",2,80,1648,709,939
050,19,153,"Iowa","Polk County",2,81,1522,632,890
050,19,153,"Iowa","Polk County",2,82,1383,552,831
050,19,153,"Iowa","Polk County",2,83,1253,501,752
050,19,153,"Iowa","Polk County",2,84,1120,425,695
050,19,153,"Iowa","Polk County",2,85,7535,2464,5071
050,19,153,"Iowa","Polk County",3,0,6267,3192,3075
050,19,153,"Iowa","Polk County",3,1,6343,3153,3190
050,19,153,"Iowa","Polk County",3,2,6495,3276,3219
050,19,153,"Iowa","Polk County",3,3,6608,3375,3233
050,19,153,"Iowa","Polk County",3,4,6940,3512,3428
050,19,153,"Iowa","Polk County",3,5,6982,3610,3372
050,19,153,"Iowa","Polk County",3,6,6866,3558,3308
050,19,153,"Iowa","Polk County",3,7,6811,3449,3362
050,19,153,"Iowa","Polk County",3,8,6716,3351,3365
050,19,153,"Iowa","Polk County",3,9,6630,3389,3241
050,19,153,"Iowa","Polk County",3,10,6642,3397,3245
050,19,153,"Iowa","Polk County",3,11,6819,3474,3345
050,19,153,"Iowa","Polk County",3,12,6962,3567,3395
050,19,153,"Iowa","Polk County",3,13,7259,3703,3556
050,19,153,"Iowa","Polk County",3,14,7244,3721,3523
050,19,153,"Iowa","Polk County",3,15,7079,3616,3463
050,19,153,"Iowa","Polk County",3,16,6843,3434,3409
050,19,153,"Iowa","Polk County",3,17,6837,3446,3391
050,19,153,"Iowa","Polk County",3,18,6063,3061,3002
050,19,153,"Iowa","Polk County",3,19,5781,2884,2897
050,19,153,"Iowa","Polk County",3,20,5998,3001,2997
050,19,153,"Iowa","Polk County",3,21,5800,2875,2925
050,19,153,"Iowa","Polk County",3,22,6062,2968,3094
050,19,153,"Iowa","Polk County",3,23,6638,3253,3385
050,19,153,"Iowa","Polk County",3,24,7137,3533,3604
050,19,153,"Iowa","Polk County",3,25,7423,3806,3617
050,19,153,"Iowa","Polk County",3,26,7375,3797,3578
050,19,153,"Iowa","Polk County",3,27,7599,3888,3711
050,19,153,"Iowa","Polk County",3,28,7690,3930,3760
050,19,153,"Iowa","Polk County",3,29,7897,3957,3940
050,19,153,"Iowa","Polk County",3,30,7830,3936,3894
050,19,153,"Iowa","Polk County",3,31,7743,3967,3776
050,19,153,"Iowa","Polk County",3,32,7422,3796,3626
050,19,153,"Iowa","Polk County",3,33,7196,3682,3514
050,19,153,"Iowa","Polk County",3,34,7203,3690,3513
050,19,153,"Iowa","Polk County",3,35,7440,3825,3615
050,19,153,"Iowa","Polk County",3,36,7574,3925,3649
050,19,153,"Iowa","Polk County",3,37,7368,3844,3524
050,19,153,"Iowa","Polk County",3,38,7511,3864,3647
050,19,153,"Iowa","Polk County",3,39,7378,3816,3562
050,19,153,"Iowa","Polk County",3,40,7260,3725,3535
050,19,153,"Iowa","Polk County",3,41,7172,3676,3496
050,19,153,"Iowa","Polk County",3,42,6790,3455,3335
050,19,153,"Iowa","Polk County",3,43,6431,3303,3128
050,19,153,"Iowa","Polk County",3,44,6223,3198,3025
050,19,153,"Iowa","Polk County",3,45,6028,3073,2955
050,19,153,"Iowa","Polk County",3,46,6085,3055,3030
050,19,153,"Iowa","Polk County",3,47,5727,2911,2816
050,19,153,"Iowa","Polk County",3,48,5664,2864,2800
050,19,153,"Iowa","Polk County",3,49,5938,3027,2911
050,19,153,"Iowa","Polk County",3,50,6395,3231,3164
050,19,153,"Iowa","Polk County",3,51,6376,3260,3116
050,19,153,"Iowa","Polk County",3,52,6154,3144,3010
050,19,153,"Iowa","Polk County",3,53,5756,2945,2811
050,19,153,"Iowa","Polk County",3,54,5729,2861,2868
050,19,153,"Iowa","Polk County",3,55,5609,2774,2835
050,19,153,"Iowa","Polk County",3,56,5826,2925,2901
050,19,153,"Iowa","Polk County",3,57,5902,2990,2912
050,19,153,"Iowa","Polk County",3,58,6080,3049,3031
050,19,153,"Iowa","Polk County",3,59,6126,3015,3111
050,19,153,"Iowa","Polk County",3,60,6083,2978,3105
050,19,153,"Iowa","Polk County",3,61,5919,2883,3036
050,19,153,"Iowa","Polk County",3,62,5550,2717,2833
050,19,153,"Iowa","Polk County",3,63,5403,2607,2796
050,19,153,"Iowa","Polk County",3,64,5191,2491,2700
050,19,153,"Iowa","Polk County",3,65,5019,2397,2622
050,19,153,"Iowa","Polk County",3,66,4971,2372,2599
050,19,153,"Iowa","Polk County",3,67,4757,2249,2508
050,19,153,"Iowa","Polk County",3,68,4463,2126,2337
050,19,153,"Iowa","Polk County",3,69,4376,2068,2308
050,19,153,"Iowa","Polk County",3,70,4059,1859,2200
050,19,153,"Iowa","Polk County",3,71,3827,1761,2066
050,19,153,"Iowa","Polk County",3,72,3685,1676,2009
050,19,153,"Iowa","Polk County",3,73,3530,1605,1925
050,19,153,"Iowa","Polk County",3,74,3730,1718,2012
050,19,153,"Iowa","Polk County",3,75,2485,1132,1353
050,19,153,"Iowa","Polk County",3,76,2281,1014,1267
050,19,153,"Iowa","Polk County",3,77,2159,946,1213
050,19,153,"Iowa","Polk County",3,78,2263,1002,1261
050,19,153,"Iowa","Polk County",3,79,1807,792,1015
050,19,153,"Iowa","Polk County",3,80,1637,687,950
050,19,153,"Iowa","Polk County",3,81,1536,645,891
050,19,153,"Iowa","Polk County",3,82,1441,604,837
050,19,153,"Iowa","Polk County",3,83,1306,513,793
050,19,153,"Iowa","Polk County",3,84,1149,437,712
050,19,153,"Iowa","Polk County",3,85,7473,2444,5029
050,19,153,"Iowa","Polk County",4,0,6460,3334,3126
050,19,153,"Iowa","Polk County",4,1,6240,3187,3053
050,19,153,"Iowa","Polk County",4,2,6388,3187,3201
050,19,153,"Iowa","Polk County",4,3,6476,3253,3223
050,19,153,"Iowa","Polk County",4,4,6628,3374,3254
050,19,153,"Iowa","Polk County",4,5,6906,3482,3424
050,19,153,"Iowa","Polk County",4,6,6936,3547,3389
050,19,153,"Iowa","Polk County",4,7,6875,3567,3308
050,19,153,"Iowa","Polk County",4,8,6784,3449,3335
050,19,153,"Iowa","Polk County",4,9,6702,3335,3367
050,19,153,"Iowa","Polk County",4,10,6636,3383,3253
050,19,153,"Iowa","Polk County",4,11,6634,3402,3232
050,19,153,"Iowa","Polk County",4,12,6792,3446,3346
050,19,153,"Iowa","Polk County",4,13,7037,3595,3442
050,19,153,"Iowa","Polk County",4,14,7217,3669,3548
050,19,153,"Iowa","Polk County",4,15,7217,3715,3502
050,19,153,"Iowa","Polk County",4,16,7070,3592,3478
050,19,153,"Iowa","Polk County",4,17,6885,3473,3412
050,19,153,"Iowa","Polk County",4,18,6173,3170,3003
050,19,153,"Iowa","Polk County",4,19,5729,2864,2865
050,19,153,"Iowa","Polk County",4,20,5932,2966,2966
050,19,153,"Iowa","Polk County",4,21,5802,2880,2922
050,19,153,"Iowa","Polk County",4,22,6221,3046,3175
050,19,153,"Iowa","Polk County",4,23,6775,3281,3494
050,19,153,"Iowa","Polk County",4,24,7198,3600,3598
050,19,153,"Iowa","Polk County",4,25,7434,3751,3683
050,19,153,"Iowa","Polk County",4,26,7614,3916,3698
050,19,153,"Iowa","Polk County",4,27,7530,3894,3636
050,19,153,"Iowa","Polk County",4,28,7725,3971,3754
050,19,153,"Iowa","Polk County",4,29,7802,3975,3827
050,19,153,"Iowa","Polk County",4,30,7926,3999,3927
050,19,153,"Iowa","Polk County",4,31,7827,3945,3882
050,19,153,"Iowa","Polk County",4,32,7723,3981,3742
050,19,153,"Iowa","Polk County",4,33,7440,3824,3616
050,19,153,"Iowa","Polk County",4,34,7166,3705,3461
050,19,153,"Iowa","Polk County",4,35,7112,3618,3494
050,19,153,"Iowa","Polk County",4,36,7416,3805,3611
050,19,153,"Iowa","Polk County",4,37,7516,3891,3625
050,19,153,"Iowa","Polk County",4,38,7321,3822,3499
050,19,153,"Iowa","Polk County",4,39,7434,3811,3623
050,19,153,"Iowa","Polk County",4,40,7338,3786,3552
050,19,153,"Iowa","Polk County",4,41,7179,3663,3516
050,19,153,"Iowa","Polk County",4,42,7184,3674,3510
050,19,153,"Iowa","Polk County",4,43,6785,3442,3343
050,19,153,"Iowa","Polk County",4,44,6430,3315,3115
050,19,153,"Iowa","Polk County",4,45,6253,3223,3030
050,19,153,"Iowa","Polk County",4,46,6055,3099,2956
050,19,153,"Iowa","Polk County",4,47,5997,3022,2975
050,19,153,"Iowa","Polk County",4,48,5693,2867,2826
050,19,153,"Iowa","Polk County",4,49,5639,2836,2803
050,19,153,"Iowa","Polk County",4,50,5900,3015,2885
050,19,153,"Iowa","Polk County",4,51,6306,3185,3121
050,19,153,"Iowa","Polk County",4,52,6382,3250,3132
050,19,153,"Iowa","Polk County",4,53,6075,3091,2984
050,19,153,"Iowa","Polk County",4,54,5751,2933,2818
050,19,153,"Iowa","Polk County",4,55,5633,2813,2820
050,19,153,"Iowa","Polk County",4,56,5553,2747,2806
050,19,153,"Iowa","Polk County",4,57,5776,2895,2881
050,19,153,"Iowa","Polk County",4,58,5870,2967,2903
050,19,153,"Iowa","Polk County",4,59,5955,2974,2981
050,19,153,"Iowa","Polk County",4,60,6017,2953,3064
050,19,153,"Iowa","Polk County",4,61,6010,2930,3080
050,19,153,"Iowa","Polk County",4,62,5833,2808,3025
050,19,153,"Iowa","Polk County",4,63,5460,2654,2806
050,19,153,"Iowa","Polk County",4,64,5307,2567,2740
050,19,153,"Iowa","Polk County",4,65,5099,2437,2662
050,19,153,"Iowa","Polk County",4,66,4939,2351,2588
050,19,153,"Iowa","Polk County",4,67,4870,2295,2575
050,19,153,"Iowa","Polk County",4,68,4660,2204,2456
050,19,153,"Iowa","Polk County",4,69,4374,2076,2298
050,19,153,"Iowa","Polk County",4,70,4268,2001,2267
050,19,153,"Iowa","Polk County",4,71,3980,1815,2165
050,19,153,"Iowa","Polk County",4,72,3751,1720,2031
050,19,153,"Iowa","Polk County",4,73,3602,1628,1974
050,19,153,"Iowa","Polk County",4,74,3431,1534,1897
050,19,153,"Iowa","Polk County",4,75,3620,1666,1954
050,19,153,"Iowa","Polk County",4,76,2393,1087,1306
050,19,153,"Iowa","Polk County",4,77,2175,951,1224
050,19,153,"Iowa","Polk County",4,78,2071,899,1172
050,19,153,"Iowa","Polk County",4,79,2141,925,1216
050,19,153,"Iowa","Polk County",4,80,1732,736,996
050,19,153,"Iowa","Polk County",4,81,1541,631,910
050,19,153,"Iowa","Polk County",4,82,1466,621,845
050,19,153,"Iowa","Polk County",4,83,1358,562,796
050,19,153,"Iowa","Polk County",4,84,1183,458,725
050,19,153,"Iowa","Polk County",4,85,7450,2427,5023
050,19,153,"Iowa","Polk County",5,0,6521,3364,3157
050,19,153,"Iowa","Polk County",5,1,6534,3396,3138
050,19,153,"Iowa","Polk County",5,2,6277,3225,3052
050,19,153,"Iowa","Polk County",5,3,6384,3218,3166
050,19,153,"Iowa","Polk County",5,4,6471,3264,3207
050,19,153,"Iowa","Polk County",5,5,6633,3390,3243
050,19,153,"Iowa","Polk County",5,6,6884,3466,3418
050,19,153,"Iowa","Polk County",5,7,6949,3566,3383
050,19,153,"Iowa","Polk County",5,8,6860,3556,3304
050,19,153,"Iowa","Polk County",5,9,6804,3451,3353
050,19,153,"Iowa","Polk County",5,10,6729,3364,3365
050,19,153,"Iowa","Polk County",5,11,6622,3376,3246
050,19,153,"Iowa","Polk County",5,12,6602,3402,3200
050,19,153,"Iowa","Polk County",5,13,6770,3441,3329
050,19,153,"Iowa","Polk County",5,14,7002,3603,3399
050,19,153,"Iowa","Polk County",5,15,7257,3692,3565
050,19,153,"Iowa","Polk County",5,16,7183,3703,3480
050,19,153,"Iowa","Polk County",5,17,7042,3582,3460
050,19,153,"Iowa","Polk County",5,18,6276,3226,3050
050,19,153,"Iowa","Polk County",5,19,5914,2970,2944
050,19,153,"Iowa","Polk County",5,20,6067,3022,3045
050,19,153,"Iowa","Polk County",5,21,5880,2926,2954
050,19,153,"Iowa","Polk County",5,22,6277,3021,3256
050,19,153,"Iowa","Polk County",5,23,6882,3402,3480
050,19,153,"Iowa","Polk County",5,24,7298,3580,3718
050,19,153,"Iowa","Polk County",5,25,7439,3750,3689
050,19,153,"Iowa","Polk County",5,26,7659,3924,3735
050,19,153,"Iowa","Polk County",5,27,7699,3938,3761
050,19,153,"Iowa","Polk County",5,28,7519,3865,3654
050,19,153,"Iowa","Polk County",5,29,7764,3958,3806
050,19,153,"Iowa","Polk County",5,30,7817,4029,3788
050,19,153,"Iowa","Polk County",5,31,7872,3981,3891
050,19,153,"Iowa","Polk County",5,32,7853,4000,3853
050,19,153,"Iowa","Polk County",5,33,7697,3987,3710
050,19,153,"Iowa","Polk County",5,34,7418,3846,3572
050,19,153,"Iowa","Polk County",5,35,7120,3641,3479
050,19,153,"Iowa","Polk County",5,36,7054,3601,3453
050,19,153,"Iowa","Polk County",5,37,7363,3771,3592
050,19,153,"Iowa","Polk County",5,38,7499,3876,3623
050,19,153,"Iowa","Polk County",5,39,7231,3750,3481
050,19,153,"Iowa","Polk County",5,40,7430,3835,3595
050,19,153,"Iowa","Polk County",5,41,7261,3711,3550
050,19,153,"Iowa","Polk County",5,42,7199,3662,3537
050,19,153,"Iowa","Polk County",5,43,7200,3689,3511
050,19,153,"Iowa","Polk County",5,44,6784,3447,3337
050,19,153,"Iowa","Polk County",5,45,6452,3325,3127
050,19,153,"Iowa","Polk County",5,46,6228,3211,3017
050,19,153,"Iowa","Polk County",5,47,6025,3115,2910
050,19,153,"Iowa","Polk County",5,48,5967,3018,2949
050,19,153,"Iowa","Polk County",5,49,5682,2879,2803
050,19,153,"Iowa","Polk County",5,50,5608,2820,2788
050,19,153,"Iowa","Polk County",5,51,5888,3007,2881
050,19,153,"Iowa","Polk County",5,52,6250,3172,3078
050,19,153,"Iowa","Polk County",5,53,6317,3193,3124
050,19,153,"Iowa","Polk County",5,54,6076,3077,2999
050,19,153,"Iowa","Polk County",5,55,5703,2915,2788
050,19,153,"Iowa","Polk County",5,56,5585,2768,2817
050,19,153,"Iowa","Polk County",5,57,5529,2725,2804
050,19,153,"Iowa","Polk County",5,58,5779,2900,2879
050,19,153,"Iowa","Polk County",5,59,5799,2912,2887
050,19,153,"Iowa","Polk County",5,60,5909,2939,2970
050,19,153,"Iowa","Polk County",5,61,5910,2875,3035
050,19,153,"Iowa","Polk County",5,62,5924,2865,3059
050,19,153,"Iowa","Polk County",5,63,5713,2753,2960
050,19,153,"Iowa","Polk County",5,64,5373,2616,2757
050,19,153,"Iowa","Polk County",5,65,5235,2522,2713
050,19,153,"Iowa","Polk County",5,66,5058,2396,2662
050,19,153,"Iowa","Polk County",5,67,4853,2291,2562
050,19,153,"Iowa","Polk County",5,68,4775,2250,2525
050,19,153,"Iowa","Polk County",5,69,4579,2172,2407
050,19,153,"Iowa","Polk County",5,70,4242,1999,2243
050,19,153,"Iowa","Polk County",5,71,4189,1959,2230
050,19,153,"Iowa","Polk County",5,72,3894,1763,2131
050,19,153,"Iowa","Polk County",5,73,3670,1672,1998
050,19,153,"Iowa","Polk County",5,74,3531,1583,1948
050,19,153,"Iowa","Polk County",5,75,3335,1484,1851
050,19,153,"Iowa","Polk County",5,76,3502,1611,1891
050,19,153,"Iowa","Polk County",5,77,2277,1012,1265
050,19,153,"Iowa","Polk County",5,78,2120,915,1205
050,19,153,"Iowa","Polk County",5,79,1979,848,1131
050,19,153,"Iowa","Polk County",5,80,2055,855,1200
050,19,153,"Iowa","Polk County",5,81,1633,681,952
050,19,153,"Iowa","Polk County",5,82,1475,605,870
050,19,153,"Iowa","Polk County",5,83,1392,589,803
050,19,153,"Iowa","Polk County",5,84,1244,502,742
050,19,153,"Iowa","Polk County",5,85,7504,2477,5027
050,19,155,"Iowa","Pottawattamie County",1,0,1048,539,509
050,19,155,"Iowa","Pottawattamie County",1,1,1071,567,504
050,19,155,"Iowa","Pottawattamie County",1,2,1191,630,561
050,19,155,"Iowa","Pottawattamie County",1,3,1170,587,583
050,19,155,"Iowa","Pottawattamie County",1,4,1191,612,579
050,19,155,"Iowa","Pottawattamie County",1,5,1177,610,567
050,19,155,"Iowa","Pottawattamie County",1,6,1216,620,596
050,19,155,"Iowa","Pottawattamie County",1,7,1199,634,565
050,19,155,"Iowa","Pottawattamie County",1,8,1203,624,579
050,19,155,"Iowa","Pottawattamie County",1,9,1268,680,588
050,19,155,"Iowa","Pottawattamie County",1,10,1303,652,651
050,19,155,"Iowa","Pottawattamie County",1,11,1273,646,627
050,19,155,"Iowa","Pottawattamie County",1,12,1270,641,629
050,19,155,"Iowa","Pottawattamie County",1,13,1292,656,636
050,19,155,"Iowa","Pottawattamie County",1,14,1303,668,635
050,19,155,"Iowa","Pottawattamie County",1,15,1305,675,630
050,19,155,"Iowa","Pottawattamie County",1,16,1292,656,636
050,19,155,"Iowa","Pottawattamie County",1,17,1272,645,627
050,19,155,"Iowa","Pottawattamie County",1,18,1267,674,593
050,19,155,"Iowa","Pottawattamie County",1,19,1353,737,616
050,19,155,"Iowa","Pottawattamie County",1,20,1138,618,520
050,19,155,"Iowa","Pottawattamie County",1,21,1007,525,482
050,19,155,"Iowa","Pottawattamie County",1,22,1043,529,514
050,19,155,"Iowa","Pottawattamie County",1,23,997,522,475
050,19,155,"Iowa","Pottawattamie County",1,24,1017,521,496
050,19,155,"Iowa","Pottawattamie County",1,25,1078,545,533
050,19,155,"Iowa","Pottawattamie County",1,26,1087,547,540
050,19,155,"Iowa","Pottawattamie County",1,27,1123,551,572
050,19,155,"Iowa","Pottawattamie County",1,28,1170,584,586
050,19,155,"Iowa","Pottawattamie County",1,29,1163,598,565
050,19,155,"Iowa","Pottawattamie County",1,30,1141,560,581
050,19,155,"Iowa","Pottawattamie County",1,31,1075,553,522
050,19,155,"Iowa","Pottawattamie County",1,32,1123,560,563
050,19,155,"Iowa","Pottawattamie County",1,33,1057,533,524
050,19,155,"Iowa","Pottawattamie County",1,34,1122,547,575
050,19,155,"Iowa","Pottawattamie County",1,35,1157,582,575
050,19,155,"Iowa","Pottawattamie County",1,36,1127,559,568
050,19,155,"Iowa","Pottawattamie County",1,37,1138,573,565
050,19,155,"Iowa","Pottawattamie County",1,38,1252,617,635
050,19,155,"Iowa","Pottawattamie County",1,39,1260,615,645
050,19,155,"Iowa","Pottawattamie County",1,40,1154,590,564
050,19,155,"Iowa","Pottawattamie County",1,41,1143,567,576
050,19,155,"Iowa","Pottawattamie County",1,42,1184,595,589
050,19,155,"Iowa","Pottawattamie County",1,43,1077,531,546
050,19,155,"Iowa","Pottawattamie County",1,44,1091,545,546
050,19,155,"Iowa","Pottawattamie County",1,45,1085,568,517
050,19,155,"Iowa","Pottawattamie County",1,46,1036,546,490
050,19,155,"Iowa","Pottawattamie County",1,47,1080,545,535
050,19,155,"Iowa","Pottawattamie County",1,48,1162,572,590
050,19,155,"Iowa","Pottawattamie County",1,49,1190,574,616
050,19,155,"Iowa","Pottawattamie County",1,50,1097,531,566
050,19,155,"Iowa","Pottawattamie County",1,51,1109,558,551
050,19,155,"Iowa","Pottawattamie County",1,52,1080,551,529
050,19,155,"Iowa","Pottawattamie County",1,53,1166,593,573
050,19,155,"Iowa","Pottawattamie County",1,54,1168,610,558
050,19,155,"Iowa","Pottawattamie County",1,55,1195,600,595
050,19,155,"Iowa","Pottawattamie County",1,56,1311,652,659
050,19,155,"Iowa","Pottawattamie County",1,57,1369,657,712
050,19,155,"Iowa","Pottawattamie County",1,58,1452,687,765
050,19,155,"Iowa","Pottawattamie County",1,59,1398,697,701
050,19,155,"Iowa","Pottawattamie County",1,60,1361,690,671
050,19,155,"Iowa","Pottawattamie County",1,61,1315,654,661
050,19,155,"Iowa","Pottawattamie County",1,62,1335,657,678
050,19,155,"Iowa","Pottawattamie County",1,63,1301,636,665
050,19,155,"Iowa","Pottawattamie County",1,64,1255,609,646
050,19,155,"Iowa","Pottawattamie County",1,65,1211,582,629
050,19,155,"Iowa","Pottawattamie County",1,66,1139,547,592
050,19,155,"Iowa","Pottawattamie County",1,67,1158,574,584
050,19,155,"Iowa","Pottawattamie County",1,68,1133,561,572
050,19,155,"Iowa","Pottawattamie County",1,69,1025,494,531
050,19,155,"Iowa","Pottawattamie County",1,70,949,449,500
050,19,155,"Iowa","Pottawattamie County",1,71,903,420,483
050,19,155,"Iowa","Pottawattamie County",1,72,934,439,495
050,19,155,"Iowa","Pottawattamie County",1,73,928,457,471
050,19,155,"Iowa","Pottawattamie County",1,74,612,277,335
050,19,155,"Iowa","Pottawattamie County",1,75,590,271,319
050,19,155,"Iowa","Pottawattamie County",1,76,610,266,344
050,19,155,"Iowa","Pottawattamie County",1,77,624,277,347
050,19,155,"Iowa","Pottawattamie County",1,78,538,234,304
050,19,155,"Iowa","Pottawattamie County",1,79,486,214,272
050,19,155,"Iowa","Pottawattamie County",1,80,435,190,245
050,19,155,"Iowa","Pottawattamie County",1,81,412,172,240
050,19,155,"Iowa","Pottawattamie County",1,82,374,147,227
050,19,155,"Iowa","Pottawattamie County",1,83,329,131,198
050,19,155,"Iowa","Pottawattamie County",1,84,327,126,201
050,19,155,"Iowa","Pottawattamie County",1,85,1896,701,1195
050,19,155,"Iowa","Pottawattamie County",2,0,1057,530,527
050,19,155,"Iowa","Pottawattamie County",2,1,1071,563,508
050,19,155,"Iowa","Pottawattamie County",2,2,1168,616,552
050,19,155,"Iowa","Pottawattamie County",2,3,1172,599,573
050,19,155,"Iowa","Pottawattamie County",2,4,1189,608,581
050,19,155,"Iowa","Pottawattamie County",2,5,1181,613,568
050,19,155,"Iowa","Pottawattamie County",2,6,1210,618,592
050,19,155,"Iowa","Pottawattamie County",2,7,1199,626,573
050,19,155,"Iowa","Pottawattamie County",2,8,1197,623,574
050,19,155,"Iowa","Pottawattamie County",2,9,1253,666,587
050,19,155,"Iowa","Pottawattamie County",2,10,1293,659,634
050,19,155,"Iowa","Pottawattamie County",2,11,1280,647,633
050,19,155,"Iowa","Pottawattamie County",2,12,1279,646,633
050,19,155,"Iowa","Pottawattamie County",2,13,1287,653,634
050,19,155,"Iowa","Pottawattamie County",2,14,1303,666,637
050,19,155,"Iowa","Pottawattamie County",2,15,1303,669,634
050,19,155,"Iowa","Pottawattamie County",2,16,1300,660,640
050,19,155,"Iowa","Pottawattamie County",2,17,1277,648,629
050,19,155,"Iowa","Pottawattamie County",2,18,1267,671,596
050,19,155,"Iowa","Pottawattamie County",2,19,1356,739,617
050,19,155,"Iowa","Pottawattamie County",2,20,1145,624,521
050,19,155,"Iowa","Pottawattamie County",2,21,1005,524,481
050,19,155,"Iowa","Pottawattamie County",2,22,1034,525,509
050,19,155,"Iowa","Pottawattamie County",2,23,1008,523,485
050,19,155,"Iowa","Pottawattamie County",2,24,1011,519,492
050,19,155,"Iowa","Pottawattamie County",2,25,1059,536,523
050,19,155,"Iowa","Pottawattamie County",2,26,1083,543,540
050,19,155,"Iowa","Pottawattamie County",2,27,1110,548,562
050,19,155,"Iowa","Pottawattamie County",2,28,1162,578,584
050,19,155,"Iowa","Pottawattamie County",2,29,1170,598,572
050,19,155,"Iowa","Pottawattamie County",2,30,1152,574,578
050,19,155,"Iowa","Pottawattamie County",2,31,1090,553,537
050,19,155,"Iowa","Pottawattamie County",2,32,1108,559,549
050,19,155,"Iowa","Pottawattamie County",2,33,1069,537,532
050,19,155,"Iowa","Pottawattamie County",2,34,1106,545,561
050,19,155,"Iowa","Pottawattamie County",2,35,1157,579,578
050,19,155,"Iowa","Pottawattamie County",2,36,1123,558,565
050,19,155,"Iowa","Pottawattamie County",2,37,1138,568,570
050,19,155,"Iowa","Pottawattamie County",2,38,1232,612,620
050,19,155,"Iowa","Pottawattamie County",2,39,1257,615,642
050,19,155,"Iowa","Pottawattamie County",2,40,1189,598,591
050,19,155,"Iowa","Pottawattamie County",2,41,1144,571,573
050,19,155,"Iowa","Pottawattamie County",2,42,1173,589,584
050,19,155,"Iowa","Pottawattamie County",2,43,1113,552,561
050,19,155,"Iowa","Pottawattamie County",2,44,1080,536,544
050,19,155,"Iowa","Pottawattamie County",2,45,1092,567,525
050,19,155,"Iowa","Pottawattamie County",2,46,1051,554,497
050,19,155,"Iowa","Pottawattamie County",2,47,1067,545,522
050,19,155,"Iowa","Pottawattamie County",2,48,1142,565,577
050,19,155,"Iowa","Pottawattamie County",2,49,1187,573,614
050,19,155,"Iowa","Pottawattamie County",2,50,1119,542,577
050,19,155,"Iowa","Pottawattamie County",2,51,1105,552,553
050,19,155,"Iowa","Pottawattamie County",2,52,1085,551,534
050,19,155,"Iowa","Pottawattamie County",2,53,1141,579,562
050,19,155,"Iowa","Pottawattamie County",2,54,1163,604,559
050,19,155,"Iowa","Pottawattamie County",2,55,1186,601,585
050,19,155,"Iowa","Pottawattamie County",2,56,1279,640,639
050,19,155,"Iowa","Pottawattamie County",2,57,1355,657,698
050,19,155,"Iowa","Pottawattamie County",2,58,1423,676,747
050,19,155,"Iowa","Pottawattamie County",2,59,1416,697,719
050,19,155,"Iowa","Pottawattamie County",2,60,1368,690,678
050,19,155,"Iowa","Pottawattamie County",2,61,1316,658,658
050,19,155,"Iowa","Pottawattamie County",2,62,1320,651,669
050,19,155,"Iowa","Pottawattamie County",2,63,1315,646,669
050,19,155,"Iowa","Pottawattamie County",2,64,1255,610,645
050,19,155,"Iowa","Pottawattamie County",2,65,1221,586,635
050,19,155,"Iowa","Pottawattamie County",2,66,1160,557,603
050,19,155,"Iowa","Pottawattamie County",2,67,1148,563,585
050,19,155,"Iowa","Pottawattamie County",2,68,1120,554,566
050,19,155,"Iowa","Pottawattamie County",2,69,1049,506,543
050,19,155,"Iowa","Pottawattamie County",2,70,961,456,505
050,19,155,"Iowa","Pottawattamie County",2,71,916,428,488
050,19,155,"Iowa","Pottawattamie County",2,72,904,423,481
050,19,155,"Iowa","Pottawattamie County",2,73,976,475,501
050,19,155,"Iowa","Pottawattamie County",2,74,645,299,346
050,19,155,"Iowa","Pottawattamie County",2,75,591,272,319
050,19,155,"Iowa","Pottawattamie County",2,76,597,264,333
050,19,155,"Iowa","Pottawattamie County",2,77,630,278,352
050,19,155,"Iowa","Pottawattamie County",2,78,544,238,306
050,19,155,"Iowa","Pottawattamie County",2,79,488,210,278
050,19,155,"Iowa","Pottawattamie County",2,80,445,195,250
050,19,155,"Iowa","Pottawattamie County",2,81,407,171,236
050,19,155,"Iowa","Pottawattamie County",2,82,377,150,227
050,19,155,"Iowa","Pottawattamie County",2,83,329,130,199
050,19,155,"Iowa","Pottawattamie County",2,84,322,125,197
050,19,155,"Iowa","Pottawattamie County",2,85,1894,700,1194
050,19,155,"Iowa","Pottawattamie County",3,0,965,464,501
050,19,155,"Iowa","Pottawattamie County",3,1,1077,550,527
050,19,155,"Iowa","Pottawattamie County",3,2,1068,557,511
050,19,155,"Iowa","Pottawattamie County",3,3,1166,606,560
050,19,155,"Iowa","Pottawattamie County",3,4,1122,572,550
050,19,155,"Iowa","Pottawattamie County",3,5,1193,611,582
050,19,155,"Iowa","Pottawattamie County",3,6,1179,619,560
050,19,155,"Iowa","Pottawattamie County",3,7,1196,612,584
050,19,155,"Iowa","Pottawattamie County",3,8,1207,626,581
050,19,155,"Iowa","Pottawattamie County",3,9,1210,629,581
050,19,155,"Iowa","Pottawattamie County",3,10,1248,670,578
050,19,155,"Iowa","Pottawattamie County",3,11,1287,645,642
050,19,155,"Iowa","Pottawattamie County",3,12,1287,649,638
050,19,155,"Iowa","Pottawattamie County",3,13,1292,656,636
050,19,155,"Iowa","Pottawattamie County",3,14,1295,647,648
050,19,155,"Iowa","Pottawattamie County",3,15,1295,664,631
050,19,155,"Iowa","Pottawattamie County",3,16,1320,678,642
050,19,155,"Iowa","Pottawattamie County",3,17,1303,662,641
050,19,155,"Iowa","Pottawattamie County",3,18,1307,691,616
050,19,155,"Iowa","Pottawattamie County",3,19,1375,751,624
050,19,155,"Iowa","Pottawattamie County",3,20,1159,645,514
050,19,155,"Iowa","Pottawattamie County",3,21,1014,539,475
050,19,155,"Iowa","Pottawattamie County",3,22,1011,486,525
050,19,155,"Iowa","Pottawattamie County",3,23,1053,537,516
050,19,155,"Iowa","Pottawattamie County",3,24,1041,533,508
050,19,155,"Iowa","Pottawattamie County",3,25,993,513,480
050,19,155,"Iowa","Pottawattamie County",3,26,1097,557,540
050,19,155,"Iowa","Pottawattamie County",3,27,1085,540,545
050,19,155,"Iowa","Pottawattamie County",3,28,1088,533,555
050,19,155,"Iowa","Pottawattamie County",3,29,1174,586,588
050,19,155,"Iowa","Pottawattamie County",3,30,1179,605,574
050,19,155,"Iowa","Pottawattamie County",3,31,1164,573,591
050,19,155,"Iowa","Pottawattamie County",3,32,1107,561,546
050,19,155,"Iowa","Pottawattamie County",3,33,1110,551,559
050,19,155,"Iowa","Pottawattamie County",3,34,1064,530,534
050,19,155,"Iowa","Pottawattamie County",3,35,1116,545,571
050,19,155,"Iowa","Pottawattamie County",3,36,1141,572,569
050,19,155,"Iowa","Pottawattamie County",3,37,1104,547,557
050,19,155,"Iowa","Pottawattamie County",3,38,1132,575,557
050,19,155,"Iowa","Pottawattamie County",3,39,1242,620,622
050,19,155,"Iowa","Pottawattamie County",3,40,1256,619,637
050,19,155,"Iowa","Pottawattamie County",3,41,1188,593,595
050,19,155,"Iowa","Pottawattamie County",3,42,1156,576,580
050,19,155,"Iowa","Pottawattamie County",3,43,1161,585,576
050,19,155,"Iowa","Pottawattamie County",3,44,1104,544,560
050,19,155,"Iowa","Pottawattamie County",3,45,1066,529,537
050,19,155,"Iowa","Pottawattamie County",3,46,1098,571,527
050,19,155,"Iowa","Pottawattamie County",3,47,1040,549,491
050,19,155,"Iowa","Pottawattamie County",3,48,1046,529,517
050,19,155,"Iowa","Pottawattamie County",3,49,1156,565,591
050,19,155,"Iowa","Pottawattamie County",3,50,1193,569,624
050,19,155,"Iowa","Pottawattamie County",3,51,1103,537,566
050,19,155,"Iowa","Pottawattamie County",3,52,1094,547,547
050,19,155,"Iowa","Pottawattamie County",3,53,1067,544,523
050,19,155,"Iowa","Pottawattamie County",3,54,1132,570,562
050,19,155,"Iowa","Pottawattamie County",3,55,1135,577,558
050,19,155,"Iowa","Pottawattamie County",3,56,1189,601,588
050,19,155,"Iowa","Pottawattamie County",3,57,1274,638,636
050,19,155,"Iowa","Pottawattamie County",3,58,1344,653,691
050,19,155,"Iowa","Pottawattamie County",3,59,1420,673,747
050,19,155,"Iowa","Pottawattamie County",3,60,1404,692,712
050,19,155,"Iowa","Pottawattamie County",3,61,1361,679,682
050,19,155,"Iowa","Pottawattamie County",3,62,1310,647,663
050,19,155,"Iowa","Pottawattamie County",3,63,1311,647,664
050,19,155,"Iowa","Pottawattamie County",3,64,1288,629,659
050,19,155,"Iowa","Pottawattamie County",3,65,1234,597,637
050,19,155,"Iowa","Pottawattamie County",3,66,1208,585,623
050,19,155,"Iowa","Pottawattamie County",3,67,1128,535,593
050,19,155,"Iowa","Pottawattamie County",3,68,1117,547,570
050,19,155,"Iowa","Pottawattamie County",3,69,1095,537,558
050,19,155,"Iowa","Pottawattamie County",3,70,1037,495,542
050,19,155,"Iowa","Pottawattamie County",3,71,910,424,486
050,19,155,"Iowa","Pottawattamie County",3,72,882,409,473
050,19,155,"Iowa","Pottawattamie County",3,73,878,407,471
050,19,155,"Iowa","Pottawattamie County",3,74,944,459,485
050,19,155,"Iowa","Pottawattamie County",3,75,618,289,329
050,19,155,"Iowa","Pottawattamie County",3,76,563,254,309
050,19,155,"Iowa","Pottawattamie County",3,77,564,241,323
050,19,155,"Iowa","Pottawattamie County",3,78,600,265,335
050,19,155,"Iowa","Pottawattamie County",3,79,519,225,294
050,19,155,"Iowa","Pottawattamie County",3,80,449,191,258
050,19,155,"Iowa","Pottawattamie County",3,81,413,179,234
050,19,155,"Iowa","Pottawattamie County",3,82,390,168,222
050,19,155,"Iowa","Pottawattamie County",3,83,345,143,202
050,19,155,"Iowa","Pottawattamie County",3,84,302,112,190
050,19,155,"Iowa","Pottawattamie County",3,85,1852,681,1171
050,19,155,"Iowa","Pottawattamie County",4,0,1003,495,508
050,19,155,"Iowa","Pottawattamie County",4,1,987,475,512
050,19,155,"Iowa","Pottawattamie County",4,2,1083,549,534
050,19,155,"Iowa","Pottawattamie County",4,3,1063,554,509
050,19,155,"Iowa","Pottawattamie County",4,4,1146,598,548
050,19,155,"Iowa","Pottawattamie County",4,5,1151,590,561
050,19,155,"Iowa","Pottawattamie County",4,6,1205,609,596
050,19,155,"Iowa","Pottawattamie County",4,7,1163,604,559
050,19,155,"Iowa","Pottawattamie County",4,8,1191,615,576
050,19,155,"Iowa","Pottawattamie County",4,9,1192,612,580
050,19,155,"Iowa","Pottawattamie County",4,10,1199,622,577
050,19,155,"Iowa","Pottawattamie County",4,11,1253,672,581
050,19,155,"Iowa","Pottawattamie County",4,12,1273,637,636
050,19,155,"Iowa","Pottawattamie County",4,13,1292,646,646
050,19,155,"Iowa","Pottawattamie County",4,14,1292,658,634
050,19,155,"Iowa","Pottawattamie County",4,15,1272,632,640
050,19,155,"Iowa","Pottawattamie County",4,16,1316,680,636
050,19,155,"Iowa","Pottawattamie County",4,17,1299,682,617
050,19,155,"Iowa","Pottawattamie County",4,18,1305,692,613
050,19,155,"Iowa","Pottawattamie County",4,19,1361,752,609
050,19,155,"Iowa","Pottawattamie County",4,20,1163,635,528
050,19,155,"Iowa","Pottawattamie County",4,21,1000,523,477
050,19,155,"Iowa","Pottawattamie County",4,22,1038,528,510
050,19,155,"Iowa","Pottawattamie County",4,23,1016,510,506
050,19,155,"Iowa","Pottawattamie County",4,24,1071,557,514
050,19,155,"Iowa","Pottawattamie County",4,25,1046,555,491
050,19,155,"Iowa","Pottawattamie County",4,26,1054,541,513
050,19,155,"Iowa","Pottawattamie County",4,27,1090,555,535
050,19,155,"Iowa","Pottawattamie County",4,28,1088,540,548
050,19,155,"Iowa","Pottawattamie County",4,29,1085,531,554
050,19,155,"Iowa","Pottawattamie County",4,30,1174,585,589
050,19,155,"Iowa","Pottawattamie County",4,31,1200,620,580
050,19,155,"Iowa","Pottawattamie County",4,32,1178,582,596
050,19,155,"Iowa","Pottawattamie County",4,33,1100,546,554
050,19,155,"Iowa","Pottawattamie County",4,34,1121,568,553
050,19,155,"Iowa","Pottawattamie County",4,35,1079,554,525
050,19,155,"Iowa","Pottawattamie County",4,36,1129,542,587
050,19,155,"Iowa","Pottawattamie County",4,37,1137,563,574
050,19,155,"Iowa","Pottawattamie County",4,38,1094,549,545
050,19,155,"Iowa","Pottawattamie County",4,39,1182,611,571
050,19,155,"Iowa","Pottawattamie County",4,40,1220,612,608
050,19,155,"Iowa","Pottawattamie County",4,41,1237,601,636
050,19,155,"Iowa","Pottawattamie County",4,42,1181,589,592
050,19,155,"Iowa","Pottawattamie County",4,43,1137,565,572
050,19,155,"Iowa","Pottawattamie County",4,44,1151,568,583
050,19,155,"Iowa","Pottawattamie County",4,45,1093,542,551
050,19,155,"Iowa","Pottawattamie County",4,46,1072,538,534
050,19,155,"Iowa","Pottawattamie County",4,47,1079,570,509
050,19,155,"Iowa","Pottawattamie County",4,48,1029,534,495
050,19,155,"Iowa","Pottawattamie County",4,49,1041,526,515
050,19,155,"Iowa","Pottawattamie County",4,50,1136,550,586
050,19,155,"Iowa","Pottawattamie County",4,51,1190,567,623
050,19,155,"Iowa","Pottawattamie County",4,52,1086,532,554
050,19,155,"Iowa","Pottawattamie County",4,53,1077,527,550
050,19,155,"Iowa","Pottawattamie County",4,54,1066,543,523
050,19,155,"Iowa","Pottawattamie County",4,55,1111,558,553
050,19,155,"Iowa","Pottawattamie County",4,56,1148,589,559
050,19,155,"Iowa","Pottawattamie County",4,57,1187,600,587
050,19,155,"Iowa","Pottawattamie County",4,58,1270,633,637
050,19,155,"Iowa","Pottawattamie County",4,59,1334,644,690
050,19,155,"Iowa","Pottawattamie County",4,60,1389,651,738
050,19,155,"Iowa","Pottawattamie County",4,61,1387,687,700
050,19,155,"Iowa","Pottawattamie County",4,62,1328,666,662
050,19,155,"Iowa","Pottawattamie County",4,63,1272,626,646
050,19,155,"Iowa","Pottawattamie County",4,64,1288,627,661
050,19,155,"Iowa","Pottawattamie County",4,65,1263,617,646
050,19,155,"Iowa","Pottawattamie County",4,66,1231,600,631
050,19,155,"Iowa","Pottawattamie County",4,67,1192,574,618
050,19,155,"Iowa","Pottawattamie County",4,68,1097,514,583
050,19,155,"Iowa","Pottawattamie County",4,69,1074,526,548
050,19,155,"Iowa","Pottawattamie County",4,70,1086,531,555
050,19,155,"Iowa","Pottawattamie County",4,71,1002,475,527
050,19,155,"Iowa","Pottawattamie County",4,72,880,409,471
050,19,155,"Iowa","Pottawattamie County",4,73,869,404,465
050,19,155,"Iowa","Pottawattamie County",4,74,845,391,454
050,19,155,"Iowa","Pottawattamie County",4,75,913,444,469
050,19,155,"Iowa","Pottawattamie County",4,76,582,266,316
050,19,155,"Iowa","Pottawattamie County",4,77,533,238,295
050,19,155,"Iowa","Pottawattamie County",4,78,529,220,309
050,19,155,"Iowa","Pottawattamie County",4,79,577,246,331
050,19,155,"Iowa","Pottawattamie County",4,80,482,204,278
050,19,155,"Iowa","Pottawattamie County",4,81,424,182,242
050,19,155,"Iowa","Pottawattamie County",4,82,374,159,215
050,19,155,"Iowa","Pottawattamie County",4,83,356,154,202
050,19,155,"Iowa","Pottawattamie County",4,84,321,121,200
050,19,155,"Iowa","Pottawattamie County",4,85,1835,663,1172
050,19,155,"Iowa","Pottawattamie County",5,0,946,455,491
050,19,155,"Iowa","Pottawattamie County",5,1,1018,508,510
050,19,155,"Iowa","Pottawattamie County",5,2,992,461,531
050,19,155,"Iowa","Pottawattamie County",5,3,1091,547,544
050,19,155,"Iowa","Pottawattamie County",5,4,1087,565,522
050,19,155,"Iowa","Pottawattamie County",5,5,1135,613,522
050,19,155,"Iowa","Pottawattamie County",5,6,1150,584,566
050,19,155,"Iowa","Pottawattamie County",5,7,1202,601,601
050,19,155,"Iowa","Pottawattamie County",5,8,1156,609,547
050,19,155,"Iowa","Pottawattamie County",5,9,1205,621,584
050,19,155,"Iowa","Pottawattamie County",5,10,1231,638,593
050,19,155,"Iowa","Pottawattamie County",5,11,1205,619,586
050,19,155,"Iowa","Pottawattamie County",5,12,1245,652,593
050,19,155,"Iowa","Pottawattamie County",5,13,1285,639,646
050,19,155,"Iowa","Pottawattamie County",5,14,1267,644,623
050,19,155,"Iowa","Pottawattamie County",5,15,1288,662,626
050,19,155,"Iowa","Pottawattamie County",5,16,1306,658,648
050,19,155,"Iowa","Pottawattamie County",5,17,1323,691,632
050,19,155,"Iowa","Pottawattamie County",5,18,1300,698,602
050,19,155,"Iowa","Pottawattamie County",5,19,1386,762,624
050,19,155,"Iowa","Pottawattamie County",5,20,1145,634,511
050,19,155,"Iowa","Pottawattamie County",5,21,1027,544,483
050,19,155,"Iowa","Pottawattamie County",5,22,1032,513,519
050,19,155,"Iowa","Pottawattamie County",5,23,1049,531,518
050,19,155,"Iowa","Pottawattamie County",5,24,1035,522,513
050,19,155,"Iowa","Pottawattamie County",5,25,1074,555,519
050,19,155,"Iowa","Pottawattamie County",5,26,1050,542,508
050,19,155,"Iowa","Pottawattamie County",5,27,1040,541,499
050,19,155,"Iowa","Pottawattamie County",5,28,1098,553,545
050,19,155,"Iowa","Pottawattamie County",5,29,1077,535,542
050,19,155,"Iowa","Pottawattamie County",5,30,1065,513,552
050,19,155,"Iowa","Pottawattamie County",5,31,1178,580,598
050,19,155,"Iowa","Pottawattamie County",5,32,1269,662,607
050,19,155,"Iowa","Pottawattamie County",5,33,1172,568,604
050,19,155,"Iowa","Pottawattamie County",5,34,1111,559,552
050,19,155,"Iowa","Pottawattamie County",5,35,1159,590,569
050,19,155,"Iowa","Pottawattamie County",5,36,1076,546,530
050,19,155,"Iowa","Pottawattamie County",5,37,1123,529,594
050,19,155,"Iowa","Pottawattamie County",5,38,1145,578,567
050,19,155,"Iowa","Pottawattamie County",5,39,1154,599,555
050,19,155,"Iowa","Pottawattamie County",5,40,1192,615,577
050,19,155,"Iowa","Pottawattamie County",5,41,1220,606,614
050,19,155,"Iowa","Pottawattamie County",5,42,1257,617,640
050,19,155,"Iowa","Pottawattamie County",5,43,1194,593,601
050,19,155,"Iowa","Pottawattamie County",5,44,1137,573,564
050,19,155,"Iowa","Pottawattamie County",5,45,1150,561,589
050,19,155,"Iowa","Pottawattamie County",5,46,1097,545,552
050,19,155,"Iowa","Pottawattamie County",5,47,1072,545,527
050,19,155,"Iowa","Pottawattamie County",5,48,1068,559,509
050,19,155,"Iowa","Pottawattamie County",5,49,1030,531,499
050,19,155,"Iowa","Pottawattamie County",5,50,1036,512,524
050,19,155,"Iowa","Pottawattamie County",5,51,1125,547,578
050,19,155,"Iowa","Pottawattamie County",5,52,1187,569,618
050,19,155,"Iowa","Pottawattamie County",5,53,1058,513,545
050,19,155,"Iowa","Pottawattamie County",5,54,1093,539,554
050,19,155,"Iowa","Pottawattamie County",5,55,1067,538,529
050,19,155,"Iowa","Pottawattamie County",5,56,1115,559,556
050,19,155,"Iowa","Pottawattamie County",5,57,1155,594,561
050,19,155,"Iowa","Pottawattamie County",5,58,1181,592,589
050,19,155,"Iowa","Pottawattamie County",5,59,1252,617,635
050,19,155,"Iowa","Pottawattamie County",5,60,1320,632,688
050,19,155,"Iowa","Pottawattamie County",5,61,1365,642,723
050,19,155,"Iowa","Pottawattamie County",5,62,1399,688,711
050,19,155,"Iowa","Pottawattamie County",5,63,1320,656,664
050,19,155,"Iowa","Pottawattamie County",5,64,1248,607,641
050,19,155,"Iowa","Pottawattamie County",5,65,1273,614,659
050,19,155,"Iowa","Pottawattamie County",5,66,1239,605,634
050,19,155,"Iowa","Pottawattamie County",5,67,1217,594,623
050,19,155,"Iowa","Pottawattamie County",5,68,1166,561,605
050,19,155,"Iowa","Pottawattamie County",5,69,1070,499,571
050,19,155,"Iowa","Pottawattamie County",5,70,1063,519,544
050,19,155,"Iowa","Pottawattamie County",5,71,1050,510,540
050,19,155,"Iowa","Pottawattamie County",5,72,974,454,520
050,19,155,"Iowa","Pottawattamie County",5,73,856,398,458
050,19,155,"Iowa","Pottawattamie County",5,74,851,395,456
050,19,155,"Iowa","Pottawattamie County",5,75,828,383,445
050,19,155,"Iowa","Pottawattamie County",5,76,879,416,463
050,19,155,"Iowa","Pottawattamie County",5,77,559,248,311
050,19,155,"Iowa","Pottawattamie County",5,78,500,218,282
050,19,155,"Iowa","Pottawattamie County",5,79,510,209,301
050,19,155,"Iowa","Pottawattamie County",5,80,549,235,314
050,19,155,"Iowa","Pottawattamie County",5,81,444,192,252
050,19,155,"Iowa","Pottawattamie County",5,82,390,165,225
050,19,155,"Iowa","Pottawattamie County",5,83,342,145,197
050,19,155,"Iowa","Pottawattamie County",5,84,331,134,197
050,19,155,"Iowa","Pottawattamie County",5,85,1853,655,1198
050,19,157,"Iowa","Poweshiek County",1,0,162,85,77
050,19,157,"Iowa","Poweshiek County",1,1,169,91,78
050,19,157,"Iowa","Poweshiek County",1,2,183,92,91
050,19,157,"Iowa","Poweshiek County",1,3,173,96,77
050,19,157,"Iowa","Poweshiek County",1,4,199,108,91
050,19,157,"Iowa","Poweshiek County",1,5,211,112,99
050,19,157,"Iowa","Poweshiek County",1,6,201,101,100
050,19,157,"Iowa","Poweshiek County",1,7,181,85,96
050,19,157,"Iowa","Poweshiek County",1,8,195,94,101
050,19,157,"Iowa","Poweshiek County",1,9,214,112,102
050,19,157,"Iowa","Poweshiek County",1,10,245,120,125
050,19,157,"Iowa","Poweshiek County",1,11,239,115,124
050,19,157,"Iowa","Poweshiek County",1,12,230,115,115
050,19,157,"Iowa","Poweshiek County",1,13,229,106,123
050,19,157,"Iowa","Poweshiek County",1,14,224,114,110
050,19,157,"Iowa","Poweshiek County",1,15,230,122,108
050,19,157,"Iowa","Poweshiek County",1,16,218,108,110
050,19,157,"Iowa","Poweshiek County",1,17,224,109,115
050,19,157,"Iowa","Poweshiek County",1,18,344,170,174
050,19,157,"Iowa","Poweshiek County",1,19,560,273,287
050,19,157,"Iowa","Poweshiek County",1,20,556,268,288
050,19,157,"Iowa","Poweshiek County",1,21,457,241,216
050,19,157,"Iowa","Poweshiek County",1,22,350,177,173
050,19,157,"Iowa","Poweshiek County",1,23,198,101,97
050,19,157,"Iowa","Poweshiek County",1,24,197,106,91
050,19,157,"Iowa","Poweshiek County",1,25,164,87,77
050,19,157,"Iowa","Poweshiek County",1,26,174,93,81
050,19,157,"Iowa","Poweshiek County",1,27,175,89,86
050,19,157,"Iowa","Poweshiek County",1,28,168,83,85
050,19,157,"Iowa","Poweshiek County",1,29,179,95,84
050,19,157,"Iowa","Poweshiek County",1,30,208,103,105
050,19,157,"Iowa","Poweshiek County",1,31,176,83,93
050,19,157,"Iowa","Poweshiek County",1,32,170,83,87
050,19,157,"Iowa","Poweshiek County",1,33,185,87,98
050,19,157,"Iowa","Poweshiek County",1,34,200,101,99
050,19,157,"Iowa","Poweshiek County",1,35,222,102,120
050,19,157,"Iowa","Poweshiek County",1,36,219,118,101
050,19,157,"Iowa","Poweshiek County",1,37,208,109,99
050,19,157,"Iowa","Poweshiek County",1,38,210,111,99
050,19,157,"Iowa","Poweshiek County",1,39,179,84,95
050,19,157,"Iowa","Poweshiek County",1,40,189,93,96
050,19,157,"Iowa","Poweshiek County",1,41,193,112,81
050,19,157,"Iowa","Poweshiek County",1,42,206,109,97
050,19,157,"Iowa","Poweshiek County",1,43,188,96,92
050,19,157,"Iowa","Poweshiek County",1,44,200,101,99
050,19,157,"Iowa","Poweshiek County",1,45,185,82,103
050,19,157,"Iowa","Poweshiek County",1,46,170,78,92
050,19,157,"Iowa","Poweshiek County",1,47,193,95,98
050,19,157,"Iowa","Poweshiek County",1,48,203,100,103
050,19,157,"Iowa","Poweshiek County",1,49,195,103,92
050,19,157,"Iowa","Poweshiek County",1,50,193,106,87
050,19,157,"Iowa","Poweshiek County",1,51,186,103,83
050,19,157,"Iowa","Poweshiek County",1,52,200,109,91
050,19,157,"Iowa","Poweshiek County",1,53,229,111,118
050,19,157,"Iowa","Poweshiek County",1,54,236,115,121
050,19,157,"Iowa","Poweshiek County",1,55,228,105,123
050,19,157,"Iowa","Poweshiek County",1,56,240,112,128
050,19,157,"Iowa","Poweshiek County",1,57,254,118,136
050,19,157,"Iowa","Poweshiek County",1,58,258,128,130
050,19,157,"Iowa","Poweshiek County",1,59,265,133,132
050,19,157,"Iowa","Poweshiek County",1,60,291,144,147
050,19,157,"Iowa","Poweshiek County",1,61,276,127,149
050,19,157,"Iowa","Poweshiek County",1,62,259,123,136
050,19,157,"Iowa","Poweshiek County",1,63,258,127,131
050,19,157,"Iowa","Poweshiek County",1,64,268,136,132
050,19,157,"Iowa","Poweshiek County",1,65,249,119,130
050,19,157,"Iowa","Poweshiek County",1,66,245,117,128
050,19,157,"Iowa","Poweshiek County",1,67,246,125,121
050,19,157,"Iowa","Poweshiek County",1,68,217,123,94
050,19,157,"Iowa","Poweshiek County",1,69,205,95,110
050,19,157,"Iowa","Poweshiek County",1,70,201,84,117
050,19,157,"Iowa","Poweshiek County",1,71,204,92,112
050,19,157,"Iowa","Poweshiek County",1,72,202,99,103
050,19,157,"Iowa","Poweshiek County",1,73,206,107,99
050,19,157,"Iowa","Poweshiek County",1,74,146,73,73
050,19,157,"Iowa","Poweshiek County",1,75,146,69,77
050,19,157,"Iowa","Poweshiek County",1,76,137,61,76
050,19,157,"Iowa","Poweshiek County",1,77,134,58,76
050,19,157,"Iowa","Poweshiek County",1,78,130,53,77
050,19,157,"Iowa","Poweshiek County",1,79,131,53,78
050,19,157,"Iowa","Poweshiek County",1,80,116,50,66
050,19,157,"Iowa","Poweshiek County",1,81,101,42,59
050,19,157,"Iowa","Poweshiek County",1,82,97,47,50
050,19,157,"Iowa","Poweshiek County",1,83,99,39,60
050,19,157,"Iowa","Poweshiek County",1,84,90,40,50
050,19,157,"Iowa","Poweshiek County",1,85,568,196,372
050,19,157,"Iowa","Poweshiek County",2,0,157,91,66
050,19,157,"Iowa","Poweshiek County",2,1,166,88,78
050,19,157,"Iowa","Poweshiek County",2,2,179,91,88
050,19,157,"Iowa","Poweshiek County",2,3,175,95,80
050,19,157,"Iowa","Poweshiek County",2,4,193,106,87
050,19,157,"Iowa","Poweshiek County",2,5,208,111,97
050,19,157,"Iowa","Poweshiek County",2,6,203,103,100
050,19,157,"Iowa","Poweshiek County",2,7,187,89,98
050,19,157,"Iowa","Poweshiek County",2,8,193,94,99
050,19,157,"Iowa","Poweshiek County",2,9,211,107,104
050,19,157,"Iowa","Poweshiek County",2,10,236,118,118
050,19,157,"Iowa","Poweshiek County",2,11,238,114,124
050,19,157,"Iowa","Poweshiek County",2,12,233,115,118
050,19,157,"Iowa","Poweshiek County",2,13,230,109,121
050,19,157,"Iowa","Poweshiek County",2,14,226,113,113
050,19,157,"Iowa","Poweshiek County",2,15,229,121,108
050,19,157,"Iowa","Poweshiek County",2,16,220,111,109
050,19,157,"Iowa","Poweshiek County",2,17,224,109,115
050,19,157,"Iowa","Poweshiek County",2,18,341,169,172
050,19,157,"Iowa","Poweshiek County",2,19,551,265,286
050,19,157,"Iowa","Poweshiek County",2,20,567,273,294
050,19,157,"Iowa","Poweshiek County",2,21,453,238,215
050,19,157,"Iowa","Poweshiek County",2,22,349,180,169
050,19,157,"Iowa","Poweshiek County",2,23,202,102,100
050,19,157,"Iowa","Poweshiek County",2,24,194,103,91
050,19,157,"Iowa","Poweshiek County",2,25,169,93,76
050,19,157,"Iowa","Poweshiek County",2,26,171,91,80
050,19,157,"Iowa","Poweshiek County",2,27,174,90,84
050,19,157,"Iowa","Poweshiek County",2,28,170,85,85
050,19,157,"Iowa","Poweshiek County",2,29,178,93,85
050,19,157,"Iowa","Poweshiek County",2,30,201,101,100
050,19,157,"Iowa","Poweshiek County",2,31,185,89,96
050,19,157,"Iowa","Poweshiek County",2,32,173,83,90
050,19,157,"Iowa","Poweshiek County",2,33,179,85,94
050,19,157,"Iowa","Poweshiek County",2,34,196,97,99
050,19,157,"Iowa","Poweshiek County",2,35,221,106,115
050,19,157,"Iowa","Poweshiek County",2,36,217,112,105
050,19,157,"Iowa","Poweshiek County",2,37,212,112,100
050,19,157,"Iowa","Poweshiek County",2,38,213,112,101
050,19,157,"Iowa","Poweshiek County",2,39,188,91,97
050,19,157,"Iowa","Poweshiek County",2,40,190,92,98
050,19,157,"Iowa","Poweshiek County",2,41,192,107,85
050,19,157,"Iowa","Poweshiek County",2,42,204,111,93
050,19,157,"Iowa","Poweshiek County",2,43,194,101,93
050,19,157,"Iowa","Poweshiek County",2,44,194,97,97
050,19,157,"Iowa","Poweshiek County",2,45,189,87,102
050,19,157,"Iowa","Poweshiek County",2,46,173,79,94
050,19,157,"Iowa","Poweshiek County",2,47,190,92,98
050,19,157,"Iowa","Poweshiek County",2,48,200,98,102
050,19,157,"Iowa","Poweshiek County",2,49,197,103,94
050,19,157,"Iowa","Poweshiek County",2,50,194,104,90
050,19,157,"Iowa","Poweshiek County",2,51,185,103,82
050,19,157,"Iowa","Poweshiek County",2,52,197,108,89
050,19,157,"Iowa","Poweshiek County",2,53,220,109,111
050,19,157,"Iowa","Poweshiek County",2,54,234,113,121
050,19,157,"Iowa","Poweshiek County",2,55,232,108,124
050,19,157,"Iowa","Poweshiek County",2,56,238,111,127
050,19,157,"Iowa","Poweshiek County",2,57,251,117,134
050,19,157,"Iowa","Poweshiek County",2,58,258,125,133
050,19,157,"Iowa","Poweshiek County",2,59,266,133,133
050,19,157,"Iowa","Poweshiek County",2,60,284,141,143
050,19,157,"Iowa","Poweshiek County",2,61,279,130,149
050,19,157,"Iowa","Poweshiek County",2,62,262,122,140
050,19,157,"Iowa","Poweshiek County",2,63,258,125,133
050,19,157,"Iowa","Poweshiek County",2,64,261,131,130
050,19,157,"Iowa","Poweshiek County",2,65,252,123,129
050,19,157,"Iowa","Poweshiek County",2,66,244,117,127
050,19,157,"Iowa","Poweshiek County",2,67,244,123,121
050,19,157,"Iowa","Poweshiek County",2,68,221,123,98
050,19,157,"Iowa","Poweshiek County",2,69,209,101,108
050,19,157,"Iowa","Poweshiek County",2,70,201,86,115
050,19,157,"Iowa","Poweshiek County",2,71,199,89,110
050,19,157,"Iowa","Poweshiek County",2,72,200,96,104
050,19,157,"Iowa","Poweshiek County",2,73,217,111,106
050,19,157,"Iowa","Poweshiek County",2,74,150,75,75
050,19,157,"Iowa","Poweshiek County",2,75,146,71,75
050,19,157,"Iowa","Poweshiek County",2,76,137,61,76
050,19,157,"Iowa","Poweshiek County",2,77,136,59,77
050,19,157,"Iowa","Poweshiek County",2,78,127,53,74
050,19,157,"Iowa","Poweshiek County",2,79,130,52,78
050,19,157,"Iowa","Poweshiek County",2,80,118,50,68
050,19,157,"Iowa","Poweshiek County",2,81,101,44,57
050,19,157,"Iowa","Poweshiek County",2,82,95,44,51
050,19,157,"Iowa","Poweshiek County",2,83,96,40,56
050,19,157,"Iowa","Poweshiek County",2,84,93,41,52
050,19,157,"Iowa","Poweshiek County",2,85,561,190,371
050,19,157,"Iowa","Poweshiek County",3,0,183,107,76
050,19,157,"Iowa","Poweshiek County",3,1,160,85,75
050,19,157,"Iowa","Poweshiek County",3,2,176,96,80
050,19,157,"Iowa","Poweshiek County",3,3,192,95,97
050,19,157,"Iowa","Poweshiek County",3,4,166,89,77
050,19,157,"Iowa","Poweshiek County",3,5,206,110,96
050,19,157,"Iowa","Poweshiek County",3,6,202,104,98
050,19,157,"Iowa","Poweshiek County",3,7,200,95,105
050,19,157,"Iowa","Poweshiek County",3,8,191,96,95
050,19,157,"Iowa","Poweshiek County",3,9,194,92,102
050,19,157,"Iowa","Poweshiek County",3,10,212,102,110
050,19,157,"Iowa","Poweshiek County",3,11,238,116,122
050,19,157,"Iowa","Poweshiek County",3,12,229,105,124
050,19,157,"Iowa","Poweshiek County",3,13,239,117,122
050,19,157,"Iowa","Poweshiek County",3,14,237,115,122
050,19,157,"Iowa","Poweshiek County",3,15,228,113,115
050,19,157,"Iowa","Poweshiek County",3,16,215,114,101
050,19,157,"Iowa","Poweshiek County",3,17,238,122,116
050,19,157,"Iowa","Poweshiek County",3,18,341,172,169
050,19,157,"Iowa","Poweshiek County",3,19,545,256,289
050,19,157,"Iowa","Poweshiek County",3,20,565,261,304
050,19,157,"Iowa","Poweshiek County",3,21,446,223,223
050,19,157,"Iowa","Poweshiek County",3,22,341,184,157
050,19,157,"Iowa","Poweshiek County",3,23,206,107,99
050,19,157,"Iowa","Poweshiek County",3,24,188,93,95
050,19,157,"Iowa","Poweshiek County",3,25,183,102,81
050,19,157,"Iowa","Poweshiek County",3,26,177,98,79
050,19,157,"Iowa","Poweshiek County",3,27,190,100,90
050,19,157,"Iowa","Poweshiek County",3,28,173,88,85
050,19,157,"Iowa","Poweshiek County",3,29,166,82,84
050,19,157,"Iowa","Poweshiek County",3,30,181,92,89
050,19,157,"Iowa","Poweshiek County",3,31,206,98,108
050,19,157,"Iowa","Poweshiek County",3,32,186,90,96
050,19,157,"Iowa","Poweshiek County",3,33,175,88,87
050,19,157,"Iowa","Poweshiek County",3,34,181,87,94
050,19,157,"Iowa","Poweshiek County",3,35,211,106,105
050,19,157,"Iowa","Poweshiek County",3,36,216,105,111
050,19,157,"Iowa","Poweshiek County",3,37,217,113,104
050,19,157,"Iowa","Poweshiek County",3,38,213,111,102
050,19,157,"Iowa","Poweshiek County",3,39,219,110,109
050,19,157,"Iowa","Poweshiek County",3,40,189,92,97
050,19,157,"Iowa","Poweshiek County",3,41,190,88,102
050,19,157,"Iowa","Poweshiek County",3,42,189,104,85
050,19,157,"Iowa","Poweshiek County",3,43,205,114,91
050,19,157,"Iowa","Poweshiek County",3,44,195,97,98
050,19,157,"Iowa","Poweshiek County",3,45,193,95,98
050,19,157,"Iowa","Poweshiek County",3,46,183,82,101
050,19,157,"Iowa","Poweshiek County",3,47,181,82,99
050,19,157,"Iowa","Poweshiek County",3,48,187,92,95
050,19,157,"Iowa","Poweshiek County",3,49,197,96,101
050,19,157,"Iowa","Poweshiek County",3,50,201,104,97
050,19,157,"Iowa","Poweshiek County",3,51,199,105,94
050,19,157,"Iowa","Poweshiek County",3,52,191,106,85
050,19,157,"Iowa","Poweshiek County",3,53,197,108,89
050,19,157,"Iowa","Poweshiek County",3,54,224,110,114
050,19,157,"Iowa","Poweshiek County",3,55,240,113,127
050,19,157,"Iowa","Poweshiek County",3,56,221,102,119
050,19,157,"Iowa","Poweshiek County",3,57,234,109,125
050,19,157,"Iowa","Poweshiek County",3,58,252,116,136
050,19,157,"Iowa","Poweshiek County",3,59,254,124,130
050,19,157,"Iowa","Poweshiek County",3,60,267,136,131
050,19,157,"Iowa","Poweshiek County",3,61,278,137,141
050,19,157,"Iowa","Poweshiek County",3,62,270,130,140
050,19,157,"Iowa","Poweshiek County",3,63,263,123,140
050,19,157,"Iowa","Poweshiek County",3,64,256,126,130
050,19,157,"Iowa","Poweshiek County",3,65,265,127,138
050,19,157,"Iowa","Poweshiek County",3,66,236,115,121
050,19,157,"Iowa","Poweshiek County",3,67,240,117,123
050,19,157,"Iowa","Poweshiek County",3,68,240,119,121
050,19,157,"Iowa","Poweshiek County",3,69,214,117,97
050,19,157,"Iowa","Poweshiek County",3,70,203,101,102
050,19,157,"Iowa","Poweshiek County",3,71,195,88,107
050,19,157,"Iowa","Poweshiek County",3,72,199,89,110
050,19,157,"Iowa","Poweshiek County",3,73,187,89,98
050,19,157,"Iowa","Poweshiek County",3,74,209,108,101
050,19,157,"Iowa","Poweshiek County",3,75,137,71,66
050,19,157,"Iowa","Poweshiek County",3,76,141,67,74
050,19,157,"Iowa","Poweshiek County",3,77,135,59,76
050,19,157,"Iowa","Poweshiek County",3,78,130,57,73
050,19,157,"Iowa","Poweshiek County",3,79,125,52,73
050,19,157,"Iowa","Poweshiek County",3,80,126,51,75
050,19,157,"Iowa","Poweshiek County",3,81,112,48,64
050,19,157,"Iowa","Poweshiek County",3,82,95,41,54
050,19,157,"Iowa","Poweshiek County",3,83,90,39,51
050,19,157,"Iowa","Poweshiek County",3,84,97,45,52
050,19,157,"Iowa","Poweshiek County",3,85,560,192,368
050,19,157,"Iowa","Poweshiek County",4,0,187,97,90
050,19,157,"Iowa","Poweshiek County",4,1,171,102,69
050,19,157,"Iowa","Poweshiek County",4,2,167,88,79
050,19,157,"Iowa","Poweshiek County",4,3,179,93,86
050,19,157,"Iowa","Poweshiek County",4,4,191,94,97
050,19,157,"Iowa","Poweshiek County",4,5,175,100,75
050,19,157,"Iowa","Poweshiek County",4,6,201,112,89
050,19,157,"Iowa","Poweshiek County",4,7,203,104,99
050,19,157,"Iowa","Poweshiek County",4,8,198,94,104
050,19,157,"Iowa","Poweshiek County",4,9,188,89,99
050,19,157,"Iowa","Poweshiek County",4,10,189,91,98
050,19,157,"Iowa","Poweshiek County",4,11,208,99,109
050,19,157,"Iowa","Poweshiek County",4,12,231,108,123
050,19,157,"Iowa","Poweshiek County",4,13,228,112,116
050,19,157,"Iowa","Poweshiek County",4,14,232,121,111
050,19,157,"Iowa","Poweshiek County",4,15,235,111,124
050,19,157,"Iowa","Poweshiek County",4,16,223,112,111
050,19,157,"Iowa","Poweshiek County",4,17,235,127,108
050,19,157,"Iowa","Poweshiek County",4,18,343,166,177
050,19,157,"Iowa","Poweshiek County",4,19,521,247,274
050,19,157,"Iowa","Poweshiek County",4,20,565,260,305
050,19,157,"Iowa","Poweshiek County",4,21,467,233,234
050,19,157,"Iowa","Poweshiek County",4,22,340,177,163
050,19,157,"Iowa","Poweshiek County",4,23,191,107,84
050,19,157,"Iowa","Poweshiek County",4,24,175,88,87
050,19,157,"Iowa","Poweshiek County",4,25,179,79,100
050,19,157,"Iowa","Poweshiek County",4,26,179,101,78
050,19,157,"Iowa","Poweshiek County",4,27,180,100,80
050,19,157,"Iowa","Poweshiek County",4,28,188,97,91
050,19,157,"Iowa","Poweshiek County",4,29,177,90,87
050,19,157,"Iowa","Poweshiek County",4,30,176,90,86
050,19,157,"Iowa","Poweshiek County",4,31,195,97,98
050,19,157,"Iowa","Poweshiek County",4,32,219,103,116
050,19,157,"Iowa","Poweshiek County",4,33,182,87,95
050,19,157,"Iowa","Poweshiek County",4,34,170,82,88
050,19,157,"Iowa","Poweshiek County",4,35,183,88,95
050,19,157,"Iowa","Poweshiek County",4,36,205,110,95
050,19,157,"Iowa","Poweshiek County",4,37,216,106,110
050,19,157,"Iowa","Poweshiek County",4,38,220,116,104
050,19,157,"Iowa","Poweshiek County",4,39,208,106,102
050,19,157,"Iowa","Poweshiek County",4,40,225,118,107
050,19,157,"Iowa","Poweshiek County",4,41,192,97,95
050,19,157,"Iowa","Poweshiek County",4,42,183,91,92
050,19,157,"Iowa","Poweshiek County",4,43,185,102,83
050,19,157,"Iowa","Poweshiek County",4,44,193,104,89
050,19,157,"Iowa","Poweshiek County",4,45,202,102,100
050,19,157,"Iowa","Poweshiek County",4,46,190,89,101
050,19,157,"Iowa","Poweshiek County",4,47,180,77,103
050,19,157,"Iowa","Poweshiek County",4,48,180,82,98
050,19,157,"Iowa","Poweshiek County",4,49,197,96,101
050,19,157,"Iowa","Poweshiek County",4,50,198,96,102
050,19,157,"Iowa","Poweshiek County",4,51,209,105,104
050,19,157,"Iowa","Poweshiek County",4,52,212,114,98
050,19,157,"Iowa","Poweshiek County",4,53,189,108,81
050,19,157,"Iowa","Poweshiek County",4,54,194,103,91
050,19,157,"Iowa","Poweshiek County",4,55,222,112,110
050,19,157,"Iowa","Poweshiek County",4,56,234,111,123
050,19,157,"Iowa","Poweshiek County",4,57,216,98,118
050,19,157,"Iowa","Poweshiek County",4,58,234,113,121
050,19,157,"Iowa","Poweshiek County",4,59,251,118,133
050,19,157,"Iowa","Poweshiek County",4,60,248,115,133
050,19,157,"Iowa","Poweshiek County",4,61,261,131,130
050,19,157,"Iowa","Poweshiek County",4,62,278,142,136
050,19,157,"Iowa","Poweshiek County",4,63,275,131,144
050,19,157,"Iowa","Poweshiek County",4,64,261,121,140
050,19,157,"Iowa","Poweshiek County",4,65,252,124,128
050,19,157,"Iowa","Poweshiek County",4,66,262,123,139
050,19,157,"Iowa","Poweshiek County",4,67,234,115,119
050,19,157,"Iowa","Poweshiek County",4,68,244,117,127
050,19,157,"Iowa","Poweshiek County",4,69,232,115,117
050,19,157,"Iowa","Poweshiek County",4,70,213,116,97
050,19,157,"Iowa","Poweshiek County",4,71,198,98,100
050,19,157,"Iowa","Poweshiek County",4,72,188,86,102
050,19,157,"Iowa","Poweshiek County",4,73,196,87,109
050,19,157,"Iowa","Poweshiek County",4,74,173,81,92
050,19,157,"Iowa","Poweshiek County",4,75,198,107,91
050,19,157,"Iowa","Poweshiek County",4,76,130,67,63
050,19,157,"Iowa","Poweshiek County",4,77,134,61,73
050,19,157,"Iowa","Poweshiek County",4,78,130,56,74
050,19,157,"Iowa","Poweshiek County",4,79,129,55,74
050,19,157,"Iowa","Poweshiek County",4,80,115,49,66
050,19,157,"Iowa","Poweshiek County",4,81,113,42,71
050,19,157,"Iowa","Poweshiek County",4,82,107,46,61
050,19,157,"Iowa","Poweshiek County",4,83,88,34,54
050,19,157,"Iowa","Poweshiek County",4,84,88,42,46
050,19,157,"Iowa","Poweshiek County",4,85,565,201,364
050,19,157,"Iowa","Poweshiek County",5,0,190,101,89
050,19,157,"Iowa","Poweshiek County",5,1,181,91,90
050,19,157,"Iowa","Poweshiek County",5,2,166,98,68
050,19,157,"Iowa","Poweshiek County",5,3,169,87,82
050,19,157,"Iowa","Poweshiek County",5,4,170,88,82
050,19,157,"Iowa","Poweshiek County",5,5,194,95,99
050,19,157,"Iowa","Poweshiek County",5,6,168,100,68
050,19,157,"Iowa","Poweshiek County",5,7,194,108,86
050,19,157,"Iowa","Poweshiek County",5,8,198,102,96
050,19,157,"Iowa","Poweshiek County",5,9,197,95,102
050,19,157,"Iowa","Poweshiek County",5,10,182,89,93
050,19,157,"Iowa","Poweshiek County",5,11,196,93,103
050,19,157,"Iowa","Poweshiek County",5,12,214,105,109
050,19,157,"Iowa","Poweshiek County",5,13,229,106,123
050,19,157,"Iowa","Poweshiek County",5,14,240,119,121
050,19,157,"Iowa","Poweshiek County",5,15,224,116,108
050,19,157,"Iowa","Poweshiek County",5,16,237,115,122
050,19,157,"Iowa","Poweshiek County",5,17,232,115,117
050,19,157,"Iowa","Poweshiek County",5,18,344,171,173
050,19,157,"Iowa","Poweshiek County",5,19,536,253,283
050,19,157,"Iowa","Poweshiek County",5,20,540,247,293
050,19,157,"Iowa","Poweshiek County",5,21,454,219,235
050,19,157,"Iowa","Poweshiek County",5,22,370,183,187
050,19,157,"Iowa","Poweshiek County",5,23,201,113,88
050,19,157,"Iowa","Poweshiek County",5,24,178,93,85
050,19,157,"Iowa","Poweshiek County",5,25,171,92,79
050,19,157,"Iowa","Poweshiek County",5,26,163,76,87
050,19,157,"Iowa","Poweshiek County",5,27,176,95,81
050,19,157,"Iowa","Poweshiek County",5,28,190,105,85
050,19,157,"Iowa","Poweshiek County",5,29,184,98,86
050,19,157,"Iowa","Poweshiek County",5,30,183,99,84
050,19,157,"Iowa","Poweshiek County",5,31,180,86,94
050,19,157,"Iowa","Poweshiek County",5,32,215,105,110
050,19,157,"Iowa","Poweshiek County",5,33,205,97,108
050,19,157,"Iowa","Poweshiek County",5,34,195,96,99
050,19,157,"Iowa","Poweshiek County",5,35,165,79,86
050,19,157,"Iowa","Poweshiek County",5,36,176,83,93
050,19,157,"Iowa","Poweshiek County",5,37,195,106,89
050,19,157,"Iowa","Poweshiek County",5,38,218,109,109
050,19,157,"Iowa","Poweshiek County",5,39,205,103,102
050,19,157,"Iowa","Poweshiek County",5,40,208,101,107
050,19,157,"Iowa","Poweshiek County",5,41,224,117,107
050,19,157,"Iowa","Poweshiek County",5,42,195,97,98
050,19,157,"Iowa","Poweshiek County",5,43,184,93,91
050,19,157,"Iowa","Poweshiek County",5,44,192,104,88
050,19,157,"Iowa","Poweshiek County",5,45,191,106,85
050,19,157,"Iowa","Poweshiek County",5,46,203,99,104
050,19,157,"Iowa","Poweshiek County",5,47,194,94,100
050,19,157,"Iowa","Poweshiek County",5,48,179,81,98
050,19,157,"Iowa","Poweshiek County",5,49,182,86,96
050,19,157,"Iowa","Poweshiek County",5,50,203,99,104
050,19,157,"Iowa","Poweshiek County",5,51,195,92,103
050,19,157,"Iowa","Poweshiek County",5,52,220,108,112
050,19,157,"Iowa","Poweshiek County",5,53,213,113,100
050,19,157,"Iowa","Poweshiek County",5,54,201,115,86
050,19,157,"Iowa","Poweshiek County",5,55,194,104,90
050,19,157,"Iowa","Poweshiek County",5,56,215,107,108
050,19,157,"Iowa","Poweshiek County",5,57,234,110,124
050,19,157,"Iowa","Poweshiek County",5,58,214,96,118
050,19,157,"Iowa","Poweshiek County",5,59,240,116,124
050,19,157,"Iowa","Poweshiek County",5,60,247,116,131
050,19,157,"Iowa","Poweshiek County",5,61,247,115,132
050,19,157,"Iowa","Poweshiek County",5,62,260,131,129
050,19,157,"Iowa","Poweshiek County",5,63,279,142,137
050,19,157,"Iowa","Poweshiek County",5,64,271,130,141
050,19,157,"Iowa","Poweshiek County",5,65,261,119,142
050,19,157,"Iowa","Poweshiek County",5,66,244,120,124
050,19,157,"Iowa","Poweshiek County",5,67,262,122,140
050,19,157,"Iowa","Poweshiek County",5,68,234,116,118
050,19,157,"Iowa","Poweshiek County",5,69,233,108,125
050,19,157,"Iowa","Poweshiek County",5,70,222,113,109
050,19,157,"Iowa","Poweshiek County",5,71,210,113,97
050,19,157,"Iowa","Poweshiek County",5,72,195,95,100
050,19,157,"Iowa","Poweshiek County",5,73,179,81,98
050,19,157,"Iowa","Poweshiek County",5,74,189,86,103
050,19,157,"Iowa","Poweshiek County",5,75,162,78,84
050,19,157,"Iowa","Poweshiek County",5,76,184,99,85
050,19,157,"Iowa","Poweshiek County",5,77,122,61,61
050,19,157,"Iowa","Poweshiek County",5,78,126,59,67
050,19,157,"Iowa","Poweshiek County",5,79,129,53,76
050,19,157,"Iowa","Poweshiek County",5,80,125,53,72
050,19,157,"Iowa","Poweshiek County",5,81,107,41,66
050,19,157,"Iowa","Poweshiek County",5,82,105,38,67
050,19,157,"Iowa","Poweshiek County",5,83,102,41,61
050,19,157,"Iowa","Poweshiek County",5,84,89,37,52
050,19,157,"Iowa","Poweshiek County",5,85,563,203,360
050,19,159,"Iowa","Ringgold County",1,0,47,25,22
050,19,159,"Iowa","Ringgold County",1,1,47,28,19
050,19,159,"Iowa","Ringgold County",1,2,49,31,18
050,19,159,"Iowa","Ringgold County",1,3,58,37,21
050,19,159,"Iowa","Ringgold County",1,4,66,32,34
050,19,159,"Iowa","Ringgold County",1,5,56,37,19
050,19,159,"Iowa","Ringgold County",1,6,51,27,24
050,19,159,"Iowa","Ringgold County",1,7,56,26,30
050,19,159,"Iowa","Ringgold County",1,8,54,28,26
050,19,159,"Iowa","Ringgold County",1,9,48,23,25
050,19,159,"Iowa","Ringgold County",1,10,69,38,31
050,19,159,"Iowa","Ringgold County",1,11,70,36,34
050,19,159,"Iowa","Ringgold County",1,12,62,29,33
050,19,159,"Iowa","Ringgold County",1,13,73,38,35
050,19,159,"Iowa","Ringgold County",1,14,79,45,34
050,19,159,"Iowa","Ringgold County",1,15,77,40,37
050,19,159,"Iowa","Ringgold County",1,16,67,32,35
050,19,159,"Iowa","Ringgold County",1,17,65,29,36
050,19,159,"Iowa","Ringgold County",1,18,65,36,29
050,19,159,"Iowa","Ringgold County",1,19,49,25,24
050,19,159,"Iowa","Ringgold County",1,20,53,27,26
050,19,159,"Iowa","Ringgold County",1,21,42,17,25
050,19,159,"Iowa","Ringgold County",1,22,49,24,25
050,19,159,"Iowa","Ringgold County",1,23,50,29,21
050,19,159,"Iowa","Ringgold County",1,24,48,28,20
050,19,159,"Iowa","Ringgold County",1,25,33,16,17
050,19,159,"Iowa","Ringgold County",1,26,35,17,18
050,19,159,"Iowa","Ringgold County",1,27,32,13,19
050,19,159,"Iowa","Ringgold County",1,28,31,13,18
050,19,159,"Iowa","Ringgold County",1,29,40,18,22
050,19,159,"Iowa","Ringgold County",1,30,38,22,16
050,19,159,"Iowa","Ringgold County",1,31,44,21,23
050,19,159,"Iowa","Ringgold County",1,32,47,20,27
050,19,159,"Iowa","Ringgold County",1,33,51,24,27
050,19,159,"Iowa","Ringgold County",1,34,51,27,24
050,19,159,"Iowa","Ringgold County",1,35,55,28,27
050,19,159,"Iowa","Ringgold County",1,36,52,28,24
050,19,159,"Iowa","Ringgold County",1,37,60,34,26
050,19,159,"Iowa","Ringgold County",1,38,66,37,29
050,19,159,"Iowa","Ringgold County",1,39,47,25,22
050,19,159,"Iowa","Ringgold County",1,40,42,17,25
050,19,159,"Iowa","Ringgold County",1,41,53,29,24
050,19,159,"Iowa","Ringgold County",1,42,54,32,22
050,19,159,"Iowa","Ringgold County",1,43,42,24,18
050,19,159,"Iowa","Ringgold County",1,44,55,26,29
050,19,159,"Iowa","Ringgold County",1,45,45,23,22
050,19,159,"Iowa","Ringgold County",1,46,40,20,20
050,19,159,"Iowa","Ringgold County",1,47,42,21,21
050,19,159,"Iowa","Ringgold County",1,48,44,21,23
050,19,159,"Iowa","Ringgold County",1,49,52,30,22
050,19,159,"Iowa","Ringgold County",1,50,46,24,22
050,19,159,"Iowa","Ringgold County",1,51,49,21,28
050,19,159,"Iowa","Ringgold County",1,52,48,23,25
050,19,159,"Iowa","Ringgold County",1,53,60,34,26
050,19,159,"Iowa","Ringgold County",1,54,55,28,27
050,19,159,"Iowa","Ringgold County",1,55,65,29,36
050,19,159,"Iowa","Ringgold County",1,56,71,35,36
050,19,159,"Iowa","Ringgold County",1,57,69,38,31
050,19,159,"Iowa","Ringgold County",1,58,79,38,41
050,19,159,"Iowa","Ringgold County",1,59,64,29,35
050,19,159,"Iowa","Ringgold County",1,60,71,34,37
050,19,159,"Iowa","Ringgold County",1,61,71,34,37
050,19,159,"Iowa","Ringgold County",1,62,92,41,51
050,19,159,"Iowa","Ringgold County",1,63,83,44,39
050,19,159,"Iowa","Ringgold County",1,64,72,41,31
050,19,159,"Iowa","Ringgold County",1,65,57,29,28
050,19,159,"Iowa","Ringgold County",1,66,62,34,28
050,19,159,"Iowa","Ringgold County",1,67,57,30,27
050,19,159,"Iowa","Ringgold County",1,68,65,29,36
050,19,159,"Iowa","Ringgold County",1,69,59,34,25
050,19,159,"Iowa","Ringgold County",1,70,56,31,25
050,19,159,"Iowa","Ringgold County",1,71,56,27,29
050,19,159,"Iowa","Ringgold County",1,72,56,28,28
050,19,159,"Iowa","Ringgold County",1,73,59,29,30
050,19,159,"Iowa","Ringgold County",1,74,40,20,20
050,19,159,"Iowa","Ringgold County",1,75,41,19,22
050,19,159,"Iowa","Ringgold County",1,76,36,15,21
050,19,159,"Iowa","Ringgold County",1,77,37,16,21
050,19,159,"Iowa","Ringgold County",1,78,37,17,20
050,19,159,"Iowa","Ringgold County",1,79,33,17,16
050,19,159,"Iowa","Ringgold County",1,80,29,14,15
050,19,159,"Iowa","Ringgold County",1,81,30,14,16
050,19,159,"Iowa","Ringgold County",1,82,29,10,19
050,19,159,"Iowa","Ringgold County",1,83,27,10,17
050,19,159,"Iowa","Ringgold County",1,84,18,8,10
050,19,159,"Iowa","Ringgold County",1,85,180,49,131
050,19,159,"Iowa","Ringgold County",2,0,50,27,23
050,19,159,"Iowa","Ringgold County",2,1,48,28,20
050,19,159,"Iowa","Ringgold County",2,2,48,30,18
050,19,159,"Iowa","Ringgold County",2,3,56,35,21
050,19,159,"Iowa","Ringgold County",2,4,64,33,31
050,19,159,"Iowa","Ringgold County",2,5,58,35,23
050,19,159,"Iowa","Ringgold County",2,6,52,29,23
050,19,159,"Iowa","Ringgold County",2,7,55,27,28
050,19,159,"Iowa","Ringgold County",2,8,53,26,27
050,19,159,"Iowa","Ringgold County",2,9,49,24,25
050,19,159,"Iowa","Ringgold County",2,10,65,35,30
050,19,159,"Iowa","Ringgold County",2,11,71,37,34
050,19,159,"Iowa","Ringgold County",2,12,64,31,33
050,19,159,"Iowa","Ringgold County",2,13,71,37,34
050,19,159,"Iowa","Ringgold County",2,14,77,43,34
050,19,159,"Iowa","Ringgold County",2,15,77,41,36
050,19,159,"Iowa","Ringgold County",2,16,69,34,35
050,19,159,"Iowa","Ringgold County",2,17,66,30,36
050,19,159,"Iowa","Ringgold County",2,18,61,33,28
050,19,159,"Iowa","Ringgold County",2,19,50,26,24
050,19,159,"Iowa","Ringgold County",2,20,53,27,26
050,19,159,"Iowa","Ringgold County",2,21,44,19,25
050,19,159,"Iowa","Ringgold County",2,22,48,23,25
050,19,159,"Iowa","Ringgold County",2,23,50,29,21
050,19,159,"Iowa","Ringgold County",2,24,47,27,20
050,19,159,"Iowa","Ringgold County",2,25,36,19,17
050,19,159,"Iowa","Ringgold County",2,26,34,16,18
050,19,159,"Iowa","Ringgold County",2,27,31,13,18
050,19,159,"Iowa","Ringgold County",2,28,31,13,18
050,19,159,"Iowa","Ringgold County",2,29,38,17,21
050,19,159,"Iowa","Ringgold County",2,30,40,22,18
050,19,159,"Iowa","Ringgold County",2,31,43,21,22
050,19,159,"Iowa","Ringgold County",2,32,47,20,27
050,19,159,"Iowa","Ringgold County",2,33,49,23,26
050,19,159,"Iowa","Ringgold County",2,34,51,26,25
050,19,159,"Iowa","Ringgold County",2,35,54,28,26
050,19,159,"Iowa","Ringgold County",2,36,52,27,25
050,19,159,"Iowa","Ringgold County",2,37,57,32,25
050,19,159,"Iowa","Ringgold County",2,38,63,35,28
050,19,159,"Iowa","Ringgold County",2,39,51,27,24
050,19,159,"Iowa","Ringgold County",2,40,44,19,25
050,19,159,"Iowa","Ringgold County",2,41,51,26,25
050,19,159,"Iowa","Ringgold County",2,42,53,31,22
050,19,159,"Iowa","Ringgold County",2,43,45,27,18
050,19,159,"Iowa","Ringgold County",2,44,51,25,26
050,19,159,"Iowa","Ringgold County",2,45,47,23,24
050,19,159,"Iowa","Ringgold County",2,46,41,21,20
050,19,159,"Iowa","Ringgold County",2,47,41,20,21
050,19,159,"Iowa","Ringgold County",2,48,43,21,22
050,19,159,"Iowa","Ringgold County",2,49,50,27,23
050,19,159,"Iowa","Ringgold County",2,50,47,25,22
050,19,159,"Iowa","Ringgold County",2,51,48,22,26
050,19,159,"Iowa","Ringgold County",2,52,48,22,26
050,19,159,"Iowa","Ringgold County",2,53,58,32,26
050,19,159,"Iowa","Ringgold County",2,54,56,29,27
050,19,159,"Iowa","Ringgold County",2,55,62,28,34
050,19,159,"Iowa","Ringgold County",2,56,70,34,36
050,19,159,"Iowa","Ringgold County",2,57,70,38,32
050,19,159,"Iowa","Ringgold County",2,58,77,38,39
050,19,159,"Iowa","Ringgold County",2,59,66,29,37
050,19,159,"Iowa","Ringgold County",2,60,68,33,35
050,19,159,"Iowa","Ringgold County",2,61,71,34,37
050,19,159,"Iowa","Ringgold County",2,62,87,39,48
050,19,159,"Iowa","Ringgold County",2,63,86,44,42
050,19,159,"Iowa","Ringgold County",2,64,75,42,33
050,19,159,"Iowa","Ringgold County",2,65,59,32,27
050,19,159,"Iowa","Ringgold County",2,66,60,32,28
050,19,159,"Iowa","Ringgold County",2,67,59,32,27
050,19,159,"Iowa","Ringgold County",2,68,62,29,33
050,19,159,"Iowa","Ringgold County",2,69,61,33,28
050,19,159,"Iowa","Ringgold County",2,70,54,30,24
050,19,159,"Iowa","Ringgold County",2,71,54,27,27
050,19,159,"Iowa","Ringgold County",2,72,54,27,27
050,19,159,"Iowa","Ringgold County",2,73,62,31,31
050,19,159,"Iowa","Ringgold County",2,74,40,20,20
050,19,159,"Iowa","Ringgold County",2,75,41,19,22
050,19,159,"Iowa","Ringgold County",2,76,36,15,21
050,19,159,"Iowa","Ringgold County",2,77,38,16,22
050,19,159,"Iowa","Ringgold County",2,78,36,16,20
050,19,159,"Iowa","Ringgold County",2,79,32,16,16
050,19,159,"Iowa","Ringgold County",2,80,30,14,16
050,19,159,"Iowa","Ringgold County",2,81,31,15,16
050,19,159,"Iowa","Ringgold County",2,82,30,11,19
050,19,159,"Iowa","Ringgold County",2,83,27,10,17
050,19,159,"Iowa","Ringgold County",2,84,19,8,11
050,19,159,"Iowa","Ringgold County",2,85,176,48,128
050,19,159,"Iowa","Ringgold County",3,0,49,29,20
050,19,159,"Iowa","Ringgold County",3,1,64,34,30
050,19,159,"Iowa","Ringgold County",3,2,46,27,19
050,19,159,"Iowa","Ringgold County",3,3,45,29,16
050,19,159,"Iowa","Ringgold County",3,4,59,35,24
050,19,159,"Iowa","Ringgold County",3,5,62,36,26
050,19,159,"Iowa","Ringgold County",3,6,60,36,24
050,19,159,"Iowa","Ringgold County",3,7,46,31,15
050,19,159,"Iowa","Ringgold County",3,8,55,26,29
050,19,159,"Iowa","Ringgold County",3,9,49,26,23
050,19,159,"Iowa","Ringgold County",3,10,50,26,24
050,19,159,"Iowa","Ringgold County",3,11,66,35,31
050,19,159,"Iowa","Ringgold County",3,12,66,31,35
050,19,159,"Iowa","Ringgold County",3,13,60,29,31
050,19,159,"Iowa","Ringgold County",3,14,72,37,35
050,19,159,"Iowa","Ringgold County",3,15,73,38,35
050,19,159,"Iowa","Ringgold County",3,16,75,41,34
050,19,159,"Iowa","Ringgold County",3,17,70,35,35
050,19,159,"Iowa","Ringgold County",3,18,60,30,30
050,19,159,"Iowa","Ringgold County",3,19,51,26,25
050,19,159,"Iowa","Ringgold County",3,20,54,30,24
050,19,159,"Iowa","Ringgold County",3,21,55,29,26
050,19,159,"Iowa","Ringgold County",3,22,42,15,27
050,19,159,"Iowa","Ringgold County",3,23,47,29,18
050,19,159,"Iowa","Ringgold County",3,24,57,32,25
050,19,159,"Iowa","Ringgold County",3,25,48,26,22
050,19,159,"Iowa","Ringgold County",3,26,35,17,18
050,19,159,"Iowa","Ringgold County",3,27,34,15,19
050,19,159,"Iowa","Ringgold County",3,28,30,11,19
050,19,159,"Iowa","Ringgold County",3,29,41,20,21
050,19,159,"Iowa","Ringgold County",3,30,44,22,22
050,19,159,"Iowa","Ringgold County",3,31,41,24,17
050,19,159,"Iowa","Ringgold County",3,32,43,19,24
050,19,159,"Iowa","Ringgold County",3,33,51,21,30
050,19,159,"Iowa","Ringgold County",3,34,52,25,27
050,19,159,"Iowa","Ringgold County",3,35,54,27,27
050,19,159,"Iowa","Ringgold County",3,36,54,29,25
050,19,159,"Iowa","Ringgold County",3,37,54,28,26
050,19,159,"Iowa","Ringgold County",3,38,55,30,25
050,19,159,"Iowa","Ringgold County",3,39,62,36,26
050,19,159,"Iowa","Ringgold County",3,40,51,26,25
050,19,159,"Iowa","Ringgold County",3,41,47,19,28
050,19,159,"Iowa","Ringgold County",3,42,47,26,21
050,19,159,"Iowa","Ringgold County",3,43,53,30,23
050,19,159,"Iowa","Ringgold County",3,44,49,27,22
050,19,159,"Iowa","Ringgold County",3,45,52,28,24
050,19,159,"Iowa","Ringgold County",3,46,48,25,23
050,19,159,"Iowa","Ringgold County",3,47,48,23,25
050,19,159,"Iowa","Ringgold County",3,48,43,23,20
050,19,159,"Iowa","Ringgold County",3,49,43,23,20
050,19,159,"Iowa","Ringgold County",3,50,49,27,22
050,19,159,"Iowa","Ringgold County",3,51,46,25,21
050,19,159,"Iowa","Ringgold County",3,52,42,19,23
050,19,159,"Iowa","Ringgold County",3,53,47,23,24
050,19,159,"Iowa","Ringgold County",3,54,59,33,26
050,19,159,"Iowa","Ringgold County",3,55,56,28,28
050,19,159,"Iowa","Ringgold County",3,56,60,26,34
050,19,159,"Iowa","Ringgold County",3,57,68,32,36
050,19,159,"Iowa","Ringgold County",3,58,72,39,33
050,19,159,"Iowa","Ringgold County",3,59,74,36,38
050,19,159,"Iowa","Ringgold County",3,60,74,33,41
050,19,159,"Iowa","Ringgold County",3,61,68,34,34
050,19,159,"Iowa","Ringgold County",3,62,72,36,36
050,19,159,"Iowa","Ringgold County",3,63,85,36,49
050,19,159,"Iowa","Ringgold County",3,64,88,45,43
050,19,159,"Iowa","Ringgold County",3,65,71,40,31
050,19,159,"Iowa","Ringgold County",3,66,60,32,28
050,19,159,"Iowa","Ringgold County",3,67,61,34,27
050,19,159,"Iowa","Ringgold County",3,68,57,31,26
050,19,159,"Iowa","Ringgold County",3,69,61,29,32
050,19,159,"Iowa","Ringgold County",3,70,62,33,29
050,19,159,"Iowa","Ringgold County",3,71,50,28,22
050,19,159,"Iowa","Ringgold County",3,72,53,27,26
050,19,159,"Iowa","Ringgold County",3,73,53,27,26
050,19,159,"Iowa","Ringgold County",3,74,57,29,28
050,19,159,"Iowa","Ringgold County",3,75,40,21,19
050,19,159,"Iowa","Ringgold County",3,76,37,17,20
050,19,159,"Iowa","Ringgold County",3,77,34,14,20
050,19,159,"Iowa","Ringgold County",3,78,34,13,21
050,19,159,"Iowa","Ringgold County",3,79,34,16,18
050,19,159,"Iowa","Ringgold County",3,80,31,13,18
050,19,159,"Iowa","Ringgold County",3,81,23,13,10
050,19,159,"Iowa","Ringgold County",3,82,31,12,19
050,19,159,"Iowa","Ringgold County",3,83,25,10,15
050,19,159,"Iowa","Ringgold County",3,84,21,10,11
050,19,159,"Iowa","Ringgold County",3,85,165,46,119
050,19,159,"Iowa","Ringgold County",4,0,42,24,18
050,19,159,"Iowa","Ringgold County",4,1,54,31,23
050,19,159,"Iowa","Ringgold County",4,2,70,38,32
050,19,159,"Iowa","Ringgold County",4,3,55,31,24
050,19,159,"Iowa","Ringgold County",4,4,59,33,26
050,19,159,"Iowa","Ringgold County",4,5,60,36,24
050,19,159,"Iowa","Ringgold County",4,6,66,39,27
050,19,159,"Iowa","Ringgold County",4,7,66,40,26
050,19,159,"Iowa","Ringgold County",4,8,46,32,14
050,19,159,"Iowa","Ringgold County",4,9,59,27,32
050,19,159,"Iowa","Ringgold County",4,10,52,25,27
050,19,159,"Iowa","Ringgold County",4,11,55,28,27
050,19,159,"Iowa","Ringgold County",4,12,67,38,29
050,19,159,"Iowa","Ringgold County",4,13,69,31,38
050,19,159,"Iowa","Ringgold County",4,14,57,32,25
050,19,159,"Iowa","Ringgold County",4,15,74,38,36
050,19,159,"Iowa","Ringgold County",4,16,75,40,35
050,19,159,"Iowa","Ringgold County",4,17,73,39,34
050,19,159,"Iowa","Ringgold County",4,18,56,31,25
050,19,159,"Iowa","Ringgold County",4,19,44,22,22
050,19,159,"Iowa","Ringgold County",4,20,49,26,23
050,19,159,"Iowa","Ringgold County",4,21,54,26,28
050,19,159,"Iowa","Ringgold County",4,22,54,27,27
050,19,159,"Iowa","Ringgold County",4,23,41,15,26
050,19,159,"Iowa","Ringgold County",4,24,46,28,18
050,19,159,"Iowa","Ringgold County",4,25,51,28,23
050,19,159,"Iowa","Ringgold County",4,26,49,26,23
050,19,159,"Iowa","Ringgold County",4,27,39,16,23
050,19,159,"Iowa","Ringgold County",4,28,29,13,16
050,19,159,"Iowa","Ringgold County",4,29,32,11,21
050,19,159,"Iowa","Ringgold County",4,30,52,23,29
050,19,159,"Iowa","Ringgold County",4,31,45,21,24
050,19,159,"Iowa","Ringgold County",4,32,42,24,18
050,19,159,"Iowa","Ringgold County",4,33,41,19,22
050,19,159,"Iowa","Ringgold County",4,34,52,22,30
050,19,159,"Iowa","Ringgold County",4,35,57,29,28
050,19,159,"Iowa","Ringgold County",4,36,53,24,29
050,19,159,"Iowa","Ringgold County",4,37,56,31,25
050,19,159,"Iowa","Ringgold County",4,38,58,32,26
050,19,159,"Iowa","Ringgold County",4,39,62,32,30
050,19,159,"Iowa","Ringgold County",4,40,65,38,27
050,19,159,"Iowa","Ringgold County",4,41,52,26,26
050,19,159,"Iowa","Ringgold County",4,42,45,17,28
050,19,159,"Iowa","Ringgold County",4,43,46,26,20
050,19,159,"Iowa","Ringgold County",4,44,59,31,28
050,19,159,"Iowa","Ringgold County",4,45,53,28,25
050,19,159,"Iowa","Ringgold County",4,46,55,29,26
050,19,159,"Iowa","Ringgold County",4,47,54,27,27
050,19,159,"Iowa","Ringgold County",4,48,48,23,25
050,19,159,"Iowa","Ringgold County",4,49,43,22,21
050,19,159,"Iowa","Ringgold County",4,50,44,24,20
050,19,159,"Iowa","Ringgold County",4,51,49,28,21
050,19,159,"Iowa","Ringgold County",4,52,48,24,24
050,19,159,"Iowa","Ringgold County",4,53,46,23,23
050,19,159,"Iowa","Ringgold County",4,54,52,25,27
050,19,159,"Iowa","Ringgold County",4,55,62,32,30
050,19,159,"Iowa","Ringgold County",4,56,56,27,29
050,19,159,"Iowa","Ringgold County",4,57,53,20,33
050,19,159,"Iowa","Ringgold County",4,58,68,32,36
050,19,159,"Iowa","Ringgold County",4,59,69,36,33
050,19,159,"Iowa","Ringgold County",4,60,72,37,35
050,19,159,"Iowa","Ringgold County",4,61,75,33,42
050,19,159,"Iowa","Ringgold County",4,62,73,35,38
050,19,159,"Iowa","Ringgold County",4,63,74,38,36
050,19,159,"Iowa","Ringgold County",4,64,85,36,49
050,19,159,"Iowa","Ringgold County",4,65,84,43,41
050,19,159,"Iowa","Ringgold County",4,66,69,39,30
050,19,159,"Iowa","Ringgold County",4,67,56,30,26
050,19,159,"Iowa","Ringgold County",4,68,63,36,27
050,19,159,"Iowa","Ringgold County",4,69,57,30,27
050,19,159,"Iowa","Ringgold County",4,70,61,28,33
050,19,159,"Iowa","Ringgold County",4,71,59,33,26
050,19,159,"Iowa","Ringgold County",4,72,47,27,20
050,19,159,"Iowa","Ringgold County",4,73,54,28,26
050,19,159,"Iowa","Ringgold County",4,74,51,27,24
050,19,159,"Iowa","Ringgold County",4,75,53,27,26
050,19,159,"Iowa","Ringgold County",4,76,36,19,17
050,19,159,"Iowa","Ringgold County",4,77,32,13,19
050,19,159,"Iowa","Ringgold County",4,78,33,12,21
050,19,159,"Iowa","Ringgold County",4,79,33,14,19
050,19,159,"Iowa","Ringgold County",4,80,34,13,21
050,19,159,"Iowa","Ringgold County",4,81,27,14,13
050,19,159,"Iowa","Ringgold County",4,82,22,11,11
050,19,159,"Iowa","Ringgold County",4,83,30,11,19
050,19,159,"Iowa","Ringgold County",4,84,21,10,11
050,19,159,"Iowa","Ringgold County",4,85,159,44,115
050,19,159,"Iowa","Ringgold County",5,0,43,26,17
050,19,159,"Iowa","Ringgold County",5,1,46,29,17
050,19,159,"Iowa","Ringgold County",5,2,53,29,24
050,19,159,"Iowa","Ringgold County",5,3,67,35,32
050,19,159,"Iowa","Ringgold County",5,4,51,31,20
050,19,159,"Iowa","Ringgold County",5,5,56,31,25
050,19,159,"Iowa","Ringgold County",5,6,66,38,28
050,19,159,"Iowa","Ringgold County",5,7,67,38,29
050,19,159,"Iowa","Ringgold County",5,8,65,33,32
050,19,159,"Iowa","Ringgold County",5,9,49,35,14
050,19,159,"Iowa","Ringgold County",5,10,63,28,35
050,19,159,"Iowa","Ringgold County",5,11,51,22,29
050,19,159,"Iowa","Ringgold County",5,12,55,29,26
050,19,159,"Iowa","Ringgold County",5,13,64,37,27
050,19,159,"Iowa","Ringgold County",5,14,66,29,37
050,19,159,"Iowa","Ringgold County",5,15,62,33,29
050,19,159,"Iowa","Ringgold County",5,16,72,36,36
050,19,159,"Iowa","Ringgold County",5,17,69,38,31
050,19,159,"Iowa","Ringgold County",5,18,58,34,24
050,19,159,"Iowa","Ringgold County",5,19,39,22,17
050,19,159,"Iowa","Ringgold County",5,20,44,23,21
050,19,159,"Iowa","Ringgold County",5,21,54,27,27
050,19,159,"Iowa","Ringgold County",5,22,54,24,30
050,19,159,"Iowa","Ringgold County",5,23,59,31,28
050,19,159,"Iowa","Ringgold County",5,24,40,15,25
050,19,159,"Iowa","Ringgold County",5,25,36,24,12
050,19,159,"Iowa","Ringgold County",5,26,43,24,19
050,19,159,"Iowa","Ringgold County",5,27,45,28,17
050,19,159,"Iowa","Ringgold County",5,28,34,13,21
050,19,159,"Iowa","Ringgold County",5,29,28,13,15
050,19,159,"Iowa","Ringgold County",5,30,36,12,24
050,19,159,"Iowa","Ringgold County",5,31,50,20,30
050,19,159,"Iowa","Ringgold County",5,32,50,25,25
050,19,159,"Iowa","Ringgold County",5,33,39,20,19
050,19,159,"Iowa","Ringgold County",5,34,45,18,27
050,19,159,"Iowa","Ringgold County",5,35,55,25,30
050,19,159,"Iowa","Ringgold County",5,36,57,30,27
050,19,159,"Iowa","Ringgold County",5,37,56,27,29
050,19,159,"Iowa","Ringgold County",5,38,57,31,26
050,19,159,"Iowa","Ringgold County",5,39,59,32,27
050,19,159,"Iowa","Ringgold County",5,40,60,30,30
050,19,159,"Iowa","Ringgold County",5,41,67,40,27
050,19,159,"Iowa","Ringgold County",5,42,51,25,26
050,19,159,"Iowa","Ringgold County",5,43,43,16,27
050,19,159,"Iowa","Ringgold County",5,44,47,26,21
050,19,159,"Iowa","Ringgold County",5,45,58,32,26
050,19,159,"Iowa","Ringgold County",5,46,49,26,23
050,19,159,"Iowa","Ringgold County",5,47,55,30,25
050,19,159,"Iowa","Ringgold County",5,48,55,29,26
050,19,159,"Iowa","Ringgold County",5,49,49,23,26
050,19,159,"Iowa","Ringgold County",5,50,41,22,19
050,19,159,"Iowa","Ringgold County",5,51,47,27,20
050,19,159,"Iowa","Ringgold County",5,52,49,27,22
050,19,159,"Iowa","Ringgold County",5,53,50,26,24
050,19,159,"Iowa","Ringgold County",5,54,45,23,22
050,19,159,"Iowa","Ringgold County",5,55,52,24,28
050,19,159,"Iowa","Ringgold County",5,56,61,31,30
050,19,159,"Iowa","Ringgold County",5,57,56,28,28
050,19,159,"Iowa","Ringgold County",5,58,53,19,34
050,19,159,"Iowa","Ringgold County",5,59,67,29,38
050,19,159,"Iowa","Ringgold County",5,60,73,38,35
050,19,159,"Iowa","Ringgold County",5,61,73,35,38
050,19,159,"Iowa","Ringgold County",5,62,74,34,40
050,19,159,"Iowa","Ringgold County",5,63,73,37,36
050,19,159,"Iowa","Ringgold County",5,64,75,38,37
050,19,159,"Iowa","Ringgold County",5,65,89,39,50
050,19,159,"Iowa","Ringgold County",5,66,83,41,42
050,19,159,"Iowa","Ringgold County",5,67,64,38,26
050,19,159,"Iowa","Ringgold County",5,68,58,31,27
050,19,159,"Iowa","Ringgold County",5,69,58,34,24
050,19,159,"Iowa","Ringgold County",5,70,58,29,29
050,19,159,"Iowa","Ringgold County",5,71,62,31,31
050,19,159,"Iowa","Ringgold County",5,72,56,31,25
050,19,159,"Iowa","Ringgold County",5,73,46,25,21
050,19,159,"Iowa","Ringgold County",5,74,49,26,23
050,19,159,"Iowa","Ringgold County",5,75,48,26,22
050,19,159,"Iowa","Ringgold County",5,76,47,25,22
050,19,159,"Iowa","Ringgold County",5,77,35,18,17
050,19,159,"Iowa","Ringgold County",5,78,31,11,20
050,19,159,"Iowa","Ringgold County",5,79,32,13,19
050,19,159,"Iowa","Ringgold County",5,80,32,10,22
050,19,159,"Iowa","Ringgold County",5,81,29,12,17
050,19,159,"Iowa","Ringgold County",5,82,26,12,14
050,19,159,"Iowa","Ringgold County",5,83,21,10,11
050,19,159,"Iowa","Ringgold County",5,84,26,12,14
050,19,159,"Iowa","Ringgold County",5,85,166,47,119
050,19,161,"Iowa","Sac County",1,0,111,58,53
050,19,161,"Iowa","Sac County",1,1,116,61,55
050,19,161,"Iowa","Sac County",1,2,112,60,52
050,19,161,"Iowa","Sac County",1,3,136,77,59
050,19,161,"Iowa","Sac County",1,4,106,52,54
050,19,161,"Iowa","Sac County",1,5,130,61,69
050,19,161,"Iowa","Sac County",1,6,136,72,64
050,19,161,"Iowa","Sac County",1,7,107,57,50
050,19,161,"Iowa","Sac County",1,8,107,53,54
050,19,161,"Iowa","Sac County",1,9,111,61,50
050,19,161,"Iowa","Sac County",1,10,130,71,59
050,19,161,"Iowa","Sac County",1,11,128,70,58
050,19,161,"Iowa","Sac County",1,12,145,73,72
050,19,161,"Iowa","Sac County",1,13,145,77,68
050,19,161,"Iowa","Sac County",1,14,148,76,72
050,19,161,"Iowa","Sac County",1,15,132,66,66
050,19,161,"Iowa","Sac County",1,16,135,65,70
050,19,161,"Iowa","Sac County",1,17,124,62,62
050,19,161,"Iowa","Sac County",1,18,90,46,44
050,19,161,"Iowa","Sac County",1,19,82,46,36
050,19,161,"Iowa","Sac County",1,20,83,44,39
050,19,161,"Iowa","Sac County",1,21,94,50,44
050,19,161,"Iowa","Sac County",1,22,103,48,55
050,19,161,"Iowa","Sac County",1,23,94,50,44
050,19,161,"Iowa","Sac County",1,24,96,39,57
050,19,161,"Iowa","Sac County",1,25,96,46,50
050,19,161,"Iowa","Sac County",1,26,83,42,41
050,19,161,"Iowa","Sac County",1,27,94,54,40
050,19,161,"Iowa","Sac County",1,28,102,49,53
050,19,161,"Iowa","Sac County",1,29,102,53,49
050,19,161,"Iowa","Sac County",1,30,100,55,45
050,19,161,"Iowa","Sac County",1,31,100,50,50
050,19,161,"Iowa","Sac County",1,32,102,43,59
050,19,161,"Iowa","Sac County",1,33,102,51,51
050,19,161,"Iowa","Sac County",1,34,102,56,46
050,19,161,"Iowa","Sac County",1,35,118,64,54
050,19,161,"Iowa","Sac County",1,36,97,50,47
050,19,161,"Iowa","Sac County",1,37,95,40,55
050,19,161,"Iowa","Sac County",1,38,97,49,48
050,19,161,"Iowa","Sac County",1,39,113,66,47
050,19,161,"Iowa","Sac County",1,40,115,61,54
050,19,161,"Iowa","Sac County",1,41,96,52,44
050,19,161,"Iowa","Sac County",1,42,96,53,43
050,19,161,"Iowa","Sac County",1,43,93,49,44
050,19,161,"Iowa","Sac County",1,44,94,48,46
050,19,161,"Iowa","Sac County",1,45,91,46,45
050,19,161,"Iowa","Sac County",1,46,87,45,42
050,19,161,"Iowa","Sac County",1,47,97,44,53
050,19,161,"Iowa","Sac County",1,48,98,47,51
050,19,161,"Iowa","Sac County",1,49,110,55,55
050,19,161,"Iowa","Sac County",1,50,133,74,59
050,19,161,"Iowa","Sac County",1,51,120,67,53
050,19,161,"Iowa","Sac County",1,52,104,54,50
050,19,161,"Iowa","Sac County",1,53,121,58,63
050,19,161,"Iowa","Sac County",1,54,133,64,69
050,19,161,"Iowa","Sac County",1,55,134,71,63
050,19,161,"Iowa","Sac County",1,56,140,81,59
050,19,161,"Iowa","Sac County",1,57,131,61,70
050,19,161,"Iowa","Sac County",1,58,145,68,77
050,19,161,"Iowa","Sac County",1,59,172,79,93
050,19,161,"Iowa","Sac County",1,60,170,87,83
050,19,161,"Iowa","Sac County",1,61,169,83,86
050,19,161,"Iowa","Sac County",1,62,166,90,76
050,19,161,"Iowa","Sac County",1,63,158,86,72
050,19,161,"Iowa","Sac County",1,64,154,83,71
050,19,161,"Iowa","Sac County",1,65,161,74,87
050,19,161,"Iowa","Sac County",1,66,162,78,84
050,19,161,"Iowa","Sac County",1,67,149,77,72
050,19,161,"Iowa","Sac County",1,68,143,75,68
050,19,161,"Iowa","Sac County",1,69,129,65,64
050,19,161,"Iowa","Sac County",1,70,115,58,57
050,19,161,"Iowa","Sac County",1,71,109,57,52
050,19,161,"Iowa","Sac County",1,72,112,52,60
050,19,161,"Iowa","Sac County",1,73,109,51,58
050,19,161,"Iowa","Sac County",1,74,86,45,41
050,19,161,"Iowa","Sac County",1,75,70,38,32
050,19,161,"Iowa","Sac County",1,76,71,37,34
050,19,161,"Iowa","Sac County",1,77,67,31,36
050,19,161,"Iowa","Sac County",1,78,69,32,37
050,19,161,"Iowa","Sac County",1,79,59,26,33
050,19,161,"Iowa","Sac County",1,80,53,22,31
050,19,161,"Iowa","Sac County",1,81,56,18,38
050,19,161,"Iowa","Sac County",1,82,61,29,32
050,19,161,"Iowa","Sac County",1,83,52,27,25
050,19,161,"Iowa","Sac County",1,84,63,27,36
050,19,161,"Iowa","Sac County",1,85,395,122,273
050,19,161,"Iowa","Sac County",2,0,107,57,50
050,19,161,"Iowa","Sac County",2,1,114,61,53
050,19,161,"Iowa","Sac County",2,2,114,62,52
050,19,161,"Iowa","Sac County",2,3,128,72,56
050,19,161,"Iowa","Sac County",2,4,114,58,56
050,19,161,"Iowa","Sac County",2,5,125,59,66
050,19,161,"Iowa","Sac County",2,6,133,69,64
050,19,161,"Iowa","Sac County",2,7,114,60,54
050,19,161,"Iowa","Sac County",2,8,106,53,53
050,19,161,"Iowa","Sac County",2,9,109,58,51
050,19,161,"Iowa","Sac County",2,10,124,68,56
050,19,161,"Iowa","Sac County",2,11,127,70,57
050,19,161,"Iowa","Sac County",2,12,141,73,68
050,19,161,"Iowa","Sac County",2,13,144,74,70
050,19,161,"Iowa","Sac County",2,14,147,77,70
050,19,161,"Iowa","Sac County",2,15,135,68,67
050,19,161,"Iowa","Sac County",2,16,136,66,70
050,19,161,"Iowa","Sac County",2,17,123,60,63
050,19,161,"Iowa","Sac County",2,18,94,49,45
050,19,161,"Iowa","Sac County",2,19,81,45,36
050,19,161,"Iowa","Sac County",2,20,85,45,40
050,19,161,"Iowa","Sac County",2,21,94,49,45
050,19,161,"Iowa","Sac County",2,22,100,49,51
050,19,161,"Iowa","Sac County",2,23,96,48,48
050,19,161,"Iowa","Sac County",2,24,97,42,55
050,19,161,"Iowa","Sac County",2,25,96,45,51
050,19,161,"Iowa","Sac County",2,26,89,46,43
050,19,161,"Iowa","Sac County",2,27,94,52,42
050,19,161,"Iowa","Sac County",2,28,102,51,51
050,19,161,"Iowa","Sac County",2,29,103,53,50
050,19,161,"Iowa","Sac County",2,30,100,54,46
050,19,161,"Iowa","Sac County",2,31,100,51,49
050,19,161,"Iowa","Sac County",2,32,103,44,59
050,19,161,"Iowa","Sac County",2,33,101,49,52
050,19,161,"Iowa","Sac County",2,34,103,56,47
050,19,161,"Iowa","Sac County",2,35,115,63,52
050,19,161,"Iowa","Sac County",2,36,101,53,48
050,19,161,"Iowa","Sac County",2,37,95,42,53
050,19,161,"Iowa","Sac County",2,38,97,47,50
050,19,161,"Iowa","Sac County",2,39,109,61,48
050,19,161,"Iowa","Sac County",2,40,116,63,53
050,19,161,"Iowa","Sac County",2,41,100,54,46
050,19,161,"Iowa","Sac County",2,42,94,51,43
050,19,161,"Iowa","Sac County",2,43,93,49,44
050,19,161,"Iowa","Sac County",2,44,94,49,45
050,19,161,"Iowa","Sac County",2,45,91,45,46
050,19,161,"Iowa","Sac County",2,46,87,45,42
050,19,161,"Iowa","Sac County",2,47,93,43,50
050,19,161,"Iowa","Sac County",2,48,97,47,50
050,19,161,"Iowa","Sac County",2,49,108,53,55
050,19,161,"Iowa","Sac County",2,50,127,68,59
050,19,161,"Iowa","Sac County",2,51,122,67,55
050,19,161,"Iowa","Sac County",2,52,108,58,50
050,19,161,"Iowa","Sac County",2,53,116,56,60
050,19,161,"Iowa","Sac County",2,54,131,64,67
050,19,161,"Iowa","Sac County",2,55,132,68,64
050,19,161,"Iowa","Sac County",2,56,139,78,61
050,19,161,"Iowa","Sac County",2,57,132,65,67
050,19,161,"Iowa","Sac County",2,58,141,66,75
050,19,161,"Iowa","Sac County",2,59,166,77,89
050,19,161,"Iowa","Sac County",2,60,170,85,85
050,19,161,"Iowa","Sac County",2,61,167,83,84
050,19,161,"Iowa","Sac County",2,62,166,87,79
050,19,161,"Iowa","Sac County",2,63,160,88,72
050,19,161,"Iowa","Sac County",2,64,154,84,70
050,19,161,"Iowa","Sac County",2,65,160,76,84
050,19,161,"Iowa","Sac County",2,66,161,76,85
050,19,161,"Iowa","Sac County",2,67,151,77,74
050,19,161,"Iowa","Sac County",2,68,145,75,70
050,19,161,"Iowa","Sac County",2,69,130,65,65
050,19,161,"Iowa","Sac County",2,70,116,59,57
050,19,161,"Iowa","Sac County",2,71,109,56,53
050,19,161,"Iowa","Sac County",2,72,108,52,56
050,19,161,"Iowa","Sac County",2,73,116,54,62
050,19,161,"Iowa","Sac County",2,74,86,44,42
050,19,161,"Iowa","Sac County",2,75,75,40,35
050,19,161,"Iowa","Sac County",2,76,70,37,33
050,19,161,"Iowa","Sac County",2,77,70,33,37
050,19,161,"Iowa","Sac County",2,78,67,31,36
050,19,161,"Iowa","Sac County",2,79,58,26,32
050,19,161,"Iowa","Sac County",2,80,53,23,30
050,19,161,"Iowa","Sac County",2,81,54,18,36
050,19,161,"Iowa","Sac County",2,82,60,26,34
050,19,161,"Iowa","Sac County",2,83,51,26,25
050,19,161,"Iowa","Sac County",2,84,60,26,34
050,19,161,"Iowa","Sac County",2,85,399,124,275
050,19,161,"Iowa","Sac County",3,0,106,56,50
050,19,161,"Iowa","Sac County",3,1,119,64,55
050,19,161,"Iowa","Sac County",3,2,118,64,54
050,19,161,"Iowa","Sac County",3,3,108,53,55
050,19,161,"Iowa","Sac County",3,4,127,72,55
050,19,161,"Iowa","Sac County",3,5,114,59,55
050,19,161,"Iowa","Sac County",3,6,121,59,62
050,19,161,"Iowa","Sac County",3,7,128,68,60
050,19,161,"Iowa","Sac County",3,8,113,59,54
050,19,161,"Iowa","Sac County",3,9,105,54,51
050,19,161,"Iowa","Sac County",3,10,102,58,44
050,19,161,"Iowa","Sac County",3,11,122,65,57
050,19,161,"Iowa","Sac County",3,12,128,71,57
050,19,161,"Iowa","Sac County",3,13,142,76,66
050,19,161,"Iowa","Sac County",3,14,140,71,69
050,19,161,"Iowa","Sac County",3,15,142,76,66
050,19,161,"Iowa","Sac County",3,16,138,70,68
050,19,161,"Iowa","Sac County",3,17,125,61,64
050,19,161,"Iowa","Sac County",3,18,99,50,49
050,19,161,"Iowa","Sac County",3,19,81,43,38
050,19,161,"Iowa","Sac County",3,20,91,46,45
050,19,161,"Iowa","Sac County",3,21,101,54,47
050,19,161,"Iowa","Sac County",3,22,94,51,43
050,19,161,"Iowa","Sac County",3,23,96,51,45
050,19,161,"Iowa","Sac County",3,24,94,47,47
050,19,161,"Iowa","Sac County",3,25,98,50,48
050,19,161,"Iowa","Sac County",3,26,100,46,54
050,19,161,"Iowa","Sac County",3,27,92,47,45
050,19,161,"Iowa","Sac County",3,28,96,52,44
050,19,161,"Iowa","Sac County",3,29,109,53,56
050,19,161,"Iowa","Sac County",3,30,107,58,49
050,19,161,"Iowa","Sac County",3,31,107,57,50
050,19,161,"Iowa","Sac County",3,32,104,54,50
050,19,161,"Iowa","Sac County",3,33,105,48,57
050,19,161,"Iowa","Sac County",3,34,99,49,50
050,19,161,"Iowa","Sac County",3,35,107,60,47
050,19,161,"Iowa","Sac County",3,36,116,63,53
050,19,161,"Iowa","Sac County",3,37,104,52,52
050,19,161,"Iowa","Sac County",3,38,92,36,56
050,19,161,"Iowa","Sac County",3,39,97,47,50
050,19,161,"Iowa","Sac County",3,40,112,62,50
050,19,161,"Iowa","Sac County",3,41,119,67,52
050,19,161,"Iowa","Sac County",3,42,98,54,44
050,19,161,"Iowa","Sac County",3,43,97,54,43
050,19,161,"Iowa","Sac County",3,44,96,50,46
050,19,161,"Iowa","Sac County",3,45,96,50,46
050,19,161,"Iowa","Sac County",3,46,96,49,47
050,19,161,"Iowa","Sac County",3,47,80,41,39
050,19,161,"Iowa","Sac County",3,48,91,41,50
050,19,161,"Iowa","Sac County",3,49,98,48,50
050,19,161,"Iowa","Sac County",3,50,111,54,57
050,19,161,"Iowa","Sac County",3,51,132,68,64
050,19,161,"Iowa","Sac County",3,52,120,66,54
050,19,161,"Iowa","Sac County",3,53,105,56,49
050,19,161,"Iowa","Sac County",3,54,116,58,58
050,19,161,"Iowa","Sac County",3,55,130,62,68
050,19,161,"Iowa","Sac County",3,56,133,65,68
050,19,161,"Iowa","Sac County",3,57,142,80,62
050,19,161,"Iowa","Sac County",3,58,132,65,67
050,19,161,"Iowa","Sac County",3,59,143,67,76
050,19,161,"Iowa","Sac County",3,60,165,76,89
050,19,161,"Iowa","Sac County",3,61,165,81,84
050,19,161,"Iowa","Sac County",3,62,163,79,84
050,19,161,"Iowa","Sac County",3,63,165,89,76
050,19,161,"Iowa","Sac County",3,64,156,86,70
050,19,161,"Iowa","Sac County",3,65,151,79,72
050,19,161,"Iowa","Sac County",3,66,153,76,77
050,19,161,"Iowa","Sac County",3,67,156,74,82
050,19,161,"Iowa","Sac County",3,68,150,77,73
050,19,161,"Iowa","Sac County",3,69,140,74,66
050,19,161,"Iowa","Sac County",3,70,126,64,62
050,19,161,"Iowa","Sac County",3,71,113,57,56
050,19,161,"Iowa","Sac County",3,72,104,54,50
050,19,161,"Iowa","Sac County",3,73,109,53,56
050,19,161,"Iowa","Sac County",3,74,114,53,61
050,19,161,"Iowa","Sac County",3,75,85,43,42
050,19,161,"Iowa","Sac County",3,76,72,39,33
050,19,161,"Iowa","Sac County",3,77,71,36,35
050,19,161,"Iowa","Sac County",3,78,64,28,36
050,19,161,"Iowa","Sac County",3,79,61,30,31
050,19,161,"Iowa","Sac County",3,80,55,26,29
050,19,161,"Iowa","Sac County",3,81,51,21,30
050,19,161,"Iowa","Sac County",3,82,52,17,35
050,19,161,"Iowa","Sac County",3,83,53,23,30
050,19,161,"Iowa","Sac County",3,84,47,21,26
050,19,161,"Iowa","Sac County",3,85,393,126,267
050,19,161,"Iowa","Sac County",4,0,112,61,51
050,19,161,"Iowa","Sac County",4,1,100,51,49
050,19,161,"Iowa","Sac County",4,2,107,53,54
050,19,161,"Iowa","Sac County",4,3,128,67,61
050,19,161,"Iowa","Sac County",4,4,109,56,53
050,19,161,"Iowa","Sac County",4,5,128,71,57
050,19,161,"Iowa","Sac County",4,6,113,59,54
050,19,161,"Iowa","Sac County",4,7,122,61,61
050,19,161,"Iowa","Sac County",4,8,131,66,65
050,19,161,"Iowa","Sac County",4,9,118,65,53
050,19,161,"Iowa","Sac County",4,10,98,46,52
050,19,161,"Iowa","Sac County",4,11,107,53,54
050,19,161,"Iowa","Sac County",4,12,127,65,62
050,19,161,"Iowa","Sac County",4,13,129,69,60
050,19,161,"Iowa","Sac County",4,14,143,71,72
050,19,161,"Iowa","Sac County",4,15,144,74,70
050,19,161,"Iowa","Sac County",4,16,142,79,63
050,19,161,"Iowa","Sac County",4,17,133,67,66
050,19,161,"Iowa","Sac County",4,18,102,52,50
050,19,161,"Iowa","Sac County",4,19,79,44,35
050,19,161,"Iowa","Sac County",4,20,83,44,39
050,19,161,"Iowa","Sac County",4,21,99,48,51
050,19,161,"Iowa","Sac County",4,22,102,54,48
050,19,161,"Iowa","Sac County",4,23,97,55,42
050,19,161,"Iowa","Sac County",4,24,89,45,44
050,19,161,"Iowa","Sac County",4,25,89,40,49
050,19,161,"Iowa","Sac County",4,26,82,42,40
050,19,161,"Iowa","Sac County",4,27,106,51,55
050,19,161,"Iowa","Sac County",4,28,97,49,48
050,19,161,"Iowa","Sac County",4,29,102,57,45
050,19,161,"Iowa","Sac County",4,30,97,46,51
050,19,161,"Iowa","Sac County",4,31,105,55,50
050,19,161,"Iowa","Sac County",4,32,109,56,53
050,19,161,"Iowa","Sac County",4,33,102,56,46
050,19,161,"Iowa","Sac County",4,34,105,46,59
050,19,161,"Iowa","Sac County",4,35,96,50,46
050,19,161,"Iowa","Sac County",4,36,113,63,50
050,19,161,"Iowa","Sac County",4,37,117,62,55
050,19,161,"Iowa","Sac County",4,38,97,49,48
050,19,161,"Iowa","Sac County",4,39,90,35,55
050,19,161,"Iowa","Sac County",4,40,96,48,48
050,19,161,"Iowa","Sac County",4,41,114,63,51
050,19,161,"Iowa","Sac County",4,42,125,68,57
050,19,161,"Iowa","Sac County",4,43,93,52,41
050,19,161,"Iowa","Sac County",4,44,102,56,46
050,19,161,"Iowa","Sac County",4,45,92,48,44
050,19,161,"Iowa","Sac County",4,46,99,54,45
050,19,161,"Iowa","Sac County",4,47,93,45,48
050,19,161,"Iowa","Sac County",4,48,79,42,37
050,19,161,"Iowa","Sac County",4,49,98,44,54
050,19,161,"Iowa","Sac County",4,50,101,50,51
050,19,161,"Iowa","Sac County",4,51,113,51,62
050,19,161,"Iowa","Sac County",4,52,125,66,59
050,19,161,"Iowa","Sac County",4,53,124,65,59
050,19,161,"Iowa","Sac County",4,54,104,55,49
050,19,161,"Iowa","Sac County",4,55,119,58,61
050,19,161,"Iowa","Sac County",4,56,131,63,68
050,19,161,"Iowa","Sac County",4,57,132,67,65
050,19,161,"Iowa","Sac County",4,58,138,79,59
050,19,161,"Iowa","Sac County",4,59,133,65,68
050,19,161,"Iowa","Sac County",4,60,144,70,74
050,19,161,"Iowa","Sac County",4,61,161,73,88
050,19,161,"Iowa","Sac County",4,62,161,76,85
050,19,161,"Iowa","Sac County",4,63,160,79,81
050,19,161,"Iowa","Sac County",4,64,163,90,73
050,19,161,"Iowa","Sac County",4,65,151,79,72
050,19,161,"Iowa","Sac County",4,66,143,75,68
050,19,161,"Iowa","Sac County",4,67,151,73,78
050,19,161,"Iowa","Sac County",4,68,156,76,80
050,19,161,"Iowa","Sac County",4,69,146,75,71
050,19,161,"Iowa","Sac County",4,70,138,72,66
050,19,161,"Iowa","Sac County",4,71,122,64,58
050,19,161,"Iowa","Sac County",4,72,113,55,58
050,19,161,"Iowa","Sac County",4,73,102,54,48
050,19,161,"Iowa","Sac County",4,74,111,55,56
050,19,161,"Iowa","Sac County",4,75,111,51,60
050,19,161,"Iowa","Sac County",4,76,79,43,36
050,19,161,"Iowa","Sac County",4,77,72,37,35
050,19,161,"Iowa","Sac County",4,78,70,36,34
050,19,161,"Iowa","Sac County",4,79,49,22,27
050,19,161,"Iowa","Sac County",4,80,58,29,29
050,19,161,"Iowa","Sac County",4,81,50,24,26
050,19,161,"Iowa","Sac County",4,82,51,22,29
050,19,161,"Iowa","Sac County",4,83,46,14,32
050,19,161,"Iowa","Sac County",4,84,49,19,30
050,19,161,"Iowa","Sac County",4,85,372,120,252
050,19,161,"Iowa","Sac County",5,0,111,59,52
050,19,161,"Iowa","Sac County",5,1,134,77,57
050,19,161,"Iowa","Sac County",5,2,105,53,52
050,19,161,"Iowa","Sac County",5,3,108,53,55
050,19,161,"Iowa","Sac County",5,4,123,65,58
050,19,161,"Iowa","Sac County",5,5,111,60,51
050,19,161,"Iowa","Sac County",5,6,133,73,60
050,19,161,"Iowa","Sac County",5,7,120,57,63
050,19,161,"Iowa","Sac County",5,8,119,58,61
050,19,161,"Iowa","Sac County",5,9,136,65,71
050,19,161,"Iowa","Sac County",5,10,110,56,54
050,19,161,"Iowa","Sac County",5,11,107,52,55
050,19,161,"Iowa","Sac County",5,12,100,52,48
050,19,161,"Iowa","Sac County",5,13,127,65,62
050,19,161,"Iowa","Sac County",5,14,126,70,56
050,19,161,"Iowa","Sac County",5,15,144,76,68
050,19,161,"Iowa","Sac County",5,16,137,69,68
050,19,161,"Iowa","Sac County",5,17,140,76,64
050,19,161,"Iowa","Sac County",5,18,113,58,55
050,19,161,"Iowa","Sac County",5,19,79,40,39
050,19,161,"Iowa","Sac County",5,20,85,48,37
050,19,161,"Iowa","Sac County",5,21,87,45,42
050,19,161,"Iowa","Sac County",5,22,107,52,55
050,19,161,"Iowa","Sac County",5,23,110,56,54
050,19,161,"Iowa","Sac County",5,24,85,49,36
050,19,161,"Iowa","Sac County",5,25,84,47,37
050,19,161,"Iowa","Sac County",5,26,87,40,47
050,19,161,"Iowa","Sac County",5,27,86,46,40
050,19,161,"Iowa","Sac County",5,28,104,48,56
050,19,161,"Iowa","Sac County",5,29,99,46,53
050,19,161,"Iowa","Sac County",5,30,100,58,42
050,19,161,"Iowa","Sac County",5,31,107,52,55
050,19,161,"Iowa","Sac County",5,32,104,54,50
050,19,161,"Iowa","Sac County",5,33,109,58,51
050,19,161,"Iowa","Sac County",5,34,101,52,49
050,19,161,"Iowa","Sac County",5,35,110,50,60
050,19,161,"Iowa","Sac County",5,36,95,48,47
050,19,161,"Iowa","Sac County",5,37,114,63,51
050,19,161,"Iowa","Sac County",5,38,118,66,52
050,19,161,"Iowa","Sac County",5,39,98,53,45
050,19,161,"Iowa","Sac County",5,40,83,34,49
050,19,161,"Iowa","Sac County",5,41,102,50,52
050,19,161,"Iowa","Sac County",5,42,114,61,53
050,19,161,"Iowa","Sac County",5,43,121,67,54
050,19,161,"Iowa","Sac County",5,44,100,56,44
050,19,161,"Iowa","Sac County",5,45,101,55,46
050,19,161,"Iowa","Sac County",5,46,89,47,42
050,19,161,"Iowa","Sac County",5,47,100,54,46
050,19,161,"Iowa","Sac County",5,48,91,45,46
050,19,161,"Iowa","Sac County",5,49,82,44,38
050,19,161,"Iowa","Sac County",5,50,98,44,54
050,19,161,"Iowa","Sac County",5,51,101,47,54
050,19,161,"Iowa","Sac County",5,52,120,56,64
050,19,161,"Iowa","Sac County",5,53,127,67,60
050,19,161,"Iowa","Sac County",5,54,123,64,59
050,19,161,"Iowa","Sac County",5,55,102,54,48
050,19,161,"Iowa","Sac County",5,56,119,60,59
050,19,161,"Iowa","Sac County",5,57,135,69,66
050,19,161,"Iowa","Sac County",5,58,133,68,65
050,19,161,"Iowa","Sac County",5,59,139,77,62
050,19,161,"Iowa","Sac County",5,60,132,65,67
050,19,161,"Iowa","Sac County",5,61,136,65,71
050,19,161,"Iowa","Sac County",5,62,156,72,84
050,19,161,"Iowa","Sac County",5,63,161,75,86
050,19,161,"Iowa","Sac County",5,64,156,78,78
050,19,161,"Iowa","Sac County",5,65,158,86,72
050,19,161,"Iowa","Sac County",5,66,153,79,74
050,19,161,"Iowa","Sac County",5,67,137,71,66
050,19,161,"Iowa","Sac County",5,68,153,75,78
050,19,161,"Iowa","Sac County",5,69,153,74,79
050,19,161,"Iowa","Sac County",5,70,144,76,68
050,19,161,"Iowa","Sac County",5,71,132,71,61
050,19,161,"Iowa","Sac County",5,72,124,63,61
050,19,161,"Iowa","Sac County",5,73,110,55,55
050,19,161,"Iowa","Sac County",5,74,98,53,45
050,19,161,"Iowa","Sac County",5,75,111,54,57
050,19,161,"Iowa","Sac County",5,76,107,50,57
050,19,161,"Iowa","Sac County",5,77,82,43,39
050,19,161,"Iowa","Sac County",5,78,72,37,35
050,19,161,"Iowa","Sac County",5,79,57,31,26
050,19,161,"Iowa","Sac County",5,80,50,23,27
050,19,161,"Iowa","Sac County",5,81,52,24,28
050,19,161,"Iowa","Sac County",5,82,50,24,26
050,19,161,"Iowa","Sac County",5,83,48,22,26
050,19,161,"Iowa","Sac County",5,84,37,9,28
050,19,161,"Iowa","Sac County",5,85,364,119,245
050,19,163,"Iowa","Scott County",1,0,2029,1041,988
050,19,163,"Iowa","Scott County",1,1,2046,1041,1005
050,19,163,"Iowa","Scott County",1,2,2129,1065,1064
050,19,163,"Iowa","Scott County",1,3,2186,1103,1083
050,19,163,"Iowa","Scott County",1,4,2214,1084,1130
050,19,163,"Iowa","Scott County",1,5,2316,1173,1143
050,19,163,"Iowa","Scott County",1,6,2328,1180,1148
050,19,163,"Iowa","Scott County",1,7,2296,1159,1137
050,19,163,"Iowa","Scott County",1,8,2278,1188,1090
050,19,163,"Iowa","Scott County",1,9,2279,1187,1092
050,19,163,"Iowa","Scott County",1,10,2322,1214,1108
050,19,163,"Iowa","Scott County",1,11,2423,1252,1171
050,19,163,"Iowa","Scott County",1,12,2503,1245,1258
050,19,163,"Iowa","Scott County",1,13,2517,1278,1239
050,19,163,"Iowa","Scott County",1,14,2444,1249,1195
050,19,163,"Iowa","Scott County",1,15,2427,1214,1213
050,19,163,"Iowa","Scott County",1,16,2399,1238,1161
050,19,163,"Iowa","Scott County",1,17,2320,1131,1189
050,19,163,"Iowa","Scott County",1,18,2178,1086,1092
050,19,163,"Iowa","Scott County",1,19,2107,1080,1027
050,19,163,"Iowa","Scott County",1,20,2072,1037,1035
050,19,163,"Iowa","Scott County",1,21,2023,984,1039
050,19,163,"Iowa","Scott County",1,22,1915,942,973
050,19,163,"Iowa","Scott County",1,23,1977,1000,977
050,19,163,"Iowa","Scott County",1,24,2063,1040,1023
050,19,163,"Iowa","Scott County",1,25,2099,1064,1035
050,19,163,"Iowa","Scott County",1,26,2193,1083,1110
050,19,163,"Iowa","Scott County",1,27,2213,1123,1090
050,19,163,"Iowa","Scott County",1,28,2234,1117,1117
050,19,163,"Iowa","Scott County",1,29,2208,1089,1119
050,19,163,"Iowa","Scott County",1,30,2235,1085,1150
050,19,163,"Iowa","Scott County",1,31,2261,1069,1192
050,19,163,"Iowa","Scott County",1,32,2161,1043,1118
050,19,163,"Iowa","Scott County",1,33,2291,1157,1134
050,19,163,"Iowa","Scott County",1,34,2383,1168,1215
050,19,163,"Iowa","Scott County",1,35,2354,1147,1207
050,19,163,"Iowa","Scott County",1,36,2319,1147,1172
050,19,163,"Iowa","Scott County",1,37,2453,1270,1183
050,19,163,"Iowa","Scott County",1,38,2539,1267,1272
050,19,163,"Iowa","Scott County",1,39,2509,1269,1240
050,19,163,"Iowa","Scott County",1,40,2395,1197,1198
050,19,163,"Iowa","Scott County",1,41,2301,1186,1115
050,19,163,"Iowa","Scott County",1,42,2240,1132,1108
050,19,163,"Iowa","Scott County",1,43,2118,1089,1029
050,19,163,"Iowa","Scott County",1,44,2058,1045,1013
050,19,163,"Iowa","Scott County",1,45,2021,1045,976
050,19,163,"Iowa","Scott County",1,46,1981,1000,981
050,19,163,"Iowa","Scott County",1,47,2023,1034,989
050,19,163,"Iowa","Scott County",1,48,2153,1072,1081
050,19,163,"Iowa","Scott County",1,49,2276,1146,1130
050,19,163,"Iowa","Scott County",1,50,2198,1117,1081
050,19,163,"Iowa","Scott County",1,51,2140,1068,1072
050,19,163,"Iowa","Scott County",1,52,2120,1059,1061
050,19,163,"Iowa","Scott County",1,53,2169,1096,1073
050,19,163,"Iowa","Scott County",1,54,2213,1112,1101
050,19,163,"Iowa","Scott County",1,55,2159,1083,1076
050,19,163,"Iowa","Scott County",1,56,2234,1110,1124
050,19,163,"Iowa","Scott County",1,57,2297,1154,1143
050,19,163,"Iowa","Scott County",1,58,2379,1153,1226
050,19,163,"Iowa","Scott County",1,59,2375,1138,1237
050,19,163,"Iowa","Scott County",1,60,2409,1178,1231
050,19,163,"Iowa","Scott County",1,61,2352,1129,1223
050,19,163,"Iowa","Scott County",1,62,2333,1145,1188
050,19,163,"Iowa","Scott County",1,63,2243,1102,1141
050,19,163,"Iowa","Scott County",1,64,2139,1087,1052
050,19,163,"Iowa","Scott County",1,65,2121,1052,1069
050,19,163,"Iowa","Scott County",1,66,2010,984,1026
050,19,163,"Iowa","Scott County",1,67,1919,935,984
050,19,163,"Iowa","Scott County",1,68,1893,915,978
050,19,163,"Iowa","Scott County",1,69,1735,844,891
050,19,163,"Iowa","Scott County",1,70,1711,822,889
050,19,163,"Iowa","Scott County",1,71,1647,772,875
050,19,163,"Iowa","Scott County",1,72,1624,776,848
050,19,163,"Iowa","Scott County",1,73,1664,819,845
050,19,163,"Iowa","Scott County",1,74,1171,554,617
050,19,163,"Iowa","Scott County",1,75,1120,534,586
050,19,163,"Iowa","Scott County",1,76,1048,510,538
050,19,163,"Iowa","Scott County",1,77,1027,470,557
050,19,163,"Iowa","Scott County",1,78,897,381,516
050,19,163,"Iowa","Scott County",1,79,805,354,451
050,19,163,"Iowa","Scott County",1,80,729,289,440
050,19,163,"Iowa","Scott County",1,81,711,298,413
050,19,163,"Iowa","Scott County",1,82,676,296,380
050,19,163,"Iowa","Scott County",1,83,598,227,371
050,19,163,"Iowa","Scott County",1,84,532,219,313
050,19,163,"Iowa","Scott County",1,85,3464,1190,2274
050,19,163,"Iowa","Scott County",2,0,2025,1038,987
050,19,163,"Iowa","Scott County",2,1,2044,1042,1002
050,19,163,"Iowa","Scott County",2,2,2113,1062,1051
050,19,163,"Iowa","Scott County",2,3,2161,1089,1072
050,19,163,"Iowa","Scott County",2,4,2211,1093,1118
050,19,163,"Iowa","Scott County",2,5,2290,1152,1138
050,19,163,"Iowa","Scott County",2,6,2330,1184,1146
050,19,163,"Iowa","Scott County",2,7,2302,1163,1139
050,19,163,"Iowa","Scott County",2,8,2270,1178,1092
050,19,163,"Iowa","Scott County",2,9,2273,1187,1086
050,19,163,"Iowa","Scott County",2,10,2308,1206,1102
050,19,163,"Iowa","Scott County",2,11,2393,1239,1154
050,19,163,"Iowa","Scott County",2,12,2499,1254,1245
050,19,163,"Iowa","Scott County",2,13,2510,1265,1245
050,19,163,"Iowa","Scott County",2,14,2458,1254,1204
050,19,163,"Iowa","Scott County",2,15,2435,1226,1209
050,19,163,"Iowa","Scott County",2,16,2407,1232,1175
050,19,163,"Iowa","Scott County",2,17,2331,1150,1181
050,19,163,"Iowa","Scott County",2,18,2185,1086,1099
050,19,163,"Iowa","Scott County",2,19,2121,1081,1040
050,19,163,"Iowa","Scott County",2,20,2106,1053,1053
050,19,163,"Iowa","Scott County",2,21,2017,982,1035
050,19,163,"Iowa","Scott County",2,22,1943,952,991
050,19,163,"Iowa","Scott County",2,23,1979,994,985
050,19,163,"Iowa","Scott County",2,24,2046,1038,1008
050,19,163,"Iowa","Scott County",2,25,2083,1052,1031
050,19,163,"Iowa","Scott County",2,26,2162,1076,1086
050,19,163,"Iowa","Scott County",2,27,2199,1105,1094
050,19,163,"Iowa","Scott County",2,28,2221,1115,1106
050,19,163,"Iowa","Scott County",2,29,2217,1098,1119
050,19,163,"Iowa","Scott County",2,30,2249,1091,1158
050,19,163,"Iowa","Scott County",2,31,2239,1065,1174
050,19,163,"Iowa","Scott County",2,32,2178,1047,1131
050,19,163,"Iowa","Scott County",2,33,2265,1136,1129
050,19,163,"Iowa","Scott County",2,34,2353,1161,1192
050,19,163,"Iowa","Scott County",2,35,2370,1155,1215
050,19,163,"Iowa","Scott County",2,36,2315,1139,1176
050,19,163,"Iowa","Scott County",2,37,2423,1238,1185
050,19,163,"Iowa","Scott County",2,38,2526,1267,1259
050,19,163,"Iowa","Scott County",2,39,2506,1262,1244
050,19,163,"Iowa","Scott County",2,40,2431,1221,1210
050,19,163,"Iowa","Scott County",2,41,2325,1191,1134
050,19,163,"Iowa","Scott County",2,42,2245,1142,1103
050,19,163,"Iowa","Scott County",2,43,2155,1102,1053
050,19,163,"Iowa","Scott County",2,44,2047,1044,1003
050,19,163,"Iowa","Scott County",2,45,2037,1049,988
050,19,163,"Iowa","Scott County",2,46,1981,1010,971
050,19,163,"Iowa","Scott County",2,47,2003,1017,986
050,19,163,"Iowa","Scott County",2,48,2119,1059,1060
050,19,163,"Iowa","Scott County",2,49,2245,1130,1115
050,19,163,"Iowa","Scott County",2,50,2219,1126,1093
050,19,163,"Iowa","Scott County",2,51,2138,1076,1062
050,19,163,"Iowa","Scott County",2,52,2112,1054,1058
050,19,163,"Iowa","Scott County",2,53,2162,1087,1075
050,19,163,"Iowa","Scott County",2,54,2183,1101,1082
050,19,163,"Iowa","Scott County",2,55,2170,1088,1082
050,19,163,"Iowa","Scott County",2,56,2217,1107,1110
050,19,163,"Iowa","Scott County",2,57,2278,1139,1139
050,19,163,"Iowa","Scott County",2,58,2346,1149,1197
050,19,163,"Iowa","Scott County",2,59,2381,1146,1235
050,19,163,"Iowa","Scott County",2,60,2388,1163,1225
050,19,163,"Iowa","Scott County",2,61,2354,1135,1219
050,19,163,"Iowa","Scott County",2,62,2326,1134,1192
050,19,163,"Iowa","Scott County",2,63,2274,1116,1158
050,19,163,"Iowa","Scott County",2,64,2139,1077,1062
050,19,163,"Iowa","Scott County",2,65,2111,1055,1056
050,19,163,"Iowa","Scott County",2,66,2026,992,1034
050,19,163,"Iowa","Scott County",2,67,1930,941,989
050,19,163,"Iowa","Scott County",2,68,1876,904,972
050,19,163,"Iowa","Scott County",2,69,1778,862,916
050,19,163,"Iowa","Scott County",2,70,1705,822,883
050,19,163,"Iowa","Scott County",2,71,1658,784,874
050,19,163,"Iowa","Scott County",2,72,1598,758,840
050,19,163,"Iowa","Scott County",2,73,1721,842,879
050,19,163,"Iowa","Scott County",2,74,1205,573,632
050,19,163,"Iowa","Scott County",2,75,1125,536,589
050,19,163,"Iowa","Scott County",2,76,1048,509,539
050,19,163,"Iowa","Scott County",2,77,1049,486,563
050,19,163,"Iowa","Scott County",2,78,910,392,518
050,19,163,"Iowa","Scott County",2,79,812,352,460
050,19,163,"Iowa","Scott County",2,80,743,297,446
050,19,163,"Iowa","Scott County",2,81,699,290,409
050,19,163,"Iowa","Scott County",2,82,679,297,382
050,19,163,"Iowa","Scott County",2,83,610,240,370
050,19,163,"Iowa","Scott County",2,84,524,208,316
050,19,163,"Iowa","Scott County",2,85,3464,1201,2263
050,19,163,"Iowa","Scott County",3,0,1851,932,919
050,19,163,"Iowa","Scott County",3,1,2010,1030,980
050,19,163,"Iowa","Scott County",3,2,2053,1039,1014
050,19,163,"Iowa","Scott County",3,3,2108,1051,1057
050,19,163,"Iowa","Scott County",3,4,2187,1126,1061
050,19,163,"Iowa","Scott County",3,5,2243,1121,1122
050,19,163,"Iowa","Scott County",3,6,2340,1176,1164
050,19,163,"Iowa","Scott County",3,7,2319,1177,1142
050,19,163,"Iowa","Scott County",3,8,2268,1147,1121
050,19,163,"Iowa","Scott County",3,9,2258,1162,1096
050,19,163,"Iowa","Scott County",3,10,2307,1207,1100
050,19,163,"Iowa","Scott County",3,11,2274,1176,1098
050,19,163,"Iowa","Scott County",3,12,2410,1252,1158
050,19,163,"Iowa","Scott County",3,13,2466,1234,1232
050,19,163,"Iowa","Scott County",3,14,2497,1267,1230
050,19,163,"Iowa","Scott County",3,15,2436,1245,1191
050,19,163,"Iowa","Scott County",3,16,2432,1221,1211
050,19,163,"Iowa","Scott County",3,17,2379,1210,1169
050,19,163,"Iowa","Scott County",3,18,2211,1105,1106
050,19,163,"Iowa","Scott County",3,19,2125,1057,1068
050,19,163,"Iowa","Scott County",3,20,2122,1050,1072
050,19,163,"Iowa","Scott County",3,21,2060,1015,1045
050,19,163,"Iowa","Scott County",3,22,1995,972,1023
050,19,163,"Iowa","Scott County",3,23,1970,981,989
050,19,163,"Iowa","Scott County",3,24,2069,1053,1016
050,19,163,"Iowa","Scott County",3,25,2037,1027,1010
050,19,163,"Iowa","Scott County",3,26,2141,1091,1050
050,19,163,"Iowa","Scott County",3,27,2127,1058,1069
050,19,163,"Iowa","Scott County",3,28,2198,1096,1102
050,19,163,"Iowa","Scott County",3,29,2222,1126,1096
050,19,163,"Iowa","Scott County",3,30,2216,1080,1136
050,19,163,"Iowa","Scott County",3,31,2244,1093,1151
050,19,163,"Iowa","Scott County",3,32,2234,1062,1172
050,19,163,"Iowa","Scott County",3,33,2176,1038,1138
050,19,163,"Iowa","Scott County",3,34,2253,1127,1126
050,19,163,"Iowa","Scott County",3,35,2383,1196,1187
050,19,163,"Iowa","Scott County",3,36,2376,1150,1226
050,19,163,"Iowa","Scott County",3,37,2295,1131,1164
050,19,163,"Iowa","Scott County",3,38,2424,1238,1186
050,19,163,"Iowa","Scott County",3,39,2514,1272,1242
050,19,163,"Iowa","Scott County",3,40,2485,1247,1238
050,19,163,"Iowa","Scott County",3,41,2423,1223,1200
050,19,163,"Iowa","Scott County",3,42,2341,1211,1130
050,19,163,"Iowa","Scott County",3,43,2259,1160,1099
050,19,163,"Iowa","Scott County",3,44,2164,1108,1056
050,19,163,"Iowa","Scott County",3,45,2046,1041,1005
050,19,163,"Iowa","Scott County",3,46,2028,1047,981
050,19,163,"Iowa","Scott County",3,47,1937,973,964
050,19,163,"Iowa","Scott County",3,48,1996,1009,987
050,19,163,"Iowa","Scott County",3,49,2115,1063,1052
050,19,163,"Iowa","Scott County",3,50,2269,1148,1121
050,19,163,"Iowa","Scott County",3,51,2202,1108,1094
050,19,163,"Iowa","Scott County",3,52,2113,1054,1059
050,19,163,"Iowa","Scott County",3,53,2097,1053,1044
050,19,163,"Iowa","Scott County",3,54,2156,1092,1064
050,19,163,"Iowa","Scott County",3,55,2179,1087,1092
050,19,163,"Iowa","Scott County",3,56,2141,1075,1066
050,19,163,"Iowa","Scott County",3,57,2187,1088,1099
050,19,163,"Iowa","Scott County",3,58,2238,1126,1112
050,19,163,"Iowa","Scott County",3,59,2288,1102,1186
050,19,163,"Iowa","Scott County",3,60,2341,1131,1210
050,19,163,"Iowa","Scott County",3,61,2341,1138,1203
050,19,163,"Iowa","Scott County",3,62,2304,1108,1196
050,19,163,"Iowa","Scott County",3,63,2254,1094,1160
050,19,163,"Iowa","Scott County",3,64,2242,1105,1137
050,19,163,"Iowa","Scott County",3,65,2096,1042,1054
050,19,163,"Iowa","Scott County",3,66,2068,1028,1040
050,19,163,"Iowa","Scott County",3,67,1985,966,1019
050,19,163,"Iowa","Scott County",3,68,1872,901,971
050,19,163,"Iowa","Scott County",3,69,1836,884,952
050,19,163,"Iowa","Scott County",3,70,1746,848,898
050,19,163,"Iowa","Scott County",3,71,1654,800,854
050,19,163,"Iowa","Scott County",3,72,1601,742,859
050,19,163,"Iowa","Scott County",3,73,1549,729,820
050,19,163,"Iowa","Scott County",3,74,1662,801,861
050,19,163,"Iowa","Scott County",3,75,1184,568,616
050,19,163,"Iowa","Scott County",3,76,1094,519,575
050,19,163,"Iowa","Scott County",3,77,991,487,504
050,19,163,"Iowa","Scott County",3,78,1014,458,556
050,19,163,"Iowa","Scott County",3,79,852,368,484
050,19,163,"Iowa","Scott County",3,80,774,324,450
050,19,163,"Iowa","Scott County",3,81,696,276,420
050,19,163,"Iowa","Scott County",3,82,644,265,379
050,19,163,"Iowa","Scott County",3,83,644,277,367
050,19,163,"Iowa","Scott County",3,84,539,220,319
050,19,163,"Iowa","Scott County",3,85,3348,1164,2184
050,19,163,"Iowa","Scott County",4,0,1874,960,914
050,19,163,"Iowa","Scott County",4,1,1847,958,889
050,19,163,"Iowa","Scott County",4,2,2015,1034,981
050,19,163,"Iowa","Scott County",4,3,2056,1036,1020
050,19,163,"Iowa","Scott County",4,4,2150,1068,1082
050,19,163,"Iowa","Scott County",4,5,2211,1134,1077
050,19,163,"Iowa","Scott County",4,6,2245,1127,1118
050,19,163,"Iowa","Scott County",4,7,2314,1175,1139
050,19,163,"Iowa","Scott County",4,8,2288,1167,1121
050,19,163,"Iowa","Scott County",4,9,2245,1135,1110
050,19,163,"Iowa","Scott County",4,10,2228,1170,1058
050,19,163,"Iowa","Scott County",4,11,2252,1154,1098
050,19,163,"Iowa","Scott County",4,12,2283,1192,1091
050,19,163,"Iowa","Scott County",4,13,2403,1262,1141
050,19,163,"Iowa","Scott County",4,14,2475,1239,1236
050,19,163,"Iowa","Scott County",4,15,2506,1262,1244
050,19,163,"Iowa","Scott County",4,16,2421,1242,1179
050,19,163,"Iowa","Scott County",4,17,2410,1192,1218
050,19,163,"Iowa","Scott County",4,18,2263,1162,1101
050,19,163,"Iowa","Scott County",4,19,2069,1050,1019
050,19,163,"Iowa","Scott County",4,20,2058,1004,1054
050,19,163,"Iowa","Scott County",4,21,2044,993,1051
050,19,163,"Iowa","Scott County",4,22,2052,1023,1029
050,19,163,"Iowa","Scott County",4,23,2118,1036,1082
050,19,163,"Iowa","Scott County",4,24,2130,1093,1037
050,19,163,"Iowa","Scott County",4,25,2134,1074,1060
050,19,163,"Iowa","Scott County",4,26,2021,1021,1000
050,19,163,"Iowa","Scott County",4,27,2096,1073,1023
050,19,163,"Iowa","Scott County",4,28,2092,1042,1050
050,19,163,"Iowa","Scott County",4,29,2196,1089,1107
050,19,163,"Iowa","Scott County",4,30,2224,1105,1119
050,19,163,"Iowa","Scott County",4,31,2220,1078,1142
050,19,163,"Iowa","Scott County",4,32,2282,1103,1179
050,19,163,"Iowa","Scott County",4,33,2239,1072,1167
050,19,163,"Iowa","Scott County",4,34,2178,1039,1139
050,19,163,"Iowa","Scott County",4,35,2275,1146,1129
050,19,163,"Iowa","Scott County",4,36,2316,1148,1168
050,19,163,"Iowa","Scott County",4,37,2351,1161,1190
050,19,163,"Iowa","Scott County",4,38,2321,1144,1177
050,19,163,"Iowa","Scott County",4,39,2436,1236,1200
050,19,163,"Iowa","Scott County",4,40,2484,1258,1226
050,19,163,"Iowa","Scott County",4,41,2493,1244,1249
050,19,163,"Iowa","Scott County",4,42,2447,1248,1199
050,19,163,"Iowa","Scott County",4,43,2312,1200,1112
050,19,163,"Iowa","Scott County",4,44,2207,1123,1084
050,19,163,"Iowa","Scott County",4,45,2167,1115,1052
050,19,163,"Iowa","Scott County",4,46,2032,1028,1004
050,19,163,"Iowa","Scott County",4,47,2002,1027,975
050,19,163,"Iowa","Scott County",4,48,1945,968,977
050,19,163,"Iowa","Scott County",4,49,1958,994,964
050,19,163,"Iowa","Scott County",4,50,2118,1061,1057
050,19,163,"Iowa","Scott County",4,51,2218,1121,1097
050,19,163,"Iowa","Scott County",4,52,2193,1098,1095
050,19,163,"Iowa","Scott County",4,53,2096,1055,1041
050,19,163,"Iowa","Scott County",4,54,2078,1046,1032
050,19,163,"Iowa","Scott County",4,55,2119,1075,1044
050,19,163,"Iowa","Scott County",4,56,2150,1072,1078
050,19,163,"Iowa","Scott County",4,57,2117,1051,1066
050,19,163,"Iowa","Scott County",4,58,2167,1071,1096
050,19,163,"Iowa","Scott County",4,59,2189,1086,1103
050,19,163,"Iowa","Scott County",4,60,2233,1061,1172
050,19,163,"Iowa","Scott County",4,61,2328,1136,1192
050,19,163,"Iowa","Scott County",4,62,2279,1097,1182
050,19,163,"Iowa","Scott County",4,63,2247,1076,1171
050,19,163,"Iowa","Scott County",4,64,2213,1083,1130
050,19,163,"Iowa","Scott County",4,65,2201,1076,1125
050,19,163,"Iowa","Scott County",4,66,2056,1009,1047
050,19,163,"Iowa","Scott County",4,67,2034,1012,1022
050,19,163,"Iowa","Scott County",4,68,1924,931,993
050,19,163,"Iowa","Scott County",4,69,1830,881,949
050,19,163,"Iowa","Scott County",4,70,1802,863,939
050,19,163,"Iowa","Scott County",4,71,1711,823,888
050,19,163,"Iowa","Scott County",4,72,1601,767,834
050,19,163,"Iowa","Scott County",4,73,1550,710,840
050,19,163,"Iowa","Scott County",4,74,1488,698,790
050,19,163,"Iowa","Scott County",4,75,1615,781,834
050,19,163,"Iowa","Scott County",4,76,1142,538,604
050,19,163,"Iowa","Scott County",4,77,1032,484,548
050,19,163,"Iowa","Scott County",4,78,954,464,490
050,19,163,"Iowa","Scott County",4,79,968,437,531
050,19,163,"Iowa","Scott County",4,80,804,332,472
050,19,163,"Iowa","Scott County",4,81,721,307,414
050,19,163,"Iowa","Scott County",4,82,649,254,395
050,19,163,"Iowa","Scott County",4,83,618,241,377
050,19,163,"Iowa","Scott County",4,84,574,248,326
050,19,163,"Iowa","Scott County",4,85,3347,1164,2183
050,19,163,"Iowa","Scott County",5,0,1887,968,919
050,19,163,"Iowa","Scott County",5,1,1908,975,933
050,19,163,"Iowa","Scott County",5,2,1910,992,918
050,19,163,"Iowa","Scott County",5,3,2051,1045,1006
050,19,163,"Iowa","Scott County",5,4,2098,1060,1038
050,19,163,"Iowa","Scott County",5,5,2135,1065,1070
050,19,163,"Iowa","Scott County",5,6,2209,1132,1077
050,19,163,"Iowa","Scott County",5,7,2258,1126,1132
050,19,163,"Iowa","Scott County",5,8,2328,1170,1158
050,19,163,"Iowa","Scott County",5,9,2280,1152,1128
050,19,163,"Iowa","Scott County",5,10,2270,1155,1115
050,19,163,"Iowa","Scott County",5,11,2232,1162,1070
050,19,163,"Iowa","Scott County",5,12,2309,1172,1137
050,19,163,"Iowa","Scott County",5,13,2290,1185,1105
050,19,163,"Iowa","Scott County",5,14,2409,1253,1156
050,19,163,"Iowa","Scott County",5,15,2488,1231,1257
050,19,163,"Iowa","Scott County",5,16,2509,1265,1244
050,19,163,"Iowa","Scott County",5,17,2399,1221,1178
050,19,163,"Iowa","Scott County",5,18,2289,1144,1145
050,19,163,"Iowa","Scott County",5,19,2096,1080,1016
050,19,163,"Iowa","Scott County",5,20,2086,1056,1030
050,19,163,"Iowa","Scott County",5,21,2004,981,1023
050,19,163,"Iowa","Scott County",5,22,2069,1013,1056
050,19,163,"Iowa","Scott County",5,23,2165,1122,1043
050,19,163,"Iowa","Scott County",5,24,2224,1112,1112
050,19,163,"Iowa","Scott County",5,25,2123,1089,1034
050,19,163,"Iowa","Scott County",5,26,2103,1089,1014
050,19,163,"Iowa","Scott County",5,27,1994,1005,989
050,19,163,"Iowa","Scott County",5,28,2063,1049,1014
050,19,163,"Iowa","Scott County",5,29,2126,1056,1070
050,19,163,"Iowa","Scott County",5,30,2214,1074,1140
050,19,163,"Iowa","Scott County",5,31,2258,1120,1138
050,19,163,"Iowa","Scott County",5,32,2226,1099,1127
050,19,163,"Iowa","Scott County",5,33,2287,1104,1183
050,19,163,"Iowa","Scott County",5,34,2242,1073,1169
050,19,163,"Iowa","Scott County",5,35,2240,1080,1160
050,19,163,"Iowa","Scott County",5,36,2293,1160,1133
050,19,163,"Iowa","Scott County",5,37,2329,1170,1159
050,19,163,"Iowa","Scott County",5,38,2367,1170,1197
050,19,163,"Iowa","Scott County",5,39,2320,1159,1161
050,19,163,"Iowa","Scott County",5,40,2435,1238,1197
050,19,163,"Iowa","Scott County",5,41,2473,1241,1232
050,19,163,"Iowa","Scott County",5,42,2498,1263,1235
050,19,163,"Iowa","Scott County",5,43,2434,1240,1194
050,19,163,"Iowa","Scott County",5,44,2298,1184,1114
050,19,163,"Iowa","Scott County",5,45,2191,1110,1081
050,19,163,"Iowa","Scott County",5,46,2167,1112,1055
050,19,163,"Iowa","Scott County",5,47,2024,1019,1005
050,19,163,"Iowa","Scott County",5,48,2020,1018,1002
050,19,163,"Iowa","Scott County",5,49,1933,969,964
050,19,163,"Iowa","Scott County",5,50,1966,995,971
050,19,163,"Iowa","Scott County",5,51,2089,1046,1043
050,19,163,"Iowa","Scott County",5,52,2174,1087,1087
050,19,163,"Iowa","Scott County",5,53,2188,1106,1082
050,19,163,"Iowa","Scott County",5,54,2096,1053,1043
050,19,163,"Iowa","Scott County",5,55,2069,1041,1028
050,19,163,"Iowa","Scott County",5,56,2090,1068,1022
050,19,163,"Iowa","Scott County",5,57,2124,1054,1070
050,19,163,"Iowa","Scott County",5,58,2107,1043,1064
050,19,163,"Iowa","Scott County",5,59,2138,1063,1075
050,19,163,"Iowa","Scott County",5,60,2165,1084,1081
050,19,163,"Iowa","Scott County",5,61,2194,1043,1151
050,19,163,"Iowa","Scott County",5,62,2286,1109,1177
050,19,163,"Iowa","Scott County",5,63,2243,1082,1161
050,19,163,"Iowa","Scott County",5,64,2214,1058,1156
050,19,163,"Iowa","Scott County",5,65,2187,1068,1119
050,19,163,"Iowa","Scott County",5,66,2174,1061,1113
050,19,163,"Iowa","Scott County",5,67,2014,988,1026
050,19,163,"Iowa","Scott County",5,68,1972,971,1001
050,19,163,"Iowa","Scott County",5,69,1877,903,974
050,19,163,"Iowa","Scott County",5,70,1797,864,933
050,19,163,"Iowa","Scott County",5,71,1762,842,920
050,19,163,"Iowa","Scott County",5,72,1686,795,891
050,19,163,"Iowa","Scott County",5,73,1576,758,818
050,19,163,"Iowa","Scott County",5,74,1508,682,826
050,19,163,"Iowa","Scott County",5,75,1448,685,763
050,19,163,"Iowa","Scott County",5,76,1575,763,812
050,19,163,"Iowa","Scott County",5,77,1091,510,581
050,19,163,"Iowa","Scott County",5,78,1014,472,542
050,19,163,"Iowa","Scott County",5,79,911,450,461
050,19,163,"Iowa","Scott County",5,80,922,396,526
050,19,163,"Iowa","Scott County",5,81,751,315,436
050,19,163,"Iowa","Scott County",5,82,664,287,377
050,19,163,"Iowa","Scott County",5,83,628,238,390
050,19,163,"Iowa","Scott County",5,84,558,219,339
050,19,163,"Iowa","Scott County",5,85,3451,1223,2228
050,19,165,"Iowa","Shelby County",1,0,130,66,64
050,19,165,"Iowa","Shelby County",1,1,130,62,68
050,19,165,"Iowa","Shelby County",1,2,105,54,51
050,19,165,"Iowa","Shelby County",1,3,121,68,53
050,19,165,"Iowa","Shelby County",1,4,128,65,63
050,19,165,"Iowa","Shelby County",1,5,150,72,78
050,19,165,"Iowa","Shelby County",1,6,140,78,62
050,19,165,"Iowa","Shelby County",1,7,155,79,76
050,19,165,"Iowa","Shelby County",1,8,155,80,75
050,19,165,"Iowa","Shelby County",1,9,150,82,68
050,19,165,"Iowa","Shelby County",1,10,163,83,80
050,19,165,"Iowa","Shelby County",1,11,161,83,78
050,19,165,"Iowa","Shelby County",1,12,170,85,85
050,19,165,"Iowa","Shelby County",1,13,168,85,83
050,19,165,"Iowa","Shelby County",1,14,163,77,86
050,19,165,"Iowa","Shelby County",1,15,151,87,64
050,19,165,"Iowa","Shelby County",1,16,169,83,86
050,19,165,"Iowa","Shelby County",1,17,196,105,91
050,19,165,"Iowa","Shelby County",1,18,141,76,65
050,19,165,"Iowa","Shelby County",1,19,115,63,52
050,19,165,"Iowa","Shelby County",1,20,125,71,54
050,19,165,"Iowa","Shelby County",1,21,118,69,49
050,19,165,"Iowa","Shelby County",1,22,117,58,59
050,19,165,"Iowa","Shelby County",1,23,117,66,51
050,19,165,"Iowa","Shelby County",1,24,106,53,53
050,19,165,"Iowa","Shelby County",1,25,96,51,45
050,19,165,"Iowa","Shelby County",1,26,106,50,56
050,19,165,"Iowa","Shelby County",1,27,117,52,65
050,19,165,"Iowa","Shelby County",1,28,130,67,63
050,19,165,"Iowa","Shelby County",1,29,109,53,56
050,19,165,"Iowa","Shelby County",1,30,105,59,46
050,19,165,"Iowa","Shelby County",1,31,100,50,50
050,19,165,"Iowa","Shelby County",1,32,117,55,62
050,19,165,"Iowa","Shelby County",1,33,106,55,51
050,19,165,"Iowa","Shelby County",1,34,117,58,59
050,19,165,"Iowa","Shelby County",1,35,115,56,59
050,19,165,"Iowa","Shelby County",1,36,114,60,54
050,19,165,"Iowa","Shelby County",1,37,121,55,66
050,19,165,"Iowa","Shelby County",1,38,111,58,53
050,19,165,"Iowa","Shelby County",1,39,120,62,58
050,19,165,"Iowa","Shelby County",1,40,123,61,62
050,19,165,"Iowa","Shelby County",1,41,120,59,61
050,19,165,"Iowa","Shelby County",1,42,100,43,57
050,19,165,"Iowa","Shelby County",1,43,113,57,56
050,19,165,"Iowa","Shelby County",1,44,124,59,65
050,19,165,"Iowa","Shelby County",1,45,133,66,67
050,19,165,"Iowa","Shelby County",1,46,114,57,57
050,19,165,"Iowa","Shelby County",1,47,133,72,61
050,19,165,"Iowa","Shelby County",1,48,142,75,67
050,19,165,"Iowa","Shelby County",1,49,124,67,57
050,19,165,"Iowa","Shelby County",1,50,139,74,65
050,19,165,"Iowa","Shelby County",1,51,157,75,82
050,19,165,"Iowa","Shelby County",1,52,143,70,73
050,19,165,"Iowa","Shelby County",1,53,161,76,85
050,19,165,"Iowa","Shelby County",1,54,160,81,79
050,19,165,"Iowa","Shelby County",1,55,170,81,89
050,19,165,"Iowa","Shelby County",1,56,181,86,95
050,19,165,"Iowa","Shelby County",1,57,194,94,100
050,19,165,"Iowa","Shelby County",1,58,202,95,107
050,19,165,"Iowa","Shelby County",1,59,213,105,108
050,19,165,"Iowa","Shelby County",1,60,194,113,81
050,19,165,"Iowa","Shelby County",1,61,192,106,86
050,19,165,"Iowa","Shelby County",1,62,188,95,93
050,19,165,"Iowa","Shelby County",1,63,190,103,87
050,19,165,"Iowa","Shelby County",1,64,163,86,77
050,19,165,"Iowa","Shelby County",1,65,175,88,87
050,19,165,"Iowa","Shelby County",1,66,174,92,82
050,19,165,"Iowa","Shelby County",1,67,152,79,73
050,19,165,"Iowa","Shelby County",1,68,139,61,78
050,19,165,"Iowa","Shelby County",1,69,136,63,73
050,19,165,"Iowa","Shelby County",1,70,135,69,66
050,19,165,"Iowa","Shelby County",1,71,134,68,66
050,19,165,"Iowa","Shelby County",1,72,119,59,60
050,19,165,"Iowa","Shelby County",1,73,138,64,74
050,19,165,"Iowa","Shelby County",1,74,104,44,60
050,19,165,"Iowa","Shelby County",1,75,95,47,48
050,19,165,"Iowa","Shelby County",1,76,90,44,46
050,19,165,"Iowa","Shelby County",1,77,98,49,49
050,19,165,"Iowa","Shelby County",1,78,87,43,44
050,19,165,"Iowa","Shelby County",1,79,74,34,40
050,19,165,"Iowa","Shelby County",1,80,72,31,41
050,19,165,"Iowa","Shelby County",1,81,71,35,36
050,19,165,"Iowa","Shelby County",1,82,75,32,43
050,19,165,"Iowa","Shelby County",1,83,73,32,41
050,19,165,"Iowa","Shelby County",1,84,75,33,42
050,19,165,"Iowa","Shelby County",1,85,443,156,287
050,19,165,"Iowa","Shelby County",2,0,127,63,64
050,19,165,"Iowa","Shelby County",2,1,128,62,66
050,19,165,"Iowa","Shelby County",2,2,110,56,54
050,19,165,"Iowa","Shelby County",2,3,117,65,52
050,19,165,"Iowa","Shelby County",2,4,130,68,62
050,19,165,"Iowa","Shelby County",2,5,147,73,74
050,19,165,"Iowa","Shelby County",2,6,144,78,66
050,19,165,"Iowa","Shelby County",2,7,154,81,73
050,19,165,"Iowa","Shelby County",2,8,157,80,77
050,19,165,"Iowa","Shelby County",2,9,149,80,69
050,19,165,"Iowa","Shelby County",2,10,160,83,77
050,19,165,"Iowa","Shelby County",2,11,161,84,77
050,19,165,"Iowa","Shelby County",2,12,168,84,84
050,19,165,"Iowa","Shelby County",2,13,168,84,84
050,19,165,"Iowa","Shelby County",2,14,162,78,84
050,19,165,"Iowa","Shelby County",2,15,153,84,69
050,19,165,"Iowa","Shelby County",2,16,164,83,81
050,19,165,"Iowa","Shelby County",2,17,189,100,89
050,19,165,"Iowa","Shelby County",2,18,145,78,67
050,19,165,"Iowa","Shelby County",2,19,116,63,53
050,19,165,"Iowa","Shelby County",2,20,127,72,55
050,19,165,"Iowa","Shelby County",2,21,121,70,51
050,19,165,"Iowa","Shelby County",2,22,115,60,55
050,19,165,"Iowa","Shelby County",2,23,115,62,53
050,19,165,"Iowa","Shelby County",2,24,107,54,53
050,19,165,"Iowa","Shelby County",2,25,99,52,47
050,19,165,"Iowa","Shelby County",2,26,105,51,54
050,19,165,"Iowa","Shelby County",2,27,115,53,62
050,19,165,"Iowa","Shelby County",2,28,128,65,63
050,19,165,"Iowa","Shelby County",2,29,114,57,57
050,19,165,"Iowa","Shelby County",2,30,106,58,48
050,19,165,"Iowa","Shelby County",2,31,103,53,50
050,19,165,"Iowa","Shelby County",2,32,115,54,61
050,19,165,"Iowa","Shelby County",2,33,109,55,54
050,19,165,"Iowa","Shelby County",2,34,113,56,57
050,19,165,"Iowa","Shelby County",2,35,117,57,60
050,19,165,"Iowa","Shelby County",2,36,115,59,56
050,19,165,"Iowa","Shelby County",2,37,121,57,64
050,19,165,"Iowa","Shelby County",2,38,115,58,57
050,19,165,"Iowa","Shelby County",2,39,118,61,57
050,19,165,"Iowa","Shelby County",2,40,121,60,61
050,19,165,"Iowa","Shelby County",2,41,122,60,62
050,19,165,"Iowa","Shelby County",2,42,105,48,57
050,19,165,"Iowa","Shelby County",2,43,110,54,56
050,19,165,"Iowa","Shelby County",2,44,121,59,62
050,19,165,"Iowa","Shelby County",2,45,130,63,67
050,19,165,"Iowa","Shelby County",2,46,118,59,59
050,19,165,"Iowa","Shelby County",2,47,128,68,60
050,19,165,"Iowa","Shelby County",2,48,140,74,66
050,19,165,"Iowa","Shelby County",2,49,128,68,60
050,19,165,"Iowa","Shelby County",2,50,136,72,64
050,19,165,"Iowa","Shelby County",2,51,149,73,76
050,19,165,"Iowa","Shelby County",2,52,145,72,73
050,19,165,"Iowa","Shelby County",2,53,156,74,82
050,19,165,"Iowa","Shelby County",2,54,160,79,81
050,19,165,"Iowa","Shelby County",2,55,169,82,87
050,19,165,"Iowa","Shelby County",2,56,179,85,94
050,19,165,"Iowa","Shelby County",2,57,188,90,98
050,19,165,"Iowa","Shelby County",2,58,199,94,105
050,19,165,"Iowa","Shelby County",2,59,210,102,108
050,19,165,"Iowa","Shelby County",2,60,194,107,87
050,19,165,"Iowa","Shelby County",2,61,191,106,85
050,19,165,"Iowa","Shelby County",2,62,190,98,92
050,19,165,"Iowa","Shelby County",2,63,190,100,90
050,19,165,"Iowa","Shelby County",2,64,169,90,79
050,19,165,"Iowa","Shelby County",2,65,171,87,84
050,19,165,"Iowa","Shelby County",2,66,175,91,84
050,19,165,"Iowa","Shelby County",2,67,157,83,74
050,19,165,"Iowa","Shelby County",2,68,140,64,76
050,19,165,"Iowa","Shelby County",2,69,136,62,74
050,19,165,"Iowa","Shelby County",2,70,134,67,67
050,19,165,"Iowa","Shelby County",2,71,135,69,66
050,19,165,"Iowa","Shelby County",2,72,120,60,60
050,19,165,"Iowa","Shelby County",2,73,140,65,75
050,19,165,"Iowa","Shelby County",2,74,107,46,61
050,19,165,"Iowa","Shelby County",2,75,96,46,50
050,19,165,"Iowa","Shelby County",2,76,91,44,47
050,19,165,"Iowa","Shelby County",2,77,98,49,49
050,19,165,"Iowa","Shelby County",2,78,88,43,45
050,19,165,"Iowa","Shelby County",2,79,75,35,40
050,19,165,"Iowa","Shelby County",2,80,72,31,41
050,19,165,"Iowa","Shelby County",2,81,69,32,37
050,19,165,"Iowa","Shelby County",2,82,72,33,39
050,19,165,"Iowa","Shelby County",2,83,73,32,41
050,19,165,"Iowa","Shelby County",2,84,68,30,38
050,19,165,"Iowa","Shelby County",2,85,443,157,286
050,19,165,"Iowa","Shelby County",3,0,93,44,49
050,19,165,"Iowa","Shelby County",3,1,143,75,68
050,19,165,"Iowa","Shelby County",3,2,132,64,68
050,19,165,"Iowa","Shelby County",3,3,134,65,69
050,19,165,"Iowa","Shelby County",3,4,138,72,66
050,19,165,"Iowa","Shelby County",3,5,132,72,60
050,19,165,"Iowa","Shelby County",3,6,160,78,82
050,19,165,"Iowa","Shelby County",3,7,152,85,67
050,19,165,"Iowa","Shelby County",3,8,161,87,74
050,19,165,"Iowa","Shelby County",3,9,157,78,79
050,19,165,"Iowa","Shelby County",3,10,152,80,72
050,19,165,"Iowa","Shelby County",3,11,166,84,82
050,19,165,"Iowa","Shelby County",3,12,160,85,75
050,19,165,"Iowa","Shelby County",3,13,167,81,86
050,19,165,"Iowa","Shelby County",3,14,166,82,84
050,19,165,"Iowa","Shelby County",3,15,164,81,83
050,19,165,"Iowa","Shelby County",3,16,153,84,69
050,19,165,"Iowa","Shelby County",3,17,161,80,81
050,19,165,"Iowa","Shelby County",3,18,159,83,76
050,19,165,"Iowa","Shelby County",3,19,112,64,48
050,19,165,"Iowa","Shelby County",3,20,135,71,64
050,19,165,"Iowa","Shelby County",3,21,131,73,58
050,19,165,"Iowa","Shelby County",3,22,122,65,57
050,19,165,"Iowa","Shelby County",3,23,112,58,54
050,19,165,"Iowa","Shelby County",3,24,109,60,49
050,19,165,"Iowa","Shelby County",3,25,109,53,56
050,19,165,"Iowa","Shelby County",3,26,106,56,50
050,19,165,"Iowa","Shelby County",3,27,106,52,54
050,19,165,"Iowa","Shelby County",3,28,125,59,66
050,19,165,"Iowa","Shelby County",3,29,111,63,48
050,19,165,"Iowa","Shelby County",3,30,117,60,57
050,19,165,"Iowa","Shelby County",3,31,112,61,51
050,19,165,"Iowa","Shelby County",3,32,111,51,60
050,19,165,"Iowa","Shelby County",3,33,117,52,65
050,19,165,"Iowa","Shelby County",3,34,117,59,58
050,19,165,"Iowa","Shelby County",3,35,110,53,57
050,19,165,"Iowa","Shelby County",3,36,125,63,62
050,19,165,"Iowa","Shelby County",3,37,126,65,61
050,19,165,"Iowa","Shelby County",3,38,131,62,69
050,19,165,"Iowa","Shelby County",3,39,119,59,60
050,19,165,"Iowa","Shelby County",3,40,122,66,56
050,19,165,"Iowa","Shelby County",3,41,122,58,64
050,19,165,"Iowa","Shelby County",3,42,125,62,63
050,19,165,"Iowa","Shelby County",3,43,104,49,55
050,19,165,"Iowa","Shelby County",3,44,106,52,54
050,19,165,"Iowa","Shelby County",3,45,124,61,63
050,19,165,"Iowa","Shelby County",3,46,129,62,67
050,19,165,"Iowa","Shelby County",3,47,115,59,56
050,19,165,"Iowa","Shelby County",3,48,131,71,60
050,19,165,"Iowa","Shelby County",3,49,139,73,66
050,19,165,"Iowa","Shelby County",3,50,130,70,60
050,19,165,"Iowa","Shelby County",3,51,132,73,59
050,19,165,"Iowa","Shelby County",3,52,146,73,73
050,19,165,"Iowa","Shelby County",3,53,145,74,71
050,19,165,"Iowa","Shelby County",3,54,154,72,82
050,19,165,"Iowa","Shelby County",3,55,156,75,81
050,19,165,"Iowa","Shelby County",3,56,165,82,83
050,19,165,"Iowa","Shelby County",3,57,171,80,91
050,19,165,"Iowa","Shelby County",3,58,189,88,101
050,19,165,"Iowa","Shelby County",3,59,203,96,107
050,19,165,"Iowa","Shelby County",3,60,208,100,108
050,19,165,"Iowa","Shelby County",3,61,191,103,88
050,19,165,"Iowa","Shelby County",3,62,187,103,84
050,19,165,"Iowa","Shelby County",3,63,185,93,92
050,19,165,"Iowa","Shelby County",3,64,190,100,90
050,19,165,"Iowa","Shelby County",3,65,161,85,76
050,19,165,"Iowa","Shelby County",3,66,165,84,81
050,19,165,"Iowa","Shelby County",3,67,179,96,83
050,19,165,"Iowa","Shelby County",3,68,147,76,71
050,19,165,"Iowa","Shelby County",3,69,137,62,75
050,19,165,"Iowa","Shelby County",3,70,131,59,72
050,19,165,"Iowa","Shelby County",3,71,138,68,70
050,19,165,"Iowa","Shelby County",3,72,132,64,68
050,19,165,"Iowa","Shelby County",3,73,123,62,61
050,19,165,"Iowa","Shelby County",3,74,142,65,77
050,19,165,"Iowa","Shelby County",3,75,99,41,58
050,19,165,"Iowa","Shelby County",3,76,93,41,52
050,19,165,"Iowa","Shelby County",3,77,92,46,46
050,19,165,"Iowa","Shelby County",3,78,95,48,47
050,19,165,"Iowa","Shelby County",3,79,83,39,44
050,19,165,"Iowa","Shelby County",3,80,68,29,39
050,19,165,"Iowa","Shelby County",3,81,66,29,37
050,19,165,"Iowa","Shelby County",3,82,68,35,33
050,19,165,"Iowa","Shelby County",3,83,77,34,43
050,19,165,"Iowa","Shelby County",3,84,63,31,32
050,19,165,"Iowa","Shelby County",3,85,439,158,281
050,19,165,"Iowa","Shelby County",4,0,116,56,60
050,19,165,"Iowa","Shelby County",4,1,96,50,46
050,19,165,"Iowa","Shelby County",4,2,140,75,65
050,19,165,"Iowa","Shelby County",4,3,131,64,67
050,19,165,"Iowa","Shelby County",4,4,133,65,68
050,19,165,"Iowa","Shelby County",4,5,134,75,59
050,19,165,"Iowa","Shelby County",4,6,139,74,65
050,19,165,"Iowa","Shelby County",4,7,168,84,84
050,19,165,"Iowa","Shelby County",4,8,150,83,67
050,19,165,"Iowa","Shelby County",4,9,165,91,74
050,19,165,"Iowa","Shelby County",4,10,154,78,76
050,19,165,"Iowa","Shelby County",4,11,140,76,64
050,19,165,"Iowa","Shelby County",4,12,161,83,78
050,19,165,"Iowa","Shelby County",4,13,163,94,69
050,19,165,"Iowa","Shelby County",4,14,164,77,87
050,19,165,"Iowa","Shelby County",4,15,168,80,88
050,19,165,"Iowa","Shelby County",4,16,163,80,83
050,19,165,"Iowa","Shelby County",4,17,156,87,69
050,19,165,"Iowa","Shelby County",4,18,134,69,65
050,19,165,"Iowa","Shelby County",4,19,124,66,58
050,19,165,"Iowa","Shelby County",4,20,107,60,47
050,19,165,"Iowa","Shelby County",4,21,130,73,57
050,19,165,"Iowa","Shelby County",4,22,121,66,55
050,19,165,"Iowa","Shelby County",4,23,121,64,57
050,19,165,"Iowa","Shelby County",4,24,101,56,45
050,19,165,"Iowa","Shelby County",4,25,103,54,49
050,19,165,"Iowa","Shelby County",4,26,104,50,54
050,19,165,"Iowa","Shelby County",4,27,104,55,49
050,19,165,"Iowa","Shelby County",4,28,108,55,53
050,19,165,"Iowa","Shelby County",4,29,123,51,72
050,19,165,"Iowa","Shelby County",4,30,120,70,50
050,19,165,"Iowa","Shelby County",4,31,131,69,62
050,19,165,"Iowa","Shelby County",4,32,115,62,53
050,19,165,"Iowa","Shelby County",4,33,109,50,59
050,19,165,"Iowa","Shelby County",4,34,117,54,63
050,19,165,"Iowa","Shelby County",4,35,117,56,61
050,19,165,"Iowa","Shelby County",4,36,115,50,65
050,19,165,"Iowa","Shelby County",4,37,133,67,66
050,19,165,"Iowa","Shelby County",4,38,122,61,61
050,19,165,"Iowa","Shelby County",4,39,140,72,68
050,19,165,"Iowa","Shelby County",4,40,119,57,62
050,19,165,"Iowa","Shelby County",4,41,129,68,61
050,19,165,"Iowa","Shelby County",4,42,126,61,65
050,19,165,"Iowa","Shelby County",4,43,127,61,66
050,19,165,"Iowa","Shelby County",4,44,113,56,57
050,19,165,"Iowa","Shelby County",4,45,109,52,57
050,19,165,"Iowa","Shelby County",4,46,118,58,60
050,19,165,"Iowa","Shelby County",4,47,136,65,71
050,19,165,"Iowa","Shelby County",4,48,110,56,54
050,19,165,"Iowa","Shelby County",4,49,129,68,61
050,19,165,"Iowa","Shelby County",4,50,141,74,67
050,19,165,"Iowa","Shelby County",4,51,125,66,59
050,19,165,"Iowa","Shelby County",4,52,136,73,63
050,19,165,"Iowa","Shelby County",4,53,145,72,73
050,19,165,"Iowa","Shelby County",4,54,148,73,75
050,19,165,"Iowa","Shelby County",4,55,154,72,82
050,19,165,"Iowa","Shelby County",4,56,147,72,75
050,19,165,"Iowa","Shelby County",4,57,164,81,83
050,19,165,"Iowa","Shelby County",4,58,174,83,91
050,19,165,"Iowa","Shelby County",4,59,195,86,109
050,19,165,"Iowa","Shelby County",4,60,205,96,109
050,19,165,"Iowa","Shelby County",4,61,209,99,110
050,19,165,"Iowa","Shelby County",4,62,185,103,82
050,19,165,"Iowa","Shelby County",4,63,186,101,85
050,19,165,"Iowa","Shelby County",4,64,182,93,89
050,19,165,"Iowa","Shelby County",4,65,187,98,89
050,19,165,"Iowa","Shelby County",4,66,161,83,78
050,19,165,"Iowa","Shelby County",4,67,163,86,77
050,19,165,"Iowa","Shelby County",4,68,164,86,78
050,19,165,"Iowa","Shelby County",4,69,147,77,70
050,19,165,"Iowa","Shelby County",4,70,132,58,74
050,19,165,"Iowa","Shelby County",4,71,130,59,71
050,19,165,"Iowa","Shelby County",4,72,130,67,63
050,19,165,"Iowa","Shelby County",4,73,133,62,71
050,19,165,"Iowa","Shelby County",4,74,124,60,64
050,19,165,"Iowa","Shelby County",4,75,138,65,73
050,19,165,"Iowa","Shelby County",4,76,101,40,61
050,19,165,"Iowa","Shelby County",4,77,98,43,55
050,19,165,"Iowa","Shelby County",4,78,89,45,44
050,19,165,"Iowa","Shelby County",4,79,86,42,44
050,19,165,"Iowa","Shelby County",4,80,79,34,45
050,19,165,"Iowa","Shelby County",4,81,59,28,31
050,19,165,"Iowa","Shelby County",4,82,62,29,33
050,19,165,"Iowa","Shelby County",4,83,70,36,34
050,19,165,"Iowa","Shelby County",4,84,71,32,39
050,19,165,"Iowa","Shelby County",4,85,435,161,274
050,19,165,"Iowa","Shelby County",5,0,112,57,55
050,19,165,"Iowa","Shelby County",5,1,119,53,66
050,19,165,"Iowa","Shelby County",5,2,110,57,53
050,19,165,"Iowa","Shelby County",5,3,143,77,66
050,19,165,"Iowa","Shelby County",5,4,137,66,71
050,19,165,"Iowa","Shelby County",5,5,140,69,71
050,19,165,"Iowa","Shelby County",5,6,140,77,63
050,19,165,"Iowa","Shelby County",5,7,145,75,70
050,19,165,"Iowa","Shelby County",5,8,174,83,91
050,19,165,"Iowa","Shelby County",5,9,152,83,69
050,19,165,"Iowa","Shelby County",5,10,163,92,71
050,19,165,"Iowa","Shelby County",5,11,157,79,78
050,19,165,"Iowa","Shelby County",5,12,149,81,68
050,19,165,"Iowa","Shelby County",5,13,171,92,79
050,19,165,"Iowa","Shelby County",5,14,170,96,74
050,19,165,"Iowa","Shelby County",5,15,164,78,86
050,19,165,"Iowa","Shelby County",5,16,165,80,85
050,19,165,"Iowa","Shelby County",5,17,162,80,82
050,19,165,"Iowa","Shelby County",5,18,129,78,51
050,19,165,"Iowa","Shelby County",5,19,99,49,50
050,19,165,"Iowa","Shelby County",5,20,131,67,64
050,19,165,"Iowa","Shelby County",5,21,118,66,52
050,19,165,"Iowa","Shelby County",5,22,129,77,52
050,19,165,"Iowa","Shelby County",5,23,122,65,57
050,19,165,"Iowa","Shelby County",5,24,115,60,55
050,19,165,"Iowa","Shelby County",5,25,91,55,36
050,19,165,"Iowa","Shelby County",5,26,103,52,51
050,19,165,"Iowa","Shelby County",5,27,118,56,62
050,19,165,"Iowa","Shelby County",5,28,111,59,52
050,19,165,"Iowa","Shelby County",5,29,118,61,57
050,19,165,"Iowa","Shelby County",5,30,128,53,75
050,19,165,"Iowa","Shelby County",5,31,132,75,57
050,19,165,"Iowa","Shelby County",5,32,130,65,65
050,19,165,"Iowa","Shelby County",5,33,112,59,53
050,19,165,"Iowa","Shelby County",5,34,114,52,62
050,19,165,"Iowa","Shelby County",5,35,128,61,67
050,19,165,"Iowa","Shelby County",5,36,136,60,76
050,19,165,"Iowa","Shelby County",5,37,120,54,66
050,19,165,"Iowa","Shelby County",5,38,135,69,66
050,19,165,"Iowa","Shelby County",5,39,145,82,63
050,19,165,"Iowa","Shelby County",5,40,142,75,67
050,19,165,"Iowa","Shelby County",5,41,125,61,64
050,19,165,"Iowa","Shelby County",5,42,130,69,61
050,19,165,"Iowa","Shelby County",5,43,127,63,64
050,19,165,"Iowa","Shelby County",5,44,130,64,66
050,19,165,"Iowa","Shelby County",5,45,116,58,58
050,19,165,"Iowa","Shelby County",5,46,111,52,59
050,19,165,"Iowa","Shelby County",5,47,119,62,57
050,19,165,"Iowa","Shelby County",5,48,141,63,78
050,19,165,"Iowa","Shelby County",5,49,107,55,52
050,19,165,"Iowa","Shelby County",5,50,129,66,63
050,19,165,"Iowa","Shelby County",5,51,146,75,71
050,19,165,"Iowa","Shelby County",5,52,126,66,60
050,19,165,"Iowa","Shelby County",5,53,133,65,68
050,19,165,"Iowa","Shelby County",5,54,140,69,71
050,19,165,"Iowa","Shelby County",5,55,143,74,69
050,19,165,"Iowa","Shelby County",5,56,154,71,83
050,19,165,"Iowa","Shelby County",5,57,147,71,76
050,19,165,"Iowa","Shelby County",5,58,163,78,85
050,19,165,"Iowa","Shelby County",5,59,172,79,93
050,19,165,"Iowa","Shelby County",5,60,200,87,113
050,19,165,"Iowa","Shelby County",5,61,207,97,110
050,19,165,"Iowa","Shelby County",5,62,200,96,104
050,19,165,"Iowa","Shelby County",5,63,184,104,80
050,19,165,"Iowa","Shelby County",5,64,179,100,79
050,19,165,"Iowa","Shelby County",5,65,180,89,91
050,19,165,"Iowa","Shelby County",5,66,179,91,88
050,19,165,"Iowa","Shelby County",5,67,159,86,73
050,19,165,"Iowa","Shelby County",5,68,155,79,76
050,19,165,"Iowa","Shelby County",5,69,162,86,76
050,19,165,"Iowa","Shelby County",5,70,146,76,70
050,19,165,"Iowa","Shelby County",5,71,128,56,72
050,19,165,"Iowa","Shelby County",5,72,120,56,64
050,19,165,"Iowa","Shelby County",5,73,132,67,65
050,19,165,"Iowa","Shelby County",5,74,132,60,72
050,19,165,"Iowa","Shelby County",5,75,121,59,62
050,19,165,"Iowa","Shelby County",5,76,131,57,74
050,19,165,"Iowa","Shelby County",5,77,98,39,59
050,19,165,"Iowa","Shelby County",5,78,95,42,53
050,19,165,"Iowa","Shelby County",5,79,83,39,44
050,19,165,"Iowa","Shelby County",5,80,79,33,46
050,19,165,"Iowa","Shelby County",5,81,69,30,39
050,19,165,"Iowa","Shelby County",5,82,57,29,28
050,19,165,"Iowa","Shelby County",5,83,61,28,33
050,19,165,"Iowa","Shelby County",5,84,63,33,30
050,19,165,"Iowa","Shelby County",5,85,448,168,280
050,19,167,"Iowa","Sioux County",1,0,519,264,255
050,19,167,"Iowa","Sioux County",1,1,504,255,249
050,19,167,"Iowa","Sioux County",1,2,527,258,269
050,19,167,"Iowa","Sioux County",1,3,507,282,225
050,19,167,"Iowa","Sioux County",1,4,498,263,235
050,19,167,"Iowa","Sioux County",1,5,535,283,252
050,19,167,"Iowa","Sioux County",1,6,542,272,270
050,19,167,"Iowa","Sioux County",1,7,529,270,259
050,19,167,"Iowa","Sioux County",1,8,527,267,260
050,19,167,"Iowa","Sioux County",1,9,548,301,247
050,19,167,"Iowa","Sioux County",1,10,570,305,265
050,19,167,"Iowa","Sioux County",1,11,590,307,283
050,19,167,"Iowa","Sioux County",1,12,627,313,314
050,19,167,"Iowa","Sioux County",1,13,604,305,299
050,19,167,"Iowa","Sioux County",1,14,575,269,306
050,19,167,"Iowa","Sioux County",1,15,582,281,301
050,19,167,"Iowa","Sioux County",1,16,573,292,281
050,19,167,"Iowa","Sioux County",1,17,548,275,273
050,19,167,"Iowa","Sioux County",1,18,674,334,340
050,19,167,"Iowa","Sioux County",1,19,921,454,467
050,19,167,"Iowa","Sioux County",1,20,871,441,430
050,19,167,"Iowa","Sioux County",1,21,808,384,424
050,19,167,"Iowa","Sioux County",1,22,617,319,298
050,19,167,"Iowa","Sioux County",1,23,439,227,212
050,19,167,"Iowa","Sioux County",1,24,393,200,193
050,19,167,"Iowa","Sioux County",1,25,384,194,190
050,19,167,"Iowa","Sioux County",1,26,400,216,184
050,19,167,"Iowa","Sioux County",1,27,376,211,165
050,19,167,"Iowa","Sioux County",1,28,385,200,185
050,19,167,"Iowa","Sioux County",1,29,386,200,186
050,19,167,"Iowa","Sioux County",1,30,354,181,173
050,19,167,"Iowa","Sioux County",1,31,333,181,152
050,19,167,"Iowa","Sioux County",1,32,377,187,190
050,19,167,"Iowa","Sioux County",1,33,370,186,184
050,19,167,"Iowa","Sioux County",1,34,416,214,202
050,19,167,"Iowa","Sioux County",1,35,438,229,209
050,19,167,"Iowa","Sioux County",1,36,453,240,213
050,19,167,"Iowa","Sioux County",1,37,438,246,192
050,19,167,"Iowa","Sioux County",1,38,449,241,208
050,19,167,"Iowa","Sioux County",1,39,442,224,218
050,19,167,"Iowa","Sioux County",1,40,425,209,216
050,19,167,"Iowa","Sioux County",1,41,439,220,219
050,19,167,"Iowa","Sioux County",1,42,418,212,206
050,19,167,"Iowa","Sioux County",1,43,394,208,186
050,19,167,"Iowa","Sioux County",1,44,336,180,156
050,19,167,"Iowa","Sioux County",1,45,360,192,168
050,19,167,"Iowa","Sioux County",1,46,330,160,170
050,19,167,"Iowa","Sioux County",1,47,308,161,147
050,19,167,"Iowa","Sioux County",1,48,354,179,175
050,19,167,"Iowa","Sioux County",1,49,373,184,189
050,19,167,"Iowa","Sioux County",1,50,355,193,162
050,19,167,"Iowa","Sioux County",1,51,369,199,170
050,19,167,"Iowa","Sioux County",1,52,343,181,162
050,19,167,"Iowa","Sioux County",1,53,345,178,167
050,19,167,"Iowa","Sioux County",1,54,351,171,180
050,19,167,"Iowa","Sioux County",1,55,386,201,185
050,19,167,"Iowa","Sioux County",1,56,392,211,181
050,19,167,"Iowa","Sioux County",1,57,406,217,189
050,19,167,"Iowa","Sioux County",1,58,417,216,201
050,19,167,"Iowa","Sioux County",1,59,411,219,192
050,19,167,"Iowa","Sioux County",1,60,435,221,214
050,19,167,"Iowa","Sioux County",1,61,443,219,224
050,19,167,"Iowa","Sioux County",1,62,432,234,198
050,19,167,"Iowa","Sioux County",1,63,405,206,199
050,19,167,"Iowa","Sioux County",1,64,383,192,191
050,19,167,"Iowa","Sioux County",1,65,369,179,190
050,19,167,"Iowa","Sioux County",1,66,361,177,184
050,19,167,"Iowa","Sioux County",1,67,362,183,179
050,19,167,"Iowa","Sioux County",1,68,348,183,165
050,19,167,"Iowa","Sioux County",1,69,325,171,154
050,19,167,"Iowa","Sioux County",1,70,293,145,148
050,19,167,"Iowa","Sioux County",1,71,260,126,134
050,19,167,"Iowa","Sioux County",1,72,256,127,129
050,19,167,"Iowa","Sioux County",1,73,246,114,132
050,19,167,"Iowa","Sioux County",1,74,175,90,85
050,19,167,"Iowa","Sioux County",1,75,188,88,100
050,19,167,"Iowa","Sioux County",1,76,198,88,110
050,19,167,"Iowa","Sioux County",1,77,208,95,113
050,19,167,"Iowa","Sioux County",1,78,181,83,98
050,19,167,"Iowa","Sioux County",1,79,168,70,98
050,19,167,"Iowa","Sioux County",1,80,172,72,100
050,19,167,"Iowa","Sioux County",1,81,154,66,88
050,19,167,"Iowa","Sioux County",1,82,151,62,89
050,19,167,"Iowa","Sioux County",1,83,132,53,79
050,19,167,"Iowa","Sioux County",1,84,138,56,82
050,19,167,"Iowa","Sioux County",1,85,939,311,628
050,19,167,"Iowa","Sioux County",2,0,498,260,238
050,19,167,"Iowa","Sioux County",2,1,507,258,249
050,19,167,"Iowa","Sioux County",2,2,520,257,263
050,19,167,"Iowa","Sioux County",2,3,510,277,233
050,19,167,"Iowa","Sioux County",2,4,505,270,235
050,19,167,"Iowa","Sioux County",2,5,525,276,249
050,19,167,"Iowa","Sioux County",2,6,539,274,265
050,19,167,"Iowa","Sioux County",2,7,530,269,261
050,19,167,"Iowa","Sioux County",2,8,527,269,258
050,19,167,"Iowa","Sioux County",2,9,541,291,250
050,19,167,"Iowa","Sioux County",2,10,561,302,259
050,19,167,"Iowa","Sioux County",2,11,585,305,280
050,19,167,"Iowa","Sioux County",2,12,624,315,309
050,19,167,"Iowa","Sioux County",2,13,612,309,303
050,19,167,"Iowa","Sioux County",2,14,584,280,304
050,19,167,"Iowa","Sioux County",2,15,582,278,304
050,19,167,"Iowa","Sioux County",2,16,573,288,285
050,19,167,"Iowa","Sioux County",2,17,555,279,276
050,19,167,"Iowa","Sioux County",2,18,666,326,340
050,19,167,"Iowa","Sioux County",2,19,926,456,470
050,19,167,"Iowa","Sioux County",2,20,875,443,432
050,19,167,"Iowa","Sioux County",2,21,809,386,423
050,19,167,"Iowa","Sioux County",2,22,614,315,299
050,19,167,"Iowa","Sioux County",2,23,441,226,215
050,19,167,"Iowa","Sioux County",2,24,397,202,195
050,19,167,"Iowa","Sioux County",2,25,386,195,191
050,19,167,"Iowa","Sioux County",2,26,399,212,187
050,19,167,"Iowa","Sioux County",2,27,380,210,170
050,19,167,"Iowa","Sioux County",2,28,384,205,179
050,19,167,"Iowa","Sioux County",2,29,385,199,186
050,19,167,"Iowa","Sioux County",2,30,366,186,180
050,19,167,"Iowa","Sioux County",2,31,338,180,158
050,19,167,"Iowa","Sioux County",2,32,363,182,181
050,19,167,"Iowa","Sioux County",2,33,372,186,186
050,19,167,"Iowa","Sioux County",2,34,402,206,196
050,19,167,"Iowa","Sioux County",2,35,437,228,209
050,19,167,"Iowa","Sioux County",2,36,447,236,211
050,19,167,"Iowa","Sioux County",2,37,445,246,199
050,19,167,"Iowa","Sioux County",2,38,449,244,205
050,19,167,"Iowa","Sioux County",2,39,444,227,217
050,19,167,"Iowa","Sioux County",2,40,430,213,217
050,19,167,"Iowa","Sioux County",2,41,434,216,218
050,19,167,"Iowa","Sioux County",2,42,422,214,208
050,19,167,"Iowa","Sioux County",2,43,403,211,192
050,19,167,"Iowa","Sioux County",2,44,346,185,161
050,19,167,"Iowa","Sioux County",2,45,356,191,165
050,19,167,"Iowa","Sioux County",2,46,335,167,168
050,19,167,"Iowa","Sioux County",2,47,314,162,152
050,19,167,"Iowa","Sioux County",2,48,344,175,169
050,19,167,"Iowa","Sioux County",2,49,368,182,186
050,19,167,"Iowa","Sioux County",2,50,361,192,169
050,19,167,"Iowa","Sioux County",2,51,365,197,168
050,19,167,"Iowa","Sioux County",2,52,347,185,162
050,19,167,"Iowa","Sioux County",2,53,345,179,166
050,19,167,"Iowa","Sioux County",2,54,348,172,176
050,19,167,"Iowa","Sioux County",2,55,379,194,185
050,19,167,"Iowa","Sioux County",2,56,390,209,181
050,19,167,"Iowa","Sioux County",2,57,401,215,186
050,19,167,"Iowa","Sioux County",2,58,415,217,198
050,19,167,"Iowa","Sioux County",2,59,414,219,195
050,19,167,"Iowa","Sioux County",2,60,431,221,210
050,19,167,"Iowa","Sioux County",2,61,439,220,219
050,19,167,"Iowa","Sioux County",2,62,435,231,204
050,19,167,"Iowa","Sioux County",2,63,417,215,202
050,19,167,"Iowa","Sioux County",2,64,384,194,190
050,19,167,"Iowa","Sioux County",2,65,368,181,187
050,19,167,"Iowa","Sioux County",2,66,361,177,184
050,19,167,"Iowa","Sioux County",2,67,358,178,180
050,19,167,"Iowa","Sioux County",2,68,346,182,164
050,19,167,"Iowa","Sioux County",2,69,333,175,158
050,19,167,"Iowa","Sioux County",2,70,298,150,148
050,19,167,"Iowa","Sioux County",2,71,269,131,138
050,19,167,"Iowa","Sioux County",2,72,254,125,129
050,19,167,"Iowa","Sioux County",2,73,260,122,138
050,19,167,"Iowa","Sioux County",2,74,177,89,88
050,19,167,"Iowa","Sioux County",2,75,185,89,96
050,19,167,"Iowa","Sioux County",2,76,194,88,106
050,19,167,"Iowa","Sioux County",2,77,211,96,115
050,19,167,"Iowa","Sioux County",2,78,182,83,99
050,19,167,"Iowa","Sioux County",2,79,172,74,98
050,19,167,"Iowa","Sioux County",2,80,174,72,102
050,19,167,"Iowa","Sioux County",2,81,156,67,89
050,19,167,"Iowa","Sioux County",2,82,152,62,90
050,19,167,"Iowa","Sioux County",2,83,137,55,82
050,19,167,"Iowa","Sioux County",2,84,134,54,80
050,19,167,"Iowa","Sioux County",2,85,938,309,629
050,19,167,"Iowa","Sioux County",3,0,484,226,258
050,19,167,"Iowa","Sioux County",3,1,534,275,259
050,19,167,"Iowa","Sioux County",3,2,518,266,252
050,19,167,"Iowa","Sioux County",3,3,526,263,263
050,19,167,"Iowa","Sioux County",3,4,513,276,237
050,19,167,"Iowa","Sioux County",3,5,510,270,240
050,19,167,"Iowa","Sioux County",3,6,538,278,260
050,19,167,"Iowa","Sioux County",3,7,549,279,270
050,19,167,"Iowa","Sioux County",3,8,532,271,261
050,19,167,"Iowa","Sioux County",3,9,532,271,261
050,19,167,"Iowa","Sioux County",3,10,544,288,256
050,19,167,"Iowa","Sioux County",3,11,559,303,256
050,19,167,"Iowa","Sioux County",3,12,592,311,281
050,19,167,"Iowa","Sioux County",3,13,628,312,316
050,19,167,"Iowa","Sioux County",3,14,600,307,293
050,19,167,"Iowa","Sioux County",3,15,593,285,308
050,19,167,"Iowa","Sioux County",3,16,584,280,304
050,19,167,"Iowa","Sioux County",3,17,568,283,285
050,19,167,"Iowa","Sioux County",3,18,673,319,354
050,19,167,"Iowa","Sioux County",3,19,925,448,477
050,19,167,"Iowa","Sioux County",3,20,880,451,429
050,19,167,"Iowa","Sioux County",3,21,804,397,407
050,19,167,"Iowa","Sioux County",3,22,619,312,307
050,19,167,"Iowa","Sioux County",3,23,420,221,199
050,19,167,"Iowa","Sioux County",3,24,399,189,210
050,19,167,"Iowa","Sioux County",3,25,385,194,191
050,19,167,"Iowa","Sioux County",3,26,380,194,186
050,19,167,"Iowa","Sioux County",3,27,389,202,187
050,19,167,"Iowa","Sioux County",3,28,393,215,178
050,19,167,"Iowa","Sioux County",3,29,379,195,184
050,19,167,"Iowa","Sioux County",3,30,381,195,186
050,19,167,"Iowa","Sioux County",3,31,367,188,179
050,19,167,"Iowa","Sioux County",3,32,338,177,161
050,19,167,"Iowa","Sioux County",3,33,362,183,179
050,19,167,"Iowa","Sioux County",3,34,372,192,180
050,19,167,"Iowa","Sioux County",3,35,406,213,193
050,19,167,"Iowa","Sioux County",3,36,438,227,211
050,19,167,"Iowa","Sioux County",3,37,446,234,212
050,19,167,"Iowa","Sioux County",3,38,455,247,208
050,19,167,"Iowa","Sioux County",3,39,465,245,220
050,19,167,"Iowa","Sioux County",3,40,446,229,217
050,19,167,"Iowa","Sioux County",3,41,432,213,219
050,19,167,"Iowa","Sioux County",3,42,432,222,210
050,19,167,"Iowa","Sioux County",3,43,426,217,209
050,19,167,"Iowa","Sioux County",3,44,396,204,192
050,19,167,"Iowa","Sioux County",3,45,346,184,162
050,19,167,"Iowa","Sioux County",3,46,349,187,162
050,19,167,"Iowa","Sioux County",3,47,333,169,164
050,19,167,"Iowa","Sioux County",3,48,318,165,153
050,19,167,"Iowa","Sioux County",3,49,335,170,165
050,19,167,"Iowa","Sioux County",3,50,357,179,178
050,19,167,"Iowa","Sioux County",3,51,364,194,170
050,19,167,"Iowa","Sioux County",3,52,364,197,167
050,19,167,"Iowa","Sioux County",3,53,347,186,161
050,19,167,"Iowa","Sioux County",3,54,339,176,163
050,19,167,"Iowa","Sioux County",3,55,352,173,179
050,19,167,"Iowa","Sioux County",3,56,371,190,181
050,19,167,"Iowa","Sioux County",3,57,383,208,175
050,19,167,"Iowa","Sioux County",3,58,403,218,185
050,19,167,"Iowa","Sioux County",3,59,403,204,199
050,19,167,"Iowa","Sioux County",3,60,416,217,199
050,19,167,"Iowa","Sioux County",3,61,421,217,204
050,19,167,"Iowa","Sioux County",3,62,442,227,215
050,19,167,"Iowa","Sioux County",3,63,434,225,209
050,19,167,"Iowa","Sioux County",3,64,414,216,198
050,19,167,"Iowa","Sioux County",3,65,379,194,185
050,19,167,"Iowa","Sioux County",3,66,367,183,184
050,19,167,"Iowa","Sioux County",3,67,356,175,181
050,19,167,"Iowa","Sioux County",3,68,339,168,171
050,19,167,"Iowa","Sioux County",3,69,343,181,162
050,19,167,"Iowa","Sioux County",3,70,330,172,158
050,19,167,"Iowa","Sioux County",3,71,290,145,145
050,19,167,"Iowa","Sioux County",3,72,266,128,138
050,19,167,"Iowa","Sioux County",3,73,248,122,126
050,19,167,"Iowa","Sioux County",3,74,246,116,130
050,19,167,"Iowa","Sioux County",3,75,178,86,92
050,19,167,"Iowa","Sioux County",3,76,184,90,94
050,19,167,"Iowa","Sioux County",3,77,187,79,108
050,19,167,"Iowa","Sioux County",3,78,196,88,108
050,19,167,"Iowa","Sioux County",3,79,177,79,98
050,19,167,"Iowa","Sioux County",3,80,172,68,104
050,19,167,"Iowa","Sioux County",3,81,162,70,92
050,19,167,"Iowa","Sioux County",3,82,151,64,87
050,19,167,"Iowa","Sioux County",3,83,145,58,87
050,19,167,"Iowa","Sioux County",3,84,119,46,73
050,19,167,"Iowa","Sioux County",3,85,921,301,620
050,19,167,"Iowa","Sioux County",4,0,542,256,286
050,19,167,"Iowa","Sioux County",4,1,484,222,262
050,19,167,"Iowa","Sioux County",4,2,533,272,261
050,19,167,"Iowa","Sioux County",4,3,531,273,258
050,19,167,"Iowa","Sioux County",4,4,516,261,255
050,19,167,"Iowa","Sioux County",4,5,493,263,230
050,19,167,"Iowa","Sioux County",4,6,506,265,241
050,19,167,"Iowa","Sioux County",4,7,543,280,263
050,19,167,"Iowa","Sioux County",4,8,542,278,264
050,19,167,"Iowa","Sioux County",4,9,520,265,255
050,19,167,"Iowa","Sioux County",4,10,537,283,254
050,19,167,"Iowa","Sioux County",4,11,542,291,251
050,19,167,"Iowa","Sioux County",4,12,563,307,256
050,19,167,"Iowa","Sioux County",4,13,588,315,273
050,19,167,"Iowa","Sioux County",4,14,638,317,321
050,19,167,"Iowa","Sioux County",4,15,610,313,297
050,19,167,"Iowa","Sioux County",4,16,590,283,307
050,19,167,"Iowa","Sioux County",4,17,581,275,306
050,19,167,"Iowa","Sioux County",4,18,677,319,358
050,19,167,"Iowa","Sioux County",4,19,950,447,503
050,19,167,"Iowa","Sioux County",4,20,902,457,445
050,19,167,"Iowa","Sioux County",4,21,850,416,434
050,19,167,"Iowa","Sioux County",4,22,639,327,312
050,19,167,"Iowa","Sioux County",4,23,458,241,217
050,19,167,"Iowa","Sioux County",4,24,385,201,184
050,19,167,"Iowa","Sioux County",4,25,391,194,197
050,19,167,"Iowa","Sioux County",4,26,393,201,192
050,19,167,"Iowa","Sioux County",4,27,360,174,186
050,19,167,"Iowa","Sioux County",4,28,392,206,186
050,19,167,"Iowa","Sioux County",4,29,409,219,190
050,19,167,"Iowa","Sioux County",4,30,381,196,185
050,19,167,"Iowa","Sioux County",4,31,379,197,182
050,19,167,"Iowa","Sioux County",4,32,374,194,180
050,19,167,"Iowa","Sioux County",4,33,341,171,170
050,19,167,"Iowa","Sioux County",4,34,354,182,172
050,19,167,"Iowa","Sioux County",4,35,372,192,180
050,19,167,"Iowa","Sioux County",4,36,396,199,197
050,19,167,"Iowa","Sioux County",4,37,429,223,206
050,19,167,"Iowa","Sioux County",4,38,436,233,203
050,19,167,"Iowa","Sioux County",4,39,448,241,207
050,19,167,"Iowa","Sioux County",4,40,453,238,215
050,19,167,"Iowa","Sioux County",4,41,437,222,215
050,19,167,"Iowa","Sioux County",4,42,429,213,216
050,19,167,"Iowa","Sioux County",4,43,440,226,214
050,19,167,"Iowa","Sioux County",4,44,414,208,206
050,19,167,"Iowa","Sioux County",4,45,394,203,191
050,19,167,"Iowa","Sioux County",4,46,349,181,168
050,19,167,"Iowa","Sioux County",4,47,346,186,160
050,19,167,"Iowa","Sioux County",4,48,335,172,163
050,19,167,"Iowa","Sioux County",4,49,317,166,151
050,19,167,"Iowa","Sioux County",4,50,332,169,163
050,19,167,"Iowa","Sioux County",4,51,368,186,182
050,19,167,"Iowa","Sioux County",4,52,365,194,171
050,19,167,"Iowa","Sioux County",4,53,365,196,169
050,19,167,"Iowa","Sioux County",4,54,349,187,162
050,19,167,"Iowa","Sioux County",4,55,348,180,168
050,19,167,"Iowa","Sioux County",4,56,351,174,177
050,19,167,"Iowa","Sioux County",4,57,362,188,174
050,19,167,"Iowa","Sioux County",4,58,380,205,175
050,19,167,"Iowa","Sioux County",4,59,393,211,182
050,19,167,"Iowa","Sioux County",4,60,400,202,198
050,19,167,"Iowa","Sioux County",4,61,404,213,191
050,19,167,"Iowa","Sioux County",4,62,418,212,206
050,19,167,"Iowa","Sioux County",4,63,442,224,218
050,19,167,"Iowa","Sioux County",4,64,429,224,205
050,19,167,"Iowa","Sioux County",4,65,411,212,199
050,19,167,"Iowa","Sioux County",4,66,374,195,179
050,19,167,"Iowa","Sioux County",4,67,370,179,191
050,19,167,"Iowa","Sioux County",4,68,346,171,175
050,19,167,"Iowa","Sioux County",4,69,337,167,170
050,19,167,"Iowa","Sioux County",4,70,338,178,160
050,19,167,"Iowa","Sioux County",4,71,319,169,150
050,19,167,"Iowa","Sioux County",4,72,296,142,154
050,19,167,"Iowa","Sioux County",4,73,264,125,139
050,19,167,"Iowa","Sioux County",4,74,241,120,121
050,19,167,"Iowa","Sioux County",4,75,244,113,131
050,19,167,"Iowa","Sioux County",4,76,179,85,94
050,19,167,"Iowa","Sioux County",4,77,179,83,96
050,19,167,"Iowa","Sioux County",4,78,173,69,104
050,19,167,"Iowa","Sioux County",4,79,189,86,103
050,19,167,"Iowa","Sioux County",4,80,180,75,105
050,19,167,"Iowa","Sioux County",4,81,158,65,93
050,19,167,"Iowa","Sioux County",4,82,154,64,90
050,19,167,"Iowa","Sioux County",4,83,154,63,91
050,19,167,"Iowa","Sioux County",4,84,128,49,79
050,19,167,"Iowa","Sioux County",4,85,898,288,610
050,19,167,"Iowa","Sioux County",5,0,507,237,270
050,19,167,"Iowa","Sioux County",5,1,556,274,282
050,19,167,"Iowa","Sioux County",5,2,497,240,257
050,19,167,"Iowa","Sioux County",5,3,535,278,257
050,19,167,"Iowa","Sioux County",5,4,528,273,255
050,19,167,"Iowa","Sioux County",5,5,514,257,257
050,19,167,"Iowa","Sioux County",5,6,508,263,245
050,19,167,"Iowa","Sioux County",5,7,512,268,244
050,19,167,"Iowa","Sioux County",5,8,547,281,266
050,19,167,"Iowa","Sioux County",5,9,548,281,267
050,19,167,"Iowa","Sioux County",5,10,522,261,261
050,19,167,"Iowa","Sioux County",5,11,542,283,259
050,19,167,"Iowa","Sioux County",5,12,559,301,258
050,19,167,"Iowa","Sioux County",5,13,563,308,255
050,19,167,"Iowa","Sioux County",5,14,590,318,272
050,19,167,"Iowa","Sioux County",5,15,651,332,319
050,19,167,"Iowa","Sioux County",5,16,606,316,290
050,19,167,"Iowa","Sioux County",5,17,587,280,307
050,19,167,"Iowa","Sioux County",5,18,676,308,368
050,19,167,"Iowa","Sioux County",5,19,944,448,496
050,19,167,"Iowa","Sioux County",5,20,896,443,453
050,19,167,"Iowa","Sioux County",5,21,838,406,432
050,19,167,"Iowa","Sioux County",5,22,683,366,317
050,19,167,"Iowa","Sioux County",5,23,430,233,197
050,19,167,"Iowa","Sioux County",5,24,414,218,196
050,19,167,"Iowa","Sioux County",5,25,369,202,167
050,19,167,"Iowa","Sioux County",5,26,387,192,195
050,19,167,"Iowa","Sioux County",5,27,379,185,194
050,19,167,"Iowa","Sioux County",5,28,352,181,171
050,19,167,"Iowa","Sioux County",5,29,395,211,184
050,19,167,"Iowa","Sioux County",5,30,405,216,189
050,19,167,"Iowa","Sioux County",5,31,378,185,193
050,19,167,"Iowa","Sioux County",5,32,387,208,179
050,19,167,"Iowa","Sioux County",5,33,375,197,178
050,19,167,"Iowa","Sioux County",5,34,339,172,167
050,19,167,"Iowa","Sioux County",5,35,354,189,165
050,19,167,"Iowa","Sioux County",5,36,373,191,182
050,19,167,"Iowa","Sioux County",5,37,391,196,195
050,19,167,"Iowa","Sioux County",5,38,436,228,208
050,19,167,"Iowa","Sioux County",5,39,439,232,207
050,19,167,"Iowa","Sioux County",5,40,448,241,207
050,19,167,"Iowa","Sioux County",5,41,457,246,211
050,19,167,"Iowa","Sioux County",5,42,445,229,216
050,19,167,"Iowa","Sioux County",5,43,431,214,217
050,19,167,"Iowa","Sioux County",5,44,435,222,213
050,19,167,"Iowa","Sioux County",5,45,424,213,211
050,19,167,"Iowa","Sioux County",5,46,393,200,193
050,19,167,"Iowa","Sioux County",5,47,349,184,165
050,19,167,"Iowa","Sioux County",5,48,354,192,162
050,19,167,"Iowa","Sioux County",5,49,323,161,162
050,19,167,"Iowa","Sioux County",5,50,309,165,144
050,19,167,"Iowa","Sioux County",5,51,341,177,164
050,19,167,"Iowa","Sioux County",5,52,362,184,178
050,19,167,"Iowa","Sioux County",5,53,355,189,166
050,19,167,"Iowa","Sioux County",5,54,361,193,168
050,19,167,"Iowa","Sioux County",5,55,354,191,163
050,19,167,"Iowa","Sioux County",5,56,338,178,160
050,19,167,"Iowa","Sioux County",5,57,345,171,174
050,19,167,"Iowa","Sioux County",5,58,358,184,174
050,19,167,"Iowa","Sioux County",5,59,370,198,172
050,19,167,"Iowa","Sioux County",5,60,393,206,187
050,19,167,"Iowa","Sioux County",5,61,397,202,195
050,19,167,"Iowa","Sioux County",5,62,403,214,189
050,19,167,"Iowa","Sioux County",5,63,412,203,209
050,19,167,"Iowa","Sioux County",5,64,431,220,211
050,19,167,"Iowa","Sioux County",5,65,415,216,199
050,19,167,"Iowa","Sioux County",5,66,405,208,197
050,19,167,"Iowa","Sioux County",5,67,375,193,182
050,19,167,"Iowa","Sioux County",5,68,357,174,183
050,19,167,"Iowa","Sioux County",5,69,345,172,173
050,19,167,"Iowa","Sioux County",5,70,336,164,172
050,19,167,"Iowa","Sioux County",5,71,329,173,156
050,19,167,"Iowa","Sioux County",5,72,329,169,160
050,19,167,"Iowa","Sioux County",5,73,294,139,155
050,19,167,"Iowa","Sioux County",5,74,259,123,136
050,19,167,"Iowa","Sioux County",5,75,243,119,124
050,19,167,"Iowa","Sioux County",5,76,242,115,127
050,19,167,"Iowa","Sioux County",5,77,176,80,96
050,19,167,"Iowa","Sioux County",5,78,165,74,91
050,19,167,"Iowa","Sioux County",5,79,175,69,106
050,19,167,"Iowa","Sioux County",5,80,182,78,104
050,19,167,"Iowa","Sioux County",5,81,167,73,94
050,19,167,"Iowa","Sioux County",5,82,152,63,89
050,19,167,"Iowa","Sioux County",5,83,155,61,94
050,19,167,"Iowa","Sioux County",5,84,139,56,83
050,19,167,"Iowa","Sioux County",5,85,906,289,617
050,19,169,"Iowa","Story County",1,0,831,424,407
050,19,169,"Iowa","Story County",1,1,850,432,418
050,19,169,"Iowa","Story County",1,2,839,430,409
050,19,169,"Iowa","Story County",1,3,886,449,437
050,19,169,"Iowa","Story County",1,4,837,421,416
050,19,169,"Iowa","Story County",1,5,843,435,408
050,19,169,"Iowa","Story County",1,6,944,492,452
050,19,169,"Iowa","Story County",1,7,885,446,439
050,19,169,"Iowa","Story County",1,8,858,425,433
050,19,169,"Iowa","Story County",1,9,916,466,450
050,19,169,"Iowa","Story County",1,10,934,484,450
050,19,169,"Iowa","Story County",1,11,981,507,474
050,19,169,"Iowa","Story County",1,12,969,482,487
050,19,169,"Iowa","Story County",1,13,957,493,464
050,19,169,"Iowa","Story County",1,14,908,462,446
050,19,169,"Iowa","Story County",1,15,885,451,434
050,19,169,"Iowa","Story County",1,16,890,477,413
050,19,169,"Iowa","Story County",1,17,952,484,468
050,19,169,"Iowa","Story County",1,18,3051,1483,1568
050,19,169,"Iowa","Story County",1,19,6342,3457,2885
050,19,169,"Iowa","Story County",1,20,5099,2746,2353
050,19,169,"Iowa","Story County",1,21,5153,2900,2253
050,19,169,"Iowa","Story County",1,22,4669,2703,1966
050,19,169,"Iowa","Story County",1,23,3606,2156,1450
050,19,169,"Iowa","Story County",1,24,2497,1500,997
050,19,169,"Iowa","Story County",1,25,1953,1153,800
050,19,169,"Iowa","Story County",1,26,1637,965,672
050,19,169,"Iowa","Story County",1,27,1356,791,565
050,19,169,"Iowa","Story County",1,28,1285,711,574
050,19,169,"Iowa","Story County",1,29,1239,633,606
050,19,169,"Iowa","Story County",1,30,1208,648,560
050,19,169,"Iowa","Story County",1,31,1142,606,536
050,19,169,"Iowa","Story County",1,32,991,536,455
050,19,169,"Iowa","Story County",1,33,976,525,451
050,19,169,"Iowa","Story County",1,34,1002,559,443
050,19,169,"Iowa","Story County",1,35,996,526,470
050,19,169,"Iowa","Story County",1,36,1023,534,489
050,19,169,"Iowa","Story County",1,37,1057,528,529
050,19,169,"Iowa","Story County",1,38,991,509,482
050,19,169,"Iowa","Story County",1,39,1002,502,500
050,19,169,"Iowa","Story County",1,40,1044,552,492
050,19,169,"Iowa","Story County",1,41,1041,565,476
050,19,169,"Iowa","Story County",1,42,975,504,471
050,19,169,"Iowa","Story County",1,43,881,438,443
050,19,169,"Iowa","Story County",1,44,845,433,412
050,19,169,"Iowa","Story County",1,45,880,454,426
050,19,169,"Iowa","Story County",1,46,802,420,382
050,19,169,"Iowa","Story County",1,47,752,399,353
050,19,169,"Iowa","Story County",1,48,802,437,365
050,19,169,"Iowa","Story County",1,49,846,468,378
050,19,169,"Iowa","Story County",1,50,786,425,361
050,19,169,"Iowa","Story County",1,51,768,392,376
050,19,169,"Iowa","Story County",1,52,836,414,422
050,19,169,"Iowa","Story County",1,53,807,401,406
050,19,169,"Iowa","Story County",1,54,832,428,404
050,19,169,"Iowa","Story County",1,55,860,437,423
050,19,169,"Iowa","Story County",1,56,879,428,451
050,19,169,"Iowa","Story County",1,57,867,429,438
050,19,169,"Iowa","Story County",1,58,896,424,472
050,19,169,"Iowa","Story County",1,59,907,433,474
050,19,169,"Iowa","Story County",1,60,936,486,450
050,19,169,"Iowa","Story County",1,61,941,478,463
050,19,169,"Iowa","Story County",1,62,960,470,490
050,19,169,"Iowa","Story County",1,63,916,458,458
050,19,169,"Iowa","Story County",1,64,876,431,445
050,19,169,"Iowa","Story County",1,65,909,447,462
050,19,169,"Iowa","Story County",1,66,862,401,461
050,19,169,"Iowa","Story County",1,67,850,403,447
050,19,169,"Iowa","Story County",1,68,812,408,404
050,19,169,"Iowa","Story County",1,69,765,381,384
050,19,169,"Iowa","Story County",1,70,688,328,360
050,19,169,"Iowa","Story County",1,71,650,314,336
050,19,169,"Iowa","Story County",1,72,638,308,330
050,19,169,"Iowa","Story County",1,73,606,291,315
050,19,169,"Iowa","Story County",1,74,385,197,188
050,19,169,"Iowa","Story County",1,75,388,190,198
050,19,169,"Iowa","Story County",1,76,445,202,243
050,19,169,"Iowa","Story County",1,77,443,193,250
050,19,169,"Iowa","Story County",1,78,372,164,208
050,19,169,"Iowa","Story County",1,79,341,165,176
050,19,169,"Iowa","Story County",1,80,323,144,179
050,19,169,"Iowa","Story County",1,81,308,133,175
050,19,169,"Iowa","Story County",1,82,282,119,163
050,19,169,"Iowa","Story County",1,83,267,118,149
050,19,169,"Iowa","Story County",1,84,265,120,145
050,19,169,"Iowa","Story County",1,85,1559,530,1029
050,19,169,"Iowa","Story County",2,0,819,416,403
050,19,169,"Iowa","Story County",2,1,840,426,414
050,19,169,"Iowa","Story County",2,2,842,431,411
050,19,169,"Iowa","Story County",2,3,867,439,428
050,19,169,"Iowa","Story County",2,4,849,429,420
050,19,169,"Iowa","Story County",2,5,848,439,409
050,19,169,"Iowa","Story County",2,6,922,481,441
050,19,169,"Iowa","Story County",2,7,899,458,441
050,19,169,"Iowa","Story County",2,8,864,430,434
050,19,169,"Iowa","Story County",2,9,900,455,445
050,19,169,"Iowa","Story County",2,10,932,479,453
050,19,169,"Iowa","Story County",2,11,968,499,469
050,19,169,"Iowa","Story County",2,12,975,488,487
050,19,169,"Iowa","Story County",2,13,959,490,469
050,19,169,"Iowa","Story County",2,14,923,472,451
050,19,169,"Iowa","Story County",2,15,894,455,439
050,19,169,"Iowa","Story County",2,16,892,473,419
050,19,169,"Iowa","Story County",2,17,951,489,462
050,19,169,"Iowa","Story County",2,18,3033,1477,1556
050,19,169,"Iowa","Story County",2,19,6320,3435,2885
050,19,169,"Iowa","Story County",2,20,5159,2776,2383
050,19,169,"Iowa","Story County",2,21,5132,2882,2250
050,19,169,"Iowa","Story County",2,22,4629,2686,1943
050,19,169,"Iowa","Story County",2,23,3579,2142,1437
050,19,169,"Iowa","Story County",2,24,2498,1493,1005
050,19,169,"Iowa","Story County",2,25,1934,1138,796
050,19,169,"Iowa","Story County",2,26,1643,970,673
050,19,169,"Iowa","Story County",2,27,1365,791,574
050,19,169,"Iowa","Story County",2,28,1284,718,566
050,19,169,"Iowa","Story County",2,29,1234,642,592
050,19,169,"Iowa","Story County",2,30,1217,643,574
050,19,169,"Iowa","Story County",2,31,1143,609,534
050,19,169,"Iowa","Story County",2,32,1030,556,474
050,19,169,"Iowa","Story County",2,33,977,528,449
050,19,169,"Iowa","Story County",2,34,987,544,443
050,19,169,"Iowa","Story County",2,35,1000,536,464
050,19,169,"Iowa","Story County",2,36,1007,527,480
050,19,169,"Iowa","Story County",2,37,1045,528,517
050,19,169,"Iowa","Story County",2,38,1008,513,495
050,19,169,"Iowa","Story County",2,39,1000,504,496
050,19,169,"Iowa","Story County",2,40,1042,546,496
050,19,169,"Iowa","Story County",2,41,1044,564,480
050,19,169,"Iowa","Story County",2,42,987,516,471
050,19,169,"Iowa","Story County",2,43,912,458,454
050,19,169,"Iowa","Story County",2,44,848,430,418
050,19,169,"Iowa","Story County",2,45,879,452,427
050,19,169,"Iowa","Story County",2,46,815,424,391
050,19,169,"Iowa","Story County",2,47,761,402,359
050,19,169,"Iowa","Story County",2,48,788,427,361
050,19,169,"Iowa","Story County",2,49,839,464,375
050,19,169,"Iowa","Story County",2,50,798,433,365
050,19,169,"Iowa","Story County",2,51,773,399,374
050,19,169,"Iowa","Story County",2,52,821,410,411
050,19,169,"Iowa","Story County",2,53,814,404,410
050,19,169,"Iowa","Story County",2,54,822,420,402
050,19,169,"Iowa","Story County",2,55,855,436,419
050,19,169,"Iowa","Story County",2,56,879,433,446
050,19,169,"Iowa","Story County",2,57,873,430,443
050,19,169,"Iowa","Story County",2,58,889,425,464
050,19,169,"Iowa","Story County",2,59,914,434,480
050,19,169,"Iowa","Story County",2,60,930,474,456
050,19,169,"Iowa","Story County",2,61,936,478,458
050,19,169,"Iowa","Story County",2,62,954,471,483
050,19,169,"Iowa","Story County",2,63,937,466,471
050,19,169,"Iowa","Story County",2,64,887,439,448
050,19,169,"Iowa","Story County",2,65,900,440,460
050,19,169,"Iowa","Story County",2,66,872,413,459
050,19,169,"Iowa","Story County",2,67,845,397,448
050,19,169,"Iowa","Story County",2,68,813,400,413
050,19,169,"Iowa","Story County",2,69,781,389,392
050,19,169,"Iowa","Story County",2,70,704,339,365
050,19,169,"Iowa","Story County",2,71,658,319,339
050,19,169,"Iowa","Story County",2,72,631,305,326
050,19,169,"Iowa","Story County",2,73,643,310,333
050,19,169,"Iowa","Story County",2,74,408,205,203
050,19,169,"Iowa","Story County",2,75,389,192,197
050,19,169,"Iowa","Story County",2,76,427,198,229
050,19,169,"Iowa","Story County",2,77,453,200,253
050,19,169,"Iowa","Story County",2,78,383,168,215
050,19,169,"Iowa","Story County",2,79,347,164,183
050,19,169,"Iowa","Story County",2,80,325,147,178
050,19,169,"Iowa","Story County",2,81,307,134,173
050,19,169,"Iowa","Story County",2,82,292,124,168
050,19,169,"Iowa","Story County",2,83,267,115,152
050,19,169,"Iowa","Story County",2,84,259,116,143
050,19,169,"Iowa","Story County",2,85,1580,537,1043
050,19,169,"Iowa","Story County",3,0,795,434,361
050,19,169,"Iowa","Story County",3,1,828,414,414
050,19,169,"Iowa","Story County",3,2,839,423,416
050,19,169,"Iowa","Story County",3,3,843,426,417
050,19,169,"Iowa","Story County",3,4,867,442,425
050,19,169,"Iowa","Story County",3,5,869,435,434
050,19,169,"Iowa","Story County",3,6,860,440,420
050,19,169,"Iowa","Story County",3,7,955,500,455
050,19,169,"Iowa","Story County",3,8,910,465,445
050,19,169,"Iowa","Story County",3,9,879,424,455
050,19,169,"Iowa","Story County",3,10,919,457,462
050,19,169,"Iowa","Story County",3,11,923,481,442
050,19,169,"Iowa","Story County",3,12,951,492,459
050,19,169,"Iowa","Story County",3,13,985,491,494
050,19,169,"Iowa","Story County",3,14,968,500,468
050,19,169,"Iowa","Story County",3,15,950,482,468
050,19,169,"Iowa","Story County",3,16,909,467,442
050,19,169,"Iowa","Story County",3,17,948,503,445
050,19,169,"Iowa","Story County",3,18,3043,1481,1562
050,19,169,"Iowa","Story County",3,19,6316,3430,2886
050,19,169,"Iowa","Story County",3,20,5167,2745,2422
050,19,169,"Iowa","Story County",3,21,5242,2905,2337
050,19,169,"Iowa","Story County",3,22,4678,2710,1968
050,19,169,"Iowa","Story County",3,23,3574,2151,1423
050,19,169,"Iowa","Story County",3,24,2481,1449,1032
050,19,169,"Iowa","Story County",3,25,1904,1117,787
050,19,169,"Iowa","Story County",3,26,1670,966,704
050,19,169,"Iowa","Story County",3,27,1378,770,608
050,19,169,"Iowa","Story County",3,28,1308,755,553
050,19,169,"Iowa","Story County",3,29,1254,698,556
050,19,169,"Iowa","Story County",3,30,1223,636,587
050,19,169,"Iowa","Story County",3,31,1197,626,571
050,19,169,"Iowa","Story County",3,32,1121,595,526
050,19,169,"Iowa","Story County",3,33,1004,536,468
050,19,169,"Iowa","Story County",3,34,957,510,447
050,19,169,"Iowa","Story County",3,35,983,541,442
050,19,169,"Iowa","Story County",3,36,998,536,462
050,19,169,"Iowa","Story County",3,37,993,528,465
050,19,169,"Iowa","Story County",3,38,1041,529,512
050,19,169,"Iowa","Story County",3,39,1003,512,491
050,19,169,"Iowa","Story County",3,40,1000,500,500
050,19,169,"Iowa","Story County",3,41,1055,552,503
050,19,169,"Iowa","Story County",3,42,1046,559,487
050,19,169,"Iowa","Story County",3,43,985,518,467
050,19,169,"Iowa","Story County",3,44,902,447,455
050,19,169,"Iowa","Story County",3,45,857,435,422
050,19,169,"Iowa","Story County",3,46,887,456,431
050,19,169,"Iowa","Story County",3,47,823,428,395
050,19,169,"Iowa","Story County",3,48,780,408,372
050,19,169,"Iowa","Story County",3,49,784,423,361
050,19,169,"Iowa","Story County",3,50,827,451,376
050,19,169,"Iowa","Story County",3,51,801,433,368
050,19,169,"Iowa","Story County",3,52,778,395,383
050,19,169,"Iowa","Story County",3,53,832,415,417
050,19,169,"Iowa","Story County",3,54,807,400,407
050,19,169,"Iowa","Story County",3,55,832,427,405
050,19,169,"Iowa","Story County",3,56,852,433,419
050,19,169,"Iowa","Story County",3,57,911,443,468
050,19,169,"Iowa","Story County",3,58,888,441,447
050,19,169,"Iowa","Story County",3,59,887,419,468
050,19,169,"Iowa","Story County",3,60,905,433,472
050,19,169,"Iowa","Story County",3,61,931,472,459
050,19,169,"Iowa","Story County",3,62,928,468,460
050,19,169,"Iowa","Story County",3,63,963,480,483
050,19,169,"Iowa","Story County",3,64,936,459,477
050,19,169,"Iowa","Story County",3,65,877,421,456
050,19,169,"Iowa","Story County",3,66,886,442,444
050,19,169,"Iowa","Story County",3,67,871,416,455
050,19,169,"Iowa","Story County",3,68,828,390,438
050,19,169,"Iowa","Story County",3,69,797,392,405
050,19,169,"Iowa","Story County",3,70,775,387,388
050,19,169,"Iowa","Story County",3,71,703,336,367
050,19,169,"Iowa","Story County",3,72,635,312,323
050,19,169,"Iowa","Story County",3,73,622,297,325
050,19,169,"Iowa","Story County",3,74,641,307,334
050,19,169,"Iowa","Story County",3,75,393,193,200
050,19,169,"Iowa","Story County",3,76,386,191,195
050,19,169,"Iowa","Story County",3,77,415,188,227
050,19,169,"Iowa","Story County",3,78,446,193,253
050,19,169,"Iowa","Story County",3,79,373,167,206
050,19,169,"Iowa","Story County",3,80,340,153,187
050,19,169,"Iowa","Story County",3,81,303,140,163
050,19,169,"Iowa","Story County",3,82,313,134,179
050,19,169,"Iowa","Story County",3,83,281,122,159
050,19,169,"Iowa","Story County",3,84,245,102,143
050,19,169,"Iowa","Story County",3,85,1619,575,1044
050,19,169,"Iowa","Story County",4,0,845,447,398
050,19,169,"Iowa","Story County",4,1,779,426,353
050,19,169,"Iowa","Story County",4,2,821,404,417
050,19,169,"Iowa","Story County",4,3,839,428,411
050,19,169,"Iowa","Story County",4,4,860,432,428
050,19,169,"Iowa","Story County",4,5,872,447,425
050,19,169,"Iowa","Story County",4,6,882,437,445
050,19,169,"Iowa","Story County",4,7,878,449,429
050,19,169,"Iowa","Story County",4,8,960,506,454
050,19,169,"Iowa","Story County",4,9,904,481,423
050,19,169,"Iowa","Story County",4,10,863,419,444
050,19,169,"Iowa","Story County",4,11,932,467,465
050,19,169,"Iowa","Story County",4,12,929,482,447
050,19,169,"Iowa","Story County",4,13,940,481,459
050,19,169,"Iowa","Story County",4,14,1015,504,511
050,19,169,"Iowa","Story County",4,15,955,486,469
050,19,169,"Iowa","Story County",4,16,957,493,464
050,19,169,"Iowa","Story County",4,17,997,521,476
050,19,169,"Iowa","Story County",4,18,2732,1355,1377
050,19,169,"Iowa","Story County",4,19,5654,3062,2592
050,19,169,"Iowa","Story County",4,20,4778,2505,2273
050,19,169,"Iowa","Story County",4,21,5070,2793,2277
050,19,169,"Iowa","Story County",4,22,4719,2688,2031
050,19,169,"Iowa","Story County",4,23,3524,2145,1379
050,19,169,"Iowa","Story County",4,24,2470,1439,1031
050,19,169,"Iowa","Story County",4,25,1901,1085,816
050,19,169,"Iowa","Story County",4,26,1609,920,689
050,19,169,"Iowa","Story County",4,27,1380,762,618
050,19,169,"Iowa","Story County",4,28,1234,693,541
050,19,169,"Iowa","Story County",4,29,1236,696,540
050,19,169,"Iowa","Story County",4,30,1204,700,504
050,19,169,"Iowa","Story County",4,31,1148,592,556
050,19,169,"Iowa","Story County",4,32,1164,605,559
050,19,169,"Iowa","Story County",4,33,1096,565,531
050,19,169,"Iowa","Story County",4,34,970,531,439
050,19,169,"Iowa","Story County",4,35,912,487,425
050,19,169,"Iowa","Story County",4,36,957,530,427
050,19,169,"Iowa","Story County",4,37,999,543,456
050,19,169,"Iowa","Story County",4,38,963,507,456
050,19,169,"Iowa","Story County",4,39,1039,522,517
050,19,169,"Iowa","Story County",4,40,1017,510,507
050,19,169,"Iowa","Story County",4,41,989,495,494
050,19,169,"Iowa","Story County",4,42,1063,559,504
050,19,169,"Iowa","Story County",4,43,1034,552,482
050,19,169,"Iowa","Story County",4,44,967,506,461
050,19,169,"Iowa","Story County",4,45,893,441,452
050,19,169,"Iowa","Story County",4,46,829,413,416
050,19,169,"Iowa","Story County",4,47,874,450,424
050,19,169,"Iowa","Story County",4,48,810,425,385
050,19,169,"Iowa","Story County",4,49,765,411,354
050,19,169,"Iowa","Story County",4,50,759,409,350
050,19,169,"Iowa","Story County",4,51,833,453,380
050,19,169,"Iowa","Story County",4,52,788,424,364
050,19,169,"Iowa","Story County",4,53,776,390,386
050,19,169,"Iowa","Story County",4,54,817,405,412
050,19,169,"Iowa","Story County",4,55,832,412,420
050,19,169,"Iowa","Story County",4,56,836,420,416
050,19,169,"Iowa","Story County",4,57,845,439,406
050,19,169,"Iowa","Story County",4,58,907,436,471
050,19,169,"Iowa","Story County",4,59,877,437,440
050,19,169,"Iowa","Story County",4,60,895,421,474
050,19,169,"Iowa","Story County",4,61,906,438,468
050,19,169,"Iowa","Story County",4,62,925,468,457
050,19,169,"Iowa","Story County",4,63,927,469,458
050,19,169,"Iowa","Story County",4,64,971,481,490
050,19,169,"Iowa","Story County",4,65,939,456,483
050,19,169,"Iowa","Story County",4,66,869,428,441
050,19,169,"Iowa","Story County",4,67,865,427,438
050,19,169,"Iowa","Story County",4,68,852,404,448
050,19,169,"Iowa","Story County",4,69,825,393,432
050,19,169,"Iowa","Story County",4,70,769,373,396
050,19,169,"Iowa","Story County",4,71,750,381,369
050,19,169,"Iowa","Story County",4,72,693,324,369
050,19,169,"Iowa","Story County",4,73,634,309,325
050,19,169,"Iowa","Story County",4,74,619,294,325
050,19,169,"Iowa","Story County",4,75,617,291,326
050,19,169,"Iowa","Story County",4,76,384,190,194
050,19,169,"Iowa","Story County",4,77,386,188,198
050,19,169,"Iowa","Story County",4,78,391,178,213
050,19,169,"Iowa","Story County",4,79,443,190,253
050,19,169,"Iowa","Story County",4,80,366,158,208
050,19,169,"Iowa","Story County",4,81,311,142,169
050,19,169,"Iowa","Story County",4,82,297,137,160
050,19,169,"Iowa","Story County",4,83,286,126,160
050,19,169,"Iowa","Story County",4,84,258,111,147
050,19,169,"Iowa","Story County",4,85,1581,565,1016
050,19,169,"Iowa","Story County",5,0,846,448,398
050,19,169,"Iowa","Story County",5,1,845,461,384
050,19,169,"Iowa","Story County",5,2,802,435,367
050,19,169,"Iowa","Story County",5,3,822,411,411
050,19,169,"Iowa","Story County",5,4,838,424,414
050,19,169,"Iowa","Story County",5,5,859,431,428
050,19,169,"Iowa","Story County",5,6,868,448,420
050,19,169,"Iowa","Story County",5,7,884,451,433
050,19,169,"Iowa","Story County",5,8,879,454,425
050,19,169,"Iowa","Story County",5,9,962,495,467
050,19,169,"Iowa","Story County",5,10,926,501,425
050,19,169,"Iowa","Story County",5,11,867,427,440
050,19,169,"Iowa","Story County",5,12,947,477,470
050,19,169,"Iowa","Story County",5,13,939,487,452
050,19,169,"Iowa","Story County",5,14,960,494,466
050,19,169,"Iowa","Story County",5,15,1017,518,499
050,19,169,"Iowa","Story County",5,16,964,495,469
050,19,169,"Iowa","Story County",5,17,1049,555,494
050,19,169,"Iowa","Story County",5,18,2751,1352,1399
050,19,169,"Iowa","Story County",5,19,5618,3066,2552
050,19,169,"Iowa","Story County",5,20,4723,2504,2219
050,19,169,"Iowa","Story County",5,21,4893,2662,2231
050,19,169,"Iowa","Story County",5,22,4644,2646,1998
050,19,169,"Iowa","Story County",5,23,3661,2134,1527
050,19,169,"Iowa","Story County",5,24,2502,1506,996
050,19,169,"Iowa","Story County",5,25,1939,1095,844
050,19,169,"Iowa","Story County",5,26,1644,929,715
050,19,169,"Iowa","Story County",5,27,1380,773,607
050,19,169,"Iowa","Story County",5,28,1325,753,572
050,19,169,"Iowa","Story County",5,29,1140,621,519
050,19,169,"Iowa","Story County",5,30,1225,679,546
050,19,169,"Iowa","Story County",5,31,1126,626,500
050,19,169,"Iowa","Story County",5,32,1093,569,524
050,19,169,"Iowa","Story County",5,33,1110,559,551
050,19,169,"Iowa","Story County",5,34,1081,562,519
050,19,169,"Iowa","Story County",5,35,949,518,431
050,19,169,"Iowa","Story County",5,36,916,501,415
050,19,169,"Iowa","Story County",5,37,980,544,436
050,19,169,"Iowa","Story County",5,38,989,537,452
050,19,169,"Iowa","Story County",5,39,942,485,457
050,19,169,"Iowa","Story County",5,40,1034,526,508
050,19,169,"Iowa","Story County",5,41,989,503,486
050,19,169,"Iowa","Story County",5,42,1001,510,491
050,19,169,"Iowa","Story County",5,43,1046,546,500
050,19,169,"Iowa","Story County",5,44,1022,542,480
050,19,169,"Iowa","Story County",5,45,979,503,476
050,19,169,"Iowa","Story County",5,46,883,441,442
050,19,169,"Iowa","Story County",5,47,826,416,410
050,19,169,"Iowa","Story County",5,48,862,441,421
050,19,169,"Iowa","Story County",5,49,796,415,381
050,19,169,"Iowa","Story County",5,50,767,407,360
050,19,169,"Iowa","Story County",5,51,776,420,356
050,19,169,"Iowa","Story County",5,52,837,450,387
050,19,169,"Iowa","Story County",5,53,782,418,364
050,19,169,"Iowa","Story County",5,54,762,394,368
050,19,169,"Iowa","Story County",5,55,806,398,408
050,19,169,"Iowa","Story County",5,56,810,398,412
050,19,169,"Iowa","Story County",5,57,809,408,401
050,19,169,"Iowa","Story County",5,58,849,445,404
050,19,169,"Iowa","Story County",5,59,900,425,475
050,19,169,"Iowa","Story County",5,60,860,427,433
050,19,169,"Iowa","Story County",5,61,894,424,470
050,19,169,"Iowa","Story County",5,62,894,430,464
050,19,169,"Iowa","Story County",5,63,929,467,462
050,19,169,"Iowa","Story County",5,64,914,465,449
050,19,169,"Iowa","Story County",5,65,965,481,484
050,19,169,"Iowa","Story County",5,66,909,449,460
050,19,169,"Iowa","Story County",5,67,851,418,433
050,19,169,"Iowa","Story County",5,68,862,424,438
050,19,169,"Iowa","Story County",5,69,840,406,434
050,19,169,"Iowa","Story County",5,70,817,382,435
050,19,169,"Iowa","Story County",5,71,758,370,388
050,19,169,"Iowa","Story County",5,72,730,369,361
050,19,169,"Iowa","Story County",5,73,696,323,373
050,19,169,"Iowa","Story County",5,74,628,310,318
050,19,169,"Iowa","Story County",5,75,599,278,321
050,19,169,"Iowa","Story County",5,76,602,290,312
050,19,169,"Iowa","Story County",5,77,375,182,193
050,19,169,"Iowa","Story County",5,78,371,182,189
050,19,169,"Iowa","Story County",5,79,379,175,204
050,19,169,"Iowa","Story County",5,80,435,183,252
050,19,169,"Iowa","Story County",5,81,352,157,195
050,19,169,"Iowa","Story County",5,82,305,136,169
050,19,169,"Iowa","Story County",5,83,283,133,150
050,19,169,"Iowa","Story County",5,84,275,124,151
050,19,169,"Iowa","Story County",5,85,1602,579,1023
050,19,171,"Iowa","Tama County",1,0,202,103,99
050,19,171,"Iowa","Tama County",1,1,226,120,106
050,19,171,"Iowa","Tama County",1,2,215,117,98
050,19,171,"Iowa","Tama County",1,3,220,115,105
050,19,171,"Iowa","Tama County",1,4,241,111,130
050,19,171,"Iowa","Tama County",1,5,248,123,125
050,19,171,"Iowa","Tama County",1,6,232,118,114
050,19,171,"Iowa","Tama County",1,7,232,117,115
050,19,171,"Iowa","Tama County",1,8,220,107,113
050,19,171,"Iowa","Tama County",1,9,199,98,101
050,19,171,"Iowa","Tama County",1,10,209,96,113
050,19,171,"Iowa","Tama County",1,11,241,112,129
050,19,171,"Iowa","Tama County",1,12,239,123,116
050,19,171,"Iowa","Tama County",1,13,240,126,114
050,19,171,"Iowa","Tama County",1,14,249,144,105
050,19,171,"Iowa","Tama County",1,15,237,134,103
050,19,171,"Iowa","Tama County",1,16,258,147,111
050,19,171,"Iowa","Tama County",1,17,255,137,118
050,19,171,"Iowa","Tama County",1,18,219,115,104
050,19,171,"Iowa","Tama County",1,19,177,94,83
050,19,171,"Iowa","Tama County",1,20,186,100,86
050,19,171,"Iowa","Tama County",1,21,181,95,86
050,19,171,"Iowa","Tama County",1,22,201,105,96
050,19,171,"Iowa","Tama County",1,23,182,87,95
050,19,171,"Iowa","Tama County",1,24,177,94,83
050,19,171,"Iowa","Tama County",1,25,182,85,97
050,19,171,"Iowa","Tama County",1,26,176,90,86
050,19,171,"Iowa","Tama County",1,27,194,109,85
050,19,171,"Iowa","Tama County",1,28,167,81,86
050,19,171,"Iowa","Tama County",1,29,169,88,81
050,19,171,"Iowa","Tama County",1,30,197,105,92
050,19,171,"Iowa","Tama County",1,31,182,97,85
050,19,171,"Iowa","Tama County",1,32,169,92,77
050,19,171,"Iowa","Tama County",1,33,165,82,83
050,19,171,"Iowa","Tama County",1,34,190,95,95
050,19,171,"Iowa","Tama County",1,35,181,99,82
050,19,171,"Iowa","Tama County",1,36,201,118,83
050,19,171,"Iowa","Tama County",1,37,186,95,91
050,19,171,"Iowa","Tama County",1,38,179,86,93
050,19,171,"Iowa","Tama County",1,39,192,93,99
050,19,171,"Iowa","Tama County",1,40,205,96,109
050,19,171,"Iowa","Tama County",1,41,192,97,95
050,19,171,"Iowa","Tama County",1,42,192,100,92
050,19,171,"Iowa","Tama County",1,43,178,87,91
050,19,171,"Iowa","Tama County",1,44,174,89,85
050,19,171,"Iowa","Tama County",1,45,183,95,88
050,19,171,"Iowa","Tama County",1,46,174,82,92
050,19,171,"Iowa","Tama County",1,47,168,81,87
050,19,171,"Iowa","Tama County",1,48,179,95,84
050,19,171,"Iowa","Tama County",1,49,226,120,106
050,19,171,"Iowa","Tama County",1,50,239,121,118
050,19,171,"Iowa","Tama County",1,51,219,111,108
050,19,171,"Iowa","Tama County",1,52,216,108,108
050,19,171,"Iowa","Tama County",1,53,227,112,115
050,19,171,"Iowa","Tama County",1,54,235,132,103
050,19,171,"Iowa","Tama County",1,55,226,117,109
050,19,171,"Iowa","Tama County",1,56,231,112,119
050,19,171,"Iowa","Tama County",1,57,244,122,122
050,19,171,"Iowa","Tama County",1,58,273,129,144
050,19,171,"Iowa","Tama County",1,59,249,120,129
050,19,171,"Iowa","Tama County",1,60,250,128,122
050,19,171,"Iowa","Tama County",1,61,257,130,127
050,19,171,"Iowa","Tama County",1,62,268,134,134
050,19,171,"Iowa","Tama County",1,63,273,146,127
050,19,171,"Iowa","Tama County",1,64,250,128,122
050,19,171,"Iowa","Tama County",1,65,255,133,122
050,19,171,"Iowa","Tama County",1,66,232,124,108
050,19,171,"Iowa","Tama County",1,67,199,103,96
050,19,171,"Iowa","Tama County",1,68,209,105,104
050,19,171,"Iowa","Tama County",1,69,212,99,113
050,19,171,"Iowa","Tama County",1,70,188,91,97
050,19,171,"Iowa","Tama County",1,71,171,87,84
050,19,171,"Iowa","Tama County",1,72,173,91,82
050,19,171,"Iowa","Tama County",1,73,157,76,81
050,19,171,"Iowa","Tama County",1,74,136,66,70
050,19,171,"Iowa","Tama County",1,75,127,57,70
050,19,171,"Iowa","Tama County",1,76,115,53,62
050,19,171,"Iowa","Tama County",1,77,121,60,61
050,19,171,"Iowa","Tama County",1,78,96,49,47
050,19,171,"Iowa","Tama County",1,79,98,42,56
050,19,171,"Iowa","Tama County",1,80,97,48,49
050,19,171,"Iowa","Tama County",1,81,89,42,47
050,19,171,"Iowa","Tama County",1,82,86,39,47
050,19,171,"Iowa","Tama County",1,83,72,32,40
050,19,171,"Iowa","Tama County",1,84,71,26,45
050,19,171,"Iowa","Tama County",1,85,485,159,326
050,19,171,"Iowa","Tama County",2,0,204,107,97
050,19,171,"Iowa","Tama County",2,1,217,115,102
050,19,171,"Iowa","Tama County",2,2,216,117,99
050,19,171,"Iowa","Tama County",2,3,218,114,104
050,19,171,"Iowa","Tama County",2,4,236,111,125
050,19,171,"Iowa","Tama County",2,5,247,121,126
050,19,171,"Iowa","Tama County",2,6,237,119,118
050,19,171,"Iowa","Tama County",2,7,229,116,113
050,19,171,"Iowa","Tama County",2,8,224,110,114
050,19,171,"Iowa","Tama County",2,9,203,98,105
050,19,171,"Iowa","Tama County",2,10,210,98,112
050,19,171,"Iowa","Tama County",2,11,231,107,124
050,19,171,"Iowa","Tama County",2,12,241,121,120
050,19,171,"Iowa","Tama County",2,13,239,126,113
050,19,171,"Iowa","Tama County",2,14,246,138,108
050,19,171,"Iowa","Tama County",2,15,241,138,103
050,19,171,"Iowa","Tama County",2,16,254,144,110
050,19,171,"Iowa","Tama County",2,17,254,139,115
050,19,171,"Iowa","Tama County",2,18,215,114,101
050,19,171,"Iowa","Tama County",2,19,176,93,83
050,19,171,"Iowa","Tama County",2,20,185,98,87
050,19,171,"Iowa","Tama County",2,21,185,99,86
050,19,171,"Iowa","Tama County",2,22,197,103,94
050,19,171,"Iowa","Tama County",2,23,186,92,94
050,19,171,"Iowa","Tama County",2,24,178,92,86
050,19,171,"Iowa","Tama County",2,25,181,87,94
050,19,171,"Iowa","Tama County",2,26,178,89,89
050,19,171,"Iowa","Tama County",2,27,187,102,85
050,19,171,"Iowa","Tama County",2,28,173,87,86
050,19,171,"Iowa","Tama County",2,29,170,85,85
050,19,171,"Iowa","Tama County",2,30,193,102,91
050,19,171,"Iowa","Tama County",2,31,183,99,84
050,19,171,"Iowa","Tama County",2,32,170,92,78
050,19,171,"Iowa","Tama County",2,33,168,86,82
050,19,171,"Iowa","Tama County",2,34,184,92,92
050,19,171,"Iowa","Tama County",2,35,187,100,87
050,19,171,"Iowa","Tama County",2,36,194,112,82
050,19,171,"Iowa","Tama County",2,37,188,100,88
050,19,171,"Iowa","Tama County",2,38,181,88,93
050,19,171,"Iowa","Tama County",2,39,187,90,97
050,19,171,"Iowa","Tama County",2,40,203,96,107
050,19,171,"Iowa","Tama County",2,41,194,95,99
050,19,171,"Iowa","Tama County",2,42,190,99,91
050,19,171,"Iowa","Tama County",2,43,182,90,92
050,19,171,"Iowa","Tama County",2,44,176,90,86
050,19,171,"Iowa","Tama County",2,45,181,94,87
050,19,171,"Iowa","Tama County",2,46,177,84,93
050,19,171,"Iowa","Tama County",2,47,165,80,85
050,19,171,"Iowa","Tama County",2,48,174,90,84
050,19,171,"Iowa","Tama County",2,49,214,114,100
050,19,171,"Iowa","Tama County",2,50,238,122,116
050,19,171,"Iowa","Tama County",2,51,222,113,109
050,19,171,"Iowa","Tama County",2,52,215,107,108
050,19,171,"Iowa","Tama County",2,53,224,111,113
050,19,171,"Iowa","Tama County",2,54,232,127,105
050,19,171,"Iowa","Tama County",2,55,228,119,109
050,19,171,"Iowa","Tama County",2,56,229,114,115
050,19,171,"Iowa","Tama County",2,57,241,121,120
050,19,171,"Iowa","Tama County",2,58,265,127,138
050,19,171,"Iowa","Tama County",2,59,256,124,132
050,19,171,"Iowa","Tama County",2,60,250,127,123
050,19,171,"Iowa","Tama County",2,61,255,130,125
050,19,171,"Iowa","Tama County",2,62,266,132,134
050,19,171,"Iowa","Tama County",2,63,274,144,130
050,19,171,"Iowa","Tama County",2,64,252,129,123
050,19,171,"Iowa","Tama County",2,65,251,129,122
050,19,171,"Iowa","Tama County",2,66,236,125,111
050,19,171,"Iowa","Tama County",2,67,205,108,97
050,19,171,"Iowa","Tama County",2,68,205,103,102
050,19,171,"Iowa","Tama County",2,69,210,100,110
050,19,171,"Iowa","Tama County",2,70,189,91,98
050,19,171,"Iowa","Tama County",2,71,173,86,87
050,19,171,"Iowa","Tama County",2,72,169,88,81
050,19,171,"Iowa","Tama County",2,73,169,83,86
050,19,171,"Iowa","Tama County",2,74,132,63,69
050,19,171,"Iowa","Tama County",2,75,129,59,70
050,19,171,"Iowa","Tama County",2,76,115,54,61
050,19,171,"Iowa","Tama County",2,77,122,59,63
050,19,171,"Iowa","Tama County",2,78,97,49,48
050,19,171,"Iowa","Tama County",2,79,96,43,53
050,19,171,"Iowa","Tama County",2,80,97,48,49
050,19,171,"Iowa","Tama County",2,81,88,42,46
050,19,171,"Iowa","Tama County",2,82,85,38,47
050,19,171,"Iowa","Tama County",2,83,71,33,38
050,19,171,"Iowa","Tama County",2,84,70,27,43
050,19,171,"Iowa","Tama County",2,85,476,156,320
050,19,171,"Iowa","Tama County",3,0,196,110,86
050,19,171,"Iowa","Tama County",3,1,192,104,88
050,19,171,"Iowa","Tama County",3,2,200,107,93
050,19,171,"Iowa","Tama County",3,3,208,114,94
050,19,171,"Iowa","Tama County",3,4,213,114,99
050,19,171,"Iowa","Tama County",3,5,218,102,116
050,19,171,"Iowa","Tama County",3,6,256,123,133
050,19,171,"Iowa","Tama County",3,7,235,117,118
050,19,171,"Iowa","Tama County",3,8,226,116,110
050,19,171,"Iowa","Tama County",3,9,216,113,103
050,19,171,"Iowa","Tama County",3,10,207,103,104
050,19,171,"Iowa","Tama County",3,11,208,101,107
050,19,171,"Iowa","Tama County",3,12,229,104,125
050,19,171,"Iowa","Tama County",3,13,236,116,120
050,19,171,"Iowa","Tama County",3,14,239,127,112
050,19,171,"Iowa","Tama County",3,15,243,138,105
050,19,171,"Iowa","Tama County",3,16,239,143,96
050,19,171,"Iowa","Tama County",3,17,253,145,108
050,19,171,"Iowa","Tama County",3,18,211,119,92
050,19,171,"Iowa","Tama County",3,19,179,97,82
050,19,171,"Iowa","Tama County",3,20,181,96,85
050,19,171,"Iowa","Tama County",3,21,188,99,89
050,19,171,"Iowa","Tama County",3,22,183,91,92
050,19,171,"Iowa","Tama County",3,23,202,111,91
050,19,171,"Iowa","Tama County",3,24,180,87,93
050,19,171,"Iowa","Tama County",3,25,171,91,80
050,19,171,"Iowa","Tama County",3,26,163,76,87
050,19,171,"Iowa","Tama County",3,27,172,84,88
050,19,171,"Iowa","Tama County",3,28,191,109,82
050,19,171,"Iowa","Tama County",3,29,176,89,87
050,19,171,"Iowa","Tama County",3,30,161,80,81
050,19,171,"Iowa","Tama County",3,31,199,106,93
050,19,171,"Iowa","Tama County",3,32,173,93,80
050,19,171,"Iowa","Tama County",3,33,172,96,76
050,19,171,"Iowa","Tama County",3,34,168,85,83
050,19,171,"Iowa","Tama County",3,35,179,93,86
050,19,171,"Iowa","Tama County",3,36,183,102,81
050,19,171,"Iowa","Tama County",3,37,203,121,82
050,19,171,"Iowa","Tama County",3,38,189,97,92
050,19,171,"Iowa","Tama County",3,39,181,92,89
050,19,171,"Iowa","Tama County",3,40,188,93,95
050,19,171,"Iowa","Tama County",3,41,211,100,111
050,19,171,"Iowa","Tama County",3,42,187,95,92
050,19,171,"Iowa","Tama County",3,43,187,94,93
050,19,171,"Iowa","Tama County",3,44,182,89,93
050,19,171,"Iowa","Tama County",3,45,179,93,86
050,19,171,"Iowa","Tama County",3,46,184,100,84
050,19,171,"Iowa","Tama County",3,47,176,79,97
050,19,171,"Iowa","Tama County",3,48,168,81,87
050,19,171,"Iowa","Tama County",3,49,178,91,87
050,19,171,"Iowa","Tama County",3,50,212,114,98
050,19,171,"Iowa","Tama County",3,51,249,125,124
050,19,171,"Iowa","Tama County",3,52,217,108,109
050,19,171,"Iowa","Tama County",3,53,224,110,114
050,19,171,"Iowa","Tama County",3,54,214,103,111
050,19,171,"Iowa","Tama County",3,55,232,123,109
050,19,171,"Iowa","Tama County",3,56,223,118,105
050,19,171,"Iowa","Tama County",3,57,224,112,112
050,19,171,"Iowa","Tama County",3,58,244,124,120
050,19,171,"Iowa","Tama County",3,59,271,130,141
050,19,171,"Iowa","Tama County",3,60,253,126,127
050,19,171,"Iowa","Tama County",3,61,259,132,127
050,19,171,"Iowa","Tama County",3,62,250,133,117
050,19,171,"Iowa","Tama County",3,63,258,125,133
050,19,171,"Iowa","Tama County",3,64,273,143,130
050,19,171,"Iowa","Tama County",3,65,247,126,121
050,19,171,"Iowa","Tama County",3,66,243,125,118
050,19,171,"Iowa","Tama County",3,67,228,122,106
050,19,171,"Iowa","Tama County",3,68,206,109,97
050,19,171,"Iowa","Tama County",3,69,201,102,99
050,19,171,"Iowa","Tama County",3,70,201,96,105
050,19,171,"Iowa","Tama County",3,71,185,87,98
050,19,171,"Iowa","Tama County",3,72,166,85,81
050,19,171,"Iowa","Tama County",3,73,161,81,80
050,19,171,"Iowa","Tama County",3,74,164,81,83
050,19,171,"Iowa","Tama County",3,75,124,58,66
050,19,171,"Iowa","Tama County",3,76,129,60,69
050,19,171,"Iowa","Tama County",3,77,105,49,56
050,19,171,"Iowa","Tama County",3,78,111,55,56
050,19,171,"Iowa","Tama County",3,79,96,49,47
050,19,171,"Iowa","Tama County",3,80,94,44,50
050,19,171,"Iowa","Tama County",3,81,84,39,45
050,19,171,"Iowa","Tama County",3,82,81,42,39
050,19,171,"Iowa","Tama County",3,83,80,37,43
050,19,171,"Iowa","Tama County",3,84,65,28,37
050,19,171,"Iowa","Tama County",3,85,465,157,308
050,19,171,"Iowa","Tama County",4,0,198,99,99
050,19,171,"Iowa","Tama County",4,1,181,96,85
050,19,171,"Iowa","Tama County",4,2,204,109,95
050,19,171,"Iowa","Tama County",4,3,218,118,100
050,19,171,"Iowa","Tama County",4,4,219,112,107
050,19,171,"Iowa","Tama County",4,5,215,111,104
050,19,171,"Iowa","Tama County",4,6,216,102,114
050,19,171,"Iowa","Tama County",4,7,254,124,130
050,19,171,"Iowa","Tama County",4,8,233,116,117
050,19,171,"Iowa","Tama County",4,9,236,120,116
050,19,171,"Iowa","Tama County",4,10,232,120,112
050,19,171,"Iowa","Tama County",4,11,211,101,110
050,19,171,"Iowa","Tama County",4,12,205,94,111
050,19,171,"Iowa","Tama County",4,13,237,112,125
050,19,171,"Iowa","Tama County",4,14,241,115,126
050,19,171,"Iowa","Tama County",4,15,233,128,105
050,19,171,"Iowa","Tama County",4,16,260,151,109
050,19,171,"Iowa","Tama County",4,17,238,143,95
050,19,171,"Iowa","Tama County",4,18,224,134,90
050,19,171,"Iowa","Tama County",4,19,173,102,71
050,19,171,"Iowa","Tama County",4,20,171,92,79
050,19,171,"Iowa","Tama County",4,21,186,92,94
050,19,171,"Iowa","Tama County",4,22,198,105,93
050,19,171,"Iowa","Tama County",4,23,187,100,87
050,19,171,"Iowa","Tama County",4,24,194,101,93
050,19,171,"Iowa","Tama County",4,25,176,95,81
050,19,171,"Iowa","Tama County",4,26,177,99,78
050,19,171,"Iowa","Tama County",4,27,171,74,97
050,19,171,"Iowa","Tama County",4,28,178,84,94
050,19,171,"Iowa","Tama County",4,29,198,117,81
050,19,171,"Iowa","Tama County",4,30,183,93,90
050,19,171,"Iowa","Tama County",4,31,164,82,82
050,19,171,"Iowa","Tama County",4,32,194,105,89
050,19,171,"Iowa","Tama County",4,33,179,95,84
050,19,171,"Iowa","Tama County",4,34,177,101,76
050,19,171,"Iowa","Tama County",4,35,178,89,89
050,19,171,"Iowa","Tama County",4,36,185,93,92
050,19,171,"Iowa","Tama County",4,37,180,98,82
050,19,171,"Iowa","Tama County",4,38,198,117,81
050,19,171,"Iowa","Tama County",4,39,192,98,94
050,19,171,"Iowa","Tama County",4,40,186,100,86
050,19,171,"Iowa","Tama County",4,41,199,98,101
050,19,171,"Iowa","Tama County",4,42,208,97,111
050,19,171,"Iowa","Tama County",4,43,202,100,102
050,19,171,"Iowa","Tama County",4,44,184,93,91
050,19,171,"Iowa","Tama County",4,45,180,90,90
050,19,171,"Iowa","Tama County",4,46,184,94,90
050,19,171,"Iowa","Tama County",4,47,177,94,83
050,19,171,"Iowa","Tama County",4,48,175,80,95
050,19,171,"Iowa","Tama County",4,49,161,77,84
050,19,171,"Iowa","Tama County",4,50,172,90,82
050,19,171,"Iowa","Tama County",4,51,214,113,101
050,19,171,"Iowa","Tama County",4,52,244,120,124
050,19,171,"Iowa","Tama County",4,53,220,106,114
050,19,171,"Iowa","Tama County",4,54,219,111,108
050,19,171,"Iowa","Tama County",4,55,221,106,115
050,19,171,"Iowa","Tama County",4,56,225,118,107
050,19,171,"Iowa","Tama County",4,57,226,120,106
050,19,171,"Iowa","Tama County",4,58,224,113,111
050,19,171,"Iowa","Tama County",4,59,245,123,122
050,19,171,"Iowa","Tama County",4,60,264,129,135
050,19,171,"Iowa","Tama County",4,61,254,124,130
050,19,171,"Iowa","Tama County",4,62,255,132,123
050,19,171,"Iowa","Tama County",4,63,249,129,120
050,19,171,"Iowa","Tama County",4,64,251,122,129
050,19,171,"Iowa","Tama County",4,65,263,137,126
050,19,171,"Iowa","Tama County",4,66,247,123,124
050,19,171,"Iowa","Tama County",4,67,233,123,110
050,19,171,"Iowa","Tama County",4,68,222,119,103
050,19,171,"Iowa","Tama County",4,69,195,101,94
050,19,171,"Iowa","Tama County",4,70,186,95,91
050,19,171,"Iowa","Tama County",4,71,194,92,102
050,19,171,"Iowa","Tama County",4,72,179,88,91
050,19,171,"Iowa","Tama County",4,73,162,82,80
050,19,171,"Iowa","Tama County",4,74,155,75,80
050,19,171,"Iowa","Tama County",4,75,154,76,78
050,19,171,"Iowa","Tama County",4,76,116,53,63
050,19,171,"Iowa","Tama County",4,77,125,59,66
050,19,171,"Iowa","Tama County",4,78,103,48,55
050,19,171,"Iowa","Tama County",4,79,112,56,56
050,19,171,"Iowa","Tama County",4,80,88,48,40
050,19,171,"Iowa","Tama County",4,81,84,35,49
050,19,171,"Iowa","Tama County",4,82,81,41,40
050,19,171,"Iowa","Tama County",4,83,77,40,37
050,19,171,"Iowa","Tama County",4,84,77,35,42
050,19,171,"Iowa","Tama County",4,85,457,155,302
050,19,171,"Iowa","Tama County",5,0,203,103,100
050,19,171,"Iowa","Tama County",5,1,193,100,93
050,19,171,"Iowa","Tama County",5,2,175,90,85
050,19,171,"Iowa","Tama County",5,3,204,113,91
050,19,171,"Iowa","Tama County",5,4,209,114,95
050,19,171,"Iowa","Tama County",5,5,220,115,105
050,19,171,"Iowa","Tama County",5,6,221,116,105
050,19,171,"Iowa","Tama County",5,7,214,102,112
050,19,171,"Iowa","Tama County",5,8,258,127,131
050,19,171,"Iowa","Tama County",5,9,234,115,119
050,19,171,"Iowa","Tama County",5,10,238,116,122
050,19,171,"Iowa","Tama County",5,11,221,115,106
050,19,171,"Iowa","Tama County",5,12,219,104,115
050,19,171,"Iowa","Tama County",5,13,205,99,106
050,19,171,"Iowa","Tama County",5,14,239,109,130
050,19,171,"Iowa","Tama County",5,15,245,119,126
050,19,171,"Iowa","Tama County",5,16,241,131,110
050,19,171,"Iowa","Tama County",5,17,271,158,113
050,19,171,"Iowa","Tama County",5,18,205,126,79
050,19,171,"Iowa","Tama County",5,19,187,114,73
050,19,171,"Iowa","Tama County",5,20,176,106,70
050,19,171,"Iowa","Tama County",5,21,176,93,83
050,19,171,"Iowa","Tama County",5,22,199,101,98
050,19,171,"Iowa","Tama County",5,23,185,96,89
050,19,171,"Iowa","Tama County",5,24,171,95,76
050,19,171,"Iowa","Tama County",5,25,184,94,90
050,19,171,"Iowa","Tama County",5,26,166,90,76
050,19,171,"Iowa","Tama County",5,27,155,85,70
050,19,171,"Iowa","Tama County",5,28,168,78,90
050,19,171,"Iowa","Tama County",5,29,184,87,97
050,19,171,"Iowa","Tama County",5,30,189,106,83
050,19,171,"Iowa","Tama County",5,31,181,91,90
050,19,171,"Iowa","Tama County",5,32,171,84,87
050,19,171,"Iowa","Tama County",5,33,199,106,93
050,19,171,"Iowa","Tama County",5,34,187,103,84
050,19,171,"Iowa","Tama County",5,35,173,100,73
050,19,171,"Iowa","Tama County",5,36,173,85,88
050,19,171,"Iowa","Tama County",5,37,185,87,98
050,19,171,"Iowa","Tama County",5,38,182,98,84
050,19,171,"Iowa","Tama County",5,39,198,114,84
050,19,171,"Iowa","Tama County",5,40,192,100,92
050,19,171,"Iowa","Tama County",5,41,185,100,85
050,19,171,"Iowa","Tama County",5,42,197,98,99
050,19,171,"Iowa","Tama County",5,43,202,96,106
050,19,171,"Iowa","Tama County",5,44,202,100,102
050,19,171,"Iowa","Tama County",5,45,183,93,90
050,19,171,"Iowa","Tama County",5,46,180,90,90
050,19,171,"Iowa","Tama County",5,47,182,89,93
050,19,171,"Iowa","Tama County",5,48,182,98,84
050,19,171,"Iowa","Tama County",5,49,169,73,96
050,19,171,"Iowa","Tama County",5,50,165,82,83
050,19,171,"Iowa","Tama County",5,51,171,88,83
050,19,171,"Iowa","Tama County",5,52,210,109,101
050,19,171,"Iowa","Tama County",5,53,245,124,121
050,19,171,"Iowa","Tama County",5,54,218,104,114
050,19,171,"Iowa","Tama County",5,55,216,106,110
050,19,171,"Iowa","Tama County",5,56,217,104,113
050,19,171,"Iowa","Tama County",5,57,229,122,107
050,19,171,"Iowa","Tama County",5,58,224,117,107
050,19,171,"Iowa","Tama County",5,59,225,111,114
050,19,171,"Iowa","Tama County",5,60,246,124,122
050,19,171,"Iowa","Tama County",5,61,263,128,135
050,19,171,"Iowa","Tama County",5,62,255,126,129
050,19,171,"Iowa","Tama County",5,63,250,130,120
050,19,171,"Iowa","Tama County",5,64,247,128,119
050,19,171,"Iowa","Tama County",5,65,248,117,131
050,19,171,"Iowa","Tama County",5,66,257,133,124
050,19,171,"Iowa","Tama County",5,67,242,122,120
050,19,171,"Iowa","Tama County",5,68,235,122,113
050,19,171,"Iowa","Tama County",5,69,207,110,97
050,19,171,"Iowa","Tama County",5,70,187,96,91
050,19,171,"Iowa","Tama County",5,71,179,91,88
050,19,171,"Iowa","Tama County",5,72,192,91,101
050,19,171,"Iowa","Tama County",5,73,176,86,90
050,19,171,"Iowa","Tama County",5,74,155,78,77
050,19,171,"Iowa","Tama County",5,75,150,72,78
050,19,171,"Iowa","Tama County",5,76,148,73,75
050,19,171,"Iowa","Tama County",5,77,107,49,58
050,19,171,"Iowa","Tama County",5,78,122,57,65
050,19,171,"Iowa","Tama County",5,79,103,47,56
050,19,171,"Iowa","Tama County",5,80,105,53,52
050,19,171,"Iowa","Tama County",5,81,78,40,38
050,19,171,"Iowa","Tama County",5,82,75,34,41
050,19,171,"Iowa","Tama County",5,83,73,37,36
050,19,171,"Iowa","Tama County",5,84,71,35,36
050,19,171,"Iowa","Tama County",5,85,464,164,300
050,19,173,"Iowa","Taylor County",1,0,62,32,30
050,19,173,"Iowa","Taylor County",1,1,60,29,31
050,19,173,"Iowa","Taylor County",1,2,71,33,38
050,19,173,"Iowa","Taylor County",1,3,67,29,38
050,19,173,"Iowa","Taylor County",1,4,76,44,32
050,19,173,"Iowa","Taylor County",1,5,87,55,32
050,19,173,"Iowa","Taylor County",1,6,87,51,36
050,19,173,"Iowa","Taylor County",1,7,85,42,43
050,19,173,"Iowa","Taylor County",1,8,68,32,36
050,19,173,"Iowa","Taylor County",1,9,77,40,37
050,19,173,"Iowa","Taylor County",1,10,74,46,28
050,19,173,"Iowa","Taylor County",1,11,70,35,35
050,19,173,"Iowa","Taylor County",1,12,87,49,38
050,19,173,"Iowa","Taylor County",1,13,81,44,37
050,19,173,"Iowa","Taylor County",1,14,91,42,49
050,19,173,"Iowa","Taylor County",1,15,87,47,40
050,19,173,"Iowa","Taylor County",1,16,75,44,31
050,19,173,"Iowa","Taylor County",1,17,69,37,32
050,19,173,"Iowa","Taylor County",1,18,61,36,25
050,19,173,"Iowa","Taylor County",1,19,58,33,25
050,19,173,"Iowa","Taylor County",1,20,60,33,27
050,19,173,"Iowa","Taylor County",1,21,60,37,23
050,19,173,"Iowa","Taylor County",1,22,60,27,33
050,19,173,"Iowa","Taylor County",1,23,54,32,22
050,19,173,"Iowa","Taylor County",1,24,52,28,24
050,19,173,"Iowa","Taylor County",1,25,58,31,27
050,19,173,"Iowa","Taylor County",1,26,59,26,33
050,19,173,"Iowa","Taylor County",1,27,54,29,25
050,19,173,"Iowa","Taylor County",1,28,48,26,22
050,19,173,"Iowa","Taylor County",1,29,64,30,34
050,19,173,"Iowa","Taylor County",1,30,61,30,31
050,19,173,"Iowa","Taylor County",1,31,61,32,29
050,19,173,"Iowa","Taylor County",1,32,56,29,27
050,19,173,"Iowa","Taylor County",1,33,59,28,31
050,19,173,"Iowa","Taylor County",1,34,67,34,33
050,19,173,"Iowa","Taylor County",1,35,77,38,39
050,19,173,"Iowa","Taylor County",1,36,68,39,29
050,19,173,"Iowa","Taylor County",1,37,72,40,32
050,19,173,"Iowa","Taylor County",1,38,83,48,35
050,19,173,"Iowa","Taylor County",1,39,81,52,29
050,19,173,"Iowa","Taylor County",1,40,75,42,33
050,19,173,"Iowa","Taylor County",1,41,64,34,30
050,19,173,"Iowa","Taylor County",1,42,65,32,33
050,19,173,"Iowa","Taylor County",1,43,58,27,31
050,19,173,"Iowa","Taylor County",1,44,50,24,26
050,19,173,"Iowa","Taylor County",1,45,56,22,34
050,19,173,"Iowa","Taylor County",1,46,57,26,31
050,19,173,"Iowa","Taylor County",1,47,50,26,24
050,19,173,"Iowa","Taylor County",1,48,66,32,34
050,19,173,"Iowa","Taylor County",1,49,65,34,31
050,19,173,"Iowa","Taylor County",1,50,57,31,26
050,19,173,"Iowa","Taylor County",1,51,73,36,37
050,19,173,"Iowa","Taylor County",1,52,69,35,34
050,19,173,"Iowa","Taylor County",1,53,67,37,30
050,19,173,"Iowa","Taylor County",1,54,68,44,24
050,19,173,"Iowa","Taylor County",1,55,81,41,40
050,19,173,"Iowa","Taylor County",1,56,93,44,49
050,19,173,"Iowa","Taylor County",1,57,85,42,43
050,19,173,"Iowa","Taylor County",1,58,89,38,51
050,19,173,"Iowa","Taylor County",1,59,86,44,42
050,19,173,"Iowa","Taylor County",1,60,92,46,46
050,19,173,"Iowa","Taylor County",1,61,90,47,43
050,19,173,"Iowa","Taylor County",1,62,77,35,42
050,19,173,"Iowa","Taylor County",1,63,80,36,44
050,19,173,"Iowa","Taylor County",1,64,83,44,39
050,19,173,"Iowa","Taylor County",1,65,74,39,35
050,19,173,"Iowa","Taylor County",1,66,82,40,42
050,19,173,"Iowa","Taylor County",1,67,83,44,39
050,19,173,"Iowa","Taylor County",1,68,89,47,42
050,19,173,"Iowa","Taylor County",1,69,83,40,43
050,19,173,"Iowa","Taylor County",1,70,71,36,35
050,19,173,"Iowa","Taylor County",1,71,66,34,32
050,19,173,"Iowa","Taylor County",1,72,68,35,33
050,19,173,"Iowa","Taylor County",1,73,67,38,29
050,19,173,"Iowa","Taylor County",1,74,60,34,26
050,19,173,"Iowa","Taylor County",1,75,56,27,29
050,19,173,"Iowa","Taylor County",1,76,60,28,32
050,19,173,"Iowa","Taylor County",1,77,43,21,22
050,19,173,"Iowa","Taylor County",1,78,43,20,23
050,19,173,"Iowa","Taylor County",1,79,45,26,19
050,19,173,"Iowa","Taylor County",1,80,38,20,18
050,19,173,"Iowa","Taylor County",1,81,32,14,18
050,19,173,"Iowa","Taylor County",1,82,33,12,21
050,19,173,"Iowa","Taylor County",1,83,35,14,21
050,19,173,"Iowa","Taylor County",1,84,31,15,16
050,19,173,"Iowa","Taylor County",1,85,191,72,119
050,19,173,"Iowa","Taylor County",2,0,61,30,31
050,19,173,"Iowa","Taylor County",2,1,60,30,30
050,19,173,"Iowa","Taylor County",2,2,68,32,36
050,19,173,"Iowa","Taylor County",2,3,66,29,37
050,19,173,"Iowa","Taylor County",2,4,73,40,33
050,19,173,"Iowa","Taylor County",2,5,85,53,32
050,19,173,"Iowa","Taylor County",2,6,89,53,36
050,19,173,"Iowa","Taylor County",2,7,85,43,42
050,19,173,"Iowa","Taylor County",2,8,72,33,39
050,19,173,"Iowa","Taylor County",2,9,75,38,37
050,19,173,"Iowa","Taylor County",2,10,74,44,30
050,19,173,"Iowa","Taylor County",2,11,70,37,33
050,19,173,"Iowa","Taylor County",2,12,83,46,37
050,19,173,"Iowa","Taylor County",2,13,82,45,37
050,19,173,"Iowa","Taylor County",2,14,88,42,46
050,19,173,"Iowa","Taylor County",2,15,88,45,43
050,19,173,"Iowa","Taylor County",2,16,77,44,33
050,19,173,"Iowa","Taylor County",2,17,69,38,31
050,19,173,"Iowa","Taylor County",2,18,62,36,26
050,19,173,"Iowa","Taylor County",2,19,55,32,23
050,19,173,"Iowa","Taylor County",2,20,62,35,27
050,19,173,"Iowa","Taylor County",2,21,61,36,25
050,19,173,"Iowa","Taylor County",2,22,59,29,30
050,19,173,"Iowa","Taylor County",2,23,54,30,24
050,19,173,"Iowa","Taylor County",2,24,53,29,24
050,19,173,"Iowa","Taylor County",2,25,56,30,26
050,19,173,"Iowa","Taylor County",2,26,61,28,33
050,19,173,"Iowa","Taylor County",2,27,54,28,26
050,19,173,"Iowa","Taylor County",2,28,51,28,23
050,19,173,"Iowa","Taylor County",2,29,60,29,31
050,19,173,"Iowa","Taylor County",2,30,62,30,32
050,19,173,"Iowa","Taylor County",2,31,58,30,28
050,19,173,"Iowa","Taylor County",2,32,56,29,27
050,19,173,"Iowa","Taylor County",2,33,58,28,30
050,19,173,"Iowa","Taylor County",2,34,64,32,32
050,19,173,"Iowa","Taylor County",2,35,74,37,37
050,19,173,"Iowa","Taylor County",2,36,69,38,31
050,19,173,"Iowa","Taylor County",2,37,69,38,31
050,19,173,"Iowa","Taylor County",2,38,81,47,34
050,19,173,"Iowa","Taylor County",2,39,81,51,30
050,19,173,"Iowa","Taylor County",2,40,75,44,31
050,19,173,"Iowa","Taylor County",2,41,66,36,30
050,19,173,"Iowa","Taylor County",2,42,64,32,32
050,19,173,"Iowa","Taylor County",2,43,59,28,31
050,19,173,"Iowa","Taylor County",2,44,51,24,27
050,19,173,"Iowa","Taylor County",2,45,55,23,32
050,19,173,"Iowa","Taylor County",2,46,56,25,31
050,19,173,"Iowa","Taylor County",2,47,52,26,26
050,19,173,"Iowa","Taylor County",2,48,63,31,32
050,19,173,"Iowa","Taylor County",2,49,64,33,31
050,19,173,"Iowa","Taylor County",2,50,59,31,28
050,19,173,"Iowa","Taylor County",2,51,70,35,35
050,19,173,"Iowa","Taylor County",2,52,69,35,34
050,19,173,"Iowa","Taylor County",2,53,68,37,31
050,19,173,"Iowa","Taylor County",2,54,67,42,25
050,19,173,"Iowa","Taylor County",2,55,78,42,36
050,19,173,"Iowa","Taylor County",2,56,90,44,46
050,19,173,"Iowa","Taylor County",2,57,87,43,44
050,19,173,"Iowa","Taylor County",2,58,86,37,49
050,19,173,"Iowa","Taylor County",2,59,87,43,44
050,19,173,"Iowa","Taylor County",2,60,91,46,45
050,19,173,"Iowa","Taylor County",2,61,90,46,44
050,19,173,"Iowa","Taylor County",2,62,80,38,42
050,19,173,"Iowa","Taylor County",2,63,81,37,44
050,19,173,"Iowa","Taylor County",2,64,80,42,38
050,19,173,"Iowa","Taylor County",2,65,76,40,36
050,19,173,"Iowa","Taylor County",2,66,81,40,41
050,19,173,"Iowa","Taylor County",2,67,82,43,39
050,19,173,"Iowa","Taylor County",2,68,85,45,40
050,19,173,"Iowa","Taylor County",2,69,84,41,43
050,19,173,"Iowa","Taylor County",2,70,73,36,37
050,19,173,"Iowa","Taylor County",2,71,67,34,33
050,19,173,"Iowa","Taylor County",2,72,66,33,33
050,19,173,"Iowa","Taylor County",2,73,72,40,32
050,19,173,"Iowa","Taylor County",2,74,58,33,25
050,19,173,"Iowa","Taylor County",2,75,57,29,28
050,19,173,"Iowa","Taylor County",2,76,58,27,31
050,19,173,"Iowa","Taylor County",2,77,48,23,25
050,19,173,"Iowa","Taylor County",2,78,41,19,22
050,19,173,"Iowa","Taylor County",2,79,45,25,20
050,19,173,"Iowa","Taylor County",2,80,38,21,17
050,19,173,"Iowa","Taylor County",2,81,32,15,17
050,19,173,"Iowa","Taylor County",2,82,33,12,21
050,19,173,"Iowa","Taylor County",2,83,33,13,20
050,19,173,"Iowa","Taylor County",2,84,30,13,17
050,19,173,"Iowa","Taylor County",2,85,190,73,117
050,19,173,"Iowa","Taylor County",3,0,62,28,34
050,19,173,"Iowa","Taylor County",3,1,69,36,33
050,19,173,"Iowa","Taylor County",3,2,62,30,32
050,19,173,"Iowa","Taylor County",3,3,70,31,39
050,19,173,"Iowa","Taylor County",3,4,75,34,41
050,19,173,"Iowa","Taylor County",3,5,82,42,40
050,19,173,"Iowa","Taylor County",3,6,87,54,33
050,19,173,"Iowa","Taylor County",3,7,88,50,38
050,19,173,"Iowa","Taylor County",3,8,85,43,42
050,19,173,"Iowa","Taylor County",3,9,68,34,34
050,19,173,"Iowa","Taylor County",3,10,79,41,38
050,19,173,"Iowa","Taylor County",3,11,78,46,32
050,19,173,"Iowa","Taylor County",3,12,63,33,30
050,19,173,"Iowa","Taylor County",3,13,83,44,39
050,19,173,"Iowa","Taylor County",3,14,82,45,37
050,19,173,"Iowa","Taylor County",3,15,85,43,42
050,19,173,"Iowa","Taylor County",3,16,83,45,38
050,19,173,"Iowa","Taylor County",3,17,75,45,30
050,19,173,"Iowa","Taylor County",3,18,61,36,25
050,19,173,"Iowa","Taylor County",3,19,46,27,19
050,19,173,"Iowa","Taylor County",3,20,65,38,27
050,19,173,"Iowa","Taylor County",3,21,63,36,27
050,19,173,"Iowa","Taylor County",3,22,68,37,31
050,19,173,"Iowa","Taylor County",3,23,61,35,26
050,19,173,"Iowa","Taylor County",3,24,58,34,24
050,19,173,"Iowa","Taylor County",3,25,57,29,28
050,19,173,"Iowa","Taylor County",3,26,54,28,26
050,19,173,"Iowa","Taylor County",3,27,67,30,37
050,19,173,"Iowa","Taylor County",3,28,52,29,23
050,19,173,"Iowa","Taylor County",3,29,54,29,25
050,19,173,"Iowa","Taylor County",3,30,61,28,33
050,19,173,"Iowa","Taylor County",3,31,65,31,34
050,19,173,"Iowa","Taylor County",3,32,54,29,25
050,19,173,"Iowa","Taylor County",3,33,54,27,27
050,19,173,"Iowa","Taylor County",3,34,57,25,32
050,19,173,"Iowa","Taylor County",3,35,67,34,33
050,19,173,"Iowa","Taylor County",3,36,69,35,34
050,19,173,"Iowa","Taylor County",3,37,78,42,36
050,19,173,"Iowa","Taylor County",3,38,73,41,32
050,19,173,"Iowa","Taylor County",3,39,79,44,35
050,19,173,"Iowa","Taylor County",3,40,79,51,28
050,19,173,"Iowa","Taylor County",3,41,79,46,33
050,19,173,"Iowa","Taylor County",3,42,67,36,31
050,19,173,"Iowa","Taylor County",3,43,63,30,33
050,19,173,"Iowa","Taylor County",3,44,62,30,32
050,19,173,"Iowa","Taylor County",3,45,52,26,26
050,19,173,"Iowa","Taylor County",3,46,56,23,33
050,19,173,"Iowa","Taylor County",3,47,56,25,31
050,19,173,"Iowa","Taylor County",3,48,52,26,26
050,19,173,"Iowa","Taylor County",3,49,64,34,30
050,19,173,"Iowa","Taylor County",3,50,62,32,30
050,19,173,"Iowa","Taylor County",3,51,55,30,25
050,19,173,"Iowa","Taylor County",3,52,72,37,35
050,19,173,"Iowa","Taylor County",3,53,67,32,35
050,19,173,"Iowa","Taylor County",3,54,66,35,31
050,19,173,"Iowa","Taylor County",3,55,67,41,26
050,19,173,"Iowa","Taylor County",3,56,74,39,35
050,19,173,"Iowa","Taylor County",3,57,91,45,46
050,19,173,"Iowa","Taylor County",3,58,88,46,42
050,19,173,"Iowa","Taylor County",3,59,85,37,48
050,19,173,"Iowa","Taylor County",3,60,87,44,43
050,19,173,"Iowa","Taylor County",3,61,87,45,42
050,19,173,"Iowa","Taylor County",3,62,90,44,46
050,19,173,"Iowa","Taylor County",3,63,80,39,41
050,19,173,"Iowa","Taylor County",3,64,84,36,48
050,19,173,"Iowa","Taylor County",3,65,80,41,39
050,19,173,"Iowa","Taylor County",3,66,74,39,35
050,19,173,"Iowa","Taylor County",3,67,77,38,39
050,19,173,"Iowa","Taylor County",3,68,83,42,41
050,19,173,"Iowa","Taylor County",3,69,80,41,39
050,19,173,"Iowa","Taylor County",3,70,81,41,40
050,19,173,"Iowa","Taylor County",3,71,72,34,38
050,19,173,"Iowa","Taylor County",3,72,65,34,31
050,19,173,"Iowa","Taylor County",3,73,62,33,29
050,19,173,"Iowa","Taylor County",3,74,71,38,33
050,19,173,"Iowa","Taylor County",3,75,52,30,22
050,19,173,"Iowa","Taylor County",3,76,57,27,30
050,19,173,"Iowa","Taylor County",3,77,54,27,27
050,19,173,"Iowa","Taylor County",3,78,47,22,25
050,19,173,"Iowa","Taylor County",3,79,40,20,20
050,19,173,"Iowa","Taylor County",3,80,43,21,22
050,19,173,"Iowa","Taylor County",3,81,38,22,16
050,19,173,"Iowa","Taylor County",3,82,28,12,16
050,19,173,"Iowa","Taylor County",3,83,28,11,17
050,19,173,"Iowa","Taylor County",3,84,28,12,16
050,19,173,"Iowa","Taylor County",3,85,182,69,113
050,19,173,"Iowa","Taylor County",4,0,75,34,41
050,19,173,"Iowa","Taylor County",4,1,65,27,38
050,19,173,"Iowa","Taylor County",4,2,76,45,31
050,19,173,"Iowa","Taylor County",4,3,61,30,31
050,19,173,"Iowa","Taylor County",4,4,72,33,39
050,19,173,"Iowa","Taylor County",4,5,74,34,40
050,19,173,"Iowa","Taylor County",4,6,78,40,38
050,19,173,"Iowa","Taylor County",4,7,86,53,33
050,19,173,"Iowa","Taylor County",4,8,87,52,35
050,19,173,"Iowa","Taylor County",4,9,87,46,41
050,19,173,"Iowa","Taylor County",4,10,65,27,38
050,19,173,"Iowa","Taylor County",4,11,72,39,33
050,19,173,"Iowa","Taylor County",4,12,80,46,34
050,19,173,"Iowa","Taylor County",4,13,71,38,33
050,19,173,"Iowa","Taylor County",4,14,78,43,35
050,19,173,"Iowa","Taylor County",4,15,86,47,39
050,19,173,"Iowa","Taylor County",4,16,90,47,43
050,19,173,"Iowa","Taylor County",4,17,89,48,41
050,19,173,"Iowa","Taylor County",4,18,64,40,24
050,19,173,"Iowa","Taylor County",4,19,49,29,20
050,19,173,"Iowa","Taylor County",4,20,58,37,21
050,19,173,"Iowa","Taylor County",4,21,58,33,25
050,19,173,"Iowa","Taylor County",4,22,63,36,27
050,19,173,"Iowa","Taylor County",4,23,66,38,28
050,19,173,"Iowa","Taylor County",4,24,68,40,28
050,19,173,"Iowa","Taylor County",4,25,53,32,21
050,19,173,"Iowa","Taylor County",4,26,65,38,27
050,19,173,"Iowa","Taylor County",4,27,59,28,31
050,19,173,"Iowa","Taylor County",4,28,74,30,44
050,19,173,"Iowa","Taylor County",4,29,53,30,23
050,19,173,"Iowa","Taylor County",4,30,61,33,28
050,19,173,"Iowa","Taylor County",4,31,63,28,35
050,19,173,"Iowa","Taylor County",4,32,72,32,40
050,19,173,"Iowa","Taylor County",4,33,56,31,25
050,19,173,"Iowa","Taylor County",4,34,52,28,24
050,19,173,"Iowa","Taylor County",4,35,60,27,33
050,19,173,"Iowa","Taylor County",4,36,68,35,33
050,19,173,"Iowa","Taylor County",4,37,69,34,35
050,19,173,"Iowa","Taylor County",4,38,76,44,32
050,19,173,"Iowa","Taylor County",4,39,71,40,31
050,19,173,"Iowa","Taylor County",4,40,76,43,33
050,19,173,"Iowa","Taylor County",4,41,84,54,30
050,19,173,"Iowa","Taylor County",4,42,79,46,33
050,19,173,"Iowa","Taylor County",4,43,67,36,31
050,19,173,"Iowa","Taylor County",4,44,69,31,38
050,19,173,"Iowa","Taylor County",4,45,58,29,29
050,19,173,"Iowa","Taylor County",4,46,53,26,27
050,19,173,"Iowa","Taylor County",4,47,58,22,36
050,19,173,"Iowa","Taylor County",4,48,59,29,30
050,19,173,"Iowa","Taylor County",4,49,50,27,23
050,19,173,"Iowa","Taylor County",4,50,67,36,31
050,19,173,"Iowa","Taylor County",4,51,61,31,30
050,19,173,"Iowa","Taylor County",4,52,58,31,27
050,19,173,"Iowa","Taylor County",4,53,74,36,38
050,19,173,"Iowa","Taylor County",4,54,68,33,35
050,19,173,"Iowa","Taylor County",4,55,65,34,31
050,19,173,"Iowa","Taylor County",4,56,64,40,24
050,19,173,"Iowa","Taylor County",4,57,74,39,35
050,19,173,"Iowa","Taylor County",4,58,90,44,46
050,19,173,"Iowa","Taylor County",4,59,90,48,42
050,19,173,"Iowa","Taylor County",4,60,81,35,46
050,19,173,"Iowa","Taylor County",4,61,86,44,42
050,19,173,"Iowa","Taylor County",4,62,86,45,41
050,19,173,"Iowa","Taylor County",4,63,90,45,45
050,19,173,"Iowa","Taylor County",4,64,79,38,41
050,19,173,"Iowa","Taylor County",4,65,84,36,48
050,19,173,"Iowa","Taylor County",4,66,73,37,36
050,19,173,"Iowa","Taylor County",4,67,67,34,33
050,19,173,"Iowa","Taylor County",4,68,75,38,37
050,19,173,"Iowa","Taylor County",4,69,79,41,38
050,19,173,"Iowa","Taylor County",4,70,74,36,38
050,19,173,"Iowa","Taylor County",4,71,76,37,39
050,19,173,"Iowa","Taylor County",4,72,68,32,36
050,19,173,"Iowa","Taylor County",4,73,60,35,25
050,19,173,"Iowa","Taylor County",4,74,58,29,29
050,19,173,"Iowa","Taylor County",4,75,66,36,30
050,19,173,"Iowa","Taylor County",4,76,52,29,23
050,19,173,"Iowa","Taylor County",4,77,51,24,27
050,19,173,"Iowa","Taylor County",4,78,51,26,25
050,19,173,"Iowa","Taylor County",4,79,43,22,21
050,19,173,"Iowa","Taylor County",4,80,35,18,17
050,19,173,"Iowa","Taylor County",4,81,38,20,18
050,19,173,"Iowa","Taylor County",4,82,41,21,20
050,19,173,"Iowa","Taylor County",4,83,23,11,12
050,19,173,"Iowa","Taylor County",4,84,24,11,13
050,19,173,"Iowa","Taylor County",4,85,181,72,109
050,19,173,"Iowa","Taylor County",5,0,75,32,43
050,19,173,"Iowa","Taylor County",5,1,73,37,36
050,19,173,"Iowa","Taylor County",5,2,68,28,40
050,19,173,"Iowa","Taylor County",5,3,68,40,28
050,19,173,"Iowa","Taylor County",5,4,65,32,33
050,19,173,"Iowa","Taylor County",5,5,75,36,39
050,19,173,"Iowa","Taylor County",5,6,78,38,40
050,19,173,"Iowa","Taylor County",5,7,81,41,40
050,19,173,"Iowa","Taylor County",5,8,92,54,38
050,19,173,"Iowa","Taylor County",5,9,87,52,35
050,19,173,"Iowa","Taylor County",5,10,88,45,43
050,19,173,"Iowa","Taylor County",5,11,70,33,37
050,19,173,"Iowa","Taylor County",5,12,74,43,31
050,19,173,"Iowa","Taylor County",5,13,77,45,32
050,19,173,"Iowa","Taylor County",5,14,68,37,31
050,19,173,"Iowa","Taylor County",5,15,85,48,37
050,19,173,"Iowa","Taylor County",5,16,95,53,42
050,19,173,"Iowa","Taylor County",5,17,97,52,45
050,19,173,"Iowa","Taylor County",5,18,70,38,32
050,19,173,"Iowa","Taylor County",5,19,55,34,21
050,19,173,"Iowa","Taylor County",5,20,52,31,21
050,19,173,"Iowa","Taylor County",5,21,56,38,18
050,19,173,"Iowa","Taylor County",5,22,63,33,30
050,19,173,"Iowa","Taylor County",5,23,63,33,30
050,19,173,"Iowa","Taylor County",5,24,61,36,25
050,19,173,"Iowa","Taylor County",5,25,66,37,29
050,19,173,"Iowa","Taylor County",5,26,49,28,21
050,19,173,"Iowa","Taylor County",5,27,65,36,29
050,19,173,"Iowa","Taylor County",5,28,63,28,35
050,19,173,"Iowa","Taylor County",5,29,73,31,42
050,19,173,"Iowa","Taylor County",5,30,51,28,23
050,19,173,"Iowa","Taylor County",5,31,68,36,32
050,19,173,"Iowa","Taylor County",5,32,66,32,34
050,19,173,"Iowa","Taylor County",5,33,74,32,42
050,19,173,"Iowa","Taylor County",5,34,62,30,32
050,19,173,"Iowa","Taylor County",5,35,62,35,27
050,19,173,"Iowa","Taylor County",5,36,60,28,32
050,19,173,"Iowa","Taylor County",5,37,74,38,36
050,19,173,"Iowa","Taylor County",5,38,69,35,34
050,19,173,"Iowa","Taylor County",5,39,75,40,35
050,19,173,"Iowa","Taylor County",5,40,72,40,32
050,19,173,"Iowa","Taylor County",5,41,80,44,36
050,19,173,"Iowa","Taylor County",5,42,83,53,30
050,19,173,"Iowa","Taylor County",5,43,80,47,33
050,19,173,"Iowa","Taylor County",5,44,68,36,32
050,19,173,"Iowa","Taylor County",5,45,68,30,38
050,19,173,"Iowa","Taylor County",5,46,64,32,32
050,19,173,"Iowa","Taylor County",5,47,56,26,30
050,19,173,"Iowa","Taylor County",5,48,58,22,36
050,19,173,"Iowa","Taylor County",5,49,58,28,30
050,19,173,"Iowa","Taylor County",5,50,49,27,22
050,19,173,"Iowa","Taylor County",5,51,68,36,32
050,19,173,"Iowa","Taylor County",5,52,64,31,33
050,19,173,"Iowa","Taylor County",5,53,65,35,30
050,19,173,"Iowa","Taylor County",5,54,72,36,36
050,19,173,"Iowa","Taylor County",5,55,66,32,34
050,19,173,"Iowa","Taylor County",5,56,66,36,30
050,19,173,"Iowa","Taylor County",5,57,63,39,24
050,19,173,"Iowa","Taylor County",5,58,71,36,35
050,19,173,"Iowa","Taylor County",5,59,86,41,45
050,19,173,"Iowa","Taylor County",5,60,92,48,44
050,19,173,"Iowa","Taylor County",5,61,78,33,45
050,19,173,"Iowa","Taylor County",5,62,84,43,41
050,19,173,"Iowa","Taylor County",5,63,86,46,40
050,19,173,"Iowa","Taylor County",5,64,89,45,44
050,19,173,"Iowa","Taylor County",5,65,76,37,39
050,19,173,"Iowa","Taylor County",5,66,82,35,47
050,19,173,"Iowa","Taylor County",5,67,70,36,34
050,19,173,"Iowa","Taylor County",5,68,68,33,35
050,19,173,"Iowa","Taylor County",5,69,77,37,40
050,19,173,"Iowa","Taylor County",5,70,74,40,34
050,19,173,"Iowa","Taylor County",5,71,71,34,37
050,19,173,"Iowa","Taylor County",5,72,75,38,37
050,19,173,"Iowa","Taylor County",5,73,64,33,31
050,19,173,"Iowa","Taylor County",5,74,56,33,23
050,19,173,"Iowa","Taylor County",5,75,57,28,29
050,19,173,"Iowa","Taylor County",5,76,63,34,29
050,19,173,"Iowa","Taylor County",5,77,48,28,20
050,19,173,"Iowa","Taylor County",5,78,48,23,25
050,19,173,"Iowa","Taylor County",5,79,50,26,24
050,19,173,"Iowa","Taylor County",5,80,39,20,19
050,19,173,"Iowa","Taylor County",5,81,31,17,14
050,19,173,"Iowa","Taylor County",5,82,39,19,20
050,19,173,"Iowa","Taylor County",5,83,37,20,17
050,19,173,"Iowa","Taylor County",5,84,21,12,9
050,19,173,"Iowa","Taylor County",5,85,179,74,105
050,19,175,"Iowa","Union County",1,0,120,61,59
050,19,175,"Iowa","Union County",1,1,129,64,65
050,19,175,"Iowa","Union County",1,2,144,68,76
050,19,175,"Iowa","Union County",1,3,135,68,67
050,19,175,"Iowa","Union County",1,4,134,64,70
050,19,175,"Iowa","Union County",1,5,129,63,66
050,19,175,"Iowa","Union County",1,6,137,65,72
050,19,175,"Iowa","Union County",1,7,150,77,73
050,19,175,"Iowa","Union County",1,8,149,72,77
050,19,175,"Iowa","Union County",1,9,138,66,72
050,19,175,"Iowa","Union County",1,10,167,80,87
050,19,175,"Iowa","Union County",1,11,165,81,84
050,19,175,"Iowa","Union County",1,12,205,113,92
050,19,175,"Iowa","Union County",1,13,190,102,88
050,19,175,"Iowa","Union County",1,14,174,96,78
050,19,175,"Iowa","Union County",1,15,194,102,92
050,19,175,"Iowa","Union County",1,16,165,80,85
050,19,175,"Iowa","Union County",1,17,178,89,89
050,19,175,"Iowa","Union County",1,18,160,79,81
050,19,175,"Iowa","Union County",1,19,205,112,93
050,19,175,"Iowa","Union County",1,20,196,89,107
050,19,175,"Iowa","Union County",1,21,127,56,71
050,19,175,"Iowa","Union County",1,22,133,62,71
050,19,175,"Iowa","Union County",1,23,135,68,67
050,19,175,"Iowa","Union County",1,24,118,69,49
050,19,175,"Iowa","Union County",1,25,116,64,52
050,19,175,"Iowa","Union County",1,26,127,67,60
050,19,175,"Iowa","Union County",1,27,148,70,78
050,19,175,"Iowa","Union County",1,28,145,71,74
050,19,175,"Iowa","Union County",1,29,135,67,68
050,19,175,"Iowa","Union County",1,30,124,62,62
050,19,175,"Iowa","Union County",1,31,127,62,65
050,19,175,"Iowa","Union County",1,32,108,56,52
050,19,175,"Iowa","Union County",1,33,127,65,62
050,19,175,"Iowa","Union County",1,34,144,73,71
050,19,175,"Iowa","Union County",1,35,161,84,77
050,19,175,"Iowa","Union County",1,36,155,74,81
050,19,175,"Iowa","Union County",1,37,162,75,87
050,19,175,"Iowa","Union County",1,38,142,78,64
050,19,175,"Iowa","Union County",1,39,163,84,79
050,19,175,"Iowa","Union County",1,40,143,64,79
050,19,175,"Iowa","Union County",1,41,146,71,75
050,19,175,"Iowa","Union County",1,42,125,53,72
050,19,175,"Iowa","Union County",1,43,128,63,65
050,19,175,"Iowa","Union County",1,44,133,75,58
050,19,175,"Iowa","Union County",1,45,145,70,75
050,19,175,"Iowa","Union County",1,46,118,59,59
050,19,175,"Iowa","Union County",1,47,141,62,79
050,19,175,"Iowa","Union County",1,48,136,67,69
050,19,175,"Iowa","Union County",1,49,158,80,78
050,19,175,"Iowa","Union County",1,50,122,62,60
050,19,175,"Iowa","Union County",1,51,127,67,60
050,19,175,"Iowa","Union County",1,52,136,63,73
050,19,175,"Iowa","Union County",1,53,140,74,66
050,19,175,"Iowa","Union County",1,54,138,74,64
050,19,175,"Iowa","Union County",1,55,147,68,79
050,19,175,"Iowa","Union County",1,56,155,73,82
050,19,175,"Iowa","Union County",1,57,166,89,77
050,19,175,"Iowa","Union County",1,58,181,84,97
050,19,175,"Iowa","Union County",1,59,178,83,95
050,19,175,"Iowa","Union County",1,60,169,83,86
050,19,175,"Iowa","Union County",1,61,188,92,96
050,19,175,"Iowa","Union County",1,62,175,86,89
050,19,175,"Iowa","Union County",1,63,159,79,80
050,19,175,"Iowa","Union County",1,64,159,76,83
050,19,175,"Iowa","Union County",1,65,145,71,74
050,19,175,"Iowa","Union County",1,66,147,68,79
050,19,175,"Iowa","Union County",1,67,146,68,78
050,19,175,"Iowa","Union County",1,68,147,73,74
050,19,175,"Iowa","Union County",1,69,157,78,79
050,19,175,"Iowa","Union County",1,70,143,72,71
050,19,175,"Iowa","Union County",1,71,137,69,68
050,19,175,"Iowa","Union County",1,72,142,69,73
050,19,175,"Iowa","Union County",1,73,127,57,70
050,19,175,"Iowa","Union County",1,74,86,41,45
050,19,175,"Iowa","Union County",1,75,88,39,49
050,19,175,"Iowa","Union County",1,76,93,38,55
050,19,175,"Iowa","Union County",1,77,92,46,46
050,19,175,"Iowa","Union County",1,78,86,39,47
050,19,175,"Iowa","Union County",1,79,79,32,47
050,19,175,"Iowa","Union County",1,80,71,26,45
050,19,175,"Iowa","Union County",1,81,69,29,40
050,19,175,"Iowa","Union County",1,82,66,27,39
050,19,175,"Iowa","Union County",1,83,47,26,21
050,19,175,"Iowa","Union County",1,84,60,29,31
050,19,175,"Iowa","Union County",1,85,340,129,211
050,19,175,"Iowa","Union County",2,0,123,66,57
050,19,175,"Iowa","Union County",2,1,128,65,63
050,19,175,"Iowa","Union County",2,2,143,68,75
050,19,175,"Iowa","Union County",2,3,139,69,70
050,19,175,"Iowa","Union County",2,4,136,66,70
050,19,175,"Iowa","Union County",2,5,131,64,67
050,19,175,"Iowa","Union County",2,6,134,65,69
050,19,175,"Iowa","Union County",2,7,148,73,75
050,19,175,"Iowa","Union County",2,8,150,74,76
050,19,175,"Iowa","Union County",2,9,140,67,73
050,19,175,"Iowa","Union County",2,10,159,75,84
050,19,175,"Iowa","Union County",2,11,168,83,85
050,19,175,"Iowa","Union County",2,12,196,105,91
050,19,175,"Iowa","Union County",2,13,191,104,87
050,19,175,"Iowa","Union County",2,14,180,99,81
050,19,175,"Iowa","Union County",2,15,189,100,89
050,19,175,"Iowa","Union County",2,16,171,85,86
050,19,175,"Iowa","Union County",2,17,176,86,90
050,19,175,"Iowa","Union County",2,18,164,81,83
050,19,175,"Iowa","Union County",2,19,207,114,93
050,19,175,"Iowa","Union County",2,20,189,84,105
050,19,175,"Iowa","Union County",2,21,131,58,73
050,19,175,"Iowa","Union County",2,22,131,60,71
050,19,175,"Iowa","Union County",2,23,132,65,67
050,19,175,"Iowa","Union County",2,24,118,66,52
050,19,175,"Iowa","Union County",2,25,117,65,52
050,19,175,"Iowa","Union County",2,26,125,66,59
050,19,175,"Iowa","Union County",2,27,142,67,75
050,19,175,"Iowa","Union County",2,28,144,69,75
050,19,175,"Iowa","Union County",2,29,136,66,70
050,19,175,"Iowa","Union County",2,30,129,64,65
050,19,175,"Iowa","Union County",2,31,126,63,63
050,19,175,"Iowa","Union County",2,32,114,59,55
050,19,175,"Iowa","Union County",2,33,118,61,57
050,19,175,"Iowa","Union County",2,34,141,72,69
050,19,175,"Iowa","Union County",2,35,160,82,78
050,19,175,"Iowa","Union County",2,36,155,75,80
050,19,175,"Iowa","Union County",2,37,162,75,87
050,19,175,"Iowa","Union County",2,38,149,79,70
050,19,175,"Iowa","Union County",2,39,156,83,73
050,19,175,"Iowa","Union County",2,40,148,69,79
050,19,175,"Iowa","Union County",2,41,145,70,75
050,19,175,"Iowa","Union County",2,42,129,57,72
050,19,175,"Iowa","Union County",2,43,128,61,67
050,19,175,"Iowa","Union County",2,44,131,71,60
050,19,175,"Iowa","Union County",2,45,141,71,70
050,19,175,"Iowa","Union County",2,46,124,61,63
050,19,175,"Iowa","Union County",2,47,133,60,73
050,19,175,"Iowa","Union County",2,48,136,66,70
050,19,175,"Iowa","Union County",2,49,152,76,76
050,19,175,"Iowa","Union County",2,50,130,66,64
050,19,175,"Iowa","Union County",2,51,126,66,60
050,19,175,"Iowa","Union County",2,52,131,62,69
050,19,175,"Iowa","Union County",2,53,139,71,68
050,19,175,"Iowa","Union County",2,54,138,74,64
050,19,175,"Iowa","Union County",2,55,142,68,74
050,19,175,"Iowa","Union County",2,56,154,72,82
050,19,175,"Iowa","Union County",2,57,162,85,77
050,19,175,"Iowa","Union County",2,58,178,85,93
050,19,175,"Iowa","Union County",2,59,178,83,95
050,19,175,"Iowa","Union County",2,60,171,83,88
050,19,175,"Iowa","Union County",2,61,184,89,95
050,19,175,"Iowa","Union County",2,62,177,87,90
050,19,175,"Iowa","Union County",2,63,166,82,84
050,19,175,"Iowa","Union County",2,64,158,76,82
050,19,175,"Iowa","Union County",2,65,147,71,76
050,19,175,"Iowa","Union County",2,66,149,70,79
050,19,175,"Iowa","Union County",2,67,146,68,78
050,19,175,"Iowa","Union County",2,68,147,72,75
050,19,175,"Iowa","Union County",2,69,155,76,79
050,19,175,"Iowa","Union County",2,70,145,72,73
050,19,175,"Iowa","Union County",2,71,138,70,68
050,19,175,"Iowa","Union County",2,72,137,67,70
050,19,175,"Iowa","Union County",2,73,137,63,74
050,19,175,"Iowa","Union County",2,74,88,41,47
050,19,175,"Iowa","Union County",2,75,88,40,48
050,19,175,"Iowa","Union County",2,76,92,39,53
050,19,175,"Iowa","Union County",2,77,95,45,50
050,19,175,"Iowa","Union County",2,78,86,40,46
050,19,175,"Iowa","Union County",2,79,79,33,46
050,19,175,"Iowa","Union County",2,80,73,27,46
050,19,175,"Iowa","Union County",2,81,69,27,42
050,19,175,"Iowa","Union County",2,82,66,28,38
050,19,175,"Iowa","Union County",2,83,50,26,24
050,19,175,"Iowa","Union County",2,84,55,27,28
050,19,175,"Iowa","Union County",2,85,341,131,210
050,19,175,"Iowa","Union County",3,0,121,71,50
050,19,175,"Iowa","Union County",3,1,128,72,56
050,19,175,"Iowa","Union County",3,2,125,65,60
050,19,175,"Iowa","Union County",3,3,146,69,77
050,19,175,"Iowa","Union County",3,4,139,67,72
050,19,175,"Iowa","Union County",3,5,133,68,65
050,19,175,"Iowa","Union County",3,6,130,67,63
050,19,175,"Iowa","Union County",3,7,138,69,69
050,19,175,"Iowa","Union County",3,8,151,76,75
050,19,175,"Iowa","Union County",3,9,145,73,72
050,19,175,"Iowa","Union County",3,10,140,68,72
050,19,175,"Iowa","Union County",3,11,161,78,83
050,19,175,"Iowa","Union County",3,12,177,93,84
050,19,175,"Iowa","Union County",3,13,179,94,85
050,19,175,"Iowa","Union County",3,14,189,95,94
050,19,175,"Iowa","Union County",3,15,183,98,85
050,19,175,"Iowa","Union County",3,16,185,96,89
050,19,175,"Iowa","Union County",3,17,170,87,83
050,19,175,"Iowa","Union County",3,18,177,87,90
050,19,175,"Iowa","Union County",3,19,207,115,92
050,19,175,"Iowa","Union County",3,20,184,86,98
050,19,175,"Iowa","Union County",3,21,144,64,80
050,19,175,"Iowa","Union County",3,22,128,59,69
050,19,175,"Iowa","Union County",3,23,121,53,68
050,19,175,"Iowa","Union County",3,24,121,64,57
050,19,175,"Iowa","Union County",3,25,145,81,64
050,19,175,"Iowa","Union County",3,26,120,59,61
050,19,175,"Iowa","Union County",3,27,117,59,58
050,19,175,"Iowa","Union County",3,28,136,68,68
050,19,175,"Iowa","Union County",3,29,140,68,72
050,19,175,"Iowa","Union County",3,30,138,64,74
050,19,175,"Iowa","Union County",3,31,121,60,61
050,19,175,"Iowa","Union County",3,32,121,63,58
050,19,175,"Iowa","Union County",3,33,119,63,56
050,19,175,"Iowa","Union County",3,34,118,60,58
050,19,175,"Iowa","Union County",3,35,152,75,77
050,19,175,"Iowa","Union County",3,36,156,81,75
050,19,175,"Iowa","Union County",3,37,154,72,82
050,19,175,"Iowa","Union County",3,38,164,80,84
050,19,175,"Iowa","Union County",3,39,151,79,72
050,19,175,"Iowa","Union County",3,40,160,87,73
050,19,175,"Iowa","Union County",3,41,149,72,77
050,19,175,"Iowa","Union County",3,42,146,68,78
050,19,175,"Iowa","Union County",3,43,123,56,67
050,19,175,"Iowa","Union County",3,44,124,61,63
050,19,175,"Iowa","Union County",3,45,129,67,62
050,19,175,"Iowa","Union County",3,46,140,72,68
050,19,175,"Iowa","Union County",3,47,122,58,64
050,19,175,"Iowa","Union County",3,48,125,58,67
050,19,175,"Iowa","Union County",3,49,136,65,71
050,19,175,"Iowa","Union County",3,50,155,81,74
050,19,175,"Iowa","Union County",3,51,130,67,63
050,19,175,"Iowa","Union County",3,52,128,65,63
050,19,175,"Iowa","Union County",3,53,131,62,69
050,19,175,"Iowa","Union County",3,54,143,73,70
050,19,175,"Iowa","Union County",3,55,140,77,63
050,19,175,"Iowa","Union County",3,56,141,69,72
050,19,175,"Iowa","Union County",3,57,156,76,80
050,19,175,"Iowa","Union County",3,58,159,83,76
050,19,175,"Iowa","Union County",3,59,172,83,89
050,19,175,"Iowa","Union County",3,60,176,80,96
050,19,175,"Iowa","Union County",3,61,167,82,85
050,19,175,"Iowa","Union County",3,62,179,87,92
050,19,175,"Iowa","Union County",3,63,174,87,87
050,19,175,"Iowa","Union County",3,64,166,80,86
050,19,175,"Iowa","Union County",3,65,157,77,80
050,19,175,"Iowa","Union County",3,66,138,65,73
050,19,175,"Iowa","Union County",3,67,149,69,80
050,19,175,"Iowa","Union County",3,68,144,67,77
050,19,175,"Iowa","Union County",3,69,143,70,73
050,19,175,"Iowa","Union County",3,70,158,78,80
050,19,175,"Iowa","Union County",3,71,140,69,71
050,19,175,"Iowa","Union County",3,72,133,66,67
050,19,175,"Iowa","Union County",3,73,134,66,68
050,19,175,"Iowa","Union County",3,74,132,60,72
050,19,175,"Iowa","Union County",3,75,84,40,44
050,19,175,"Iowa","Union County",3,76,85,37,48
050,19,175,"Iowa","Union County",3,77,86,36,50
050,19,175,"Iowa","Union County",3,78,92,44,48
050,19,175,"Iowa","Union County",3,79,76,35,41
050,19,175,"Iowa","Union County",3,80,76,32,44
050,19,175,"Iowa","Union County",3,81,72,25,47
050,19,175,"Iowa","Union County",3,82,68,25,43
050,19,175,"Iowa","Union County",3,83,53,21,32
050,19,175,"Iowa","Union County",3,84,48,23,25
050,19,175,"Iowa","Union County",3,85,336,134,202
050,19,175,"Iowa","Union County",4,0,109,59,50
050,19,175,"Iowa","Union County",4,1,115,60,55
050,19,175,"Iowa","Union County",4,2,119,67,52
050,19,175,"Iowa","Union County",4,3,124,60,64
050,19,175,"Iowa","Union County",4,4,151,74,77
050,19,175,"Iowa","Union County",4,5,139,68,71
050,19,175,"Iowa","Union County",4,6,134,70,64
050,19,175,"Iowa","Union County",4,7,134,67,67
050,19,175,"Iowa","Union County",4,8,129,61,68
050,19,175,"Iowa","Union County",4,9,148,72,76
050,19,175,"Iowa","Union County",4,10,143,77,66
050,19,175,"Iowa","Union County",4,11,141,66,75
050,19,175,"Iowa","Union County",4,12,164,78,86
050,19,175,"Iowa","Union County",4,13,164,86,78
050,19,175,"Iowa","Union County",4,14,188,100,88
050,19,175,"Iowa","Union County",4,15,193,100,93
050,19,175,"Iowa","Union County",4,16,177,95,82
050,19,175,"Iowa","Union County",4,17,195,97,98
050,19,175,"Iowa","Union County",4,18,168,84,84
050,19,175,"Iowa","Union County",4,19,222,124,98
050,19,175,"Iowa","Union County",4,20,166,76,90
050,19,175,"Iowa","Union County",4,21,112,53,59
050,19,175,"Iowa","Union County",4,22,139,61,78
050,19,175,"Iowa","Union County",4,23,126,62,64
050,19,175,"Iowa","Union County",4,24,119,57,62
050,19,175,"Iowa","Union County",4,25,129,76,53
050,19,175,"Iowa","Union County",4,26,134,75,59
050,19,175,"Iowa","Union County",4,27,114,55,59
050,19,175,"Iowa","Union County",4,28,109,59,50
050,19,175,"Iowa","Union County",4,29,117,57,60
050,19,175,"Iowa","Union County",4,30,136,67,69
050,19,175,"Iowa","Union County",4,31,152,78,74
050,19,175,"Iowa","Union County",4,32,137,71,66
050,19,175,"Iowa","Union County",4,33,131,70,61
050,19,175,"Iowa","Union County",4,34,123,64,59
050,19,175,"Iowa","Union County",4,35,131,68,63
050,19,175,"Iowa","Union County",4,36,148,73,75
050,19,175,"Iowa","Union County",4,37,161,84,77
050,19,175,"Iowa","Union County",4,38,155,75,80
050,19,175,"Iowa","Union County",4,39,164,77,87
050,19,175,"Iowa","Union County",4,40,141,74,67
050,19,175,"Iowa","Union County",4,41,160,84,76
050,19,175,"Iowa","Union County",4,42,145,70,75
050,19,175,"Iowa","Union County",4,43,148,69,79
050,19,175,"Iowa","Union County",4,44,121,55,66
050,19,175,"Iowa","Union County",4,45,128,65,63
050,19,175,"Iowa","Union County",4,46,127,66,61
050,19,175,"Iowa","Union County",4,47,137,71,66
050,19,175,"Iowa","Union County",4,48,122,59,63
050,19,175,"Iowa","Union County",4,49,123,58,65
050,19,175,"Iowa","Union County",4,50,134,63,71
050,19,175,"Iowa","Union County",4,51,150,81,69
050,19,175,"Iowa","Union County",4,52,128,68,60
050,19,175,"Iowa","Union County",4,53,131,64,67
050,19,175,"Iowa","Union County",4,54,128,61,67
050,19,175,"Iowa","Union County",4,55,142,73,69
050,19,175,"Iowa","Union County",4,56,139,74,65
050,19,175,"Iowa","Union County",4,57,145,71,74
050,19,175,"Iowa","Union County",4,58,162,80,82
050,19,175,"Iowa","Union County",4,59,158,81,77
050,19,175,"Iowa","Union County",4,60,177,83,94
050,19,175,"Iowa","Union County",4,61,173,77,96
050,19,175,"Iowa","Union County",4,62,156,77,79
050,19,175,"Iowa","Union County",4,63,181,89,92
050,19,175,"Iowa","Union County",4,64,172,85,87
050,19,175,"Iowa","Union County",4,65,166,83,83
050,19,175,"Iowa","Union County",4,66,151,74,77
050,19,175,"Iowa","Union County",4,67,134,63,71
050,19,175,"Iowa","Union County",4,68,147,69,78
050,19,175,"Iowa","Union County",4,69,134,62,72
050,19,175,"Iowa","Union County",4,70,141,69,72
050,19,175,"Iowa","Union County",4,71,155,77,78
050,19,175,"Iowa","Union County",4,72,133,65,68
050,19,175,"Iowa","Union County",4,73,135,65,70
050,19,175,"Iowa","Union County",4,74,135,69,66
050,19,175,"Iowa","Union County",4,75,125,55,70
050,19,175,"Iowa","Union County",4,76,80,40,40
050,19,175,"Iowa","Union County",4,77,81,35,46
050,19,175,"Iowa","Union County",4,78,83,34,49
050,19,175,"Iowa","Union County",4,79,88,43,45
050,19,175,"Iowa","Union County",4,80,69,29,40
050,19,175,"Iowa","Union County",4,81,75,30,45
050,19,175,"Iowa","Union County",4,82,69,23,46
050,19,175,"Iowa","Union County",4,83,52,18,34
050,19,175,"Iowa","Union County",4,84,53,17,36
050,19,175,"Iowa","Union County",4,85,309,126,183
050,19,175,"Iowa","Union County",5,0,104,56,48
050,19,175,"Iowa","Union County",5,1,105,54,51
050,19,175,"Iowa","Union County",5,2,114,58,56
050,19,175,"Iowa","Union County",5,3,125,70,55
050,19,175,"Iowa","Union County",5,4,130,60,70
050,19,175,"Iowa","Union County",5,5,152,72,80
050,19,175,"Iowa","Union County",5,6,137,67,70
050,19,175,"Iowa","Union County",5,7,139,72,67
050,19,175,"Iowa","Union County",5,8,135,65,70
050,19,175,"Iowa","Union County",5,9,130,64,66
050,19,175,"Iowa","Union County",5,10,149,75,74
050,19,175,"Iowa","Union County",5,11,144,79,65
050,19,175,"Iowa","Union County",5,12,150,71,79
050,19,175,"Iowa","Union County",5,13,168,80,88
050,19,175,"Iowa","Union County",5,14,167,87,80
050,19,175,"Iowa","Union County",5,15,182,101,81
050,19,175,"Iowa","Union County",5,16,196,105,91
050,19,175,"Iowa","Union County",5,17,186,95,91
050,19,175,"Iowa","Union County",5,18,197,100,97
050,19,175,"Iowa","Union County",5,19,214,122,92
050,19,175,"Iowa","Union County",5,20,191,88,103
050,19,175,"Iowa","Union County",5,21,116,55,61
050,19,175,"Iowa","Union County",5,22,115,56,59
050,19,175,"Iowa","Union County",5,23,137,66,71
050,19,175,"Iowa","Union County",5,24,132,69,63
050,19,175,"Iowa","Union County",5,25,138,75,63
050,19,175,"Iowa","Union County",5,26,116,63,53
050,19,175,"Iowa","Union County",5,27,145,76,69
050,19,175,"Iowa","Union County",5,28,117,58,59
050,19,175,"Iowa","Union County",5,29,109,63,46
050,19,175,"Iowa","Union County",5,30,122,62,60
050,19,175,"Iowa","Union County",5,31,145,81,64
050,19,175,"Iowa","Union County",5,32,169,95,74
050,19,175,"Iowa","Union County",5,33,125,64,61
050,19,175,"Iowa","Union County",5,34,128,64,64
050,19,175,"Iowa","Union County",5,35,116,59,57
050,19,175,"Iowa","Union County",5,36,131,62,69
050,19,175,"Iowa","Union County",5,37,153,74,79
050,19,175,"Iowa","Union County",5,38,161,83,78
050,19,175,"Iowa","Union County",5,39,152,77,75
050,19,175,"Iowa","Union County",5,40,167,80,87
050,19,175,"Iowa","Union County",5,41,137,68,69
050,19,175,"Iowa","Union County",5,42,162,87,75
050,19,175,"Iowa","Union County",5,43,141,68,73
050,19,175,"Iowa","Union County",5,44,156,72,84
050,19,175,"Iowa","Union County",5,45,126,56,70
050,19,175,"Iowa","Union County",5,46,135,65,70
050,19,175,"Iowa","Union County",5,47,130,64,66
050,19,175,"Iowa","Union County",5,48,136,67,69
050,19,175,"Iowa","Union County",5,49,126,63,63
050,19,175,"Iowa","Union County",5,50,128,56,72
050,19,175,"Iowa","Union County",5,51,138,65,73
050,19,175,"Iowa","Union County",5,52,154,84,70
050,19,175,"Iowa","Union County",5,53,130,67,63
050,19,175,"Iowa","Union County",5,54,132,63,69
050,19,175,"Iowa","Union County",5,55,125,61,64
050,19,175,"Iowa","Union County",5,56,142,72,70
050,19,175,"Iowa","Union County",5,57,138,71,67
050,19,175,"Iowa","Union County",5,58,144,70,74
050,19,175,"Iowa","Union County",5,59,163,80,83
050,19,175,"Iowa","Union County",5,60,157,79,78
050,19,175,"Iowa","Union County",5,61,173,81,92
050,19,175,"Iowa","Union County",5,62,169,74,95
050,19,175,"Iowa","Union County",5,63,154,77,77
050,19,175,"Iowa","Union County",5,64,178,88,90
050,19,175,"Iowa","Union County",5,65,170,84,86
050,19,175,"Iowa","Union County",5,66,161,77,84
050,19,175,"Iowa","Union County",5,67,155,76,79
050,19,175,"Iowa","Union County",5,68,132,63,69
050,19,175,"Iowa","Union County",5,69,138,62,76
050,19,175,"Iowa","Union County",5,70,136,62,74
050,19,175,"Iowa","Union County",5,71,133,63,70
050,19,175,"Iowa","Union County",5,72,151,74,77
050,19,175,"Iowa","Union County",5,73,133,65,68
050,19,175,"Iowa","Union County",5,74,133,64,69
050,19,175,"Iowa","Union County",5,75,129,65,64
050,19,175,"Iowa","Union County",5,76,124,57,67
050,19,175,"Iowa","Union County",5,77,74,36,38
050,19,175,"Iowa","Union County",5,78,71,32,39
050,19,175,"Iowa","Union County",5,79,74,32,42
050,19,175,"Iowa","Union County",5,80,75,33,42
050,19,175,"Iowa","Union County",5,81,70,29,41
050,19,175,"Iowa","Union County",5,82,69,25,44
050,19,175,"Iowa","Union County",5,83,52,15,37
050,19,175,"Iowa","Union County",5,84,47,12,35
050,19,175,"Iowa","Union County",5,85,296,117,179
050,19,177,"Iowa","Van Buren County",1,0,93,48,45
050,19,177,"Iowa","Van Buren County",1,1,94,48,46
050,19,177,"Iowa","Van Buren County",1,2,102,50,52
050,19,177,"Iowa","Van Buren County",1,3,84,47,37
050,19,177,"Iowa","Van Buren County",1,4,90,55,35
050,19,177,"Iowa","Van Buren County",1,5,72,38,34
050,19,177,"Iowa","Van Buren County",1,6,86,40,46
050,19,177,"Iowa","Van Buren County",1,7,100,47,53
050,19,177,"Iowa","Van Buren County",1,8,92,46,46
050,19,177,"Iowa","Van Buren County",1,9,86,47,39
050,19,177,"Iowa","Van Buren County",1,10,109,56,53
050,19,177,"Iowa","Van Buren County",1,11,93,57,36
050,19,177,"Iowa","Van Buren County",1,12,104,58,46
050,19,177,"Iowa","Van Buren County",1,13,94,57,37
050,19,177,"Iowa","Van Buren County",1,14,101,57,44
050,19,177,"Iowa","Van Buren County",1,15,92,49,43
050,19,177,"Iowa","Van Buren County",1,16,94,47,47
050,19,177,"Iowa","Van Buren County",1,17,103,57,46
050,19,177,"Iowa","Van Buren County",1,18,87,50,37
050,19,177,"Iowa","Van Buren County",1,19,66,43,23
050,19,177,"Iowa","Van Buren County",1,20,60,29,31
050,19,177,"Iowa","Van Buren County",1,21,67,29,38
050,19,177,"Iowa","Van Buren County",1,22,71,29,42
050,19,177,"Iowa","Van Buren County",1,23,79,42,37
050,19,177,"Iowa","Van Buren County",1,24,77,46,31
050,19,177,"Iowa","Van Buren County",1,25,75,37,38
050,19,177,"Iowa","Van Buren County",1,26,84,38,46
050,19,177,"Iowa","Van Buren County",1,27,71,42,29
050,19,177,"Iowa","Van Buren County",1,28,65,35,30
050,19,177,"Iowa","Van Buren County",1,29,61,30,31
050,19,177,"Iowa","Van Buren County",1,30,68,29,39
050,19,177,"Iowa","Van Buren County",1,31,70,36,34
050,19,177,"Iowa","Van Buren County",1,32,71,39,32
050,19,177,"Iowa","Van Buren County",1,33,61,27,34
050,19,177,"Iowa","Van Buren County",1,34,71,31,40
050,19,177,"Iowa","Van Buren County",1,35,79,39,40
050,19,177,"Iowa","Van Buren County",1,36,78,38,40
050,19,177,"Iowa","Van Buren County",1,37,81,41,40
050,19,177,"Iowa","Van Buren County",1,38,85,40,45
050,19,177,"Iowa","Van Buren County",1,39,87,48,39
050,19,177,"Iowa","Van Buren County",1,40,86,54,32
050,19,177,"Iowa","Van Buren County",1,41,83,44,39
050,19,177,"Iowa","Van Buren County",1,42,74,40,34
050,19,177,"Iowa","Van Buren County",1,43,74,39,35
050,19,177,"Iowa","Van Buren County",1,44,70,40,30
050,19,177,"Iowa","Van Buren County",1,45,81,40,41
050,19,177,"Iowa","Van Buren County",1,46,78,37,41
050,19,177,"Iowa","Van Buren County",1,47,65,42,23
050,19,177,"Iowa","Van Buren County",1,48,86,48,38
050,19,177,"Iowa","Van Buren County",1,49,81,40,41
050,19,177,"Iowa","Van Buren County",1,50,88,49,39
050,19,177,"Iowa","Van Buren County",1,51,77,46,31
050,19,177,"Iowa","Van Buren County",1,52,92,46,46
050,19,177,"Iowa","Van Buren County",1,53,100,49,51
050,19,177,"Iowa","Van Buren County",1,54,91,43,48
050,19,177,"Iowa","Van Buren County",1,55,98,47,51
050,19,177,"Iowa","Van Buren County",1,56,102,51,51
050,19,177,"Iowa","Van Buren County",1,57,100,50,50
050,19,177,"Iowa","Van Buren County",1,58,121,60,61
050,19,177,"Iowa","Van Buren County",1,59,111,54,57
050,19,177,"Iowa","Van Buren County",1,60,118,61,57
050,19,177,"Iowa","Van Buren County",1,61,105,57,48
050,19,177,"Iowa","Van Buren County",1,62,104,47,57
050,19,177,"Iowa","Van Buren County",1,63,104,54,50
050,19,177,"Iowa","Van Buren County",1,64,115,62,53
050,19,177,"Iowa","Van Buren County",1,65,104,54,50
050,19,177,"Iowa","Van Buren County",1,66,121,56,65
050,19,177,"Iowa","Van Buren County",1,67,123,59,64
050,19,177,"Iowa","Van Buren County",1,68,106,54,52
050,19,177,"Iowa","Van Buren County",1,69,89,48,41
050,19,177,"Iowa","Van Buren County",1,70,88,41,47
050,19,177,"Iowa","Van Buren County",1,71,97,46,51
050,19,177,"Iowa","Van Buren County",1,72,93,49,44
050,19,177,"Iowa","Van Buren County",1,73,72,33,39
050,19,177,"Iowa","Van Buren County",1,74,62,26,36
050,19,177,"Iowa","Van Buren County",1,75,60,33,27
050,19,177,"Iowa","Van Buren County",1,76,50,23,27
050,19,177,"Iowa","Van Buren County",1,77,64,31,33
050,19,177,"Iowa","Van Buren County",1,78,50,23,27
050,19,177,"Iowa","Van Buren County",1,79,40,20,20
050,19,177,"Iowa","Van Buren County",1,80,37,18,19
050,19,177,"Iowa","Van Buren County",1,81,46,21,25
050,19,177,"Iowa","Van Buren County",1,82,43,20,23
050,19,177,"Iowa","Van Buren County",1,83,44,18,26
050,19,177,"Iowa","Van Buren County",1,84,36,12,24
050,19,177,"Iowa","Van Buren County",1,85,174,70,104
050,19,177,"Iowa","Van Buren County",2,0,94,48,46
050,19,177,"Iowa","Van Buren County",2,1,95,49,46
050,19,177,"Iowa","Van Buren County",2,2,100,50,50
050,19,177,"Iowa","Van Buren County",2,3,88,48,40
050,19,177,"Iowa","Van Buren County",2,4,89,53,36
050,19,177,"Iowa","Van Buren County",2,5,77,42,35
050,19,177,"Iowa","Van Buren County",2,6,83,39,44
050,19,177,"Iowa","Van Buren County",2,7,99,46,53
050,19,177,"Iowa","Van Buren County",2,8,93,46,47
050,19,177,"Iowa","Van Buren County",2,9,88,47,41
050,19,177,"Iowa","Van Buren County",2,10,104,54,50
050,19,177,"Iowa","Van Buren County",2,11,96,56,40
050,19,177,"Iowa","Van Buren County",2,12,102,58,44
050,19,177,"Iowa","Van Buren County",2,13,98,58,40
050,19,177,"Iowa","Van Buren County",2,14,100,57,43
050,19,177,"Iowa","Van Buren County",2,15,95,51,44
050,19,177,"Iowa","Van Buren County",2,16,95,48,47
050,19,177,"Iowa","Van Buren County",2,17,101,54,47
050,19,177,"Iowa","Van Buren County",2,18,84,48,36
050,19,177,"Iowa","Van Buren County",2,19,66,42,24
050,19,177,"Iowa","Van Buren County",2,20,64,33,31
050,19,177,"Iowa","Van Buren County",2,21,68,30,38
050,19,177,"Iowa","Van Buren County",2,22,71,29,42
050,19,177,"Iowa","Van Buren County",2,23,78,40,38
050,19,177,"Iowa","Van Buren County",2,24,77,45,32
050,19,177,"Iowa","Van Buren County",2,25,77,39,38
050,19,177,"Iowa","Van Buren County",2,26,82,39,43
050,19,177,"Iowa","Van Buren County",2,27,75,41,34
050,19,177,"Iowa","Van Buren County",2,28,67,37,30
050,19,177,"Iowa","Van Buren County",2,29,63,31,32
050,19,177,"Iowa","Van Buren County",2,30,67,30,37
050,19,177,"Iowa","Van Buren County",2,31,69,34,35
050,19,177,"Iowa","Van Buren County",2,32,69,38,31
050,19,177,"Iowa","Van Buren County",2,33,64,30,34
050,19,177,"Iowa","Van Buren County",2,34,70,31,39
050,19,177,"Iowa","Van Buren County",2,35,77,37,40
050,19,177,"Iowa","Van Buren County",2,36,77,37,40
050,19,177,"Iowa","Van Buren County",2,37,79,39,40
050,19,177,"Iowa","Van Buren County",2,38,85,41,44
050,19,177,"Iowa","Van Buren County",2,39,87,47,40
050,19,177,"Iowa","Van Buren County",2,40,88,53,35
050,19,177,"Iowa","Van Buren County",2,41,83,46,37
050,19,177,"Iowa","Van Buren County",2,42,75,40,35
050,19,177,"Iowa","Van Buren County",2,43,74,40,34
050,19,177,"Iowa","Van Buren County",2,44,69,39,30
050,19,177,"Iowa","Van Buren County",2,45,79,40,39
050,19,177,"Iowa","Van Buren County",2,46,77,37,40
050,19,177,"Iowa","Van Buren County",2,47,68,41,27
050,19,177,"Iowa","Van Buren County",2,48,82,47,35
050,19,177,"Iowa","Van Buren County",2,49,83,42,41
050,19,177,"Iowa","Van Buren County",2,50,87,48,39
050,19,177,"Iowa","Van Buren County",2,51,80,47,33
050,19,177,"Iowa","Van Buren County",2,52,87,45,42
050,19,177,"Iowa","Van Buren County",2,53,98,48,50
050,19,177,"Iowa","Van Buren County",2,54,94,45,49
050,19,177,"Iowa","Van Buren County",2,55,98,46,52
050,19,177,"Iowa","Van Buren County",2,56,102,50,52
050,19,177,"Iowa","Van Buren County",2,57,99,51,48
050,19,177,"Iowa","Van Buren County",2,58,115,57,58
050,19,177,"Iowa","Van Buren County",2,59,113,55,58
050,19,177,"Iowa","Van Buren County",2,60,116,59,57
050,19,177,"Iowa","Van Buren County",2,61,108,58,50
050,19,177,"Iowa","Van Buren County",2,62,105,50,55
050,19,177,"Iowa","Van Buren County",2,63,103,52,51
050,19,177,"Iowa","Van Buren County",2,64,113,61,52
050,19,177,"Iowa","Van Buren County",2,65,107,56,51
050,19,177,"Iowa","Van Buren County",2,66,118,56,62
050,19,177,"Iowa","Van Buren County",2,67,122,58,64
050,19,177,"Iowa","Van Buren County",2,68,108,53,55
050,19,177,"Iowa","Van Buren County",2,69,92,49,43
050,19,177,"Iowa","Van Buren County",2,70,88,43,45
050,19,177,"Iowa","Van Buren County",2,71,95,45,50
050,19,177,"Iowa","Van Buren County",2,72,92,47,45
050,19,177,"Iowa","Van Buren County",2,73,82,39,43
050,19,177,"Iowa","Van Buren County",2,74,61,26,35
050,19,177,"Iowa","Van Buren County",2,75,62,32,30
050,19,177,"Iowa","Van Buren County",2,76,52,25,27
050,19,177,"Iowa","Van Buren County",2,77,61,29,32
050,19,177,"Iowa","Van Buren County",2,78,52,25,27
050,19,177,"Iowa","Van Buren County",2,79,41,20,21
050,19,177,"Iowa","Van Buren County",2,80,36,18,18
050,19,177,"Iowa","Van Buren County",2,81,43,20,23
050,19,177,"Iowa","Van Buren County",2,82,43,20,23
050,19,177,"Iowa","Van Buren County",2,83,43,18,25
050,19,177,"Iowa","Van Buren County",2,84,38,14,24
050,19,177,"Iowa","Van Buren County",2,85,177,71,106
050,19,177,"Iowa","Van Buren County",3,0,95,46,49
050,19,177,"Iowa","Van Buren County",3,1,94,47,47
050,19,177,"Iowa","Van Buren County",3,2,93,47,46
050,19,177,"Iowa","Van Buren County",3,3,101,50,51
050,19,177,"Iowa","Van Buren County",3,4,88,50,38
050,19,177,"Iowa","Van Buren County",3,5,87,54,33
050,19,177,"Iowa","Van Buren County",3,6,70,38,32
050,19,177,"Iowa","Van Buren County",3,7,87,45,42
050,19,177,"Iowa","Van Buren County",3,8,100,47,53
050,19,177,"Iowa","Van Buren County",3,9,92,45,47
050,19,177,"Iowa","Van Buren County",3,10,98,52,46
050,19,177,"Iowa","Van Buren County",3,11,101,52,49
050,19,177,"Iowa","Van Buren County",3,12,99,61,38
050,19,177,"Iowa","Van Buren County",3,13,100,59,41
050,19,177,"Iowa","Van Buren County",3,14,96,58,38
050,19,177,"Iowa","Van Buren County",3,15,102,54,48
050,19,177,"Iowa","Van Buren County",3,16,97,52,45
050,19,177,"Iowa","Van Buren County",3,17,97,48,49
050,19,177,"Iowa","Van Buren County",3,18,83,48,35
050,19,177,"Iowa","Van Buren County",3,19,68,40,28
050,19,177,"Iowa","Van Buren County",3,20,75,44,31
050,19,177,"Iowa","Van Buren County",3,21,66,33,33
050,19,177,"Iowa","Van Buren County",3,22,68,31,37
050,19,177,"Iowa","Van Buren County",3,23,75,33,42
050,19,177,"Iowa","Van Buren County",3,24,73,38,35
050,19,177,"Iowa","Van Buren County",3,25,75,41,34
050,19,177,"Iowa","Van Buren County",3,26,81,40,41
050,19,177,"Iowa","Van Buren County",3,27,81,39,42
050,19,177,"Iowa","Van Buren County",3,28,69,36,33
050,19,177,"Iowa","Van Buren County",3,29,59,35,24
050,19,177,"Iowa","Van Buren County",3,30,73,36,37
050,19,177,"Iowa","Van Buren County",3,31,67,32,35
050,19,177,"Iowa","Van Buren County",3,32,73,37,36
050,19,177,"Iowa","Van Buren County",3,33,71,35,36
050,19,177,"Iowa","Van Buren County",3,34,67,32,35
050,19,177,"Iowa","Van Buren County",3,35,72,33,39
050,19,177,"Iowa","Van Buren County",3,36,76,38,38
050,19,177,"Iowa","Van Buren County",3,37,76,35,41
050,19,177,"Iowa","Van Buren County",3,38,84,41,43
050,19,177,"Iowa","Van Buren County",3,39,85,41,44
050,19,177,"Iowa","Van Buren County",3,40,90,48,42
050,19,177,"Iowa","Van Buren County",3,41,88,57,31
050,19,177,"Iowa","Van Buren County",3,42,84,48,36
050,19,177,"Iowa","Van Buren County",3,43,77,41,36
050,19,177,"Iowa","Van Buren County",3,44,72,38,34
050,19,177,"Iowa","Van Buren County",3,45,74,44,30
050,19,177,"Iowa","Van Buren County",3,46,79,40,39
050,19,177,"Iowa","Van Buren County",3,47,77,38,39
050,19,177,"Iowa","Van Buren County",3,48,69,42,27
050,19,177,"Iowa","Van Buren County",3,49,88,50,38
050,19,177,"Iowa","Van Buren County",3,50,86,45,41
050,19,177,"Iowa","Van Buren County",3,51,91,52,39
050,19,177,"Iowa","Van Buren County",3,52,79,46,33
050,19,177,"Iowa","Van Buren County",3,53,90,47,43
050,19,177,"Iowa","Van Buren County",3,54,99,49,50
050,19,177,"Iowa","Van Buren County",3,55,91,43,48
050,19,177,"Iowa","Van Buren County",3,56,101,47,54
050,19,177,"Iowa","Van Buren County",3,57,106,54,52
050,19,177,"Iowa","Van Buren County",3,58,101,49,52
050,19,177,"Iowa","Van Buren County",3,59,112,56,56
050,19,177,"Iowa","Van Buren County",3,60,117,58,59
050,19,177,"Iowa","Van Buren County",3,61,109,54,55
050,19,177,"Iowa","Van Buren County",3,62,111,59,52
050,19,177,"Iowa","Van Buren County",3,63,103,49,54
050,19,177,"Iowa","Van Buren County",3,64,104,54,50
050,19,177,"Iowa","Van Buren County",3,65,112,58,54
050,19,177,"Iowa","Van Buren County",3,66,107,55,52
050,19,177,"Iowa","Van Buren County",3,67,116,54,62
050,19,177,"Iowa","Van Buren County",3,68,117,54,63
050,19,177,"Iowa","Van Buren County",3,69,108,53,55
050,19,177,"Iowa","Van Buren County",3,70,86,47,39
050,19,177,"Iowa","Van Buren County",3,71,87,41,46
050,19,177,"Iowa","Van Buren County",3,72,91,42,49
050,19,177,"Iowa","Van Buren County",3,73,90,45,45
050,19,177,"Iowa","Van Buren County",3,74,84,40,44
050,19,177,"Iowa","Van Buren County",3,75,62,27,35
050,19,177,"Iowa","Van Buren County",3,76,57,28,29
050,19,177,"Iowa","Van Buren County",3,77,50,23,27
050,19,177,"Iowa","Van Buren County",3,78,56,24,32
050,19,177,"Iowa","Van Buren County",3,79,48,25,23
050,19,177,"Iowa","Van Buren County",3,80,40,20,20
050,19,177,"Iowa","Van Buren County",3,81,35,18,17
050,19,177,"Iowa","Van Buren County",3,82,38,18,20
050,19,177,"Iowa","Van Buren County",3,83,42,19,23
050,19,177,"Iowa","Van Buren County",3,84,41,16,25
050,19,177,"Iowa","Van Buren County",3,85,179,71,108
050,19,177,"Iowa","Van Buren County",4,0,99,50,49
050,19,177,"Iowa","Van Buren County",4,1,99,50,49
050,19,177,"Iowa","Van Buren County",4,2,94,45,49
050,19,177,"Iowa","Van Buren County",4,3,91,47,44
050,19,177,"Iowa","Van Buren County",4,4,107,52,55
050,19,177,"Iowa","Van Buren County",4,5,93,51,42
050,19,177,"Iowa","Van Buren County",4,6,88,56,32
050,19,177,"Iowa","Van Buren County",4,7,72,37,35
050,19,177,"Iowa","Van Buren County",4,8,90,49,41
050,19,177,"Iowa","Van Buren County",4,9,103,46,57
050,19,177,"Iowa","Van Buren County",4,10,101,49,52
050,19,177,"Iowa","Van Buren County",4,11,98,51,47
050,19,177,"Iowa","Van Buren County",4,12,99,50,49
050,19,177,"Iowa","Van Buren County",4,13,95,57,38
050,19,177,"Iowa","Van Buren County",4,14,101,55,46
050,19,177,"Iowa","Van Buren County",4,15,97,58,39
050,19,177,"Iowa","Van Buren County",4,16,96,51,45
050,19,177,"Iowa","Van Buren County",4,17,97,50,47
050,19,177,"Iowa","Van Buren County",4,18,80,40,40
050,19,177,"Iowa","Van Buren County",4,19,61,33,28
050,19,177,"Iowa","Van Buren County",4,20,70,42,28
050,19,177,"Iowa","Van Buren County",4,21,78,45,33
050,19,177,"Iowa","Van Buren County",4,22,78,39,39
050,19,177,"Iowa","Van Buren County",4,23,69,31,38
050,19,177,"Iowa","Van Buren County",4,24,70,36,34
050,19,177,"Iowa","Van Buren County",4,25,72,40,32
050,19,177,"Iowa","Van Buren County",4,26,67,36,31
050,19,177,"Iowa","Van Buren County",4,27,77,39,38
050,19,177,"Iowa","Van Buren County",4,28,81,38,43
050,19,177,"Iowa","Van Buren County",4,29,69,35,34
050,19,177,"Iowa","Van Buren County",4,30,61,35,26
050,19,177,"Iowa","Van Buren County",4,31,64,30,34
050,19,177,"Iowa","Van Buren County",4,32,72,32,40
050,19,177,"Iowa","Van Buren County",4,33,71,37,34
050,19,177,"Iowa","Van Buren County",4,34,66,35,31
050,19,177,"Iowa","Van Buren County",4,35,73,34,39
050,19,177,"Iowa","Van Buren County",4,36,74,36,38
050,19,177,"Iowa","Van Buren County",4,37,81,41,40
050,19,177,"Iowa","Van Buren County",4,38,79,37,42
050,19,177,"Iowa","Van Buren County",4,39,86,42,44
050,19,177,"Iowa","Van Buren County",4,40,89,44,45
050,19,177,"Iowa","Van Buren County",4,41,91,51,40
050,19,177,"Iowa","Van Buren County",4,42,90,57,33
050,19,177,"Iowa","Van Buren County",4,43,81,48,33
050,19,177,"Iowa","Van Buren County",4,44,75,38,37
050,19,177,"Iowa","Van Buren County",4,45,79,42,37
050,19,177,"Iowa","Van Buren County",4,46,71,39,32
050,19,177,"Iowa","Van Buren County",4,47,77,39,38
050,19,177,"Iowa","Van Buren County",4,48,78,38,40
050,19,177,"Iowa","Van Buren County",4,49,71,42,29
050,19,177,"Iowa","Van Buren County",4,50,88,50,38
050,19,177,"Iowa","Van Buren County",4,51,87,46,41
050,19,177,"Iowa","Van Buren County",4,52,90,54,36
050,19,177,"Iowa","Van Buren County",4,53,78,42,36
050,19,177,"Iowa","Van Buren County",4,54,86,45,41
050,19,177,"Iowa","Van Buren County",4,55,100,50,50
050,19,177,"Iowa","Van Buren County",4,56,88,41,47
050,19,177,"Iowa","Van Buren County",4,57,101,48,53
050,19,177,"Iowa","Van Buren County",4,58,108,55,53
050,19,177,"Iowa","Van Buren County",4,59,99,48,51
050,19,177,"Iowa","Van Buren County",4,60,113,56,57
050,19,177,"Iowa","Van Buren County",4,61,111,55,56
050,19,177,"Iowa","Van Buren County",4,62,112,55,57
050,19,177,"Iowa","Van Buren County",4,63,103,56,47
050,19,177,"Iowa","Van Buren County",4,64,105,53,52
050,19,177,"Iowa","Van Buren County",4,65,101,54,47
050,19,177,"Iowa","Van Buren County",4,66,110,53,57
050,19,177,"Iowa","Van Buren County",4,67,107,55,52
050,19,177,"Iowa","Van Buren County",4,68,111,52,59
050,19,177,"Iowa","Van Buren County",4,69,117,54,63
050,19,177,"Iowa","Van Buren County",4,70,104,49,55
050,19,177,"Iowa","Van Buren County",4,71,88,47,41
050,19,177,"Iowa","Van Buren County",4,72,81,36,45
050,19,177,"Iowa","Van Buren County",4,73,88,42,46
050,19,177,"Iowa","Van Buren County",4,74,86,42,44
050,19,177,"Iowa","Van Buren County",4,75,86,41,45
050,19,177,"Iowa","Van Buren County",4,76,58,26,32
050,19,177,"Iowa","Van Buren County",4,77,58,29,29
050,19,177,"Iowa","Van Buren County",4,78,44,19,25
050,19,177,"Iowa","Van Buren County",4,79,47,21,26
050,19,177,"Iowa","Van Buren County",4,80,45,22,23
050,19,177,"Iowa","Van Buren County",4,81,40,19,21
050,19,177,"Iowa","Van Buren County",4,82,34,17,17
050,19,177,"Iowa","Van Buren County",4,83,35,15,20
050,19,177,"Iowa","Van Buren County",4,84,36,15,21
050,19,177,"Iowa","Van Buren County",4,85,186,68,118
050,19,177,"Iowa","Van Buren County",5,0,100,51,49
050,19,177,"Iowa","Van Buren County",5,1,95,50,45
050,19,177,"Iowa","Van Buren County",5,2,101,53,48
050,19,177,"Iowa","Van Buren County",5,3,95,47,48
050,19,177,"Iowa","Van Buren County",5,4,96,51,45
050,19,177,"Iowa","Van Buren County",5,5,104,47,57
050,19,177,"Iowa","Van Buren County",5,6,87,50,37
050,19,177,"Iowa","Van Buren County",5,7,88,56,32
050,19,177,"Iowa","Van Buren County",5,8,72,38,34
050,19,177,"Iowa","Van Buren County",5,9,93,50,43
050,19,177,"Iowa","Van Buren County",5,10,105,47,58
050,19,177,"Iowa","Van Buren County",5,11,107,48,59
050,19,177,"Iowa","Van Buren County",5,12,96,49,47
050,19,177,"Iowa","Van Buren County",5,13,102,54,48
050,19,177,"Iowa","Van Buren County",5,14,103,61,42
050,19,177,"Iowa","Van Buren County",5,15,103,59,44
050,19,177,"Iowa","Van Buren County",5,16,97,57,40
050,19,177,"Iowa","Van Buren County",5,17,94,50,44
050,19,177,"Iowa","Van Buren County",5,18,82,45,37
050,19,177,"Iowa","Van Buren County",5,19,62,33,29
050,19,177,"Iowa","Van Buren County",5,20,59,33,26
050,19,177,"Iowa","Van Buren County",5,21,81,50,31
050,19,177,"Iowa","Van Buren County",5,22,80,45,35
050,19,177,"Iowa","Van Buren County",5,23,75,40,35
050,19,177,"Iowa","Van Buren County",5,24,63,28,35
050,19,177,"Iowa","Van Buren County",5,25,66,31,35
050,19,177,"Iowa","Van Buren County",5,26,77,43,34
050,19,177,"Iowa","Van Buren County",5,27,73,37,36
050,19,177,"Iowa","Van Buren County",5,28,82,45,37
050,19,177,"Iowa","Van Buren County",5,29,88,41,47
050,19,177,"Iowa","Van Buren County",5,30,75,41,34
050,19,177,"Iowa","Van Buren County",5,31,59,33,26
050,19,177,"Iowa","Van Buren County",5,32,68,34,34
050,19,177,"Iowa","Van Buren County",5,33,67,29,38
050,19,177,"Iowa","Van Buren County",5,34,68,36,32
050,19,177,"Iowa","Van Buren County",5,35,66,34,32
050,19,177,"Iowa","Van Buren County",5,36,72,33,39
050,19,177,"Iowa","Van Buren County",5,37,82,40,42
050,19,177,"Iowa","Van Buren County",5,38,81,39,42
050,19,177,"Iowa","Van Buren County",5,39,79,37,42
050,19,177,"Iowa","Van Buren County",5,40,83,40,43
050,19,177,"Iowa","Van Buren County",5,41,92,48,44
050,19,177,"Iowa","Van Buren County",5,42,85,49,36
050,19,177,"Iowa","Van Buren County",5,43,89,56,33
050,19,177,"Iowa","Van Buren County",5,44,83,49,34
050,19,177,"Iowa","Van Buren County",5,45,81,40,41
050,19,177,"Iowa","Van Buren County",5,46,82,44,38
050,19,177,"Iowa","Van Buren County",5,47,71,39,32
050,19,177,"Iowa","Van Buren County",5,48,78,39,39
050,19,177,"Iowa","Van Buren County",5,49,76,38,38
050,19,177,"Iowa","Van Buren County",5,50,76,43,33
050,19,177,"Iowa","Van Buren County",5,51,85,49,36
050,19,177,"Iowa","Van Buren County",5,52,88,46,42
050,19,177,"Iowa","Van Buren County",5,53,90,54,36
050,19,177,"Iowa","Van Buren County",5,54,77,41,36
050,19,177,"Iowa","Van Buren County",5,55,88,47,41
050,19,177,"Iowa","Van Buren County",5,56,96,48,48
050,19,177,"Iowa","Van Buren County",5,57,88,43,45
050,19,177,"Iowa","Van Buren County",5,58,100,46,54
050,19,177,"Iowa","Van Buren County",5,59,102,51,51
050,19,177,"Iowa","Van Buren County",5,60,98,45,53
050,19,177,"Iowa","Van Buren County",5,61,114,54,60
050,19,177,"Iowa","Van Buren County",5,62,111,56,55
050,19,177,"Iowa","Van Buren County",5,63,114,56,58
050,19,177,"Iowa","Van Buren County",5,64,98,55,43
050,19,177,"Iowa","Van Buren County",5,65,108,52,56
050,19,177,"Iowa","Van Buren County",5,66,100,54,46
050,19,177,"Iowa","Van Buren County",5,67,111,54,57
050,19,177,"Iowa","Van Buren County",5,68,99,51,48
050,19,177,"Iowa","Van Buren County",5,69,112,53,59
050,19,177,"Iowa","Van Buren County",5,70,117,52,65
050,19,177,"Iowa","Van Buren County",5,71,100,47,53
050,19,177,"Iowa","Van Buren County",5,72,80,41,39
050,19,177,"Iowa","Van Buren County",5,73,78,36,42
050,19,177,"Iowa","Van Buren County",5,74,84,39,45
050,19,177,"Iowa","Van Buren County",5,75,84,40,44
050,19,177,"Iowa","Van Buren County",5,76,83,39,44
050,19,177,"Iowa","Van Buren County",5,77,58,26,32
050,19,177,"Iowa","Van Buren County",5,78,51,24,27
050,19,177,"Iowa","Van Buren County",5,79,40,17,23
050,19,177,"Iowa","Van Buren County",5,80,45,19,26
050,19,177,"Iowa","Van Buren County",5,81,44,21,23
050,19,177,"Iowa","Van Buren County",5,82,37,18,19
050,19,177,"Iowa","Van Buren County",5,83,33,15,18
050,19,177,"Iowa","Van Buren County",5,84,32,12,20
050,19,177,"Iowa","Van Buren County",5,85,182,60,122
050,19,179,"Iowa","Wapello County",1,0,439,225,214
050,19,179,"Iowa","Wapello County",1,1,439,226,213
050,19,179,"Iowa","Wapello County",1,2,462,249,213
050,19,179,"Iowa","Wapello County",1,3,486,265,221
050,19,179,"Iowa","Wapello County",1,4,472,244,228
050,19,179,"Iowa","Wapello County",1,5,429,212,217
050,19,179,"Iowa","Wapello County",1,6,454,230,224
050,19,179,"Iowa","Wapello County",1,7,411,210,201
050,19,179,"Iowa","Wapello County",1,8,419,212,207
050,19,179,"Iowa","Wapello County",1,9,463,259,204
050,19,179,"Iowa","Wapello County",1,10,456,245,211
050,19,179,"Iowa","Wapello County",1,11,486,261,225
050,19,179,"Iowa","Wapello County",1,12,491,252,239
050,19,179,"Iowa","Wapello County",1,13,493,254,239
050,19,179,"Iowa","Wapello County",1,14,487,232,255
050,19,179,"Iowa","Wapello County",1,15,490,248,242
050,19,179,"Iowa","Wapello County",1,16,489,263,226
050,19,179,"Iowa","Wapello County",1,17,488,263,225
050,19,179,"Iowa","Wapello County",1,18,420,214,206
050,19,179,"Iowa","Wapello County",1,19,472,241,231
050,19,179,"Iowa","Wapello County",1,20,414,219,195
050,19,179,"Iowa","Wapello County",1,21,383,188,195
050,19,179,"Iowa","Wapello County",1,22,370,186,184
050,19,179,"Iowa","Wapello County",1,23,434,237,197
050,19,179,"Iowa","Wapello County",1,24,435,229,206
050,19,179,"Iowa","Wapello County",1,25,435,218,217
050,19,179,"Iowa","Wapello County",1,26,474,251,223
050,19,179,"Iowa","Wapello County",1,27,492,248,244
050,19,179,"Iowa","Wapello County",1,28,473,238,235
050,19,179,"Iowa","Wapello County",1,29,473,249,224
050,19,179,"Iowa","Wapello County",1,30,458,241,217
050,19,179,"Iowa","Wapello County",1,31,464,246,218
050,19,179,"Iowa","Wapello County",1,32,414,199,215
050,19,179,"Iowa","Wapello County",1,33,411,211,200
050,19,179,"Iowa","Wapello County",1,34,431,237,194
050,19,179,"Iowa","Wapello County",1,35,426,219,207
050,19,179,"Iowa","Wapello County",1,36,433,235,198
050,19,179,"Iowa","Wapello County",1,37,451,235,216
050,19,179,"Iowa","Wapello County",1,38,453,238,215
050,19,179,"Iowa","Wapello County",1,39,442,239,203
050,19,179,"Iowa","Wapello County",1,40,474,248,226
050,19,179,"Iowa","Wapello County",1,41,411,213,198
050,19,179,"Iowa","Wapello County",1,42,434,223,211
050,19,179,"Iowa","Wapello County",1,43,412,220,192
050,19,179,"Iowa","Wapello County",1,44,413,232,181
050,19,179,"Iowa","Wapello County",1,45,385,206,179
050,19,179,"Iowa","Wapello County",1,46,399,205,194
050,19,179,"Iowa","Wapello County",1,47,394,206,188
050,19,179,"Iowa","Wapello County",1,48,406,210,196
050,19,179,"Iowa","Wapello County",1,49,420,222,198
050,19,179,"Iowa","Wapello County",1,50,419,229,190
050,19,179,"Iowa","Wapello County",1,51,411,203,208
050,19,179,"Iowa","Wapello County",1,52,402,202,200
050,19,179,"Iowa","Wapello County",1,53,417,226,191
050,19,179,"Iowa","Wapello County",1,54,410,202,208
050,19,179,"Iowa","Wapello County",1,55,432,206,226
050,19,179,"Iowa","Wapello County",1,56,458,219,239
050,19,179,"Iowa","Wapello County",1,57,497,237,260
050,19,179,"Iowa","Wapello County",1,58,512,251,261
050,19,179,"Iowa","Wapello County",1,59,491,240,251
050,19,179,"Iowa","Wapello County",1,60,482,230,252
050,19,179,"Iowa","Wapello County",1,61,484,236,248
050,19,179,"Iowa","Wapello County",1,62,507,245,262
050,19,179,"Iowa","Wapello County",1,63,491,243,248
050,19,179,"Iowa","Wapello County",1,64,485,238,247
050,19,179,"Iowa","Wapello County",1,65,473,226,247
050,19,179,"Iowa","Wapello County",1,66,460,227,233
050,19,179,"Iowa","Wapello County",1,67,444,222,222
050,19,179,"Iowa","Wapello County",1,68,413,212,201
050,19,179,"Iowa","Wapello County",1,69,386,189,197
050,19,179,"Iowa","Wapello County",1,70,340,168,172
050,19,179,"Iowa","Wapello County",1,71,332,160,172
050,19,179,"Iowa","Wapello County",1,72,349,159,190
050,19,179,"Iowa","Wapello County",1,73,336,150,186
050,19,179,"Iowa","Wapello County",1,74,236,105,131
050,19,179,"Iowa","Wapello County",1,75,226,111,115
050,19,179,"Iowa","Wapello County",1,76,232,96,136
050,19,179,"Iowa","Wapello County",1,77,231,107,124
050,19,179,"Iowa","Wapello County",1,78,191,91,100
050,19,179,"Iowa","Wapello County",1,79,202,89,113
050,19,179,"Iowa","Wapello County",1,80,179,80,99
050,19,179,"Iowa","Wapello County",1,81,164,73,91
050,19,179,"Iowa","Wapello County",1,82,158,68,90
050,19,179,"Iowa","Wapello County",1,83,128,53,75
050,19,179,"Iowa","Wapello County",1,84,123,47,76
050,19,179,"Iowa","Wapello County",1,85,775,259,516
050,19,179,"Iowa","Wapello County",2,0,445,228,217
050,19,179,"Iowa","Wapello County",2,1,437,226,211
050,19,179,"Iowa","Wapello County",2,2,454,244,210
050,19,179,"Iowa","Wapello County",2,3,484,263,221
050,19,179,"Iowa","Wapello County",2,4,474,249,225
050,19,179,"Iowa","Wapello County",2,5,443,222,221
050,19,179,"Iowa","Wapello County",2,6,449,229,220
050,19,179,"Iowa","Wapello County",2,7,420,216,204
050,19,179,"Iowa","Wapello County",2,8,418,213,205
050,19,179,"Iowa","Wapello County",2,9,450,245,205
050,19,179,"Iowa","Wapello County",2,10,455,247,208
050,19,179,"Iowa","Wapello County",2,11,477,256,221
050,19,179,"Iowa","Wapello County",2,12,490,255,235
050,19,179,"Iowa","Wapello County",2,13,491,252,239
050,19,179,"Iowa","Wapello County",2,14,488,238,250
050,19,179,"Iowa","Wapello County",2,15,489,246,243
050,19,179,"Iowa","Wapello County",2,16,488,260,228
050,19,179,"Iowa","Wapello County",2,17,485,263,222
050,19,179,"Iowa","Wapello County",2,18,418,216,202
050,19,179,"Iowa","Wapello County",2,19,465,239,226
050,19,179,"Iowa","Wapello County",2,20,421,218,203
050,19,179,"Iowa","Wapello County",2,21,381,190,191
050,19,179,"Iowa","Wapello County",2,22,372,184,188
050,19,179,"Iowa","Wapello County",2,23,418,225,193
050,19,179,"Iowa","Wapello County",2,24,431,230,201
050,19,179,"Iowa","Wapello County",2,25,436,224,212
050,19,179,"Iowa","Wapello County",2,26,462,240,222
050,19,179,"Iowa","Wapello County",2,27,484,247,237
050,19,179,"Iowa","Wapello County",2,28,476,240,236
050,19,179,"Iowa","Wapello County",2,29,470,246,224
050,19,179,"Iowa","Wapello County",2,30,464,244,220
050,19,179,"Iowa","Wapello County",2,31,463,243,220
050,19,179,"Iowa","Wapello County",2,32,426,210,216
050,19,179,"Iowa","Wapello County",2,33,409,207,202
050,19,179,"Iowa","Wapello County",2,34,423,231,192
050,19,179,"Iowa","Wapello County",2,35,431,224,207
050,19,179,"Iowa","Wapello County",2,36,427,228,199
050,19,179,"Iowa","Wapello County",2,37,446,235,211
050,19,179,"Iowa","Wapello County",2,38,456,239,217
050,19,179,"Iowa","Wapello County",2,39,444,240,204
050,19,179,"Iowa","Wapello County",2,40,471,249,222
050,19,179,"Iowa","Wapello County",2,41,424,220,204
050,19,179,"Iowa","Wapello County",2,42,430,221,209
050,19,179,"Iowa","Wapello County",2,43,420,221,199
050,19,179,"Iowa","Wapello County",2,44,407,227,180
050,19,179,"Iowa","Wapello County",2,45,395,213,182
050,19,179,"Iowa","Wapello County",2,46,393,203,190
050,19,179,"Iowa","Wapello County",2,47,394,206,188
050,19,179,"Iowa","Wapello County",2,48,404,210,194
050,19,179,"Iowa","Wapello County",2,49,412,215,197
050,19,179,"Iowa","Wapello County",2,50,419,228,191
050,19,179,"Iowa","Wapello County",2,51,406,205,201
050,19,179,"Iowa","Wapello County",2,52,405,203,202
050,19,179,"Iowa","Wapello County",2,53,409,218,191
050,19,179,"Iowa","Wapello County",2,54,413,209,204
050,19,179,"Iowa","Wapello County",2,55,424,203,221
050,19,179,"Iowa","Wapello County",2,56,451,215,236
050,19,179,"Iowa","Wapello County",2,57,483,231,252
050,19,179,"Iowa","Wapello County",2,58,505,245,260
050,19,179,"Iowa","Wapello County",2,59,497,245,252
050,19,179,"Iowa","Wapello County",2,60,482,230,252
050,19,179,"Iowa","Wapello County",2,61,476,231,245
050,19,179,"Iowa","Wapello County",2,62,500,242,258
050,19,179,"Iowa","Wapello County",2,63,497,244,253
050,19,179,"Iowa","Wapello County",2,64,481,236,245
050,19,179,"Iowa","Wapello County",2,65,472,230,242
050,19,179,"Iowa","Wapello County",2,66,461,226,235
050,19,179,"Iowa","Wapello County",2,67,442,221,221
050,19,179,"Iowa","Wapello County",2,68,417,212,205
050,19,179,"Iowa","Wapello County",2,69,392,193,199
050,19,179,"Iowa","Wapello County",2,70,348,171,177
050,19,179,"Iowa","Wapello County",2,71,333,162,171
050,19,179,"Iowa","Wapello County",2,72,334,155,179
050,19,179,"Iowa","Wapello County",2,73,353,159,194
050,19,179,"Iowa","Wapello County",2,74,242,108,134
050,19,179,"Iowa","Wapello County",2,75,222,104,118
050,19,179,"Iowa","Wapello County",2,76,225,96,129
050,19,179,"Iowa","Wapello County",2,77,235,106,129
050,19,179,"Iowa","Wapello County",2,78,194,92,102
050,19,179,"Iowa","Wapello County",2,79,198,88,110
050,19,179,"Iowa","Wapello County",2,80,181,82,99
050,19,179,"Iowa","Wapello County",2,81,164,72,92
050,19,179,"Iowa","Wapello County",2,82,158,67,91
050,19,179,"Iowa","Wapello County",2,83,125,53,72
050,19,179,"Iowa","Wapello County",2,84,119,46,73
050,19,179,"Iowa","Wapello County",2,85,753,249,504
050,19,179,"Iowa","Wapello County",3,0,445,222,223
050,19,179,"Iowa","Wapello County",3,1,456,239,217
050,19,179,"Iowa","Wapello County",3,2,439,213,226
050,19,179,"Iowa","Wapello County",3,3,462,243,219
050,19,179,"Iowa","Wapello County",3,4,470,251,219
050,19,179,"Iowa","Wapello County",3,5,467,238,229
050,19,179,"Iowa","Wapello County",3,6,437,204,233
050,19,179,"Iowa","Wapello County",3,7,451,230,221
050,19,179,"Iowa","Wapello County",3,8,436,222,214
050,19,179,"Iowa","Wapello County",3,9,433,218,215
050,19,179,"Iowa","Wapello County",3,10,457,252,205
050,19,179,"Iowa","Wapello County",3,11,455,242,213
050,19,179,"Iowa","Wapello County",3,12,494,258,236
050,19,179,"Iowa","Wapello County",3,13,515,265,250
050,19,179,"Iowa","Wapello County",3,14,486,252,234
050,19,179,"Iowa","Wapello County",3,15,499,249,250
050,19,179,"Iowa","Wapello County",3,16,505,265,240
050,19,179,"Iowa","Wapello County",3,17,497,264,233
050,19,179,"Iowa","Wapello County",3,18,423,223,200
050,19,179,"Iowa","Wapello County",3,19,466,253,213
050,19,179,"Iowa","Wapello County",3,20,440,222,218
050,19,179,"Iowa","Wapello County",3,21,405,207,198
050,19,179,"Iowa","Wapello County",3,22,372,184,188
050,19,179,"Iowa","Wapello County",3,23,370,182,188
050,19,179,"Iowa","Wapello County",3,24,406,216,190
050,19,179,"Iowa","Wapello County",3,25,432,227,205
050,19,179,"Iowa","Wapello County",3,26,427,215,212
050,19,179,"Iowa","Wapello County",3,27,443,231,212
050,19,179,"Iowa","Wapello County",3,28,476,246,230
050,19,179,"Iowa","Wapello County",3,29,496,258,238
050,19,179,"Iowa","Wapello County",3,30,475,254,221
050,19,179,"Iowa","Wapello County",3,31,468,253,215
050,19,179,"Iowa","Wapello County",3,32,462,243,219
050,19,179,"Iowa","Wapello County",3,33,433,219,214
050,19,179,"Iowa","Wapello County",3,34,406,208,198
050,19,179,"Iowa","Wapello County",3,35,415,213,202
050,19,179,"Iowa","Wapello County",3,36,428,223,205
050,19,179,"Iowa","Wapello County",3,37,430,227,203
050,19,179,"Iowa","Wapello County",3,38,462,240,222
050,19,179,"Iowa","Wapello County",3,39,459,249,210
050,19,179,"Iowa","Wapello County",3,40,459,241,218
050,19,179,"Iowa","Wapello County",3,41,450,238,212
050,19,179,"Iowa","Wapello County",3,42,425,226,199
050,19,179,"Iowa","Wapello County",3,43,415,212,203
050,19,179,"Iowa","Wapello County",3,44,429,226,203
050,19,179,"Iowa","Wapello County",3,45,410,229,181
050,19,179,"Iowa","Wapello County",3,46,395,213,182
050,19,179,"Iowa","Wapello County",3,47,406,207,199
050,19,179,"Iowa","Wapello County",3,48,399,207,192
050,19,179,"Iowa","Wapello County",3,49,393,202,191
050,19,179,"Iowa","Wapello County",3,50,419,216,203
050,19,179,"Iowa","Wapello County",3,51,411,227,184
050,19,179,"Iowa","Wapello County",3,52,405,202,203
050,19,179,"Iowa","Wapello County",3,53,401,204,197
050,19,179,"Iowa","Wapello County",3,54,411,216,195
050,19,179,"Iowa","Wapello County",3,55,406,209,197
050,19,179,"Iowa","Wapello County",3,56,424,202,222
050,19,179,"Iowa","Wapello County",3,57,437,218,219
050,19,179,"Iowa","Wapello County",3,58,465,222,243
050,19,179,"Iowa","Wapello County",3,59,499,240,259
050,19,179,"Iowa","Wapello County",3,60,493,249,244
050,19,179,"Iowa","Wapello County",3,61,472,227,245
050,19,179,"Iowa","Wapello County",3,62,461,225,236
050,19,179,"Iowa","Wapello County",3,63,490,239,251
050,19,179,"Iowa","Wapello County",3,64,487,239,248
050,19,179,"Iowa","Wapello County",3,65,465,232,233
050,19,179,"Iowa","Wapello County",3,66,467,226,241
050,19,179,"Iowa","Wapello County",3,67,440,217,223
050,19,179,"Iowa","Wapello County",3,68,429,211,218
050,19,179,"Iowa","Wapello County",3,69,402,206,196
050,19,179,"Iowa","Wapello County",3,70,374,181,193
050,19,179,"Iowa","Wapello County",3,71,339,167,172
050,19,179,"Iowa","Wapello County",3,72,329,159,170
050,19,179,"Iowa","Wapello County",3,73,319,149,170
050,19,179,"Iowa","Wapello County",3,74,335,152,183
050,19,179,"Iowa","Wapello County",3,75,227,100,127
050,19,179,"Iowa","Wapello County",3,76,208,98,110
050,19,179,"Iowa","Wapello County",3,77,222,101,121
050,19,179,"Iowa","Wapello County",3,78,212,93,119
050,19,179,"Iowa","Wapello County",3,79,181,80,101
050,19,179,"Iowa","Wapello County",3,80,189,87,102
050,19,179,"Iowa","Wapello County",3,81,169,76,93
050,19,179,"Iowa","Wapello County",3,82,160,70,90
050,19,179,"Iowa","Wapello County",3,83,130,59,71
050,19,179,"Iowa","Wapello County",3,84,114,43,71
050,19,179,"Iowa","Wapello County",3,85,724,247,477
050,19,179,"Iowa","Wapello County",4,0,443,220,223
050,19,179,"Iowa","Wapello County",4,1,453,231,222
050,19,179,"Iowa","Wapello County",4,2,449,232,217
050,19,179,"Iowa","Wapello County",4,3,426,211,215
050,19,179,"Iowa","Wapello County",4,4,438,228,210
050,19,179,"Iowa","Wapello County",4,5,469,249,220
050,19,179,"Iowa","Wapello County",4,6,451,225,226
050,19,179,"Iowa","Wapello County",4,7,446,219,227
050,19,179,"Iowa","Wapello County",4,8,435,216,219
050,19,179,"Iowa","Wapello County",4,9,420,214,206
050,19,179,"Iowa","Wapello County",4,10,422,214,208
050,19,179,"Iowa","Wapello County",4,11,448,248,200
050,19,179,"Iowa","Wapello County",4,12,464,250,214
050,19,179,"Iowa","Wapello County",4,13,502,265,237
050,19,179,"Iowa","Wapello County",4,14,509,269,240
050,19,179,"Iowa","Wapello County",4,15,516,270,246
050,19,179,"Iowa","Wapello County",4,16,520,257,263
050,19,179,"Iowa","Wapello County",4,17,517,282,235
050,19,179,"Iowa","Wapello County",4,18,434,225,209
050,19,179,"Iowa","Wapello County",4,19,443,244,199
050,19,179,"Iowa","Wapello County",4,20,432,236,196
050,19,179,"Iowa","Wapello County",4,21,407,222,185
050,19,179,"Iowa","Wapello County",4,22,375,197,178
050,19,179,"Iowa","Wapello County",4,23,360,189,171
050,19,179,"Iowa","Wapello County",4,24,370,180,190
050,19,179,"Iowa","Wapello County",4,25,390,215,175
050,19,179,"Iowa","Wapello County",4,26,425,232,193
050,19,179,"Iowa","Wapello County",4,27,433,215,218
050,19,179,"Iowa","Wapello County",4,28,461,243,218
050,19,179,"Iowa","Wapello County",4,29,485,255,230
050,19,179,"Iowa","Wapello County",4,30,494,262,232
050,19,179,"Iowa","Wapello County",4,31,462,249,213
050,19,179,"Iowa","Wapello County",4,32,437,221,216
050,19,179,"Iowa","Wapello County",4,33,471,237,234
050,19,179,"Iowa","Wapello County",4,34,421,215,206
050,19,179,"Iowa","Wapello County",4,35,395,193,202
050,19,179,"Iowa","Wapello County",4,36,403,209,194
050,19,179,"Iowa","Wapello County",4,37,430,226,204
050,19,179,"Iowa","Wapello County",4,38,455,236,219
050,19,179,"Iowa","Wapello County",4,39,461,238,223
050,19,179,"Iowa","Wapello County",4,40,471,253,218
050,19,179,"Iowa","Wapello County",4,41,452,244,208
050,19,179,"Iowa","Wapello County",4,42,457,249,208
050,19,179,"Iowa","Wapello County",4,43,422,216,206
050,19,179,"Iowa","Wapello County",4,44,408,213,195
050,19,179,"Iowa","Wapello County",4,45,419,219,200
050,19,179,"Iowa","Wapello County",4,46,411,231,180
050,19,179,"Iowa","Wapello County",4,47,393,214,179
050,19,179,"Iowa","Wapello County",4,48,414,210,204
050,19,179,"Iowa","Wapello County",4,49,401,208,193
050,19,179,"Iowa","Wapello County",4,50,401,208,193
050,19,179,"Iowa","Wapello County",4,51,409,209,200
050,19,179,"Iowa","Wapello County",4,52,408,222,186
050,19,179,"Iowa","Wapello County",4,53,401,205,196
050,19,179,"Iowa","Wapello County",4,54,408,214,194
050,19,179,"Iowa","Wapello County",4,55,400,208,192
050,19,179,"Iowa","Wapello County",4,56,412,212,200
050,19,179,"Iowa","Wapello County",4,57,421,200,221
050,19,179,"Iowa","Wapello County",4,58,435,217,218
050,19,179,"Iowa","Wapello County",4,59,466,218,248
050,19,179,"Iowa","Wapello County",4,60,496,236,260
050,19,179,"Iowa","Wapello County",4,61,478,238,240
050,19,179,"Iowa","Wapello County",4,62,480,231,249
050,19,179,"Iowa","Wapello County",4,63,445,219,226
050,19,179,"Iowa","Wapello County",4,64,487,240,247
050,19,179,"Iowa","Wapello County",4,65,471,233,238
050,19,179,"Iowa","Wapello County",4,66,443,220,223
050,19,179,"Iowa","Wapello County",4,67,459,222,237
050,19,179,"Iowa","Wapello County",4,68,421,208,213
050,19,179,"Iowa","Wapello County",4,69,409,203,206
050,19,179,"Iowa","Wapello County",4,70,385,189,196
050,19,179,"Iowa","Wapello County",4,71,366,173,193
050,19,179,"Iowa","Wapello County",4,72,325,163,162
050,19,179,"Iowa","Wapello County",4,73,314,150,164
050,19,179,"Iowa","Wapello County",4,74,306,147,159
050,19,179,"Iowa","Wapello County",4,75,318,141,177
050,19,179,"Iowa","Wapello County",4,76,217,95,122
050,19,179,"Iowa","Wapello County",4,77,200,96,104
050,19,179,"Iowa","Wapello County",4,78,206,87,119
050,19,179,"Iowa","Wapello County",4,79,200,85,115
050,19,179,"Iowa","Wapello County",4,80,176,73,103
050,19,179,"Iowa","Wapello County",4,81,178,82,96
050,19,179,"Iowa","Wapello County",4,82,157,71,86
050,19,179,"Iowa","Wapello County",4,83,140,65,75
050,19,179,"Iowa","Wapello County",4,84,113,43,70
050,19,179,"Iowa","Wapello County",4,85,710,237,473
050,19,179,"Iowa","Wapello County",5,0,453,224,229
050,19,179,"Iowa","Wapello County",5,1,465,231,234
050,19,179,"Iowa","Wapello County",5,2,441,222,219
050,19,179,"Iowa","Wapello County",5,3,450,239,211
050,19,179,"Iowa","Wapello County",5,4,442,227,215
050,19,179,"Iowa","Wapello County",5,5,453,233,220
050,19,179,"Iowa","Wapello County",5,6,467,254,213
050,19,179,"Iowa","Wapello County",5,7,455,226,229
050,19,179,"Iowa","Wapello County",5,8,460,226,234
050,19,179,"Iowa","Wapello County",5,9,430,216,214
050,19,179,"Iowa","Wapello County",5,10,439,224,215
050,19,179,"Iowa","Wapello County",5,11,432,217,215
050,19,179,"Iowa","Wapello County",5,12,460,255,205
050,19,179,"Iowa","Wapello County",5,13,458,240,218
050,19,179,"Iowa","Wapello County",5,14,492,263,229
050,19,179,"Iowa","Wapello County",5,15,521,273,248
050,19,179,"Iowa","Wapello County",5,16,542,285,257
050,19,179,"Iowa","Wapello County",5,17,535,275,260
050,19,179,"Iowa","Wapello County",5,18,457,241,216
050,19,179,"Iowa","Wapello County",5,19,464,248,216
050,19,179,"Iowa","Wapello County",5,20,438,242,196
050,19,179,"Iowa","Wapello County",5,21,420,237,183
050,19,179,"Iowa","Wapello County",5,22,396,213,183
050,19,179,"Iowa","Wapello County",5,23,392,204,188
050,19,179,"Iowa","Wapello County",5,24,385,188,197
050,19,179,"Iowa","Wapello County",5,25,367,181,186
050,19,179,"Iowa","Wapello County",5,26,390,219,171
050,19,179,"Iowa","Wapello County",5,27,410,214,196
050,19,179,"Iowa","Wapello County",5,28,433,227,206
050,19,179,"Iowa","Wapello County",5,29,469,239,230
050,19,179,"Iowa","Wapello County",5,30,482,261,221
050,19,179,"Iowa","Wapello County",5,31,487,265,222
050,19,179,"Iowa","Wapello County",5,32,459,238,221
050,19,179,"Iowa","Wapello County",5,33,439,220,219
050,19,179,"Iowa","Wapello County",5,34,481,249,232
050,19,179,"Iowa","Wapello County",5,35,436,225,211
050,19,179,"Iowa","Wapello County",5,36,392,198,194
050,19,179,"Iowa","Wapello County",5,37,408,210,198
050,19,179,"Iowa","Wapello County",5,38,441,232,209
050,19,179,"Iowa","Wapello County",5,39,443,230,213
050,19,179,"Iowa","Wapello County",5,40,467,234,233
050,19,179,"Iowa","Wapello County",5,41,455,239,216
050,19,179,"Iowa","Wapello County",5,42,453,252,201
050,19,179,"Iowa","Wapello County",5,43,447,242,205
050,19,179,"Iowa","Wapello County",5,44,413,217,196
050,19,179,"Iowa","Wapello County",5,45,410,215,195
050,19,179,"Iowa","Wapello County",5,46,424,218,206
050,19,179,"Iowa","Wapello County",5,47,411,234,177
050,19,179,"Iowa","Wapello County",5,48,391,210,181
050,19,179,"Iowa","Wapello County",5,49,415,207,208
050,19,179,"Iowa","Wapello County",5,50,404,209,195
050,19,179,"Iowa","Wapello County",5,51,401,209,192
050,19,179,"Iowa","Wapello County",5,52,407,218,189
050,19,179,"Iowa","Wapello County",5,53,403,219,184
050,19,179,"Iowa","Wapello County",5,54,409,209,200
050,19,179,"Iowa","Wapello County",5,55,401,210,191
050,19,179,"Iowa","Wapello County",5,56,399,210,189
050,19,179,"Iowa","Wapello County",5,57,412,208,204
050,19,179,"Iowa","Wapello County",5,58,411,191,220
050,19,179,"Iowa","Wapello County",5,59,428,215,213
050,19,179,"Iowa","Wapello County",5,60,456,212,244
050,19,179,"Iowa","Wapello County",5,61,477,227,250
050,19,179,"Iowa","Wapello County",5,62,472,236,236
050,19,179,"Iowa","Wapello County",5,63,468,223,245
050,19,179,"Iowa","Wapello County",5,64,446,219,227
050,19,179,"Iowa","Wapello County",5,65,476,245,231
050,19,179,"Iowa","Wapello County",5,66,454,230,224
050,19,179,"Iowa","Wapello County",5,67,428,210,218
050,19,179,"Iowa","Wapello County",5,68,447,218,229
050,19,179,"Iowa","Wapello County",5,69,411,202,209
050,19,179,"Iowa","Wapello County",5,70,396,190,206
050,19,179,"Iowa","Wapello County",5,71,374,185,189
050,19,179,"Iowa","Wapello County",5,72,356,168,188
050,19,179,"Iowa","Wapello County",5,73,308,153,155
050,19,179,"Iowa","Wapello County",5,74,304,148,156
050,19,179,"Iowa","Wapello County",5,75,286,138,148
050,19,179,"Iowa","Wapello County",5,76,307,134,173
050,19,179,"Iowa","Wapello County",5,77,209,96,113
050,19,179,"Iowa","Wapello County",5,78,188,84,104
050,19,179,"Iowa","Wapello County",5,79,193,78,115
050,19,179,"Iowa","Wapello County",5,80,186,76,110
050,19,179,"Iowa","Wapello County",5,81,163,67,96
050,19,179,"Iowa","Wapello County",5,82,162,72,90
050,19,179,"Iowa","Wapello County",5,83,133,64,69
050,19,179,"Iowa","Wapello County",5,84,124,53,71
050,19,179,"Iowa","Wapello County",5,85,697,233,464
050,19,181,"Iowa","Warren County",1,0,568,290,278
050,19,181,"Iowa","Warren County",1,1,588,315,273
050,19,181,"Iowa","Warren County",1,2,645,331,314
050,19,181,"Iowa","Warren County",1,3,669,345,324
050,19,181,"Iowa","Warren County",1,4,701,353,348
050,19,181,"Iowa","Warren County",1,5,682,348,334
050,19,181,"Iowa","Warren County",1,6,677,327,350
050,19,181,"Iowa","Warren County",1,7,726,368,358
050,19,181,"Iowa","Warren County",1,8,703,363,340
050,19,181,"Iowa","Warren County",1,9,708,375,333
050,19,181,"Iowa","Warren County",1,10,778,406,372
050,19,181,"Iowa","Warren County",1,11,831,448,383
050,19,181,"Iowa","Warren County",1,12,837,437,400
050,19,181,"Iowa","Warren County",1,13,798,406,392
050,19,181,"Iowa","Warren County",1,14,782,386,396
050,19,181,"Iowa","Warren County",1,15,779,396,383
050,19,181,"Iowa","Warren County",1,16,746,374,372
050,19,181,"Iowa","Warren County",1,17,759,396,363
050,19,181,"Iowa","Warren County",1,18,718,375,343
050,19,181,"Iowa","Warren County",1,19,789,404,385
050,19,181,"Iowa","Warren County",1,20,723,335,388
050,19,181,"Iowa","Warren County",1,21,709,358,351
050,19,181,"Iowa","Warren County",1,22,689,352,337
050,19,181,"Iowa","Warren County",1,23,553,274,279
050,19,181,"Iowa","Warren County",1,24,506,249,257
050,19,181,"Iowa","Warren County",1,25,530,241,289
050,19,181,"Iowa","Warren County",1,26,563,274,289
050,19,181,"Iowa","Warren County",1,27,571,305,266
050,19,181,"Iowa","Warren County",1,28,586,287,299
050,19,181,"Iowa","Warren County",1,29,577,276,301
050,19,181,"Iowa","Warren County",1,30,614,311,303
050,19,181,"Iowa","Warren County",1,31,621,296,325
050,19,181,"Iowa","Warren County",1,32,626,328,298
050,19,181,"Iowa","Warren County",1,33,614,311,303
050,19,181,"Iowa","Warren County",1,34,664,329,335
050,19,181,"Iowa","Warren County",1,35,692,334,358
050,19,181,"Iowa","Warren County",1,36,709,358,351
050,19,181,"Iowa","Warren County",1,37,751,389,362
050,19,181,"Iowa","Warren County",1,38,707,344,363
050,19,181,"Iowa","Warren County",1,39,723,369,354
050,19,181,"Iowa","Warren County",1,40,729,364,365
050,19,181,"Iowa","Warren County",1,41,699,358,341
050,19,181,"Iowa","Warren County",1,42,684,350,334
050,19,181,"Iowa","Warren County",1,43,611,312,299
050,19,181,"Iowa","Warren County",1,44,614,326,288
050,19,181,"Iowa","Warren County",1,45,633,336,297
050,19,181,"Iowa","Warren County",1,46,586,284,302
050,19,181,"Iowa","Warren County",1,47,610,298,312
050,19,181,"Iowa","Warren County",1,48,686,346,340
050,19,181,"Iowa","Warren County",1,49,732,364,368
050,19,181,"Iowa","Warren County",1,50,697,348,349
050,19,181,"Iowa","Warren County",1,51,659,338,321
050,19,181,"Iowa","Warren County",1,52,646,310,336
050,19,181,"Iowa","Warren County",1,53,667,340,327
050,19,181,"Iowa","Warren County",1,54,651,336,315
050,19,181,"Iowa","Warren County",1,55,695,342,353
050,19,181,"Iowa","Warren County",1,56,698,342,356
050,19,181,"Iowa","Warren County",1,57,689,342,347
050,19,181,"Iowa","Warren County",1,58,735,363,372
050,19,181,"Iowa","Warren County",1,59,748,376,372
050,19,181,"Iowa","Warren County",1,60,677,323,354
050,19,181,"Iowa","Warren County",1,61,646,322,324
050,19,181,"Iowa","Warren County",1,62,661,327,334
050,19,181,"Iowa","Warren County",1,63,602,296,306
050,19,181,"Iowa","Warren County",1,64,572,284,288
050,19,181,"Iowa","Warren County",1,65,578,270,308
050,19,181,"Iowa","Warren County",1,66,566,277,289
050,19,181,"Iowa","Warren County",1,67,539,272,267
050,19,181,"Iowa","Warren County",1,68,583,299,284
050,19,181,"Iowa","Warren County",1,69,546,267,279
050,19,181,"Iowa","Warren County",1,70,487,234,253
050,19,181,"Iowa","Warren County",1,71,487,224,263
050,19,181,"Iowa","Warren County",1,72,467,227,240
050,19,181,"Iowa","Warren County",1,73,473,223,250
050,19,181,"Iowa","Warren County",1,74,329,167,162
050,19,181,"Iowa","Warren County",1,75,325,149,176
050,19,181,"Iowa","Warren County",1,76,322,158,164
050,19,181,"Iowa","Warren County",1,77,294,141,153
050,19,181,"Iowa","Warren County",1,78,265,111,154
050,19,181,"Iowa","Warren County",1,79,256,103,153
050,19,181,"Iowa","Warren County",1,80,248,116,132
050,19,181,"Iowa","Warren County",1,81,213,88,125
050,19,181,"Iowa","Warren County",1,82,190,81,109
050,19,181,"Iowa","Warren County",1,83,164,64,100
050,19,181,"Iowa","Warren County",1,84,166,67,99
050,19,181,"Iowa","Warren County",1,85,1061,361,700
050,19,181,"Iowa","Warren County",2,0,553,290,263
050,19,181,"Iowa","Warren County",2,1,589,312,277
050,19,181,"Iowa","Warren County",2,2,637,332,305
050,19,181,"Iowa","Warren County",2,3,670,343,327
050,19,181,"Iowa","Warren County",2,4,703,355,348
050,19,181,"Iowa","Warren County",2,5,690,353,337
050,19,181,"Iowa","Warren County",2,6,685,337,348
050,19,181,"Iowa","Warren County",2,7,717,358,359
050,19,181,"Iowa","Warren County",2,8,711,365,346
050,19,181,"Iowa","Warren County",2,9,714,376,338
050,19,181,"Iowa","Warren County",2,10,767,402,365
050,19,181,"Iowa","Warren County",2,11,819,439,380
050,19,181,"Iowa","Warren County",2,12,837,440,397
050,19,181,"Iowa","Warren County",2,13,805,411,394
050,19,181,"Iowa","Warren County",2,14,786,391,395
050,19,181,"Iowa","Warren County",2,15,783,392,391
050,19,181,"Iowa","Warren County",2,16,759,382,377
050,19,181,"Iowa","Warren County",2,17,756,393,363
050,19,181,"Iowa","Warren County",2,18,717,372,345
050,19,181,"Iowa","Warren County",2,19,786,402,384
050,19,181,"Iowa","Warren County",2,20,741,345,396
050,19,181,"Iowa","Warren County",2,21,706,350,356
050,19,181,"Iowa","Warren County",2,22,687,351,336
050,19,181,"Iowa","Warren County",2,23,553,277,276
050,19,181,"Iowa","Warren County",2,24,517,253,264
050,19,181,"Iowa","Warren County",2,25,529,243,286
050,19,181,"Iowa","Warren County",2,26,563,276,287
050,19,181,"Iowa","Warren County",2,27,579,304,275
050,19,181,"Iowa","Warren County",2,28,590,292,298
050,19,181,"Iowa","Warren County",2,29,589,286,303
050,19,181,"Iowa","Warren County",2,30,617,309,308
050,19,181,"Iowa","Warren County",2,31,624,304,320
050,19,181,"Iowa","Warren County",2,32,630,323,307
050,19,181,"Iowa","Warren County",2,33,625,318,307
050,19,181,"Iowa","Warren County",2,34,662,331,331
050,19,181,"Iowa","Warren County",2,35,697,342,355
050,19,181,"Iowa","Warren County",2,36,707,356,351
050,19,181,"Iowa","Warren County",2,37,741,381,360
050,19,181,"Iowa","Warren County",2,38,722,358,364
050,19,181,"Iowa","Warren County",2,39,718,364,354
050,19,181,"Iowa","Warren County",2,40,732,367,365
050,19,181,"Iowa","Warren County",2,41,708,361,347
050,19,181,"Iowa","Warren County",2,42,683,349,334
050,19,181,"Iowa","Warren County",2,43,637,326,311
050,19,181,"Iowa","Warren County",2,44,612,325,287
050,19,181,"Iowa","Warren County",2,45,625,331,294
050,19,181,"Iowa","Warren County",2,46,595,296,299
050,19,181,"Iowa","Warren County",2,47,601,294,307
050,19,181,"Iowa","Warren County",2,48,663,332,331
050,19,181,"Iowa","Warren County",2,49,727,363,364
050,19,181,"Iowa","Warren County",2,50,709,355,354
050,19,181,"Iowa","Warren County",2,51,670,340,330
050,19,181,"Iowa","Warren County",2,52,652,318,334
050,19,181,"Iowa","Warren County",2,53,664,334,330
050,19,181,"Iowa","Warren County",2,54,654,336,318
050,19,181,"Iowa","Warren County",2,55,681,340,341
050,19,181,"Iowa","Warren County",2,56,699,344,355
050,19,181,"Iowa","Warren County",2,57,693,343,350
050,19,181,"Iowa","Warren County",2,58,723,355,368
050,19,181,"Iowa","Warren County",2,59,749,376,373
050,19,181,"Iowa","Warren County",2,60,691,335,356
050,19,181,"Iowa","Warren County",2,61,655,321,334
050,19,181,"Iowa","Warren County",2,62,661,328,333
050,19,181,"Iowa","Warren County",2,63,620,304,316
050,19,181,"Iowa","Warren County",2,64,572,283,289
050,19,181,"Iowa","Warren County",2,65,576,271,305
050,19,181,"Iowa","Warren County",2,66,571,275,296
050,19,181,"Iowa","Warren County",2,67,546,272,274
050,19,181,"Iowa","Warren County",2,68,566,289,277
050,19,181,"Iowa","Warren County",2,69,558,277,281
050,19,181,"Iowa","Warren County",2,70,501,242,259
050,19,181,"Iowa","Warren County",2,71,487,227,260
050,19,181,"Iowa","Warren County",2,72,459,220,239
050,19,181,"Iowa","Warren County",2,73,495,235,260
050,19,181,"Iowa","Warren County",2,74,339,168,171
050,19,181,"Iowa","Warren County",2,75,327,154,173
050,19,181,"Iowa","Warren County",2,76,323,155,168
050,19,181,"Iowa","Warren County",2,77,308,149,159
050,19,181,"Iowa","Warren County",2,78,267,115,152
050,19,181,"Iowa","Warren County",2,79,256,103,153
050,19,181,"Iowa","Warren County",2,80,245,114,131
050,19,181,"Iowa","Warren County",2,81,214,93,121
050,19,181,"Iowa","Warren County",2,82,193,80,113
050,19,181,"Iowa","Warren County",2,83,169,68,101
050,19,181,"Iowa","Warren County",2,84,166,67,99
050,19,181,"Iowa","Warren County",2,85,1068,364,704
050,19,181,"Iowa","Warren County",3,0,569,301,268
050,19,181,"Iowa","Warren County",3,1,579,301,278
050,19,181,"Iowa","Warren County",3,2,619,319,300
050,19,181,"Iowa","Warren County",3,3,663,341,322
050,19,181,"Iowa","Warren County",3,4,692,349,343
050,19,181,"Iowa","Warren County",3,5,735,360,375
050,19,181,"Iowa","Warren County",3,6,727,380,347
050,19,181,"Iowa","Warren County",3,7,710,336,374
050,19,181,"Iowa","Warren County",3,8,736,363,373
050,19,181,"Iowa","Warren County",3,9,735,372,363
050,19,181,"Iowa","Warren County",3,10,709,375,334
050,19,181,"Iowa","Warren County",3,11,790,424,366
050,19,181,"Iowa","Warren County",3,12,849,445,404
050,19,181,"Iowa","Warren County",3,13,856,454,402
050,19,181,"Iowa","Warren County",3,14,826,430,396
050,19,181,"Iowa","Warren County",3,15,822,414,408
050,19,181,"Iowa","Warren County",3,16,805,413,392
050,19,181,"Iowa","Warren County",3,17,765,386,379
050,19,181,"Iowa","Warren County",3,18,737,377,360
050,19,181,"Iowa","Warren County",3,19,771,404,367
050,19,181,"Iowa","Warren County",3,20,800,374,426
050,19,181,"Iowa","Warren County",3,21,729,353,376
050,19,181,"Iowa","Warren County",3,22,658,333,325
050,19,181,"Iowa","Warren County",3,23,554,280,274
050,19,181,"Iowa","Warren County",3,24,550,296,254
050,19,181,"Iowa","Warren County",3,25,538,261,277
050,19,181,"Iowa","Warren County",3,26,556,256,300
050,19,181,"Iowa","Warren County",3,27,576,285,291
050,19,181,"Iowa","Warren County",3,28,592,306,286
050,19,181,"Iowa","Warren County",3,29,605,296,309
050,19,181,"Iowa","Warren County",3,30,607,299,308
050,19,181,"Iowa","Warren County",3,31,645,301,344
050,19,181,"Iowa","Warren County",3,32,648,327,321
050,19,181,"Iowa","Warren County",3,33,645,330,315
050,19,181,"Iowa","Warren County",3,34,664,350,314
050,19,181,"Iowa","Warren County",3,35,697,347,350
050,19,181,"Iowa","Warren County",3,36,720,363,357
050,19,181,"Iowa","Warren County",3,37,746,359,387
050,19,181,"Iowa","Warren County",3,38,778,393,385
050,19,181,"Iowa","Warren County",3,39,737,369,368
050,19,181,"Iowa","Warren County",3,40,736,369,367
050,19,181,"Iowa","Warren County",3,41,738,366,372
050,19,181,"Iowa","Warren County",3,42,729,386,343
050,19,181,"Iowa","Warren County",3,43,702,353,349
050,19,181,"Iowa","Warren County",3,44,660,337,323
050,19,181,"Iowa","Warren County",3,45,617,334,283
050,19,181,"Iowa","Warren County",3,46,640,349,291
050,19,181,"Iowa","Warren County",3,47,614,307,307
050,19,181,"Iowa","Warren County",3,48,600,290,310
050,19,181,"Iowa","Warren County",3,49,685,342,343
050,19,181,"Iowa","Warren County",3,50,728,371,357
050,19,181,"Iowa","Warren County",3,51,710,356,354
050,19,181,"Iowa","Warren County",3,52,681,347,334
050,19,181,"Iowa","Warren County",3,53,655,322,333
050,19,181,"Iowa","Warren County",3,54,656,325,331
050,19,181,"Iowa","Warren County",3,55,659,334,325
050,19,181,"Iowa","Warren County",3,56,668,338,330
050,19,181,"Iowa","Warren County",3,57,698,346,352
050,19,181,"Iowa","Warren County",3,58,687,332,355
050,19,181,"Iowa","Warren County",3,59,716,355,361
050,19,181,"Iowa","Warren County",3,60,745,376,369
050,19,181,"Iowa","Warren County",3,61,696,340,356
050,19,181,"Iowa","Warren County",3,62,666,328,338
050,19,181,"Iowa","Warren County",3,63,645,315,330
050,19,181,"Iowa","Warren County",3,64,604,291,313
050,19,181,"Iowa","Warren County",3,65,572,276,296
050,19,181,"Iowa","Warren County",3,66,570,264,306
050,19,181,"Iowa","Warren County",3,67,561,272,289
050,19,181,"Iowa","Warren County",3,68,533,253,280
050,19,181,"Iowa","Warren County",3,69,547,280,267
050,19,181,"Iowa","Warren County",3,70,560,275,285
050,19,181,"Iowa","Warren County",3,71,488,240,248
050,19,181,"Iowa","Warren County",3,72,477,225,252
050,19,181,"Iowa","Warren County",3,73,456,221,235
050,19,181,"Iowa","Warren County",3,74,477,230,247
050,19,181,"Iowa","Warren County",3,75,328,157,171
050,19,181,"Iowa","Warren County",3,76,315,144,171
050,19,181,"Iowa","Warren County",3,77,311,150,161
050,19,181,"Iowa","Warren County",3,78,294,133,161
050,19,181,"Iowa","Warren County",3,79,255,109,146
050,19,181,"Iowa","Warren County",3,80,238,103,135
050,19,181,"Iowa","Warren County",3,81,227,98,129
050,19,181,"Iowa","Warren County",3,82,196,84,112
050,19,181,"Iowa","Warren County",3,83,172,71,101
050,19,181,"Iowa","Warren County",3,84,165,67,98
050,19,181,"Iowa","Warren County",3,85,1068,361,707
050,19,181,"Iowa","Warren County",4,0,608,324,284
050,19,181,"Iowa","Warren County",4,1,591,309,282
050,19,181,"Iowa","Warren County",4,2,612,310,302
050,19,181,"Iowa","Warren County",4,3,669,346,323
050,19,181,"Iowa","Warren County",4,4,691,357,334
050,19,181,"Iowa","Warren County",4,5,717,372,345
050,19,181,"Iowa","Warren County",4,6,753,370,383
050,19,181,"Iowa","Warren County",4,7,755,392,363
050,19,181,"Iowa","Warren County",4,8,731,351,380
050,19,181,"Iowa","Warren County",4,9,761,378,383
050,19,181,"Iowa","Warren County",4,10,773,397,376
050,19,181,"Iowa","Warren County",4,11,740,388,352
050,19,181,"Iowa","Warren County",4,12,800,427,373
050,19,181,"Iowa","Warren County",4,13,856,451,405
050,19,181,"Iowa","Warren County",4,14,868,464,404
050,19,181,"Iowa","Warren County",4,15,818,422,396
050,19,181,"Iowa","Warren County",4,16,800,399,401
050,19,181,"Iowa","Warren County",4,17,805,408,397
050,19,181,"Iowa","Warren County",4,18,722,366,356
050,19,181,"Iowa","Warren County",4,19,754,395,359
050,19,181,"Iowa","Warren County",4,20,754,374,380
050,19,181,"Iowa","Warren County",4,21,737,357,380
050,19,181,"Iowa","Warren County",4,22,715,353,362
050,19,181,"Iowa","Warren County",4,23,535,272,263
050,19,181,"Iowa","Warren County",4,24,526,269,257
050,19,181,"Iowa","Warren County",4,25,598,308,290
050,19,181,"Iowa","Warren County",4,26,582,287,295
050,19,181,"Iowa","Warren County",4,27,601,287,314
050,19,181,"Iowa","Warren County",4,28,599,293,306
050,19,181,"Iowa","Warren County",4,29,623,320,303
050,19,181,"Iowa","Warren County",4,30,639,320,319
050,19,181,"Iowa","Warren County",4,31,622,297,325
050,19,181,"Iowa","Warren County",4,32,674,327,347
050,19,181,"Iowa","Warren County",4,33,686,334,352
050,19,181,"Iowa","Warren County",4,34,663,346,317
050,19,181,"Iowa","Warren County",4,35,701,373,328
050,19,181,"Iowa","Warren County",4,36,739,373,366
050,19,181,"Iowa","Warren County",4,37,732,367,365
050,19,181,"Iowa","Warren County",4,38,759,366,393
050,19,181,"Iowa","Warren County",4,39,781,394,387
050,19,181,"Iowa","Warren County",4,40,767,375,392
050,19,181,"Iowa","Warren County",4,41,759,381,378
050,19,181,"Iowa","Warren County",4,42,738,374,364
050,19,181,"Iowa","Warren County",4,43,740,390,350
050,19,181,"Iowa","Warren County",4,44,711,359,352
050,19,181,"Iowa","Warren County",4,45,658,338,320
050,19,181,"Iowa","Warren County",4,46,596,326,270
050,19,181,"Iowa","Warren County",4,47,646,360,286
050,19,181,"Iowa","Warren County",4,48,593,291,302
050,19,181,"Iowa","Warren County",4,49,599,290,309
050,19,181,"Iowa","Warren County",4,50,695,346,349
050,19,181,"Iowa","Warren County",4,51,729,368,361
050,19,181,"Iowa","Warren County",4,52,709,349,360
050,19,181,"Iowa","Warren County",4,53,686,348,338
050,19,181,"Iowa","Warren County",4,54,655,325,330
050,19,181,"Iowa","Warren County",4,55,641,310,331
050,19,181,"Iowa","Warren County",4,56,663,338,325
050,19,181,"Iowa","Warren County",4,57,670,333,337
050,19,181,"Iowa","Warren County",4,58,690,334,356
050,19,181,"Iowa","Warren County",4,59,692,327,365
050,19,181,"Iowa","Warren County",4,60,727,363,364
050,19,181,"Iowa","Warren County",4,61,765,390,375
050,19,181,"Iowa","Warren County",4,62,717,346,371
050,19,181,"Iowa","Warren County",4,63,662,323,339
050,19,181,"Iowa","Warren County",4,64,651,320,331
050,19,181,"Iowa","Warren County",4,65,600,286,314
050,19,181,"Iowa","Warren County",4,66,578,274,304
050,19,181,"Iowa","Warren County",4,67,564,264,300
050,19,181,"Iowa","Warren County",4,68,545,257,288
050,19,181,"Iowa","Warren County",4,69,520,245,275
050,19,181,"Iowa","Warren County",4,70,540,275,265
050,19,181,"Iowa","Warren County",4,71,551,270,281
050,19,181,"Iowa","Warren County",4,72,469,230,239
050,19,181,"Iowa","Warren County",4,73,472,224,248
050,19,181,"Iowa","Warren County",4,74,447,224,223
050,19,181,"Iowa","Warren County",4,75,463,218,245
050,19,181,"Iowa","Warren County",4,76,326,154,172
050,19,181,"Iowa","Warren County",4,77,304,142,162
050,19,181,"Iowa","Warren County",4,78,301,136,165
050,19,181,"Iowa","Warren County",4,79,290,133,157
050,19,181,"Iowa","Warren County",4,80,251,117,134
050,19,181,"Iowa","Warren County",4,81,221,84,137
050,19,181,"Iowa","Warren County",4,82,212,85,127
050,19,181,"Iowa","Warren County",4,83,179,72,107
050,19,181,"Iowa","Warren County",4,84,165,66,99
050,19,181,"Iowa","Warren County",4,85,1056,346,710
050,19,181,"Iowa","Warren County",5,0,611,326,285
050,19,181,"Iowa","Warren County",5,1,674,336,338
050,19,181,"Iowa","Warren County",5,2,600,315,285
050,19,181,"Iowa","Warren County",5,3,641,323,318
050,19,181,"Iowa","Warren County",5,4,681,346,335
050,19,181,"Iowa","Warren County",5,5,720,359,361
050,19,181,"Iowa","Warren County",5,6,731,379,352
050,19,181,"Iowa","Warren County",5,7,762,379,383
050,19,181,"Iowa","Warren County",5,8,769,402,367
050,19,181,"Iowa","Warren County",5,9,738,363,375
050,19,181,"Iowa","Warren County",5,10,773,382,391
050,19,181,"Iowa","Warren County",5,11,782,409,373
050,19,181,"Iowa","Warren County",5,12,744,389,355
050,19,181,"Iowa","Warren County",5,13,831,435,396
050,19,181,"Iowa","Warren County",5,14,862,448,414
050,19,181,"Iowa","Warren County",5,15,882,463,419
050,19,181,"Iowa","Warren County",5,16,836,423,413
050,19,181,"Iowa","Warren County",5,17,806,410,396
050,19,181,"Iowa","Warren County",5,18,744,383,361
050,19,181,"Iowa","Warren County",5,19,752,385,367
050,19,181,"Iowa","Warren County",5,20,749,361,388
050,19,181,"Iowa","Warren County",5,21,745,378,367
050,19,181,"Iowa","Warren County",5,22,718,365,353
050,19,181,"Iowa","Warren County",5,23,608,301,307
050,19,181,"Iowa","Warren County",5,24,573,303,270
050,19,181,"Iowa","Warren County",5,25,570,292,278
050,19,181,"Iowa","Warren County",5,26,595,318,277
050,19,181,"Iowa","Warren County",5,27,619,313,306
050,19,181,"Iowa","Warren County",5,28,611,298,313
050,19,181,"Iowa","Warren County",5,29,614,309,305
050,19,181,"Iowa","Warren County",5,30,673,344,329
050,19,181,"Iowa","Warren County",5,31,687,336,351
050,19,181,"Iowa","Warren County",5,32,645,316,329
050,19,181,"Iowa","Warren County",5,33,712,335,377
050,19,181,"Iowa","Warren County",5,34,720,350,370
050,19,181,"Iowa","Warren County",5,35,684,357,327
050,19,181,"Iowa","Warren County",5,36,723,386,337
050,19,181,"Iowa","Warren County",5,37,756,381,375
050,19,181,"Iowa","Warren County",5,38,759,376,383
050,19,181,"Iowa","Warren County",5,39,759,372,387
050,19,181,"Iowa","Warren County",5,40,794,401,393
050,19,181,"Iowa","Warren County",5,41,781,391,390
050,19,181,"Iowa","Warren County",5,42,758,380,378
050,19,181,"Iowa","Warren County",5,43,762,388,374
050,19,181,"Iowa","Warren County",5,44,740,387,353
050,19,181,"Iowa","Warren County",5,45,724,367,357
050,19,181,"Iowa","Warren County",5,46,664,338,326
050,19,181,"Iowa","Warren County",5,47,603,326,277
050,19,181,"Iowa","Warren County",5,48,653,354,299
050,19,181,"Iowa","Warren County",5,49,614,298,316
050,19,181,"Iowa","Warren County",5,50,605,294,311
050,19,181,"Iowa","Warren County",5,51,687,349,338
050,19,181,"Iowa","Warren County",5,52,735,366,369
050,19,181,"Iowa","Warren County",5,53,711,347,364
050,19,181,"Iowa","Warren County",5,54,694,355,339
050,19,181,"Iowa","Warren County",5,55,638,313,325
050,19,181,"Iowa","Warren County",5,56,644,312,332
050,19,181,"Iowa","Warren County",5,57,698,362,336
050,19,181,"Iowa","Warren County",5,58,658,323,335
050,19,181,"Iowa","Warren County",5,59,696,342,354
050,19,181,"Iowa","Warren County",5,60,677,324,353
050,19,181,"Iowa","Warren County",5,61,721,356,365
050,19,181,"Iowa","Warren County",5,62,768,389,379
050,19,181,"Iowa","Warren County",5,63,708,336,372
050,19,181,"Iowa","Warren County",5,64,661,320,341
050,19,181,"Iowa","Warren County",5,65,647,307,340
050,19,181,"Iowa","Warren County",5,66,604,284,320
050,19,181,"Iowa","Warren County",5,67,576,271,305
050,19,181,"Iowa","Warren County",5,68,544,248,296
050,19,181,"Iowa","Warren County",5,69,538,255,283
050,19,181,"Iowa","Warren County",5,70,519,239,280
050,19,181,"Iowa","Warren County",5,71,519,268,251
050,19,181,"Iowa","Warren County",5,72,528,263,265
050,19,181,"Iowa","Warren County",5,73,469,226,243
050,19,181,"Iowa","Warren County",5,74,470,227,243
050,19,181,"Iowa","Warren County",5,75,418,205,213
050,19,181,"Iowa","Warren County",5,76,453,208,245
050,19,181,"Iowa","Warren County",5,77,310,148,162
050,19,181,"Iowa","Warren County",5,78,303,137,166
050,19,181,"Iowa","Warren County",5,79,290,131,159
050,19,181,"Iowa","Warren County",5,80,277,133,144
050,19,181,"Iowa","Warren County",5,81,237,100,137
050,19,181,"Iowa","Warren County",5,82,199,68,131
050,19,181,"Iowa","Warren County",5,83,193,72,121
050,19,181,"Iowa","Warren County",5,84,170,68,102
050,19,181,"Iowa","Warren County",5,85,1088,346,742
050,19,183,"Iowa","Washington County",1,0,289,147,142
050,19,183,"Iowa","Washington County",1,1,301,148,153
050,19,183,"Iowa","Washington County",1,2,290,148,142
050,19,183,"Iowa","Washington County",1,3,292,149,143
050,19,183,"Iowa","Washington County",1,4,298,157,141
050,19,183,"Iowa","Washington County",1,5,320,161,159
050,19,183,"Iowa","Washington County",1,6,321,168,153
050,19,183,"Iowa","Washington County",1,7,320,162,158
050,19,183,"Iowa","Washington County",1,8,317,161,156
050,19,183,"Iowa","Washington County",1,9,309,173,136
050,19,183,"Iowa","Washington County",1,10,294,154,140
050,19,183,"Iowa","Washington County",1,11,323,167,156
050,19,183,"Iowa","Washington County",1,12,336,159,177
050,19,183,"Iowa","Washington County",1,13,349,185,164
050,19,183,"Iowa","Washington County",1,14,325,175,150
050,19,183,"Iowa","Washington County",1,15,303,157,146
050,19,183,"Iowa","Washington County",1,16,317,167,150
050,19,183,"Iowa","Washington County",1,17,311,158,153
050,19,183,"Iowa","Washington County",1,18,288,151,137
050,19,183,"Iowa","Washington County",1,19,227,129,98
050,19,183,"Iowa","Washington County",1,20,238,131,107
050,19,183,"Iowa","Washington County",1,21,220,113,107
050,19,183,"Iowa","Washington County",1,22,232,106,126
050,19,183,"Iowa","Washington County",1,23,248,108,140
050,19,183,"Iowa","Washington County",1,24,223,111,112
050,19,183,"Iowa","Washington County",1,25,236,113,123
050,19,183,"Iowa","Washington County",1,26,267,138,129
050,19,183,"Iowa","Washington County",1,27,279,142,137
050,19,183,"Iowa","Washington County",1,28,280,144,136
050,19,183,"Iowa","Washington County",1,29,290,156,134
050,19,183,"Iowa","Washington County",1,30,255,125,130
050,19,183,"Iowa","Washington County",1,31,252,126,126
050,19,183,"Iowa","Washington County",1,32,239,127,112
050,19,183,"Iowa","Washington County",1,33,244,114,130
050,19,183,"Iowa","Washington County",1,34,260,126,134
050,19,183,"Iowa","Washington County",1,35,263,131,132
050,19,183,"Iowa","Washington County",1,36,271,143,128
050,19,183,"Iowa","Washington County",1,37,257,134,123
050,19,183,"Iowa","Washington County",1,38,288,145,143
050,19,183,"Iowa","Washington County",1,39,267,133,134
050,19,183,"Iowa","Washington County",1,40,246,127,119
050,19,183,"Iowa","Washington County",1,41,227,121,106
050,19,183,"Iowa","Washington County",1,42,259,122,137
050,19,183,"Iowa","Washington County",1,43,260,133,127
050,19,183,"Iowa","Washington County",1,44,241,121,120
050,19,183,"Iowa","Washington County",1,45,229,115,114
050,19,183,"Iowa","Washington County",1,46,228,117,111
050,19,183,"Iowa","Washington County",1,47,225,115,110
050,19,183,"Iowa","Washington County",1,48,265,128,137
050,19,183,"Iowa","Washington County",1,49,274,138,136
050,19,183,"Iowa","Washington County",1,50,265,128,137
050,19,183,"Iowa","Washington County",1,51,255,127,128
050,19,183,"Iowa","Washington County",1,52,255,123,132
050,19,183,"Iowa","Washington County",1,53,279,144,135
050,19,183,"Iowa","Washington County",1,54,302,163,139
050,19,183,"Iowa","Washington County",1,55,325,164,161
050,19,183,"Iowa","Washington County",1,56,302,146,156
050,19,183,"Iowa","Washington County",1,57,297,149,148
050,19,183,"Iowa","Washington County",1,58,319,162,157
050,19,183,"Iowa","Washington County",1,59,324,169,155
050,19,183,"Iowa","Washington County",1,60,319,165,154
050,19,183,"Iowa","Washington County",1,61,318,169,149
050,19,183,"Iowa","Washington County",1,62,302,151,151
050,19,183,"Iowa","Washington County",1,63,311,156,155
050,19,183,"Iowa","Washington County",1,64,283,142,141
050,19,183,"Iowa","Washington County",1,65,289,152,137
050,19,183,"Iowa","Washington County",1,66,300,153,147
050,19,183,"Iowa","Washington County",1,67,283,136,147
050,19,183,"Iowa","Washington County",1,68,263,121,142
050,19,183,"Iowa","Washington County",1,69,242,102,140
050,19,183,"Iowa","Washington County",1,70,237,117,120
050,19,183,"Iowa","Washington County",1,71,239,127,112
050,19,183,"Iowa","Washington County",1,72,226,114,112
050,19,183,"Iowa","Washington County",1,73,222,115,107
050,19,183,"Iowa","Washington County",1,74,169,70,99
050,19,183,"Iowa","Washington County",1,75,173,78,95
050,19,183,"Iowa","Washington County",1,76,175,81,94
050,19,183,"Iowa","Washington County",1,77,167,85,82
050,19,183,"Iowa","Washington County",1,78,137,65,72
050,19,183,"Iowa","Washington County",1,79,129,60,69
050,19,183,"Iowa","Washington County",1,80,115,58,57
050,19,183,"Iowa","Washington County",1,81,111,52,59
050,19,183,"Iowa","Washington County",1,82,105,51,54
050,19,183,"Iowa","Washington County",1,83,108,48,60
050,19,183,"Iowa","Washington County",1,84,90,40,50
050,19,183,"Iowa","Washington County",1,85,637,191,446
050,19,183,"Iowa","Washington County",2,0,287,138,149
050,19,183,"Iowa","Washington County",2,1,295,146,149
050,19,183,"Iowa","Washington County",2,2,292,149,143
050,19,183,"Iowa","Washington County",2,3,292,149,143
050,19,183,"Iowa","Washington County",2,4,297,156,141
050,19,183,"Iowa","Washington County",2,5,314,161,153
050,19,183,"Iowa","Washington County",2,6,321,167,154
050,19,183,"Iowa","Washington County",2,7,319,163,156
050,19,183,"Iowa","Washington County",2,8,320,163,157
050,19,183,"Iowa","Washington County",2,9,308,168,140
050,19,183,"Iowa","Washington County",2,10,296,157,139
050,19,183,"Iowa","Washington County",2,11,319,165,154
050,19,183,"Iowa","Washington County",2,12,333,161,172
050,19,183,"Iowa","Washington County",2,13,347,178,169
050,19,183,"Iowa","Washington County",2,14,331,178,153
050,19,183,"Iowa","Washington County",2,15,307,162,145
050,19,183,"Iowa","Washington County",2,16,311,163,148
050,19,183,"Iowa","Washington County",2,17,315,161,154
050,19,183,"Iowa","Washington County",2,18,277,146,131
050,19,183,"Iowa","Washington County",2,19,229,126,103
050,19,183,"Iowa","Washington County",2,20,241,132,109
050,19,183,"Iowa","Washington County",2,21,226,119,107
050,19,183,"Iowa","Washington County",2,22,229,107,122
050,19,183,"Iowa","Washington County",2,23,241,107,134
050,19,183,"Iowa","Washington County",2,24,228,110,118
050,19,183,"Iowa","Washington County",2,25,234,113,121
050,19,183,"Iowa","Washington County",2,26,261,133,128
050,19,183,"Iowa","Washington County",2,27,278,143,135
050,19,183,"Iowa","Washington County",2,28,278,144,134
050,19,183,"Iowa","Washington County",2,29,285,151,134
050,19,183,"Iowa","Washington County",2,30,266,132,134
050,19,183,"Iowa","Washington County",2,31,255,128,127
050,19,183,"Iowa","Washington County",2,32,241,126,115
050,19,183,"Iowa","Washington County",2,33,244,118,126
050,19,183,"Iowa","Washington County",2,34,258,123,135
050,19,183,"Iowa","Washington County",2,35,263,129,134
050,19,183,"Iowa","Washington County",2,36,267,140,127
050,19,183,"Iowa","Washington County",2,37,261,137,124
050,19,183,"Iowa","Washington County",2,38,283,144,139
050,19,183,"Iowa","Washington County",2,39,270,135,135
050,19,183,"Iowa","Washington County",2,40,252,129,123
050,19,183,"Iowa","Washington County",2,41,229,122,107
050,19,183,"Iowa","Washington County",2,42,250,121,129
050,19,183,"Iowa","Washington County",2,43,262,131,131
050,19,183,"Iowa","Washington County",2,44,243,123,120
050,19,183,"Iowa","Washington County",2,45,233,118,115
050,19,183,"Iowa","Washington County",2,46,228,118,110
050,19,183,"Iowa","Washington County",2,47,226,116,110
050,19,183,"Iowa","Washington County",2,48,253,123,130
050,19,183,"Iowa","Washington County",2,49,273,136,137
050,19,183,"Iowa","Washington County",2,50,269,131,138
050,19,183,"Iowa","Washington County",2,51,258,127,131
050,19,183,"Iowa","Washington County",2,52,256,125,131
050,19,183,"Iowa","Washington County",2,53,274,140,134
050,19,183,"Iowa","Washington County",2,54,295,158,137
050,19,183,"Iowa","Washington County",2,55,317,163,154
050,19,183,"Iowa","Washington County",2,56,308,150,158
050,19,183,"Iowa","Washington County",2,57,301,150,151
050,19,183,"Iowa","Washington County",2,58,310,157,153
050,19,183,"Iowa","Washington County",2,59,324,168,156
050,19,183,"Iowa","Washington County",2,60,316,163,153
050,19,183,"Iowa","Washington County",2,61,317,166,151
050,19,183,"Iowa","Washington County",2,62,306,154,152
050,19,183,"Iowa","Washington County",2,63,311,155,156
050,19,183,"Iowa","Washington County",2,64,286,143,143
050,19,183,"Iowa","Washington County",2,65,286,148,138
050,19,183,"Iowa","Washington County",2,66,295,151,144
050,19,183,"Iowa","Washington County",2,67,286,139,147
050,19,183,"Iowa","Washington County",2,68,266,124,142
050,19,183,"Iowa","Washington County",2,69,249,108,141
050,19,183,"Iowa","Washington County",2,70,235,110,125
050,19,183,"Iowa","Washington County",2,71,241,126,115
050,19,183,"Iowa","Washington County",2,72,222,114,108
050,19,183,"Iowa","Washington County",2,73,232,118,114
050,19,183,"Iowa","Washington County",2,74,168,74,94
050,19,183,"Iowa","Washington County",2,75,174,78,96
050,19,183,"Iowa","Washington County",2,76,172,78,94
050,19,183,"Iowa","Washington County",2,77,171,86,85
050,19,183,"Iowa","Washington County",2,78,139,67,72
050,19,183,"Iowa","Washington County",2,79,130,62,68
050,19,183,"Iowa","Washington County",2,80,117,58,59
050,19,183,"Iowa","Washington County",2,81,109,51,58
050,19,183,"Iowa","Washington County",2,82,107,53,54
050,19,183,"Iowa","Washington County",2,83,102,45,57
050,19,183,"Iowa","Washington County",2,84,93,41,52
050,19,183,"Iowa","Washington County",2,85,632,188,444
050,19,183,"Iowa","Washington County",3,0,314,159,155
050,19,183,"Iowa","Washington County",3,1,305,145,160
050,19,183,"Iowa","Washington County",3,2,291,144,147
050,19,183,"Iowa","Washington County",3,3,284,150,134
050,19,183,"Iowa","Washington County",3,4,294,144,150
050,19,183,"Iowa","Washington County",3,5,304,157,147
050,19,183,"Iowa","Washington County",3,6,320,167,153
050,19,183,"Iowa","Washington County",3,7,316,168,148
050,19,183,"Iowa","Washington County",3,8,325,167,158
050,19,183,"Iowa","Washington County",3,9,326,167,159
050,19,183,"Iowa","Washington County",3,10,303,160,143
050,19,183,"Iowa","Washington County",3,11,289,165,124
050,19,183,"Iowa","Washington County",3,12,312,164,148
050,19,183,"Iowa","Washington County",3,13,328,164,164
050,19,183,"Iowa","Washington County",3,14,341,170,171
050,19,183,"Iowa","Washington County",3,15,315,167,148
050,19,183,"Iowa","Washington County",3,16,307,161,146
050,19,183,"Iowa","Washington County",3,17,306,162,144
050,19,183,"Iowa","Washington County",3,18,263,145,118
050,19,183,"Iowa","Washington County",3,19,217,118,99
050,19,183,"Iowa","Washington County",3,20,235,128,107
050,19,183,"Iowa","Washington County",3,21,241,131,110
050,19,183,"Iowa","Washington County",3,22,238,120,118
050,19,183,"Iowa","Washington County",3,23,229,111,118
050,19,183,"Iowa","Washington County",3,24,254,110,144
050,19,183,"Iowa","Washington County",3,25,238,114,124
050,19,183,"Iowa","Washington County",3,26,235,113,122
050,19,183,"Iowa","Washington County",3,27,262,131,131
050,19,183,"Iowa","Washington County",3,28,279,145,134
050,19,183,"Iowa","Washington County",3,29,283,140,143
050,19,183,"Iowa","Washington County",3,30,291,158,133
050,19,183,"Iowa","Washington County",3,31,271,135,136
050,19,183,"Iowa","Washington County",3,32,261,129,132
050,19,183,"Iowa","Washington County",3,33,243,136,107
050,19,183,"Iowa","Washington County",3,34,250,124,126
050,19,183,"Iowa","Washington County",3,35,274,136,138
050,19,183,"Iowa","Washington County",3,36,268,136,132
050,19,183,"Iowa","Washington County",3,37,270,140,130
050,19,183,"Iowa","Washington County",3,38,255,137,118
050,19,183,"Iowa","Washington County",3,39,283,142,141
050,19,183,"Iowa","Washington County",3,40,274,135,139
050,19,183,"Iowa","Washington County",3,41,259,134,125
050,19,183,"Iowa","Washington County",3,42,235,122,113
050,19,183,"Iowa","Washington County",3,43,247,120,127
050,19,183,"Iowa","Washington County",3,44,260,130,130
050,19,183,"Iowa","Washington County",3,45,237,123,114
050,19,183,"Iowa","Washington County",3,46,231,117,114
050,19,183,"Iowa","Washington County",3,47,229,118,111
050,19,183,"Iowa","Washington County",3,48,220,112,108
050,19,183,"Iowa","Washington County",3,49,246,117,129
050,19,183,"Iowa","Washington County",3,50,269,133,136
050,19,183,"Iowa","Washington County",3,51,271,130,141
050,19,183,"Iowa","Washington County",3,52,252,123,129
050,19,183,"Iowa","Washington County",3,53,246,118,128
050,19,183,"Iowa","Washington County",3,54,276,141,135
050,19,183,"Iowa","Washington County",3,55,294,161,133
050,19,183,"Iowa","Washington County",3,56,300,154,146
050,19,183,"Iowa","Washington County",3,57,312,156,156
050,19,183,"Iowa","Washington County",3,58,293,144,149
050,19,183,"Iowa","Washington County",3,59,320,163,157
050,19,183,"Iowa","Washington County",3,60,313,163,150
050,19,183,"Iowa","Washington County",3,61,312,161,151
050,19,183,"Iowa","Washington County",3,62,311,165,146
050,19,183,"Iowa","Washington County",3,63,303,152,151
050,19,183,"Iowa","Washington County",3,64,310,154,156
050,19,183,"Iowa","Washington County",3,65,281,141,140
050,19,183,"Iowa","Washington County",3,66,282,145,137
050,19,183,"Iowa","Washington County",3,67,288,148,140
050,19,183,"Iowa","Washington County",3,68,285,139,146
050,19,183,"Iowa","Washington County",3,69,253,121,132
050,19,183,"Iowa","Washington County",3,70,241,102,139
050,19,183,"Iowa","Washington County",3,71,240,114,126
050,19,183,"Iowa","Washington County",3,72,229,120,109
050,19,183,"Iowa","Washington County",3,73,218,108,110
050,19,183,"Iowa","Washington County",3,74,228,116,112
050,19,183,"Iowa","Washington County",3,75,166,76,90
050,19,183,"Iowa","Washington County",3,76,163,70,93
050,19,183,"Iowa","Washington County",3,77,167,71,96
050,19,183,"Iowa","Washington County",3,78,162,82,80
050,19,183,"Iowa","Washington County",3,79,137,65,72
050,19,183,"Iowa","Washington County",3,80,122,55,67
050,19,183,"Iowa","Washington County",3,81,110,52,58
050,19,183,"Iowa","Washington County",3,82,107,53,54
050,19,183,"Iowa","Washington County",3,83,101,48,53
050,19,183,"Iowa","Washington County",3,84,93,40,53
050,19,183,"Iowa","Washington County",3,85,609,174,435
050,19,183,"Iowa","Washington County",4,0,274,150,124
050,19,183,"Iowa","Washington County",4,1,303,160,143
050,19,183,"Iowa","Washington County",4,2,309,150,159
050,19,183,"Iowa","Washington County",4,3,302,151,151
050,19,183,"Iowa","Washington County",4,4,288,148,140
050,19,183,"Iowa","Washington County",4,5,295,142,153
050,19,183,"Iowa","Washington County",4,6,316,164,152
050,19,183,"Iowa","Washington County",4,7,307,160,147
050,19,183,"Iowa","Washington County",4,8,322,170,152
050,19,183,"Iowa","Washington County",4,9,318,156,162
050,19,183,"Iowa","Washington County",4,10,320,160,160
050,19,183,"Iowa","Washington County",4,11,305,163,142
050,19,183,"Iowa","Washington County",4,12,294,166,128
050,19,183,"Iowa","Washington County",4,13,313,162,151
050,19,183,"Iowa","Washington County",4,14,332,164,168
050,19,183,"Iowa","Washington County",4,15,344,173,171
050,19,183,"Iowa","Washington County",4,16,317,168,149
050,19,183,"Iowa","Washington County",4,17,308,162,146
050,19,183,"Iowa","Washington County",4,18,258,143,115
050,19,183,"Iowa","Washington County",4,19,205,113,92
050,19,183,"Iowa","Washington County",4,20,226,121,105
050,19,183,"Iowa","Washington County",4,21,243,128,115
050,19,183,"Iowa","Washington County",4,22,243,136,107
050,19,183,"Iowa","Washington County",4,23,243,125,118
050,19,183,"Iowa","Washington County",4,24,239,111,128
050,19,183,"Iowa","Washington County",4,25,251,112,139
050,19,183,"Iowa","Washington County",4,26,235,113,122
050,19,183,"Iowa","Washington County",4,27,234,110,124
050,19,183,"Iowa","Washington County",4,28,260,128,132
050,19,183,"Iowa","Washington County",4,29,287,150,137
050,19,183,"Iowa","Washington County",4,30,296,149,147
050,19,183,"Iowa","Washington County",4,31,287,157,130
050,19,183,"Iowa","Washington County",4,32,267,133,134
050,19,183,"Iowa","Washington County",4,33,252,122,130
050,19,183,"Iowa","Washington County",4,34,249,138,111
050,19,183,"Iowa","Washington County",4,35,261,134,127
050,19,183,"Iowa","Washington County",4,36,271,138,133
050,19,183,"Iowa","Washington County",4,37,275,139,136
050,19,183,"Iowa","Washington County",4,38,266,139,127
050,19,183,"Iowa","Washington County",4,39,252,135,117
050,19,183,"Iowa","Washington County",4,40,281,146,135
050,19,183,"Iowa","Washington County",4,41,283,134,149
050,19,183,"Iowa","Washington County",4,42,263,143,120
050,19,183,"Iowa","Washington County",4,43,248,130,118
050,19,183,"Iowa","Washington County",4,44,240,114,126
050,19,183,"Iowa","Washington County",4,45,266,129,137
050,19,183,"Iowa","Washington County",4,46,236,122,114
050,19,183,"Iowa","Washington County",4,47,228,118,110
050,19,183,"Iowa","Washington County",4,48,228,118,110
050,19,183,"Iowa","Washington County",4,49,221,114,107
050,19,183,"Iowa","Washington County",4,50,247,119,128
050,19,183,"Iowa","Washington County",4,51,274,135,139
050,19,183,"Iowa","Washington County",4,52,264,125,139
050,19,183,"Iowa","Washington County",4,53,246,121,125
050,19,183,"Iowa","Washington County",4,54,245,121,124
050,19,183,"Iowa","Washington County",4,55,278,146,132
050,19,183,"Iowa","Washington County",4,56,288,156,132
050,19,183,"Iowa","Washington County",4,57,310,161,149
050,19,183,"Iowa","Washington County",4,58,295,145,150
050,19,183,"Iowa","Washington County",4,59,306,151,155
050,19,183,"Iowa","Washington County",4,60,311,158,153
050,19,183,"Iowa","Washington County",4,61,325,163,162
050,19,183,"Iowa","Washington County",4,62,305,154,151
050,19,183,"Iowa","Washington County",4,63,307,159,148
050,19,183,"Iowa","Washington County",4,64,302,150,152
050,19,183,"Iowa","Washington County",4,65,308,154,154
050,19,183,"Iowa","Washington County",4,66,276,142,134
050,19,183,"Iowa","Washington County",4,67,271,137,134
050,19,183,"Iowa","Washington County",4,68,284,147,137
050,19,183,"Iowa","Washington County",4,69,279,139,140
050,19,183,"Iowa","Washington County",4,70,242,114,128
050,19,183,"Iowa","Washington County",4,71,247,104,143
050,19,183,"Iowa","Washington County",4,72,228,109,119
050,19,183,"Iowa","Washington County",4,73,219,116,103
050,19,183,"Iowa","Washington County",4,74,211,103,108
050,19,183,"Iowa","Washington County",4,75,230,118,112
050,19,183,"Iowa","Washington County",4,76,151,67,84
050,19,183,"Iowa","Washington County",4,77,158,68,90
050,19,183,"Iowa","Washington County",4,78,160,69,91
050,19,183,"Iowa","Washington County",4,79,163,82,81
050,19,183,"Iowa","Washington County",4,80,136,63,73
050,19,183,"Iowa","Washington County",4,81,113,48,65
050,19,183,"Iowa","Washington County",4,82,108,53,55
050,19,183,"Iowa","Washington County",4,83,99,47,52
050,19,183,"Iowa","Washington County",4,84,90,44,46
050,19,183,"Iowa","Washington County",4,85,605,169,436
050,19,183,"Iowa","Washington County",5,0,277,150,127
050,19,183,"Iowa","Washington County",5,1,282,150,132
050,19,183,"Iowa","Washington County",5,2,308,158,150
050,19,183,"Iowa","Washington County",5,3,317,150,167
050,19,183,"Iowa","Washington County",5,4,303,150,153
050,19,183,"Iowa","Washington County",5,5,294,150,144
050,19,183,"Iowa","Washington County",5,6,298,144,154
050,19,183,"Iowa","Washington County",5,7,317,160,157
050,19,183,"Iowa","Washington County",5,8,308,158,150
050,19,183,"Iowa","Washington County",5,9,325,171,154
050,19,183,"Iowa","Washington County",5,10,322,159,163
050,19,183,"Iowa","Washington County",5,11,324,162,162
050,19,183,"Iowa","Washington County",5,12,302,156,146
050,19,183,"Iowa","Washington County",5,13,293,168,125
050,19,183,"Iowa","Washington County",5,14,326,170,156
050,19,183,"Iowa","Washington County",5,15,324,161,163
050,19,183,"Iowa","Washington County",5,16,339,168,171
050,19,183,"Iowa","Washington County",5,17,317,164,153
050,19,183,"Iowa","Washington County",5,18,253,140,113
050,19,183,"Iowa","Washington County",5,19,202,113,89
050,19,183,"Iowa","Washington County",5,20,220,116,104
050,19,183,"Iowa","Washington County",5,21,232,123,109
050,19,183,"Iowa","Washington County",5,22,252,132,120
050,19,183,"Iowa","Washington County",5,23,249,136,113
050,19,183,"Iowa","Washington County",5,24,244,133,111
050,19,183,"Iowa","Washington County",5,25,241,107,134
050,19,183,"Iowa","Washington County",5,26,235,107,128
050,19,183,"Iowa","Washington County",5,27,244,117,127
050,19,183,"Iowa","Washington County",5,28,238,118,120
050,19,183,"Iowa","Washington County",5,29,258,129,129
050,19,183,"Iowa","Washington County",5,30,300,157,143
050,19,183,"Iowa","Washington County",5,31,316,155,161
050,19,183,"Iowa","Washington County",5,32,285,161,124
050,19,183,"Iowa","Washington County",5,33,282,143,139
050,19,183,"Iowa","Washington County",5,34,259,125,134
050,19,183,"Iowa","Washington County",5,35,246,138,108
050,19,183,"Iowa","Washington County",5,36,273,146,127
050,19,183,"Iowa","Washington County",5,37,275,145,130
050,19,183,"Iowa","Washington County",5,38,277,142,135
050,19,183,"Iowa","Washington County",5,39,253,126,127
050,19,183,"Iowa","Washington County",5,40,248,134,114
050,19,183,"Iowa","Washington County",5,41,288,148,140
050,19,183,"Iowa","Washington County",5,42,292,141,151
050,19,183,"Iowa","Washington County",5,43,264,145,119
050,19,183,"Iowa","Washington County",5,44,243,129,114
050,19,183,"Iowa","Washington County",5,45,242,116,126
050,19,183,"Iowa","Washington County",5,46,263,128,135
050,19,183,"Iowa","Washington County",5,47,229,115,114
050,19,183,"Iowa","Washington County",5,48,228,114,114
050,19,183,"Iowa","Washington County",5,49,240,126,114
050,19,183,"Iowa","Washington County",5,50,220,110,110
050,19,183,"Iowa","Washington County",5,51,239,114,125
050,19,183,"Iowa","Washington County",5,52,272,133,139
050,19,183,"Iowa","Washington County",5,53,261,122,139
050,19,183,"Iowa","Washington County",5,54,245,121,124
050,19,183,"Iowa","Washington County",5,55,250,125,125
050,19,183,"Iowa","Washington County",5,56,278,141,137
050,19,183,"Iowa","Washington County",5,57,294,164,130
050,19,183,"Iowa","Washington County",5,58,294,147,147
050,19,183,"Iowa","Washington County",5,59,299,148,151
050,19,183,"Iowa","Washington County",5,60,299,149,150
050,19,183,"Iowa","Washington County",5,61,300,152,148
050,19,183,"Iowa","Washington County",5,62,317,158,159
050,19,183,"Iowa","Washington County",5,63,300,148,152
050,19,183,"Iowa","Washington County",5,64,301,157,144
050,19,183,"Iowa","Washington County",5,65,295,144,151
050,19,183,"Iowa","Washington County",5,66,300,152,148
050,19,183,"Iowa","Washington County",5,67,265,133,132
050,19,183,"Iowa","Washington County",5,68,261,132,129
050,19,183,"Iowa","Washington County",5,69,278,148,130
050,19,183,"Iowa","Washington County",5,70,267,131,136
050,19,183,"Iowa","Washington County",5,71,248,117,131
050,19,183,"Iowa","Washington County",5,72,239,97,142
050,19,183,"Iowa","Washington County",5,73,216,105,111
050,19,183,"Iowa","Washington County",5,74,223,117,106
050,19,183,"Iowa","Washington County",5,75,205,102,103
050,19,183,"Iowa","Washington County",5,76,212,110,102
050,19,183,"Iowa","Washington County",5,77,148,66,82
050,19,183,"Iowa","Washington County",5,78,150,66,84
050,19,183,"Iowa","Washington County",5,79,155,67,88
050,19,183,"Iowa","Washington County",5,80,150,76,74
050,19,183,"Iowa","Washington County",5,81,130,56,74
050,19,183,"Iowa","Washington County",5,82,115,50,65
050,19,183,"Iowa","Washington County",5,83,102,47,55
050,19,183,"Iowa","Washington County",5,84,85,41,44
050,19,183,"Iowa","Washington County",5,85,600,169,431
050,19,185,"Iowa","Wayne County",1,0,89,47,42
050,19,185,"Iowa","Wayne County",1,1,96,53,43
050,19,185,"Iowa","Wayne County",1,2,89,47,42
050,19,185,"Iowa","Wayne County",1,3,92,48,44
050,19,185,"Iowa","Wayne County",1,4,86,42,44
050,19,185,"Iowa","Wayne County",1,5,86,36,50
050,19,185,"Iowa","Wayne County",1,6,95,44,51
050,19,185,"Iowa","Wayne County",1,7,95,43,52
050,19,185,"Iowa","Wayne County",1,8,84,46,38
050,19,185,"Iowa","Wayne County",1,9,91,47,44
050,19,185,"Iowa","Wayne County",1,10,98,53,45
050,19,185,"Iowa","Wayne County",1,11,108,54,54
050,19,185,"Iowa","Wayne County",1,12,112,54,58
050,19,185,"Iowa","Wayne County",1,13,94,43,51
050,19,185,"Iowa","Wayne County",1,14,100,54,46
050,19,185,"Iowa","Wayne County",1,15,98,53,45
050,19,185,"Iowa","Wayne County",1,16,93,52,41
050,19,185,"Iowa","Wayne County",1,17,99,50,49
050,19,185,"Iowa","Wayne County",1,18,88,45,43
050,19,185,"Iowa","Wayne County",1,19,65,34,31
050,19,185,"Iowa","Wayne County",1,20,55,26,29
050,19,185,"Iowa","Wayne County",1,21,59,31,28
050,19,185,"Iowa","Wayne County",1,22,48,26,22
050,19,185,"Iowa","Wayne County",1,23,60,29,31
050,19,185,"Iowa","Wayne County",1,24,73,33,40
050,19,185,"Iowa","Wayne County",1,25,66,35,31
050,19,185,"Iowa","Wayne County",1,26,60,29,31
050,19,185,"Iowa","Wayne County",1,27,63,30,33
050,19,185,"Iowa","Wayne County",1,28,77,42,35
050,19,185,"Iowa","Wayne County",1,29,61,27,34
050,19,185,"Iowa","Wayne County",1,30,70,33,37
050,19,185,"Iowa","Wayne County",1,31,67,33,34
050,19,185,"Iowa","Wayne County",1,32,58,26,32
050,19,185,"Iowa","Wayne County",1,33,58,29,29
050,19,185,"Iowa","Wayne County",1,34,68,33,35
050,19,185,"Iowa","Wayne County",1,35,82,30,52
050,19,185,"Iowa","Wayne County",1,36,79,40,39
050,19,185,"Iowa","Wayne County",1,37,66,35,31
050,19,185,"Iowa","Wayne County",1,38,68,37,31
050,19,185,"Iowa","Wayne County",1,39,79,44,35
050,19,185,"Iowa","Wayne County",1,40,67,35,32
050,19,185,"Iowa","Wayne County",1,41,62,33,29
050,19,185,"Iowa","Wayne County",1,42,54,29,25
050,19,185,"Iowa","Wayne County",1,43,52,27,25
050,19,185,"Iowa","Wayne County",1,44,55,26,29
050,19,185,"Iowa","Wayne County",1,45,76,38,38
050,19,185,"Iowa","Wayne County",1,46,68,37,31
050,19,185,"Iowa","Wayne County",1,47,61,35,26
050,19,185,"Iowa","Wayne County",1,48,77,41,36
050,19,185,"Iowa","Wayne County",1,49,70,35,35
050,19,185,"Iowa","Wayne County",1,50,61,30,31
050,19,185,"Iowa","Wayne County",1,51,64,35,29
050,19,185,"Iowa","Wayne County",1,52,57,28,29
050,19,185,"Iowa","Wayne County",1,53,64,34,30
050,19,185,"Iowa","Wayne County",1,54,65,38,27
050,19,185,"Iowa","Wayne County",1,55,73,37,36
050,19,185,"Iowa","Wayne County",1,56,96,47,49
050,19,185,"Iowa","Wayne County",1,57,103,57,46
050,19,185,"Iowa","Wayne County",1,58,98,52,46
050,19,185,"Iowa","Wayne County",1,59,99,51,48
050,19,185,"Iowa","Wayne County",1,60,86,43,43
050,19,185,"Iowa","Wayne County",1,61,96,55,41
050,19,185,"Iowa","Wayne County",1,62,106,59,47
050,19,185,"Iowa","Wayne County",1,63,106,64,42
050,19,185,"Iowa","Wayne County",1,64,107,55,52
050,19,185,"Iowa","Wayne County",1,65,104,53,51
050,19,185,"Iowa","Wayne County",1,66,91,46,45
050,19,185,"Iowa","Wayne County",1,67,88,42,46
050,19,185,"Iowa","Wayne County",1,68,86,44,42
050,19,185,"Iowa","Wayne County",1,69,62,30,32
050,19,185,"Iowa","Wayne County",1,70,64,30,34
050,19,185,"Iowa","Wayne County",1,71,56,27,29
050,19,185,"Iowa","Wayne County",1,72,67,40,27
050,19,185,"Iowa","Wayne County",1,73,67,38,29
050,19,185,"Iowa","Wayne County",1,74,50,28,22
050,19,185,"Iowa","Wayne County",1,75,44,24,20
050,19,185,"Iowa","Wayne County",1,76,62,22,40
050,19,185,"Iowa","Wayne County",1,77,73,29,44
050,19,185,"Iowa","Wayne County",1,78,56,23,33
050,19,185,"Iowa","Wayne County",1,79,55,23,32
050,19,185,"Iowa","Wayne County",1,80,37,15,22
050,19,185,"Iowa","Wayne County",1,81,37,13,24
050,19,185,"Iowa","Wayne County",1,82,31,13,18
050,19,185,"Iowa","Wayne County",1,83,30,14,16
050,19,185,"Iowa","Wayne County",1,84,29,12,17
050,19,185,"Iowa","Wayne County",1,85,215,68,147
050,19,185,"Iowa","Wayne County",2,0,100,53,47
050,19,185,"Iowa","Wayne County",2,1,94,52,42
050,19,185,"Iowa","Wayne County",2,2,91,49,42
050,19,185,"Iowa","Wayne County",2,3,93,49,44
050,19,185,"Iowa","Wayne County",2,4,89,44,45
050,19,185,"Iowa","Wayne County",2,5,87,38,49
050,19,185,"Iowa","Wayne County",2,6,94,42,52
050,19,185,"Iowa","Wayne County",2,7,96,44,52
050,19,185,"Iowa","Wayne County",2,8,88,46,42
050,19,185,"Iowa","Wayne County",2,9,91,48,43
050,19,185,"Iowa","Wayne County",2,10,98,52,46
050,19,185,"Iowa","Wayne County",2,11,106,54,52
050,19,185,"Iowa","Wayne County",2,12,111,54,57
050,19,185,"Iowa","Wayne County",2,13,100,46,54
050,19,185,"Iowa","Wayne County",2,14,100,52,48
050,19,185,"Iowa","Wayne County",2,15,98,53,45
050,19,185,"Iowa","Wayne County",2,16,94,53,41
050,19,185,"Iowa","Wayne County",2,17,98,51,47
050,19,185,"Iowa","Wayne County",2,18,87,45,42
050,19,185,"Iowa","Wayne County",2,19,66,34,32
050,19,185,"Iowa","Wayne County",2,20,57,28,29
050,19,185,"Iowa","Wayne County",2,21,56,29,27
050,19,185,"Iowa","Wayne County",2,22,51,27,24
050,19,185,"Iowa","Wayne County",2,23,58,29,29
050,19,185,"Iowa","Wayne County",2,24,70,32,38
050,19,185,"Iowa","Wayne County",2,25,67,34,33
050,19,185,"Iowa","Wayne County",2,26,61,30,31
050,19,185,"Iowa","Wayne County",2,27,62,30,32
050,19,185,"Iowa","Wayne County",2,28,73,38,35
050,19,185,"Iowa","Wayne County",2,29,65,31,34
050,19,185,"Iowa","Wayne County",2,30,69,32,37
050,19,185,"Iowa","Wayne County",2,31,67,32,35
050,19,185,"Iowa","Wayne County",2,32,60,28,32
050,19,185,"Iowa","Wayne County",2,33,57,29,28
050,19,185,"Iowa","Wayne County",2,34,66,32,34
050,19,185,"Iowa","Wayne County",2,35,80,31,49
050,19,185,"Iowa","Wayne County",2,36,79,37,42
050,19,185,"Iowa","Wayne County",2,37,69,36,33
050,19,185,"Iowa","Wayne County",2,38,69,37,32
050,19,185,"Iowa","Wayne County",2,39,76,43,33
050,19,185,"Iowa","Wayne County",2,40,70,37,33
050,19,185,"Iowa","Wayne County",2,41,63,33,30
050,19,185,"Iowa","Wayne County",2,42,55,30,25
050,19,185,"Iowa","Wayne County",2,43,52,27,25
050,19,185,"Iowa","Wayne County",2,44,55,26,29
050,19,185,"Iowa","Wayne County",2,45,71,35,36
050,19,185,"Iowa","Wayne County",2,46,69,37,32
050,19,185,"Iowa","Wayne County",2,47,61,34,27
050,19,185,"Iowa","Wayne County",2,48,74,40,34
050,19,185,"Iowa","Wayne County",2,49,72,36,36
050,19,185,"Iowa","Wayne County",2,50,63,32,31
050,19,185,"Iowa","Wayne County",2,51,63,33,30
050,19,185,"Iowa","Wayne County",2,52,57,29,28
050,19,185,"Iowa","Wayne County",2,53,62,32,30
050,19,185,"Iowa","Wayne County",2,54,65,37,28
050,19,185,"Iowa","Wayne County",2,55,71,37,34
050,19,185,"Iowa","Wayne County",2,56,90,45,45
050,19,185,"Iowa","Wayne County",2,57,100,54,46
050,19,185,"Iowa","Wayne County",2,58,98,53,45
050,19,185,"Iowa","Wayne County",2,59,101,53,48
050,19,185,"Iowa","Wayne County",2,60,89,45,44
050,19,185,"Iowa","Wayne County",2,61,92,50,42
050,19,185,"Iowa","Wayne County",2,62,104,58,46
050,19,185,"Iowa","Wayne County",2,63,107,64,43
050,19,185,"Iowa","Wayne County",2,64,107,57,50
050,19,185,"Iowa","Wayne County",2,65,106,55,51
050,19,185,"Iowa","Wayne County",2,66,93,47,46
050,19,185,"Iowa","Wayne County",2,67,89,43,46
050,19,185,"Iowa","Wayne County",2,68,85,43,42
050,19,185,"Iowa","Wayne County",2,69,68,33,35
050,19,185,"Iowa","Wayne County",2,70,62,29,33
050,19,185,"Iowa","Wayne County",2,71,58,28,30
050,19,185,"Iowa","Wayne County",2,72,65,37,28
050,19,185,"Iowa","Wayne County",2,73,68,39,29
050,19,185,"Iowa","Wayne County",2,74,49,27,22
050,19,185,"Iowa","Wayne County",2,75,45,24,21
050,19,185,"Iowa","Wayne County",2,76,57,22,35
050,19,185,"Iowa","Wayne County",2,77,72,29,43
050,19,185,"Iowa","Wayne County",2,78,55,22,33
050,19,185,"Iowa","Wayne County",2,79,55,23,32
050,19,185,"Iowa","Wayne County",2,80,41,17,24
050,19,185,"Iowa","Wayne County",2,81,37,14,23
050,19,185,"Iowa","Wayne County",2,82,32,13,19
050,19,185,"Iowa","Wayne County",2,83,29,13,16
050,19,185,"Iowa","Wayne County",2,84,30,12,18
050,19,185,"Iowa","Wayne County",2,85,212,69,143
050,19,185,"Iowa","Wayne County",3,0,88,50,38
050,19,185,"Iowa","Wayne County",3,1,106,55,51
050,19,185,"Iowa","Wayne County",3,2,88,48,40
050,19,185,"Iowa","Wayne County",3,3,89,47,42
050,19,185,"Iowa","Wayne County",3,4,102,51,51
050,19,185,"Iowa","Wayne County",3,5,91,42,49
050,19,185,"Iowa","Wayne County",3,6,91,40,51
050,19,185,"Iowa","Wayne County",3,7,90,43,47
050,19,185,"Iowa","Wayne County",3,8,102,47,55
050,19,185,"Iowa","Wayne County",3,9,88,45,43
050,19,185,"Iowa","Wayne County",3,10,95,52,43
050,19,185,"Iowa","Wayne County",3,11,96,52,44
050,19,185,"Iowa","Wayne County",3,12,107,57,50
050,19,185,"Iowa","Wayne County",3,13,112,54,58
050,19,185,"Iowa","Wayne County",3,14,100,43,57
050,19,185,"Iowa","Wayne County",3,15,100,54,46
050,19,185,"Iowa","Wayne County",3,16,94,53,41
050,19,185,"Iowa","Wayne County",3,17,97,54,43
050,19,185,"Iowa","Wayne County",3,18,88,48,40
050,19,185,"Iowa","Wayne County",3,19,64,34,30
050,19,185,"Iowa","Wayne County",3,20,74,36,38
050,19,185,"Iowa","Wayne County",3,21,56,28,28
050,19,185,"Iowa","Wayne County",3,22,62,35,27
050,19,185,"Iowa","Wayne County",3,23,55,29,26
050,19,185,"Iowa","Wayne County",3,24,60,28,32
050,19,185,"Iowa","Wayne County",3,25,67,29,38
050,19,185,"Iowa","Wayne County",3,26,69,38,31
050,19,185,"Iowa","Wayne County",3,27,61,29,32
050,19,185,"Iowa","Wayne County",3,28,66,33,33
050,19,185,"Iowa","Wayne County",3,29,76,41,35
050,19,185,"Iowa","Wayne County",3,30,64,29,35
050,19,185,"Iowa","Wayne County",3,31,70,32,38
050,19,185,"Iowa","Wayne County",3,32,70,35,35
050,19,185,"Iowa","Wayne County",3,33,64,26,38
050,19,185,"Iowa","Wayne County",3,34,60,33,27
050,19,185,"Iowa","Wayne County",3,35,65,30,35
050,19,185,"Iowa","Wayne County",3,36,80,35,45
050,19,185,"Iowa","Wayne County",3,37,78,35,43
050,19,185,"Iowa","Wayne County",3,38,69,36,33
050,19,185,"Iowa","Wayne County",3,39,69,38,31
050,19,185,"Iowa","Wayne County",3,40,73,43,30
050,19,185,"Iowa","Wayne County",3,41,70,38,32
050,19,185,"Iowa","Wayne County",3,42,64,34,30
050,19,185,"Iowa","Wayne County",3,43,54,27,27
050,19,185,"Iowa","Wayne County",3,44,48,27,21
050,19,185,"Iowa","Wayne County",3,45,53,25,28
050,19,185,"Iowa","Wayne County",3,46,65,30,35
050,19,185,"Iowa","Wayne County",3,47,68,37,31
050,19,185,"Iowa","Wayne County",3,48,66,36,30
050,19,185,"Iowa","Wayne County",3,49,68,36,32
050,19,185,"Iowa","Wayne County",3,50,76,40,36
050,19,185,"Iowa","Wayne County",3,51,60,31,29
050,19,185,"Iowa","Wayne County",3,52,62,31,31
050,19,185,"Iowa","Wayne County",3,53,57,29,28
050,19,185,"Iowa","Wayne County",3,54,63,32,31
050,19,185,"Iowa","Wayne County",3,55,65,36,29
050,19,185,"Iowa","Wayne County",3,56,75,41,34
050,19,185,"Iowa","Wayne County",3,57,94,48,46
050,19,185,"Iowa","Wayne County",3,58,105,56,49
050,19,185,"Iowa","Wayne County",3,59,101,57,44
050,19,185,"Iowa","Wayne County",3,60,96,49,47
050,19,185,"Iowa","Wayne County",3,61,88,45,43
050,19,185,"Iowa","Wayne County",3,62,96,50,46
050,19,185,"Iowa","Wayne County",3,63,104,58,46
050,19,185,"Iowa","Wayne County",3,64,100,59,41
050,19,185,"Iowa","Wayne County",3,65,111,60,51
050,19,185,"Iowa","Wayne County",3,66,100,53,47
050,19,185,"Iowa","Wayne County",3,67,94,47,47
050,19,185,"Iowa","Wayne County",3,68,88,43,45
050,19,185,"Iowa","Wayne County",3,69,79,41,38
050,19,185,"Iowa","Wayne County",3,70,69,33,36
050,19,185,"Iowa","Wayne County",3,71,60,29,31
050,19,185,"Iowa","Wayne County",3,72,61,30,31
050,19,185,"Iowa","Wayne County",3,73,65,35,30
050,19,185,"Iowa","Wayne County",3,74,66,38,28
050,19,185,"Iowa","Wayne County",3,75,48,27,21
050,19,185,"Iowa","Wayne County",3,76,43,22,21
050,19,185,"Iowa","Wayne County",3,77,58,23,35
050,19,185,"Iowa","Wayne County",3,78,64,27,37
050,19,185,"Iowa","Wayne County",3,79,50,18,32
050,19,185,"Iowa","Wayne County",3,80,54,23,31
050,19,185,"Iowa","Wayne County",3,81,37,17,20
050,19,185,"Iowa","Wayne County",3,82,30,12,18
050,19,185,"Iowa","Wayne County",3,83,29,11,18
050,19,185,"Iowa","Wayne County",3,84,27,10,17
050,19,185,"Iowa","Wayne County",3,85,204,68,136
050,19,185,"Iowa","Wayne County",4,0,86,51,35
050,19,185,"Iowa","Wayne County",4,1,94,50,44
050,19,185,"Iowa","Wayne County",4,2,106,57,49
050,19,185,"Iowa","Wayne County",4,3,87,48,39
050,19,185,"Iowa","Wayne County",4,4,94,52,42
050,19,185,"Iowa","Wayne County",4,5,97,52,45
050,19,185,"Iowa","Wayne County",4,6,87,41,46
050,19,185,"Iowa","Wayne County",4,7,92,39,53
050,19,185,"Iowa","Wayne County",4,8,89,39,50
050,19,185,"Iowa","Wayne County",4,9,100,45,55
050,19,185,"Iowa","Wayne County",4,10,84,43,41
050,19,185,"Iowa","Wayne County",4,11,92,49,43
050,19,185,"Iowa","Wayne County",4,12,91,50,41
050,19,185,"Iowa","Wayne County",4,13,103,53,50
050,19,185,"Iowa","Wayne County",4,14,114,57,57
050,19,185,"Iowa","Wayne County",4,15,101,45,56
050,19,185,"Iowa","Wayne County",4,16,95,48,47
050,19,185,"Iowa","Wayne County",4,17,97,54,43
050,19,185,"Iowa","Wayne County",4,18,77,44,33
050,19,185,"Iowa","Wayne County",4,19,64,37,27
050,19,185,"Iowa","Wayne County",4,20,62,33,29
050,19,185,"Iowa","Wayne County",4,21,68,33,35
050,19,185,"Iowa","Wayne County",4,22,57,29,28
050,19,185,"Iowa","Wayne County",4,23,60,35,25
050,19,185,"Iowa","Wayne County",4,24,56,31,25
050,19,185,"Iowa","Wayne County",4,25,56,26,30
050,19,185,"Iowa","Wayne County",4,26,73,31,42
050,19,185,"Iowa","Wayne County",4,27,69,38,31
050,19,185,"Iowa","Wayne County",4,28,61,31,30
050,19,185,"Iowa","Wayne County",4,29,75,38,37
050,19,185,"Iowa","Wayne County",4,30,76,37,39
050,19,185,"Iowa","Wayne County",4,31,68,32,36
050,19,185,"Iowa","Wayne County",4,32,69,32,37
050,19,185,"Iowa","Wayne County",4,33,68,34,34
050,19,185,"Iowa","Wayne County",4,34,64,27,37
050,19,185,"Iowa","Wayne County",4,35,56,31,25
050,19,185,"Iowa","Wayne County",4,36,69,34,35
050,19,185,"Iowa","Wayne County",4,37,77,34,43
050,19,185,"Iowa","Wayne County",4,38,73,32,41
050,19,185,"Iowa","Wayne County",4,39,71,40,31
050,19,185,"Iowa","Wayne County",4,40,64,36,28
050,19,185,"Iowa","Wayne County",4,41,73,42,31
050,19,185,"Iowa","Wayne County",4,42,69,36,33
050,19,185,"Iowa","Wayne County",4,43,63,34,29
050,19,185,"Iowa","Wayne County",4,44,54,27,27
050,19,185,"Iowa","Wayne County",4,45,52,28,24
050,19,185,"Iowa","Wayne County",4,46,52,25,27
050,19,185,"Iowa","Wayne County",4,47,63,30,33
050,19,185,"Iowa","Wayne County",4,48,70,38,32
050,19,185,"Iowa","Wayne County",4,49,69,36,33
050,19,185,"Iowa","Wayne County",4,50,67,35,32
050,19,185,"Iowa","Wayne County",4,51,79,40,39
050,19,185,"Iowa","Wayne County",4,52,60,31,29
050,19,185,"Iowa","Wayne County",4,53,64,32,32
050,19,185,"Iowa","Wayne County",4,54,52,28,24
050,19,185,"Iowa","Wayne County",4,55,59,28,31
050,19,185,"Iowa","Wayne County",4,56,65,36,29
050,19,185,"Iowa","Wayne County",4,57,74,40,34
050,19,185,"Iowa","Wayne County",4,58,94,48,46
050,19,185,"Iowa","Wayne County",4,59,108,59,49
050,19,185,"Iowa","Wayne County",4,60,98,52,46
050,19,185,"Iowa","Wayne County",4,61,94,48,46
050,19,185,"Iowa","Wayne County",4,62,87,46,41
050,19,185,"Iowa","Wayne County",4,63,93,49,44
050,19,185,"Iowa","Wayne County",4,64,111,61,50
050,19,185,"Iowa","Wayne County",4,65,103,59,44
050,19,185,"Iowa","Wayne County",4,66,105,59,46
050,19,185,"Iowa","Wayne County",4,67,96,50,46
050,19,185,"Iowa","Wayne County",4,68,93,46,47
050,19,185,"Iowa","Wayne County",4,69,85,40,45
050,19,185,"Iowa","Wayne County",4,70,78,40,38
050,19,185,"Iowa","Wayne County",4,71,68,32,36
050,19,185,"Iowa","Wayne County",4,72,61,29,32
050,19,185,"Iowa","Wayne County",4,73,64,32,32
050,19,185,"Iowa","Wayne County",4,74,61,32,29
050,19,185,"Iowa","Wayne County",4,75,68,39,29
050,19,185,"Iowa","Wayne County",4,76,46,26,20
050,19,185,"Iowa","Wayne County",4,77,44,23,21
050,19,185,"Iowa","Wayne County",4,78,54,19,35
050,19,185,"Iowa","Wayne County",4,79,62,24,38
050,19,185,"Iowa","Wayne County",4,80,48,18,30
050,19,185,"Iowa","Wayne County",4,81,53,24,29
050,19,185,"Iowa","Wayne County",4,82,33,15,18
050,19,185,"Iowa","Wayne County",4,83,29,12,17
050,19,185,"Iowa","Wayne County",4,84,28,10,18
050,19,185,"Iowa","Wayne County",4,85,199,68,131
050,19,185,"Iowa","Wayne County",5,0,87,52,35
050,19,185,"Iowa","Wayne County",5,1,90,53,37
050,19,185,"Iowa","Wayne County",5,2,94,51,43
050,19,185,"Iowa","Wayne County",5,3,103,55,48
050,19,185,"Iowa","Wayne County",5,4,88,47,41
050,19,185,"Iowa","Wayne County",5,5,91,51,40
050,19,185,"Iowa","Wayne County",5,6,98,53,45
050,19,185,"Iowa","Wayne County",5,7,81,38,43
050,19,185,"Iowa","Wayne County",5,8,96,40,56
050,19,185,"Iowa","Wayne County",5,9,94,45,49
050,19,185,"Iowa","Wayne County",5,10,98,46,52
050,19,185,"Iowa","Wayne County",5,11,84,43,41
050,19,185,"Iowa","Wayne County",5,12,95,51,44
050,19,185,"Iowa","Wayne County",5,13,94,53,41
050,19,185,"Iowa","Wayne County",5,14,105,54,51
050,19,185,"Iowa","Wayne County",5,15,106,53,53
050,19,185,"Iowa","Wayne County",5,16,102,49,53
050,19,185,"Iowa","Wayne County",5,17,101,54,47
050,19,185,"Iowa","Wayne County",5,18,77,42,35
050,19,185,"Iowa","Wayne County",5,19,59,35,24
050,19,185,"Iowa","Wayne County",5,20,69,38,31
050,19,185,"Iowa","Wayne County",5,21,68,35,33
050,19,185,"Iowa","Wayne County",5,22,73,37,36
050,19,185,"Iowa","Wayne County",5,23,57,30,27
050,19,185,"Iowa","Wayne County",5,24,61,33,28
050,19,185,"Iowa","Wayne County",5,25,58,30,28
050,19,185,"Iowa","Wayne County",5,26,67,35,32
050,19,185,"Iowa","Wayne County",5,27,72,31,41
050,19,185,"Iowa","Wayne County",5,28,69,43,26
050,19,185,"Iowa","Wayne County",5,29,70,34,36
050,19,185,"Iowa","Wayne County",5,30,77,40,37
050,19,185,"Iowa","Wayne County",5,31,78,37,41
050,19,185,"Iowa","Wayne County",5,32,69,33,36
050,19,185,"Iowa","Wayne County",5,33,68,33,35
050,19,185,"Iowa","Wayne County",5,34,71,35,36
050,19,185,"Iowa","Wayne County",5,35,64,26,38
050,19,185,"Iowa","Wayne County",5,36,57,31,26
050,19,185,"Iowa","Wayne County",5,37,70,35,35
050,19,185,"Iowa","Wayne County",5,38,77,35,42
050,19,185,"Iowa","Wayne County",5,39,77,37,40
050,19,185,"Iowa","Wayne County",5,40,71,39,32
050,19,185,"Iowa","Wayne County",5,41,69,40,29
050,19,185,"Iowa","Wayne County",5,42,80,44,36
050,19,185,"Iowa","Wayne County",5,43,72,38,34
050,19,185,"Iowa","Wayne County",5,44,61,33,28
050,19,185,"Iowa","Wayne County",5,45,55,28,27
050,19,185,"Iowa","Wayne County",5,46,52,29,23
050,19,185,"Iowa","Wayne County",5,47,54,28,26
050,19,185,"Iowa","Wayne County",5,48,65,34,31
050,19,185,"Iowa","Wayne County",5,49,70,37,33
050,19,185,"Iowa","Wayne County",5,50,69,35,34
050,19,185,"Iowa","Wayne County",5,51,72,37,35
050,19,185,"Iowa","Wayne County",5,52,79,40,39
050,19,185,"Iowa","Wayne County",5,53,56,29,27
050,19,185,"Iowa","Wayne County",5,54,60,29,31
050,19,185,"Iowa","Wayne County",5,55,53,27,26
050,19,185,"Iowa","Wayne County",5,56,60,27,33
050,19,185,"Iowa","Wayne County",5,57,65,39,26
050,19,185,"Iowa","Wayne County",5,58,72,38,34
050,19,185,"Iowa","Wayne County",5,59,102,55,47
050,19,185,"Iowa","Wayne County",5,60,106,55,51
050,19,185,"Iowa","Wayne County",5,61,98,52,46
050,19,185,"Iowa","Wayne County",5,62,95,51,44
050,19,185,"Iowa","Wayne County",5,63,86,45,41
050,19,185,"Iowa","Wayne County",5,64,93,52,41
050,19,185,"Iowa","Wayne County",5,65,111,60,51
050,19,185,"Iowa","Wayne County",5,66,97,57,40
050,19,185,"Iowa","Wayne County",5,67,106,59,47
050,19,185,"Iowa","Wayne County",5,68,90,49,41
050,19,185,"Iowa","Wayne County",5,69,92,47,45
050,19,185,"Iowa","Wayne County",5,70,84,39,45
050,19,185,"Iowa","Wayne County",5,71,73,38,35
050,19,185,"Iowa","Wayne County",5,72,69,32,37
050,19,185,"Iowa","Wayne County",5,73,60,30,30
050,19,185,"Iowa","Wayne County",5,74,63,32,31
050,19,185,"Iowa","Wayne County",5,75,61,33,28
050,19,185,"Iowa","Wayne County",5,76,64,35,29
050,19,185,"Iowa","Wayne County",5,77,47,27,20
050,19,185,"Iowa","Wayne County",5,78,36,18,18
050,19,185,"Iowa","Wayne County",5,79,49,17,32
050,19,185,"Iowa","Wayne County",5,80,58,22,36
050,19,185,"Iowa","Wayne County",5,81,48,19,29
050,19,185,"Iowa","Wayne County",5,82,49,22,27
050,19,185,"Iowa","Wayne County",5,83,31,13,18
050,19,185,"Iowa","Wayne County",5,84,29,11,18
050,19,185,"Iowa","Wayne County",5,85,210,73,137
050,19,187,"Iowa","Webster County",1,0,431,221,210
050,19,187,"Iowa","Webster County",1,1,439,235,204
050,19,187,"Iowa","Webster County",1,2,436,224,212
050,19,187,"Iowa","Webster County",1,3,430,211,219
050,19,187,"Iowa","Webster County",1,4,410,210,200
050,19,187,"Iowa","Webster County",1,5,446,208,238
050,19,187,"Iowa","Webster County",1,6,438,222,216
050,19,187,"Iowa","Webster County",1,7,418,217,201
050,19,187,"Iowa","Webster County",1,8,435,217,218
050,19,187,"Iowa","Webster County",1,9,439,240,199
050,19,187,"Iowa","Webster County",1,10,425,219,206
050,19,187,"Iowa","Webster County",1,11,458,232,226
050,19,187,"Iowa","Webster County",1,12,457,236,221
050,19,187,"Iowa","Webster County",1,13,455,229,226
050,19,187,"Iowa","Webster County",1,14,455,231,224
050,19,187,"Iowa","Webster County",1,15,447,253,194
050,19,187,"Iowa","Webster County",1,16,487,268,219
050,19,187,"Iowa","Webster County",1,17,496,273,223
050,19,187,"Iowa","Webster County",1,18,556,319,237
050,19,187,"Iowa","Webster County",1,19,772,482,290
050,19,187,"Iowa","Webster County",1,20,740,467,273
050,19,187,"Iowa","Webster County",1,21,559,344,215
050,19,187,"Iowa","Webster County",1,22,535,313,222
050,19,187,"Iowa","Webster County",1,23,515,301,214
050,19,187,"Iowa","Webster County",1,24,489,288,201
050,19,187,"Iowa","Webster County",1,25,499,297,202
050,19,187,"Iowa","Webster County",1,26,487,295,192
050,19,187,"Iowa","Webster County",1,27,498,294,204
050,19,187,"Iowa","Webster County",1,28,483,280,203
050,19,187,"Iowa","Webster County",1,29,473,266,207
050,19,187,"Iowa","Webster County",1,30,442,232,210
050,19,187,"Iowa","Webster County",1,31,425,236,189
050,19,187,"Iowa","Webster County",1,32,411,229,182
050,19,187,"Iowa","Webster County",1,33,395,209,186
050,19,187,"Iowa","Webster County",1,34,394,193,201
050,19,187,"Iowa","Webster County",1,35,378,189,189
050,19,187,"Iowa","Webster County",1,36,417,219,198
050,19,187,"Iowa","Webster County",1,37,421,229,192
050,19,187,"Iowa","Webster County",1,38,453,232,221
050,19,187,"Iowa","Webster County",1,39,454,239,215
050,19,187,"Iowa","Webster County",1,40,445,216,229
050,19,187,"Iowa","Webster County",1,41,420,204,216
050,19,187,"Iowa","Webster County",1,42,424,243,181
050,19,187,"Iowa","Webster County",1,43,394,216,178
050,19,187,"Iowa","Webster County",1,44,352,193,159
050,19,187,"Iowa","Webster County",1,45,353,182,171
050,19,187,"Iowa","Webster County",1,46,337,177,160
050,19,187,"Iowa","Webster County",1,47,358,190,168
050,19,187,"Iowa","Webster County",1,48,379,194,185
050,19,187,"Iowa","Webster County",1,49,398,193,205
050,19,187,"Iowa","Webster County",1,50,404,204,200
050,19,187,"Iowa","Webster County",1,51,419,218,201
050,19,187,"Iowa","Webster County",1,52,402,219,183
050,19,187,"Iowa","Webster County",1,53,434,235,199
050,19,187,"Iowa","Webster County",1,54,428,234,194
050,19,187,"Iowa","Webster County",1,55,454,222,232
050,19,187,"Iowa","Webster County",1,56,443,206,237
050,19,187,"Iowa","Webster County",1,57,485,231,254
050,19,187,"Iowa","Webster County",1,58,561,280,281
050,19,187,"Iowa","Webster County",1,59,563,283,280
050,19,187,"Iowa","Webster County",1,60,543,273,270
050,19,187,"Iowa","Webster County",1,61,562,285,277
050,19,187,"Iowa","Webster County",1,62,549,273,276
050,19,187,"Iowa","Webster County",1,63,539,270,269
050,19,187,"Iowa","Webster County",1,64,507,259,248
050,19,187,"Iowa","Webster County",1,65,505,261,244
050,19,187,"Iowa","Webster County",1,66,458,230,228
050,19,187,"Iowa","Webster County",1,67,437,217,220
050,19,187,"Iowa","Webster County",1,68,420,195,225
050,19,187,"Iowa","Webster County",1,69,420,212,208
050,19,187,"Iowa","Webster County",1,70,396,198,198
050,19,187,"Iowa","Webster County",1,71,353,170,183
050,19,187,"Iowa","Webster County",1,72,360,156,204
050,19,187,"Iowa","Webster County",1,73,366,168,198
050,19,187,"Iowa","Webster County",1,74,248,119,129
050,19,187,"Iowa","Webster County",1,75,239,115,124
050,19,187,"Iowa","Webster County",1,76,274,122,152
050,19,187,"Iowa","Webster County",1,77,255,115,140
050,19,187,"Iowa","Webster County",1,78,201,97,104
050,19,187,"Iowa","Webster County",1,79,193,90,103
050,19,187,"Iowa","Webster County",1,80,206,98,108
050,19,187,"Iowa","Webster County",1,81,197,80,117
050,19,187,"Iowa","Webster County",1,82,176,73,103
050,19,187,"Iowa","Webster County",1,83,166,65,101
050,19,187,"Iowa","Webster County",1,84,149,54,95
050,19,187,"Iowa","Webster County",1,85,1032,351,681
050,19,187,"Iowa","Webster County",2,0,449,235,214
050,19,187,"Iowa","Webster County",2,1,433,230,203
050,19,187,"Iowa","Webster County",2,2,435,225,210
050,19,187,"Iowa","Webster County",2,3,426,212,214
050,19,187,"Iowa","Webster County",2,4,417,208,209
050,19,187,"Iowa","Webster County",2,5,442,210,232
050,19,187,"Iowa","Webster County",2,6,444,222,222
050,19,187,"Iowa","Webster County",2,7,421,217,204
050,19,187,"Iowa","Webster County",2,8,429,217,212
050,19,187,"Iowa","Webster County",2,9,436,234,202
050,19,187,"Iowa","Webster County",2,10,429,225,204
050,19,187,"Iowa","Webster County",2,11,448,228,220
050,19,187,"Iowa","Webster County",2,12,461,238,223
050,19,187,"Iowa","Webster County",2,13,459,232,227
050,19,187,"Iowa","Webster County",2,14,455,230,225
050,19,187,"Iowa","Webster County",2,15,448,246,202
050,19,187,"Iowa","Webster County",2,16,483,267,216
050,19,187,"Iowa","Webster County",2,17,494,273,221
050,19,187,"Iowa","Webster County",2,18,552,323,229
050,19,187,"Iowa","Webster County",2,19,773,481,292
050,19,187,"Iowa","Webster County",2,20,738,466,272
050,19,187,"Iowa","Webster County",2,21,558,344,214
050,19,187,"Iowa","Webster County",2,22,535,318,217
050,19,187,"Iowa","Webster County",2,23,519,303,216
050,19,187,"Iowa","Webster County",2,24,489,284,205
050,19,187,"Iowa","Webster County",2,25,497,295,202
050,19,187,"Iowa","Webster County",2,26,487,291,196
050,19,187,"Iowa","Webster County",2,27,495,296,199
050,19,187,"Iowa","Webster County",2,28,490,285,205
050,19,187,"Iowa","Webster County",2,29,472,268,204
050,19,187,"Iowa","Webster County",2,30,446,236,210
050,19,187,"Iowa","Webster County",2,31,429,233,196
050,19,187,"Iowa","Webster County",2,32,414,229,185
050,19,187,"Iowa","Webster County",2,33,397,211,186
050,19,187,"Iowa","Webster County",2,34,389,192,197
050,19,187,"Iowa","Webster County",2,35,386,193,193
050,19,187,"Iowa","Webster County",2,36,404,210,194
050,19,187,"Iowa","Webster County",2,37,419,226,193
050,19,187,"Iowa","Webster County",2,38,446,232,214
050,19,187,"Iowa","Webster County",2,39,449,233,216
050,19,187,"Iowa","Webster County",2,40,452,226,226
050,19,187,"Iowa","Webster County",2,41,425,205,220
050,19,187,"Iowa","Webster County",2,42,423,235,188
050,19,187,"Iowa","Webster County",2,43,401,221,180
050,19,187,"Iowa","Webster County",2,44,359,197,162
050,19,187,"Iowa","Webster County",2,45,356,186,170
050,19,187,"Iowa","Webster County",2,46,341,178,163
050,19,187,"Iowa","Webster County",2,47,351,187,164
050,19,187,"Iowa","Webster County",2,48,374,194,180
050,19,187,"Iowa","Webster County",2,49,395,193,202
050,19,187,"Iowa","Webster County",2,50,400,198,202
050,19,187,"Iowa","Webster County",2,51,416,216,200
050,19,187,"Iowa","Webster County",2,52,404,217,187
050,19,187,"Iowa","Webster County",2,53,428,231,197
050,19,187,"Iowa","Webster County",2,54,427,233,194
050,19,187,"Iowa","Webster County",2,55,446,223,223
050,19,187,"Iowa","Webster County",2,56,447,211,236
050,19,187,"Iowa","Webster County",2,57,474,224,250
050,19,187,"Iowa","Webster County",2,58,542,267,275
050,19,187,"Iowa","Webster County",2,59,560,282,278
050,19,187,"Iowa","Webster County",2,60,546,274,272
050,19,187,"Iowa","Webster County",2,61,557,282,275
050,19,187,"Iowa","Webster County",2,62,550,276,274
050,19,187,"Iowa","Webster County",2,63,544,273,271
050,19,187,"Iowa","Webster County",2,64,509,259,250
050,19,187,"Iowa","Webster County",2,65,501,259,242
050,19,187,"Iowa","Webster County",2,66,465,234,231
050,19,187,"Iowa","Webster County",2,67,441,219,222
050,19,187,"Iowa","Webster County",2,68,419,196,223
050,19,187,"Iowa","Webster County",2,69,422,209,213
050,19,187,"Iowa","Webster County",2,70,401,202,199
050,19,187,"Iowa","Webster County",2,71,361,173,188
050,19,187,"Iowa","Webster County",2,72,348,155,193
050,19,187,"Iowa","Webster County",2,73,379,171,208
050,19,187,"Iowa","Webster County",2,74,260,124,136
050,19,187,"Iowa","Webster County",2,75,240,117,123
050,19,187,"Iowa","Webster County",2,76,264,118,146
050,19,187,"Iowa","Webster County",2,77,261,117,144
050,19,187,"Iowa","Webster County",2,78,205,99,106
050,19,187,"Iowa","Webster County",2,79,189,89,100
050,19,187,"Iowa","Webster County",2,80,199,94,105
050,19,187,"Iowa","Webster County",2,81,201,85,116
050,19,187,"Iowa","Webster County",2,82,177,73,104
050,19,187,"Iowa","Webster County",2,83,166,65,101
050,19,187,"Iowa","Webster County",2,84,146,54,92
050,19,187,"Iowa","Webster County",2,85,1031,348,683
050,19,187,"Iowa","Webster County",3,0,410,209,201
050,19,187,"Iowa","Webster County",3,1,441,236,205
050,19,187,"Iowa","Webster County",3,2,435,231,204
050,19,187,"Iowa","Webster County",3,3,442,230,212
050,19,187,"Iowa","Webster County",3,4,433,215,218
050,19,187,"Iowa","Webster County",3,5,421,212,209
050,19,187,"Iowa","Webster County",3,6,427,204,223
050,19,187,"Iowa","Webster County",3,7,432,221,211
050,19,187,"Iowa","Webster County",3,8,420,225,195
050,19,187,"Iowa","Webster County",3,9,440,223,217
050,19,187,"Iowa","Webster County",3,10,445,242,203
050,19,187,"Iowa","Webster County",3,11,426,226,200
050,19,187,"Iowa","Webster County",3,12,436,221,215
050,19,187,"Iowa","Webster County",3,13,462,243,219
050,19,187,"Iowa","Webster County",3,14,470,240,230
050,19,187,"Iowa","Webster County",3,15,455,231,224
050,19,187,"Iowa","Webster County",3,16,460,251,209
050,19,187,"Iowa","Webster County",3,17,469,260,209
050,19,187,"Iowa","Webster County",3,18,563,344,219
050,19,187,"Iowa","Webster County",3,19,787,495,292
050,19,187,"Iowa","Webster County",3,20,729,463,266
050,19,187,"Iowa","Webster County",3,21,564,351,213
050,19,187,"Iowa","Webster County",3,22,552,336,216
050,19,187,"Iowa","Webster County",3,23,521,315,206
050,19,187,"Iowa","Webster County",3,24,514,287,227
050,19,187,"Iowa","Webster County",3,25,523,310,213
050,19,187,"Iowa","Webster County",3,26,478,287,191
050,19,187,"Iowa","Webster County",3,27,501,310,191
050,19,187,"Iowa","Webster County",3,28,505,315,190
050,19,187,"Iowa","Webster County",3,29,485,281,204
050,19,187,"Iowa","Webster County",3,30,471,264,207
050,19,187,"Iowa","Webster County",3,31,455,251,204
050,19,187,"Iowa","Webster County",3,32,456,255,201
050,19,187,"Iowa","Webster County",3,33,430,236,194
050,19,187,"Iowa","Webster County",3,34,401,216,185
050,19,187,"Iowa","Webster County",3,35,394,199,195
050,19,187,"Iowa","Webster County",3,36,406,204,202
050,19,187,"Iowa","Webster County",3,37,400,214,186
050,19,187,"Iowa","Webster County",3,38,433,243,190
050,19,187,"Iowa","Webster County",3,39,450,236,214
050,19,187,"Iowa","Webster County",3,40,461,248,213
050,19,187,"Iowa","Webster County",3,41,449,225,224
050,19,187,"Iowa","Webster County",3,42,439,220,219
050,19,187,"Iowa","Webster County",3,43,420,237,183
050,19,187,"Iowa","Webster County",3,44,407,234,173
050,19,187,"Iowa","Webster County",3,45,367,203,164
050,19,187,"Iowa","Webster County",3,46,373,196,177
050,19,187,"Iowa","Webster County",3,47,344,187,157
050,19,187,"Iowa","Webster County",3,48,342,190,152
050,19,187,"Iowa","Webster County",3,49,380,201,179
050,19,187,"Iowa","Webster County",3,50,381,181,200
050,19,187,"Iowa","Webster County",3,51,413,211,202
050,19,187,"Iowa","Webster County",3,52,402,206,196
050,19,187,"Iowa","Webster County",3,53,437,243,194
050,19,187,"Iowa","Webster County",3,54,423,230,193
050,19,187,"Iowa","Webster County",3,55,437,246,191
050,19,187,"Iowa","Webster County",3,56,440,229,211
050,19,187,"Iowa","Webster County",3,57,448,212,236
050,19,187,"Iowa","Webster County",3,58,481,228,253
050,19,187,"Iowa","Webster County",3,59,541,272,269
050,19,187,"Iowa","Webster County",3,60,558,283,275
050,19,187,"Iowa","Webster County",3,61,542,274,268
050,19,187,"Iowa","Webster County",3,62,539,270,269
050,19,187,"Iowa","Webster County",3,63,548,274,274
050,19,187,"Iowa","Webster County",3,64,530,269,261
050,19,187,"Iowa","Webster County",3,65,492,253,239
050,19,187,"Iowa","Webster County",3,66,479,243,236
050,19,187,"Iowa","Webster County",3,67,454,235,219
050,19,187,"Iowa","Webster County",3,68,413,203,210
050,19,187,"Iowa","Webster County",3,69,405,190,215
050,19,187,"Iowa","Webster County",3,70,404,200,204
050,19,187,"Iowa","Webster County",3,71,389,193,196
050,19,187,"Iowa","Webster County",3,72,341,160,181
050,19,187,"Iowa","Webster County",3,73,340,149,191
050,19,187,"Iowa","Webster County",3,74,364,167,197
050,19,187,"Iowa","Webster County",3,75,251,120,131
050,19,187,"Iowa","Webster County",3,76,231,105,126
050,19,187,"Iowa","Webster County",3,77,246,112,134
050,19,187,"Iowa","Webster County",3,78,250,116,134
050,19,187,"Iowa","Webster County",3,79,194,92,102
050,19,187,"Iowa","Webster County",3,80,183,80,103
050,19,187,"Iowa","Webster County",3,81,209,93,116
050,19,187,"Iowa","Webster County",3,82,180,81,99
050,19,187,"Iowa","Webster County",3,83,154,54,100
050,19,187,"Iowa","Webster County",3,84,143,59,84
050,19,187,"Iowa","Webster County",3,85,1004,334,670
050,19,187,"Iowa","Webster County",4,0,417,215,202
050,19,187,"Iowa","Webster County",4,1,408,222,186
050,19,187,"Iowa","Webster County",4,2,432,227,205
050,19,187,"Iowa","Webster County",4,3,411,218,193
050,19,187,"Iowa","Webster County",4,4,452,232,220
050,19,187,"Iowa","Webster County",4,5,425,216,209
050,19,187,"Iowa","Webster County",4,6,409,206,203
050,19,187,"Iowa","Webster County",4,7,445,213,232
050,19,187,"Iowa","Webster County",4,8,428,219,209
050,19,187,"Iowa","Webster County",4,9,427,225,202
050,19,187,"Iowa","Webster County",4,10,440,226,214
050,19,187,"Iowa","Webster County",4,11,440,234,206
050,19,187,"Iowa","Webster County",4,12,414,221,193
050,19,187,"Iowa","Webster County",4,13,451,234,217
050,19,187,"Iowa","Webster County",4,14,458,243,215
050,19,187,"Iowa","Webster County",4,15,473,242,231
050,19,187,"Iowa","Webster County",4,16,462,228,234
050,19,187,"Iowa","Webster County",4,17,466,254,212
050,19,187,"Iowa","Webster County",4,18,547,329,218
050,19,187,"Iowa","Webster County",4,19,782,506,276
050,19,187,"Iowa","Webster County",4,20,734,463,271
050,19,187,"Iowa","Webster County",4,21,520,327,193
050,19,187,"Iowa","Webster County",4,22,524,326,198
050,19,187,"Iowa","Webster County",4,23,515,313,202
050,19,187,"Iowa","Webster County",4,24,499,286,213
050,19,187,"Iowa","Webster County",4,25,534,305,229
050,19,187,"Iowa","Webster County",4,26,520,300,220
050,19,187,"Iowa","Webster County",4,27,470,273,197
050,19,187,"Iowa","Webster County",4,28,482,287,195
050,19,187,"Iowa","Webster County",4,29,489,297,192
050,19,187,"Iowa","Webster County",4,30,461,259,202
050,19,187,"Iowa","Webster County",4,31,445,240,205
050,19,187,"Iowa","Webster County",4,32,447,243,204
050,19,187,"Iowa","Webster County",4,33,446,248,198
050,19,187,"Iowa","Webster County",4,34,405,210,195
050,19,187,"Iowa","Webster County",4,35,390,211,179
050,19,187,"Iowa","Webster County",4,36,388,190,198
050,19,187,"Iowa","Webster County",4,37,392,205,187
050,19,187,"Iowa","Webster County",4,38,391,212,179
050,19,187,"Iowa","Webster County",4,39,428,229,199
050,19,187,"Iowa","Webster County",4,40,444,238,206
050,19,187,"Iowa","Webster County",4,41,445,234,211
050,19,187,"Iowa","Webster County",4,42,453,229,224
050,19,187,"Iowa","Webster County",4,43,415,203,212
050,19,187,"Iowa","Webster County",4,44,412,236,176
050,19,187,"Iowa","Webster County",4,45,393,223,170
050,19,187,"Iowa","Webster County",4,46,356,193,163
050,19,187,"Iowa","Webster County",4,47,367,193,174
050,19,187,"Iowa","Webster County",4,48,339,181,158
050,19,187,"Iowa","Webster County",4,49,343,182,161
050,19,187,"Iowa","Webster County",4,50,359,179,180
050,19,187,"Iowa","Webster County",4,51,389,184,205
050,19,187,"Iowa","Webster County",4,52,395,198,197
050,19,187,"Iowa","Webster County",4,53,416,219,197
050,19,187,"Iowa","Webster County",4,54,410,231,179
050,19,187,"Iowa","Webster County",4,55,417,226,191
050,19,187,"Iowa","Webster County",4,56,423,236,187
050,19,187,"Iowa","Webster County",4,57,420,214,206
050,19,187,"Iowa","Webster County",4,58,434,200,234
050,19,187,"Iowa","Webster County",4,59,479,230,249
050,19,187,"Iowa","Webster County",4,60,524,261,263
050,19,187,"Iowa","Webster County",4,61,564,286,278
050,19,187,"Iowa","Webster County",4,62,524,262,262
050,19,187,"Iowa","Webster County",4,63,519,266,253
050,19,187,"Iowa","Webster County",4,64,525,261,264
050,19,187,"Iowa","Webster County",4,65,522,267,255
050,19,187,"Iowa","Webster County",4,66,470,237,233
050,19,187,"Iowa","Webster County",4,67,460,234,226
050,19,187,"Iowa","Webster County",4,68,435,220,215
050,19,187,"Iowa","Webster County",4,69,407,199,208
050,19,187,"Iowa","Webster County",4,70,384,180,204
050,19,187,"Iowa","Webster County",4,71,387,190,197
050,19,187,"Iowa","Webster County",4,72,358,177,181
050,19,187,"Iowa","Webster County",4,73,333,153,180
050,19,187,"Iowa","Webster County",4,74,334,150,184
050,19,187,"Iowa","Webster County",4,75,349,160,189
050,19,187,"Iowa","Webster County",4,76,247,111,136
050,19,187,"Iowa","Webster County",4,77,214,98,116
050,19,187,"Iowa","Webster County",4,78,241,110,131
050,19,187,"Iowa","Webster County",4,79,241,110,131
050,19,187,"Iowa","Webster County",4,80,190,86,104
050,19,187,"Iowa","Webster County",4,81,184,75,109
050,19,187,"Iowa","Webster County",4,82,186,87,99
050,19,187,"Iowa","Webster County",4,83,159,68,91
050,19,187,"Iowa","Webster County",4,84,132,48,84
050,19,187,"Iowa","Webster County",4,85,987,322,665
050,19,187,"Iowa","Webster County",5,0,411,213,198
050,19,187,"Iowa","Webster County",5,1,421,234,187
050,19,187,"Iowa","Webster County",5,2,408,224,184
050,19,187,"Iowa","Webster County",5,3,442,236,206
050,19,187,"Iowa","Webster County",5,4,419,221,198
050,19,187,"Iowa","Webster County",5,5,449,229,220
050,19,187,"Iowa","Webster County",5,6,420,216,204
050,19,187,"Iowa","Webster County",5,7,402,202,200
050,19,187,"Iowa","Webster County",5,8,443,211,232
050,19,187,"Iowa","Webster County",5,9,424,215,209
050,19,187,"Iowa","Webster County",5,10,428,224,204
050,19,187,"Iowa","Webster County",5,11,431,225,206
050,19,187,"Iowa","Webster County",5,12,443,235,208
050,19,187,"Iowa","Webster County",5,13,426,227,199
050,19,187,"Iowa","Webster County",5,14,452,235,217
050,19,187,"Iowa","Webster County",5,15,447,237,210
050,19,187,"Iowa","Webster County",5,16,480,246,234
050,19,187,"Iowa","Webster County",5,17,468,230,238
050,19,187,"Iowa","Webster County",5,18,525,317,208
050,19,187,"Iowa","Webster County",5,19,769,494,275
050,19,187,"Iowa","Webster County",5,20,736,480,256
050,19,187,"Iowa","Webster County",5,21,542,334,208
050,19,187,"Iowa","Webster County",5,22,508,323,185
050,19,187,"Iowa","Webster County",5,23,511,321,190
050,19,187,"Iowa","Webster County",5,24,467,275,192
050,19,187,"Iowa","Webster County",5,25,515,286,229
050,19,187,"Iowa","Webster County",5,26,546,301,245
050,19,187,"Iowa","Webster County",5,27,516,299,217
050,19,187,"Iowa","Webster County",5,28,442,248,194
050,19,187,"Iowa","Webster County",5,29,482,282,200
050,19,187,"Iowa","Webster County",5,30,461,274,187
050,19,187,"Iowa","Webster County",5,31,459,246,213
050,19,187,"Iowa","Webster County",5,32,451,243,208
050,19,187,"Iowa","Webster County",5,33,451,236,215
050,19,187,"Iowa","Webster County",5,34,430,238,192
050,19,187,"Iowa","Webster County",5,35,409,217,192
050,19,187,"Iowa","Webster County",5,36,386,207,179
050,19,187,"Iowa","Webster County",5,37,373,187,186
050,19,187,"Iowa","Webster County",5,38,383,204,179
050,19,187,"Iowa","Webster County",5,39,379,195,184
050,19,187,"Iowa","Webster County",5,40,433,238,195
050,19,187,"Iowa","Webster County",5,41,445,229,216
050,19,187,"Iowa","Webster County",5,42,452,242,210
050,19,187,"Iowa","Webster County",5,43,433,218,215
050,19,187,"Iowa","Webster County",5,44,419,206,213
050,19,187,"Iowa","Webster County",5,45,422,238,184
050,19,187,"Iowa","Webster County",5,46,396,229,167
050,19,187,"Iowa","Webster County",5,47,356,193,163
050,19,187,"Iowa","Webster County",5,48,365,194,171
050,19,187,"Iowa","Webster County",5,49,336,174,162
050,19,187,"Iowa","Webster County",5,50,327,161,166
050,19,187,"Iowa","Webster County",5,51,369,186,183
050,19,187,"Iowa","Webster County",5,52,371,169,202
050,19,187,"Iowa","Webster County",5,53,396,204,192
050,19,187,"Iowa","Webster County",5,54,405,216,189
050,19,187,"Iowa","Webster County",5,55,411,232,179
050,19,187,"Iowa","Webster County",5,56,406,218,188
050,19,187,"Iowa","Webster County",5,57,413,227,186
050,19,187,"Iowa","Webster County",5,58,420,210,210
050,19,187,"Iowa","Webster County",5,59,415,197,218
050,19,187,"Iowa","Webster County",5,60,466,223,243
050,19,187,"Iowa","Webster County",5,61,529,260,269
050,19,187,"Iowa","Webster County",5,62,551,277,274
050,19,187,"Iowa","Webster County",5,63,512,257,255
050,19,187,"Iowa","Webster County",5,64,504,262,242
050,19,187,"Iowa","Webster County",5,65,506,255,251
050,19,187,"Iowa","Webster County",5,66,513,260,253
050,19,187,"Iowa","Webster County",5,67,457,240,217
050,19,187,"Iowa","Webster County",5,68,437,221,216
050,19,187,"Iowa","Webster County",5,69,427,220,207
050,19,187,"Iowa","Webster County",5,70,394,195,199
050,19,187,"Iowa","Webster County",5,71,366,170,196
050,19,187,"Iowa","Webster County",5,72,371,179,192
050,19,187,"Iowa","Webster County",5,73,353,171,182
050,19,187,"Iowa","Webster County",5,74,325,153,172
050,19,187,"Iowa","Webster County",5,75,321,143,178
050,19,187,"Iowa","Webster County",5,76,344,150,194
050,19,187,"Iowa","Webster County",5,77,239,105,134
050,19,187,"Iowa","Webster County",5,78,212,101,111
050,19,187,"Iowa","Webster County",5,79,237,106,131
050,19,187,"Iowa","Webster County",5,80,235,105,130
050,19,187,"Iowa","Webster County",5,81,199,84,115
050,19,187,"Iowa","Webster County",5,82,161,69,92
050,19,187,"Iowa","Webster County",5,83,169,74,95
050,19,187,"Iowa","Webster County",5,84,134,59,75
050,19,187,"Iowa","Webster County",5,85,978,309,669
050,19,189,"Iowa","Winnebago County",1,0,98,50,48
050,19,189,"Iowa","Winnebago County",1,1,100,51,49
050,19,189,"Iowa","Winnebago County",1,2,118,60,58
050,19,189,"Iowa","Winnebago County",1,3,123,55,68
050,19,189,"Iowa","Winnebago County",1,4,114,62,52
050,19,189,"Iowa","Winnebago County",1,5,125,68,57
050,19,189,"Iowa","Winnebago County",1,6,138,65,73
050,19,189,"Iowa","Winnebago County",1,7,139,62,77
050,19,189,"Iowa","Winnebago County",1,8,130,59,71
050,19,189,"Iowa","Winnebago County",1,9,146,64,82
050,19,189,"Iowa","Winnebago County",1,10,130,67,63
050,19,189,"Iowa","Winnebago County",1,11,162,80,82
050,19,189,"Iowa","Winnebago County",1,12,140,70,70
050,19,189,"Iowa","Winnebago County",1,13,137,72,65
050,19,189,"Iowa","Winnebago County",1,14,148,74,74
050,19,189,"Iowa","Winnebago County",1,15,136,69,67
050,19,189,"Iowa","Winnebago County",1,16,148,77,71
050,19,189,"Iowa","Winnebago County",1,17,141,74,67
050,19,189,"Iowa","Winnebago County",1,18,184,91,93
050,19,189,"Iowa","Winnebago County",1,19,197,98,99
050,19,189,"Iowa","Winnebago County",1,20,192,104,88
050,19,189,"Iowa","Winnebago County",1,21,170,96,74
050,19,189,"Iowa","Winnebago County",1,22,145,80,65
050,19,189,"Iowa","Winnebago County",1,23,115,65,50
050,19,189,"Iowa","Winnebago County",1,24,94,49,45
050,19,189,"Iowa","Winnebago County",1,25,115,58,57
050,19,189,"Iowa","Winnebago County",1,26,118,60,58
050,19,189,"Iowa","Winnebago County",1,27,119,65,54
050,19,189,"Iowa","Winnebago County",1,28,99,61,38
050,19,189,"Iowa","Winnebago County",1,29,93,55,38
050,19,189,"Iowa","Winnebago County",1,30,113,62,51
050,19,189,"Iowa","Winnebago County",1,31,115,63,52
050,19,189,"Iowa","Winnebago County",1,32,116,58,58
050,19,189,"Iowa","Winnebago County",1,33,102,50,52
050,19,189,"Iowa","Winnebago County",1,34,129,68,61
050,19,189,"Iowa","Winnebago County",1,35,121,61,60
050,19,189,"Iowa","Winnebago County",1,36,118,66,52
050,19,189,"Iowa","Winnebago County",1,37,117,62,55
050,19,189,"Iowa","Winnebago County",1,38,117,58,59
050,19,189,"Iowa","Winnebago County",1,39,132,77,55
050,19,189,"Iowa","Winnebago County",1,40,110,56,54
050,19,189,"Iowa","Winnebago County",1,41,117,59,58
050,19,189,"Iowa","Winnebago County",1,42,120,57,63
050,19,189,"Iowa","Winnebago County",1,43,124,63,61
050,19,189,"Iowa","Winnebago County",1,44,99,53,46
050,19,189,"Iowa","Winnebago County",1,45,100,54,46
050,19,189,"Iowa","Winnebago County",1,46,106,56,50
050,19,189,"Iowa","Winnebago County",1,47,114,59,55
050,19,189,"Iowa","Winnebago County",1,48,129,62,67
050,19,189,"Iowa","Winnebago County",1,49,134,67,67
050,19,189,"Iowa","Winnebago County",1,50,121,56,65
050,19,189,"Iowa","Winnebago County",1,51,115,63,52
050,19,189,"Iowa","Winnebago County",1,52,97,51,46
050,19,189,"Iowa","Winnebago County",1,53,111,59,52
050,19,189,"Iowa","Winnebago County",1,54,116,58,58
050,19,189,"Iowa","Winnebago County",1,55,127,67,60
050,19,189,"Iowa","Winnebago County",1,56,149,71,78
050,19,189,"Iowa","Winnebago County",1,57,137,67,70
050,19,189,"Iowa","Winnebago County",1,58,146,78,68
050,19,189,"Iowa","Winnebago County",1,59,155,77,78
050,19,189,"Iowa","Winnebago County",1,60,162,81,81
050,19,189,"Iowa","Winnebago County",1,61,159,82,77
050,19,189,"Iowa","Winnebago County",1,62,155,80,75
050,19,189,"Iowa","Winnebago County",1,63,164,75,89
050,19,189,"Iowa","Winnebago County",1,64,154,72,82
050,19,189,"Iowa","Winnebago County",1,65,163,80,83
050,19,189,"Iowa","Winnebago County",1,66,153,78,75
050,19,189,"Iowa","Winnebago County",1,67,158,83,75
050,19,189,"Iowa","Winnebago County",1,68,151,78,73
050,19,189,"Iowa","Winnebago County",1,69,124,69,55
050,19,189,"Iowa","Winnebago County",1,70,118,60,58
050,19,189,"Iowa","Winnebago County",1,71,111,53,58
050,19,189,"Iowa","Winnebago County",1,72,112,53,59
050,19,189,"Iowa","Winnebago County",1,73,100,47,53
050,19,189,"Iowa","Winnebago County",1,74,73,38,35
050,19,189,"Iowa","Winnebago County",1,75,79,36,43
050,19,189,"Iowa","Winnebago County",1,76,84,34,50
050,19,189,"Iowa","Winnebago County",1,77,85,33,52
050,19,189,"Iowa","Winnebago County",1,78,73,34,39
050,19,189,"Iowa","Winnebago County",1,79,63,27,36
050,19,189,"Iowa","Winnebago County",1,80,64,25,39
050,19,189,"Iowa","Winnebago County",1,81,68,32,36
050,19,189,"Iowa","Winnebago County",1,82,57,25,32
050,19,189,"Iowa","Winnebago County",1,83,48,19,29
050,19,189,"Iowa","Winnebago County",1,84,47,23,24
050,19,189,"Iowa","Winnebago County",1,85,337,103,234
050,19,189,"Iowa","Winnebago County",2,0,100,56,44
050,19,189,"Iowa","Winnebago County",2,1,99,51,48
050,19,189,"Iowa","Winnebago County",2,2,114,58,56
050,19,189,"Iowa","Winnebago County",2,3,121,56,65
050,19,189,"Iowa","Winnebago County",2,4,119,62,57
050,19,189,"Iowa","Winnebago County",2,5,123,66,57
050,19,189,"Iowa","Winnebago County",2,6,136,66,70
050,19,189,"Iowa","Winnebago County",2,7,140,64,76
050,19,189,"Iowa","Winnebago County",2,8,133,60,73
050,19,189,"Iowa","Winnebago County",2,9,141,62,79
050,19,189,"Iowa","Winnebago County",2,10,134,67,67
050,19,189,"Iowa","Winnebago County",2,11,154,77,77
050,19,189,"Iowa","Winnebago County",2,12,144,72,72
050,19,189,"Iowa","Winnebago County",2,13,137,71,66
050,19,189,"Iowa","Winnebago County",2,14,148,75,73
050,19,189,"Iowa","Winnebago County",2,15,138,69,69
050,19,189,"Iowa","Winnebago County",2,16,145,76,69
050,19,189,"Iowa","Winnebago County",2,17,142,74,68
050,19,189,"Iowa","Winnebago County",2,18,182,91,91
050,19,189,"Iowa","Winnebago County",2,19,197,98,99
050,19,189,"Iowa","Winnebago County",2,20,195,102,93
050,19,189,"Iowa","Winnebago County",2,21,172,96,76
050,19,189,"Iowa","Winnebago County",2,22,140,79,61
050,19,189,"Iowa","Winnebago County",2,23,116,63,53
050,19,189,"Iowa","Winnebago County",2,24,97,52,45
050,19,189,"Iowa","Winnebago County",2,25,110,56,54
050,19,189,"Iowa","Winnebago County",2,26,118,59,59
050,19,189,"Iowa","Winnebago County",2,27,117,64,53
050,19,189,"Iowa","Winnebago County",2,28,104,63,41
050,19,189,"Iowa","Winnebago County",2,29,96,58,38
050,19,189,"Iowa","Winnebago County",2,30,107,59,48
050,19,189,"Iowa","Winnebago County",2,31,113,61,52
050,19,189,"Iowa","Winnebago County",2,32,114,57,57
050,19,189,"Iowa","Winnebago County",2,33,106,53,53
050,19,189,"Iowa","Winnebago County",2,34,123,64,59
050,19,189,"Iowa","Winnebago County",2,35,124,64,60
050,19,189,"Iowa","Winnebago County",2,36,119,65,54
050,19,189,"Iowa","Winnebago County",2,37,118,64,54
050,19,189,"Iowa","Winnebago County",2,38,119,60,59
050,19,189,"Iowa","Winnebago County",2,39,125,69,56
050,19,189,"Iowa","Winnebago County",2,40,116,61,55
050,19,189,"Iowa","Winnebago County",2,41,115,57,58
050,19,189,"Iowa","Winnebago County",2,42,119,58,61
050,19,189,"Iowa","Winnebago County",2,43,124,62,62
050,19,189,"Iowa","Winnebago County",2,44,105,55,50
050,19,189,"Iowa","Winnebago County",2,45,100,54,46
050,19,189,"Iowa","Winnebago County",2,46,105,55,50
050,19,189,"Iowa","Winnebago County",2,47,110,57,53
050,19,189,"Iowa","Winnebago County",2,48,125,62,63
050,19,189,"Iowa","Winnebago County",2,49,135,66,69
050,19,189,"Iowa","Winnebago County",2,50,126,59,67
050,19,189,"Iowa","Winnebago County",2,51,115,61,54
050,19,189,"Iowa","Winnebago County",2,52,101,54,47
050,19,189,"Iowa","Winnebago County",2,53,108,57,51
050,19,189,"Iowa","Winnebago County",2,54,115,60,55
050,19,189,"Iowa","Winnebago County",2,55,123,64,59
050,19,189,"Iowa","Winnebago County",2,56,144,70,74
050,19,189,"Iowa","Winnebago County",2,57,139,67,72
050,19,189,"Iowa","Winnebago County",2,58,143,75,68
050,19,189,"Iowa","Winnebago County",2,59,154,78,76
050,19,189,"Iowa","Winnebago County",2,60,159,80,79
050,19,189,"Iowa","Winnebago County",2,61,160,82,78
050,19,189,"Iowa","Winnebago County",2,62,154,78,76
050,19,189,"Iowa","Winnebago County",2,63,163,76,87
050,19,189,"Iowa","Winnebago County",2,64,153,71,82
050,19,189,"Iowa","Winnebago County",2,65,158,75,83
050,19,189,"Iowa","Winnebago County",2,66,155,79,76
050,19,189,"Iowa","Winnebago County",2,67,156,82,74
050,19,189,"Iowa","Winnebago County",2,68,148,77,71
050,19,189,"Iowa","Winnebago County",2,69,132,72,60
050,19,189,"Iowa","Winnebago County",2,70,118,61,57
050,19,189,"Iowa","Winnebago County",2,71,112,53,59
050,19,189,"Iowa","Winnebago County",2,72,109,52,57
050,19,189,"Iowa","Winnebago County",2,73,106,50,56
050,19,189,"Iowa","Winnebago County",2,74,75,38,37
050,19,189,"Iowa","Winnebago County",2,75,78,37,41
050,19,189,"Iowa","Winnebago County",2,76,81,33,48
050,19,189,"Iowa","Winnebago County",2,77,88,35,53
050,19,189,"Iowa","Winnebago County",2,78,73,32,41
050,19,189,"Iowa","Winnebago County",2,79,63,26,37
050,19,189,"Iowa","Winnebago County",2,80,64,26,38
050,19,189,"Iowa","Winnebago County",2,81,66,30,36
050,19,189,"Iowa","Winnebago County",2,82,60,26,34
050,19,189,"Iowa","Winnebago County",2,83,51,21,30
050,19,189,"Iowa","Winnebago County",2,84,45,20,25
050,19,189,"Iowa","Winnebago County",2,85,333,105,228
050,19,189,"Iowa","Winnebago County",3,0,100,47,53
050,19,189,"Iowa","Winnebago County",3,1,104,57,47
050,19,189,"Iowa","Winnebago County",3,2,101,55,46
050,19,189,"Iowa","Winnebago County",3,3,121,58,63
050,19,189,"Iowa","Winnebago County",3,4,126,59,67
050,19,189,"Iowa","Winnebago County",3,5,119,59,60
050,19,189,"Iowa","Winnebago County",3,6,123,65,58
050,19,189,"Iowa","Winnebago County",3,7,143,71,72
050,19,189,"Iowa","Winnebago County",3,8,140,64,76
050,19,189,"Iowa","Winnebago County",3,9,142,68,74
050,19,189,"Iowa","Winnebago County",3,10,140,63,77
050,19,189,"Iowa","Winnebago County",3,11,134,67,67
050,19,189,"Iowa","Winnebago County",3,12,154,78,76
050,19,189,"Iowa","Winnebago County",3,13,151,76,75
050,19,189,"Iowa","Winnebago County",3,14,138,74,64
050,19,189,"Iowa","Winnebago County",3,15,152,79,73
050,19,189,"Iowa","Winnebago County",3,16,142,76,66
050,19,189,"Iowa","Winnebago County",3,17,144,74,70
050,19,189,"Iowa","Winnebago County",3,18,188,102,86
050,19,189,"Iowa","Winnebago County",3,19,194,99,95
050,19,189,"Iowa","Winnebago County",3,20,192,94,98
050,19,189,"Iowa","Winnebago County",3,21,182,98,84
050,19,189,"Iowa","Winnebago County",3,22,131,80,51
050,19,189,"Iowa","Winnebago County",3,23,116,65,51
050,19,189,"Iowa","Winnebago County",3,24,106,55,51
050,19,189,"Iowa","Winnebago County",3,25,101,52,49
050,19,189,"Iowa","Winnebago County",3,26,101,53,48
050,19,189,"Iowa","Winnebago County",3,27,108,55,53
050,19,189,"Iowa","Winnebago County",3,28,117,65,52
050,19,189,"Iowa","Winnebago County",3,29,111,63,48
050,19,189,"Iowa","Winnebago County",3,30,92,54,38
050,19,189,"Iowa","Winnebago County",3,31,119,66,53
050,19,189,"Iowa","Winnebago County",3,32,112,59,53
050,19,189,"Iowa","Winnebago County",3,33,105,54,51
050,19,189,"Iowa","Winnebago County",3,34,111,57,54
050,19,189,"Iowa","Winnebago County",3,35,128,66,62
050,19,189,"Iowa","Winnebago County",3,36,115,59,56
050,19,189,"Iowa","Winnebago County",3,37,119,63,56
050,19,189,"Iowa","Winnebago County",3,38,125,67,58
050,19,189,"Iowa","Winnebago County",3,39,119,59,60
050,19,189,"Iowa","Winnebago County",3,40,128,70,58
050,19,189,"Iowa","Winnebago County",3,41,120,65,55
050,19,189,"Iowa","Winnebago County",3,42,118,59,59
050,19,189,"Iowa","Winnebago County",3,43,114,55,59
050,19,189,"Iowa","Winnebago County",3,44,127,65,62
050,19,189,"Iowa","Winnebago County",3,45,105,54,51
050,19,189,"Iowa","Winnebago County",3,46,102,54,48
050,19,189,"Iowa","Winnebago County",3,47,108,56,52
050,19,189,"Iowa","Winnebago County",3,48,111,58,53
050,19,189,"Iowa","Winnebago County",3,49,119,59,60
050,19,189,"Iowa","Winnebago County",3,50,132,64,68
050,19,189,"Iowa","Winnebago County",3,51,128,62,66
050,19,189,"Iowa","Winnebago County",3,52,117,60,57
050,19,189,"Iowa","Winnebago County",3,53,101,57,44
050,19,189,"Iowa","Winnebago County",3,54,107,54,53
050,19,189,"Iowa","Winnebago County",3,55,114,61,53
050,19,189,"Iowa","Winnebago County",3,56,127,67,60
050,19,189,"Iowa","Winnebago County",3,57,140,65,75
050,19,189,"Iowa","Winnebago County",3,58,141,69,72
050,19,189,"Iowa","Winnebago County",3,59,146,75,71
050,19,189,"Iowa","Winnebago County",3,60,151,78,73
050,19,189,"Iowa","Winnebago County",3,61,159,82,77
050,19,189,"Iowa","Winnebago County",3,62,156,82,74
050,19,189,"Iowa","Winnebago County",3,63,160,78,82
050,19,189,"Iowa","Winnebago County",3,64,160,74,86
050,19,189,"Iowa","Winnebago County",3,65,153,68,85
050,19,189,"Iowa","Winnebago County",3,66,161,77,84
050,19,189,"Iowa","Winnebago County",3,67,150,75,75
050,19,189,"Iowa","Winnebago County",3,68,153,81,72
050,19,189,"Iowa","Winnebago County",3,69,145,73,72
050,19,189,"Iowa","Winnebago County",3,70,133,71,62
050,19,189,"Iowa","Winnebago County",3,71,115,60,55
050,19,189,"Iowa","Winnebago County",3,72,109,49,60
050,19,189,"Iowa","Winnebago County",3,73,104,49,55
050,19,189,"Iowa","Winnebago County",3,74,101,48,53
050,19,189,"Iowa","Winnebago County",3,75,71,35,36
050,19,189,"Iowa","Winnebago County",3,76,74,34,40
050,19,189,"Iowa","Winnebago County",3,77,82,32,50
050,19,189,"Iowa","Winnebago County",3,78,80,32,48
050,19,189,"Iowa","Winnebago County",3,79,68,28,40
050,19,189,"Iowa","Winnebago County",3,80,59,24,35
050,19,189,"Iowa","Winnebago County",3,81,61,26,35
050,19,189,"Iowa","Winnebago County",3,82,62,24,38
050,19,189,"Iowa","Winnebago County",3,83,57,26,31
050,19,189,"Iowa","Winnebago County",3,84,45,20,25
050,19,189,"Iowa","Winnebago County",3,85,321,98,223
050,19,189,"Iowa","Winnebago County",4,0,98,51,47
050,19,189,"Iowa","Winnebago County",4,1,117,54,63
050,19,189,"Iowa","Winnebago County",4,2,93,53,40
050,19,189,"Iowa","Winnebago County",4,3,102,56,46
050,19,189,"Iowa","Winnebago County",4,4,116,55,61
050,19,189,"Iowa","Winnebago County",4,5,132,61,71
050,19,189,"Iowa","Winnebago County",4,6,120,63,57
050,19,189,"Iowa","Winnebago County",4,7,126,69,57
050,19,189,"Iowa","Winnebago County",4,8,145,72,73
050,19,189,"Iowa","Winnebago County",4,9,142,67,75
050,19,189,"Iowa","Winnebago County",4,10,140,69,71
050,19,189,"Iowa","Winnebago County",4,11,143,66,77
050,19,189,"Iowa","Winnebago County",4,12,136,68,68
050,19,189,"Iowa","Winnebago County",4,13,151,77,74
050,19,189,"Iowa","Winnebago County",4,14,151,77,74
050,19,189,"Iowa","Winnebago County",4,15,129,72,57
050,19,189,"Iowa","Winnebago County",4,16,153,80,73
050,19,189,"Iowa","Winnebago County",4,17,135,71,64
050,19,189,"Iowa","Winnebago County",4,18,189,101,88
050,19,189,"Iowa","Winnebago County",4,19,189,105,84
050,19,189,"Iowa","Winnebago County",4,20,199,99,100
050,19,189,"Iowa","Winnebago County",4,21,185,93,92
050,19,189,"Iowa","Winnebago County",4,22,156,88,68
050,19,189,"Iowa","Winnebago County",4,23,114,64,50
050,19,189,"Iowa","Winnebago County",4,24,103,65,38
050,19,189,"Iowa","Winnebago County",4,25,103,52,51
050,19,189,"Iowa","Winnebago County",4,26,101,54,47
050,19,189,"Iowa","Winnebago County",4,27,108,57,51
050,19,189,"Iowa","Winnebago County",4,28,114,60,54
050,19,189,"Iowa","Winnebago County",4,29,114,68,46
050,19,189,"Iowa","Winnebago County",4,30,108,59,49
050,19,189,"Iowa","Winnebago County",4,31,99,61,38
050,19,189,"Iowa","Winnebago County",4,32,115,59,56
050,19,189,"Iowa","Winnebago County",4,33,106,57,49
050,19,189,"Iowa","Winnebago County",4,34,106,53,53
050,19,189,"Iowa","Winnebago County",4,35,110,56,54
050,19,189,"Iowa","Winnebago County",4,36,133,67,66
050,19,189,"Iowa","Winnebago County",4,37,118,64,54
050,19,189,"Iowa","Winnebago County",4,38,120,65,55
050,19,189,"Iowa","Winnebago County",4,39,125,68,57
050,19,189,"Iowa","Winnebago County",4,40,126,59,67
050,19,189,"Iowa","Winnebago County",4,41,124,71,53
050,19,189,"Iowa","Winnebago County",4,42,122,65,57
050,19,189,"Iowa","Winnebago County",4,43,113,54,59
050,19,189,"Iowa","Winnebago County",4,44,118,59,59
050,19,189,"Iowa","Winnebago County",4,45,125,65,60
050,19,189,"Iowa","Winnebago County",4,46,113,54,59
050,19,189,"Iowa","Winnebago County",4,47,95,52,43
050,19,189,"Iowa","Winnebago County",4,48,104,52,52
050,19,189,"Iowa","Winnebago County",4,49,114,58,56
050,19,189,"Iowa","Winnebago County",4,50,129,67,62
050,19,189,"Iowa","Winnebago County",4,51,131,68,63
050,19,189,"Iowa","Winnebago County",4,52,127,63,64
050,19,189,"Iowa","Winnebago County",4,53,117,60,57
050,19,189,"Iowa","Winnebago County",4,54,98,54,44
050,19,189,"Iowa","Winnebago County",4,55,107,55,52
050,19,189,"Iowa","Winnebago County",4,56,118,63,55
050,19,189,"Iowa","Winnebago County",4,57,121,64,57
050,19,189,"Iowa","Winnebago County",4,58,144,70,74
050,19,189,"Iowa","Winnebago County",4,59,140,69,71
050,19,189,"Iowa","Winnebago County",4,60,150,78,72
050,19,189,"Iowa","Winnebago County",4,61,146,74,72
050,19,189,"Iowa","Winnebago County",4,62,157,81,76
050,19,189,"Iowa","Winnebago County",4,63,153,79,74
050,19,189,"Iowa","Winnebago County",4,64,155,77,78
050,19,189,"Iowa","Winnebago County",4,65,162,74,88
050,19,189,"Iowa","Winnebago County",4,66,151,69,82
050,19,189,"Iowa","Winnebago County",4,67,157,75,82
050,19,189,"Iowa","Winnebago County",4,68,147,76,71
050,19,189,"Iowa","Winnebago County",4,69,152,80,72
050,19,189,"Iowa","Winnebago County",4,70,141,70,71
050,19,189,"Iowa","Winnebago County",4,71,133,70,63
050,19,189,"Iowa","Winnebago County",4,72,113,57,56
050,19,189,"Iowa","Winnebago County",4,73,105,44,61
050,19,189,"Iowa","Winnebago County",4,74,105,49,56
050,19,189,"Iowa","Winnebago County",4,75,96,46,50
050,19,189,"Iowa","Winnebago County",4,76,67,31,36
050,19,189,"Iowa","Winnebago County",4,77,73,34,39
050,19,189,"Iowa","Winnebago County",4,78,70,25,45
050,19,189,"Iowa","Winnebago County",4,79,78,31,47
050,19,189,"Iowa","Winnebago County",4,80,66,28,38
050,19,189,"Iowa","Winnebago County",4,81,58,26,32
050,19,189,"Iowa","Winnebago County",4,82,50,18,32
050,19,189,"Iowa","Winnebago County",4,83,57,23,34
050,19,189,"Iowa","Winnebago County",4,84,52,26,26
050,19,189,"Iowa","Winnebago County",4,85,315,88,227
050,19,189,"Iowa","Winnebago County",5,0,96,49,47
050,19,189,"Iowa","Winnebago County",5,1,98,50,48
050,19,189,"Iowa","Winnebago County",5,2,112,50,62
050,19,189,"Iowa","Winnebago County",5,3,94,55,39
050,19,189,"Iowa","Winnebago County",5,4,103,59,44
050,19,189,"Iowa","Winnebago County",5,5,116,55,61
050,19,189,"Iowa","Winnebago County",5,6,137,64,73
050,19,189,"Iowa","Winnebago County",5,7,129,68,61
050,19,189,"Iowa","Winnebago County",5,8,120,62,58
050,19,189,"Iowa","Winnebago County",5,9,145,74,71
050,19,189,"Iowa","Winnebago County",5,10,140,69,71
050,19,189,"Iowa","Winnebago County",5,11,146,73,73
050,19,189,"Iowa","Winnebago County",5,12,142,65,77
050,19,189,"Iowa","Winnebago County",5,13,141,70,71
050,19,189,"Iowa","Winnebago County",5,14,147,78,69
050,19,189,"Iowa","Winnebago County",5,15,153,76,77
050,19,189,"Iowa","Winnebago County",5,16,130,72,58
050,19,189,"Iowa","Winnebago County",5,17,151,81,70
050,19,189,"Iowa","Winnebago County",5,18,182,98,84
050,19,189,"Iowa","Winnebago County",5,19,194,103,91
050,19,189,"Iowa","Winnebago County",5,20,187,104,83
050,19,189,"Iowa","Winnebago County",5,21,169,90,79
050,19,189,"Iowa","Winnebago County",5,22,145,74,71
050,19,189,"Iowa","Winnebago County",5,23,144,79,65
050,19,189,"Iowa","Winnebago County",5,24,111,61,50
050,19,189,"Iowa","Winnebago County",5,25,104,66,38
050,19,189,"Iowa","Winnebago County",5,26,100,45,55
050,19,189,"Iowa","Winnebago County",5,27,108,59,49
050,19,189,"Iowa","Winnebago County",5,28,106,54,52
050,19,189,"Iowa","Winnebago County",5,29,117,62,55
050,19,189,"Iowa","Winnebago County",5,30,113,64,49
050,19,189,"Iowa","Winnebago County",5,31,111,63,48
050,19,189,"Iowa","Winnebago County",5,32,92,54,38
050,19,189,"Iowa","Winnebago County",5,33,116,59,57
050,19,189,"Iowa","Winnebago County",5,34,108,58,50
050,19,189,"Iowa","Winnebago County",5,35,107,56,51
050,19,189,"Iowa","Winnebago County",5,36,111,56,55
050,19,189,"Iowa","Winnebago County",5,37,134,67,67
050,19,189,"Iowa","Winnebago County",5,38,122,65,57
050,19,189,"Iowa","Winnebago County",5,39,113,61,52
050,19,189,"Iowa","Winnebago County",5,40,128,71,57
050,19,189,"Iowa","Winnebago County",5,41,124,61,63
050,19,189,"Iowa","Winnebago County",5,42,122,70,52
050,19,189,"Iowa","Winnebago County",5,43,120,61,59
050,19,189,"Iowa","Winnebago County",5,44,111,52,59
050,19,189,"Iowa","Winnebago County",5,45,124,62,62
050,19,189,"Iowa","Winnebago County",5,46,125,66,59
050,19,189,"Iowa","Winnebago County",5,47,109,51,58
050,19,189,"Iowa","Winnebago County",5,48,93,51,42
050,19,189,"Iowa","Winnebago County",5,49,103,51,52
050,19,189,"Iowa","Winnebago County",5,50,109,53,56
050,19,189,"Iowa","Winnebago County",5,51,126,66,60
050,19,189,"Iowa","Winnebago County",5,52,130,68,62
050,19,189,"Iowa","Winnebago County",5,53,127,63,64
050,19,189,"Iowa","Winnebago County",5,54,119,62,57
050,19,189,"Iowa","Winnebago County",5,55,98,52,46
050,19,189,"Iowa","Winnebago County",5,56,111,57,54
050,19,189,"Iowa","Winnebago County",5,57,117,64,53
050,19,189,"Iowa","Winnebago County",5,58,120,62,58
050,19,189,"Iowa","Winnebago County",5,59,146,73,73
050,19,189,"Iowa","Winnebago County",5,60,144,72,72
050,19,189,"Iowa","Winnebago County",5,61,141,73,68
050,19,189,"Iowa","Winnebago County",5,62,145,72,73
050,19,189,"Iowa","Winnebago County",5,63,160,80,80
050,19,189,"Iowa","Winnebago County",5,64,154,81,73
050,19,189,"Iowa","Winnebago County",5,65,159,78,81
050,19,189,"Iowa","Winnebago County",5,66,153,70,83
050,19,189,"Iowa","Winnebago County",5,67,145,65,80
050,19,189,"Iowa","Winnebago County",5,68,153,74,79
050,19,189,"Iowa","Winnebago County",5,69,148,79,69
050,19,189,"Iowa","Winnebago County",5,70,149,78,71
050,19,189,"Iowa","Winnebago County",5,71,141,70,71
050,19,189,"Iowa","Winnebago County",5,72,131,68,63
050,19,189,"Iowa","Winnebago County",5,73,104,51,53
050,19,189,"Iowa","Winnebago County",5,74,100,43,57
050,19,189,"Iowa","Winnebago County",5,75,100,47,53
050,19,189,"Iowa","Winnebago County",5,76,86,39,47
050,19,189,"Iowa","Winnebago County",5,77,69,32,37
050,19,189,"Iowa","Winnebago County",5,78,66,31,35
050,19,189,"Iowa","Winnebago County",5,79,65,23,42
050,19,189,"Iowa","Winnebago County",5,80,73,30,43
050,19,189,"Iowa","Winnebago County",5,81,67,32,35
050,19,189,"Iowa","Winnebago County",5,82,47,18,29
050,19,189,"Iowa","Winnebago County",5,83,44,16,28
050,19,189,"Iowa","Winnebago County",5,84,50,22,28
050,19,189,"Iowa","Winnebago County",5,85,321,91,230
050,19,191,"Iowa","Winneshiek County",1,0,188,99,89
050,19,191,"Iowa","Winneshiek County",1,1,181,94,87
050,19,191,"Iowa","Winneshiek County",1,2,183,90,93
050,19,191,"Iowa","Winneshiek County",1,3,181,84,97
050,19,191,"Iowa","Winneshiek County",1,4,189,95,94
050,19,191,"Iowa","Winneshiek County",1,5,188,108,80
050,19,191,"Iowa","Winneshiek County",1,6,193,105,88
050,19,191,"Iowa","Winneshiek County",1,7,186,95,91
050,19,191,"Iowa","Winneshiek County",1,8,191,95,96
050,19,191,"Iowa","Winneshiek County",1,9,195,108,87
050,19,191,"Iowa","Winneshiek County",1,10,223,116,107
050,19,191,"Iowa","Winneshiek County",1,11,234,127,107
050,19,191,"Iowa","Winneshiek County",1,12,262,132,130
050,19,191,"Iowa","Winneshiek County",1,13,264,132,132
050,19,191,"Iowa","Winneshiek County",1,14,233,118,115
050,19,191,"Iowa","Winneshiek County",1,15,251,126,125
050,19,191,"Iowa","Winneshiek County",1,16,250,139,111
050,19,191,"Iowa","Winneshiek County",1,17,250,135,115
050,19,191,"Iowa","Winneshiek County",1,18,380,182,198
050,19,191,"Iowa","Winneshiek County",1,19,606,270,336
050,19,191,"Iowa","Winneshiek County",1,20,530,234,296
050,19,191,"Iowa","Winneshiek County",1,21,506,246,260
050,19,191,"Iowa","Winneshiek County",1,22,367,188,179
050,19,191,"Iowa","Winneshiek County",1,23,206,109,97
050,19,191,"Iowa","Winneshiek County",1,24,173,84,89
050,19,191,"Iowa","Winneshiek County",1,25,185,101,84
050,19,191,"Iowa","Winneshiek County",1,26,177,99,78
050,19,191,"Iowa","Winneshiek County",1,27,163,83,80
050,19,191,"Iowa","Winneshiek County",1,28,173,87,86
050,19,191,"Iowa","Winneshiek County",1,29,191,98,93
050,19,191,"Iowa","Winneshiek County",1,30,187,97,90
050,19,191,"Iowa","Winneshiek County",1,31,192,97,95
050,19,191,"Iowa","Winneshiek County",1,32,178,87,91
050,19,191,"Iowa","Winneshiek County",1,33,190,99,91
050,19,191,"Iowa","Winneshiek County",1,34,195,111,84
050,19,191,"Iowa","Winneshiek County",1,35,188,97,91
050,19,191,"Iowa","Winneshiek County",1,36,187,101,86
050,19,191,"Iowa","Winneshiek County",1,37,213,110,103
050,19,191,"Iowa","Winneshiek County",1,38,210,105,105
050,19,191,"Iowa","Winneshiek County",1,39,208,104,104
050,19,191,"Iowa","Winneshiek County",1,40,231,131,100
050,19,191,"Iowa","Winneshiek County",1,41,207,110,97
050,19,191,"Iowa","Winneshiek County",1,42,201,109,92
050,19,191,"Iowa","Winneshiek County",1,43,204,109,95
050,19,191,"Iowa","Winneshiek County",1,44,199,100,99
050,19,191,"Iowa","Winneshiek County",1,45,198,96,102
050,19,191,"Iowa","Winneshiek County",1,46,201,99,102
050,19,191,"Iowa","Winneshiek County",1,47,197,104,93
050,19,191,"Iowa","Winneshiek County",1,48,201,104,97
050,19,191,"Iowa","Winneshiek County",1,49,216,110,106
050,19,191,"Iowa","Winneshiek County",1,50,231,123,108
050,19,191,"Iowa","Winneshiek County",1,51,237,124,113
050,19,191,"Iowa","Winneshiek County",1,52,233,123,110
050,19,191,"Iowa","Winneshiek County",1,53,222,113,109
050,19,191,"Iowa","Winneshiek County",1,54,255,136,119
050,19,191,"Iowa","Winneshiek County",1,55,278,152,126
050,19,191,"Iowa","Winneshiek County",1,56,285,152,133
050,19,191,"Iowa","Winneshiek County",1,57,282,139,143
050,19,191,"Iowa","Winneshiek County",1,58,309,150,159
050,19,191,"Iowa","Winneshiek County",1,59,317,147,170
050,19,191,"Iowa","Winneshiek County",1,60,312,149,163
050,19,191,"Iowa","Winneshiek County",1,61,334,176,158
050,19,191,"Iowa","Winneshiek County",1,62,347,184,163
050,19,191,"Iowa","Winneshiek County",1,63,316,169,147
050,19,191,"Iowa","Winneshiek County",1,64,324,174,150
050,19,191,"Iowa","Winneshiek County",1,65,293,154,139
050,19,191,"Iowa","Winneshiek County",1,66,280,146,134
050,19,191,"Iowa","Winneshiek County",1,67,274,134,140
050,19,191,"Iowa","Winneshiek County",1,68,261,123,138
050,19,191,"Iowa","Winneshiek County",1,69,241,119,122
050,19,191,"Iowa","Winneshiek County",1,70,240,130,110
050,19,191,"Iowa","Winneshiek County",1,71,236,116,120
050,19,191,"Iowa","Winneshiek County",1,72,228,114,114
050,19,191,"Iowa","Winneshiek County",1,73,204,100,104
050,19,191,"Iowa","Winneshiek County",1,74,156,77,79
050,19,191,"Iowa","Winneshiek County",1,75,152,78,74
050,19,191,"Iowa","Winneshiek County",1,76,145,62,83
050,19,191,"Iowa","Winneshiek County",1,77,143,70,73
050,19,191,"Iowa","Winneshiek County",1,78,138,62,76
050,19,191,"Iowa","Winneshiek County",1,79,135,63,72
050,19,191,"Iowa","Winneshiek County",1,80,127,63,64
050,19,191,"Iowa","Winneshiek County",1,81,125,59,66
050,19,191,"Iowa","Winneshiek County",1,82,114,50,64
050,19,191,"Iowa","Winneshiek County",1,83,97,41,56
050,19,191,"Iowa","Winneshiek County",1,84,98,48,50
050,19,191,"Iowa","Winneshiek County",1,85,593,218,375
050,19,191,"Iowa","Winneshiek County",2,0,190,96,94
050,19,191,"Iowa","Winneshiek County",2,1,179,92,87
050,19,191,"Iowa","Winneshiek County",2,2,179,89,90
050,19,191,"Iowa","Winneshiek County",2,3,182,86,96
050,19,191,"Iowa","Winneshiek County",2,4,188,93,95
050,19,191,"Iowa","Winneshiek County",2,5,187,104,83
050,19,191,"Iowa","Winneshiek County",2,6,194,107,87
050,19,191,"Iowa","Winneshiek County",2,7,189,98,91
050,19,191,"Iowa","Winneshiek County",2,8,189,95,94
050,19,191,"Iowa","Winneshiek County",2,9,194,105,89
050,19,191,"Iowa","Winneshiek County",2,10,218,115,103
050,19,191,"Iowa","Winneshiek County",2,11,233,125,108
050,19,191,"Iowa","Winneshiek County",2,12,257,131,126
050,19,191,"Iowa","Winneshiek County",2,13,263,132,131
050,19,191,"Iowa","Winneshiek County",2,14,241,121,120
050,19,191,"Iowa","Winneshiek County",2,15,244,122,122
050,19,191,"Iowa","Winneshiek County",2,16,249,136,113
050,19,191,"Iowa","Winneshiek County",2,17,250,137,113
050,19,191,"Iowa","Winneshiek County",2,18,380,182,198
050,19,191,"Iowa","Winneshiek County",2,19,606,273,333
050,19,191,"Iowa","Winneshiek County",2,20,532,236,296
050,19,191,"Iowa","Winneshiek County",2,21,505,243,262
050,19,191,"Iowa","Winneshiek County",2,22,359,184,175
050,19,191,"Iowa","Winneshiek County",2,23,202,105,97
050,19,191,"Iowa","Winneshiek County",2,24,174,87,87
050,19,191,"Iowa","Winneshiek County",2,25,180,97,83
050,19,191,"Iowa","Winneshiek County",2,26,178,100,78
050,19,191,"Iowa","Winneshiek County",2,27,168,86,82
050,19,191,"Iowa","Winneshiek County",2,28,173,88,85
050,19,191,"Iowa","Winneshiek County",2,29,189,97,92
050,19,191,"Iowa","Winneshiek County",2,30,191,99,92
050,19,191,"Iowa","Winneshiek County",2,31,189,96,93
050,19,191,"Iowa","Winneshiek County",2,32,181,89,92
050,19,191,"Iowa","Winneshiek County",2,33,189,98,91
050,19,191,"Iowa","Winneshiek County",2,34,194,108,86
050,19,191,"Iowa","Winneshiek County",2,35,192,100,92
050,19,191,"Iowa","Winneshiek County",2,36,185,98,87
050,19,191,"Iowa","Winneshiek County",2,37,207,107,100
050,19,191,"Iowa","Winneshiek County",2,38,211,106,105
050,19,191,"Iowa","Winneshiek County",2,39,208,104,104
050,19,191,"Iowa","Winneshiek County",2,40,224,123,101
050,19,191,"Iowa","Winneshiek County",2,41,210,113,97
050,19,191,"Iowa","Winneshiek County",2,42,201,109,92
050,19,191,"Iowa","Winneshiek County",2,43,205,110,95
050,19,191,"Iowa","Winneshiek County",2,44,196,101,95
050,19,191,"Iowa","Winneshiek County",2,45,200,98,102
050,19,191,"Iowa","Winneshiek County",2,46,199,98,101
050,19,191,"Iowa","Winneshiek County",2,47,198,103,95
050,19,191,"Iowa","Winneshiek County",2,48,201,105,96
050,19,191,"Iowa","Winneshiek County",2,49,214,109,105
050,19,191,"Iowa","Winneshiek County",2,50,229,121,108
050,19,191,"Iowa","Winneshiek County",2,51,236,124,112
050,19,191,"Iowa","Winneshiek County",2,52,234,123,111
050,19,191,"Iowa","Winneshiek County",2,53,227,117,110
050,19,191,"Iowa","Winneshiek County",2,54,245,130,115
050,19,191,"Iowa","Winneshiek County",2,55,271,148,123
050,19,191,"Iowa","Winneshiek County",2,56,282,151,131
050,19,191,"Iowa","Winneshiek County",2,57,283,142,141
050,19,191,"Iowa","Winneshiek County",2,58,303,149,154
050,19,191,"Iowa","Winneshiek County",2,59,315,146,169
050,19,191,"Iowa","Winneshiek County",2,60,311,147,164
050,19,191,"Iowa","Winneshiek County",2,61,328,168,160
050,19,191,"Iowa","Winneshiek County",2,62,342,180,162
050,19,191,"Iowa","Winneshiek County",2,63,326,174,152
050,19,191,"Iowa","Winneshiek County",2,64,321,172,149
050,19,191,"Iowa","Winneshiek County",2,65,300,158,142
050,19,191,"Iowa","Winneshiek County",2,66,285,149,136
050,19,191,"Iowa","Winneshiek County",2,67,276,137,139
050,19,191,"Iowa","Winneshiek County",2,68,263,125,138
050,19,191,"Iowa","Winneshiek County",2,69,246,120,126
050,19,191,"Iowa","Winneshiek County",2,70,240,127,113
050,19,191,"Iowa","Winneshiek County",2,71,236,120,116
050,19,191,"Iowa","Winneshiek County",2,72,226,113,113
050,19,191,"Iowa","Winneshiek County",2,73,220,109,111
050,19,191,"Iowa","Winneshiek County",2,74,158,78,80
050,19,191,"Iowa","Winneshiek County",2,75,153,78,75
050,19,191,"Iowa","Winneshiek County",2,76,145,65,80
050,19,191,"Iowa","Winneshiek County",2,77,147,70,77
050,19,191,"Iowa","Winneshiek County",2,78,137,63,74
050,19,191,"Iowa","Winneshiek County",2,79,134,62,72
050,19,191,"Iowa","Winneshiek County",2,80,128,63,65
050,19,191,"Iowa","Winneshiek County",2,81,124,60,64
050,19,191,"Iowa","Winneshiek County",2,82,118,53,65
050,19,191,"Iowa","Winneshiek County",2,83,97,42,55
050,19,191,"Iowa","Winneshiek County",2,84,97,46,51
050,19,191,"Iowa","Winneshiek County",2,85,595,223,372
050,19,191,"Iowa","Winneshiek County",3,0,189,98,91
050,19,191,"Iowa","Winneshiek County",3,1,184,88,96
050,19,191,"Iowa","Winneshiek County",3,2,181,93,88
050,19,191,"Iowa","Winneshiek County",3,3,184,96,88
050,19,191,"Iowa","Winneshiek County",3,4,185,86,99
050,19,191,"Iowa","Winneshiek County",3,5,182,86,96
050,19,191,"Iowa","Winneshiek County",3,6,188,105,83
050,19,191,"Iowa","Winneshiek County",3,7,197,111,86
050,19,191,"Iowa","Winneshiek County",3,8,184,97,87
050,19,191,"Iowa","Winneshiek County",3,9,182,91,91
050,19,191,"Iowa","Winneshiek County",3,10,197,106,91
050,19,191,"Iowa","Winneshiek County",3,11,221,114,107
050,19,191,"Iowa","Winneshiek County",3,12,226,122,104
050,19,191,"Iowa","Winneshiek County",3,13,256,131,125
050,19,191,"Iowa","Winneshiek County",3,14,260,133,127
050,19,191,"Iowa","Winneshiek County",3,15,247,125,122
050,19,191,"Iowa","Winneshiek County",3,16,249,125,124
050,19,191,"Iowa","Winneshiek County",3,17,257,139,118
050,19,191,"Iowa","Winneshiek County",3,18,386,191,195
050,19,191,"Iowa","Winneshiek County",3,19,616,282,334
050,19,191,"Iowa","Winneshiek County",3,20,540,252,288
050,19,191,"Iowa","Winneshiek County",3,21,486,228,258
050,19,191,"Iowa","Winneshiek County",3,22,349,182,167
050,19,191,"Iowa","Winneshiek County",3,23,190,104,86
050,19,191,"Iowa","Winneshiek County",3,24,164,84,80
050,19,191,"Iowa","Winneshiek County",3,25,174,85,89
050,19,191,"Iowa","Winneshiek County",3,26,181,93,88
050,19,191,"Iowa","Winneshiek County",3,27,171,92,79
050,19,191,"Iowa","Winneshiek County",3,28,171,87,84
050,19,191,"Iowa","Winneshiek County",3,29,188,102,86
050,19,191,"Iowa","Winneshiek County",3,30,182,93,89
050,19,191,"Iowa","Winneshiek County",3,31,187,92,95
050,19,191,"Iowa","Winneshiek County",3,32,185,93,92
050,19,191,"Iowa","Winneshiek County",3,33,187,94,93
050,19,191,"Iowa","Winneshiek County",3,34,198,103,95
050,19,191,"Iowa","Winneshiek County",3,35,198,110,88
050,19,191,"Iowa","Winneshiek County",3,36,204,108,96
050,19,191,"Iowa","Winneshiek County",3,37,192,100,92
050,19,191,"Iowa","Winneshiek County",3,38,207,109,98
050,19,191,"Iowa","Winneshiek County",3,39,206,102,104
050,19,191,"Iowa","Winneshiek County",3,40,211,101,110
050,19,191,"Iowa","Winneshiek County",3,41,222,121,101
050,19,191,"Iowa","Winneshiek County",3,42,208,113,95
050,19,191,"Iowa","Winneshiek County",3,43,207,111,96
050,19,191,"Iowa","Winneshiek County",3,44,206,109,97
050,19,191,"Iowa","Winneshiek County",3,45,194,102,92
050,19,191,"Iowa","Winneshiek County",3,46,195,97,98
050,19,191,"Iowa","Winneshiek County",3,47,191,93,98
050,19,191,"Iowa","Winneshiek County",3,48,199,103,96
050,19,191,"Iowa","Winneshiek County",3,49,202,105,97
050,19,191,"Iowa","Winneshiek County",3,50,211,108,103
050,19,191,"Iowa","Winneshiek County",3,51,228,121,107
050,19,191,"Iowa","Winneshiek County",3,52,237,118,119
050,19,191,"Iowa","Winneshiek County",3,53,233,123,110
050,19,191,"Iowa","Winneshiek County",3,54,227,116,111
050,19,191,"Iowa","Winneshiek County",3,55,240,131,109
050,19,191,"Iowa","Winneshiek County",3,56,269,146,123
050,19,191,"Iowa","Winneshiek County",3,57,279,146,133
050,19,191,"Iowa","Winneshiek County",3,58,292,149,143
050,19,191,"Iowa","Winneshiek County",3,59,306,153,153
050,19,191,"Iowa","Winneshiek County",3,60,316,146,170
050,19,191,"Iowa","Winneshiek County",3,61,307,146,161
050,19,191,"Iowa","Winneshiek County",3,62,321,164,157
050,19,191,"Iowa","Winneshiek County",3,63,339,180,159
050,19,191,"Iowa","Winneshiek County",3,64,322,171,151
050,19,191,"Iowa","Winneshiek County",3,65,323,173,150
050,19,191,"Iowa","Winneshiek County",3,66,295,155,140
050,19,191,"Iowa","Winneshiek County",3,67,284,147,137
050,19,191,"Iowa","Winneshiek County",3,68,273,136,137
050,19,191,"Iowa","Winneshiek County",3,69,259,122,137
050,19,191,"Iowa","Winneshiek County",3,70,242,119,123
050,19,191,"Iowa","Winneshiek County",3,71,239,130,109
050,19,191,"Iowa","Winneshiek County",3,72,229,113,116
050,19,191,"Iowa","Winneshiek County",3,73,219,110,109
050,19,191,"Iowa","Winneshiek County",3,74,213,106,107
050,19,191,"Iowa","Winneshiek County",3,75,153,75,78
050,19,191,"Iowa","Winneshiek County",3,76,150,75,75
050,19,191,"Iowa","Winneshiek County",3,77,144,66,78
050,19,191,"Iowa","Winneshiek County",3,78,148,71,77
050,19,191,"Iowa","Winneshiek County",3,79,133,63,70
050,19,191,"Iowa","Winneshiek County",3,80,129,58,71
050,19,191,"Iowa","Winneshiek County",3,81,118,58,60
050,19,191,"Iowa","Winneshiek County",3,82,120,59,61
050,19,191,"Iowa","Winneshiek County",3,83,105,43,62
050,19,191,"Iowa","Winneshiek County",3,84,91,38,53
050,19,191,"Iowa","Winneshiek County",3,85,575,223,352
050,19,191,"Iowa","Winneshiek County",4,0,188,100,88
050,19,191,"Iowa","Winneshiek County",4,1,204,101,103
050,19,191,"Iowa","Winneshiek County",4,2,189,90,99
050,19,191,"Iowa","Winneshiek County",4,3,182,97,85
050,19,191,"Iowa","Winneshiek County",4,4,204,106,98
050,19,191,"Iowa","Winneshiek County",4,5,193,89,104
050,19,191,"Iowa","Winneshiek County",4,6,191,100,91
050,19,191,"Iowa","Winneshiek County",4,7,191,100,91
050,19,191,"Iowa","Winneshiek County",4,8,200,110,90
050,19,191,"Iowa","Winneshiek County",4,9,180,94,86
050,19,191,"Iowa","Winneshiek County",4,10,187,92,95
050,19,191,"Iowa","Winneshiek County",4,11,201,109,92
050,19,191,"Iowa","Winneshiek County",4,12,220,118,102
050,19,191,"Iowa","Winneshiek County",4,13,225,122,103
050,19,191,"Iowa","Winneshiek County",4,14,256,126,130
050,19,191,"Iowa","Winneshiek County",4,15,260,133,127
050,19,191,"Iowa","Winneshiek County",4,16,243,124,119
050,19,191,"Iowa","Winneshiek County",4,17,246,124,122
050,19,191,"Iowa","Winneshiek County",4,18,369,178,191
050,19,191,"Iowa","Winneshiek County",4,19,591,275,316
050,19,191,"Iowa","Winneshiek County",4,20,531,245,286
050,19,191,"Iowa","Winneshiek County",4,21,488,241,247
050,19,191,"Iowa","Winneshiek County",4,22,347,171,176
050,19,191,"Iowa","Winneshiek County",4,23,204,107,97
050,19,191,"Iowa","Winneshiek County",4,24,167,92,75
050,19,191,"Iowa","Winneshiek County",4,25,150,78,72
050,19,191,"Iowa","Winneshiek County",4,26,181,93,88
050,19,191,"Iowa","Winneshiek County",4,27,175,87,88
050,19,191,"Iowa","Winneshiek County",4,28,169,91,78
050,19,191,"Iowa","Winneshiek County",4,29,172,87,85
050,19,191,"Iowa","Winneshiek County",4,30,187,97,90
050,19,191,"Iowa","Winneshiek County",4,31,201,104,97
050,19,191,"Iowa","Winneshiek County",4,32,188,94,94
050,19,191,"Iowa","Winneshiek County",4,33,189,95,94
050,19,191,"Iowa","Winneshiek County",4,34,185,93,92
050,19,191,"Iowa","Winneshiek County",4,35,210,112,98
050,19,191,"Iowa","Winneshiek County",4,36,210,115,95
050,19,191,"Iowa","Winneshiek County",4,37,212,115,97
050,19,191,"Iowa","Winneshiek County",4,38,195,102,93
050,19,191,"Iowa","Winneshiek County",4,39,202,105,97
050,19,191,"Iowa","Winneshiek County",4,40,205,103,102
050,19,191,"Iowa","Winneshiek County",4,41,214,108,106
050,19,191,"Iowa","Winneshiek County",4,42,226,121,105
050,19,191,"Iowa","Winneshiek County",4,43,211,116,95
050,19,191,"Iowa","Winneshiek County",4,44,208,111,97
050,19,191,"Iowa","Winneshiek County",4,45,209,115,94
050,19,191,"Iowa","Winneshiek County",4,46,191,101,90
050,19,191,"Iowa","Winneshiek County",4,47,194,94,100
050,19,191,"Iowa","Winneshiek County",4,48,188,93,95
050,19,191,"Iowa","Winneshiek County",4,49,189,96,93
050,19,191,"Iowa","Winneshiek County",4,50,204,103,101
050,19,191,"Iowa","Winneshiek County",4,51,210,107,103
050,19,191,"Iowa","Winneshiek County",4,52,225,120,105
050,19,191,"Iowa","Winneshiek County",4,53,232,113,119
050,19,191,"Iowa","Winneshiek County",4,54,230,123,107
050,19,191,"Iowa","Winneshiek County",4,55,222,114,108
050,19,191,"Iowa","Winneshiek County",4,56,239,128,111
050,19,191,"Iowa","Winneshiek County",4,57,271,147,124
050,19,191,"Iowa","Winneshiek County",4,58,274,147,127
050,19,191,"Iowa","Winneshiek County",4,59,286,149,137
050,19,191,"Iowa","Winneshiek County",4,60,306,152,154
050,19,191,"Iowa","Winneshiek County",4,61,317,143,174
050,19,191,"Iowa","Winneshiek County",4,62,308,148,160
050,19,191,"Iowa","Winneshiek County",4,63,319,162,157
050,19,191,"Iowa","Winneshiek County",4,64,340,183,157
050,19,191,"Iowa","Winneshiek County",4,65,316,171,145
050,19,191,"Iowa","Winneshiek County",4,66,323,172,151
050,19,191,"Iowa","Winneshiek County",4,67,295,156,139
050,19,191,"Iowa","Winneshiek County",4,68,286,148,138
050,19,191,"Iowa","Winneshiek County",4,69,268,130,138
050,19,191,"Iowa","Winneshiek County",4,70,261,124,137
050,19,191,"Iowa","Winneshiek County",4,71,244,119,125
050,19,191,"Iowa","Winneshiek County",4,72,239,128,111
050,19,191,"Iowa","Winneshiek County",4,73,230,113,117
050,19,191,"Iowa","Winneshiek County",4,74,219,111,108
050,19,191,"Iowa","Winneshiek County",4,75,215,105,110
050,19,191,"Iowa","Winneshiek County",4,76,147,69,78
050,19,191,"Iowa","Winneshiek County",4,77,142,71,71
050,19,191,"Iowa","Winneshiek County",4,78,138,64,74
050,19,191,"Iowa","Winneshiek County",4,79,141,67,74
050,19,191,"Iowa","Winneshiek County",4,80,130,60,70
050,19,191,"Iowa","Winneshiek County",4,81,125,58,67
050,19,191,"Iowa","Winneshiek County",4,82,107,52,55
050,19,191,"Iowa","Winneshiek County",4,83,109,47,62
050,19,191,"Iowa","Winneshiek County",4,84,96,39,57
050,19,191,"Iowa","Winneshiek County",4,85,570,228,342
050,19,191,"Iowa","Winneshiek County",5,0,179,96,83
050,19,191,"Iowa","Winneshiek County",5,1,185,101,84
050,19,191,"Iowa","Winneshiek County",5,2,196,99,97
050,19,191,"Iowa","Winneshiek County",5,3,192,96,96
050,19,191,"Iowa","Winneshiek County",5,4,182,94,88
050,19,191,"Iowa","Winneshiek County",5,5,206,110,96
050,19,191,"Iowa","Winneshiek County",5,6,188,89,99
050,19,191,"Iowa","Winneshiek County",5,7,190,97,93
050,19,191,"Iowa","Winneshiek County",5,8,193,101,92
050,19,191,"Iowa","Winneshiek County",5,9,202,116,86
050,19,191,"Iowa","Winneshiek County",5,10,185,97,88
050,19,191,"Iowa","Winneshiek County",5,11,185,93,92
050,19,191,"Iowa","Winneshiek County",5,12,204,114,90
050,19,191,"Iowa","Winneshiek County",5,13,222,117,105
050,19,191,"Iowa","Winneshiek County",5,14,221,118,103
050,19,191,"Iowa","Winneshiek County",5,15,255,131,124
050,19,191,"Iowa","Winneshiek County",5,16,249,125,124
050,19,191,"Iowa","Winneshiek County",5,17,245,124,121
050,19,191,"Iowa","Winneshiek County",5,18,364,172,192
050,19,191,"Iowa","Winneshiek County",5,19,585,274,311
050,19,191,"Iowa","Winneshiek County",5,20,534,252,282
050,19,191,"Iowa","Winneshiek County",5,21,491,237,254
050,19,191,"Iowa","Winneshiek County",5,22,342,182,160
050,19,191,"Iowa","Winneshiek County",5,23,216,113,103
050,19,191,"Iowa","Winneshiek County",5,24,175,86,89
050,19,191,"Iowa","Winneshiek County",5,25,143,82,61
050,19,191,"Iowa","Winneshiek County",5,26,140,75,65
050,19,191,"Iowa","Winneshiek County",5,27,182,95,87
050,19,191,"Iowa","Winneshiek County",5,28,171,84,87
050,19,191,"Iowa","Winneshiek County",5,29,158,85,73
050,19,191,"Iowa","Winneshiek County",5,30,177,89,88
050,19,191,"Iowa","Winneshiek County",5,31,186,95,91
050,19,191,"Iowa","Winneshiek County",5,32,212,113,99
050,19,191,"Iowa","Winneshiek County",5,33,199,102,97
050,19,191,"Iowa","Winneshiek County",5,34,208,99,109
050,19,191,"Iowa","Winneshiek County",5,35,184,97,87
050,19,191,"Iowa","Winneshiek County",5,36,208,111,97
050,19,191,"Iowa","Winneshiek County",5,37,215,116,99
050,19,191,"Iowa","Winneshiek County",5,38,210,116,94
050,19,191,"Iowa","Winneshiek County",5,39,195,99,96
050,19,191,"Iowa","Winneshiek County",5,40,200,100,100
050,19,191,"Iowa","Winneshiek County",5,41,207,107,100
050,19,191,"Iowa","Winneshiek County",5,42,219,112,107
050,19,191,"Iowa","Winneshiek County",5,43,226,117,109
050,19,191,"Iowa","Winneshiek County",5,44,219,121,98
050,19,191,"Iowa","Winneshiek County",5,45,207,113,94
050,19,191,"Iowa","Winneshiek County",5,46,208,112,96
050,19,191,"Iowa","Winneshiek County",5,47,192,104,88
050,19,191,"Iowa","Winneshiek County",5,48,198,94,104
050,19,191,"Iowa","Winneshiek County",5,49,188,93,95
050,19,191,"Iowa","Winneshiek County",5,50,184,93,91
050,19,191,"Iowa","Winneshiek County",5,51,199,98,101
050,19,191,"Iowa","Winneshiek County",5,52,207,104,103
050,19,191,"Iowa","Winneshiek County",5,53,221,118,103
050,19,191,"Iowa","Winneshiek County",5,54,223,109,114
050,19,191,"Iowa","Winneshiek County",5,55,228,121,107
050,19,191,"Iowa","Winneshiek County",5,56,215,109,106
050,19,191,"Iowa","Winneshiek County",5,57,239,126,113
050,19,191,"Iowa","Winneshiek County",5,58,271,145,126
050,19,191,"Iowa","Winneshiek County",5,59,270,147,123
050,19,191,"Iowa","Winneshiek County",5,60,284,148,136
050,19,191,"Iowa","Winneshiek County",5,61,302,152,150
050,19,191,"Iowa","Winneshiek County",5,62,316,141,175
050,19,191,"Iowa","Winneshiek County",5,63,312,152,160
050,19,191,"Iowa","Winneshiek County",5,64,327,168,159
050,19,191,"Iowa","Winneshiek County",5,65,332,179,153
050,19,191,"Iowa","Winneshiek County",5,66,311,165,146
050,19,191,"Iowa","Winneshiek County",5,67,326,173,153
050,19,191,"Iowa","Winneshiek County",5,68,291,155,136
050,19,191,"Iowa","Winneshiek County",5,69,281,147,134
050,19,191,"Iowa","Winneshiek County",5,70,266,130,136
050,19,191,"Iowa","Winneshiek County",5,71,263,126,137
050,19,191,"Iowa","Winneshiek County",5,72,244,116,128
050,19,191,"Iowa","Winneshiek County",5,73,236,127,109
050,19,191,"Iowa","Winneshiek County",5,74,231,114,117
050,19,191,"Iowa","Winneshiek County",5,75,215,112,103
050,19,191,"Iowa","Winneshiek County",5,76,206,98,108
050,19,191,"Iowa","Winneshiek County",5,77,140,65,75
050,19,191,"Iowa","Winneshiek County",5,78,140,68,72
050,19,191,"Iowa","Winneshiek County",5,79,136,65,71
050,19,191,"Iowa","Winneshiek County",5,80,138,65,73
050,19,191,"Iowa","Winneshiek County",5,81,126,59,67
050,19,191,"Iowa","Winneshiek County",5,82,119,53,66
050,19,191,"Iowa","Winneshiek County",5,83,98,43,55
050,19,191,"Iowa","Winneshiek County",5,84,101,45,56
050,19,191,"Iowa","Winneshiek County",5,85,579,238,341
050,19,193,"Iowa","Woodbury County",1,0,1423,728,695
050,19,193,"Iowa","Woodbury County",1,1,1414,719,695
050,19,193,"Iowa","Woodbury County",1,2,1440,740,700
050,19,193,"Iowa","Woodbury County",1,3,1475,757,718
050,19,193,"Iowa","Woodbury County",1,4,1488,749,739
050,19,193,"Iowa","Woodbury County",1,5,1535,768,767
050,19,193,"Iowa","Woodbury County",1,6,1511,768,743
050,19,193,"Iowa","Woodbury County",1,7,1510,794,716
050,19,193,"Iowa","Woodbury County",1,8,1492,796,696
050,19,193,"Iowa","Woodbury County",1,9,1501,751,750
050,19,193,"Iowa","Woodbury County",1,10,1571,806,765
050,19,193,"Iowa","Woodbury County",1,11,1611,807,804
050,19,193,"Iowa","Woodbury County",1,12,1673,831,842
050,19,193,"Iowa","Woodbury County",1,13,1700,863,837
050,19,193,"Iowa","Woodbury County",1,14,1601,832,769
050,19,193,"Iowa","Woodbury County",1,15,1573,814,759
050,19,193,"Iowa","Woodbury County",1,16,1614,803,811
050,19,193,"Iowa","Woodbury County",1,17,1563,809,754
050,19,193,"Iowa","Woodbury County",1,18,1466,761,705
050,19,193,"Iowa","Woodbury County",1,19,1639,868,771
050,19,193,"Iowa","Woodbury County",1,20,1568,813,755
050,19,193,"Iowa","Woodbury County",1,21,1519,731,788
050,19,193,"Iowa","Woodbury County",1,22,1382,677,705
050,19,193,"Iowa","Woodbury County",1,23,1315,666,649
050,19,193,"Iowa","Woodbury County",1,24,1333,695,638
050,19,193,"Iowa","Woodbury County",1,25,1372,704,668
050,19,193,"Iowa","Woodbury County",1,26,1360,700,660
050,19,193,"Iowa","Woodbury County",1,27,1381,732,649
050,19,193,"Iowa","Woodbury County",1,28,1417,739,678
050,19,193,"Iowa","Woodbury County",1,29,1379,740,639
050,19,193,"Iowa","Woodbury County",1,30,1378,720,658
050,19,193,"Iowa","Woodbury County",1,31,1280,669,611
050,19,193,"Iowa","Woodbury County",1,32,1304,690,614
050,19,193,"Iowa","Woodbury County",1,33,1346,712,634
050,19,193,"Iowa","Woodbury County",1,34,1372,716,656
050,19,193,"Iowa","Woodbury County",1,35,1401,750,651
050,19,193,"Iowa","Woodbury County",1,36,1417,740,677
050,19,193,"Iowa","Woodbury County",1,37,1411,713,698
050,19,193,"Iowa","Woodbury County",1,38,1407,727,680
050,19,193,"Iowa","Woodbury County",1,39,1354,710,644
050,19,193,"Iowa","Woodbury County",1,40,1405,704,701
050,19,193,"Iowa","Woodbury County",1,41,1316,667,649
050,19,193,"Iowa","Woodbury County",1,42,1300,672,628
050,19,193,"Iowa","Woodbury County",1,43,1216,618,598
050,19,193,"Iowa","Woodbury County",1,44,1206,619,587
050,19,193,"Iowa","Woodbury County",1,45,1176,597,579
050,19,193,"Iowa","Woodbury County",1,46,1168,562,606
050,19,193,"Iowa","Woodbury County",1,47,1215,583,632
050,19,193,"Iowa","Woodbury County",1,48,1257,621,636
050,19,193,"Iowa","Woodbury County",1,49,1337,702,635
050,19,193,"Iowa","Woodbury County",1,50,1211,628,583
050,19,193,"Iowa","Woodbury County",1,51,1176,606,570
050,19,193,"Iowa","Woodbury County",1,52,1146,575,571
050,19,193,"Iowa","Woodbury County",1,53,1231,617,614
050,19,193,"Iowa","Woodbury County",1,54,1224,629,595
050,19,193,"Iowa","Woodbury County",1,55,1239,630,609
050,19,193,"Iowa","Woodbury County",1,56,1342,690,652
050,19,193,"Iowa","Woodbury County",1,57,1352,703,649
050,19,193,"Iowa","Woodbury County",1,58,1347,686,661
050,19,193,"Iowa","Woodbury County",1,59,1314,670,644
050,19,193,"Iowa","Woodbury County",1,60,1279,632,647
050,19,193,"Iowa","Woodbury County",1,61,1276,629,647
050,19,193,"Iowa","Woodbury County",1,62,1268,615,653
050,19,193,"Iowa","Woodbury County",1,63,1227,593,634
050,19,193,"Iowa","Woodbury County",1,64,1184,602,582
050,19,193,"Iowa","Woodbury County",1,65,1160,589,571
050,19,193,"Iowa","Woodbury County",1,66,1155,557,598
050,19,193,"Iowa","Woodbury County",1,67,1114,542,572
050,19,193,"Iowa","Woodbury County",1,68,1077,534,543
050,19,193,"Iowa","Woodbury County",1,69,988,484,504
050,19,193,"Iowa","Woodbury County",1,70,957,459,498
050,19,193,"Iowa","Woodbury County",1,71,898,416,482
050,19,193,"Iowa","Woodbury County",1,72,891,406,485
050,19,193,"Iowa","Woodbury County",1,73,877,418,459
050,19,193,"Iowa","Woodbury County",1,74,579,274,305
050,19,193,"Iowa","Woodbury County",1,75,569,243,326
050,19,193,"Iowa","Woodbury County",1,76,588,259,329
050,19,193,"Iowa","Woodbury County",1,77,586,263,323
050,19,193,"Iowa","Woodbury County",1,78,466,212,254
050,19,193,"Iowa","Woodbury County",1,79,462,216,246
050,19,193,"Iowa","Woodbury County",1,80,446,194,252
050,19,193,"Iowa","Woodbury County",1,81,384,156,228
050,19,193,"Iowa","Woodbury County",1,82,345,143,202
050,19,193,"Iowa","Woodbury County",1,83,340,134,206
050,19,193,"Iowa","Woodbury County",1,84,307,124,183
050,19,193,"Iowa","Woodbury County",1,85,1842,632,1210
050,19,193,"Iowa","Woodbury County",2,0,1442,727,715
050,19,193,"Iowa","Woodbury County",2,1,1418,720,698
050,19,193,"Iowa","Woodbury County",2,2,1435,735,700
050,19,193,"Iowa","Woodbury County",2,3,1465,751,714
050,19,193,"Iowa","Woodbury County",2,4,1487,754,733
050,19,193,"Iowa","Woodbury County",2,5,1519,759,760
050,19,193,"Iowa","Woodbury County",2,6,1514,767,747
050,19,193,"Iowa","Woodbury County",2,7,1513,789,724
050,19,193,"Iowa","Woodbury County",2,8,1497,796,701
050,19,193,"Iowa","Woodbury County",2,9,1500,763,737
050,19,193,"Iowa","Woodbury County",2,10,1557,797,760
050,19,193,"Iowa","Woodbury County",2,11,1594,801,793
050,19,193,"Iowa","Woodbury County",2,12,1667,830,837
050,19,193,"Iowa","Woodbury County",2,13,1697,856,841
050,19,193,"Iowa","Woodbury County",2,14,1628,842,786
050,19,193,"Iowa","Woodbury County",2,15,1586,822,764
050,19,193,"Iowa","Woodbury County",2,16,1611,811,800
050,19,193,"Iowa","Woodbury County",2,17,1573,807,766
050,19,193,"Iowa","Woodbury County",2,18,1475,765,710
050,19,193,"Iowa","Woodbury County",2,19,1636,867,769
050,19,193,"Iowa","Woodbury County",2,20,1578,818,760
050,19,193,"Iowa","Woodbury County",2,21,1513,733,780
050,19,193,"Iowa","Woodbury County",2,22,1396,686,710
050,19,193,"Iowa","Woodbury County",2,23,1319,664,655
050,19,193,"Iowa","Woodbury County",2,24,1331,686,645
050,19,193,"Iowa","Woodbury County",2,25,1356,701,655
050,19,193,"Iowa","Woodbury County",2,26,1352,698,654
050,19,193,"Iowa","Woodbury County",2,27,1374,722,652
050,19,193,"Iowa","Woodbury County",2,28,1402,734,668
050,19,193,"Iowa","Woodbury County",2,29,1389,739,650
050,19,193,"Iowa","Woodbury County",2,30,1376,724,652
050,19,193,"Iowa","Woodbury County",2,31,1303,684,619
050,19,193,"Iowa","Woodbury County",2,32,1295,679,616
050,19,193,"Iowa","Woodbury County",2,33,1337,709,628
050,19,193,"Iowa","Woodbury County",2,34,1364,713,651
050,19,193,"Iowa","Woodbury County",2,35,1402,747,655
050,19,193,"Iowa","Woodbury County",2,36,1404,737,667
050,19,193,"Iowa","Woodbury County",2,37,1416,720,696
050,19,193,"Iowa","Woodbury County",2,38,1403,724,679
050,19,193,"Iowa","Woodbury County",2,39,1361,707,654
050,19,193,"Iowa","Woodbury County",2,40,1397,707,690
050,19,193,"Iowa","Woodbury County",2,41,1335,677,658
050,19,193,"Iowa","Woodbury County",2,42,1299,667,632
050,19,193,"Iowa","Woodbury County",2,43,1244,636,608
050,19,193,"Iowa","Woodbury County",2,44,1201,616,585
050,19,193,"Iowa","Woodbury County",2,45,1187,605,582
050,19,193,"Iowa","Woodbury County",2,46,1162,567,595
050,19,193,"Iowa","Woodbury County",2,47,1198,579,619
050,19,193,"Iowa","Woodbury County",2,48,1239,612,627
050,19,193,"Iowa","Woodbury County",2,49,1322,687,635
050,19,193,"Iowa","Woodbury County",2,50,1234,642,592
050,19,193,"Iowa","Woodbury County",2,51,1179,610,569
050,19,193,"Iowa","Woodbury County",2,52,1154,585,569
050,19,193,"Iowa","Woodbury County",2,53,1205,606,599
050,19,193,"Iowa","Woodbury County",2,54,1215,619,596
050,19,193,"Iowa","Woodbury County",2,55,1229,627,602
050,19,193,"Iowa","Woodbury County",2,56,1316,674,642
050,19,193,"Iowa","Woodbury County",2,57,1344,697,647
050,19,193,"Iowa","Woodbury County",2,58,1346,689,657
050,19,193,"Iowa","Woodbury County",2,59,1323,674,649
050,19,193,"Iowa","Woodbury County",2,60,1278,634,644
050,19,193,"Iowa","Woodbury County",2,61,1267,622,645
050,19,193,"Iowa","Woodbury County",2,62,1260,616,644
050,19,193,"Iowa","Woodbury County",2,63,1234,592,642
050,19,193,"Iowa","Woodbury County",2,64,1177,594,583
050,19,193,"Iowa","Woodbury County",2,65,1159,587,572
050,19,193,"Iowa","Woodbury County",2,66,1148,560,588
050,19,193,"Iowa","Woodbury County",2,67,1107,536,571
050,19,193,"Iowa","Woodbury County",2,68,1075,532,543
050,19,193,"Iowa","Woodbury County",2,69,1009,493,516
050,19,193,"Iowa","Woodbury County",2,70,948,459,489
050,19,193,"Iowa","Woodbury County",2,71,909,424,485
050,19,193,"Iowa","Woodbury County",2,72,873,397,476
050,19,193,"Iowa","Woodbury County",2,73,917,431,486
050,19,193,"Iowa","Woodbury County",2,74,609,289,320
050,19,193,"Iowa","Woodbury County",2,75,571,249,322
050,19,193,"Iowa","Woodbury County",2,76,575,252,323
050,19,193,"Iowa","Woodbury County",2,77,595,264,331
050,19,193,"Iowa","Woodbury County",2,78,479,214,265
050,19,193,"Iowa","Woodbury County",2,79,452,210,242
050,19,193,"Iowa","Woodbury County",2,80,440,196,244
050,19,193,"Iowa","Woodbury County",2,81,396,162,234
050,19,193,"Iowa","Woodbury County",2,82,346,144,202
050,19,193,"Iowa","Woodbury County",2,83,332,130,202
050,19,193,"Iowa","Woodbury County",2,84,307,125,182
050,19,193,"Iowa","Woodbury County",2,85,1835,634,1201
050,19,193,"Iowa","Woodbury County",3,0,1368,660,708
050,19,193,"Iowa","Woodbury County",3,1,1443,747,696
050,19,193,"Iowa","Woodbury County",3,2,1425,726,699
050,19,193,"Iowa","Woodbury County",3,3,1459,741,718
050,19,193,"Iowa","Woodbury County",3,4,1468,744,724
050,19,193,"Iowa","Woodbury County",3,5,1481,755,726
050,19,193,"Iowa","Woodbury County",3,6,1515,765,750
050,19,193,"Iowa","Woodbury County",3,7,1533,781,752
050,19,193,"Iowa","Woodbury County",3,8,1495,781,714
050,19,193,"Iowa","Woodbury County",3,9,1497,788,709
050,19,193,"Iowa","Woodbury County",3,10,1475,756,719
050,19,193,"Iowa","Woodbury County",3,11,1559,793,766
050,19,193,"Iowa","Woodbury County",3,12,1610,807,803
050,19,193,"Iowa","Woodbury County",3,13,1675,837,838
050,19,193,"Iowa","Woodbury County",3,14,1708,860,848
050,19,193,"Iowa","Woodbury County",3,15,1635,838,797
050,19,193,"Iowa","Woodbury County",3,16,1586,830,756
050,19,193,"Iowa","Woodbury County",3,17,1602,807,795
050,19,193,"Iowa","Woodbury County",3,18,1530,778,752
050,19,193,"Iowa","Woodbury County",3,19,1621,862,759
050,19,193,"Iowa","Woodbury County",3,20,1556,810,746
050,19,193,"Iowa","Woodbury County",3,21,1528,748,780
050,19,193,"Iowa","Woodbury County",3,22,1396,691,705
050,19,193,"Iowa","Woodbury County",3,23,1325,664,661
050,19,193,"Iowa","Woodbury County",3,24,1367,687,680
050,19,193,"Iowa","Woodbury County",3,25,1302,670,632
050,19,193,"Iowa","Woodbury County",3,26,1363,708,655
050,19,193,"Iowa","Woodbury County",3,27,1376,702,674
050,19,193,"Iowa","Woodbury County",3,28,1379,720,659
050,19,193,"Iowa","Woodbury County",3,29,1452,771,681
050,19,193,"Iowa","Woodbury County",3,30,1348,706,642
050,19,193,"Iowa","Woodbury County",3,31,1392,726,666
050,19,193,"Iowa","Woodbury County",3,32,1281,664,617
050,19,193,"Iowa","Woodbury County",3,33,1264,668,596
050,19,193,"Iowa","Woodbury County",3,34,1299,672,627
050,19,193,"Iowa","Woodbury County",3,35,1362,709,653
050,19,193,"Iowa","Woodbury County",3,36,1425,774,651
050,19,193,"Iowa","Woodbury County",3,37,1383,720,663
050,19,193,"Iowa","Woodbury County",3,38,1392,721,671
050,19,193,"Iowa","Woodbury County",3,39,1391,720,671
050,19,193,"Iowa","Woodbury County",3,40,1374,709,665
050,19,193,"Iowa","Woodbury County",3,41,1397,710,687
050,19,193,"Iowa","Woodbury County",3,42,1307,657,650
050,19,193,"Iowa","Woodbury County",3,43,1259,633,626
050,19,193,"Iowa","Woodbury County",3,44,1247,638,609
050,19,193,"Iowa","Woodbury County",3,45,1190,599,591
050,19,193,"Iowa","Woodbury County",3,46,1179,594,585
050,19,193,"Iowa","Woodbury County",3,47,1165,569,596
050,19,193,"Iowa","Woodbury County",3,48,1167,558,609
050,19,193,"Iowa","Woodbury County",3,49,1249,610,639
050,19,193,"Iowa","Woodbury County",3,50,1317,692,625
050,19,193,"Iowa","Woodbury County",3,51,1236,648,588
050,19,193,"Iowa","Woodbury County",3,52,1179,606,573
050,19,193,"Iowa","Woodbury County",3,53,1142,587,555
050,19,193,"Iowa","Woodbury County",3,54,1190,594,596
050,19,193,"Iowa","Woodbury County",3,55,1208,617,591
050,19,193,"Iowa","Woodbury County",3,56,1232,621,611
050,19,193,"Iowa","Woodbury County",3,57,1285,654,631
050,19,193,"Iowa","Woodbury County",3,58,1337,692,645
050,19,193,"Iowa","Woodbury County",3,59,1326,682,644
050,19,193,"Iowa","Woodbury County",3,60,1298,657,641
050,19,193,"Iowa","Woodbury County",3,61,1274,625,649
050,19,193,"Iowa","Woodbury County",3,62,1245,615,630
050,19,193,"Iowa","Woodbury County",3,63,1215,594,621
050,19,193,"Iowa","Woodbury County",3,64,1195,575,620
050,19,193,"Iowa","Woodbury County",3,65,1140,566,574
050,19,193,"Iowa","Woodbury County",3,66,1118,567,551
050,19,193,"Iowa","Woodbury County",3,67,1115,545,570
050,19,193,"Iowa","Woodbury County",3,68,1089,516,573
050,19,193,"Iowa","Woodbury County",3,69,1032,511,521
050,19,193,"Iowa","Woodbury County",3,70,977,473,504
050,19,193,"Iowa","Woodbury County",3,71,935,449,486
050,19,193,"Iowa","Woodbury County",3,72,867,402,465
050,19,193,"Iowa","Woodbury County",3,73,853,393,460
050,19,193,"Iowa","Woodbury County",3,74,874,404,470
050,19,193,"Iowa","Woodbury County",3,75,582,273,309
050,19,193,"Iowa","Woodbury County",3,76,537,237,300
050,19,193,"Iowa","Woodbury County",3,77,550,229,321
050,19,193,"Iowa","Woodbury County",3,78,563,245,318
050,19,193,"Iowa","Woodbury County",3,79,456,211,245
050,19,193,"Iowa","Woodbury County",3,80,417,193,224
050,19,193,"Iowa","Woodbury County",3,81,425,186,239
050,19,193,"Iowa","Woodbury County",3,82,358,153,205
050,19,193,"Iowa","Woodbury County",3,83,313,117,196
050,19,193,"Iowa","Woodbury County",3,84,301,116,185
050,19,193,"Iowa","Woodbury County",3,85,1768,626,1142
050,19,193,"Iowa","Woodbury County",4,0,1415,666,749
050,19,193,"Iowa","Woodbury County",4,1,1332,645,687
050,19,193,"Iowa","Woodbury County",4,2,1476,754,722
050,19,193,"Iowa","Woodbury County",4,3,1403,703,700
050,19,193,"Iowa","Woodbury County",4,4,1459,742,717
050,19,193,"Iowa","Woodbury County",4,5,1460,745,715
050,19,193,"Iowa","Woodbury County",4,6,1420,726,694
050,19,193,"Iowa","Woodbury County",4,7,1504,774,730
050,19,193,"Iowa","Woodbury County",4,8,1514,777,737
050,19,193,"Iowa","Woodbury County",4,9,1493,777,716
050,19,193,"Iowa","Woodbury County",4,10,1473,778,695
050,19,193,"Iowa","Woodbury County",4,11,1456,741,715
050,19,193,"Iowa","Woodbury County",4,12,1560,802,758
050,19,193,"Iowa","Woodbury County",4,13,1607,806,801
050,19,193,"Iowa","Woodbury County",4,14,1695,858,837
050,19,193,"Iowa","Woodbury County",4,15,1711,853,858
050,19,193,"Iowa","Woodbury County",4,16,1670,858,812
050,19,193,"Iowa","Woodbury County",4,17,1565,817,748
050,19,193,"Iowa","Woodbury County",4,18,1556,775,781
050,19,193,"Iowa","Woodbury County",4,19,1666,884,782
050,19,193,"Iowa","Woodbury County",4,20,1518,788,730
050,19,193,"Iowa","Woodbury County",4,21,1495,754,741
050,19,193,"Iowa","Woodbury County",4,22,1476,753,723
050,19,193,"Iowa","Woodbury County",4,23,1358,685,673
050,19,193,"Iowa","Woodbury County",4,24,1368,699,669
050,19,193,"Iowa","Woodbury County",4,25,1383,688,695
050,19,193,"Iowa","Woodbury County",4,26,1284,667,617
050,19,193,"Iowa","Woodbury County",4,27,1374,713,661
050,19,193,"Iowa","Woodbury County",4,28,1386,728,658
050,19,193,"Iowa","Woodbury County",4,29,1385,739,646
050,19,193,"Iowa","Woodbury County",4,30,1450,778,672
050,19,193,"Iowa","Woodbury County",4,31,1372,726,646
050,19,193,"Iowa","Woodbury County",4,32,1394,734,660
050,19,193,"Iowa","Woodbury County",4,33,1287,683,604
050,19,193,"Iowa","Woodbury County",4,34,1268,653,615
050,19,193,"Iowa","Woodbury County",4,35,1311,676,635
050,19,193,"Iowa","Woodbury County",4,36,1337,692,645
050,19,193,"Iowa","Woodbury County",4,37,1392,742,650
050,19,193,"Iowa","Woodbury County",4,38,1367,713,654
050,19,193,"Iowa","Woodbury County",4,39,1385,721,664
050,19,193,"Iowa","Woodbury County",4,40,1380,717,663
050,19,193,"Iowa","Woodbury County",4,41,1362,713,649
050,19,193,"Iowa","Woodbury County",4,42,1377,697,680
050,19,193,"Iowa","Woodbury County",4,43,1276,636,640
050,19,193,"Iowa","Woodbury County",4,44,1266,649,617
050,19,193,"Iowa","Woodbury County",4,45,1238,624,614
050,19,193,"Iowa","Woodbury County",4,46,1176,579,597
050,19,193,"Iowa","Woodbury County",4,47,1170,587,583
050,19,193,"Iowa","Woodbury County",4,48,1146,563,583
050,19,193,"Iowa","Woodbury County",4,49,1165,568,597
050,19,193,"Iowa","Woodbury County",4,50,1226,599,627
050,19,193,"Iowa","Woodbury County",4,51,1285,677,608
050,19,193,"Iowa","Woodbury County",4,52,1237,651,586
050,19,193,"Iowa","Woodbury County",4,53,1178,603,575
050,19,193,"Iowa","Woodbury County",4,54,1128,564,564
050,19,193,"Iowa","Woodbury County",4,55,1181,582,599
050,19,193,"Iowa","Woodbury County",4,56,1199,611,588
050,19,193,"Iowa","Woodbury County",4,57,1207,611,596
050,19,193,"Iowa","Woodbury County",4,58,1275,653,622
050,19,193,"Iowa","Woodbury County",4,59,1329,687,642
050,19,193,"Iowa","Woodbury County",4,60,1302,655,647
050,19,193,"Iowa","Woodbury County",4,61,1291,646,645
050,19,193,"Iowa","Woodbury County",4,62,1254,624,630
050,19,193,"Iowa","Woodbury County",4,63,1213,603,610
050,19,193,"Iowa","Woodbury County",4,64,1186,585,601
050,19,193,"Iowa","Woodbury County",4,65,1164,554,610
050,19,193,"Iowa","Woodbury County",4,66,1103,547,556
050,19,193,"Iowa","Woodbury County",4,67,1065,540,525
050,19,193,"Iowa","Woodbury County",4,68,1094,532,562
050,19,193,"Iowa","Woodbury County",4,69,1058,497,561
050,19,193,"Iowa","Woodbury County",4,70,1005,490,515
050,19,193,"Iowa","Woodbury County",4,71,960,463,497
050,19,193,"Iowa","Woodbury County",4,72,905,433,472
050,19,193,"Iowa","Woodbury County",4,73,848,393,455
050,19,193,"Iowa","Woodbury County",4,74,822,376,446
050,19,193,"Iowa","Woodbury County",4,75,845,392,453
050,19,193,"Iowa","Woodbury County",4,76,542,251,291
050,19,193,"Iowa","Woodbury County",4,77,513,218,295
050,19,193,"Iowa","Woodbury County",4,78,524,215,309
050,19,193,"Iowa","Woodbury County",4,79,533,247,286
050,19,193,"Iowa","Woodbury County",4,80,428,195,233
050,19,193,"Iowa","Woodbury County",4,81,395,184,211
050,19,193,"Iowa","Woodbury County",4,82,387,178,209
050,19,193,"Iowa","Woodbury County",4,83,328,130,198
050,19,193,"Iowa","Woodbury County",4,84,277,104,173
050,19,193,"Iowa","Woodbury County",4,85,1690,610,1080
050,19,193,"Iowa","Woodbury County",5,0,1416,667,749
050,19,193,"Iowa","Woodbury County",5,1,1427,665,762
050,19,193,"Iowa","Woodbury County",5,2,1327,634,693
050,19,193,"Iowa","Woodbury County",5,3,1473,753,720
050,19,193,"Iowa","Woodbury County",5,4,1386,701,685
050,19,193,"Iowa","Woodbury County",5,5,1454,752,702
050,19,193,"Iowa","Woodbury County",5,6,1466,753,713
050,19,193,"Iowa","Woodbury County",5,7,1440,744,696
050,19,193,"Iowa","Woodbury County",5,8,1492,775,717
050,19,193,"Iowa","Woodbury County",5,9,1513,769,744
050,19,193,"Iowa","Woodbury County",5,10,1476,778,698
050,19,193,"Iowa","Woodbury County",5,11,1460,780,680
050,19,193,"Iowa","Woodbury County",5,12,1455,738,717
050,19,193,"Iowa","Woodbury County",5,13,1570,809,761
050,19,193,"Iowa","Woodbury County",5,14,1644,826,818
050,19,193,"Iowa","Woodbury County",5,15,1721,873,848
050,19,193,"Iowa","Woodbury County",5,16,1733,867,866
050,19,193,"Iowa","Woodbury County",5,17,1663,849,814
050,19,193,"Iowa","Woodbury County",5,18,1513,782,731
050,19,193,"Iowa","Woodbury County",5,19,1710,885,825
050,19,193,"Iowa","Woodbury County",5,20,1611,835,776
050,19,193,"Iowa","Woodbury County",5,21,1490,745,745
050,19,193,"Iowa","Woodbury County",5,22,1451,731,720
050,19,193,"Iowa","Woodbury County",5,23,1403,720,683
050,19,193,"Iowa","Woodbury County",5,24,1372,698,674
050,19,193,"Iowa","Woodbury County",5,25,1376,713,663
050,19,193,"Iowa","Woodbury County",5,26,1388,714,674
050,19,193,"Iowa","Woodbury County",5,27,1297,681,616
050,19,193,"Iowa","Woodbury County",5,28,1396,752,644
050,19,193,"Iowa","Woodbury County",5,29,1382,737,645
050,19,193,"Iowa","Woodbury County",5,30,1378,737,641
050,19,193,"Iowa","Woodbury County",5,31,1422,753,669
050,19,193,"Iowa","Woodbury County",5,32,1372,725,647
050,19,193,"Iowa","Woodbury County",5,33,1383,728,655
050,19,193,"Iowa","Woodbury County",5,34,1319,699,620
050,19,193,"Iowa","Woodbury County",5,35,1280,657,623
050,19,193,"Iowa","Woodbury County",5,36,1300,677,623
050,19,193,"Iowa","Woodbury County",5,37,1350,683,667
050,19,193,"Iowa","Woodbury County",5,38,1408,748,660
050,19,193,"Iowa","Woodbury County",5,39,1389,723,666
050,19,193,"Iowa","Woodbury County",5,40,1381,719,662
050,19,193,"Iowa","Woodbury County",5,41,1377,721,656
050,19,193,"Iowa","Woodbury County",5,42,1372,715,657
050,19,193,"Iowa","Woodbury County",5,43,1349,677,672
050,19,193,"Iowa","Woodbury County",5,44,1320,669,651
050,19,193,"Iowa","Woodbury County",5,45,1250,635,615
050,19,193,"Iowa","Woodbury County",5,46,1222,615,607
050,19,193,"Iowa","Woodbury County",5,47,1180,585,595
050,19,193,"Iowa","Woodbury County",5,48,1145,576,569
050,19,193,"Iowa","Woodbury County",5,49,1150,571,579
050,19,193,"Iowa","Woodbury County",5,50,1146,554,592
050,19,193,"Iowa","Woodbury County",5,51,1227,609,618
050,19,193,"Iowa","Woodbury County",5,52,1291,683,608
050,19,193,"Iowa","Woodbury County",5,53,1220,646,574
050,19,193,"Iowa","Woodbury County",5,54,1181,606,575
050,19,193,"Iowa","Woodbury County",5,55,1098,546,552
050,19,193,"Iowa","Woodbury County",5,56,1162,565,597
050,19,193,"Iowa","Woodbury County",5,57,1195,604,591
050,19,193,"Iowa","Woodbury County",5,58,1206,606,600
050,19,193,"Iowa","Woodbury County",5,59,1262,653,609
050,19,193,"Iowa","Woodbury County",5,60,1305,668,637
050,19,193,"Iowa","Woodbury County",5,61,1284,643,641
050,19,193,"Iowa","Woodbury County",5,62,1251,630,621
050,19,193,"Iowa","Woodbury County",5,63,1217,612,605
050,19,193,"Iowa","Woodbury County",5,64,1183,592,591
050,19,193,"Iowa","Woodbury County",5,65,1153,557,596
050,19,193,"Iowa","Woodbury County",5,66,1129,534,595
050,19,193,"Iowa","Woodbury County",5,67,1086,532,554
050,19,193,"Iowa","Woodbury County",5,68,1050,534,516
050,19,193,"Iowa","Woodbury County",5,69,1068,516,552
050,19,193,"Iowa","Woodbury County",5,70,1033,480,553
050,19,193,"Iowa","Woodbury County",5,71,974,471,503
050,19,193,"Iowa","Woodbury County",5,72,937,449,488
050,19,193,"Iowa","Woodbury County",5,73,891,429,462
050,19,193,"Iowa","Woodbury County",5,74,815,371,444
050,19,193,"Iowa","Woodbury County",5,75,791,364,427
050,19,193,"Iowa","Woodbury County",5,76,806,370,436
050,19,193,"Iowa","Woodbury County",5,77,524,232,292
050,19,193,"Iowa","Woodbury County",5,78,490,206,284
050,19,193,"Iowa","Woodbury County",5,79,503,215,288
050,19,193,"Iowa","Woodbury County",5,80,510,232,278
050,19,193,"Iowa","Woodbury County",5,81,424,193,231
050,19,193,"Iowa","Woodbury County",5,82,363,173,190
050,19,193,"Iowa","Woodbury County",5,83,365,159,206
050,19,193,"Iowa","Woodbury County",5,84,300,120,180
050,19,193,"Iowa","Woodbury County",5,85,1659,596,1063
050,19,195,"Iowa","Worth County",1,0,79,42,37
050,19,195,"Iowa","Worth County",1,1,85,49,36
050,19,195,"Iowa","Worth County",1,2,89,55,34
050,19,195,"Iowa","Worth County",1,3,92,53,39
050,19,195,"Iowa","Worth County",1,4,94,50,44
050,19,195,"Iowa","Worth County",1,5,83,44,39
050,19,195,"Iowa","Worth County",1,6,68,36,32
050,19,195,"Iowa","Worth County",1,7,86,45,41
050,19,195,"Iowa","Worth County",1,8,91,50,41
050,19,195,"Iowa","Worth County",1,9,85,43,42
050,19,195,"Iowa","Worth County",1,10,88,39,49
050,19,195,"Iowa","Worth County",1,11,91,48,43
050,19,195,"Iowa","Worth County",1,12,94,46,48
050,19,195,"Iowa","Worth County",1,13,93,51,42
050,19,195,"Iowa","Worth County",1,14,81,47,34
050,19,195,"Iowa","Worth County",1,15,94,49,45
050,19,195,"Iowa","Worth County",1,16,102,50,52
050,19,195,"Iowa","Worth County",1,17,84,45,39
050,19,195,"Iowa","Worth County",1,18,66,34,32
050,19,195,"Iowa","Worth County",1,19,58,30,28
050,19,195,"Iowa","Worth County",1,20,78,34,44
050,19,195,"Iowa","Worth County",1,21,76,36,40
050,19,195,"Iowa","Worth County",1,22,76,30,46
050,19,195,"Iowa","Worth County",1,23,62,34,28
050,19,195,"Iowa","Worth County",1,24,81,43,38
050,19,195,"Iowa","Worth County",1,25,94,47,47
050,19,195,"Iowa","Worth County",1,26,97,43,54
050,19,195,"Iowa","Worth County",1,27,90,39,51
050,19,195,"Iowa","Worth County",1,28,108,57,51
050,19,195,"Iowa","Worth County",1,29,86,52,34
050,19,195,"Iowa","Worth County",1,30,80,41,39
050,19,195,"Iowa","Worth County",1,31,76,41,35
050,19,195,"Iowa","Worth County",1,32,75,34,41
050,19,195,"Iowa","Worth County",1,33,74,37,37
050,19,195,"Iowa","Worth County",1,34,66,32,34
050,19,195,"Iowa","Worth County",1,35,84,44,40
050,19,195,"Iowa","Worth County",1,36,97,50,47
050,19,195,"Iowa","Worth County",1,37,95,57,38
050,19,195,"Iowa","Worth County",1,38,112,68,44
050,19,195,"Iowa","Worth County",1,39,94,50,44
050,19,195,"Iowa","Worth County",1,40,84,43,41
050,19,195,"Iowa","Worth County",1,41,81,37,44
050,19,195,"Iowa","Worth County",1,42,90,47,43
050,19,195,"Iowa","Worth County",1,43,80,47,33
050,19,195,"Iowa","Worth County",1,44,78,46,32
050,19,195,"Iowa","Worth County",1,45,73,36,37
050,19,195,"Iowa","Worth County",1,46,93,45,48
050,19,195,"Iowa","Worth County",1,47,86,42,44
050,19,195,"Iowa","Worth County",1,48,87,43,44
050,19,195,"Iowa","Worth County",1,49,99,45,54
050,19,195,"Iowa","Worth County",1,50,103,52,51
050,19,195,"Iowa","Worth County",1,51,87,42,45
050,19,195,"Iowa","Worth County",1,52,93,45,48
050,19,195,"Iowa","Worth County",1,53,103,56,47
050,19,195,"Iowa","Worth County",1,54,100,56,44
050,19,195,"Iowa","Worth County",1,55,104,52,52
050,19,195,"Iowa","Worth County",1,56,113,63,50
050,19,195,"Iowa","Worth County",1,57,126,66,60
050,19,195,"Iowa","Worth County",1,58,121,64,57
050,19,195,"Iowa","Worth County",1,59,118,61,57
050,19,195,"Iowa","Worth County",1,60,99,58,41
050,19,195,"Iowa","Worth County",1,61,110,58,52
050,19,195,"Iowa","Worth County",1,62,121,61,60
050,19,195,"Iowa","Worth County",1,63,102,53,49
050,19,195,"Iowa","Worth County",1,64,111,57,54
050,19,195,"Iowa","Worth County",1,65,121,62,59
050,19,195,"Iowa","Worth County",1,66,121,59,62
050,19,195,"Iowa","Worth County",1,67,112,60,52
050,19,195,"Iowa","Worth County",1,68,97,48,49
050,19,195,"Iowa","Worth County",1,69,83,39,44
050,19,195,"Iowa","Worth County",1,70,84,44,40
050,19,195,"Iowa","Worth County",1,71,82,50,32
050,19,195,"Iowa","Worth County",1,72,78,35,43
050,19,195,"Iowa","Worth County",1,73,84,37,47
050,19,195,"Iowa","Worth County",1,74,58,31,27
050,19,195,"Iowa","Worth County",1,75,58,30,28
050,19,195,"Iowa","Worth County",1,76,59,27,32
050,19,195,"Iowa","Worth County",1,77,49,19,30
050,19,195,"Iowa","Worth County",1,78,49,27,22
050,19,195,"Iowa","Worth County",1,79,44,28,16
050,19,195,"Iowa","Worth County",1,80,49,28,21
050,19,195,"Iowa","Worth County",1,81,36,19,17
050,19,195,"Iowa","Worth County",1,82,36,19,17
050,19,195,"Iowa","Worth County",1,83,43,22,21
050,19,195,"Iowa","Worth County",1,84,34,14,20
050,19,195,"Iowa","Worth County",1,85,202,64,138
050,19,195,"Iowa","Worth County",2,0,76,36,40
050,19,195,"Iowa","Worth County",2,1,85,48,37
050,19,195,"Iowa","Worth County",2,2,89,53,36
050,19,195,"Iowa","Worth County",2,3,92,54,38
050,19,195,"Iowa","Worth County",2,4,96,51,45
050,19,195,"Iowa","Worth County",2,5,86,45,41
050,19,195,"Iowa","Worth County",2,6,73,38,35
050,19,195,"Iowa","Worth County",2,7,81,42,39
050,19,195,"Iowa","Worth County",2,8,89,48,41
050,19,195,"Iowa","Worth County",2,9,88,46,42
050,19,195,"Iowa","Worth County",2,10,87,40,47
050,19,195,"Iowa","Worth County",2,11,89,45,44
050,19,195,"Iowa","Worth County",2,12,93,47,46
050,19,195,"Iowa","Worth County",2,13,91,49,42
050,19,195,"Iowa","Worth County",2,14,84,48,36
050,19,195,"Iowa","Worth County",2,15,91,48,43
050,19,195,"Iowa","Worth County",2,16,100,50,50
050,19,195,"Iowa","Worth County",2,17,87,46,41
050,19,195,"Iowa","Worth County",2,18,66,34,32
050,19,195,"Iowa","Worth County",2,19,56,29,27
050,19,195,"Iowa","Worth County",2,20,74,33,41
050,19,195,"Iowa","Worth County",2,21,77,35,42
050,19,195,"Iowa","Worth County",2,22,75,31,44
050,19,195,"Iowa","Worth County",2,23,66,33,33
050,19,195,"Iowa","Worth County",2,24,74,39,35
050,19,195,"Iowa","Worth County",2,25,91,47,44
050,19,195,"Iowa","Worth County",2,26,95,43,52
050,19,195,"Iowa","Worth County",2,27,93,41,52
050,19,195,"Iowa","Worth County",2,28,104,53,51
050,19,195,"Iowa","Worth County",2,29,92,54,38
050,19,195,"Iowa","Worth County",2,30,85,46,39
050,19,195,"Iowa","Worth County",2,31,79,42,37
050,19,195,"Iowa","Worth County",2,32,77,37,40
050,19,195,"Iowa","Worth County",2,33,73,36,37
050,19,195,"Iowa","Worth County",2,34,67,33,34
050,19,195,"Iowa","Worth County",2,35,82,42,40
050,19,195,"Iowa","Worth County",2,36,93,49,44
050,19,195,"Iowa","Worth County",2,37,95,55,40
050,19,195,"Iowa","Worth County",2,38,108,65,43
050,19,195,"Iowa","Worth County",2,39,97,54,43
050,19,195,"Iowa","Worth County",2,40,87,44,43
050,19,195,"Iowa","Worth County",2,41,81,38,43
050,19,195,"Iowa","Worth County",2,42,88,45,43
050,19,195,"Iowa","Worth County",2,43,84,47,37
050,19,195,"Iowa","Worth County",2,44,77,45,32
050,19,195,"Iowa","Worth County",2,45,76,39,37
050,19,195,"Iowa","Worth County",2,46,87,42,45
050,19,195,"Iowa","Worth County",2,47,87,42,45
050,19,195,"Iowa","Worth County",2,48,87,43,44
050,19,195,"Iowa","Worth County",2,49,95,44,51
050,19,195,"Iowa","Worth County",2,50,102,51,51
050,19,195,"Iowa","Worth County",2,51,90,44,46
050,19,195,"Iowa","Worth County",2,52,91,44,47
050,19,195,"Iowa","Worth County",2,53,100,53,47
050,19,195,"Iowa","Worth County",2,54,101,56,45
050,19,195,"Iowa","Worth County",2,55,104,53,51
050,19,195,"Iowa","Worth County",2,56,110,60,50
050,19,195,"Iowa","Worth County",2,57,121,64,57
050,19,195,"Iowa","Worth County",2,58,119,62,57
050,19,195,"Iowa","Worth County",2,59,119,61,58
050,19,195,"Iowa","Worth County",2,60,102,58,44
050,19,195,"Iowa","Worth County",2,61,106,57,49
050,19,195,"Iowa","Worth County",2,62,117,60,57
050,19,195,"Iowa","Worth County",2,63,108,56,52
050,19,195,"Iowa","Worth County",2,64,108,56,52
050,19,195,"Iowa","Worth County",2,65,118,60,58
050,19,195,"Iowa","Worth County",2,66,122,60,62
050,19,195,"Iowa","Worth County",2,67,116,61,55
050,19,195,"Iowa","Worth County",2,68,99,50,49
050,19,195,"Iowa","Worth County",2,69,86,41,45
050,19,195,"Iowa","Worth County",2,70,82,42,40
050,19,195,"Iowa","Worth County",2,71,81,48,33
050,19,195,"Iowa","Worth County",2,72,78,38,40
050,19,195,"Iowa","Worth County",2,73,87,38,49
050,19,195,"Iowa","Worth County",2,74,59,30,29
050,19,195,"Iowa","Worth County",2,75,58,30,28
050,19,195,"Iowa","Worth County",2,76,57,27,30
050,19,195,"Iowa","Worth County",2,77,52,21,31
050,19,195,"Iowa","Worth County",2,78,48,25,23
050,19,195,"Iowa","Worth County",2,79,44,27,17
050,19,195,"Iowa","Worth County",2,80,48,28,20
050,19,195,"Iowa","Worth County",2,81,39,21,18
050,19,195,"Iowa","Worth County",2,82,35,18,17
050,19,195,"Iowa","Worth County",2,83,40,21,19
050,19,195,"Iowa","Worth County",2,84,36,15,21
050,19,195,"Iowa","Worth County",2,85,208,67,141
050,19,195,"Iowa","Worth County",3,0,75,32,43
050,19,195,"Iowa","Worth County",3,1,77,35,42
050,19,195,"Iowa","Worth County",3,2,84,47,37
050,19,195,"Iowa","Worth County",3,3,81,48,33
050,19,195,"Iowa","Worth County",3,4,91,52,39
050,19,195,"Iowa","Worth County",3,5,91,46,45
050,19,195,"Iowa","Worth County",3,6,84,43,41
050,19,195,"Iowa","Worth County",3,7,70,37,33
050,19,195,"Iowa","Worth County",3,8,82,43,39
050,19,195,"Iowa","Worth County",3,9,91,50,41
050,19,195,"Iowa","Worth County",3,10,91,49,42
050,19,195,"Iowa","Worth County",3,11,92,43,49
050,19,195,"Iowa","Worth County",3,12,85,42,43
050,19,195,"Iowa","Worth County",3,13,88,46,42
050,19,195,"Iowa","Worth County",3,14,94,49,45
050,19,195,"Iowa","Worth County",3,15,81,48,33
050,19,195,"Iowa","Worth County",3,16,87,46,41
050,19,195,"Iowa","Worth County",3,17,101,52,49
050,19,195,"Iowa","Worth County",3,18,72,39,33
050,19,195,"Iowa","Worth County",3,19,53,28,25
050,19,195,"Iowa","Worth County",3,20,63,30,33
050,19,195,"Iowa","Worth County",3,21,77,39,38
050,19,195,"Iowa","Worth County",3,22,79,36,43
050,19,195,"Iowa","Worth County",3,23,80,37,43
050,19,195,"Iowa","Worth County",3,24,68,32,36
050,19,195,"Iowa","Worth County",3,25,67,40,27
050,19,195,"Iowa","Worth County",3,26,91,49,42
050,19,195,"Iowa","Worth County",3,27,89,41,48
050,19,195,"Iowa","Worth County",3,28,90,39,51
050,19,195,"Iowa","Worth County",3,29,99,49,50
050,19,195,"Iowa","Worth County",3,30,96,54,42
050,19,195,"Iowa","Worth County",3,31,87,47,40
050,19,195,"Iowa","Worth County",3,32,74,40,34
050,19,195,"Iowa","Worth County",3,33,76,38,38
050,19,195,"Iowa","Worth County",3,34,76,35,41
050,19,195,"Iowa","Worth County",3,35,74,39,35
050,19,195,"Iowa","Worth County",3,36,80,45,35
050,19,195,"Iowa","Worth County",3,37,94,50,44
050,19,195,"Iowa","Worth County",3,38,90,53,37
050,19,195,"Iowa","Worth County",3,39,106,65,41
050,19,195,"Iowa","Worth County",3,40,103,57,46
050,19,195,"Iowa","Worth County",3,41,86,44,42
050,19,195,"Iowa","Worth County",3,42,77,38,39
050,19,195,"Iowa","Worth County",3,43,88,45,43
050,19,195,"Iowa","Worth County",3,44,85,47,38
050,19,195,"Iowa","Worth County",3,45,82,49,33
050,19,195,"Iowa","Worth County",3,46,80,41,39
050,19,195,"Iowa","Worth County",3,47,86,42,44
050,19,195,"Iowa","Worth County",3,48,89,43,46
050,19,195,"Iowa","Worth County",3,49,89,47,42
050,19,195,"Iowa","Worth County",3,50,94,42,52
050,19,195,"Iowa","Worth County",3,51,98,51,47
050,19,195,"Iowa","Worth County",3,52,90,45,45
050,19,195,"Iowa","Worth County",3,53,89,44,45
050,19,195,"Iowa","Worth County",3,54,99,52,47
050,19,195,"Iowa","Worth County",3,55,100,55,45
050,19,195,"Iowa","Worth County",3,56,100,50,50
050,19,195,"Iowa","Worth County",3,57,110,61,49
050,19,195,"Iowa","Worth County",3,58,118,62,56
050,19,195,"Iowa","Worth County",3,59,113,58,55
050,19,195,"Iowa","Worth County",3,60,118,61,57
050,19,195,"Iowa","Worth County",3,61,103,60,43
050,19,195,"Iowa","Worth County",3,62,106,56,50
050,19,195,"Iowa","Worth County",3,63,109,58,51
050,19,195,"Iowa","Worth County",3,64,106,57,49
050,19,195,"Iowa","Worth County",3,65,105,55,50
050,19,195,"Iowa","Worth County",3,66,114,55,59
050,19,195,"Iowa","Worth County",3,67,125,62,63
050,19,195,"Iowa","Worth County",3,68,112,59,53
050,19,195,"Iowa","Worth County",3,69,98,48,50
050,19,195,"Iowa","Worth County",3,70,87,42,45
050,19,195,"Iowa","Worth County",3,71,82,44,38
050,19,195,"Iowa","Worth County",3,72,84,48,36
050,19,195,"Iowa","Worth County",3,73,78,38,40
050,19,195,"Iowa","Worth County",3,74,86,37,49
050,19,195,"Iowa","Worth County",3,75,60,30,30
050,19,195,"Iowa","Worth County",3,76,58,29,29
050,19,195,"Iowa","Worth County",3,77,49,20,29
050,19,195,"Iowa","Worth County",3,78,50,21,29
050,19,195,"Iowa","Worth County",3,79,45,22,23
050,19,195,"Iowa","Worth County",3,80,45,27,18
050,19,195,"Iowa","Worth County",3,81,43,22,21
050,19,195,"Iowa","Worth County",3,82,37,19,18
050,19,195,"Iowa","Worth County",3,83,33,16,17
050,19,195,"Iowa","Worth County",3,84,38,20,18
050,19,195,"Iowa","Worth County",3,85,204,68,136
050,19,195,"Iowa","Worth County",4,0,78,40,38
050,19,195,"Iowa","Worth County",4,1,74,29,45
050,19,195,"Iowa","Worth County",4,2,74,35,39
050,19,195,"Iowa","Worth County",4,3,79,45,34
050,19,195,"Iowa","Worth County",4,4,87,49,38
050,19,195,"Iowa","Worth County",4,5,91,50,41
050,19,195,"Iowa","Worth County",4,6,90,46,44
050,19,195,"Iowa","Worth County",4,7,88,44,44
050,19,195,"Iowa","Worth County",4,8,78,39,39
050,19,195,"Iowa","Worth County",4,9,80,41,39
050,19,195,"Iowa","Worth County",4,10,98,55,43
050,19,195,"Iowa","Worth County",4,11,91,49,42
050,19,195,"Iowa","Worth County",4,12,84,38,46
050,19,195,"Iowa","Worth County",4,13,88,42,46
050,19,195,"Iowa","Worth County",4,14,91,48,43
050,19,195,"Iowa","Worth County",4,15,93,49,44
050,19,195,"Iowa","Worth County",4,16,82,52,30
050,19,195,"Iowa","Worth County",4,17,88,47,41
050,19,195,"Iowa","Worth County",4,18,86,45,41
050,19,195,"Iowa","Worth County",4,19,56,31,25
050,19,195,"Iowa","Worth County",4,20,58,31,27
050,19,195,"Iowa","Worth County",4,21,61,26,35
050,19,195,"Iowa","Worth County",4,22,84,45,39
050,19,195,"Iowa","Worth County",4,23,83,36,47
050,19,195,"Iowa","Worth County",4,24,74,33,41
050,19,195,"Iowa","Worth County",4,25,69,28,41
050,19,195,"Iowa","Worth County",4,26,66,38,28
050,19,195,"Iowa","Worth County",4,27,85,46,39
050,19,195,"Iowa","Worth County",4,28,87,41,46
050,19,195,"Iowa","Worth County",4,29,87,38,49
050,19,195,"Iowa","Worth County",4,30,94,48,46
050,19,195,"Iowa","Worth County",4,31,91,51,40
050,19,195,"Iowa","Worth County",4,32,83,44,39
050,19,195,"Iowa","Worth County",4,33,74,36,38
050,19,195,"Iowa","Worth County",4,34,87,42,45
050,19,195,"Iowa","Worth County",4,35,78,37,41
050,19,195,"Iowa","Worth County",4,36,74,41,33
050,19,195,"Iowa","Worth County",4,37,79,43,36
050,19,195,"Iowa","Worth County",4,38,89,44,45
050,19,195,"Iowa","Worth County",4,39,88,53,35
050,19,195,"Iowa","Worth County",4,40,106,63,43
050,19,195,"Iowa","Worth County",4,41,104,58,46
050,19,195,"Iowa","Worth County",4,42,83,46,37
050,19,195,"Iowa","Worth County",4,43,72,35,37
050,19,195,"Iowa","Worth County",4,44,87,45,42
050,19,195,"Iowa","Worth County",4,45,82,46,36
050,19,195,"Iowa","Worth County",4,46,79,48,31
050,19,195,"Iowa","Worth County",4,47,80,40,40
050,19,195,"Iowa","Worth County",4,48,78,39,39
050,19,195,"Iowa","Worth County",4,49,83,41,42
050,19,195,"Iowa","Worth County",4,50,88,45,43
050,19,195,"Iowa","Worth County",4,51,94,41,53
050,19,195,"Iowa","Worth County",4,52,94,48,46
050,19,195,"Iowa","Worth County",4,53,91,46,45
050,19,195,"Iowa","Worth County",4,54,92,45,47
050,19,195,"Iowa","Worth County",4,55,104,55,49
050,19,195,"Iowa","Worth County",4,56,103,56,47
050,19,195,"Iowa","Worth County",4,57,97,48,49
050,19,195,"Iowa","Worth County",4,58,110,59,51
050,19,195,"Iowa","Worth County",4,59,123,66,57
050,19,195,"Iowa","Worth County",4,60,112,57,55
050,19,195,"Iowa","Worth County",4,61,116,61,55
050,19,195,"Iowa","Worth County",4,62,102,58,44
050,19,195,"Iowa","Worth County",4,63,104,55,49
050,19,195,"Iowa","Worth County",4,64,107,58,49
050,19,195,"Iowa","Worth County",4,65,104,58,46
050,19,195,"Iowa","Worth County",4,66,102,55,47
050,19,195,"Iowa","Worth County",4,67,111,55,56
050,19,195,"Iowa","Worth County",4,68,115,57,58
050,19,195,"Iowa","Worth County",4,69,109,59,50
050,19,195,"Iowa","Worth County",4,70,98,47,51
050,19,195,"Iowa","Worth County",4,71,83,40,43
050,19,195,"Iowa","Worth County",4,72,82,44,38
050,19,195,"Iowa","Worth County",4,73,85,49,36
050,19,195,"Iowa","Worth County",4,74,71,35,36
050,19,195,"Iowa","Worth County",4,75,82,36,46
050,19,195,"Iowa","Worth County",4,76,56,26,30
050,19,195,"Iowa","Worth County",4,77,57,28,29
050,19,195,"Iowa","Worth County",4,78,49,22,27
050,19,195,"Iowa","Worth County",4,79,49,20,29
050,19,195,"Iowa","Worth County",4,80,44,22,22
050,19,195,"Iowa","Worth County",4,81,43,24,19
050,19,195,"Iowa","Worth County",4,82,43,23,20
050,19,195,"Iowa","Worth County",4,83,32,16,16
050,19,195,"Iowa","Worth County",4,84,34,15,19
050,19,195,"Iowa","Worth County",4,85,204,71,133
050,19,195,"Iowa","Worth County",5,0,79,41,38
050,19,195,"Iowa","Worth County",5,1,82,40,42
050,19,195,"Iowa","Worth County",5,2,71,28,43
050,19,195,"Iowa","Worth County",5,3,80,40,40
050,19,195,"Iowa","Worth County",5,4,86,51,35
050,19,195,"Iowa","Worth County",5,5,83,46,37
050,19,195,"Iowa","Worth County",5,6,98,54,44
050,19,195,"Iowa","Worth County",5,7,93,51,42
050,19,195,"Iowa","Worth County",5,8,82,39,43
050,19,195,"Iowa","Worth County",5,9,82,40,42
050,19,195,"Iowa","Worth County",5,10,73,40,33
050,19,195,"Iowa","Worth County",5,11,98,52,46
050,19,195,"Iowa","Worth County",5,12,97,51,46
050,19,195,"Iowa","Worth County",5,13,90,39,51
050,19,195,"Iowa","Worth County",5,14,90,46,44
050,19,195,"Iowa","Worth County",5,15,97,52,45
050,19,195,"Iowa","Worth County",5,16,84,45,39
050,19,195,"Iowa","Worth County",5,17,88,53,35
050,19,195,"Iowa","Worth County",5,18,73,39,34
050,19,195,"Iowa","Worth County",5,19,65,35,30
050,19,195,"Iowa","Worth County",5,20,60,32,28
050,19,195,"Iowa","Worth County",5,21,57,31,26
050,19,195,"Iowa","Worth County",5,22,67,33,34
050,19,195,"Iowa","Worth County",5,23,88,46,42
050,19,195,"Iowa","Worth County",5,24,75,35,40
050,19,195,"Iowa","Worth County",5,25,73,34,39
050,19,195,"Iowa","Worth County",5,26,59,30,29
050,19,195,"Iowa","Worth County",5,27,63,35,28
050,19,195,"Iowa","Worth County",5,28,76,40,36
050,19,195,"Iowa","Worth County",5,29,81,41,40
050,19,195,"Iowa","Worth County",5,30,92,39,53
050,19,195,"Iowa","Worth County",5,31,105,53,52
050,19,195,"Iowa","Worth County",5,32,95,52,43
050,19,195,"Iowa","Worth County",5,33,81,42,39
050,19,195,"Iowa","Worth County",5,34,81,41,40
050,19,195,"Iowa","Worth County",5,35,88,43,45
050,19,195,"Iowa","Worth County",5,36,78,37,41
050,19,195,"Iowa","Worth County",5,37,75,44,31
050,19,195,"Iowa","Worth County",5,38,76,41,35
050,19,195,"Iowa","Worth County",5,39,93,44,49
050,19,195,"Iowa","Worth County",5,40,91,55,36
050,19,195,"Iowa","Worth County",5,41,106,62,44
050,19,195,"Iowa","Worth County",5,42,100,55,45
050,19,195,"Iowa","Worth County",5,43,80,44,36
050,19,195,"Iowa","Worth County",5,44,70,32,38
050,19,195,"Iowa","Worth County",5,45,90,48,42
050,19,195,"Iowa","Worth County",5,46,86,47,39
050,19,195,"Iowa","Worth County",5,47,83,51,32
050,19,195,"Iowa","Worth County",5,48,80,40,40
050,19,195,"Iowa","Worth County",5,49,78,39,39
050,19,195,"Iowa","Worth County",5,50,84,41,43
050,19,195,"Iowa","Worth County",5,51,86,46,40
050,19,195,"Iowa","Worth County",5,52,92,39,53
050,19,195,"Iowa","Worth County",5,53,92,48,44
050,19,195,"Iowa","Worth County",5,54,91,46,45
050,19,195,"Iowa","Worth County",5,55,87,42,45
050,19,195,"Iowa","Worth County",5,56,104,54,50
050,19,195,"Iowa","Worth County",5,57,102,55,47
050,19,195,"Iowa","Worth County",5,58,92,46,46
050,19,195,"Iowa","Worth County",5,59,105,58,47
050,19,195,"Iowa","Worth County",5,60,122,66,56
050,19,195,"Iowa","Worth County",5,61,112,57,55
050,19,195,"Iowa","Worth County",5,62,121,65,56
050,19,195,"Iowa","Worth County",5,63,98,55,43
050,19,195,"Iowa","Worth County",5,64,102,55,47
050,19,195,"Iowa","Worth County",5,65,102,57,45
050,19,195,"Iowa","Worth County",5,66,105,57,48
050,19,195,"Iowa","Worth County",5,67,104,56,48
050,19,195,"Iowa","Worth County",5,68,106,53,53
050,19,195,"Iowa","Worth County",5,69,111,55,56
050,19,195,"Iowa","Worth County",5,70,105,57,48
050,19,195,"Iowa","Worth County",5,71,95,46,49
050,19,195,"Iowa","Worth County",5,72,83,39,44
050,19,195,"Iowa","Worth County",5,73,80,44,36
050,19,195,"Iowa","Worth County",5,74,83,46,37
050,19,195,"Iowa","Worth County",5,75,73,35,38
050,19,195,"Iowa","Worth County",5,76,78,32,46
050,19,195,"Iowa","Worth County",5,77,52,24,28
050,19,195,"Iowa","Worth County",5,78,59,31,28
050,19,195,"Iowa","Worth County",5,79,46,19,27
050,19,195,"Iowa","Worth County",5,80,49,19,30
050,19,195,"Iowa","Worth County",5,81,41,19,22
050,19,195,"Iowa","Worth County",5,82,45,26,19
050,19,195,"Iowa","Worth County",5,83,38,20,18
050,19,195,"Iowa","Worth County",5,84,29,15,14
050,19,195,"Iowa","Worth County",5,85,205,70,135
050,19,197,"Iowa","Wright County",1,0,178,90,88
050,19,197,"Iowa","Wright County",1,1,184,92,92
050,19,197,"Iowa","Wright County",1,2,155,77,78
050,19,197,"Iowa","Wright County",1,3,200,107,93
050,19,197,"Iowa","Wright County",1,4,195,111,84
050,19,197,"Iowa","Wright County",1,5,185,101,84
050,19,197,"Iowa","Wright County",1,6,177,90,87
050,19,197,"Iowa","Wright County",1,7,157,70,87
050,19,197,"Iowa","Wright County",1,8,178,94,84
050,19,197,"Iowa","Wright County",1,9,163,85,78
050,19,197,"Iowa","Wright County",1,10,186,92,94
050,19,197,"Iowa","Wright County",1,11,188,105,83
050,19,197,"Iowa","Wright County",1,12,212,109,103
050,19,197,"Iowa","Wright County",1,13,227,100,127
050,19,197,"Iowa","Wright County",1,14,192,86,106
050,19,197,"Iowa","Wright County",1,15,187,105,82
050,19,197,"Iowa","Wright County",1,16,201,113,88
050,19,197,"Iowa","Wright County",1,17,203,105,98
050,19,197,"Iowa","Wright County",1,18,169,91,78
050,19,197,"Iowa","Wright County",1,19,124,65,59
050,19,197,"Iowa","Wright County",1,20,140,72,68
050,19,197,"Iowa","Wright County",1,21,130,65,65
050,19,197,"Iowa","Wright County",1,22,114,62,52
050,19,197,"Iowa","Wright County",1,23,126,66,60
050,19,197,"Iowa","Wright County",1,24,112,62,50
050,19,197,"Iowa","Wright County",1,25,119,61,58
050,19,197,"Iowa","Wright County",1,26,126,64,62
050,19,197,"Iowa","Wright County",1,27,139,70,69
050,19,197,"Iowa","Wright County",1,28,121,60,61
050,19,197,"Iowa","Wright County",1,29,131,63,68
050,19,197,"Iowa","Wright County",1,30,135,77,58
050,19,197,"Iowa","Wright County",1,31,143,80,63
050,19,197,"Iowa","Wright County",1,32,127,59,68
050,19,197,"Iowa","Wright County",1,33,121,67,54
050,19,197,"Iowa","Wright County",1,34,143,76,67
050,19,197,"Iowa","Wright County",1,35,154,77,77
050,19,197,"Iowa","Wright County",1,36,151,83,68
050,19,197,"Iowa","Wright County",1,37,167,86,81
050,19,197,"Iowa","Wright County",1,38,151,83,68
050,19,197,"Iowa","Wright County",1,39,147,85,62
050,19,197,"Iowa","Wright County",1,40,138,75,63
050,19,197,"Iowa","Wright County",1,41,136,57,79
050,19,197,"Iowa","Wright County",1,42,136,61,75
050,19,197,"Iowa","Wright County",1,43,145,68,77
050,19,197,"Iowa","Wright County",1,44,130,74,56
050,19,197,"Iowa","Wright County",1,45,142,72,70
050,19,197,"Iowa","Wright County",1,46,152,82,70
050,19,197,"Iowa","Wright County",1,47,125,71,54
050,19,197,"Iowa","Wright County",1,48,133,63,70
050,19,197,"Iowa","Wright County",1,49,142,69,73
050,19,197,"Iowa","Wright County",1,50,127,76,51
050,19,197,"Iowa","Wright County",1,51,136,78,58
050,19,197,"Iowa","Wright County",1,52,140,80,60
050,19,197,"Iowa","Wright County",1,53,123,65,58
050,19,197,"Iowa","Wright County",1,54,121,68,53
050,19,197,"Iowa","Wright County",1,55,144,70,74
050,19,197,"Iowa","Wright County",1,56,170,82,88
050,19,197,"Iowa","Wright County",1,57,188,94,94
050,19,197,"Iowa","Wright County",1,58,170,80,90
050,19,197,"Iowa","Wright County",1,59,186,94,92
050,19,197,"Iowa","Wright County",1,60,182,99,83
050,19,197,"Iowa","Wright County",1,61,175,84,91
050,19,197,"Iowa","Wright County",1,62,184,96,88
050,19,197,"Iowa","Wright County",1,63,186,102,84
050,19,197,"Iowa","Wright County",1,64,194,105,89
050,19,197,"Iowa","Wright County",1,65,199,107,92
050,19,197,"Iowa","Wright County",1,66,193,101,92
050,19,197,"Iowa","Wright County",1,67,183,100,83
050,19,197,"Iowa","Wright County",1,68,182,93,89
050,19,197,"Iowa","Wright County",1,69,144,74,70
050,19,197,"Iowa","Wright County",1,70,137,68,69
050,19,197,"Iowa","Wright County",1,71,122,66,56
050,19,197,"Iowa","Wright County",1,72,122,60,62
050,19,197,"Iowa","Wright County",1,73,128,60,68
050,19,197,"Iowa","Wright County",1,74,88,41,47
050,19,197,"Iowa","Wright County",1,75,93,45,48
050,19,197,"Iowa","Wright County",1,76,101,48,53
050,19,197,"Iowa","Wright County",1,77,105,55,50
050,19,197,"Iowa","Wright County",1,78,89,45,44
050,19,197,"Iowa","Wright County",1,79,79,31,48
050,19,197,"Iowa","Wright County",1,80,83,35,48
050,19,197,"Iowa","Wright County",1,81,75,35,40
050,19,197,"Iowa","Wright County",1,82,69,30,39
050,19,197,"Iowa","Wright County",1,83,63,29,34
050,19,197,"Iowa","Wright County",1,84,62,25,37
050,19,197,"Iowa","Wright County",1,85,462,176,286
050,19,197,"Iowa","Wright County",2,0,187,99,88
050,19,197,"Iowa","Wright County",2,1,179,90,89
050,19,197,"Iowa","Wright County",2,2,163,81,82
050,19,197,"Iowa","Wright County",2,3,188,100,88
050,19,197,"Iowa","Wright County",2,4,193,107,86
050,19,197,"Iowa","Wright County",2,5,187,102,85
050,19,197,"Iowa","Wright County",2,6,176,91,85
050,19,197,"Iowa","Wright County",2,7,162,76,86
050,19,197,"Iowa","Wright County",2,8,173,89,84
050,19,197,"Iowa","Wright County",2,9,167,88,79
050,19,197,"Iowa","Wright County",2,10,179,90,89
050,19,197,"Iowa","Wright County",2,11,189,103,86
050,19,197,"Iowa","Wright County",2,12,206,108,98
050,19,197,"Iowa","Wright County",2,13,221,100,121
050,19,197,"Iowa","Wright County",2,14,199,89,110
050,19,197,"Iowa","Wright County",2,15,188,102,86
050,19,197,"Iowa","Wright County",2,16,196,110,86
050,19,197,"Iowa","Wright County",2,17,202,108,94
050,19,197,"Iowa","Wright County",2,18,168,90,78
050,19,197,"Iowa","Wright County",2,19,127,68,59
050,19,197,"Iowa","Wright County",2,20,139,72,67
050,19,197,"Iowa","Wright County",2,21,131,67,64
050,19,197,"Iowa","Wright County",2,22,118,63,55
050,19,197,"Iowa","Wright County",2,23,124,65,59
050,19,197,"Iowa","Wright County",2,24,114,63,51
050,19,197,"Iowa","Wright County",2,25,115,59,56
050,19,197,"Iowa","Wright County",2,26,126,64,62
050,19,197,"Iowa","Wright County",2,27,133,67,66
050,19,197,"Iowa","Wright County",2,28,126,63,63
050,19,197,"Iowa","Wright County",2,29,130,63,67
050,19,197,"Iowa","Wright County",2,30,135,74,61
050,19,197,"Iowa","Wright County",2,31,140,77,63
050,19,197,"Iowa","Wright County",2,32,131,65,66
050,19,197,"Iowa","Wright County",2,33,123,66,57
050,19,197,"Iowa","Wright County",2,34,139,74,65
050,19,197,"Iowa","Wright County",2,35,149,76,73
050,19,197,"Iowa","Wright County",2,36,151,81,70
050,19,197,"Iowa","Wright County",2,37,162,84,78
050,19,197,"Iowa","Wright County",2,38,156,84,72
050,19,197,"Iowa","Wright County",2,39,147,84,63
050,19,197,"Iowa","Wright County",2,40,141,77,64
050,19,197,"Iowa","Wright County",2,41,138,62,76
050,19,197,"Iowa","Wright County",2,42,136,60,76
050,19,197,"Iowa","Wright County",2,43,144,67,77
050,19,197,"Iowa","Wright County",2,44,133,73,60
050,19,197,"Iowa","Wright County",2,45,140,73,67
050,19,197,"Iowa","Wright County",2,46,149,79,70
050,19,197,"Iowa","Wright County",2,47,129,72,57
050,19,197,"Iowa","Wright County",2,48,131,65,66
050,19,197,"Iowa","Wright County",2,49,138,66,72
050,19,197,"Iowa","Wright County",2,50,129,73,56
050,19,197,"Iowa","Wright County",2,51,134,77,57
050,19,197,"Iowa","Wright County",2,52,138,78,60
050,19,197,"Iowa","Wright County",2,53,127,68,59
050,19,197,"Iowa","Wright County",2,54,121,67,54
050,19,197,"Iowa","Wright County",2,55,140,70,70
050,19,197,"Iowa","Wright County",2,56,161,77,84
050,19,197,"Iowa","Wright County",2,57,180,90,90
050,19,197,"Iowa","Wright County",2,58,176,84,92
050,19,197,"Iowa","Wright County",2,59,186,93,93
050,19,197,"Iowa","Wright County",2,60,182,96,86
050,19,197,"Iowa","Wright County",2,61,175,87,88
050,19,197,"Iowa","Wright County",2,62,180,93,87
050,19,197,"Iowa","Wright County",2,63,189,103,86
050,19,197,"Iowa","Wright County",2,64,189,102,87
050,19,197,"Iowa","Wright County",2,65,198,106,92
050,19,197,"Iowa","Wright County",2,66,194,103,91
050,19,197,"Iowa","Wright County",2,67,185,100,85
050,19,197,"Iowa","Wright County",2,68,181,94,87
050,19,197,"Iowa","Wright County",2,69,153,79,74
050,19,197,"Iowa","Wright County",2,70,138,69,69
050,19,197,"Iowa","Wright County",2,71,125,66,59
050,19,197,"Iowa","Wright County",2,72,118,59,59
050,19,197,"Iowa","Wright County",2,73,130,61,69
050,19,197,"Iowa","Wright County",2,74,92,43,49
050,19,197,"Iowa","Wright County",2,75,92,44,48
050,19,197,"Iowa","Wright County",2,76,99,47,52
050,19,197,"Iowa","Wright County",2,77,106,54,52
050,19,197,"Iowa","Wright County",2,78,90,46,44
050,19,197,"Iowa","Wright County",2,79,81,34,47
050,19,197,"Iowa","Wright County",2,80,82,34,48
050,19,197,"Iowa","Wright County",2,81,75,35,40
050,19,197,"Iowa","Wright County",2,82,70,31,39
050,19,197,"Iowa","Wright County",2,83,63,29,34
050,19,197,"Iowa","Wright County",2,84,60,26,34
050,19,197,"Iowa","Wright County",2,85,459,174,285
050,19,197,"Iowa","Wright County",3,0,150,84,66
050,19,197,"Iowa","Wright County",3,1,200,107,93
050,19,197,"Iowa","Wright County",3,2,182,90,92
050,19,197,"Iowa","Wright County",3,3,164,83,81
050,19,197,"Iowa","Wright County",3,4,186,99,87
050,19,197,"Iowa","Wright County",3,5,198,110,88
050,19,197,"Iowa","Wright County",3,6,186,100,86
050,19,197,"Iowa","Wright County",3,7,180,99,81
050,19,197,"Iowa","Wright County",3,8,162,81,81
050,19,197,"Iowa","Wright County",3,9,163,82,81
050,19,197,"Iowa","Wright County",3,10,170,90,80
050,19,197,"Iowa","Wright County",3,11,173,88,85
050,19,197,"Iowa","Wright County",3,12,193,109,84
050,19,197,"Iowa","Wright County",3,13,201,105,96
050,19,197,"Iowa","Wright County",3,14,230,104,126
050,19,197,"Iowa","Wright County",3,15,206,97,109
050,19,197,"Iowa","Wright County",3,16,188,104,84
050,19,197,"Iowa","Wright County",3,17,194,107,87
050,19,197,"Iowa","Wright County",3,18,170,93,77
050,19,197,"Iowa","Wright County",3,19,126,72,54
050,19,197,"Iowa","Wright County",3,20,123,61,62
050,19,197,"Iowa","Wright County",3,21,147,79,68
050,19,197,"Iowa","Wright County",3,22,128,60,68
050,19,197,"Iowa","Wright County",3,23,114,68,46
050,19,197,"Iowa","Wright County",3,24,118,64,54
050,19,197,"Iowa","Wright County",3,25,116,65,51
050,19,197,"Iowa","Wright County",3,26,118,56,62
050,19,197,"Iowa","Wright County",3,27,133,69,64
050,19,197,"Iowa","Wright County",3,28,137,66,71
050,19,197,"Iowa","Wright County",3,29,126,62,64
050,19,197,"Iowa","Wright County",3,30,136,71,65
050,19,197,"Iowa","Wright County",3,31,139,77,62
050,19,197,"Iowa","Wright County",3,32,147,79,68
050,19,197,"Iowa","Wright County",3,33,129,64,65
050,19,197,"Iowa","Wright County",3,34,129,66,63
050,19,197,"Iowa","Wright County",3,35,134,74,60
050,19,197,"Iowa","Wright County",3,36,150,74,76
050,19,197,"Iowa","Wright County",3,37,142,76,66
050,19,197,"Iowa","Wright County",3,38,166,83,83
050,19,197,"Iowa","Wright County",3,39,154,82,72
050,19,197,"Iowa","Wright County",3,40,127,67,60
050,19,197,"Iowa","Wright County",3,41,141,79,62
050,19,197,"Iowa","Wright County",3,42,137,62,75
050,19,197,"Iowa","Wright County",3,43,138,63,75
050,19,197,"Iowa","Wright County",3,44,140,66,74
050,19,197,"Iowa","Wright County",3,45,134,74,60
050,19,197,"Iowa","Wright County",3,46,135,68,67
050,19,197,"Iowa","Wright County",3,47,150,78,72
050,19,197,"Iowa","Wright County",3,48,127,71,56
050,19,197,"Iowa","Wright County",3,49,133,65,68
050,19,197,"Iowa","Wright County",3,50,138,69,69
050,19,197,"Iowa","Wright County",3,51,126,70,56
050,19,197,"Iowa","Wright County",3,52,128,76,52
050,19,197,"Iowa","Wright County",3,53,141,81,60
050,19,197,"Iowa","Wright County",3,54,126,65,61
050,19,197,"Iowa","Wright County",3,55,124,69,55
050,19,197,"Iowa","Wright County",3,56,135,64,71
050,19,197,"Iowa","Wright County",3,57,161,77,84
050,19,197,"Iowa","Wright County",3,58,178,85,93
050,19,197,"Iowa","Wright County",3,59,174,83,91
050,19,197,"Iowa","Wright County",3,60,183,91,92
050,19,197,"Iowa","Wright County",3,61,182,98,84
050,19,197,"Iowa","Wright County",3,62,169,89,80
050,19,197,"Iowa","Wright County",3,63,179,92,87
050,19,197,"Iowa","Wright County",3,64,179,94,85
050,19,197,"Iowa","Wright County",3,65,189,102,87
050,19,197,"Iowa","Wright County",3,66,195,105,90
050,19,197,"Iowa","Wright County",3,67,192,102,90
050,19,197,"Iowa","Wright County",3,68,182,99,83
050,19,197,"Iowa","Wright County",3,69,181,93,88
050,19,197,"Iowa","Wright County",3,70,145,74,71
050,19,197,"Iowa","Wright County",3,71,127,59,68
050,19,197,"Iowa","Wright County",3,72,126,69,57
050,19,197,"Iowa","Wright County",3,73,112,57,55
050,19,197,"Iowa","Wright County",3,74,126,58,68
050,19,197,"Iowa","Wright County",3,75,88,43,45
050,19,197,"Iowa","Wright County",3,76,88,42,46
050,19,197,"Iowa","Wright County",3,77,93,44,49
050,19,197,"Iowa","Wright County",3,78,100,50,50
050,19,197,"Iowa","Wright County",3,79,83,42,41
050,19,197,"Iowa","Wright County",3,80,80,33,47
050,19,197,"Iowa","Wright County",3,81,74,30,44
050,19,197,"Iowa","Wright County",3,82,71,34,37
050,19,197,"Iowa","Wright County",3,83,67,28,39
050,19,197,"Iowa","Wright County",3,84,56,27,29
050,19,197,"Iowa","Wright County",3,85,445,173,272
050,19,197,"Iowa","Wright County",4,0,165,94,71
050,19,197,"Iowa","Wright County",4,1,150,83,67
050,19,197,"Iowa","Wright County",4,2,188,109,79
050,19,197,"Iowa","Wright County",4,3,175,93,82
050,19,197,"Iowa","Wright County",4,4,168,85,83
050,19,197,"Iowa","Wright County",4,5,178,93,85
050,19,197,"Iowa","Wright County",4,6,206,115,91
050,19,197,"Iowa","Wright County",4,7,189,107,82
050,19,197,"Iowa","Wright County",4,8,182,101,81
050,19,197,"Iowa","Wright County",4,9,166,80,86
050,19,197,"Iowa","Wright County",4,10,161,80,81
050,19,197,"Iowa","Wright County",4,11,177,93,84
050,19,197,"Iowa","Wright County",4,12,179,87,92
050,19,197,"Iowa","Wright County",4,13,191,108,83
050,19,197,"Iowa","Wright County",4,14,210,110,100
050,19,197,"Iowa","Wright County",4,15,238,100,138
050,19,197,"Iowa","Wright County",4,16,221,97,124
050,19,197,"Iowa","Wright County",4,17,187,103,84
050,19,197,"Iowa","Wright County",4,18,173,101,72
050,19,197,"Iowa","Wright County",4,19,137,77,60
050,19,197,"Iowa","Wright County",4,20,118,61,57
050,19,197,"Iowa","Wright County",4,21,128,64,64
050,19,197,"Iowa","Wright County",4,22,146,74,72
050,19,197,"Iowa","Wright County",4,23,119,55,64
050,19,197,"Iowa","Wright County",4,24,106,64,42
050,19,197,"Iowa","Wright County",4,25,120,71,49
050,19,197,"Iowa","Wright County",4,26,109,63,46
050,19,197,"Iowa","Wright County",4,27,126,60,66
050,19,197,"Iowa","Wright County",4,28,133,69,64
050,19,197,"Iowa","Wright County",4,29,123,55,68
050,19,197,"Iowa","Wright County",4,30,130,63,67
050,19,197,"Iowa","Wright County",4,31,128,64,64
050,19,197,"Iowa","Wright County",4,32,137,75,62
050,19,197,"Iowa","Wright County",4,33,139,77,62
050,19,197,"Iowa","Wright County",4,34,130,63,67
050,19,197,"Iowa","Wright County",4,35,121,61,60
050,19,197,"Iowa","Wright County",4,36,140,79,61
050,19,197,"Iowa","Wright County",4,37,155,78,77
050,19,197,"Iowa","Wright County",4,38,150,82,68
050,19,197,"Iowa","Wright County",4,39,164,82,82
050,19,197,"Iowa","Wright County",4,40,158,84,74
050,19,197,"Iowa","Wright County",4,41,128,64,64
050,19,197,"Iowa","Wright County",4,42,140,80,60
050,19,197,"Iowa","Wright County",4,43,137,62,75
050,19,197,"Iowa","Wright County",4,44,142,64,78
050,19,197,"Iowa","Wright County",4,45,145,67,78
050,19,197,"Iowa","Wright County",4,46,129,70,59
050,19,197,"Iowa","Wright County",4,47,127,64,63
050,19,197,"Iowa","Wright County",4,48,143,78,65
050,19,197,"Iowa","Wright County",4,49,117,64,53
050,19,197,"Iowa","Wright County",4,50,140,66,74
050,19,197,"Iowa","Wright County",4,51,136,65,71
050,19,197,"Iowa","Wright County",4,52,125,71,54
050,19,197,"Iowa","Wright County",4,53,125,75,50
050,19,197,"Iowa","Wright County",4,54,138,79,59
050,19,197,"Iowa","Wright County",4,55,121,64,57
050,19,197,"Iowa","Wright County",4,56,113,61,52
050,19,197,"Iowa","Wright County",4,57,129,63,66
050,19,197,"Iowa","Wright County",4,58,152,73,79
050,19,197,"Iowa","Wright County",4,59,178,87,91
050,19,197,"Iowa","Wright County",4,60,172,79,93
050,19,197,"Iowa","Wright County",4,61,182,91,91
050,19,197,"Iowa","Wright County",4,62,176,95,81
050,19,197,"Iowa","Wright County",4,63,166,86,80
050,19,197,"Iowa","Wright County",4,64,176,90,86
050,19,197,"Iowa","Wright County",4,65,174,91,83
050,19,197,"Iowa","Wright County",4,66,181,102,79
050,19,197,"Iowa","Wright County",4,67,191,102,89
050,19,197,"Iowa","Wright County",4,68,184,98,86
050,19,197,"Iowa","Wright County",4,69,176,97,79
050,19,197,"Iowa","Wright County",4,70,180,90,90
050,19,197,"Iowa","Wright County",4,71,136,64,72
050,19,197,"Iowa","Wright County",4,72,125,59,66
050,19,197,"Iowa","Wright County",4,73,124,68,56
050,19,197,"Iowa","Wright County",4,74,112,55,57
050,19,197,"Iowa","Wright County",4,75,123,59,64
050,19,197,"Iowa","Wright County",4,76,85,41,44
050,19,197,"Iowa","Wright County",4,77,81,40,41
050,19,197,"Iowa","Wright County",4,78,92,44,48
050,19,197,"Iowa","Wright County",4,79,99,48,51
050,19,197,"Iowa","Wright County",4,80,80,40,40
050,19,197,"Iowa","Wright County",4,81,71,30,41
050,19,197,"Iowa","Wright County",4,82,71,29,42
050,19,197,"Iowa","Wright County",4,83,69,34,35
050,19,197,"Iowa","Wright County",4,84,61,25,36
050,19,197,"Iowa","Wright County",4,85,422,168,254
050,19,197,"Iowa","Wright County",5,0,169,97,72
050,19,197,"Iowa","Wright County",5,1,168,95,73
050,19,197,"Iowa","Wright County",5,2,150,85,65
050,19,197,"Iowa","Wright County",5,3,180,111,69
050,19,197,"Iowa","Wright County",5,4,167,91,76
050,19,197,"Iowa","Wright County",5,5,170,89,81
050,19,197,"Iowa","Wright County",5,6,177,92,85
050,19,197,"Iowa","Wright County",5,7,210,115,95
050,19,197,"Iowa","Wright County",5,8,181,103,78
050,19,197,"Iowa","Wright County",5,9,189,103,86
050,19,197,"Iowa","Wright County",5,10,157,79,78
050,19,197,"Iowa","Wright County",5,11,164,80,84
050,19,197,"Iowa","Wright County",5,12,178,95,83
050,19,197,"Iowa","Wright County",5,13,171,85,86
050,19,197,"Iowa","Wright County",5,14,195,107,88
050,19,197,"Iowa","Wright County",5,15,219,103,116
050,19,197,"Iowa","Wright County",5,16,254,105,149
050,19,197,"Iowa","Wright County",5,17,225,102,123
050,19,197,"Iowa","Wright County",5,18,165,95,70
050,19,197,"Iowa","Wright County",5,19,138,78,60
050,19,197,"Iowa","Wright County",5,20,142,73,69
050,19,197,"Iowa","Wright County",5,21,119,66,53
050,19,197,"Iowa","Wright County",5,22,126,60,66
050,19,197,"Iowa","Wright County",5,23,143,69,74
050,19,197,"Iowa","Wright County",5,24,125,65,60
050,19,197,"Iowa","Wright County",5,25,125,73,52
050,19,197,"Iowa","Wright County",5,26,118,73,45
050,19,197,"Iowa","Wright County",5,27,112,66,46
050,19,197,"Iowa","Wright County",5,28,131,59,72
050,19,197,"Iowa","Wright County",5,29,134,69,65
050,19,197,"Iowa","Wright County",5,30,129,60,69
050,19,197,"Iowa","Wright County",5,31,126,58,68
050,19,197,"Iowa","Wright County",5,32,126,64,62
050,19,197,"Iowa","Wright County",5,33,134,71,63
050,19,197,"Iowa","Wright County",5,34,131,74,57
050,19,197,"Iowa","Wright County",5,35,126,60,66
050,19,197,"Iowa","Wright County",5,36,115,59,56
050,19,197,"Iowa","Wright County",5,37,142,75,67
050,19,197,"Iowa","Wright County",5,38,157,82,75
050,19,197,"Iowa","Wright County",5,39,150,78,72
050,19,197,"Iowa","Wright County",5,40,165,84,81
050,19,197,"Iowa","Wright County",5,41,166,88,78
050,19,197,"Iowa","Wright County",5,42,123,59,64
050,19,197,"Iowa","Wright County",5,43,135,78,57
050,19,197,"Iowa","Wright County",5,44,136,61,75
050,19,197,"Iowa","Wright County",5,45,141,63,78
050,19,197,"Iowa","Wright County",5,46,135,63,72
050,19,197,"Iowa","Wright County",5,47,125,69,56
050,19,197,"Iowa","Wright County",5,48,130,67,63
050,19,197,"Iowa","Wright County",5,49,138,74,64
050,19,197,"Iowa","Wright County",5,50,113,64,49
050,19,197,"Iowa","Wright County",5,51,140,64,76
050,19,197,"Iowa","Wright County",5,52,127,60,67
050,19,197,"Iowa","Wright County",5,53,129,74,55
050,19,197,"Iowa","Wright County",5,54,126,77,49
050,19,197,"Iowa","Wright County",5,55,142,81,61
050,19,197,"Iowa","Wright County",5,56,119,60,59
050,19,197,"Iowa","Wright County",5,57,108,60,48
050,19,197,"Iowa","Wright County",5,58,131,64,67
050,19,197,"Iowa","Wright County",5,59,154,77,77
050,19,197,"Iowa","Wright County",5,60,173,80,93
050,19,197,"Iowa","Wright County",5,61,171,78,93
050,19,197,"Iowa","Wright County",5,62,183,92,91
050,19,197,"Iowa","Wright County",5,63,176,93,83
050,19,197,"Iowa","Wright County",5,64,161,83,78
050,19,197,"Iowa","Wright County",5,65,174,88,86
050,19,197,"Iowa","Wright County",5,66,175,93,82
050,19,197,"Iowa","Wright County",5,67,178,98,80
050,19,197,"Iowa","Wright County",5,68,184,99,85
050,19,197,"Iowa","Wright County",5,69,178,95,83
050,19,197,"Iowa","Wright County",5,70,172,93,79
050,19,197,"Iowa","Wright County",5,71,169,81,88
050,19,197,"Iowa","Wright County",5,72,132,62,70
050,19,197,"Iowa","Wright County",5,73,123,57,66
050,19,197,"Iowa","Wright County",5,74,121,64,57
050,19,197,"Iowa","Wright County",5,75,112,57,55
050,19,197,"Iowa","Wright County",5,76,122,57,65
050,19,197,"Iowa","Wright County",5,77,81,39,42
050,19,197,"Iowa","Wright County",5,78,78,38,40
050,19,197,"Iowa","Wright County",5,79,88,39,49
050,19,197,"Iowa","Wright County",5,80,96,47,49
050,19,197,"Iowa","Wright County",5,81,73,37,36
050,19,197,"Iowa","Wright County",5,82,68,29,39
050,19,197,"Iowa","Wright County",5,83,72,29,43
050,19,197,"Iowa","Wright County",5,84,63,31,32
050,19,197,"Iowa","Wright County",5,85,412,165,247

