"SUMLEV","STATE","COUNTY","STNAME","CTYNAME","YEAR","AGE","TOT_POP","TOT_MALE","TOT_FEMALE"
050,09,110,"Connecticut","Capitol Planning Region",1,0,9536,4899,4637
050,09,110,"Connecticut","Capitol Planning Region",1,1,9756,5065,4691
050,09,110,"Connecticut","Capitol Planning Region",1,2,10079,5171,4908
050,09,110,"Connecticut","Capitol Planning Region",1,3,10149,5124,5025
050,09,110,"Connecticut","Capitol Planning Region",1,4,10333,5252,5081
050,09,110,"Connecticut","Capitol Planning Region",1,5,10627,5452,5175
050,09,110,"Connecticut","Capitol Planning Region",1,6,10488,5392,5096
050,09,110,"Connecticut","Capitol Planning Region",1,7,10590,5415,5175
050,09,110,"Connecticut","Capitol Planning Region",1,8,10735,5482,5253
050,09,110,"Connecticut","Capitol Planning Region",1,9,11014,5554,5460
050,09,110,"Connecticut","Capitol Planning Region",1,10,11411,5793,5618
050,09,110,"Connecticut","Capitol Planning Region",1,11,11658,5867,5791
050,09,110,"Connecticut","Capitol Planning Region",1,12,11972,5997,5975
050,09,110,"Connecticut","Capitol Planning Region",1,13,12160,6106,6054
050,09,110,"Connecticut","Capitol Planning Region",1,14,12234,6200,6034
050,09,110,"Connecticut","Capitol Planning Region",1,15,12377,6327,6050
050,09,110,"Connecticut","Capitol Planning Region",1,16,12592,6442,6150
050,09,110,"Connecticut","Capitol Planning Region",1,17,12554,6469,6085
050,09,110,"Connecticut","Capitol Planning Region",1,18,14273,7286,6987
050,09,110,"Connecticut","Capitol Planning Region",1,19,15485,7892,7593
050,09,110,"Connecticut","Capitol Planning Region",1,20,16042,7929,8113
050,09,110,"Connecticut","Capitol Planning Region",1,21,15393,7705,7688
050,09,110,"Connecticut","Capitol Planning Region",1,22,13931,7153,6778
050,09,110,"Connecticut","Capitol Planning Region",1,23,12698,6556,6142
050,09,110,"Connecticut","Capitol Planning Region",1,24,12393,6423,5970
050,09,110,"Connecticut","Capitol Planning Region",1,25,12511,6456,6055
050,09,110,"Connecticut","Capitol Planning Region",1,26,12758,6701,6057
050,09,110,"Connecticut","Capitol Planning Region",1,27,12781,6622,6159
050,09,110,"Connecticut","Capitol Planning Region",1,28,12440,6363,6077
050,09,110,"Connecticut","Capitol Planning Region",1,29,12407,6440,5967
050,09,110,"Connecticut","Capitol Planning Region",1,30,12294,6371,5923
050,09,110,"Connecticut","Capitol Planning Region",1,31,12474,6416,6058
050,09,110,"Connecticut","Capitol Planning Region",1,32,12677,6461,6216
050,09,110,"Connecticut","Capitol Planning Region",1,33,12755,6497,6258
050,09,110,"Connecticut","Capitol Planning Region",1,34,12962,6564,6398
050,09,110,"Connecticut","Capitol Planning Region",1,35,12744,6512,6232
050,09,110,"Connecticut","Capitol Planning Region",1,36,12722,6412,6310
050,09,110,"Connecticut","Capitol Planning Region",1,37,12716,6406,6310
050,09,110,"Connecticut","Capitol Planning Region",1,38,12649,6320,6329
050,09,110,"Connecticut","Capitol Planning Region",1,39,12638,6268,6370
050,09,110,"Connecticut","Capitol Planning Region",1,40,12395,6187,6208
050,09,110,"Connecticut","Capitol Planning Region",1,41,11906,5905,6001
050,09,110,"Connecticut","Capitol Planning Region",1,42,11639,5730,5909
050,09,110,"Connecticut","Capitol Planning Region",1,43,11253,5564,5689
050,09,110,"Connecticut","Capitol Planning Region",1,44,11023,5489,5534
050,09,110,"Connecticut","Capitol Planning Region",1,45,11109,5505,5604
050,09,110,"Connecticut","Capitol Planning Region",1,46,10928,5312,5616
050,09,110,"Connecticut","Capitol Planning Region",1,47,11283,5495,5788
050,09,110,"Connecticut","Capitol Planning Region",1,48,12220,6019,6201
050,09,110,"Connecticut","Capitol Planning Region",1,49,13204,6495,6709
050,09,110,"Connecticut","Capitol Planning Region",1,50,12936,6277,6659
050,09,110,"Connecticut","Capitol Planning Region",1,51,12788,6255,6533
050,09,110,"Connecticut","Capitol Planning Region",1,52,12680,6196,6484
050,09,110,"Connecticut","Capitol Planning Region",1,53,13144,6435,6709
050,09,110,"Connecticut","Capitol Planning Region",1,54,13655,6689,6966
050,09,110,"Connecticut","Capitol Planning Region",1,55,14273,6931,7342
050,09,110,"Connecticut","Capitol Planning Region",1,56,14262,6984,7278
050,09,110,"Connecticut","Capitol Planning Region",1,57,14132,6897,7235
050,09,110,"Connecticut","Capitol Planning Region",1,58,14195,6921,7274
050,09,110,"Connecticut","Capitol Planning Region",1,59,14068,6886,7182
050,09,110,"Connecticut","Capitol Planning Region",1,60,13746,6736,7010
050,09,110,"Connecticut","Capitol Planning Region",1,61,13488,6588,6900
050,09,110,"Connecticut","Capitol Planning Region",1,62,13352,6493,6859
050,09,110,"Connecticut","Capitol Planning Region",1,63,12899,6333,6566
050,09,110,"Connecticut","Capitol Planning Region",1,64,12305,5923,6382
050,09,110,"Connecticut","Capitol Planning Region",1,65,11777,5636,6141
050,09,110,"Connecticut","Capitol Planning Region",1,66,11051,5241,5810
050,09,110,"Connecticut","Capitol Planning Region",1,67,10723,5095,5628
050,09,110,"Connecticut","Capitol Planning Region",1,68,10171,4801,5370
050,09,110,"Connecticut","Capitol Planning Region",1,69,9332,4316,5016
050,09,110,"Connecticut","Capitol Planning Region",1,70,9013,4139,4874
050,09,110,"Connecticut","Capitol Planning Region",1,71,8828,4010,4818
050,09,110,"Connecticut","Capitol Planning Region",1,72,9082,4090,4992
050,09,110,"Connecticut","Capitol Planning Region",1,73,9129,4136,4993
050,09,110,"Connecticut","Capitol Planning Region",1,74,6740,2996,3744
050,09,110,"Connecticut","Capitol Planning Region",1,75,6605,2967,3638
050,09,110,"Connecticut","Capitol Planning Region",1,76,6518,2933,3585
050,09,110,"Connecticut","Capitol Planning Region",1,77,6589,2935,3654
050,09,110,"Connecticut","Capitol Planning Region",1,78,5513,2404,3109
050,09,110,"Connecticut","Capitol Planning Region",1,79,4808,2096,2712
050,09,110,"Connecticut","Capitol Planning Region",1,80,4327,1838,2489
050,09,110,"Connecticut","Capitol Planning Region",1,81,4175,1747,2428
050,09,110,"Connecticut","Capitol Planning Region",1,82,3952,1675,2277
050,09,110,"Connecticut","Capitol Planning Region",1,83,3571,1465,2106
050,09,110,"Connecticut","Capitol Planning Region",1,84,3284,1318,1966
050,09,110,"Connecticut","Capitol Planning Region",1,85,22196,7445,14751
050,09,110,"Connecticut","Capitol Planning Region",2,0,9491,4867,4624
050,09,110,"Connecticut","Capitol Planning Region",2,1,9731,5036,4695
050,09,110,"Connecticut","Capitol Planning Region",2,2,10027,5158,4869
050,09,110,"Connecticut","Capitol Planning Region",2,3,10121,5127,4994
050,09,110,"Connecticut","Capitol Planning Region",2,4,10319,5235,5084
050,09,110,"Connecticut","Capitol Planning Region",2,5,10561,5399,5162
050,09,110,"Connecticut","Capitol Planning Region",2,6,10550,5416,5134
050,09,110,"Connecticut","Capitol Planning Region",2,7,10553,5401,5152
050,09,110,"Connecticut","Capitol Planning Region",2,8,10680,5453,5227
050,09,110,"Connecticut","Capitol Planning Region",2,9,10943,5539,5404
050,09,110,"Connecticut","Capitol Planning Region",2,10,11311,5730,5581
050,09,110,"Connecticut","Capitol Planning Region",2,11,11557,5824,5733
050,09,110,"Connecticut","Capitol Planning Region",2,12,11942,5993,5949
050,09,110,"Connecticut","Capitol Planning Region",2,13,12097,6071,6026
050,09,110,"Connecticut","Capitol Planning Region",2,14,12206,6169,6037
050,09,110,"Connecticut","Capitol Planning Region",2,15,12354,6293,6061
050,09,110,"Connecticut","Capitol Planning Region",2,16,12545,6417,6128
050,09,110,"Connecticut","Capitol Planning Region",2,17,12553,6457,6096
050,09,110,"Connecticut","Capitol Planning Region",2,18,12528,6485,6043
050,09,110,"Connecticut","Capitol Planning Region",2,19,12601,6489,6112
050,09,110,"Connecticut","Capitol Planning Region",2,20,13700,6790,6910
050,09,110,"Connecticut","Capitol Planning Region",2,21,13568,6800,6768
050,09,110,"Connecticut","Capitol Planning Region",2,22,13177,6721,6456
050,09,110,"Connecticut","Capitol Planning Region",2,23,12488,6416,6072
050,09,110,"Connecticut","Capitol Planning Region",2,24,12243,6312,5931
050,09,110,"Connecticut","Capitol Planning Region",2,25,12402,6393,6009
050,09,110,"Connecticut","Capitol Planning Region",2,26,12623,6592,6031
050,09,110,"Connecticut","Capitol Planning Region",2,27,12672,6564,6108
050,09,110,"Connecticut","Capitol Planning Region",2,28,12488,6390,6098
050,09,110,"Connecticut","Capitol Planning Region",2,29,12377,6389,5988
050,09,110,"Connecticut","Capitol Planning Region",2,30,12373,6387,5986
050,09,110,"Connecticut","Capitol Planning Region",2,31,12358,6352,6006
050,09,110,"Connecticut","Capitol Planning Region",2,32,12549,6394,6155
050,09,110,"Connecticut","Capitol Planning Region",2,33,12677,6443,6234
050,09,110,"Connecticut","Capitol Planning Region",2,34,12888,6521,6367
050,09,110,"Connecticut","Capitol Planning Region",2,35,12846,6535,6311
050,09,110,"Connecticut","Capitol Planning Region",2,36,12612,6353,6259
050,09,110,"Connecticut","Capitol Planning Region",2,37,12703,6383,6320
050,09,110,"Connecticut","Capitol Planning Region",2,38,12680,6326,6354
050,09,110,"Connecticut","Capitol Planning Region",2,39,12549,6222,6327
050,09,110,"Connecticut","Capitol Planning Region",2,40,12502,6217,6285
050,09,110,"Connecticut","Capitol Planning Region",2,41,11980,5934,6046
050,09,110,"Connecticut","Capitol Planning Region",2,42,11611,5715,5896
050,09,110,"Connecticut","Capitol Planning Region",2,43,11393,5621,5772
050,09,110,"Connecticut","Capitol Planning Region",2,44,10942,5424,5518
050,09,110,"Connecticut","Capitol Planning Region",2,45,11092,5482,5610
050,09,110,"Connecticut","Capitol Planning Region",2,46,10893,5313,5580
050,09,110,"Connecticut","Capitol Planning Region",2,47,11126,5405,5721
050,09,110,"Connecticut","Capitol Planning Region",2,48,11946,5852,6094
050,09,110,"Connecticut","Capitol Planning Region",2,49,12955,6362,6593
050,09,110,"Connecticut","Capitol Planning Region",2,50,12952,6292,6660
050,09,110,"Connecticut","Capitol Planning Region",2,51,12701,6190,6511
050,09,110,"Connecticut","Capitol Planning Region",2,52,12632,6158,6474
050,09,110,"Connecticut","Capitol Planning Region",2,53,12952,6330,6622
050,09,110,"Connecticut","Capitol Planning Region",2,54,13441,6588,6853
050,09,110,"Connecticut","Capitol Planning Region",2,55,14046,6827,7219
050,09,110,"Connecticut","Capitol Planning Region",2,56,14242,6955,7287
050,09,110,"Connecticut","Capitol Planning Region",2,57,14101,6876,7225
050,09,110,"Connecticut","Capitol Planning Region",2,58,14090,6862,7228
050,09,110,"Connecticut","Capitol Planning Region",2,59,14059,6870,7189
050,09,110,"Connecticut","Capitol Planning Region",2,60,13716,6710,7006
050,09,110,"Connecticut","Capitol Planning Region",2,61,13426,6561,6865
050,09,110,"Connecticut","Capitol Planning Region",2,62,13259,6448,6811
050,09,110,"Connecticut","Capitol Planning Region",2,63,12996,6362,6634
050,09,110,"Connecticut","Capitol Planning Region",2,64,12259,5925,6334
050,09,110,"Connecticut","Capitol Planning Region",2,65,11788,5634,6154
050,09,110,"Connecticut","Capitol Planning Region",2,66,11144,5284,5860
050,09,110,"Connecticut","Capitol Planning Region",2,67,10667,5052,5615
050,09,110,"Connecticut","Capitol Planning Region",2,68,10151,4791,5360
050,09,110,"Connecticut","Capitol Planning Region",2,69,9504,4412,5092
050,09,110,"Connecticut","Capitol Planning Region",2,70,8973,4118,4855
050,09,110,"Connecticut","Capitol Planning Region",2,71,8786,3989,4797
050,09,110,"Connecticut","Capitol Planning Region",2,72,8802,3964,4838
050,09,110,"Connecticut","Capitol Planning Region",2,73,9429,4255,5174
050,09,110,"Connecticut","Capitol Planning Region",2,74,6824,3032,3792
050,09,110,"Connecticut","Capitol Planning Region",2,75,6580,2946,3634
050,09,110,"Connecticut","Capitol Planning Region",2,76,6384,2864,3520
050,09,110,"Connecticut","Capitol Planning Region",2,77,6632,2965,3667
050,09,110,"Connecticut","Capitol Planning Region",2,78,5571,2436,3135
050,09,110,"Connecticut","Capitol Planning Region",2,79,4867,2113,2754
050,09,110,"Connecticut","Capitol Planning Region",2,80,4334,1850,2484
050,09,110,"Connecticut","Capitol Planning Region",2,81,4078,1717,2361
050,09,110,"Connecticut","Capitol Planning Region",2,82,3923,1655,2268
050,09,110,"Connecticut","Capitol Planning Region",2,83,3518,1446,2072
050,09,110,"Connecticut","Capitol Planning Region",2,84,3223,1305,1918
050,09,110,"Connecticut","Capitol Planning Region",2,85,21303,7192,14111
050,09,110,"Connecticut","Capitol Planning Region",3,0,9182,4700,4482
050,09,110,"Connecticut","Capitol Planning Region",3,1,9719,4950,4769
050,09,110,"Connecticut","Capitol Planning Region",3,2,9881,5112,4769
050,09,110,"Connecticut","Capitol Planning Region",3,3,10097,5207,4890
050,09,110,"Connecticut","Capitol Planning Region",3,4,10313,5181,5132
050,09,110,"Connecticut","Capitol Planning Region",3,5,10467,5334,5133
050,09,110,"Connecticut","Capitol Planning Region",3,6,10658,5441,5217
050,09,110,"Connecticut","Capitol Planning Region",3,7,10633,5475,5158
050,09,110,"Connecticut","Capitol Planning Region",3,8,10611,5447,5164
050,09,110,"Connecticut","Capitol Planning Region",3,9,10772,5487,5285
050,09,110,"Connecticut","Capitol Planning Region",3,10,11027,5575,5452
050,09,110,"Connecticut","Capitol Planning Region",3,11,11360,5764,5596
050,09,110,"Connecticut","Capitol Planning Region",3,12,11617,5857,5760
050,09,110,"Connecticut","Capitol Planning Region",3,13,11982,6004,5978
050,09,110,"Connecticut","Capitol Planning Region",3,14,12166,6115,6051
050,09,110,"Connecticut","Capitol Planning Region",3,15,12174,6147,6027
050,09,110,"Connecticut","Capitol Planning Region",3,16,12324,6268,6056
050,09,110,"Connecticut","Capitol Planning Region",3,17,12594,6427,6167
050,09,110,"Connecticut","Capitol Planning Region",3,18,13698,6982,6716
050,09,110,"Connecticut","Capitol Planning Region",3,19,14564,7423,7141
050,09,110,"Connecticut","Capitol Planning Region",3,20,15445,7676,7769
050,09,110,"Connecticut","Capitol Planning Region",3,21,14791,7380,7411
050,09,110,"Connecticut","Capitol Planning Region",3,22,13775,7020,6755
050,09,110,"Connecticut","Capitol Planning Region",3,23,12751,6523,6228
050,09,110,"Connecticut","Capitol Planning Region",3,24,12387,6356,6031
050,09,110,"Connecticut","Capitol Planning Region",3,25,12286,6293,5993
050,09,110,"Connecticut","Capitol Planning Region",3,26,12487,6420,6067
050,09,110,"Connecticut","Capitol Planning Region",3,27,12741,6607,6134
050,09,110,"Connecticut","Capitol Planning Region",3,28,12663,6492,6171
050,09,110,"Connecticut","Capitol Planning Region",3,29,12693,6453,6240
050,09,110,"Connecticut","Capitol Planning Region",3,30,12557,6489,6068
050,09,110,"Connecticut","Capitol Planning Region",3,31,12571,6462,6109
050,09,110,"Connecticut","Capitol Planning Region",3,32,12479,6359,6120
050,09,110,"Connecticut","Capitol Planning Region",3,33,12627,6423,6204
050,09,110,"Connecticut","Capitol Planning Region",3,34,12784,6485,6299
050,09,110,"Connecticut","Capitol Planning Region",3,35,13021,6546,6475
050,09,110,"Connecticut","Capitol Planning Region",3,36,12951,6570,6381
050,09,110,"Connecticut","Capitol Planning Region",3,37,12685,6365,6320
050,09,110,"Connecticut","Capitol Planning Region",3,38,12826,6438,6388
050,09,110,"Connecticut","Capitol Planning Region",3,39,12760,6355,6405
050,09,110,"Connecticut","Capitol Planning Region",3,40,12560,6220,6340
050,09,110,"Connecticut","Capitol Planning Region",3,41,12556,6207,6349
050,09,110,"Connecticut","Capitol Planning Region",3,42,11920,5876,6044
050,09,110,"Connecticut","Capitol Planning Region",3,43,11649,5758,5891
050,09,110,"Connecticut","Capitol Planning Region",3,44,11386,5598,5788
050,09,110,"Connecticut","Capitol Planning Region",3,45,10895,5377,5518
050,09,110,"Connecticut","Capitol Planning Region",3,46,11075,5488,5587
050,09,110,"Connecticut","Capitol Planning Region",3,47,10782,5231,5551
050,09,110,"Connecticut","Capitol Planning Region",3,48,11060,5347,5713
050,09,110,"Connecticut","Capitol Planning Region",3,49,11813,5812,6001
050,09,110,"Connecticut","Capitol Planning Region",3,50,12841,6302,6539
050,09,110,"Connecticut","Capitol Planning Region",3,51,12882,6256,6626
050,09,110,"Connecticut","Capitol Planning Region",3,52,12567,6068,6499
050,09,110,"Connecticut","Capitol Planning Region",3,53,12513,6113,6400
050,09,110,"Connecticut","Capitol Planning Region",3,54,12855,6286,6569
050,09,110,"Connecticut","Capitol Planning Region",3,55,13265,6490,6775
050,09,110,"Connecticut","Capitol Planning Region",3,56,13869,6713,7156
050,09,110,"Connecticut","Capitol Planning Region",3,57,13979,6805,7174
050,09,110,"Connecticut","Capitol Planning Region",3,58,13910,6741,7169
050,09,110,"Connecticut","Capitol Planning Region",3,59,13817,6739,7078
050,09,110,"Connecticut","Capitol Planning Region",3,60,13715,6627,7088
050,09,110,"Connecticut","Capitol Planning Region",3,61,13447,6622,6825
050,09,110,"Connecticut","Capitol Planning Region",3,62,13096,6346,6750
050,09,110,"Connecticut","Capitol Planning Region",3,63,12924,6245,6679
050,09,110,"Connecticut","Capitol Planning Region",3,64,12626,6145,6481
050,09,110,"Connecticut","Capitol Planning Region",3,65,11991,5752,6239
050,09,110,"Connecticut","Capitol Planning Region",3,66,11524,5472,6052
050,09,110,"Connecticut","Capitol Planning Region",3,67,10871,5130,5741
050,09,110,"Connecticut","Capitol Planning Region",3,68,10468,4929,5539
050,09,110,"Connecticut","Capitol Planning Region",3,69,9934,4663,5271
050,09,110,"Connecticut","Capitol Planning Region",3,70,9325,4313,5012
050,09,110,"Connecticut","Capitol Planning Region",3,71,8804,4000,4804
050,09,110,"Connecticut","Capitol Planning Region",3,72,8571,3866,4705
050,09,110,"Connecticut","Capitol Planning Region",3,73,8584,3839,4745
050,09,110,"Connecticut","Capitol Planning Region",3,74,9198,4132,5066
050,09,110,"Connecticut","Capitol Planning Region",3,75,6618,2926,3692
050,09,110,"Connecticut","Capitol Planning Region",3,76,6384,2815,3569
050,09,110,"Connecticut","Capitol Planning Region",3,77,6211,2772,3439
050,09,110,"Connecticut","Capitol Planning Region",3,78,6341,2807,3534
050,09,110,"Connecticut","Capitol Planning Region",3,79,5408,2335,3073
050,09,110,"Connecticut","Capitol Planning Region",3,80,4639,1997,2642
050,09,110,"Connecticut","Capitol Planning Region",3,81,4121,1737,2384
050,09,110,"Connecticut","Capitol Planning Region",3,82,3896,1633,2263
050,09,110,"Connecticut","Capitol Planning Region",3,83,3707,1522,2185
050,09,110,"Connecticut","Capitol Planning Region",3,84,3262,1328,1934
050,09,110,"Connecticut","Capitol Planning Region",3,85,21164,7185,13979
050,09,110,"Connecticut","Capitol Planning Region",4,0,9537,4872,4665
050,09,110,"Connecticut","Capitol Planning Region",4,1,9374,4850,4524
050,09,110,"Connecticut","Capitol Planning Region",4,2,9891,5069,4822
050,09,110,"Connecticut","Capitol Planning Region",4,3,10055,5224,4831
050,09,110,"Connecticut","Capitol Planning Region",4,4,10272,5300,4972
050,09,110,"Connecticut","Capitol Planning Region",4,5,10365,5212,5153
050,09,110,"Connecticut","Capitol Planning Region",4,6,10560,5406,5154
050,09,110,"Connecticut","Capitol Planning Region",4,7,10766,5467,5299
050,09,110,"Connecticut","Capitol Planning Region",4,8,10739,5506,5233
050,09,110,"Connecticut","Capitol Planning Region",4,9,10666,5448,5218
050,09,110,"Connecticut","Capitol Planning Region",4,10,10824,5495,5329
050,09,110,"Connecticut","Capitol Planning Region",4,11,11106,5624,5482
050,09,110,"Connecticut","Capitol Planning Region",4,12,11429,5764,5665
050,09,110,"Connecticut","Capitol Planning Region",4,13,11611,5840,5771
050,09,110,"Connecticut","Capitol Planning Region",4,14,12018,6016,6002
050,09,110,"Connecticut","Capitol Planning Region",4,15,12207,6102,6105
050,09,110,"Connecticut","Capitol Planning Region",4,16,12175,6136,6039
050,09,110,"Connecticut","Capitol Planning Region",4,17,12457,6320,6137
050,09,110,"Connecticut","Capitol Planning Region",4,18,13968,7087,6881
050,09,110,"Connecticut","Capitol Planning Region",4,19,14803,7575,7228
050,09,110,"Connecticut","Capitol Planning Region",4,20,15499,7711,7788
050,09,110,"Connecticut","Capitol Planning Region",4,21,15003,7566,7437
050,09,110,"Connecticut","Capitol Planning Region",4,22,13924,7109,6815
050,09,110,"Connecticut","Capitol Planning Region",4,23,12610,6467,6143
050,09,110,"Connecticut","Capitol Planning Region",4,24,12401,6343,6058
050,09,110,"Connecticut","Capitol Planning Region",4,25,12381,6339,6042
050,09,110,"Connecticut","Capitol Planning Region",4,26,12257,6286,5971
050,09,110,"Connecticut","Capitol Planning Region",4,27,12457,6353,6104
050,09,110,"Connecticut","Capitol Planning Region",4,28,12788,6574,6214
050,09,110,"Connecticut","Capitol Planning Region",4,29,12875,6562,6313
050,09,110,"Connecticut","Capitol Planning Region",4,30,12754,6457,6297
050,09,110,"Connecticut","Capitol Planning Region",4,31,12826,6614,6212
050,09,110,"Connecticut","Capitol Planning Region",4,32,12719,6544,6175
050,09,110,"Connecticut","Capitol Planning Region",4,33,12644,6446,6198
050,09,110,"Connecticut","Capitol Planning Region",4,34,12762,6461,6301
050,09,110,"Connecticut","Capitol Planning Region",4,35,13004,6600,6404
050,09,110,"Connecticut","Capitol Planning Region",4,36,13119,6595,6524
050,09,110,"Connecticut","Capitol Planning Region",4,37,13004,6604,6400
050,09,110,"Connecticut","Capitol Planning Region",4,38,12692,6365,6327
050,09,110,"Connecticut","Capitol Planning Region",4,39,12909,6462,6447
050,09,110,"Connecticut","Capitol Planning Region",4,40,12808,6392,6416
050,09,110,"Connecticut","Capitol Planning Region",4,41,12584,6182,6402
050,09,110,"Connecticut","Capitol Planning Region",4,42,12534,6159,6375
050,09,110,"Connecticut","Capitol Planning Region",4,43,11972,5888,6084
050,09,110,"Connecticut","Capitol Planning Region",4,44,11648,5760,5888
050,09,110,"Connecticut","Capitol Planning Region",4,45,11399,5592,5807
050,09,110,"Connecticut","Capitol Planning Region",4,46,10891,5405,5486
050,09,110,"Connecticut","Capitol Planning Region",4,47,11035,5469,5566
050,09,110,"Connecticut","Capitol Planning Region",4,48,10807,5227,5580
050,09,110,"Connecticut","Capitol Planning Region",4,49,11015,5310,5705
050,09,110,"Connecticut","Capitol Planning Region",4,50,11697,5751,5946
050,09,110,"Connecticut","Capitol Planning Region",4,51,12715,6239,6476
050,09,110,"Connecticut","Capitol Planning Region",4,52,12746,6152,6594
050,09,110,"Connecticut","Capitol Planning Region",4,53,12428,6025,6403
050,09,110,"Connecticut","Capitol Planning Region",4,54,12416,6078,6338
050,09,110,"Connecticut","Capitol Planning Region",4,55,12691,6175,6516
050,09,110,"Connecticut","Capitol Planning Region",4,56,13100,6414,6686
050,09,110,"Connecticut","Capitol Planning Region",4,57,13634,6540,7094
050,09,110,"Connecticut","Capitol Planning Region",4,58,13725,6652,7073
050,09,110,"Connecticut","Capitol Planning Region",4,59,13603,6586,7017
050,09,110,"Connecticut","Capitol Planning Region",4,60,13502,6542,6960
050,09,110,"Connecticut","Capitol Planning Region",4,61,13492,6534,6958
050,09,110,"Connecticut","Capitol Planning Region",4,62,13078,6391,6687
050,09,110,"Connecticut","Capitol Planning Region",4,63,12764,6173,6591
050,09,110,"Connecticut","Capitol Planning Region",4,64,12562,6033,6529
050,09,110,"Connecticut","Capitol Planning Region",4,65,12366,6015,6351
050,09,110,"Connecticut","Capitol Planning Region",4,66,11695,5588,6107
050,09,110,"Connecticut","Capitol Planning Region",4,67,11191,5291,5900
050,09,110,"Connecticut","Capitol Planning Region",4,68,10659,4968,5691
050,09,110,"Connecticut","Capitol Planning Region",4,69,10184,4769,5415
050,09,110,"Connecticut","Capitol Planning Region",4,70,9772,4538,5234
050,09,110,"Connecticut","Capitol Planning Region",4,71,9124,4167,4957
050,09,110,"Connecticut","Capitol Planning Region",4,72,8616,3917,4699
050,09,110,"Connecticut","Capitol Planning Region",4,73,8430,3790,4640
050,09,110,"Connecticut","Capitol Planning Region",4,74,8399,3709,4690
050,09,110,"Connecticut","Capitol Planning Region",4,75,8909,3993,4916
050,09,110,"Connecticut","Capitol Planning Region",4,76,6501,2846,3655
050,09,110,"Connecticut","Capitol Planning Region",4,77,6212,2742,3470
050,09,110,"Connecticut","Capitol Planning Region",4,78,5977,2644,3333
050,09,110,"Connecticut","Capitol Planning Region",4,79,6144,2684,3460
050,09,110,"Connecticut","Capitol Planning Region",4,80,5172,2221,2951
050,09,110,"Connecticut","Capitol Planning Region",4,81,4394,1861,2533
050,09,110,"Connecticut","Capitol Planning Region",4,82,3933,1642,2291
050,09,110,"Connecticut","Capitol Planning Region",4,83,3669,1501,2168
050,09,110,"Connecticut","Capitol Planning Region",4,84,3401,1378,2023
050,09,110,"Connecticut","Capitol Planning Region",4,85,21023,7197,13826
050,09,110,"Connecticut","Capitol Planning Region",5,0,9385,4810,4575
050,09,110,"Connecticut","Capitol Planning Region",5,1,9742,4987,4755
050,09,110,"Connecticut","Capitol Planning Region",5,2,9605,4984,4621
050,09,110,"Connecticut","Capitol Planning Region",5,3,10053,5157,4896
050,09,110,"Connecticut","Capitol Planning Region",5,4,10246,5337,4909
050,09,110,"Connecticut","Capitol Planning Region",5,5,10474,5390,5084
050,09,110,"Connecticut","Capitol Planning Region",5,6,10466,5244,5222
050,09,110,"Connecticut","Capitol Planning Region",5,7,10639,5433,5206
050,09,110,"Connecticut","Capitol Planning Region",5,8,10895,5522,5373
050,09,110,"Connecticut","Capitol Planning Region",5,9,10861,5554,5307
050,09,110,"Connecticut","Capitol Planning Region",5,10,10809,5513,5296
050,09,110,"Connecticut","Capitol Planning Region",5,11,10987,5564,5423
050,09,110,"Connecticut","Capitol Planning Region",5,12,11172,5641,5531
050,09,110,"Connecticut","Capitol Planning Region",5,13,11525,5790,5735
050,09,110,"Connecticut","Capitol Planning Region",5,14,11706,5902,5804
050,09,110,"Connecticut","Capitol Planning Region",5,15,12109,6057,6052
050,09,110,"Connecticut","Capitol Planning Region",5,16,12241,6138,6103
050,09,110,"Connecticut","Capitol Planning Region",5,17,12273,6156,6117
050,09,110,"Connecticut","Capitol Planning Region",5,18,13926,7039,6887
050,09,110,"Connecticut","Capitol Planning Region",5,19,15046,7671,7375
050,09,110,"Connecticut","Capitol Planning Region",5,20,15615,7790,7825
050,09,110,"Connecticut","Capitol Planning Region",5,21,14805,7477,7328
050,09,110,"Connecticut","Capitol Planning Region",5,22,13872,7193,6679
050,09,110,"Connecticut","Capitol Planning Region",5,23,12618,6497,6121
050,09,110,"Connecticut","Capitol Planning Region",5,24,12275,6296,5979
050,09,110,"Connecticut","Capitol Planning Region",5,25,12434,6302,6132
050,09,110,"Connecticut","Capitol Planning Region",5,26,12358,6334,6024
050,09,110,"Connecticut","Capitol Planning Region",5,27,12237,6252,5985
050,09,110,"Connecticut","Capitol Planning Region",5,28,12540,6330,6210
050,09,110,"Connecticut","Capitol Planning Region",5,29,12881,6643,6238
050,09,110,"Connecticut","Capitol Planning Region",5,30,12994,6605,6389
050,09,110,"Connecticut","Capitol Planning Region",5,31,13009,6612,6397
050,09,110,"Connecticut","Capitol Planning Region",5,32,12944,6657,6287
050,09,110,"Connecticut","Capitol Planning Region",5,33,12908,6631,6277
050,09,110,"Connecticut","Capitol Planning Region",5,34,12830,6538,6292
050,09,110,"Connecticut","Capitol Planning Region",5,35,12900,6508,6392
050,09,110,"Connecticut","Capitol Planning Region",5,36,13094,6660,6434
050,09,110,"Connecticut","Capitol Planning Region",5,37,13228,6648,6580
050,09,110,"Connecticut","Capitol Planning Region",5,38,13069,6632,6437
050,09,110,"Connecticut","Capitol Planning Region",5,39,12740,6375,6365
050,09,110,"Connecticut","Capitol Planning Region",5,40,12946,6475,6471
050,09,110,"Connecticut","Capitol Planning Region",5,41,12883,6410,6473
050,09,110,"Connecticut","Capitol Planning Region",5,42,12583,6164,6419
050,09,110,"Connecticut","Capitol Planning Region",5,43,12692,6252,6440
050,09,110,"Connecticut","Capitol Planning Region",5,44,11990,5894,6096
050,09,110,"Connecticut","Capitol Planning Region",5,45,11694,5755,5939
050,09,110,"Connecticut","Capitol Planning Region",5,46,11408,5612,5796
050,09,110,"Connecticut","Capitol Planning Region",5,47,10882,5415,5467
050,09,110,"Connecticut","Capitol Planning Region",5,48,11058,5464,5594
050,09,110,"Connecticut","Capitol Planning Region",5,49,10775,5209,5566
050,09,110,"Connecticut","Capitol Planning Region",5,50,10963,5285,5678
050,09,110,"Connecticut","Capitol Planning Region",5,51,11619,5690,5929
050,09,110,"Connecticut","Capitol Planning Region",5,52,12616,6153,6463
050,09,110,"Connecticut","Capitol Planning Region",5,53,12605,6107,6498
050,09,110,"Connecticut","Capitol Planning Region",5,54,12323,5998,6325
050,09,110,"Connecticut","Capitol Planning Region",5,55,12318,5995,6323
050,09,110,"Connecticut","Capitol Planning Region",5,56,12500,6072,6428
050,09,110,"Connecticut","Capitol Planning Region",5,57,12927,6332,6595
050,09,110,"Connecticut","Capitol Planning Region",5,58,13467,6462,7005
050,09,110,"Connecticut","Capitol Planning Region",5,59,13478,6561,6917
050,09,110,"Connecticut","Capitol Planning Region",5,60,13351,6447,6904
050,09,110,"Connecticut","Capitol Planning Region",5,61,13297,6435,6862
050,09,110,"Connecticut","Capitol Planning Region",5,62,13226,6342,6884
050,09,110,"Connecticut","Capitol Planning Region",5,63,12831,6266,6565
050,09,110,"Connecticut","Capitol Planning Region",5,64,12448,5991,6457
050,09,110,"Connecticut","Capitol Planning Region",5,65,12334,5912,6422
050,09,110,"Connecticut","Capitol Planning Region",5,66,12158,5892,6266
050,09,110,"Connecticut","Capitol Planning Region",5,67,11512,5492,6020
050,09,110,"Connecticut","Capitol Planning Region",5,68,11027,5181,5846
050,09,110,"Connecticut","Capitol Planning Region",5,69,10435,4828,5607
050,09,110,"Connecticut","Capitol Planning Region",5,70,10005,4661,5344
050,09,110,"Connecticut","Capitol Planning Region",5,71,9622,4435,5187
050,09,110,"Connecticut","Capitol Planning Region",5,72,8954,4087,4867
050,09,110,"Connecticut","Capitol Planning Region",5,73,8481,3831,4650
050,09,110,"Connecticut","Capitol Planning Region",5,74,8249,3682,4567
050,09,110,"Connecticut","Capitol Planning Region",5,75,8166,3592,4574
050,09,110,"Connecticut","Capitol Planning Region",5,76,8704,3875,4829
050,09,110,"Connecticut","Capitol Planning Region",5,77,6358,2758,3600
050,09,110,"Connecticut","Capitol Planning Region",5,78,5943,2602,3341
050,09,110,"Connecticut","Capitol Planning Region",5,79,5776,2529,3247
050,09,110,"Connecticut","Capitol Planning Region",5,80,5869,2555,3314
050,09,110,"Connecticut","Capitol Planning Region",5,81,4933,2093,2840
050,09,110,"Connecticut","Capitol Planning Region",5,82,4221,1791,2430
050,09,110,"Connecticut","Capitol Planning Region",5,83,3732,1515,2217
050,09,110,"Connecticut","Capitol Planning Region",5,84,3369,1366,2003
050,09,110,"Connecticut","Capitol Planning Region",5,85,21089,7304,13785
050,09,120,"Connecticut","Greater Bridgeport Planning Region",1,0,3352,1707,1645
050,09,120,"Connecticut","Greater Bridgeport Planning Region",1,1,3460,1744,1716
050,09,120,"Connecticut","Greater Bridgeport Planning Region",1,2,3546,1821,1725
050,09,120,"Connecticut","Greater Bridgeport Planning Region",1,3,3653,1878,1775
050,09,120,"Connecticut","Greater Bridgeport Planning Region",1,4,3753,1910,1843
050,09,120,"Connecticut","Greater Bridgeport Planning Region",1,5,3798,1924,1874
050,09,120,"Connecticut","Greater Bridgeport Planning Region",1,6,3807,1934,1873
050,09,120,"Connecticut","Greater Bridgeport Planning Region",1,7,3845,1928,1917
050,09,120,"Connecticut","Greater Bridgeport Planning Region",1,8,3946,1985,1961
050,09,120,"Connecticut","Greater Bridgeport Planning Region",1,9,4059,2068,1991
050,09,120,"Connecticut","Greater Bridgeport Planning Region",1,10,4218,2143,2075
050,09,120,"Connecticut","Greater Bridgeport Planning Region",1,11,4445,2268,2177
050,09,120,"Connecticut","Greater Bridgeport Planning Region",1,12,4593,2356,2237
050,09,120,"Connecticut","Greater Bridgeport Planning Region",1,13,4659,2382,2277
050,09,120,"Connecticut","Greater Bridgeport Planning Region",1,14,4631,2341,2290
050,09,120,"Connecticut","Greater Bridgeport Planning Region",1,15,4596,2336,2260
050,09,120,"Connecticut","Greater Bridgeport Planning Region",1,16,4654,2385,2269
050,09,120,"Connecticut","Greater Bridgeport Planning Region",1,17,4610,2369,2241
050,09,120,"Connecticut","Greater Bridgeport Planning Region",1,18,5318,2602,2716
050,09,120,"Connecticut","Greater Bridgeport Planning Region",1,19,5482,2656,2826
050,09,120,"Connecticut","Greater Bridgeport Planning Region",1,20,5092,2500,2592
050,09,120,"Connecticut","Greater Bridgeport Planning Region",1,21,4749,2387,2362
050,09,120,"Connecticut","Greater Bridgeport Planning Region",1,22,4312,2160,2152
050,09,120,"Connecticut","Greater Bridgeport Planning Region",1,23,3989,2055,1934
050,09,120,"Connecticut","Greater Bridgeport Planning Region",1,24,3840,2003,1837
050,09,120,"Connecticut","Greater Bridgeport Planning Region",1,25,3689,1900,1789
050,09,120,"Connecticut","Greater Bridgeport Planning Region",1,26,3759,1932,1827
050,09,120,"Connecticut","Greater Bridgeport Planning Region",1,27,3760,1899,1861
050,09,120,"Connecticut","Greater Bridgeport Planning Region",1,28,3621,1838,1783
050,09,120,"Connecticut","Greater Bridgeport Planning Region",1,29,3569,1821,1748
050,09,120,"Connecticut","Greater Bridgeport Planning Region",1,30,3637,1810,1827
050,09,120,"Connecticut","Greater Bridgeport Planning Region",1,31,3627,1800,1827
050,09,120,"Connecticut","Greater Bridgeport Planning Region",1,32,3774,1867,1907
050,09,120,"Connecticut","Greater Bridgeport Planning Region",1,33,3903,1936,1967
050,09,120,"Connecticut","Greater Bridgeport Planning Region",1,34,4035,2027,2008
050,09,120,"Connecticut","Greater Bridgeport Planning Region",1,35,4004,2039,1965
050,09,120,"Connecticut","Greater Bridgeport Planning Region",1,36,4041,2051,1990
050,09,120,"Connecticut","Greater Bridgeport Planning Region",1,37,4131,2067,2064
050,09,120,"Connecticut","Greater Bridgeport Planning Region",1,38,4204,2100,2104
050,09,120,"Connecticut","Greater Bridgeport Planning Region",1,39,4224,2100,2124
050,09,120,"Connecticut","Greater Bridgeport Planning Region",1,40,4231,2066,2165
050,09,120,"Connecticut","Greater Bridgeport Planning Region",1,41,4159,2051,2108
050,09,120,"Connecticut","Greater Bridgeport Planning Region",1,42,4190,2099,2091
050,09,120,"Connecticut","Greater Bridgeport Planning Region",1,43,4151,2060,2091
050,09,120,"Connecticut","Greater Bridgeport Planning Region",1,44,4099,2038,2061
050,09,120,"Connecticut","Greater Bridgeport Planning Region",1,45,4099,2034,2065
050,09,120,"Connecticut","Greater Bridgeport Planning Region",1,46,4088,2012,2076
050,09,120,"Connecticut","Greater Bridgeport Planning Region",1,47,4237,2081,2156
050,09,120,"Connecticut","Greater Bridgeport Planning Region",1,48,4469,2200,2269
050,09,120,"Connecticut","Greater Bridgeport Planning Region",1,49,4785,2346,2439
050,09,120,"Connecticut","Greater Bridgeport Planning Region",1,50,4756,2347,2409
050,09,120,"Connecticut","Greater Bridgeport Planning Region",1,51,4613,2290,2323
050,09,120,"Connecticut","Greater Bridgeport Planning Region",1,52,4647,2273,2374
050,09,120,"Connecticut","Greater Bridgeport Planning Region",1,53,4780,2339,2441
050,09,120,"Connecticut","Greater Bridgeport Planning Region",1,54,4888,2398,2490
050,09,120,"Connecticut","Greater Bridgeport Planning Region",1,55,4953,2423,2530
050,09,120,"Connecticut","Greater Bridgeport Planning Region",1,56,4935,2398,2537
050,09,120,"Connecticut","Greater Bridgeport Planning Region",1,57,4815,2360,2455
050,09,120,"Connecticut","Greater Bridgeport Planning Region",1,58,4812,2341,2471
050,09,120,"Connecticut","Greater Bridgeport Planning Region",1,59,4690,2265,2425
050,09,120,"Connecticut","Greater Bridgeport Planning Region",1,60,4553,2227,2326
050,09,120,"Connecticut","Greater Bridgeport Planning Region",1,61,4392,2154,2238
050,09,120,"Connecticut","Greater Bridgeport Planning Region",1,62,4277,2105,2172
050,09,120,"Connecticut","Greater Bridgeport Planning Region",1,63,4069,1978,2091
050,09,120,"Connecticut","Greater Bridgeport Planning Region",1,64,3889,1910,1979
050,09,120,"Connecticut","Greater Bridgeport Planning Region",1,65,3695,1805,1890
050,09,120,"Connecticut","Greater Bridgeport Planning Region",1,66,3433,1690,1743
050,09,120,"Connecticut","Greater Bridgeport Planning Region",1,67,3199,1541,1658
050,09,120,"Connecticut","Greater Bridgeport Planning Region",1,68,2991,1423,1568
050,09,120,"Connecticut","Greater Bridgeport Planning Region",1,69,2756,1289,1467
050,09,120,"Connecticut","Greater Bridgeport Planning Region",1,70,2633,1210,1423
050,09,120,"Connecticut","Greater Bridgeport Planning Region",1,71,2537,1159,1378
050,09,120,"Connecticut","Greater Bridgeport Planning Region",1,72,2596,1186,1410
050,09,120,"Connecticut","Greater Bridgeport Planning Region",1,73,2680,1240,1440
050,09,120,"Connecticut","Greater Bridgeport Planning Region",1,74,1949,893,1056
050,09,120,"Connecticut","Greater Bridgeport Planning Region",1,75,1928,885,1043
050,09,120,"Connecticut","Greater Bridgeport Planning Region",1,76,1902,856,1046
050,09,120,"Connecticut","Greater Bridgeport Planning Region",1,77,1909,848,1061
050,09,120,"Connecticut","Greater Bridgeport Planning Region",1,78,1610,705,905
050,09,120,"Connecticut","Greater Bridgeport Planning Region",1,79,1439,614,825
050,09,120,"Connecticut","Greater Bridgeport Planning Region",1,80,1339,569,770
050,09,120,"Connecticut","Greater Bridgeport Planning Region",1,81,1244,519,725
050,09,120,"Connecticut","Greater Bridgeport Planning Region",1,82,1145,474,671
050,09,120,"Connecticut","Greater Bridgeport Planning Region",1,83,1054,443,611
050,09,120,"Connecticut","Greater Bridgeport Planning Region",1,84,999,406,593
050,09,120,"Connecticut","Greater Bridgeport Planning Region",1,85,6774,2366,4408
050,09,120,"Connecticut","Greater Bridgeport Planning Region",2,0,3355,1701,1654
050,09,120,"Connecticut","Greater Bridgeport Planning Region",2,1,3448,1740,1708
050,09,120,"Connecticut","Greater Bridgeport Planning Region",2,2,3538,1810,1728
050,09,120,"Connecticut","Greater Bridgeport Planning Region",2,3,3621,1858,1763
050,09,120,"Connecticut","Greater Bridgeport Planning Region",2,4,3738,1906,1832
050,09,120,"Connecticut","Greater Bridgeport Planning Region",2,5,3795,1926,1869
050,09,120,"Connecticut","Greater Bridgeport Planning Region",2,6,3817,1938,1879
050,09,120,"Connecticut","Greater Bridgeport Planning Region",2,7,3836,1931,1905
050,09,120,"Connecticut","Greater Bridgeport Planning Region",2,8,3910,1963,1947
050,09,120,"Connecticut","Greater Bridgeport Planning Region",2,9,4030,2048,1982
050,09,120,"Connecticut","Greater Bridgeport Planning Region",2,10,4185,2122,2063
050,09,120,"Connecticut","Greater Bridgeport Planning Region",2,11,4360,2223,2137
050,09,120,"Connecticut","Greater Bridgeport Planning Region",2,12,4569,2343,2226
050,09,120,"Connecticut","Greater Bridgeport Planning Region",2,13,4626,2368,2258
050,09,120,"Connecticut","Greater Bridgeport Planning Region",2,14,4627,2344,2283
050,09,120,"Connecticut","Greater Bridgeport Planning Region",2,15,4601,2334,2267
050,09,120,"Connecticut","Greater Bridgeport Planning Region",2,16,4636,2368,2268
050,09,120,"Connecticut","Greater Bridgeport Planning Region",2,17,4612,2367,2245
050,09,120,"Connecticut","Greater Bridgeport Planning Region",2,18,5244,2564,2680
050,09,120,"Connecticut","Greater Bridgeport Planning Region",2,19,5387,2615,2772
050,09,120,"Connecticut","Greater Bridgeport Planning Region",2,20,5069,2492,2577
050,09,120,"Connecticut","Greater Bridgeport Planning Region",2,21,4670,2343,2327
050,09,120,"Connecticut","Greater Bridgeport Planning Region",2,22,4270,2136,2134
050,09,120,"Connecticut","Greater Bridgeport Planning Region",2,23,3991,2051,1940
050,09,120,"Connecticut","Greater Bridgeport Planning Region",2,24,3816,1985,1831
050,09,120,"Connecticut","Greater Bridgeport Planning Region",2,25,3682,1902,1780
050,09,120,"Connecticut","Greater Bridgeport Planning Region",2,26,3714,1910,1804
050,09,120,"Connecticut","Greater Bridgeport Planning Region",2,27,3723,1887,1836
050,09,120,"Connecticut","Greater Bridgeport Planning Region",2,28,3637,1840,1797
050,09,120,"Connecticut","Greater Bridgeport Planning Region",2,29,3598,1827,1771
050,09,120,"Connecticut","Greater Bridgeport Planning Region",2,30,3647,1814,1833
050,09,120,"Connecticut","Greater Bridgeport Planning Region",2,31,3620,1798,1822
050,09,120,"Connecticut","Greater Bridgeport Planning Region",2,32,3741,1855,1886
050,09,120,"Connecticut","Greater Bridgeport Planning Region",2,33,3865,1919,1946
050,09,120,"Connecticut","Greater Bridgeport Planning Region",2,34,4003,2008,1995
050,09,120,"Connecticut","Greater Bridgeport Planning Region",2,35,4037,2051,1986
050,09,120,"Connecticut","Greater Bridgeport Planning Region",2,36,4024,2042,1982
050,09,120,"Connecticut","Greater Bridgeport Planning Region",2,37,4122,2072,2050
050,09,120,"Connecticut","Greater Bridgeport Planning Region",2,38,4210,2101,2109
050,09,120,"Connecticut","Greater Bridgeport Planning Region",2,39,4208,2096,2112
050,09,120,"Connecticut","Greater Bridgeport Planning Region",2,40,4261,2093,2168
050,09,120,"Connecticut","Greater Bridgeport Planning Region",2,41,4161,2044,2117
050,09,120,"Connecticut","Greater Bridgeport Planning Region",2,42,4162,2078,2084
050,09,120,"Connecticut","Greater Bridgeport Planning Region",2,43,4170,2072,2098
050,09,120,"Connecticut","Greater Bridgeport Planning Region",2,44,4075,2027,2048
050,09,120,"Connecticut","Greater Bridgeport Planning Region",2,45,4114,2043,2071
050,09,120,"Connecticut","Greater Bridgeport Planning Region",2,46,4067,2005,2062
050,09,120,"Connecticut","Greater Bridgeport Planning Region",2,47,4185,2053,2132
050,09,120,"Connecticut","Greater Bridgeport Planning Region",2,48,4414,2174,2240
050,09,120,"Connecticut","Greater Bridgeport Planning Region",2,49,4720,2320,2400
050,09,120,"Connecticut","Greater Bridgeport Planning Region",2,50,4769,2347,2422
050,09,120,"Connecticut","Greater Bridgeport Planning Region",2,51,4617,2289,2328
050,09,120,"Connecticut","Greater Bridgeport Planning Region",2,52,4621,2265,2356
050,09,120,"Connecticut","Greater Bridgeport Planning Region",2,53,4734,2317,2417
050,09,120,"Connecticut","Greater Bridgeport Planning Region",2,54,4828,2369,2459
050,09,120,"Connecticut","Greater Bridgeport Planning Region",2,55,4920,2410,2510
050,09,120,"Connecticut","Greater Bridgeport Planning Region",2,56,4941,2403,2538
050,09,120,"Connecticut","Greater Bridgeport Planning Region",2,57,4832,2363,2469
050,09,120,"Connecticut","Greater Bridgeport Planning Region",2,58,4792,2335,2457
050,09,120,"Connecticut","Greater Bridgeport Planning Region",2,59,4708,2276,2432
050,09,120,"Connecticut","Greater Bridgeport Planning Region",2,60,4566,2224,2342
050,09,120,"Connecticut","Greater Bridgeport Planning Region",2,61,4396,2151,2245
050,09,120,"Connecticut","Greater Bridgeport Planning Region",2,62,4266,2095,2171
050,09,120,"Connecticut","Greater Bridgeport Planning Region",2,63,4117,2006,2111
050,09,120,"Connecticut","Greater Bridgeport Planning Region",2,64,3883,1898,1985
050,09,120,"Connecticut","Greater Bridgeport Planning Region",2,65,3707,1811,1896
050,09,120,"Connecticut","Greater Bridgeport Planning Region",2,66,3477,1705,1772
050,09,120,"Connecticut","Greater Bridgeport Planning Region",2,67,3218,1554,1664
050,09,120,"Connecticut","Greater Bridgeport Planning Region",2,68,2993,1425,1568
050,09,120,"Connecticut","Greater Bridgeport Planning Region",2,69,2799,1311,1488
050,09,120,"Connecticut","Greater Bridgeport Planning Region",2,70,2638,1217,1421
050,09,120,"Connecticut","Greater Bridgeport Planning Region",2,71,2535,1156,1379
050,09,120,"Connecticut","Greater Bridgeport Planning Region",2,72,2522,1151,1371
050,09,120,"Connecticut","Greater Bridgeport Planning Region",2,73,2744,1265,1479
050,09,120,"Connecticut","Greater Bridgeport Planning Region",2,74,1979,907,1072
050,09,120,"Connecticut","Greater Bridgeport Planning Region",2,75,1913,878,1035
050,09,120,"Connecticut","Greater Bridgeport Planning Region",2,76,1866,844,1022
050,09,120,"Connecticut","Greater Bridgeport Planning Region",2,77,1912,853,1059
050,09,120,"Connecticut","Greater Bridgeport Planning Region",2,78,1628,716,912
050,09,120,"Connecticut","Greater Bridgeport Planning Region",2,79,1441,619,822
050,09,120,"Connecticut","Greater Bridgeport Planning Region",2,80,1329,567,762
050,09,120,"Connecticut","Greater Bridgeport Planning Region",2,81,1224,516,708
050,09,120,"Connecticut","Greater Bridgeport Planning Region",2,82,1135,471,664
050,09,120,"Connecticut","Greater Bridgeport Planning Region",2,83,1038,435,603
050,09,120,"Connecticut","Greater Bridgeport Planning Region",2,84,970,400,570
050,09,120,"Connecticut","Greater Bridgeport Planning Region",2,85,6418,2274,4144
050,09,120,"Connecticut","Greater Bridgeport Planning Region",3,0,3229,1636,1593
050,09,120,"Connecticut","Greater Bridgeport Planning Region",3,1,3474,1771,1703
050,09,120,"Connecticut","Greater Bridgeport Planning Region",3,2,3573,1810,1763
050,09,120,"Connecticut","Greater Bridgeport Planning Region",3,3,3596,1818,1778
050,09,120,"Connecticut","Greater Bridgeport Planning Region",3,4,3669,1893,1776
050,09,120,"Connecticut","Greater Bridgeport Planning Region",3,5,3785,1934,1851
050,09,120,"Connecticut","Greater Bridgeport Planning Region",3,6,3857,1964,1893
050,09,120,"Connecticut","Greater Bridgeport Planning Region",3,7,3839,1959,1880
050,09,120,"Connecticut","Greater Bridgeport Planning Region",3,8,3839,1949,1890
050,09,120,"Connecticut","Greater Bridgeport Planning Region",3,9,3911,1979,1932
050,09,120,"Connecticut","Greater Bridgeport Planning Region",3,10,4094,2064,2030
050,09,120,"Connecticut","Greater Bridgeport Planning Region",3,11,4183,2118,2065
050,09,120,"Connecticut","Greater Bridgeport Planning Region",3,12,4346,2235,2111
050,09,120,"Connecticut","Greater Bridgeport Planning Region",3,13,4614,2365,2249
050,09,120,"Connecticut","Greater Bridgeport Planning Region",3,14,4601,2358,2243
050,09,120,"Connecticut","Greater Bridgeport Planning Region",3,15,4595,2349,2246
050,09,120,"Connecticut","Greater Bridgeport Planning Region",3,16,4613,2344,2269
050,09,120,"Connecticut","Greater Bridgeport Planning Region",3,17,4603,2359,2244
050,09,120,"Connecticut","Greater Bridgeport Planning Region",3,18,5494,2685,2809
050,09,120,"Connecticut","Greater Bridgeport Planning Region",3,19,5591,2691,2900
050,09,120,"Connecticut","Greater Bridgeport Planning Region",3,20,5286,2595,2691
050,09,120,"Connecticut","Greater Bridgeport Planning Region",3,21,4830,2405,2425
050,09,120,"Connecticut","Greater Bridgeport Planning Region",3,22,4366,2202,2164
050,09,120,"Connecticut","Greater Bridgeport Planning Region",3,23,4050,2065,1985
050,09,120,"Connecticut","Greater Bridgeport Planning Region",3,24,3912,2006,1906
050,09,120,"Connecticut","Greater Bridgeport Planning Region",3,25,3746,1954,1792
050,09,120,"Connecticut","Greater Bridgeport Planning Region",3,26,3589,1840,1749
050,09,120,"Connecticut","Greater Bridgeport Planning Region",3,27,3678,1891,1787
050,09,120,"Connecticut","Greater Bridgeport Planning Region",3,28,3641,1887,1754
050,09,120,"Connecticut","Greater Bridgeport Planning Region",3,29,3755,1877,1878
050,09,120,"Connecticut","Greater Bridgeport Planning Region",3,30,3732,1891,1841
050,09,120,"Connecticut","Greater Bridgeport Planning Region",3,31,3824,1869,1955
050,09,120,"Connecticut","Greater Bridgeport Planning Region",3,32,3752,1854,1898
050,09,120,"Connecticut","Greater Bridgeport Planning Region",3,33,3901,1923,1978
050,09,120,"Connecticut","Greater Bridgeport Planning Region",3,34,3971,1986,1985
050,09,120,"Connecticut","Greater Bridgeport Planning Region",3,35,4162,2086,2076
050,09,120,"Connecticut","Greater Bridgeport Planning Region",3,36,4135,2104,2031
050,09,120,"Connecticut","Greater Bridgeport Planning Region",3,37,4159,2125,2034
050,09,120,"Connecticut","Greater Bridgeport Planning Region",3,38,4190,2118,2072
050,09,120,"Connecticut","Greater Bridgeport Planning Region",3,39,4290,2144,2146
050,09,120,"Connecticut","Greater Bridgeport Planning Region",3,40,4313,2141,2172
050,09,120,"Connecticut","Greater Bridgeport Planning Region",3,41,4306,2121,2185
050,09,120,"Connecticut","Greater Bridgeport Planning Region",3,42,4201,2074,2127
050,09,120,"Connecticut","Greater Bridgeport Planning Region",3,43,4166,2065,2101
050,09,120,"Connecticut","Greater Bridgeport Planning Region",3,44,4194,2088,2106
050,09,120,"Connecticut","Greater Bridgeport Planning Region",3,45,4131,2076,2055
050,09,120,"Connecticut","Greater Bridgeport Planning Region",3,46,4150,2056,2094
050,09,120,"Connecticut","Greater Bridgeport Planning Region",3,47,4061,1972,2089
050,09,120,"Connecticut","Greater Bridgeport Planning Region",3,48,4192,2050,2142
050,09,120,"Connecticut","Greater Bridgeport Planning Region",3,49,4436,2175,2261
050,09,120,"Connecticut","Greater Bridgeport Planning Region",3,50,4761,2351,2410
050,09,120,"Connecticut","Greater Bridgeport Planning Region",3,51,4710,2323,2387
050,09,120,"Connecticut","Greater Bridgeport Planning Region",3,52,4602,2283,2319
050,09,120,"Connecticut","Greater Bridgeport Planning Region",3,53,4624,2293,2331
050,09,120,"Connecticut","Greater Bridgeport Planning Region",3,54,4674,2290,2384
050,09,120,"Connecticut","Greater Bridgeport Planning Region",3,55,4777,2345,2432
050,09,120,"Connecticut","Greater Bridgeport Planning Region",3,56,4872,2390,2482
050,09,120,"Connecticut","Greater Bridgeport Planning Region",3,57,4865,2371,2494
050,09,120,"Connecticut","Greater Bridgeport Planning Region",3,58,4732,2298,2434
050,09,120,"Connecticut","Greater Bridgeport Planning Region",3,59,4679,2282,2397
050,09,120,"Connecticut","Greater Bridgeport Planning Region",3,60,4593,2225,2368
050,09,120,"Connecticut","Greater Bridgeport Planning Region",3,61,4453,2145,2308
050,09,120,"Connecticut","Greater Bridgeport Planning Region",3,62,4281,2090,2191
050,09,120,"Connecticut","Greater Bridgeport Planning Region",3,63,4216,2068,2148
050,09,120,"Connecticut","Greater Bridgeport Planning Region",3,64,3991,1929,2062
050,09,120,"Connecticut","Greater Bridgeport Planning Region",3,65,3791,1846,1945
050,09,120,"Connecticut","Greater Bridgeport Planning Region",3,66,3636,1769,1867
050,09,120,"Connecticut","Greater Bridgeport Planning Region",3,67,3418,1676,1742
050,09,120,"Connecticut","Greater Bridgeport Planning Region",3,68,3161,1521,1640
050,09,120,"Connecticut","Greater Bridgeport Planning Region",3,69,2949,1395,1554
050,09,120,"Connecticut","Greater Bridgeport Planning Region",3,70,2717,1265,1452
050,09,120,"Connecticut","Greater Bridgeport Planning Region",3,71,2587,1186,1401
050,09,120,"Connecticut","Greater Bridgeport Planning Region",3,72,2491,1132,1359
050,09,120,"Connecticut","Greater Bridgeport Planning Region",3,73,2470,1112,1358
050,09,120,"Connecticut","Greater Bridgeport Planning Region",3,74,2674,1231,1443
050,09,120,"Connecticut","Greater Bridgeport Planning Region",3,75,1948,885,1063
050,09,120,"Connecticut","Greater Bridgeport Planning Region",3,76,1872,847,1025
050,09,120,"Connecticut","Greater Bridgeport Planning Region",3,77,1825,811,1014
050,09,120,"Connecticut","Greater Bridgeport Planning Region",3,78,1836,807,1029
050,09,120,"Connecticut","Greater Bridgeport Planning Region",3,79,1565,675,890
050,09,120,"Connecticut","Greater Bridgeport Planning Region",3,80,1385,588,797
050,09,120,"Connecticut","Greater Bridgeport Planning Region",3,81,1285,540,745
050,09,120,"Connecticut","Greater Bridgeport Planning Region",3,82,1182,484,698
050,09,120,"Connecticut","Greater Bridgeport Planning Region",3,83,1077,434,643
050,09,120,"Connecticut","Greater Bridgeport Planning Region",3,84,986,399,587
050,09,120,"Connecticut","Greater Bridgeport Planning Region",3,85,6442,2290,4152
050,09,120,"Connecticut","Greater Bridgeport Planning Region",4,0,3428,1717,1711
050,09,120,"Connecticut","Greater Bridgeport Planning Region",4,1,3338,1669,1669
050,09,120,"Connecticut","Greater Bridgeport Planning Region",4,2,3537,1798,1739
050,09,120,"Connecticut","Greater Bridgeport Planning Region",4,3,3620,1835,1785
050,09,120,"Connecticut","Greater Bridgeport Planning Region",4,4,3677,1884,1793
050,09,120,"Connecticut","Greater Bridgeport Planning Region",4,5,3765,1901,1864
050,09,120,"Connecticut","Greater Bridgeport Planning Region",4,6,3885,1997,1888
050,09,120,"Connecticut","Greater Bridgeport Planning Region",4,7,3894,1986,1908
050,09,120,"Connecticut","Greater Bridgeport Planning Region",4,8,3883,1960,1923
050,09,120,"Connecticut","Greater Bridgeport Planning Region",4,9,3868,1974,1894
050,09,120,"Connecticut","Greater Bridgeport Planning Region",4,10,3938,1992,1946
050,09,120,"Connecticut","Greater Bridgeport Planning Region",4,11,4094,2093,2001
050,09,120,"Connecticut","Greater Bridgeport Planning Region",4,12,4233,2143,2090
050,09,120,"Connecticut","Greater Bridgeport Planning Region",4,13,4395,2255,2140
050,09,120,"Connecticut","Greater Bridgeport Planning Region",4,14,4629,2372,2257
050,09,120,"Connecticut","Greater Bridgeport Planning Region",4,15,4643,2397,2246
050,09,120,"Connecticut","Greater Bridgeport Planning Region",4,16,4615,2366,2249
050,09,120,"Connecticut","Greater Bridgeport Planning Region",4,17,4631,2342,2289
050,09,120,"Connecticut","Greater Bridgeport Planning Region",4,18,5508,2665,2843
050,09,120,"Connecticut","Greater Bridgeport Planning Region",4,19,5699,2773,2926
050,09,120,"Connecticut","Greater Bridgeport Planning Region",4,20,5247,2589,2658
050,09,120,"Connecticut","Greater Bridgeport Planning Region",4,21,4921,2490,2431
050,09,120,"Connecticut","Greater Bridgeport Planning Region",4,22,4438,2247,2191
050,09,120,"Connecticut","Greater Bridgeport Planning Region",4,23,4005,2031,1974
050,09,120,"Connecticut","Greater Bridgeport Planning Region",4,24,3836,1966,1870
050,09,120,"Connecticut","Greater Bridgeport Planning Region",4,25,3620,1878,1742
050,09,120,"Connecticut","Greater Bridgeport Planning Region",4,26,3593,1838,1755
050,09,120,"Connecticut","Greater Bridgeport Planning Region",4,27,3489,1772,1717
050,09,120,"Connecticut","Greater Bridgeport Planning Region",4,28,3560,1778,1782
050,09,120,"Connecticut","Greater Bridgeport Planning Region",4,29,3645,1855,1790
050,09,120,"Connecticut","Greater Bridgeport Planning Region",4,30,3763,1859,1904
050,09,120,"Connecticut","Greater Bridgeport Planning Region",4,31,3753,1920,1833
050,09,120,"Connecticut","Greater Bridgeport Planning Region",4,32,3840,1878,1962
050,09,120,"Connecticut","Greater Bridgeport Planning Region",4,33,3841,1891,1950
050,09,120,"Connecticut","Greater Bridgeport Planning Region",4,34,3976,1940,2036
050,09,120,"Connecticut","Greater Bridgeport Planning Region",4,35,4006,2015,1991
050,09,120,"Connecticut","Greater Bridgeport Planning Region",4,36,4202,2075,2127
050,09,120,"Connecticut","Greater Bridgeport Planning Region",4,37,4220,2155,2065
050,09,120,"Connecticut","Greater Bridgeport Planning Region",4,38,4325,2209,2116
050,09,120,"Connecticut","Greater Bridgeport Planning Region",4,39,4306,2153,2153
050,09,120,"Connecticut","Greater Bridgeport Planning Region",4,40,4343,2159,2184
050,09,120,"Connecticut","Greater Bridgeport Planning Region",4,41,4284,2125,2159
050,09,120,"Connecticut","Greater Bridgeport Planning Region",4,42,4399,2143,2256
050,09,120,"Connecticut","Greater Bridgeport Planning Region",4,43,4181,2079,2102
050,09,120,"Connecticut","Greater Bridgeport Planning Region",4,44,4192,2100,2092
050,09,120,"Connecticut","Greater Bridgeport Planning Region",4,45,4237,2123,2114
050,09,120,"Connecticut","Greater Bridgeport Planning Region",4,46,4107,2075,2032
050,09,120,"Connecticut","Greater Bridgeport Planning Region",4,47,4151,1997,2154
050,09,120,"Connecticut","Greater Bridgeport Planning Region",4,48,4047,1954,2093
050,09,120,"Connecticut","Greater Bridgeport Planning Region",4,49,4223,2067,2156
050,09,120,"Connecticut","Greater Bridgeport Planning Region",4,50,4441,2174,2267
050,09,120,"Connecticut","Greater Bridgeport Planning Region",4,51,4713,2338,2375
050,09,120,"Connecticut","Greater Bridgeport Planning Region",4,52,4662,2283,2379
050,09,120,"Connecticut","Greater Bridgeport Planning Region",4,53,4543,2243,2300
050,09,120,"Connecticut","Greater Bridgeport Planning Region",4,54,4613,2298,2315
050,09,120,"Connecticut","Greater Bridgeport Planning Region",4,55,4624,2261,2363
050,09,120,"Connecticut","Greater Bridgeport Planning Region",4,56,4716,2303,2413
050,09,120,"Connecticut","Greater Bridgeport Planning Region",4,57,4806,2358,2448
050,09,120,"Connecticut","Greater Bridgeport Planning Region",4,58,4782,2346,2436
050,09,120,"Connecticut","Greater Bridgeport Planning Region",4,59,4663,2266,2397
050,09,120,"Connecticut","Greater Bridgeport Planning Region",4,60,4576,2221,2355
050,09,120,"Connecticut","Greater Bridgeport Planning Region",4,61,4461,2150,2311
050,09,120,"Connecticut","Greater Bridgeport Planning Region",4,62,4310,2085,2225
050,09,120,"Connecticut","Greater Bridgeport Planning Region",4,63,4173,2039,2134
050,09,120,"Connecticut","Greater Bridgeport Planning Region",4,64,4128,2018,2110
050,09,120,"Connecticut","Greater Bridgeport Planning Region",4,65,3913,1883,2030
050,09,120,"Connecticut","Greater Bridgeport Planning Region",4,66,3704,1808,1896
050,09,120,"Connecticut","Greater Bridgeport Planning Region",4,67,3540,1727,1813
050,09,120,"Connecticut","Greater Bridgeport Planning Region",4,68,3335,1638,1697
050,09,120,"Connecticut","Greater Bridgeport Planning Region",4,69,3091,1483,1608
050,09,120,"Connecticut","Greater Bridgeport Planning Region",4,70,2881,1354,1527
050,09,120,"Connecticut","Greater Bridgeport Planning Region",4,71,2644,1217,1427
050,09,120,"Connecticut","Greater Bridgeport Planning Region",4,72,2538,1158,1380
050,09,120,"Connecticut","Greater Bridgeport Planning Region",4,73,2414,1097,1317
050,09,120,"Connecticut","Greater Bridgeport Planning Region",4,74,2415,1083,1332
050,09,120,"Connecticut","Greater Bridgeport Planning Region",4,75,2600,1195,1405
050,09,120,"Connecticut","Greater Bridgeport Planning Region",4,76,1891,852,1039
050,09,120,"Connecticut","Greater Bridgeport Planning Region",4,77,1834,817,1017
050,09,120,"Connecticut","Greater Bridgeport Planning Region",4,78,1756,772,984
050,09,120,"Connecticut","Greater Bridgeport Planning Region",4,79,1758,770,988
050,09,120,"Connecticut","Greater Bridgeport Planning Region",4,80,1516,640,876
050,09,120,"Connecticut","Greater Bridgeport Planning Region",4,81,1329,557,772
050,09,120,"Connecticut","Greater Bridgeport Planning Region",4,82,1222,517,705
050,09,120,"Connecticut","Greater Bridgeport Planning Region",4,83,1131,449,682
050,09,120,"Connecticut","Greater Bridgeport Planning Region",4,84,1032,406,626
050,09,120,"Connecticut","Greater Bridgeport Planning Region",4,85,6340,2261,4079
050,09,120,"Connecticut","Greater Bridgeport Planning Region",5,0,3363,1684,1679
050,09,120,"Connecticut","Greater Bridgeport Planning Region",5,1,3577,1797,1780
050,09,120,"Connecticut","Greater Bridgeport Planning Region",5,2,3439,1724,1715
050,09,120,"Connecticut","Greater Bridgeport Planning Region",5,3,3623,1835,1788
050,09,120,"Connecticut","Greater Bridgeport Planning Region",5,4,3667,1883,1784
050,09,120,"Connecticut","Greater Bridgeport Planning Region",5,5,3752,1908,1844
050,09,120,"Connecticut","Greater Bridgeport Planning Region",5,6,3784,1929,1855
050,09,120,"Connecticut","Greater Bridgeport Planning Region",5,7,3902,2024,1878
050,09,120,"Connecticut","Greater Bridgeport Planning Region",5,8,3970,2006,1964
050,09,120,"Connecticut","Greater Bridgeport Planning Region",5,9,3878,1966,1912
050,09,120,"Connecticut","Greater Bridgeport Planning Region",5,10,3903,1976,1927
050,09,120,"Connecticut","Greater Bridgeport Planning Region",5,11,3947,2007,1940
050,09,120,"Connecticut","Greater Bridgeport Planning Region",5,12,4085,2078,2007
050,09,120,"Connecticut","Greater Bridgeport Planning Region",5,13,4247,2166,2081
050,09,120,"Connecticut","Greater Bridgeport Planning Region",5,14,4379,2230,2149
050,09,120,"Connecticut","Greater Bridgeport Planning Region",5,15,4648,2402,2246
050,09,120,"Connecticut","Greater Bridgeport Planning Region",5,16,4644,2409,2235
050,09,120,"Connecticut","Greater Bridgeport Planning Region",5,17,4614,2374,2240
050,09,120,"Connecticut","Greater Bridgeport Planning Region",5,18,5513,2644,2869
050,09,120,"Connecticut","Greater Bridgeport Planning Region",5,19,5724,2762,2962
050,09,120,"Connecticut","Greater Bridgeport Planning Region",5,20,5295,2626,2669
050,09,120,"Connecticut","Greater Bridgeport Planning Region",5,21,4885,2474,2411
050,09,120,"Connecticut","Greater Bridgeport Planning Region",5,22,4522,2311,2211
050,09,120,"Connecticut","Greater Bridgeport Planning Region",5,23,4051,2072,1979
050,09,120,"Connecticut","Greater Bridgeport Planning Region",5,24,3801,1927,1874
050,09,120,"Connecticut","Greater Bridgeport Planning Region",5,25,3612,1863,1749
050,09,120,"Connecticut","Greater Bridgeport Planning Region",5,26,3514,1805,1709
050,09,120,"Connecticut","Greater Bridgeport Planning Region",5,27,3515,1783,1732
050,09,120,"Connecticut","Greater Bridgeport Planning Region",5,28,3415,1712,1703
050,09,120,"Connecticut","Greater Bridgeport Planning Region",5,29,3602,1780,1822
050,09,120,"Connecticut","Greater Bridgeport Planning Region",5,30,3763,1895,1868
050,09,120,"Connecticut","Greater Bridgeport Planning Region",5,31,3793,1884,1909
050,09,120,"Connecticut","Greater Bridgeport Planning Region",5,32,3853,1979,1874
050,09,120,"Connecticut","Greater Bridgeport Planning Region",5,33,3931,1907,2024
050,09,120,"Connecticut","Greater Bridgeport Planning Region",5,34,3940,1945,1995
050,09,120,"Connecticut","Greater Bridgeport Planning Region",5,35,4025,1957,2068
050,09,120,"Connecticut","Greater Bridgeport Planning Region",5,36,4000,2003,1997
050,09,120,"Connecticut","Greater Bridgeport Planning Region",5,37,4295,2118,2177
050,09,120,"Connecticut","Greater Bridgeport Planning Region",5,38,4279,2181,2098
050,09,120,"Connecticut","Greater Bridgeport Planning Region",5,39,4373,2224,2149
050,09,120,"Connecticut","Greater Bridgeport Planning Region",5,40,4340,2164,2176
050,09,120,"Connecticut","Greater Bridgeport Planning Region",5,41,4345,2167,2178
050,09,120,"Connecticut","Greater Bridgeport Planning Region",5,42,4297,2134,2163
050,09,120,"Connecticut","Greater Bridgeport Planning Region",5,43,4375,2131,2244
050,09,120,"Connecticut","Greater Bridgeport Planning Region",5,44,4191,2063,2128
050,09,120,"Connecticut","Greater Bridgeport Planning Region",5,45,4211,2095,2116
050,09,120,"Connecticut","Greater Bridgeport Planning Region",5,46,4256,2144,2112
050,09,120,"Connecticut","Greater Bridgeport Planning Region",5,47,4101,2043,2058
050,09,120,"Connecticut","Greater Bridgeport Planning Region",5,48,4160,1995,2165
050,09,120,"Connecticut","Greater Bridgeport Planning Region",5,49,4047,1959,2088
050,09,120,"Connecticut","Greater Bridgeport Planning Region",5,50,4193,2050,2143
050,09,120,"Connecticut","Greater Bridgeport Planning Region",5,51,4405,2158,2247
050,09,120,"Connecticut","Greater Bridgeport Planning Region",5,52,4626,2269,2357
050,09,120,"Connecticut","Greater Bridgeport Planning Region",5,53,4655,2301,2354
050,09,120,"Connecticut","Greater Bridgeport Planning Region",5,54,4477,2209,2268
050,09,120,"Connecticut","Greater Bridgeport Planning Region",5,55,4552,2275,2277
050,09,120,"Connecticut","Greater Bridgeport Planning Region",5,56,4572,2216,2356
050,09,120,"Connecticut","Greater Bridgeport Planning Region",5,57,4650,2276,2374
050,09,120,"Connecticut","Greater Bridgeport Planning Region",5,58,4763,2340,2423
050,09,120,"Connecticut","Greater Bridgeport Planning Region",5,59,4693,2296,2397
050,09,120,"Connecticut","Greater Bridgeport Planning Region",5,60,4563,2209,2354
050,09,120,"Connecticut","Greater Bridgeport Planning Region",5,61,4448,2162,2286
050,09,120,"Connecticut","Greater Bridgeport Planning Region",5,62,4401,2114,2287
050,09,120,"Connecticut","Greater Bridgeport Planning Region",5,63,4235,2032,2203
050,09,120,"Connecticut","Greater Bridgeport Planning Region",5,64,4071,1977,2094
050,09,120,"Connecticut","Greater Bridgeport Planning Region",5,65,4050,1959,2091
050,09,120,"Connecticut","Greater Bridgeport Planning Region",5,66,3807,1815,1992
050,09,120,"Connecticut","Greater Bridgeport Planning Region",5,67,3641,1771,1870
050,09,120,"Connecticut","Greater Bridgeport Planning Region",5,68,3482,1692,1790
050,09,120,"Connecticut","Greater Bridgeport Planning Region",5,69,3284,1593,1691
050,09,120,"Connecticut","Greater Bridgeport Planning Region",5,70,3041,1450,1591
050,09,120,"Connecticut","Greater Bridgeport Planning Region",5,71,2837,1324,1513
050,09,120,"Connecticut","Greater Bridgeport Planning Region",5,72,2613,1206,1407
050,09,120,"Connecticut","Greater Bridgeport Planning Region",5,73,2493,1130,1363
050,09,120,"Connecticut","Greater Bridgeport Planning Region",5,74,2373,1075,1298
050,09,120,"Connecticut","Greater Bridgeport Planning Region",5,75,2367,1053,1314
050,09,120,"Connecticut","Greater Bridgeport Planning Region",5,76,2541,1154,1387
050,09,120,"Connecticut","Greater Bridgeport Planning Region",5,77,1851,832,1019
050,09,120,"Connecticut","Greater Bridgeport Planning Region",5,78,1803,788,1015
050,09,120,"Connecticut","Greater Bridgeport Planning Region",5,79,1707,745,962
050,09,120,"Connecticut","Greater Bridgeport Planning Region",5,80,1708,744,964
050,09,120,"Connecticut","Greater Bridgeport Planning Region",5,81,1449,607,842
050,09,120,"Connecticut","Greater Bridgeport Planning Region",5,82,1284,534,750
050,09,120,"Connecticut","Greater Bridgeport Planning Region",5,83,1153,477,676
050,09,120,"Connecticut","Greater Bridgeport Planning Region",5,84,1080,417,663
050,09,120,"Connecticut","Greater Bridgeport Planning Region",5,85,6337,2270,4067
050,09,130,"Connecticut","Lower Connecticut River Valley Planning Region",1,0,1366,692,674
050,09,130,"Connecticut","Lower Connecticut River Valley Planning Region",1,1,1386,692,694
050,09,130,"Connecticut","Lower Connecticut River Valley Planning Region",1,2,1424,750,674
050,09,130,"Connecticut","Lower Connecticut River Valley Planning Region",1,3,1405,736,669
050,09,130,"Connecticut","Lower Connecticut River Valley Planning Region",1,4,1472,781,691
050,09,130,"Connecticut","Lower Connecticut River Valley Planning Region",1,5,1544,760,784
050,09,130,"Connecticut","Lower Connecticut River Valley Planning Region",1,6,1513,756,757
050,09,130,"Connecticut","Lower Connecticut River Valley Planning Region",1,7,1540,765,775
050,09,130,"Connecticut","Lower Connecticut River Valley Planning Region",1,8,1618,837,781
050,09,130,"Connecticut","Lower Connecticut River Valley Planning Region",1,9,1637,857,780
050,09,130,"Connecticut","Lower Connecticut River Valley Planning Region",1,10,1674,850,824
050,09,130,"Connecticut","Lower Connecticut River Valley Planning Region",1,11,1725,878,847
050,09,130,"Connecticut","Lower Connecticut River Valley Planning Region",1,12,1846,946,900
050,09,130,"Connecticut","Lower Connecticut River Valley Planning Region",1,13,1878,951,927
050,09,130,"Connecticut","Lower Connecticut River Valley Planning Region",1,14,1944,1003,941
050,09,130,"Connecticut","Lower Connecticut River Valley Planning Region",1,15,1975,1044,931
050,09,130,"Connecticut","Lower Connecticut River Valley Planning Region",1,16,2092,1114,978
050,09,130,"Connecticut","Lower Connecticut River Valley Planning Region",1,17,2158,1134,1024
050,09,130,"Connecticut","Lower Connecticut River Valley Planning Region",1,18,2279,1170,1109
050,09,130,"Connecticut","Lower Connecticut River Valley Planning Region",1,19,2363,1180,1183
050,09,130,"Connecticut","Lower Connecticut River Valley Planning Region",1,20,2372,1199,1173
050,09,130,"Connecticut","Lower Connecticut River Valley Planning Region",1,21,2422,1266,1156
050,09,130,"Connecticut","Lower Connecticut River Valley Planning Region",1,22,2156,1121,1035
050,09,130,"Connecticut","Lower Connecticut River Valley Planning Region",1,23,1864,977,887
050,09,130,"Connecticut","Lower Connecticut River Valley Planning Region",1,24,1912,969,943
050,09,130,"Connecticut","Lower Connecticut River Valley Planning Region",1,25,2014,1057,957
050,09,130,"Connecticut","Lower Connecticut River Valley Planning Region",1,26,1984,1030,954
050,09,130,"Connecticut","Lower Connecticut River Valley Planning Region",1,27,1991,1045,946
050,09,130,"Connecticut","Lower Connecticut River Valley Planning Region",1,28,1965,1022,943
050,09,130,"Connecticut","Lower Connecticut River Valley Planning Region",1,29,2015,1039,976
050,09,130,"Connecticut","Lower Connecticut River Valley Planning Region",1,30,1985,989,996
050,09,130,"Connecticut","Lower Connecticut River Valley Planning Region",1,31,2008,986,1022
050,09,130,"Connecticut","Lower Connecticut River Valley Planning Region",1,32,2027,1010,1017
050,09,130,"Connecticut","Lower Connecticut River Valley Planning Region",1,33,2087,1060,1027
050,09,130,"Connecticut","Lower Connecticut River Valley Planning Region",1,34,2156,1075,1081
050,09,130,"Connecticut","Lower Connecticut River Valley Planning Region",1,35,2093,1073,1020
050,09,130,"Connecticut","Lower Connecticut River Valley Planning Region",1,36,2023,1003,1020
050,09,130,"Connecticut","Lower Connecticut River Valley Planning Region",1,37,2109,1046,1063
050,09,130,"Connecticut","Lower Connecticut River Valley Planning Region",1,38,2082,1003,1079
050,09,130,"Connecticut","Lower Connecticut River Valley Planning Region",1,39,2056,1005,1051
050,09,130,"Connecticut","Lower Connecticut River Valley Planning Region",1,40,1941,969,972
050,09,130,"Connecticut","Lower Connecticut River Valley Planning Region",1,41,1862,939,923
050,09,130,"Connecticut","Lower Connecticut River Valley Planning Region",1,42,1869,935,934
050,09,130,"Connecticut","Lower Connecticut River Valley Planning Region",1,43,1830,932,898
050,09,130,"Connecticut","Lower Connecticut River Valley Planning Region",1,44,1825,915,910
050,09,130,"Connecticut","Lower Connecticut River Valley Planning Region",1,45,1895,951,944
050,09,130,"Connecticut","Lower Connecticut River Valley Planning Region",1,46,1909,952,957
050,09,130,"Connecticut","Lower Connecticut River Valley Planning Region",1,47,2031,1006,1025
050,09,130,"Connecticut","Lower Connecticut River Valley Planning Region",1,48,2316,1128,1188
050,09,130,"Connecticut","Lower Connecticut River Valley Planning Region",1,49,2536,1279,1257
050,09,130,"Connecticut","Lower Connecticut River Valley Planning Region",1,50,2553,1252,1301
050,09,130,"Connecticut","Lower Connecticut River Valley Planning Region",1,51,2578,1251,1327
050,09,130,"Connecticut","Lower Connecticut River Valley Planning Region",1,52,2565,1258,1307
050,09,130,"Connecticut","Lower Connecticut River Valley Planning Region",1,53,2643,1310,1333
050,09,130,"Connecticut","Lower Connecticut River Valley Planning Region",1,54,2770,1360,1410
050,09,130,"Connecticut","Lower Connecticut River Valley Planning Region",1,55,2895,1416,1479
050,09,130,"Connecticut","Lower Connecticut River Valley Planning Region",1,56,2905,1416,1489
050,09,130,"Connecticut","Lower Connecticut River Valley Planning Region",1,57,2957,1450,1507
050,09,130,"Connecticut","Lower Connecticut River Valley Planning Region",1,58,2991,1489,1502
050,09,130,"Connecticut","Lower Connecticut River Valley Planning Region",1,59,3022,1462,1560
050,09,130,"Connecticut","Lower Connecticut River Valley Planning Region",1,60,2914,1443,1471
050,09,130,"Connecticut","Lower Connecticut River Valley Planning Region",1,61,2844,1425,1419
050,09,130,"Connecticut","Lower Connecticut River Valley Planning Region",1,62,2851,1408,1443
050,09,130,"Connecticut","Lower Connecticut River Valley Planning Region",1,63,2702,1352,1350
050,09,130,"Connecticut","Lower Connecticut River Valley Planning Region",1,64,2599,1301,1298
050,09,130,"Connecticut","Lower Connecticut River Valley Planning Region",1,65,2482,1221,1261
050,09,130,"Connecticut","Lower Connecticut River Valley Planning Region",1,66,2424,1155,1269
050,09,130,"Connecticut","Lower Connecticut River Valley Planning Region",1,67,2344,1116,1228
050,09,130,"Connecticut","Lower Connecticut River Valley Planning Region",1,68,2295,1099,1196
050,09,130,"Connecticut","Lower Connecticut River Valley Planning Region",1,69,2019,958,1061
050,09,130,"Connecticut","Lower Connecticut River Valley Planning Region",1,70,2030,955,1075
050,09,130,"Connecticut","Lower Connecticut River Valley Planning Region",1,71,1966,925,1041
050,09,130,"Connecticut","Lower Connecticut River Valley Planning Region",1,72,2029,964,1065
050,09,130,"Connecticut","Lower Connecticut River Valley Planning Region",1,73,2056,960,1096
050,09,130,"Connecticut","Lower Connecticut River Valley Planning Region",1,74,1429,682,747
050,09,130,"Connecticut","Lower Connecticut River Valley Planning Region",1,75,1423,664,759
050,09,130,"Connecticut","Lower Connecticut River Valley Planning Region",1,76,1434,637,797
050,09,130,"Connecticut","Lower Connecticut River Valley Planning Region",1,77,1420,625,795
050,09,130,"Connecticut","Lower Connecticut River Valley Planning Region",1,78,1191,545,646
050,09,130,"Connecticut","Lower Connecticut River Valley Planning Region",1,79,1028,462,566
050,09,130,"Connecticut","Lower Connecticut River Valley Planning Region",1,80,918,397,521
050,09,130,"Connecticut","Lower Connecticut River Valley Planning Region",1,81,870,400,470
050,09,130,"Connecticut","Lower Connecticut River Valley Planning Region",1,82,803,352,451
050,09,130,"Connecticut","Lower Connecticut River Valley Planning Region",1,83,720,301,419
050,09,130,"Connecticut","Lower Connecticut River Valley Planning Region",1,84,646,261,385
050,09,130,"Connecticut","Lower Connecticut River Valley Planning Region",1,85,4735,1630,3105
050,09,130,"Connecticut","Lower Connecticut River Valley Planning Region",2,0,1376,688,688
050,09,130,"Connecticut","Lower Connecticut River Valley Planning Region",2,1,1380,695,685
050,09,130,"Connecticut","Lower Connecticut River Valley Planning Region",2,2,1415,736,679
050,09,130,"Connecticut","Lower Connecticut River Valley Planning Region",2,3,1404,735,669
050,09,130,"Connecticut","Lower Connecticut River Valley Planning Region",2,4,1463,770,693
050,09,130,"Connecticut","Lower Connecticut River Valley Planning Region",2,5,1528,769,759
050,09,130,"Connecticut","Lower Connecticut River Valley Planning Region",2,6,1530,767,763
050,09,130,"Connecticut","Lower Connecticut River Valley Planning Region",2,7,1533,764,769
050,09,130,"Connecticut","Lower Connecticut River Valley Planning Region",2,8,1593,816,777
050,09,130,"Connecticut","Lower Connecticut River Valley Planning Region",2,9,1629,850,779
050,09,130,"Connecticut","Lower Connecticut River Valley Planning Region",2,10,1661,853,808
050,09,130,"Connecticut","Lower Connecticut River Valley Planning Region",2,11,1706,869,837
050,09,130,"Connecticut","Lower Connecticut River Valley Planning Region",2,12,1823,931,892
050,09,130,"Connecticut","Lower Connecticut River Valley Planning Region",2,13,1864,948,916
050,09,130,"Connecticut","Lower Connecticut River Valley Planning Region",2,14,1920,989,931
050,09,130,"Connecticut","Lower Connecticut River Valley Planning Region",2,15,1966,1032,934
050,09,130,"Connecticut","Lower Connecticut River Valley Planning Region",2,16,2070,1102,968
050,09,130,"Connecticut","Lower Connecticut River Valley Planning Region",2,17,2143,1128,1015
050,09,130,"Connecticut","Lower Connecticut River Valley Planning Region",2,18,2176,1130,1046
050,09,130,"Connecticut","Lower Connecticut River Valley Planning Region",2,19,2206,1107,1099
050,09,130,"Connecticut","Lower Connecticut River Valley Planning Region",2,20,2242,1138,1104
050,09,130,"Connecticut","Lower Connecticut River Valley Planning Region",2,21,2280,1185,1095
050,09,130,"Connecticut","Lower Connecticut River Valley Planning Region",2,22,2092,1091,1001
050,09,130,"Connecticut","Lower Connecticut River Valley Planning Region",2,23,1863,963,900
050,09,130,"Connecticut","Lower Connecticut River Valley Planning Region",2,24,1901,971,930
050,09,130,"Connecticut","Lower Connecticut River Valley Planning Region",2,25,1990,1046,944
050,09,130,"Connecticut","Lower Connecticut River Valley Planning Region",2,26,1990,1037,953
050,09,130,"Connecticut","Lower Connecticut River Valley Planning Region",2,27,1992,1044,948
050,09,130,"Connecticut","Lower Connecticut River Valley Planning Region",2,28,1970,1028,942
050,09,130,"Connecticut","Lower Connecticut River Valley Planning Region",2,29,2012,1037,975
050,09,130,"Connecticut","Lower Connecticut River Valley Planning Region",2,30,2012,1009,1003
050,09,130,"Connecticut","Lower Connecticut River Valley Planning Region",2,31,1990,977,1013
050,09,130,"Connecticut","Lower Connecticut River Valley Planning Region",2,32,2033,1005,1028
050,09,130,"Connecticut","Lower Connecticut River Valley Planning Region",2,33,2073,1049,1024
050,09,130,"Connecticut","Lower Connecticut River Valley Planning Region",2,34,2139,1075,1064
050,09,130,"Connecticut","Lower Connecticut River Valley Planning Region",2,35,2130,1085,1045
050,09,130,"Connecticut","Lower Connecticut River Valley Planning Region",2,36,2029,1015,1014
050,09,130,"Connecticut","Lower Connecticut River Valley Planning Region",2,37,2095,1044,1051
050,09,130,"Connecticut","Lower Connecticut River Valley Planning Region",2,38,2087,1014,1073
050,09,130,"Connecticut","Lower Connecticut River Valley Planning Region",2,39,2063,1010,1053
050,09,130,"Connecticut","Lower Connecticut River Valley Planning Region",2,40,1983,986,997
050,09,130,"Connecticut","Lower Connecticut River Valley Planning Region",2,41,1876,944,932
050,09,130,"Connecticut","Lower Connecticut River Valley Planning Region",2,42,1855,929,926
050,09,130,"Connecticut","Lower Connecticut River Valley Planning Region",2,43,1852,942,910
050,09,130,"Connecticut","Lower Connecticut River Valley Planning Region",2,44,1820,917,903
050,09,130,"Connecticut","Lower Connecticut River Valley Planning Region",2,45,1880,945,935
050,09,130,"Connecticut","Lower Connecticut River Valley Planning Region",2,46,1892,944,948
050,09,130,"Connecticut","Lower Connecticut River Valley Planning Region",2,47,1994,990,1004
050,09,130,"Connecticut","Lower Connecticut River Valley Planning Region",2,48,2245,1098,1147
050,09,130,"Connecticut","Lower Connecticut River Valley Planning Region",2,49,2485,1242,1243
050,09,130,"Connecticut","Lower Connecticut River Valley Planning Region",2,50,2553,1261,1292
050,09,130,"Connecticut","Lower Connecticut River Valley Planning Region",2,51,2559,1242,1317
050,09,130,"Connecticut","Lower Connecticut River Valley Planning Region",2,52,2559,1253,1306
050,09,130,"Connecticut","Lower Connecticut River Valley Planning Region",2,53,2619,1294,1325
050,09,130,"Connecticut","Lower Connecticut River Valley Planning Region",2,54,2735,1349,1386
050,09,130,"Connecticut","Lower Connecticut River Valley Planning Region",2,55,2859,1396,1463
050,09,130,"Connecticut","Lower Connecticut River Valley Planning Region",2,56,2906,1411,1495
050,09,130,"Connecticut","Lower Connecticut River Valley Planning Region",2,57,2950,1447,1503
050,09,130,"Connecticut","Lower Connecticut River Valley Planning Region",2,58,2978,1479,1499
050,09,130,"Connecticut","Lower Connecticut River Valley Planning Region",2,59,3016,1467,1549
050,09,130,"Connecticut","Lower Connecticut River Valley Planning Region",2,60,2922,1442,1480
050,09,130,"Connecticut","Lower Connecticut River Valley Planning Region",2,61,2841,1419,1422
050,09,130,"Connecticut","Lower Connecticut River Valley Planning Region",2,62,2844,1409,1435
050,09,130,"Connecticut","Lower Connecticut River Valley Planning Region",2,63,2746,1369,1377
050,09,130,"Connecticut","Lower Connecticut River Valley Planning Region",2,64,2589,1289,1300
050,09,130,"Connecticut","Lower Connecticut River Valley Planning Region",2,65,2503,1236,1267
050,09,130,"Connecticut","Lower Connecticut River Valley Planning Region",2,66,2431,1169,1262
050,09,130,"Connecticut","Lower Connecticut River Valley Planning Region",2,67,2352,1121,1231
050,09,130,"Connecticut","Lower Connecticut River Valley Planning Region",2,68,2282,1094,1188
050,09,130,"Connecticut","Lower Connecticut River Valley Planning Region",2,69,2089,990,1099
050,09,130,"Connecticut","Lower Connecticut River Valley Planning Region",2,70,2006,945,1061
050,09,130,"Connecticut","Lower Connecticut River Valley Planning Region",2,71,1972,926,1046
050,09,130,"Connecticut","Lower Connecticut River Valley Planning Region",2,72,1976,936,1040
050,09,130,"Connecticut","Lower Connecticut River Valley Planning Region",2,73,2137,1001,1136
050,09,130,"Connecticut","Lower Connecticut River Valley Planning Region",2,74,1469,691,778
050,09,130,"Connecticut","Lower Connecticut River Valley Planning Region",2,75,1419,666,753
050,09,130,"Connecticut","Lower Connecticut River Valley Planning Region",2,76,1407,635,772
050,09,130,"Connecticut","Lower Connecticut River Valley Planning Region",2,77,1440,634,806
050,09,130,"Connecticut","Lower Connecticut River Valley Planning Region",2,78,1214,550,664
050,09,130,"Connecticut","Lower Connecticut River Valley Planning Region",2,79,1054,477,577
050,09,130,"Connecticut","Lower Connecticut River Valley Planning Region",2,80,928,403,525
050,09,130,"Connecticut","Lower Connecticut River Valley Planning Region",2,81,851,381,470
050,09,130,"Connecticut","Lower Connecticut River Valley Planning Region",2,82,806,358,448
050,09,130,"Connecticut","Lower Connecticut River Valley Planning Region",2,83,715,301,414
050,09,130,"Connecticut","Lower Connecticut River Valley Planning Region",2,84,642,259,383
050,09,130,"Connecticut","Lower Connecticut River Valley Planning Region",2,85,4648,1608,3040
050,09,130,"Connecticut","Lower Connecticut River Valley Planning Region",3,0,1351,719,632
050,09,130,"Connecticut","Lower Connecticut River Valley Planning Region",3,1,1409,699,710
050,09,130,"Connecticut","Lower Connecticut River Valley Planning Region",3,2,1402,702,700
050,09,130,"Connecticut","Lower Connecticut River Valley Planning Region",3,3,1443,751,692
050,09,130,"Connecticut","Lower Connecticut River Valley Planning Region",3,4,1424,749,675
050,09,130,"Connecticut","Lower Connecticut River Valley Planning Region",3,5,1514,781,733
050,09,130,"Connecticut","Lower Connecticut River Valley Planning Region",3,6,1577,788,789
050,09,130,"Connecticut","Lower Connecticut River Valley Planning Region",3,7,1542,770,772
050,09,130,"Connecticut","Lower Connecticut River Valley Planning Region",3,8,1575,772,803
050,09,130,"Connecticut","Lower Connecticut River Valley Planning Region",3,9,1595,836,759
050,09,130,"Connecticut","Lower Connecticut River Valley Planning Region",3,10,1653,856,797
050,09,130,"Connecticut","Lower Connecticut River Valley Planning Region",3,11,1685,864,821
050,09,130,"Connecticut","Lower Connecticut River Valley Planning Region",3,12,1746,891,855
050,09,130,"Connecticut","Lower Connecticut River Valley Planning Region",3,13,1838,929,909
050,09,130,"Connecticut","Lower Connecticut River Valley Planning Region",3,14,1895,967,928
050,09,130,"Connecticut","Lower Connecticut River Valley Planning Region",3,15,1933,1008,925
050,09,130,"Connecticut","Lower Connecticut River Valley Planning Region",3,16,2001,1049,952
050,09,130,"Connecticut","Lower Connecticut River Valley Planning Region",3,17,2115,1110,1005
050,09,130,"Connecticut","Lower Connecticut River Valley Planning Region",3,18,2301,1205,1096
050,09,130,"Connecticut","Lower Connecticut River Valley Planning Region",3,19,2450,1216,1234
050,09,130,"Connecticut","Lower Connecticut River Valley Planning Region",3,20,2410,1219,1191
050,09,130,"Connecticut","Lower Connecticut River Valley Planning Region",3,21,2410,1235,1175
050,09,130,"Connecticut","Lower Connecticut River Valley Planning Region",3,22,2237,1149,1088
050,09,130,"Connecticut","Lower Connecticut River Valley Planning Region",3,23,1895,957,938
050,09,130,"Connecticut","Lower Connecticut River Valley Planning Region",3,24,1888,959,929
050,09,130,"Connecticut","Lower Connecticut River Valley Planning Region",3,25,2019,1027,992
050,09,130,"Connecticut","Lower Connecticut River Valley Planning Region",3,26,1986,1048,938
050,09,130,"Connecticut","Lower Connecticut River Valley Planning Region",3,27,2082,1085,997
050,09,130,"Connecticut","Lower Connecticut River Valley Planning Region",3,28,2046,1068,978
050,09,130,"Connecticut","Lower Connecticut River Valley Planning Region",3,29,1998,1037,961
050,09,130,"Connecticut","Lower Connecticut River Valley Planning Region",3,30,2072,1066,1006
050,09,130,"Connecticut","Lower Connecticut River Valley Planning Region",3,31,2056,1024,1032
050,09,130,"Connecticut","Lower Connecticut River Valley Planning Region",3,32,2079,1042,1037
050,09,130,"Connecticut","Lower Connecticut River Valley Planning Region",3,33,2118,1040,1078
050,09,130,"Connecticut","Lower Connecticut River Valley Planning Region",3,34,2124,1074,1050
050,09,130,"Connecticut","Lower Connecticut River Valley Planning Region",3,35,2177,1093,1084
050,09,130,"Connecticut","Lower Connecticut River Valley Planning Region",3,36,2161,1099,1062
050,09,130,"Connecticut","Lower Connecticut River Valley Planning Region",3,37,2133,1058,1075
050,09,130,"Connecticut","Lower Connecticut River Valley Planning Region",3,38,2135,1041,1094
050,09,130,"Connecticut","Lower Connecticut River Valley Planning Region",3,39,2142,1045,1097
050,09,130,"Connecticut","Lower Connecticut River Valley Planning Region",3,40,2103,1030,1073
050,09,130,"Connecticut","Lower Connecticut River Valley Planning Region",3,41,1971,1000,971
050,09,130,"Connecticut","Lower Connecticut River Valley Planning Region",3,42,1925,968,957
050,09,130,"Connecticut","Lower Connecticut River Valley Planning Region",3,43,1881,945,936
050,09,130,"Connecticut","Lower Connecticut River Valley Planning Region",3,44,1895,970,925
050,09,130,"Connecticut","Lower Connecticut River Valley Planning Region",3,45,1816,905,911
050,09,130,"Connecticut","Lower Connecticut River Valley Planning Region",3,46,1889,926,963
050,09,130,"Connecticut","Lower Connecticut River Valley Planning Region",3,47,1932,986,946
050,09,130,"Connecticut","Lower Connecticut River Valley Planning Region",3,48,2039,1013,1026
050,09,130,"Connecticut","Lower Connecticut River Valley Planning Region",3,49,2248,1094,1154
050,09,130,"Connecticut","Lower Connecticut River Valley Planning Region",3,50,2486,1234,1252
050,09,130,"Connecticut","Lower Connecticut River Valley Planning Region",3,51,2556,1266,1290
050,09,130,"Connecticut","Lower Connecticut River Valley Planning Region",3,52,2571,1245,1326
050,09,130,"Connecticut","Lower Connecticut River Valley Planning Region",3,53,2559,1253,1306
050,09,130,"Connecticut","Lower Connecticut River Valley Planning Region",3,54,2656,1301,1355
050,09,130,"Connecticut","Lower Connecticut River Valley Planning Region",3,55,2721,1338,1383
050,09,130,"Connecticut","Lower Connecticut River Valley Planning Region",3,56,2848,1390,1458
050,09,130,"Connecticut","Lower Connecticut River Valley Planning Region",3,57,2897,1424,1473
050,09,130,"Connecticut","Lower Connecticut River Valley Planning Region",3,58,2967,1466,1501
050,09,130,"Connecticut","Lower Connecticut River Valley Planning Region",3,59,2969,1459,1510
050,09,130,"Connecticut","Lower Connecticut River Valley Planning Region",3,60,2993,1469,1524
050,09,130,"Connecticut","Lower Connecticut River Valley Planning Region",3,61,2905,1438,1467
050,09,130,"Connecticut","Lower Connecticut River Valley Planning Region",3,62,2867,1421,1446
050,09,130,"Connecticut","Lower Connecticut River Valley Planning Region",3,63,2824,1404,1420
050,09,130,"Connecticut","Lower Connecticut River Valley Planning Region",3,64,2714,1344,1370
050,09,130,"Connecticut","Lower Connecticut River Valley Planning Region",3,65,2568,1254,1314
050,09,130,"Connecticut","Lower Connecticut River Valley Planning Region",3,66,2462,1224,1238
050,09,130,"Connecticut","Lower Connecticut River Valley Planning Region",3,67,2392,1155,1237
050,09,130,"Connecticut","Lower Connecticut River Valley Planning Region",3,68,2316,1104,1212
050,09,130,"Connecticut","Lower Connecticut River Valley Planning Region",3,69,2271,1092,1179
050,09,130,"Connecticut","Lower Connecticut River Valley Planning Region",3,70,2070,968,1102
050,09,130,"Connecticut","Lower Connecticut River Valley Planning Region",3,71,1981,939,1042
050,09,130,"Connecticut","Lower Connecticut River Valley Planning Region",3,72,1948,913,1035
050,09,130,"Connecticut","Lower Connecticut River Valley Planning Region",3,73,1949,914,1035
050,09,130,"Connecticut","Lower Connecticut River Valley Planning Region",3,74,2082,971,1111
050,09,130,"Connecticut","Lower Connecticut River Valley Planning Region",3,75,1435,674,761
050,09,130,"Connecticut","Lower Connecticut River Valley Planning Region",3,76,1388,645,743
050,09,130,"Connecticut","Lower Connecticut River Valley Planning Region",3,77,1378,617,761
050,09,130,"Connecticut","Lower Connecticut River Valley Planning Region",3,78,1412,625,787
050,09,130,"Connecticut","Lower Connecticut River Valley Planning Region",3,79,1177,532,645
050,09,130,"Connecticut","Lower Connecticut River Valley Planning Region",3,80,1017,465,552
050,09,130,"Connecticut","Lower Connecticut River Valley Planning Region",3,81,872,374,498
050,09,130,"Connecticut","Lower Connecticut River Valley Planning Region",3,82,811,358,453
050,09,130,"Connecticut","Lower Connecticut River Valley Planning Region",3,83,750,336,414
050,09,130,"Connecticut","Lower Connecticut River Valley Planning Region",3,84,663,277,386
050,09,130,"Connecticut","Lower Connecticut River Valley Planning Region",3,85,4639,1608,3031
050,09,130,"Connecticut","Lower Connecticut River Valley Planning Region",4,0,1438,763,675
050,09,130,"Connecticut","Lower Connecticut River Valley Planning Region",4,1,1361,709,652
050,09,130,"Connecticut","Lower Connecticut River Valley Planning Region",4,2,1434,719,715
050,09,130,"Connecticut","Lower Connecticut River Valley Planning Region",4,3,1423,722,701
050,09,130,"Connecticut","Lower Connecticut River Valley Planning Region",4,4,1445,755,690
050,09,130,"Connecticut","Lower Connecticut River Valley Planning Region",4,5,1454,770,684
050,09,130,"Connecticut","Lower Connecticut River Valley Planning Region",4,6,1501,784,717
050,09,130,"Connecticut","Lower Connecticut River Valley Planning Region",4,7,1596,804,792
050,09,130,"Connecticut","Lower Connecticut River Valley Planning Region",4,8,1571,798,773
050,09,130,"Connecticut","Lower Connecticut River Valley Planning Region",4,9,1579,787,792
050,09,130,"Connecticut","Lower Connecticut River Valley Planning Region",4,10,1610,843,767
050,09,130,"Connecticut","Lower Connecticut River Valley Planning Region",4,11,1658,844,814
050,09,130,"Connecticut","Lower Connecticut River Valley Planning Region",4,12,1721,879,842
050,09,130,"Connecticut","Lower Connecticut River Valley Planning Region",4,13,1746,897,849
050,09,130,"Connecticut","Lower Connecticut River Valley Planning Region",4,14,1849,941,908
050,09,130,"Connecticut","Lower Connecticut River Valley Planning Region",4,15,1927,981,946
050,09,130,"Connecticut","Lower Connecticut River Valley Planning Region",4,16,1976,1030,946
050,09,130,"Connecticut","Lower Connecticut River Valley Planning Region",4,17,2041,1070,971
050,09,130,"Connecticut","Lower Connecticut River Valley Planning Region",4,18,2226,1163,1063
050,09,130,"Connecticut","Lower Connecticut River Valley Planning Region",4,19,2374,1213,1161
050,09,130,"Connecticut","Lower Connecticut River Valley Planning Region",4,20,2396,1213,1183
050,09,130,"Connecticut","Lower Connecticut River Valley Planning Region",4,21,2397,1231,1166
050,09,130,"Connecticut","Lower Connecticut River Valley Planning Region",4,22,2156,1106,1050
050,09,130,"Connecticut","Lower Connecticut River Valley Planning Region",4,23,1936,996,940
050,09,130,"Connecticut","Lower Connecticut River Valley Planning Region",4,24,1905,962,943
050,09,130,"Connecticut","Lower Connecticut River Valley Planning Region",4,25,1908,990,918
050,09,130,"Connecticut","Lower Connecticut River Valley Planning Region",4,26,2031,1029,1002
050,09,130,"Connecticut","Lower Connecticut River Valley Planning Region",4,27,2023,1076,947
050,09,130,"Connecticut","Lower Connecticut River Valley Planning Region",4,28,2064,1055,1009
050,09,130,"Connecticut","Lower Connecticut River Valley Planning Region",4,29,2089,1080,1009
050,09,130,"Connecticut","Lower Connecticut River Valley Planning Region",4,30,2079,1056,1023
050,09,130,"Connecticut","Lower Connecticut River Valley Planning Region",4,31,2100,1071,1029
050,09,130,"Connecticut","Lower Connecticut River Valley Planning Region",4,32,2146,1067,1079
050,09,130,"Connecticut","Lower Connecticut River Valley Planning Region",4,33,2089,1051,1038
050,09,130,"Connecticut","Lower Connecticut River Valley Planning Region",4,34,2182,1086,1096
050,09,130,"Connecticut","Lower Connecticut River Valley Planning Region",4,35,2156,1094,1062
050,09,130,"Connecticut","Lower Connecticut River Valley Planning Region",4,36,2176,1118,1058
050,09,130,"Connecticut","Lower Connecticut River Valley Planning Region",4,37,2233,1141,1092
050,09,130,"Connecticut","Lower Connecticut River Valley Planning Region",4,38,2141,1042,1099
050,09,130,"Connecticut","Lower Connecticut River Valley Planning Region",4,39,2151,1062,1089
050,09,130,"Connecticut","Lower Connecticut River Valley Planning Region",4,40,2147,1052,1095
050,09,130,"Connecticut","Lower Connecticut River Valley Planning Region",4,41,2090,1042,1048
050,09,130,"Connecticut","Lower Connecticut River Valley Planning Region",4,42,2001,1003,998
050,09,130,"Connecticut","Lower Connecticut River Valley Planning Region",4,43,1903,964,939
050,09,130,"Connecticut","Lower Connecticut River Valley Planning Region",4,44,1944,972,972
050,09,130,"Connecticut","Lower Connecticut River Valley Planning Region",4,45,1892,957,935
050,09,130,"Connecticut","Lower Connecticut River Valley Planning Region",4,46,1853,905,948
050,09,130,"Connecticut","Lower Connecticut River Valley Planning Region",4,47,1932,972,960
050,09,130,"Connecticut","Lower Connecticut River Valley Planning Region",4,48,1961,998,963
050,09,130,"Connecticut","Lower Connecticut River Valley Planning Region",4,49,2039,991,1048
050,09,130,"Connecticut","Lower Connecticut River Valley Planning Region",4,50,2255,1101,1154
050,09,130,"Connecticut","Lower Connecticut River Valley Planning Region",4,51,2482,1219,1263
050,09,130,"Connecticut","Lower Connecticut River Valley Planning Region",4,52,2588,1272,1316
050,09,130,"Connecticut","Lower Connecticut River Valley Planning Region",4,53,2575,1244,1331
050,09,130,"Connecticut","Lower Connecticut River Valley Planning Region",4,54,2580,1258,1322
050,09,130,"Connecticut","Lower Connecticut River Valley Planning Region",4,55,2631,1280,1351
050,09,130,"Connecticut","Lower Connecticut River Valley Planning Region",4,56,2711,1320,1391
050,09,130,"Connecticut","Lower Connecticut River Valley Planning Region",4,57,2839,1407,1432
050,09,130,"Connecticut","Lower Connecticut River Valley Planning Region",4,58,2952,1478,1474
050,09,130,"Connecticut","Lower Connecticut River Valley Planning Region",4,59,2928,1436,1492
050,09,130,"Connecticut","Lower Connecticut River Valley Planning Region",4,60,2909,1440,1469
050,09,130,"Connecticut","Lower Connecticut River Valley Planning Region",4,61,2936,1440,1496
050,09,130,"Connecticut","Lower Connecticut River Valley Planning Region",4,62,2925,1426,1499
050,09,130,"Connecticut","Lower Connecticut River Valley Planning Region",4,63,2851,1418,1433
050,09,130,"Connecticut","Lower Connecticut River Valley Planning Region",4,64,2770,1366,1404
050,09,130,"Connecticut","Lower Connecticut River Valley Planning Region",4,65,2698,1332,1366
050,09,130,"Connecticut","Lower Connecticut River Valley Planning Region",4,66,2494,1205,1289
050,09,130,"Connecticut","Lower Connecticut River Valley Planning Region",4,67,2417,1196,1221
050,09,130,"Connecticut","Lower Connecticut River Valley Planning Region",4,68,2358,1142,1216
050,09,130,"Connecticut","Lower Connecticut River Valley Planning Region",4,69,2300,1094,1206
050,09,130,"Connecticut","Lower Connecticut River Valley Planning Region",4,70,2275,1083,1192
050,09,130,"Connecticut","Lower Connecticut River Valley Planning Region",4,71,2036,959,1077
050,09,130,"Connecticut","Lower Connecticut River Valley Planning Region",4,72,1965,917,1048
050,09,130,"Connecticut","Lower Connecticut River Valley Planning Region",4,73,1908,890,1018
050,09,130,"Connecticut","Lower Connecticut River Valley Planning Region",4,74,1912,905,1007
050,09,130,"Connecticut","Lower Connecticut River Valley Planning Region",4,75,2064,967,1097
050,09,130,"Connecticut","Lower Connecticut River Valley Planning Region",4,76,1408,656,752
050,09,130,"Connecticut","Lower Connecticut River Valley Planning Region",4,77,1345,617,728
050,09,130,"Connecticut","Lower Connecticut River Valley Planning Region",4,78,1350,602,748
050,09,130,"Connecticut","Lower Connecticut River Valley Planning Region",4,79,1363,583,780
050,09,130,"Connecticut","Lower Connecticut River Valley Planning Region",4,80,1143,514,629
050,09,130,"Connecticut","Lower Connecticut River Valley Planning Region",4,81,960,424,536
050,09,130,"Connecticut","Lower Connecticut River Valley Planning Region",4,82,837,353,484
050,09,130,"Connecticut","Lower Connecticut River Valley Planning Region",4,83,785,343,442
050,09,130,"Connecticut","Lower Connecticut River Valley Planning Region",4,84,697,305,392
050,09,130,"Connecticut","Lower Connecticut River Valley Planning Region",4,85,4685,1623,3062
050,09,130,"Connecticut","Lower Connecticut River Valley Planning Region",5,0,1421,755,666
050,09,130,"Connecticut","Lower Connecticut River Valley Planning Region",5,1,1439,768,671
050,09,130,"Connecticut","Lower Connecticut River Valley Planning Region",5,2,1367,719,648
050,09,130,"Connecticut","Lower Connecticut River Valley Planning Region",5,3,1428,718,710
050,09,130,"Connecticut","Lower Connecticut River Valley Planning Region",5,4,1433,718,715
050,09,130,"Connecticut","Lower Connecticut River Valley Planning Region",5,5,1478,779,699
050,09,130,"Connecticut","Lower Connecticut River Valley Planning Region",5,6,1468,792,676
050,09,130,"Connecticut","Lower Connecticut River Valley Planning Region",5,7,1539,811,728
050,09,130,"Connecticut","Lower Connecticut River Valley Planning Region",5,8,1601,798,803
050,09,130,"Connecticut","Lower Connecticut River Valley Planning Region",5,9,1586,791,795
050,09,130,"Connecticut","Lower Connecticut River Valley Planning Region",5,10,1608,803,805
050,09,130,"Connecticut","Lower Connecticut River Valley Planning Region",5,11,1623,845,778
050,09,130,"Connecticut","Lower Connecticut River Valley Planning Region",5,12,1681,861,820
050,09,130,"Connecticut","Lower Connecticut River Valley Planning Region",5,13,1713,876,837
050,09,130,"Connecticut","Lower Connecticut River Valley Planning Region",5,14,1758,896,862
050,09,130,"Connecticut","Lower Connecticut River Valley Planning Region",5,15,1870,951,919
050,09,130,"Connecticut","Lower Connecticut River Valley Planning Region",5,16,1947,997,950
050,09,130,"Connecticut","Lower Connecticut River Valley Planning Region",5,17,2008,1044,964
050,09,130,"Connecticut","Lower Connecticut River Valley Planning Region",5,18,2131,1121,1010
050,09,130,"Connecticut","Lower Connecticut River Valley Planning Region",5,19,2317,1181,1136
050,09,130,"Connecticut","Lower Connecticut River Valley Planning Region",5,20,2342,1226,1116
050,09,130,"Connecticut","Lower Connecticut River Valley Planning Region",5,21,2405,1238,1167
050,09,130,"Connecticut","Lower Connecticut River Valley Planning Region",5,22,2161,1102,1059
050,09,130,"Connecticut","Lower Connecticut River Valley Planning Region",5,23,1916,981,935
050,09,130,"Connecticut","Lower Connecticut River Valley Planning Region",5,24,1948,999,949
050,09,130,"Connecticut","Lower Connecticut River Valley Planning Region",5,25,1925,1006,919
050,09,130,"Connecticut","Lower Connecticut River Valley Planning Region",5,26,1881,974,907
050,09,130,"Connecticut","Lower Connecticut River Valley Planning Region",5,27,2036,1017,1019
050,09,130,"Connecticut","Lower Connecticut River Valley Planning Region",5,28,2021,1055,966
050,09,130,"Connecticut","Lower Connecticut River Valley Planning Region",5,29,2116,1080,1036
050,09,130,"Connecticut","Lower Connecticut River Valley Planning Region",5,30,2098,1084,1014
050,09,130,"Connecticut","Lower Connecticut River Valley Planning Region",5,31,2072,1055,1017
050,09,130,"Connecticut","Lower Connecticut River Valley Planning Region",5,32,2157,1077,1080
050,09,130,"Connecticut","Lower Connecticut River Valley Planning Region",5,33,2179,1100,1079
050,09,130,"Connecticut","Lower Connecticut River Valley Planning Region",5,34,2107,1044,1063
050,09,130,"Connecticut","Lower Connecticut River Valley Planning Region",5,35,2205,1099,1106
050,09,130,"Connecticut","Lower Connecticut River Valley Planning Region",5,36,2182,1110,1072
050,09,130,"Connecticut","Lower Connecticut River Valley Planning Region",5,37,2223,1132,1091
050,09,130,"Connecticut","Lower Connecticut River Valley Planning Region",5,38,2215,1114,1101
050,09,130,"Connecticut","Lower Connecticut River Valley Planning Region",5,39,2151,1054,1097
050,09,130,"Connecticut","Lower Connecticut River Valley Planning Region",5,40,2161,1074,1087
050,09,130,"Connecticut","Lower Connecticut River Valley Planning Region",5,41,2137,1053,1084
050,09,130,"Connecticut","Lower Connecticut River Valley Planning Region",5,42,2101,1041,1060
050,09,130,"Connecticut","Lower Connecticut River Valley Planning Region",5,43,2046,1028,1018
050,09,130,"Connecticut","Lower Connecticut River Valley Planning Region",5,44,1971,1027,944
050,09,130,"Connecticut","Lower Connecticut River Valley Planning Region",5,45,1937,967,970
050,09,130,"Connecticut","Lower Connecticut River Valley Planning Region",5,46,1887,945,942
050,09,130,"Connecticut","Lower Connecticut River Valley Planning Region",5,47,1881,931,950
050,09,130,"Connecticut","Lower Connecticut River Valley Planning Region",5,48,1936,972,964
050,09,130,"Connecticut","Lower Connecticut River Valley Planning Region",5,49,1961,988,973
050,09,130,"Connecticut","Lower Connecticut River Valley Planning Region",5,50,2027,989,1038
050,09,130,"Connecticut","Lower Connecticut River Valley Planning Region",5,51,2248,1084,1164
050,09,130,"Connecticut","Lower Connecticut River Valley Planning Region",5,52,2466,1210,1256
050,09,130,"Connecticut","Lower Connecticut River Valley Planning Region",5,53,2561,1259,1302
050,09,130,"Connecticut","Lower Connecticut River Valley Planning Region",5,54,2608,1273,1335
050,09,130,"Connecticut","Lower Connecticut River Valley Planning Region",5,55,2539,1242,1297
050,09,130,"Connecticut","Lower Connecticut River Valley Planning Region",5,56,2624,1256,1368
050,09,130,"Connecticut","Lower Connecticut River Valley Planning Region",5,57,2665,1297,1368
050,09,130,"Connecticut","Lower Connecticut River Valley Planning Region",5,58,2838,1419,1419
050,09,130,"Connecticut","Lower Connecticut River Valley Planning Region",5,59,2908,1425,1483
050,09,130,"Connecticut","Lower Connecticut River Valley Planning Region",5,60,2895,1417,1478
050,09,130,"Connecticut","Lower Connecticut River Valley Planning Region",5,61,2862,1411,1451
050,09,130,"Connecticut","Lower Connecticut River Valley Planning Region",5,62,2927,1433,1494
050,09,130,"Connecticut","Lower Connecticut River Valley Planning Region",5,63,2898,1421,1477
050,09,130,"Connecticut","Lower Connecticut River Valley Planning Region",5,64,2806,1393,1413
050,09,130,"Connecticut","Lower Connecticut River Valley Planning Region",5,65,2797,1372,1425
050,09,130,"Connecticut","Lower Connecticut River Valley Planning Region",5,66,2648,1301,1347
050,09,130,"Connecticut","Lower Connecticut River Valley Planning Region",5,67,2475,1192,1283
050,09,130,"Connecticut","Lower Connecticut River Valley Planning Region",5,68,2398,1192,1206
050,09,130,"Connecticut","Lower Connecticut River Valley Planning Region",5,69,2349,1139,1210
050,09,130,"Connecticut","Lower Connecticut River Valley Planning Region",5,70,2276,1058,1218
050,09,130,"Connecticut","Lower Connecticut River Valley Planning Region",5,71,2248,1067,1181
050,09,130,"Connecticut","Lower Connecticut River Valley Planning Region",5,72,2017,941,1076
050,09,130,"Connecticut","Lower Connecticut River Valley Planning Region",5,73,1906,887,1019
050,09,130,"Connecticut","Lower Connecticut River Valley Planning Region",5,74,1874,877,997
050,09,130,"Connecticut","Lower Connecticut River Valley Planning Region",5,75,1892,886,1006
050,09,130,"Connecticut","Lower Connecticut River Valley Planning Region",5,76,2041,952,1089
050,09,130,"Connecticut","Lower Connecticut River Valley Planning Region",5,77,1366,633,733
050,09,130,"Connecticut","Lower Connecticut River Valley Planning Region",5,78,1332,611,721
050,09,130,"Connecticut","Lower Connecticut River Valley Planning Region",5,79,1312,575,737
050,09,130,"Connecticut","Lower Connecticut River Valley Planning Region",5,80,1332,572,760
050,09,130,"Connecticut","Lower Connecticut River Valley Planning Region",5,81,1073,470,603
050,09,130,"Connecticut","Lower Connecticut River Valley Planning Region",5,82,912,395,517
050,09,130,"Connecticut","Lower Connecticut River Valley Planning Region",5,83,799,341,458
050,09,130,"Connecticut","Lower Connecticut River Valley Planning Region",5,84,732,308,424
050,09,130,"Connecticut","Lower Connecticut River Valley Planning Region",5,85,4790,1687,3103
050,09,140,"Connecticut","Naugatuck Valley Planning Region",1,0,4365,2241,2124
050,09,140,"Connecticut","Naugatuck Valley Planning Region",1,1,4475,2295,2180
050,09,140,"Connecticut","Naugatuck Valley Planning Region",1,2,4588,2331,2257
050,09,140,"Connecticut","Naugatuck Valley Planning Region",1,3,4693,2375,2318
050,09,140,"Connecticut","Naugatuck Valley Planning Region",1,4,4750,2415,2335
050,09,140,"Connecticut","Naugatuck Valley Planning Region",1,5,4787,2446,2341
050,09,140,"Connecticut","Naugatuck Valley Planning Region",1,6,4841,2496,2345
050,09,140,"Connecticut","Naugatuck Valley Planning Region",1,7,4881,2501,2380
050,09,140,"Connecticut","Naugatuck Valley Planning Region",1,8,4899,2506,2393
050,09,140,"Connecticut","Naugatuck Valley Planning Region",1,9,5065,2583,2482
050,09,140,"Connecticut","Naugatuck Valley Planning Region",1,10,5196,2684,2512
050,09,140,"Connecticut","Naugatuck Valley Planning Region",1,11,5416,2812,2604
050,09,140,"Connecticut","Naugatuck Valley Planning Region",1,12,5664,2899,2765
050,09,140,"Connecticut","Naugatuck Valley Planning Region",1,13,5710,2904,2806
050,09,140,"Connecticut","Naugatuck Valley Planning Region",1,14,5693,2927,2766
050,09,140,"Connecticut","Naugatuck Valley Planning Region",1,15,5759,2927,2832
050,09,140,"Connecticut","Naugatuck Valley Planning Region",1,16,5870,2987,2883
050,09,140,"Connecticut","Naugatuck Valley Planning Region",1,17,5925,3047,2878
050,09,140,"Connecticut","Naugatuck Valley Planning Region",1,18,5354,2837,2517
050,09,140,"Connecticut","Naugatuck Valley Planning Region",1,19,4667,2462,2205
050,09,140,"Connecticut","Naugatuck Valley Planning Region",1,20,5006,2618,2388
050,09,140,"Connecticut","Naugatuck Valley Planning Region",1,21,5190,2652,2538
050,09,140,"Connecticut","Naugatuck Valley Planning Region",1,22,5268,2667,2601
050,09,140,"Connecticut","Naugatuck Valley Planning Region",1,23,5446,2785,2661
050,09,140,"Connecticut","Naugatuck Valley Planning Region",1,24,5547,2805,2742
050,09,140,"Connecticut","Naugatuck Valley Planning Region",1,25,5704,2901,2803
050,09,140,"Connecticut","Naugatuck Valley Planning Region",1,26,5858,2966,2892
050,09,140,"Connecticut","Naugatuck Valley Planning Region",1,27,5901,2984,2917
050,09,140,"Connecticut","Naugatuck Valley Planning Region",1,28,5791,2912,2879
050,09,140,"Connecticut","Naugatuck Valley Planning Region",1,29,5750,2909,2841
050,09,140,"Connecticut","Naugatuck Valley Planning Region",1,30,5767,2918,2849
050,09,140,"Connecticut","Naugatuck Valley Planning Region",1,31,5789,2901,2888
050,09,140,"Connecticut","Naugatuck Valley Planning Region",1,32,5898,2922,2976
050,09,140,"Connecticut","Naugatuck Valley Planning Region",1,33,5855,2887,2968
050,09,140,"Connecticut","Naugatuck Valley Planning Region",1,34,5883,2910,2973
050,09,140,"Connecticut","Naugatuck Valley Planning Region",1,35,5819,2887,2932
050,09,140,"Connecticut","Naugatuck Valley Planning Region",1,36,5734,2879,2855
050,09,140,"Connecticut","Naugatuck Valley Planning Region",1,37,5738,2836,2902
050,09,140,"Connecticut","Naugatuck Valley Planning Region",1,38,5655,2780,2875
050,09,140,"Connecticut","Naugatuck Valley Planning Region",1,39,5572,2751,2821
050,09,140,"Connecticut","Naugatuck Valley Planning Region",1,40,5522,2711,2811
050,09,140,"Connecticut","Naugatuck Valley Planning Region",1,41,5441,2651,2790
050,09,140,"Connecticut","Naugatuck Valley Planning Region",1,42,5374,2599,2775
050,09,140,"Connecticut","Naugatuck Valley Planning Region",1,43,5270,2545,2725
050,09,140,"Connecticut","Naugatuck Valley Planning Region",1,44,5146,2502,2644
050,09,140,"Connecticut","Naugatuck Valley Planning Region",1,45,5176,2521,2655
050,09,140,"Connecticut","Naugatuck Valley Planning Region",1,46,5138,2480,2658
050,09,140,"Connecticut","Naugatuck Valley Planning Region",1,47,5359,2586,2773
050,09,140,"Connecticut","Naugatuck Valley Planning Region",1,48,5789,2813,2976
050,09,140,"Connecticut","Naugatuck Valley Planning Region",1,49,6314,3064,3250
050,09,140,"Connecticut","Naugatuck Valley Planning Region",1,50,6278,3053,3225
050,09,140,"Connecticut","Naugatuck Valley Planning Region",1,51,6272,3050,3222
050,09,140,"Connecticut","Naugatuck Valley Planning Region",1,52,6148,3012,3136
050,09,140,"Connecticut","Naugatuck Valley Planning Region",1,53,6370,3122,3248
050,09,140,"Connecticut","Naugatuck Valley Planning Region",1,54,6583,3202,3381
050,09,140,"Connecticut","Naugatuck Valley Planning Region",1,55,6800,3296,3504
050,09,140,"Connecticut","Naugatuck Valley Planning Region",1,56,6900,3372,3528
050,09,140,"Connecticut","Naugatuck Valley Planning Region",1,57,6801,3314,3487
050,09,140,"Connecticut","Naugatuck Valley Planning Region",1,58,6870,3350,3520
050,09,140,"Connecticut","Naugatuck Valley Planning Region",1,59,6865,3372,3493
050,09,140,"Connecticut","Naugatuck Valley Planning Region",1,60,6737,3272,3465
050,09,140,"Connecticut","Naugatuck Valley Planning Region",1,61,6637,3236,3401
050,09,140,"Connecticut","Naugatuck Valley Planning Region",1,62,6571,3217,3354
050,09,140,"Connecticut","Naugatuck Valley Planning Region",1,63,6241,3023,3218
050,09,140,"Connecticut","Naugatuck Valley Planning Region",1,64,6029,2878,3151
050,09,140,"Connecticut","Naugatuck Valley Planning Region",1,65,5759,2770,2989
050,09,140,"Connecticut","Naugatuck Valley Planning Region",1,66,5486,2647,2839
050,09,140,"Connecticut","Naugatuck Valley Planning Region",1,67,5248,2502,2746
050,09,140,"Connecticut","Naugatuck Valley Planning Region",1,68,5030,2371,2659
050,09,140,"Connecticut","Naugatuck Valley Planning Region",1,69,4624,2153,2471
050,09,140,"Connecticut","Naugatuck Valley Planning Region",1,70,4525,2094,2431
050,09,140,"Connecticut","Naugatuck Valley Planning Region",1,71,4462,2056,2406
050,09,140,"Connecticut","Naugatuck Valley Planning Region",1,72,4529,2072,2457
050,09,140,"Connecticut","Naugatuck Valley Planning Region",1,73,4563,2108,2455
050,09,140,"Connecticut","Naugatuck Valley Planning Region",1,74,3288,1472,1816
050,09,140,"Connecticut","Naugatuck Valley Planning Region",1,75,3198,1443,1755
050,09,140,"Connecticut","Naugatuck Valley Planning Region",1,76,3240,1456,1784
050,09,140,"Connecticut","Naugatuck Valley Planning Region",1,77,3218,1431,1787
050,09,140,"Connecticut","Naugatuck Valley Planning Region",1,78,2659,1153,1506
050,09,140,"Connecticut","Naugatuck Valley Planning Region",1,79,2306,1003,1303
050,09,140,"Connecticut","Naugatuck Valley Planning Region",1,80,2125,901,1224
050,09,140,"Connecticut","Naugatuck Valley Planning Region",1,81,2027,860,1167
050,09,140,"Connecticut","Naugatuck Valley Planning Region",1,82,1875,771,1104
050,09,140,"Connecticut","Naugatuck Valley Planning Region",1,83,1651,666,985
050,09,140,"Connecticut","Naugatuck Valley Planning Region",1,84,1565,637,928
050,09,140,"Connecticut","Naugatuck Valley Planning Region",1,85,10657,3616,7041
050,09,140,"Connecticut","Naugatuck Valley Planning Region",2,0,4360,2241,2119
050,09,140,"Connecticut","Naugatuck Valley Planning Region",2,1,4473,2294,2179
050,09,140,"Connecticut","Naugatuck Valley Planning Region",2,2,4584,2335,2249
050,09,140,"Connecticut","Naugatuck Valley Planning Region",2,3,4685,2372,2313
050,09,140,"Connecticut","Naugatuck Valley Planning Region",2,4,4765,2414,2351
050,09,140,"Connecticut","Naugatuck Valley Planning Region",2,5,4793,2448,2345
050,09,140,"Connecticut","Naugatuck Valley Planning Region",2,6,4851,2499,2352
050,09,140,"Connecticut","Naugatuck Valley Planning Region",2,7,4874,2502,2372
050,09,140,"Connecticut","Naugatuck Valley Planning Region",2,8,4881,2498,2383
050,09,140,"Connecticut","Naugatuck Valley Planning Region",2,9,5026,2565,2461
050,09,140,"Connecticut","Naugatuck Valley Planning Region",2,10,5170,2661,2509
050,09,140,"Connecticut","Naugatuck Valley Planning Region",2,11,5345,2770,2575
050,09,140,"Connecticut","Naugatuck Valley Planning Region",2,12,5635,2895,2740
050,09,140,"Connecticut","Naugatuck Valley Planning Region",2,13,5698,2907,2791
050,09,140,"Connecticut","Naugatuck Valley Planning Region",2,14,5702,2922,2780
050,09,140,"Connecticut","Naugatuck Valley Planning Region",2,15,5750,2927,2823
050,09,140,"Connecticut","Naugatuck Valley Planning Region",2,16,5854,2978,2876
050,09,140,"Connecticut","Naugatuck Valley Planning Region",2,17,5915,3032,2883
050,09,140,"Connecticut","Naugatuck Valley Planning Region",2,18,5239,2776,2463
050,09,140,"Connecticut","Naugatuck Valley Planning Region",2,19,4570,2422,2148
050,09,140,"Connecticut","Naugatuck Valley Planning Region",2,20,4959,2597,2362
050,09,140,"Connecticut","Naugatuck Valley Planning Region",2,21,5125,2629,2496
050,09,140,"Connecticut","Naugatuck Valley Planning Region",2,22,5247,2655,2592
050,09,140,"Connecticut","Naugatuck Valley Planning Region",2,23,5432,2770,2662
050,09,140,"Connecticut","Naugatuck Valley Planning Region",2,24,5513,2792,2721
050,09,140,"Connecticut","Naugatuck Valley Planning Region",2,25,5679,2887,2792
050,09,140,"Connecticut","Naugatuck Valley Planning Region",2,26,5822,2949,2873
050,09,140,"Connecticut","Naugatuck Valley Planning Region",2,27,5884,2967,2917
050,09,140,"Connecticut","Naugatuck Valley Planning Region",2,28,5809,2925,2884
050,09,140,"Connecticut","Naugatuck Valley Planning Region",2,29,5775,2916,2859
050,09,140,"Connecticut","Naugatuck Valley Planning Region",2,30,5793,2929,2864
050,09,140,"Connecticut","Naugatuck Valley Planning Region",2,31,5781,2902,2879
050,09,140,"Connecticut","Naugatuck Valley Planning Region",2,32,5856,2906,2950
050,09,140,"Connecticut","Naugatuck Valley Planning Region",2,33,5860,2889,2971
050,09,140,"Connecticut","Naugatuck Valley Planning Region",2,34,5875,2899,2976
050,09,140,"Connecticut","Naugatuck Valley Planning Region",2,35,5867,2908,2959
050,09,140,"Connecticut","Naugatuck Valley Planning Region",2,36,5726,2856,2870
050,09,140,"Connecticut","Naugatuck Valley Planning Region",2,37,5757,2856,2901
050,09,140,"Connecticut","Naugatuck Valley Planning Region",2,38,5702,2803,2899
050,09,140,"Connecticut","Naugatuck Valley Planning Region",2,39,5595,2756,2839
050,09,140,"Connecticut","Naugatuck Valley Planning Region",2,40,5563,2731,2832
050,09,140,"Connecticut","Naugatuck Valley Planning Region",2,41,5454,2663,2791
050,09,140,"Connecticut","Naugatuck Valley Planning Region",2,42,5363,2604,2759
050,09,140,"Connecticut","Naugatuck Valley Planning Region",2,43,5325,2570,2755
050,09,140,"Connecticut","Naugatuck Valley Planning Region",2,44,5140,2490,2650
050,09,140,"Connecticut","Naugatuck Valley Planning Region",2,45,5189,2522,2667
050,09,140,"Connecticut","Naugatuck Valley Planning Region",2,46,5128,2476,2652
050,09,140,"Connecticut","Naugatuck Valley Planning Region",2,47,5284,2546,2738
050,09,140,"Connecticut","Naugatuck Valley Planning Region",2,48,5679,2755,2924
050,09,140,"Connecticut","Naugatuck Valley Planning Region",2,49,6210,3018,3192
050,09,140,"Connecticut","Naugatuck Valley Planning Region",2,50,6280,3053,3227
050,09,140,"Connecticut","Naugatuck Valley Planning Region",2,51,6242,3038,3204
050,09,140,"Connecticut","Naugatuck Valley Planning Region",2,52,6156,3008,3148
050,09,140,"Connecticut","Naugatuck Valley Planning Region",2,53,6297,3082,3215
050,09,140,"Connecticut","Naugatuck Valley Planning Region",2,54,6504,3168,3336
050,09,140,"Connecticut","Naugatuck Valley Planning Region",2,55,6736,3267,3469
050,09,140,"Connecticut","Naugatuck Valley Planning Region",2,56,6881,3359,3522
050,09,140,"Connecticut","Naugatuck Valley Planning Region",2,57,6811,3320,3491
050,09,140,"Connecticut","Naugatuck Valley Planning Region",2,58,6824,3321,3503
050,09,140,"Connecticut","Naugatuck Valley Planning Region",2,59,6859,3364,3495
050,09,140,"Connecticut","Naugatuck Valley Planning Region",2,60,6724,3271,3453
050,09,140,"Connecticut","Naugatuck Valley Planning Region",2,61,6620,3224,3396
050,09,140,"Connecticut","Naugatuck Valley Planning Region",2,62,6538,3196,3342
050,09,140,"Connecticut","Naugatuck Valley Planning Region",2,63,6338,3076,3262
050,09,140,"Connecticut","Naugatuck Valley Planning Region",2,64,6007,2872,3135
050,09,140,"Connecticut","Naugatuck Valley Planning Region",2,65,5782,2774,3008
050,09,140,"Connecticut","Naugatuck Valley Planning Region",2,66,5533,2662,2871
050,09,140,"Connecticut","Naugatuck Valley Planning Region",2,67,5262,2511,2751
050,09,140,"Connecticut","Naugatuck Valley Planning Region",2,68,5012,2364,2648
050,09,140,"Connecticut","Naugatuck Valley Planning Region",2,69,4718,2198,2520
050,09,140,"Connecticut","Naugatuck Valley Planning Region",2,70,4507,2081,2426
050,09,140,"Connecticut","Naugatuck Valley Planning Region",2,71,4454,2052,2402
050,09,140,"Connecticut","Naugatuck Valley Planning Region",2,72,4404,2016,2388
050,09,140,"Connecticut","Naugatuck Valley Planning Region",2,73,4739,2184,2555
050,09,140,"Connecticut","Naugatuck Valley Planning Region",2,74,3354,1511,1843
050,09,140,"Connecticut","Naugatuck Valley Planning Region",2,75,3197,1440,1757
050,09,140,"Connecticut","Naugatuck Valley Planning Region",2,76,3157,1415,1742
050,09,140,"Connecticut","Naugatuck Valley Planning Region",2,77,3251,1446,1805
050,09,140,"Connecticut","Naugatuck Valley Planning Region",2,78,2702,1179,1523
050,09,140,"Connecticut","Naugatuck Valley Planning Region",2,79,2338,1016,1322
050,09,140,"Connecticut","Naugatuck Valley Planning Region",2,80,2131,908,1223
050,09,140,"Connecticut","Naugatuck Valley Planning Region",2,81,1990,840,1150
050,09,140,"Connecticut","Naugatuck Valley Planning Region",2,82,1871,770,1101
050,09,140,"Connecticut","Naugatuck Valley Planning Region",2,83,1644,661,983
050,09,140,"Connecticut","Naugatuck Valley Planning Region",2,84,1532,620,912
050,09,140,"Connecticut","Naugatuck Valley Planning Region",2,85,10328,3518,6810
050,09,140,"Connecticut","Naugatuck Valley Planning Region",3,0,4257,2188,2069
050,09,140,"Connecticut","Naugatuck Valley Planning Region",3,1,4538,2305,2233
050,09,140,"Connecticut","Naugatuck Valley Planning Region",3,2,4609,2349,2260
050,09,140,"Connecticut","Naugatuck Valley Planning Region",3,3,4735,2429,2306
050,09,140,"Connecticut","Naugatuck Valley Planning Region",3,4,4747,2395,2352
050,09,140,"Connecticut","Naugatuck Valley Planning Region",3,5,4819,2470,2349
050,09,140,"Connecticut","Naugatuck Valley Planning Region",3,6,4841,2474,2367
050,09,140,"Connecticut","Naugatuck Valley Planning Region",3,7,4912,2526,2386
050,09,140,"Connecticut","Naugatuck Valley Planning Region",3,8,4945,2517,2428
050,09,140,"Connecticut","Naugatuck Valley Planning Region",3,9,4923,2511,2412
050,09,140,"Connecticut","Naugatuck Valley Planning Region",3,10,5111,2617,2494
050,09,140,"Connecticut","Naugatuck Valley Planning Region",3,11,5254,2715,2539
050,09,140,"Connecticut","Naugatuck Valley Planning Region",3,12,5434,2825,2609
050,09,140,"Connecticut","Naugatuck Valley Planning Region",3,13,5660,2906,2754
050,09,140,"Connecticut","Naugatuck Valley Planning Region",3,14,5757,2910,2847
050,09,140,"Connecticut","Naugatuck Valley Planning Region",3,15,5776,2934,2842
050,09,140,"Connecticut","Naugatuck Valley Planning Region",3,16,5796,2960,2836
050,09,140,"Connecticut","Naugatuck Valley Planning Region",3,17,5974,3065,2909
050,09,140,"Connecticut","Naugatuck Valley Planning Region",3,18,5352,2827,2525
050,09,140,"Connecticut","Naugatuck Valley Planning Region",3,19,4610,2427,2183
050,09,140,"Connecticut","Naugatuck Valley Planning Region",3,20,4968,2613,2355
050,09,140,"Connecticut","Naugatuck Valley Planning Region",3,21,5257,2707,2550
050,09,140,"Connecticut","Naugatuck Valley Planning Region",3,22,5353,2715,2638
050,09,140,"Connecticut","Naugatuck Valley Planning Region",3,23,5402,2752,2650
050,09,140,"Connecticut","Naugatuck Valley Planning Region",3,24,5496,2826,2670
050,09,140,"Connecticut","Naugatuck Valley Planning Region",3,25,5595,2849,2746
050,09,140,"Connecticut","Naugatuck Valley Planning Region",3,26,5813,2961,2852
050,09,140,"Connecticut","Naugatuck Valley Planning Region",3,27,5891,2966,2925
050,09,140,"Connecticut","Naugatuck Valley Planning Region",3,28,6054,3041,3013
050,09,140,"Connecticut","Naugatuck Valley Planning Region",3,29,5988,3004,2984
050,09,140,"Connecticut","Naugatuck Valley Planning Region",3,30,5892,2945,2947
050,09,140,"Connecticut","Naugatuck Valley Planning Region",3,31,5959,2992,2967
050,09,140,"Connecticut","Naugatuck Valley Planning Region",3,32,5947,2965,2982
050,09,140,"Connecticut","Naugatuck Valley Planning Region",3,33,5941,2942,2999
050,09,140,"Connecticut","Naugatuck Valley Planning Region",3,34,6027,2992,3035
050,09,140,"Connecticut","Naugatuck Valley Planning Region",3,35,5920,2954,2966
050,09,140,"Connecticut","Naugatuck Valley Planning Region",3,36,5954,2958,2996
050,09,140,"Connecticut","Naugatuck Valley Planning Region",3,37,5797,2884,2913
050,09,140,"Connecticut","Naugatuck Valley Planning Region",3,38,5788,2859,2929
050,09,140,"Connecticut","Naugatuck Valley Planning Region",3,39,5817,2870,2947
050,09,140,"Connecticut","Naugatuck Valley Planning Region",3,40,5626,2776,2850
050,09,140,"Connecticut","Naugatuck Valley Planning Region",3,41,5698,2845,2853
050,09,140,"Connecticut","Naugatuck Valley Planning Region",3,42,5490,2676,2814
050,09,140,"Connecticut","Naugatuck Valley Planning Region",3,43,5401,2642,2759
050,09,140,"Connecticut","Naugatuck Valley Planning Region",3,44,5315,2591,2724
050,09,140,"Connecticut","Naugatuck Valley Planning Region",3,45,5172,2499,2673
050,09,140,"Connecticut","Naugatuck Valley Planning Region",3,46,5219,2537,2682
050,09,140,"Connecticut","Naugatuck Valley Planning Region",3,47,5129,2473,2656
050,09,140,"Connecticut","Naugatuck Valley Planning Region",3,48,5292,2549,2743
050,09,140,"Connecticut","Naugatuck Valley Planning Region",3,49,5699,2780,2919
050,09,140,"Connecticut","Naugatuck Valley Planning Region",3,50,6137,2981,3156
050,09,140,"Connecticut","Naugatuck Valley Planning Region",3,51,6248,3045,3203
050,09,140,"Connecticut","Naugatuck Valley Planning Region",3,52,6235,3028,3207
050,09,140,"Connecticut","Naugatuck Valley Planning Region",3,53,6119,2969,3150
050,09,140,"Connecticut","Naugatuck Valley Planning Region",3,54,6267,3044,3223
050,09,140,"Connecticut","Naugatuck Valley Planning Region",3,55,6474,3124,3350
050,09,140,"Connecticut","Naugatuck Valley Planning Region",3,56,6695,3238,3457
050,09,140,"Connecticut","Naugatuck Valley Planning Region",3,57,6819,3330,3489
050,09,140,"Connecticut","Naugatuck Valley Planning Region",3,58,6742,3285,3457
050,09,140,"Connecticut","Naugatuck Valley Planning Region",3,59,6707,3250,3457
050,09,140,"Connecticut","Naugatuck Valley Planning Region",3,60,6798,3327,3471
050,09,140,"Connecticut","Naugatuck Valley Planning Region",3,61,6619,3213,3406
050,09,140,"Connecticut","Naugatuck Valley Planning Region",3,62,6498,3152,3346
050,09,140,"Connecticut","Naugatuck Valley Planning Region",3,63,6403,3117,3286
050,09,140,"Connecticut","Naugatuck Valley Planning Region",3,64,6212,3013,3199
050,09,140,"Connecticut","Naugatuck Valley Planning Region",3,65,5857,2788,3069
050,09,140,"Connecticut","Naugatuck Valley Planning Region",3,66,5670,2722,2948
050,09,140,"Connecticut","Naugatuck Valley Planning Region",3,67,5441,2606,2835
050,09,140,"Connecticut","Naugatuck Valley Planning Region",3,68,5167,2465,2702
050,09,140,"Connecticut","Naugatuck Valley Planning Region",3,69,4912,2297,2615
050,09,140,"Connecticut","Naugatuck Valley Planning Region",3,70,4622,2140,2482
050,09,140,"Connecticut","Naugatuck Valley Planning Region",3,71,4439,2035,2404
050,09,140,"Connecticut","Naugatuck Valley Planning Region",3,72,4388,2007,2381
050,09,140,"Connecticut","Naugatuck Valley Planning Region",3,73,4316,1967,2349
050,09,140,"Connecticut","Naugatuck Valley Planning Region",3,74,4646,2127,2519
050,09,140,"Connecticut","Naugatuck Valley Planning Region",3,75,3289,1469,1820
050,09,140,"Connecticut","Naugatuck Valley Planning Region",3,76,3113,1387,1726
050,09,140,"Connecticut","Naugatuck Valley Planning Region",3,77,3067,1373,1694
050,09,140,"Connecticut","Naugatuck Valley Planning Region",3,78,3125,1369,1756
050,09,140,"Connecticut","Naugatuck Valley Planning Region",3,79,2598,1126,1472
050,09,140,"Connecticut","Naugatuck Valley Planning Region",3,80,2227,958,1269
050,09,140,"Connecticut","Naugatuck Valley Planning Region",3,81,2040,860,1180
050,09,140,"Connecticut","Naugatuck Valley Planning Region",3,82,1899,797,1102
050,09,140,"Connecticut","Naugatuck Valley Planning Region",3,83,1758,712,1046
050,09,140,"Connecticut","Naugatuck Valley Planning Region",3,84,1534,622,912
050,09,140,"Connecticut","Naugatuck Valley Planning Region",3,85,10250,3526,6724
050,09,140,"Connecticut","Naugatuck Valley Planning Region",4,0,4414,2286,2128
050,09,140,"Connecticut","Naugatuck Valley Planning Region",4,1,4476,2365,2111
050,09,140,"Connecticut","Naugatuck Valley Planning Region",4,2,4657,2376,2281
050,09,140,"Connecticut","Naugatuck Valley Planning Region",4,3,4722,2407,2315
050,09,140,"Connecticut","Naugatuck Valley Planning Region",4,4,4801,2444,2357
050,09,140,"Connecticut","Naugatuck Valley Planning Region",4,5,4886,2482,2404
050,09,140,"Connecticut","Naugatuck Valley Planning Region",4,6,4928,2554,2374
050,09,140,"Connecticut","Naugatuck Valley Planning Region",4,7,4965,2556,2409
050,09,140,"Connecticut","Naugatuck Valley Planning Region",4,8,5024,2584,2440
050,09,140,"Connecticut","Naugatuck Valley Planning Region",4,9,4960,2531,2429
050,09,140,"Connecticut","Naugatuck Valley Planning Region",4,10,5042,2560,2482
050,09,140,"Connecticut","Naugatuck Valley Planning Region",4,11,5184,2615,2569
050,09,140,"Connecticut","Naugatuck Valley Planning Region",4,12,5280,2698,2582
050,09,140,"Connecticut","Naugatuck Valley Planning Region",4,13,5494,2845,2649
050,09,140,"Connecticut","Naugatuck Valley Planning Region",4,14,5698,2926,2772
050,09,140,"Connecticut","Naugatuck Valley Planning Region",4,15,5823,2944,2879
050,09,140,"Connecticut","Naugatuck Valley Planning Region",4,16,5788,2966,2822
050,09,140,"Connecticut","Naugatuck Valley Planning Region",4,17,5928,3042,2886
050,09,140,"Connecticut","Naugatuck Valley Planning Region",4,18,5381,2847,2534
050,09,140,"Connecticut","Naugatuck Valley Planning Region",4,19,4549,2394,2155
050,09,140,"Connecticut","Naugatuck Valley Planning Region",4,20,4751,2487,2264
050,09,140,"Connecticut","Naugatuck Valley Planning Region",4,21,5137,2662,2475
050,09,140,"Connecticut","Naugatuck Valley Planning Region",4,22,5357,2762,2595
050,09,140,"Connecticut","Naugatuck Valley Planning Region",4,23,5497,2791,2706
050,09,140,"Connecticut","Naugatuck Valley Planning Region",4,24,5415,2760,2655
050,09,140,"Connecticut","Naugatuck Valley Planning Region",4,25,5542,2857,2685
050,09,140,"Connecticut","Naugatuck Valley Planning Region",4,26,5565,2827,2738
050,09,140,"Connecticut","Naugatuck Valley Planning Region",4,27,5778,2951,2827
050,09,140,"Connecticut","Naugatuck Valley Planning Region",4,28,5917,3008,2909
050,09,140,"Connecticut","Naugatuck Valley Planning Region",4,29,6027,3023,3004
050,09,140,"Connecticut","Naugatuck Valley Planning Region",4,30,6017,3012,3005
050,09,140,"Connecticut","Naugatuck Valley Planning Region",4,31,5970,2960,3010
050,09,140,"Connecticut","Naugatuck Valley Planning Region",4,32,6055,3058,2997
050,09,140,"Connecticut","Naugatuck Valley Planning Region",4,33,6003,2969,3034
050,09,140,"Connecticut","Naugatuck Valley Planning Region",4,34,6051,3014,3037
050,09,140,"Connecticut","Naugatuck Valley Planning Region",4,35,6142,3064,3078
050,09,140,"Connecticut","Naugatuck Valley Planning Region",4,36,6059,3015,3044
050,09,140,"Connecticut","Naugatuck Valley Planning Region",4,37,5968,2950,3018
050,09,140,"Connecticut","Naugatuck Valley Planning Region",4,38,5876,2899,2977
050,09,140,"Connecticut","Naugatuck Valley Planning Region",4,39,5947,2960,2987
050,09,140,"Connecticut","Naugatuck Valley Planning Region",4,40,5868,2886,2982
050,09,140,"Connecticut","Naugatuck Valley Planning Region",4,41,5708,2845,2863
050,09,140,"Connecticut","Naugatuck Valley Planning Region",4,42,5748,2890,2858
050,09,140,"Connecticut","Naugatuck Valley Planning Region",4,43,5552,2705,2847
050,09,140,"Connecticut","Naugatuck Valley Planning Region",4,44,5407,2636,2771
050,09,140,"Connecticut","Naugatuck Valley Planning Region",4,45,5331,2604,2727
050,09,140,"Connecticut","Naugatuck Valley Planning Region",4,46,5198,2527,2671
050,09,140,"Connecticut","Naugatuck Valley Planning Region",4,47,5198,2514,2684
050,09,140,"Connecticut","Naugatuck Valley Planning Region",4,48,5176,2480,2696
050,09,140,"Connecticut","Naugatuck Valley Planning Region",4,49,5266,2553,2713
050,09,140,"Connecticut","Naugatuck Valley Planning Region",4,50,5676,2782,2894
050,09,140,"Connecticut","Naugatuck Valley Planning Region",4,51,6107,2969,3138
050,09,140,"Connecticut","Naugatuck Valley Planning Region",4,52,6176,3021,3155
050,09,140,"Connecticut","Naugatuck Valley Planning Region",4,53,6148,2990,3158
050,09,140,"Connecticut","Naugatuck Valley Planning Region",4,54,6071,2941,3130
050,09,140,"Connecticut","Naugatuck Valley Planning Region",4,55,6243,3026,3217
050,09,140,"Connecticut","Naugatuck Valley Planning Region",4,56,6402,3084,3318
050,09,140,"Connecticut","Naugatuck Valley Planning Region",4,57,6614,3214,3400
050,09,140,"Connecticut","Naugatuck Valley Planning Region",4,58,6745,3304,3441
050,09,140,"Connecticut","Naugatuck Valley Planning Region",4,59,6604,3222,3382
050,09,140,"Connecticut","Naugatuck Valley Planning Region",4,60,6584,3182,3402
050,09,140,"Connecticut","Naugatuck Valley Planning Region",4,61,6653,3253,3400
050,09,140,"Connecticut","Naugatuck Valley Planning Region",4,62,6472,3115,3357
050,09,140,"Connecticut","Naugatuck Valley Planning Region",4,63,6355,3058,3297
050,09,140,"Connecticut","Naugatuck Valley Planning Region",4,64,6302,3049,3253
050,09,140,"Connecticut","Naugatuck Valley Planning Region",4,65,6068,2934,3134
050,09,140,"Connecticut","Naugatuck Valley Planning Region",4,66,5738,2729,3009
050,09,140,"Connecticut","Naugatuck Valley Planning Region",4,67,5540,2633,2907
050,09,140,"Connecticut","Naugatuck Valley Planning Region",4,68,5368,2545,2823
050,09,140,"Connecticut","Naugatuck Valley Planning Region",4,69,5062,2407,2655
050,09,140,"Connecticut","Naugatuck Valley Planning Region",4,70,4817,2251,2566
050,09,140,"Connecticut","Naugatuck Valley Planning Region",4,71,4556,2085,2471
050,09,140,"Connecticut","Naugatuck Valley Planning Region",4,72,4336,1971,2365
050,09,140,"Connecticut","Naugatuck Valley Planning Region",4,73,4313,1957,2356
050,09,140,"Connecticut","Naugatuck Valley Planning Region",4,74,4211,1903,2308
050,09,140,"Connecticut","Naugatuck Valley Planning Region",4,75,4493,2045,2448
050,09,140,"Connecticut","Naugatuck Valley Planning Region",4,76,3190,1406,1784
050,09,140,"Connecticut","Naugatuck Valley Planning Region",4,77,3030,1338,1692
050,09,140,"Connecticut","Naugatuck Valley Planning Region",4,78,2945,1300,1645
050,09,140,"Connecticut","Naugatuck Valley Planning Region",4,79,3000,1303,1697
050,09,140,"Connecticut","Naugatuck Valley Planning Region",4,80,2496,1061,1435
050,09,140,"Connecticut","Naugatuck Valley Planning Region",4,81,2130,898,1232
050,09,140,"Connecticut","Naugatuck Valley Planning Region",4,82,1951,811,1140
050,09,140,"Connecticut","Naugatuck Valley Planning Region",4,83,1803,741,1062
050,09,140,"Connecticut","Naugatuck Valley Planning Region",4,84,1644,655,989
050,09,140,"Connecticut","Naugatuck Valley Planning Region",4,85,10221,3551,6670
050,09,140,"Connecticut","Naugatuck Valley Planning Region",5,0,4356,2255,2101
050,09,140,"Connecticut","Naugatuck Valley Planning Region",5,1,4544,2374,2170
050,09,140,"Connecticut","Naugatuck Valley Planning Region",5,2,4633,2439,2194
050,09,140,"Connecticut","Naugatuck Valley Planning Region",5,3,4763,2410,2353
050,09,140,"Connecticut","Naugatuck Valley Planning Region",5,4,4836,2447,2389
050,09,140,"Connecticut","Naugatuck Valley Planning Region",5,5,4837,2459,2378
050,09,140,"Connecticut","Naugatuck Valley Planning Region",5,6,5001,2559,2442
050,09,140,"Connecticut","Naugatuck Valley Planning Region",5,7,4998,2582,2416
050,09,140,"Connecticut","Naugatuck Valley Planning Region",5,8,5002,2587,2415
050,09,140,"Connecticut","Naugatuck Valley Planning Region",5,9,5100,2629,2471
050,09,140,"Connecticut","Naugatuck Valley Planning Region",5,10,5027,2563,2464
050,09,140,"Connecticut","Naugatuck Valley Planning Region",5,11,5087,2598,2489
050,09,140,"Connecticut","Naugatuck Valley Planning Region",5,12,5223,2648,2575
050,09,140,"Connecticut","Naugatuck Valley Planning Region",5,13,5336,2723,2613
050,09,140,"Connecticut","Naugatuck Valley Planning Region",5,14,5571,2888,2683
050,09,140,"Connecticut","Naugatuck Valley Planning Region",5,15,5816,2970,2846
050,09,140,"Connecticut","Naugatuck Valley Planning Region",5,16,5883,2974,2909
050,09,140,"Connecticut","Naugatuck Valley Planning Region",5,17,5885,3011,2874
050,09,140,"Connecticut","Naugatuck Valley Planning Region",5,18,5340,2813,2527
050,09,140,"Connecticut","Naugatuck Valley Planning Region",5,19,4636,2450,2186
050,09,140,"Connecticut","Naugatuck Valley Planning Region",5,20,4857,2527,2330
050,09,140,"Connecticut","Naugatuck Valley Planning Region",5,21,4966,2546,2420
050,09,140,"Connecticut","Naugatuck Valley Planning Region",5,22,5343,2746,2597
050,09,140,"Connecticut","Naugatuck Valley Planning Region",5,23,5501,2799,2702
050,09,140,"Connecticut","Naugatuck Valley Planning Region",5,24,5596,2836,2760
050,09,140,"Connecticut","Naugatuck Valley Planning Region",5,25,5497,2805,2692
050,09,140,"Connecticut","Naugatuck Valley Planning Region",5,26,5563,2878,2685
050,09,140,"Connecticut","Naugatuck Valley Planning Region",5,27,5545,2822,2723
050,09,140,"Connecticut","Naugatuck Valley Planning Region",5,28,5783,2961,2822
050,09,140,"Connecticut","Naugatuck Valley Planning Region",5,29,5921,2998,2923
050,09,140,"Connecticut","Naugatuck Valley Planning Region",5,30,6047,3030,3017
050,09,140,"Connecticut","Naugatuck Valley Planning Region",5,31,6168,3051,3117
050,09,140,"Connecticut","Naugatuck Valley Planning Region",5,32,6067,3043,3024
050,09,140,"Connecticut","Naugatuck Valley Planning Region",5,33,6210,3120,3090
050,09,140,"Connecticut","Naugatuck Valley Planning Region",5,34,6081,3023,3058
050,09,140,"Connecticut","Naugatuck Valley Planning Region",5,35,6144,3074,3070
050,09,140,"Connecticut","Naugatuck Valley Planning Region",5,36,6206,3084,3122
050,09,140,"Connecticut","Naugatuck Valley Planning Region",5,37,6008,3004,3004
050,09,140,"Connecticut","Naugatuck Valley Planning Region",5,38,6052,2981,3071
050,09,140,"Connecticut","Naugatuck Valley Planning Region",5,39,5953,2928,3025
050,09,140,"Connecticut","Naugatuck Valley Planning Region",5,40,5986,2978,3008
050,09,140,"Connecticut","Naugatuck Valley Planning Region",5,41,5934,2927,3007
050,09,140,"Connecticut","Naugatuck Valley Planning Region",5,42,5825,2894,2931
050,09,140,"Connecticut","Naugatuck Valley Planning Region",5,43,5804,2912,2892
050,09,140,"Connecticut","Naugatuck Valley Planning Region",5,44,5581,2738,2843
050,09,140,"Connecticut","Naugatuck Valley Planning Region",5,45,5436,2658,2778
050,09,140,"Connecticut","Naugatuck Valley Planning Region",5,46,5340,2604,2736
050,09,140,"Connecticut","Naugatuck Valley Planning Region",5,47,5218,2534,2684
050,09,140,"Connecticut","Naugatuck Valley Planning Region",5,48,5191,2518,2673
050,09,140,"Connecticut","Naugatuck Valley Planning Region",5,49,5193,2505,2688
050,09,140,"Connecticut","Naugatuck Valley Planning Region",5,50,5270,2538,2732
050,09,140,"Connecticut","Naugatuck Valley Planning Region",5,51,5645,2778,2867
050,09,140,"Connecticut","Naugatuck Valley Planning Region",5,52,6148,2983,3165
050,09,140,"Connecticut","Naugatuck Valley Planning Region",5,53,6159,3019,3140
050,09,140,"Connecticut","Naugatuck Valley Planning Region",5,54,6110,2972,3138
050,09,140,"Connecticut","Naugatuck Valley Planning Region",5,55,6071,2911,3160
050,09,140,"Connecticut","Naugatuck Valley Planning Region",5,56,6230,3036,3194
050,09,140,"Connecticut","Naugatuck Valley Planning Region",5,57,6333,3070,3263
050,09,140,"Connecticut","Naugatuck Valley Planning Region",5,58,6522,3178,3344
050,09,140,"Connecticut","Naugatuck Valley Planning Region",5,59,6665,3287,3378
050,09,140,"Connecticut","Naugatuck Valley Planning Region",5,60,6549,3171,3378
050,09,140,"Connecticut","Naugatuck Valley Planning Region",5,61,6495,3143,3352
050,09,140,"Connecticut","Naugatuck Valley Planning Region",5,62,6525,3136,3389
050,09,140,"Connecticut","Naugatuck Valley Planning Region",5,63,6355,3035,3320
050,09,140,"Connecticut","Naugatuck Valley Planning Region",5,64,6255,3008,3247
050,09,140,"Connecticut","Naugatuck Valley Planning Region",5,65,6215,2995,3220
050,09,140,"Connecticut","Naugatuck Valley Planning Region",5,66,5987,2887,3100
050,09,140,"Connecticut","Naugatuck Valley Planning Region",5,67,5638,2663,2975
050,09,140,"Connecticut","Naugatuck Valley Planning Region",5,68,5469,2590,2879
050,09,140,"Connecticut","Naugatuck Valley Planning Region",5,69,5287,2501,2786
050,09,140,"Connecticut","Naugatuck Valley Planning Region",5,70,5010,2379,2631
050,09,140,"Connecticut","Naugatuck Valley Planning Region",5,71,4761,2202,2559
050,09,140,"Connecticut","Naugatuck Valley Planning Region",5,72,4485,2048,2437
050,09,140,"Connecticut","Naugatuck Valley Planning Region",5,73,4280,1939,2341
050,09,140,"Connecticut","Naugatuck Valley Planning Region",5,74,4224,1909,2315
050,09,140,"Connecticut","Naugatuck Valley Planning Region",5,75,4113,1845,2268
050,09,140,"Connecticut","Naugatuck Valley Planning Region",5,76,4385,1986,2399
050,09,140,"Connecticut","Naugatuck Valley Planning Region",5,77,3104,1357,1747
050,09,140,"Connecticut","Naugatuck Valley Planning Region",5,78,2921,1280,1641
050,09,140,"Connecticut","Naugatuck Valley Planning Region",5,79,2848,1261,1587
050,09,140,"Connecticut","Naugatuck Valley Planning Region",5,80,2908,1256,1652
050,09,140,"Connecticut","Naugatuck Valley Planning Region",5,81,2386,1001,1385
050,09,140,"Connecticut","Naugatuck Valley Planning Region",5,82,2026,849,1177
050,09,140,"Connecticut","Naugatuck Valley Planning Region",5,83,1849,750,1099
050,09,140,"Connecticut","Naugatuck Valley Planning Region",5,84,1694,683,1011
050,09,140,"Connecticut","Naugatuck Valley Planning Region",5,85,10316,3617,6699
050,09,150,"Connecticut","Northeastern Connecticut Planning Region",1,0,806,416,390
050,09,150,"Connecticut","Northeastern Connecticut Planning Region",1,1,806,437,369
050,09,150,"Connecticut","Northeastern Connecticut Planning Region",1,2,842,425,417
050,09,150,"Connecticut","Northeastern Connecticut Planning Region",1,3,883,447,436
050,09,150,"Connecticut","Northeastern Connecticut Planning Region",1,4,961,484,477
050,09,150,"Connecticut","Northeastern Connecticut Planning Region",1,5,974,487,487
050,09,150,"Connecticut","Northeastern Connecticut Planning Region",1,6,934,490,444
050,09,150,"Connecticut","Northeastern Connecticut Planning Region",1,7,974,487,487
050,09,150,"Connecticut","Northeastern Connecticut Planning Region",1,8,970,514,456
050,09,150,"Connecticut","Northeastern Connecticut Planning Region",1,9,970,495,475
050,09,150,"Connecticut","Northeastern Connecticut Planning Region",1,10,1014,513,501
050,09,150,"Connecticut","Northeastern Connecticut Planning Region",1,11,1051,541,510
050,09,150,"Connecticut","Northeastern Connecticut Planning Region",1,12,1103,557,546
050,09,150,"Connecticut","Northeastern Connecticut Planning Region",1,13,1083,549,534
050,09,150,"Connecticut","Northeastern Connecticut Planning Region",1,14,1119,590,529
050,09,150,"Connecticut","Northeastern Connecticut Planning Region",1,15,1122,596,526
050,09,150,"Connecticut","Northeastern Connecticut Planning Region",1,16,1174,606,568
050,09,150,"Connecticut","Northeastern Connecticut Planning Region",1,17,1155,580,575
050,09,150,"Connecticut","Northeastern Connecticut Planning Region",1,18,1030,536,494
050,09,150,"Connecticut","Northeastern Connecticut Planning Region",1,19,896,462,434
050,09,150,"Connecticut","Northeastern Connecticut Planning Region",1,20,992,505,487
050,09,150,"Connecticut","Northeastern Connecticut Planning Region",1,21,1010,526,484
050,09,150,"Connecticut","Northeastern Connecticut Planning Region",1,22,1013,542,471
050,09,150,"Connecticut","Northeastern Connecticut Planning Region",1,23,1068,553,515
050,09,150,"Connecticut","Northeastern Connecticut Planning Region",1,24,1105,573,532
050,09,150,"Connecticut","Northeastern Connecticut Planning Region",1,25,1156,621,535
050,09,150,"Connecticut","Northeastern Connecticut Planning Region",1,26,1156,619,537
050,09,150,"Connecticut","Northeastern Connecticut Planning Region",1,27,1176,590,586
050,09,150,"Connecticut","Northeastern Connecticut Planning Region",1,28,1178,637,541
050,09,150,"Connecticut","Northeastern Connecticut Planning Region",1,29,1177,617,560
050,09,150,"Connecticut","Northeastern Connecticut Planning Region",1,30,1235,620,615
050,09,150,"Connecticut","Northeastern Connecticut Planning Region",1,31,1219,619,600
050,09,150,"Connecticut","Northeastern Connecticut Planning Region",1,32,1235,646,589
050,09,150,"Connecticut","Northeastern Connecticut Planning Region",1,33,1228,651,577
050,09,150,"Connecticut","Northeastern Connecticut Planning Region",1,34,1206,624,582
050,09,150,"Connecticut","Northeastern Connecticut Planning Region",1,35,1204,605,599
050,09,150,"Connecticut","Northeastern Connecticut Planning Region",1,36,1228,611,617
050,09,150,"Connecticut","Northeastern Connecticut Planning Region",1,37,1199,610,589
050,09,150,"Connecticut","Northeastern Connecticut Planning Region",1,38,1172,593,579
050,09,150,"Connecticut","Northeastern Connecticut Planning Region",1,39,1216,609,607
050,09,150,"Connecticut","Northeastern Connecticut Planning Region",1,40,1216,631,585
050,09,150,"Connecticut","Northeastern Connecticut Planning Region",1,41,1180,594,586
050,09,150,"Connecticut","Northeastern Connecticut Planning Region",1,42,1110,554,556
050,09,150,"Connecticut","Northeastern Connecticut Planning Region",1,43,1117,554,563
050,09,150,"Connecticut","Northeastern Connecticut Planning Region",1,44,1149,577,572
050,09,150,"Connecticut","Northeastern Connecticut Planning Region",1,45,1134,572,562
050,09,150,"Connecticut","Northeastern Connecticut Planning Region",1,46,1080,538,542
050,09,150,"Connecticut","Northeastern Connecticut Planning Region",1,47,1172,597,575
050,09,150,"Connecticut","Northeastern Connecticut Planning Region",1,48,1324,679,645
050,09,150,"Connecticut","Northeastern Connecticut Planning Region",1,49,1435,723,712
050,09,150,"Connecticut","Northeastern Connecticut Planning Region",1,50,1366,686,680
050,09,150,"Connecticut","Northeastern Connecticut Planning Region",1,51,1352,675,677
050,09,150,"Connecticut","Northeastern Connecticut Planning Region",1,52,1401,714,687
050,09,150,"Connecticut","Northeastern Connecticut Planning Region",1,53,1404,696,708
050,09,150,"Connecticut","Northeastern Connecticut Planning Region",1,54,1452,722,730
050,09,150,"Connecticut","Northeastern Connecticut Planning Region",1,55,1545,748,797
050,09,150,"Connecticut","Northeastern Connecticut Planning Region",1,56,1615,792,823
050,09,150,"Connecticut","Northeastern Connecticut Planning Region",1,57,1592,821,771
050,09,150,"Connecticut","Northeastern Connecticut Planning Region",1,58,1626,820,806
050,09,150,"Connecticut","Northeastern Connecticut Planning Region",1,59,1659,807,852
050,09,150,"Connecticut","Northeastern Connecticut Planning Region",1,60,1625,791,834
050,09,150,"Connecticut","Northeastern Connecticut Planning Region",1,61,1602,783,819
050,09,150,"Connecticut","Northeastern Connecticut Planning Region",1,62,1558,782,776
050,09,150,"Connecticut","Northeastern Connecticut Planning Region",1,63,1459,730,729
050,09,150,"Connecticut","Northeastern Connecticut Planning Region",1,64,1410,685,725
050,09,150,"Connecticut","Northeastern Connecticut Planning Region",1,65,1379,670,709
050,09,150,"Connecticut","Northeastern Connecticut Planning Region",1,66,1300,634,666
050,09,150,"Connecticut","Northeastern Connecticut Planning Region",1,67,1234,603,631
050,09,150,"Connecticut","Northeastern Connecticut Planning Region",1,68,1185,578,607
050,09,150,"Connecticut","Northeastern Connecticut Planning Region",1,69,1050,516,534
050,09,150,"Connecticut","Northeastern Connecticut Planning Region",1,70,1016,485,531
050,09,150,"Connecticut","Northeastern Connecticut Planning Region",1,71,962,450,512
050,09,150,"Connecticut","Northeastern Connecticut Planning Region",1,72,982,473,509
050,09,150,"Connecticut","Northeastern Connecticut Planning Region",1,73,982,466,516
050,09,150,"Connecticut","Northeastern Connecticut Planning Region",1,74,690,328,362
050,09,150,"Connecticut","Northeastern Connecticut Planning Region",1,75,690,335,355
050,09,150,"Connecticut","Northeastern Connecticut Planning Region",1,76,721,352,369
050,09,150,"Connecticut","Northeastern Connecticut Planning Region",1,77,675,307,368
050,09,150,"Connecticut","Northeastern Connecticut Planning Region",1,78,539,238,301
050,09,150,"Connecticut","Northeastern Connecticut Planning Region",1,79,476,212,264
050,09,150,"Connecticut","Northeastern Connecticut Planning Region",1,80,460,212,248
050,09,150,"Connecticut","Northeastern Connecticut Planning Region",1,81,407,176,231
050,09,150,"Connecticut","Northeastern Connecticut Planning Region",1,82,379,175,204
050,09,150,"Connecticut","Northeastern Connecticut Planning Region",1,83,347,144,203
050,09,150,"Connecticut","Northeastern Connecticut Planning Region",1,84,304,131,173
050,09,150,"Connecticut","Northeastern Connecticut Planning Region",1,85,1935,636,1299
050,09,150,"Connecticut","Northeastern Connecticut Planning Region",2,0,819,427,392
050,09,150,"Connecticut","Northeastern Connecticut Planning Region",2,1,803,427,376
050,09,150,"Connecticut","Northeastern Connecticut Planning Region",2,2,839,431,408
050,09,150,"Connecticut","Northeastern Connecticut Planning Region",2,3,872,442,430
050,09,150,"Connecticut","Northeastern Connecticut Planning Region",2,4,946,475,471
050,09,150,"Connecticut","Northeastern Connecticut Planning Region",2,5,976,493,483
050,09,150,"Connecticut","Northeastern Connecticut Planning Region",2,6,949,494,455
050,09,150,"Connecticut","Northeastern Connecticut Planning Region",2,7,970,490,480
050,09,150,"Connecticut","Northeastern Connecticut Planning Region",2,8,974,508,466
050,09,150,"Connecticut","Northeastern Connecticut Planning Region",2,9,976,502,474
050,09,150,"Connecticut","Northeastern Connecticut Planning Region",2,10,1010,513,497
050,09,150,"Connecticut","Northeastern Connecticut Planning Region",2,11,1039,532,507
050,09,150,"Connecticut","Northeastern Connecticut Planning Region",2,12,1101,560,541
050,09,150,"Connecticut","Northeastern Connecticut Planning Region",2,13,1088,553,535
050,09,150,"Connecticut","Northeastern Connecticut Planning Region",2,14,1113,584,529
050,09,150,"Connecticut","Northeastern Connecticut Planning Region",2,15,1130,599,531
050,09,150,"Connecticut","Northeastern Connecticut Planning Region",2,16,1167,607,560
050,09,150,"Connecticut","Northeastern Connecticut Planning Region",2,17,1156,583,573
050,09,150,"Connecticut","Northeastern Connecticut Planning Region",2,18,1025,529,496
050,09,150,"Connecticut","Northeastern Connecticut Planning Region",2,19,893,462,431
050,09,150,"Connecticut","Northeastern Connecticut Planning Region",2,20,983,504,479
050,09,150,"Connecticut","Northeastern Connecticut Planning Region",2,21,1007,523,484
050,09,150,"Connecticut","Northeastern Connecticut Planning Region",2,22,1013,538,475
050,09,150,"Connecticut","Northeastern Connecticut Planning Region",2,23,1060,554,506
050,09,150,"Connecticut","Northeastern Connecticut Planning Region",2,24,1097,569,528
050,09,150,"Connecticut","Northeastern Connecticut Planning Region",2,25,1139,609,530
050,09,150,"Connecticut","Northeastern Connecticut Planning Region",2,26,1156,616,540
050,09,150,"Connecticut","Northeastern Connecticut Planning Region",2,27,1170,594,576
050,09,150,"Connecticut","Northeastern Connecticut Planning Region",2,28,1172,621,551
050,09,150,"Connecticut","Northeastern Connecticut Planning Region",2,29,1184,622,562
050,09,150,"Connecticut","Northeastern Connecticut Planning Region",2,30,1224,615,609
050,09,150,"Connecticut","Northeastern Connecticut Planning Region",2,31,1219,615,604
050,09,150,"Connecticut","Northeastern Connecticut Planning Region",2,32,1231,638,593
050,09,150,"Connecticut","Northeastern Connecticut Planning Region",2,33,1226,644,582
050,09,150,"Connecticut","Northeastern Connecticut Planning Region",2,34,1211,630,581
050,09,150,"Connecticut","Northeastern Connecticut Planning Region",2,35,1217,615,602
050,09,150,"Connecticut","Northeastern Connecticut Planning Region",2,36,1211,603,608
050,09,150,"Connecticut","Northeastern Connecticut Planning Region",2,37,1209,611,598
050,09,150,"Connecticut","Northeastern Connecticut Planning Region",2,38,1181,597,584
050,09,150,"Connecticut","Northeastern Connecticut Planning Region",2,39,1197,602,595
050,09,150,"Connecticut","Northeastern Connecticut Planning Region",2,40,1219,626,593
050,09,150,"Connecticut","Northeastern Connecticut Planning Region",2,41,1189,601,588
050,09,150,"Connecticut","Northeastern Connecticut Planning Region",2,42,1122,560,562
050,09,150,"Connecticut","Northeastern Connecticut Planning Region",2,43,1127,559,568
050,09,150,"Connecticut","Northeastern Connecticut Planning Region",2,44,1132,565,567
050,09,150,"Connecticut","Northeastern Connecticut Planning Region",2,45,1139,573,566
050,09,150,"Connecticut","Northeastern Connecticut Planning Region",2,46,1090,542,548
050,09,150,"Connecticut","Northeastern Connecticut Planning Region",2,47,1147,583,564
050,09,150,"Connecticut","Northeastern Connecticut Planning Region",2,48,1281,656,625
050,09,150,"Connecticut","Northeastern Connecticut Planning Region",2,49,1410,715,695
050,09,150,"Connecticut","Northeastern Connecticut Planning Region",2,50,1382,695,687
050,09,150,"Connecticut","Northeastern Connecticut Planning Region",2,51,1354,679,675
050,09,150,"Connecticut","Northeastern Connecticut Planning Region",2,52,1381,701,680
050,09,150,"Connecticut","Northeastern Connecticut Planning Region",2,53,1402,697,705
050,09,150,"Connecticut","Northeastern Connecticut Planning Region",2,54,1435,713,722
050,09,150,"Connecticut","Northeastern Connecticut Planning Region",2,55,1514,736,778
050,09,150,"Connecticut","Northeastern Connecticut Planning Region",2,56,1595,778,817
050,09,150,"Connecticut","Northeastern Connecticut Planning Region",2,57,1595,813,782
050,09,150,"Connecticut","Northeastern Connecticut Planning Region",2,58,1613,818,795
050,09,150,"Connecticut","Northeastern Connecticut Planning Region",2,59,1654,813,841
050,09,150,"Connecticut","Northeastern Connecticut Planning Region",2,60,1621,787,834
050,09,150,"Connecticut","Northeastern Connecticut Planning Region",2,61,1597,780,817
050,09,150,"Connecticut","Northeastern Connecticut Planning Region",2,62,1556,776,780
050,09,150,"Connecticut","Northeastern Connecticut Planning Region",2,63,1491,747,744
050,09,150,"Connecticut","Northeastern Connecticut Planning Region",2,64,1402,684,718
050,09,150,"Connecticut","Northeastern Connecticut Planning Region",2,65,1382,672,710
050,09,150,"Connecticut","Northeastern Connecticut Planning Region",2,66,1314,639,675
050,09,150,"Connecticut","Northeastern Connecticut Planning Region",2,67,1243,606,637
050,09,150,"Connecticut","Northeastern Connecticut Planning Region",2,68,1183,579,604
050,09,150,"Connecticut","Northeastern Connecticut Planning Region",2,69,1085,533,552
050,09,150,"Connecticut","Northeastern Connecticut Planning Region",2,70,1013,487,526
050,09,150,"Connecticut","Northeastern Connecticut Planning Region",2,71,973,457,516
050,09,150,"Connecticut","Northeastern Connecticut Planning Region",2,72,958,457,501
050,09,150,"Connecticut","Northeastern Connecticut Planning Region",2,73,1027,491,536
050,09,150,"Connecticut","Northeastern Connecticut Planning Region",2,74,712,340,372
050,09,150,"Connecticut","Northeastern Connecticut Planning Region",2,75,688,333,355
050,09,150,"Connecticut","Northeastern Connecticut Planning Region",2,76,697,339,358
050,09,150,"Connecticut","Northeastern Connecticut Planning Region",2,77,695,321,374
050,09,150,"Connecticut","Northeastern Connecticut Planning Region",2,78,553,246,307
050,09,150,"Connecticut","Northeastern Connecticut Planning Region",2,79,481,214,267
050,09,150,"Connecticut","Northeastern Connecticut Planning Region",2,80,458,208,250
050,09,150,"Connecticut","Northeastern Connecticut Planning Region",2,81,410,178,232
050,09,150,"Connecticut","Northeastern Connecticut Planning Region",2,82,377,170,207
050,09,150,"Connecticut","Northeastern Connecticut Planning Region",2,83,343,146,197
050,09,150,"Connecticut","Northeastern Connecticut Planning Region",2,84,310,131,179
050,09,150,"Connecticut","Northeastern Connecticut Planning Region",2,85,1919,641,1278
050,09,150,"Connecticut","Northeastern Connecticut Planning Region",3,0,784,424,360
050,09,150,"Connecticut","Northeastern Connecticut Planning Region",3,1,851,457,394
050,09,150,"Connecticut","Northeastern Connecticut Planning Region",3,2,845,450,395
050,09,150,"Connecticut","Northeastern Connecticut Planning Region",3,3,860,443,417
050,09,150,"Connecticut","Northeastern Connecticut Planning Region",3,4,874,445,429
050,09,150,"Connecticut","Northeastern Connecticut Planning Region",3,5,963,474,489
050,09,150,"Connecticut","Northeastern Connecticut Planning Region",3,6,980,508,472
050,09,150,"Connecticut","Northeastern Connecticut Planning Region",3,7,962,501,461
050,09,150,"Connecticut","Northeastern Connecticut Planning Region",3,8,992,498,494
050,09,150,"Connecticut","Northeastern Connecticut Planning Region",3,9,977,503,474
050,09,150,"Connecticut","Northeastern Connecticut Planning Region",3,10,986,503,483
050,09,150,"Connecticut","Northeastern Connecticut Planning Region",3,11,1001,507,494
050,09,150,"Connecticut","Northeastern Connecticut Planning Region",3,12,1071,555,516
050,09,150,"Connecticut","Northeastern Connecticut Planning Region",3,13,1100,552,548
050,09,150,"Connecticut","Northeastern Connecticut Planning Region",3,14,1118,569,549
050,09,150,"Connecticut","Northeastern Connecticut Planning Region",3,15,1118,586,532
050,09,150,"Connecticut","Northeastern Connecticut Planning Region",3,16,1129,594,535
050,09,150,"Connecticut","Northeastern Connecticut Planning Region",3,17,1143,585,558
050,09,150,"Connecticut","Northeastern Connecticut Planning Region",3,18,1050,542,508
050,09,150,"Connecticut","Northeastern Connecticut Planning Region",3,19,886,457,429
050,09,150,"Connecticut","Northeastern Connecticut Planning Region",3,20,934,476,458
050,09,150,"Connecticut","Northeastern Connecticut Planning Region",3,21,1017,516,501
050,09,150,"Connecticut","Northeastern Connecticut Planning Region",3,22,1052,539,513
050,09,150,"Connecticut","Northeastern Connecticut Planning Region",3,23,1055,580,475
050,09,150,"Connecticut","Northeastern Connecticut Planning Region",3,24,1077,567,510
050,09,150,"Connecticut","Northeastern Connecticut Planning Region",3,25,1107,586,521
050,09,150,"Connecticut","Northeastern Connecticut Planning Region",3,26,1166,627,539
050,09,150,"Connecticut","Northeastern Connecticut Planning Region",3,27,1176,620,556
050,09,150,"Connecticut","Northeastern Connecticut Planning Region",3,28,1244,648,596
050,09,150,"Connecticut","Northeastern Connecticut Planning Region",3,29,1249,665,584
050,09,150,"Connecticut","Northeastern Connecticut Planning Region",3,30,1164,603,561
050,09,150,"Connecticut","Northeastern Connecticut Planning Region",3,31,1246,637,609
050,09,150,"Connecticut","Northeastern Connecticut Planning Region",3,32,1232,617,615
050,09,150,"Connecticut","Northeastern Connecticut Planning Region",3,33,1243,637,606
050,09,150,"Connecticut","Northeastern Connecticut Planning Region",3,34,1237,634,603
050,09,150,"Connecticut","Northeastern Connecticut Planning Region",3,35,1229,632,597
050,09,150,"Connecticut","Northeastern Connecticut Planning Region",3,36,1255,634,621
050,09,150,"Connecticut","Northeastern Connecticut Planning Region",3,37,1250,628,622
050,09,150,"Connecticut","Northeastern Connecticut Planning Region",3,38,1208,604,604
050,09,150,"Connecticut","Northeastern Connecticut Planning Region",3,39,1186,599,587
050,09,150,"Connecticut","Northeastern Connecticut Planning Region",3,40,1220,613,607
050,09,150,"Connecticut","Northeastern Connecticut Planning Region",3,41,1219,622,597
050,09,150,"Connecticut","Northeastern Connecticut Planning Region",3,42,1181,609,572
050,09,150,"Connecticut","Northeastern Connecticut Planning Region",3,43,1144,585,559
050,09,150,"Connecticut","Northeastern Connecticut Planning Region",3,44,1152,578,574
050,09,150,"Connecticut","Northeastern Connecticut Planning Region",3,45,1152,575,577
050,09,150,"Connecticut","Northeastern Connecticut Planning Region",3,46,1161,578,583
050,09,150,"Connecticut","Northeastern Connecticut Planning Region",3,47,1117,557,560
050,09,150,"Connecticut","Northeastern Connecticut Planning Region",3,48,1159,583,576
050,09,150,"Connecticut","Northeastern Connecticut Planning Region",3,49,1262,635,627
050,09,150,"Connecticut","Northeastern Connecticut Planning Region",3,50,1418,725,693
050,09,150,"Connecticut","Northeastern Connecticut Planning Region",3,51,1389,692,697
050,09,150,"Connecticut","Northeastern Connecticut Planning Region",3,52,1356,688,668
050,09,150,"Connecticut","Northeastern Connecticut Planning Region",3,53,1375,693,682
050,09,150,"Connecticut","Northeastern Connecticut Planning Region",3,54,1420,706,714
050,09,150,"Connecticut","Northeastern Connecticut Planning Region",3,55,1443,710,733
050,09,150,"Connecticut","Northeastern Connecticut Planning Region",3,56,1507,732,775
050,09,150,"Connecticut","Northeastern Connecticut Planning Region",3,57,1598,786,812
050,09,150,"Connecticut","Northeastern Connecticut Planning Region",3,58,1589,816,773
050,09,150,"Connecticut","Northeastern Connecticut Planning Region",3,59,1598,801,797
050,09,150,"Connecticut","Northeastern Connecticut Planning Region",3,60,1625,800,825
050,09,150,"Connecticut","Northeastern Connecticut Planning Region",3,61,1590,765,825
050,09,150,"Connecticut","Northeastern Connecticut Planning Region",3,62,1586,777,809
050,09,150,"Connecticut","Northeastern Connecticut Planning Region",3,63,1533,769,764
050,09,150,"Connecticut","Northeastern Connecticut Planning Region",3,64,1452,732,720
050,09,150,"Connecticut","Northeastern Connecticut Planning Region",3,65,1379,667,712
050,09,150,"Connecticut","Northeastern Connecticut Planning Region",3,66,1339,645,694
050,09,150,"Connecticut","Northeastern Connecticut Planning Region",3,67,1298,632,666
050,09,150,"Connecticut","Northeastern Connecticut Planning Region",3,68,1216,587,629
050,09,150,"Connecticut","Northeastern Connecticut Planning Region",3,69,1156,567,589
050,09,150,"Connecticut","Northeastern Connecticut Planning Region",3,70,1055,527,528
050,09,150,"Connecticut","Northeastern Connecticut Planning Region",3,71,990,479,511
050,09,150,"Connecticut","Northeastern Connecticut Planning Region",3,72,952,450,502
050,09,150,"Connecticut","Northeastern Connecticut Planning Region",3,73,924,436,488
050,09,150,"Connecticut","Northeastern Connecticut Planning Region",3,74,993,475,518
050,09,150,"Connecticut","Northeastern Connecticut Planning Region",3,75,694,329,365
050,09,150,"Connecticut","Northeastern Connecticut Planning Region",3,76,658,314,344
050,09,150,"Connecticut","Northeastern Connecticut Planning Region",3,77,674,324,350
050,09,150,"Connecticut","Northeastern Connecticut Planning Region",3,78,655,295,360
050,09,150,"Connecticut","Northeastern Connecticut Planning Region",3,79,531,232,299
050,09,150,"Connecticut","Northeastern Connecticut Planning Region",3,80,459,205,254
050,09,150,"Connecticut","Northeastern Connecticut Planning Region",3,81,438,198,240
050,09,150,"Connecticut","Northeastern Connecticut Planning Region",3,82,381,165,216
050,09,150,"Connecticut","Northeastern Connecticut Planning Region",3,83,352,162,190
050,09,150,"Connecticut","Northeastern Connecticut Planning Region",3,84,317,129,188
050,09,150,"Connecticut","Northeastern Connecticut Planning Region",3,85,1881,655,1226
050,09,150,"Connecticut","Northeastern Connecticut Planning Region",4,0,882,471,411
050,09,150,"Connecticut","Northeastern Connecticut Planning Region",4,1,830,447,383
050,09,150,"Connecticut","Northeastern Connecticut Planning Region",4,2,874,472,402
050,09,150,"Connecticut","Northeastern Connecticut Planning Region",4,3,852,450,402
050,09,150,"Connecticut","Northeastern Connecticut Planning Region",4,4,894,469,425
050,09,150,"Connecticut","Northeastern Connecticut Planning Region",4,5,905,463,442
050,09,150,"Connecticut","Northeastern Connecticut Planning Region",4,6,985,493,492
050,09,150,"Connecticut","Northeastern Connecticut Planning Region",4,7,999,498,501
050,09,150,"Connecticut","Northeastern Connecticut Planning Region",4,8,967,496,471
050,09,150,"Connecticut","Northeastern Connecticut Planning Region",4,9,1004,499,505
050,09,150,"Connecticut","Northeastern Connecticut Planning Region",4,10,974,509,465
050,09,150,"Connecticut","Northeastern Connecticut Planning Region",4,11,1010,507,503
050,09,150,"Connecticut","Northeastern Connecticut Planning Region",4,12,1014,519,495
050,09,150,"Connecticut","Northeastern Connecticut Planning Region",4,13,1084,560,524
050,09,150,"Connecticut","Northeastern Connecticut Planning Region",4,14,1142,575,567
050,09,150,"Connecticut","Northeastern Connecticut Planning Region",4,15,1099,563,536
050,09,150,"Connecticut","Northeastern Connecticut Planning Region",4,16,1123,586,537
050,09,150,"Connecticut","Northeastern Connecticut Planning Region",4,17,1150,607,543
050,09,150,"Connecticut","Northeastern Connecticut Planning Region",4,18,1033,538,495
050,09,150,"Connecticut","Northeastern Connecticut Planning Region",4,19,867,442,425
050,09,150,"Connecticut","Northeastern Connecticut Planning Region",4,20,894,455,439
050,09,150,"Connecticut","Northeastern Connecticut Planning Region",4,21,966,493,473
050,09,150,"Connecticut","Northeastern Connecticut Planning Region",4,22,1047,516,531
050,09,150,"Connecticut","Northeastern Connecticut Planning Region",4,23,1060,542,518
050,09,150,"Connecticut","Northeastern Connecticut Planning Region",4,24,1037,583,454
050,09,150,"Connecticut","Northeastern Connecticut Planning Region",4,25,1085,593,492
050,09,150,"Connecticut","Northeastern Connecticut Planning Region",4,26,1108,596,512
050,09,150,"Connecticut","Northeastern Connecticut Planning Region",4,27,1223,645,578
050,09,150,"Connecticut","Northeastern Connecticut Planning Region",4,28,1197,638,559
050,09,150,"Connecticut","Northeastern Connecticut Planning Region",4,29,1260,668,592
050,09,150,"Connecticut","Northeastern Connecticut Planning Region",4,30,1253,662,591
050,09,150,"Connecticut","Northeastern Connecticut Planning Region",4,31,1237,625,612
050,09,150,"Connecticut","Northeastern Connecticut Planning Region",4,32,1249,633,616
050,09,150,"Connecticut","Northeastern Connecticut Planning Region",4,33,1265,636,629
050,09,150,"Connecticut","Northeastern Connecticut Planning Region",4,34,1237,629,608
050,09,150,"Connecticut","Northeastern Connecticut Planning Region",4,35,1296,663,633
050,09,150,"Connecticut","Northeastern Connecticut Planning Region",4,36,1288,657,631
050,09,150,"Connecticut","Northeastern Connecticut Planning Region",4,37,1317,671,646
050,09,150,"Connecticut","Northeastern Connecticut Planning Region",4,38,1273,641,632
050,09,150,"Connecticut","Northeastern Connecticut Planning Region",4,39,1194,603,591
050,09,150,"Connecticut","Northeastern Connecticut Planning Region",4,40,1182,591,591
050,09,150,"Connecticut","Northeastern Connecticut Planning Region",4,41,1229,615,614
050,09,150,"Connecticut","Northeastern Connecticut Planning Region",4,42,1236,624,612
050,09,150,"Connecticut","Northeastern Connecticut Planning Region",4,43,1214,629,585
050,09,150,"Connecticut","Northeastern Connecticut Planning Region",4,44,1151,595,556
050,09,150,"Connecticut","Northeastern Connecticut Planning Region",4,45,1133,572,561
050,09,150,"Connecticut","Northeastern Connecticut Planning Region",4,46,1169,582,587
050,09,150,"Connecticut","Northeastern Connecticut Planning Region",4,47,1194,597,597
050,09,150,"Connecticut","Northeastern Connecticut Planning Region",4,48,1122,562,560
050,09,150,"Connecticut","Northeastern Connecticut Planning Region",4,49,1174,592,582
050,09,150,"Connecticut","Northeastern Connecticut Planning Region",4,50,1247,630,617
050,09,150,"Connecticut","Northeastern Connecticut Planning Region",4,51,1448,732,716
050,09,150,"Connecticut","Northeastern Connecticut Planning Region",4,52,1400,697,703
050,09,150,"Connecticut","Northeastern Connecticut Planning Region",4,53,1356,682,674
050,09,150,"Connecticut","Northeastern Connecticut Planning Region",4,54,1369,693,676
050,09,150,"Connecticut","Northeastern Connecticut Planning Region",4,55,1406,700,706
050,09,150,"Connecticut","Northeastern Connecticut Planning Region",4,56,1415,706,709
050,09,150,"Connecticut","Northeastern Connecticut Planning Region",4,57,1481,711,770
050,09,150,"Connecticut","Northeastern Connecticut Planning Region",4,58,1590,783,807
050,09,150,"Connecticut","Northeastern Connecticut Planning Region",4,59,1580,807,773
050,09,150,"Connecticut","Northeastern Connecticut Planning Region",4,60,1573,780,793
050,09,150,"Connecticut","Northeastern Connecticut Planning Region",4,61,1620,797,823
050,09,150,"Connecticut","Northeastern Connecticut Planning Region",4,62,1600,765,835
050,09,150,"Connecticut","Northeastern Connecticut Planning Region",4,63,1561,769,792
050,09,150,"Connecticut","Northeastern Connecticut Planning Region",4,64,1496,753,743
050,09,150,"Connecticut","Northeastern Connecticut Planning Region",4,65,1443,728,715
050,09,150,"Connecticut","Northeastern Connecticut Planning Region",4,66,1334,633,701
050,09,150,"Connecticut","Northeastern Connecticut Planning Region",4,67,1333,643,690
050,09,150,"Connecticut","Northeastern Connecticut Planning Region",4,68,1262,610,652
050,09,150,"Connecticut","Northeastern Connecticut Planning Region",4,69,1185,567,618
050,09,150,"Connecticut","Northeastern Connecticut Planning Region",4,70,1116,541,575
050,09,150,"Connecticut","Northeastern Connecticut Planning Region",4,71,1021,506,515
050,09,150,"Connecticut","Northeastern Connecticut Planning Region",4,72,977,472,505
050,09,150,"Connecticut","Northeastern Connecticut Planning Region",4,73,907,420,487
050,09,150,"Connecticut","Northeastern Connecticut Planning Region",4,74,884,415,469
050,09,150,"Connecticut","Northeastern Connecticut Planning Region",4,75,960,453,507
050,09,150,"Connecticut","Northeastern Connecticut Planning Region",4,76,679,320,359
050,09,150,"Connecticut","Northeastern Connecticut Planning Region",4,77,641,305,336
050,09,150,"Connecticut","Northeastern Connecticut Planning Region",4,78,644,303,341
050,09,150,"Connecticut","Northeastern Connecticut Planning Region",4,79,637,283,354
050,09,150,"Connecticut","Northeastern Connecticut Planning Region",4,80,517,224,293
050,09,150,"Connecticut","Northeastern Connecticut Planning Region",4,81,440,189,251
050,09,150,"Connecticut","Northeastern Connecticut Planning Region",4,82,408,182,226
050,09,150,"Connecticut","Northeastern Connecticut Planning Region",4,83,369,161,208
050,09,150,"Connecticut","Northeastern Connecticut Planning Region",4,84,330,150,180
050,09,150,"Connecticut","Northeastern Connecticut Planning Region",4,85,1941,679,1262
050,09,150,"Connecticut","Northeastern Connecticut Planning Region",5,0,820,439,381
050,09,150,"Connecticut","Northeastern Connecticut Planning Region",5,1,901,472,429
050,09,150,"Connecticut","Northeastern Connecticut Planning Region",5,2,848,449,399
050,09,150,"Connecticut","Northeastern Connecticut Planning Region",5,3,864,468,396
050,09,150,"Connecticut","Northeastern Connecticut Planning Region",5,4,882,475,407
050,09,150,"Connecticut","Northeastern Connecticut Planning Region",5,5,915,480,435
050,09,150,"Connecticut","Northeastern Connecticut Planning Region",5,6,917,482,435
050,09,150,"Connecticut","Northeastern Connecticut Planning Region",5,7,992,494,498
050,09,150,"Connecticut","Northeastern Connecticut Planning Region",5,8,1012,522,490
050,09,150,"Connecticut","Northeastern Connecticut Planning Region",5,9,977,509,468
050,09,150,"Connecticut","Northeastern Connecticut Planning Region",5,10,1007,496,511
050,09,150,"Connecticut","Northeastern Connecticut Planning Region",5,11,969,500,469
050,09,150,"Connecticut","Northeastern Connecticut Planning Region",5,12,1010,511,499
050,09,150,"Connecticut","Northeastern Connecticut Planning Region",5,13,1018,527,491
050,09,150,"Connecticut","Northeastern Connecticut Planning Region",5,14,1096,576,520
050,09,150,"Connecticut","Northeastern Connecticut Planning Region",5,15,1136,569,567
050,09,150,"Connecticut","Northeastern Connecticut Planning Region",5,16,1112,561,551
050,09,150,"Connecticut","Northeastern Connecticut Planning Region",5,17,1100,562,538
050,09,150,"Connecticut","Northeastern Connecticut Planning Region",5,18,1012,537,475
050,09,150,"Connecticut","Northeastern Connecticut Planning Region",5,19,856,439,417
050,09,150,"Connecticut","Northeastern Connecticut Planning Region",5,20,922,471,451
050,09,150,"Connecticut","Northeastern Connecticut Planning Region",5,21,935,477,458
050,09,150,"Connecticut","Northeastern Connecticut Planning Region",5,22,1003,519,484
050,09,150,"Connecticut","Northeastern Connecticut Planning Region",5,23,1065,539,526
050,09,150,"Connecticut","Northeastern Connecticut Planning Region",5,24,1105,568,537
050,09,150,"Connecticut","Northeastern Connecticut Planning Region",5,25,1045,581,464
050,09,150,"Connecticut","Northeastern Connecticut Planning Region",5,26,1119,592,527
050,09,150,"Connecticut","Northeastern Connecticut Planning Region",5,27,1126,599,527
050,09,150,"Connecticut","Northeastern Connecticut Planning Region",5,28,1265,685,580
050,09,150,"Connecticut","Northeastern Connecticut Planning Region",5,29,1257,688,569
050,09,150,"Connecticut","Northeastern Connecticut Planning Region",5,30,1245,650,595
050,09,150,"Connecticut","Northeastern Connecticut Planning Region",5,31,1316,693,623
050,09,150,"Connecticut","Northeastern Connecticut Planning Region",5,32,1245,635,610
050,09,150,"Connecticut","Northeastern Connecticut Planning Region",5,33,1301,672,629
050,09,150,"Connecticut","Northeastern Connecticut Planning Region",5,34,1320,664,656
050,09,150,"Connecticut","Northeastern Connecticut Planning Region",5,35,1255,637,618
050,09,150,"Connecticut","Northeastern Connecticut Planning Region",5,36,1341,672,669
050,09,150,"Connecticut","Northeastern Connecticut Planning Region",5,37,1328,684,644
050,09,150,"Connecticut","Northeastern Connecticut Planning Region",5,38,1302,664,638
050,09,150,"Connecticut","Northeastern Connecticut Planning Region",5,39,1285,663,622
050,09,150,"Connecticut","Northeastern Connecticut Planning Region",5,40,1203,602,601
050,09,150,"Connecticut","Northeastern Connecticut Planning Region",5,41,1200,599,601
050,09,150,"Connecticut","Northeastern Connecticut Planning Region",5,42,1256,635,621
050,09,150,"Connecticut","Northeastern Connecticut Planning Region",5,43,1270,648,622
050,09,150,"Connecticut","Northeastern Connecticut Planning Region",5,44,1235,638,597
050,09,150,"Connecticut","Northeastern Connecticut Planning Region",5,45,1150,593,557
050,09,150,"Connecticut","Northeastern Connecticut Planning Region",5,46,1143,570,573
050,09,150,"Connecticut","Northeastern Connecticut Planning Region",5,47,1173,597,576
050,09,150,"Connecticut","Northeastern Connecticut Planning Region",5,48,1192,603,589
050,09,150,"Connecticut","Northeastern Connecticut Planning Region",5,49,1112,556,556
050,09,150,"Connecticut","Northeastern Connecticut Planning Region",5,50,1170,591,579
050,09,150,"Connecticut","Northeastern Connecticut Planning Region",5,51,1263,630,633
050,09,150,"Connecticut","Northeastern Connecticut Planning Region",5,52,1455,735,720
050,09,150,"Connecticut","Northeastern Connecticut Planning Region",5,53,1385,674,711
050,09,150,"Connecticut","Northeastern Connecticut Planning Region",5,54,1358,690,668
050,09,150,"Connecticut","Northeastern Connecticut Planning Region",5,55,1367,675,692
050,09,150,"Connecticut","Northeastern Connecticut Planning Region",5,56,1404,701,703
050,09,150,"Connecticut","Northeastern Connecticut Planning Region",5,57,1396,695,701
050,09,150,"Connecticut","Northeastern Connecticut Planning Region",5,58,1468,705,763
050,09,150,"Connecticut","Northeastern Connecticut Planning Region",5,59,1578,790,788
050,09,150,"Connecticut","Northeastern Connecticut Planning Region",5,60,1575,799,776
050,09,150,"Connecticut","Northeastern Connecticut Planning Region",5,61,1561,777,784
050,09,150,"Connecticut","Northeastern Connecticut Planning Region",5,62,1612,791,821
050,09,150,"Connecticut","Northeastern Connecticut Planning Region",5,63,1603,776,827
050,09,150,"Connecticut","Northeastern Connecticut Planning Region",5,64,1542,751,791
050,09,150,"Connecticut","Northeastern Connecticut Planning Region",5,65,1495,742,753
050,09,150,"Connecticut","Northeastern Connecticut Planning Region",5,66,1438,719,719
050,09,150,"Connecticut","Northeastern Connecticut Planning Region",5,67,1331,632,699
050,09,150,"Connecticut","Northeastern Connecticut Planning Region",5,68,1306,623,683
050,09,150,"Connecticut","Northeastern Connecticut Planning Region",5,69,1235,599,636
050,09,150,"Connecticut","Northeastern Connecticut Planning Region",5,70,1163,561,602
050,09,150,"Connecticut","Northeastern Connecticut Planning Region",5,71,1080,530,550
050,09,150,"Connecticut","Northeastern Connecticut Planning Region",5,72,1004,496,508
050,09,150,"Connecticut","Northeastern Connecticut Planning Region",5,73,947,453,494
050,09,150,"Connecticut","Northeastern Connecticut Planning Region",5,74,879,404,475
050,09,150,"Connecticut","Northeastern Connecticut Planning Region",5,75,864,405,459
050,09,150,"Connecticut","Northeastern Connecticut Planning Region",5,76,927,437,490
050,09,150,"Connecticut","Northeastern Connecticut Planning Region",5,77,654,306,348
050,09,150,"Connecticut","Northeastern Connecticut Planning Region",5,78,612,290,322
050,09,150,"Connecticut","Northeastern Connecticut Planning Region",5,79,612,286,326
050,09,150,"Connecticut","Northeastern Connecticut Planning Region",5,80,606,270,336
050,09,150,"Connecticut","Northeastern Connecticut Planning Region",5,81,502,215,287
050,09,150,"Connecticut","Northeastern Connecticut Planning Region",5,82,401,170,231
050,09,150,"Connecticut","Northeastern Connecticut Planning Region",5,83,387,171,216
050,09,150,"Connecticut","Northeastern Connecticut Planning Region",5,84,342,150,192
050,09,150,"Connecticut","Northeastern Connecticut Planning Region",5,85,2012,714,1298
050,09,160,"Connecticut","Northwest Hills Planning Region",1,0,874,450,424
050,09,160,"Connecticut","Northwest Hills Planning Region",1,1,924,477,447
050,09,160,"Connecticut","Northwest Hills Planning Region",1,2,938,478,460
050,09,160,"Connecticut","Northwest Hills Planning Region",1,3,993,512,481
050,09,160,"Connecticut","Northwest Hills Planning Region",1,4,980,488,492
050,09,160,"Connecticut","Northwest Hills Planning Region",1,5,1012,519,493
050,09,160,"Connecticut","Northwest Hills Planning Region",1,6,1025,522,503
050,09,160,"Connecticut","Northwest Hills Planning Region",1,7,1038,540,498
050,09,160,"Connecticut","Northwest Hills Planning Region",1,8,1081,555,526
050,09,160,"Connecticut","Northwest Hills Planning Region",1,9,1126,584,542
050,09,160,"Connecticut","Northwest Hills Planning Region",1,10,1161,629,532
050,09,160,"Connecticut","Northwest Hills Planning Region",1,11,1218,634,584
050,09,160,"Connecticut","Northwest Hills Planning Region",1,12,1269,657,612
050,09,160,"Connecticut","Northwest Hills Planning Region",1,13,1293,658,635
050,09,160,"Connecticut","Northwest Hills Planning Region",1,14,1322,681,641
050,09,160,"Connecticut","Northwest Hills Planning Region",1,15,1408,705,703
050,09,160,"Connecticut","Northwest Hills Planning Region",1,16,1440,728,712
050,09,160,"Connecticut","Northwest Hills Planning Region",1,17,1439,745,694
050,09,160,"Connecticut","Northwest Hills Planning Region",1,18,1263,685,578
050,09,160,"Connecticut","Northwest Hills Planning Region",1,19,1036,557,479
050,09,160,"Connecticut","Northwest Hills Planning Region",1,20,1113,577,536
050,09,160,"Connecticut","Northwest Hills Planning Region",1,21,1184,605,579
050,09,160,"Connecticut","Northwest Hills Planning Region",1,22,1177,608,569
050,09,160,"Connecticut","Northwest Hills Planning Region",1,23,1216,637,579
050,09,160,"Connecticut","Northwest Hills Planning Region",1,24,1211,613,598
050,09,160,"Connecticut","Northwest Hills Planning Region",1,25,1267,669,598
050,09,160,"Connecticut","Northwest Hills Planning Region",1,26,1280,671,609
050,09,160,"Connecticut","Northwest Hills Planning Region",1,27,1237,649,588
050,09,160,"Connecticut","Northwest Hills Planning Region",1,28,1240,646,594
050,09,160,"Connecticut","Northwest Hills Planning Region",1,29,1211,624,587
050,09,160,"Connecticut","Northwest Hills Planning Region",1,30,1203,632,571
050,09,160,"Connecticut","Northwest Hills Planning Region",1,31,1221,611,610
050,09,160,"Connecticut","Northwest Hills Planning Region",1,32,1246,648,598
050,09,160,"Connecticut","Northwest Hills Planning Region",1,33,1263,627,636
050,09,160,"Connecticut","Northwest Hills Planning Region",1,34,1238,622,616
050,09,160,"Connecticut","Northwest Hills Planning Region",1,35,1285,667,618
050,09,160,"Connecticut","Northwest Hills Planning Region",1,36,1275,644,631
050,09,160,"Connecticut","Northwest Hills Planning Region",1,37,1265,631,634
050,09,160,"Connecticut","Northwest Hills Planning Region",1,38,1300,677,623
050,09,160,"Connecticut","Northwest Hills Planning Region",1,39,1316,675,641
050,09,160,"Connecticut","Northwest Hills Planning Region",1,40,1251,632,619
050,09,160,"Connecticut","Northwest Hills Planning Region",1,41,1242,604,638
050,09,160,"Connecticut","Northwest Hills Planning Region",1,42,1240,624,616
050,09,160,"Connecticut","Northwest Hills Planning Region",1,43,1180,593,587
050,09,160,"Connecticut","Northwest Hills Planning Region",1,44,1192,604,588
050,09,160,"Connecticut","Northwest Hills Planning Region",1,45,1194,597,597
050,09,160,"Connecticut","Northwest Hills Planning Region",1,46,1218,604,614
050,09,160,"Connecticut","Northwest Hills Planning Region",1,47,1307,646,661
050,09,160,"Connecticut","Northwest Hills Planning Region",1,48,1430,686,744
050,09,160,"Connecticut","Northwest Hills Planning Region",1,49,1621,801,820
050,09,160,"Connecticut","Northwest Hills Planning Region",1,50,1699,837,862
050,09,160,"Connecticut","Northwest Hills Planning Region",1,51,1663,817,846
050,09,160,"Connecticut","Northwest Hills Planning Region",1,52,1652,815,837
050,09,160,"Connecticut","Northwest Hills Planning Region",1,53,1717,871,846
050,09,160,"Connecticut","Northwest Hills Planning Region",1,54,1826,915,911
050,09,160,"Connecticut","Northwest Hills Planning Region",1,55,1919,937,982
050,09,160,"Connecticut","Northwest Hills Planning Region",1,56,1978,979,999
050,09,160,"Connecticut","Northwest Hills Planning Region",1,57,1932,968,964
050,09,160,"Connecticut","Northwest Hills Planning Region",1,58,1945,961,984
050,09,160,"Connecticut","Northwest Hills Planning Region",1,59,1960,962,998
050,09,160,"Connecticut","Northwest Hills Planning Region",1,60,1944,961,983
050,09,160,"Connecticut","Northwest Hills Planning Region",1,61,1946,978,968
050,09,160,"Connecticut","Northwest Hills Planning Region",1,62,1938,974,964
050,09,160,"Connecticut","Northwest Hills Planning Region",1,63,1889,941,948
050,09,160,"Connecticut","Northwest Hills Planning Region",1,64,1788,877,911
050,09,160,"Connecticut","Northwest Hills Planning Region",1,65,1726,844,882
050,09,160,"Connecticut","Northwest Hills Planning Region",1,66,1689,850,839
050,09,160,"Connecticut","Northwest Hills Planning Region",1,67,1582,779,803
050,09,160,"Connecticut","Northwest Hills Planning Region",1,68,1543,753,790
050,09,160,"Connecticut","Northwest Hills Planning Region",1,69,1403,680,723
050,09,160,"Connecticut","Northwest Hills Planning Region",1,70,1361,672,689
050,09,160,"Connecticut","Northwest Hills Planning Region",1,71,1340,666,674
050,09,160,"Connecticut","Northwest Hills Planning Region",1,72,1344,666,678
050,09,160,"Connecticut","Northwest Hills Planning Region",1,73,1393,676,717
050,09,160,"Connecticut","Northwest Hills Planning Region",1,74,983,457,526
050,09,160,"Connecticut","Northwest Hills Planning Region",1,75,945,437,508
050,09,160,"Connecticut","Northwest Hills Planning Region",1,76,1005,466,539
050,09,160,"Connecticut","Northwest Hills Planning Region",1,77,982,460,522
050,09,160,"Connecticut","Northwest Hills Planning Region",1,78,787,360,427
050,09,160,"Connecticut","Northwest Hills Planning Region",1,79,689,320,369
050,09,160,"Connecticut","Northwest Hills Planning Region",1,80,615,273,342
050,09,160,"Connecticut","Northwest Hills Planning Region",1,81,602,266,336
050,09,160,"Connecticut","Northwest Hills Planning Region",1,82,539,225,314
050,09,160,"Connecticut","Northwest Hills Planning Region",1,83,458,199,259
050,09,160,"Connecticut","Northwest Hills Planning Region",1,84,444,195,249
050,09,160,"Connecticut","Northwest Hills Planning Region",1,85,2776,996,1780
050,09,160,"Connecticut","Northwest Hills Planning Region",2,0,883,454,429
050,09,160,"Connecticut","Northwest Hills Planning Region",2,1,912,471,441
050,09,160,"Connecticut","Northwest Hills Planning Region",2,2,937,480,457
050,09,160,"Connecticut","Northwest Hills Planning Region",2,3,980,508,472
050,09,160,"Connecticut","Northwest Hills Planning Region",2,4,988,497,491
050,09,160,"Connecticut","Northwest Hills Planning Region",2,5,1006,514,492
050,09,160,"Connecticut","Northwest Hills Planning Region",2,6,1023,521,502
050,09,160,"Connecticut","Northwest Hills Planning Region",2,7,1034,536,498
050,09,160,"Connecticut","Northwest Hills Planning Region",2,8,1073,551,522
050,09,160,"Connecticut","Northwest Hills Planning Region",2,9,1114,579,535
050,09,160,"Connecticut","Northwest Hills Planning Region",2,10,1152,616,536
050,09,160,"Connecticut","Northwest Hills Planning Region",2,11,1202,631,571
050,09,160,"Connecticut","Northwest Hills Planning Region",2,12,1266,656,610
050,09,160,"Connecticut","Northwest Hills Planning Region",2,13,1284,656,628
050,09,160,"Connecticut","Northwest Hills Planning Region",2,14,1315,674,641
050,09,160,"Connecticut","Northwest Hills Planning Region",2,15,1394,701,693
050,09,160,"Connecticut","Northwest Hills Planning Region",2,16,1439,722,717
050,09,160,"Connecticut","Northwest Hills Planning Region",2,17,1435,739,696
050,09,160,"Connecticut","Northwest Hills Planning Region",2,18,1241,672,569
050,09,160,"Connecticut","Northwest Hills Planning Region",2,19,1037,558,479
050,09,160,"Connecticut","Northwest Hills Planning Region",2,20,1118,581,537
050,09,160,"Connecticut","Northwest Hills Planning Region",2,21,1167,601,566
050,09,160,"Connecticut","Northwest Hills Planning Region",2,22,1171,603,568
050,09,160,"Connecticut","Northwest Hills Planning Region",2,23,1214,638,576
050,09,160,"Connecticut","Northwest Hills Planning Region",2,24,1198,608,590
050,09,160,"Connecticut","Northwest Hills Planning Region",2,25,1251,658,593
050,09,160,"Connecticut","Northwest Hills Planning Region",2,26,1282,674,608
050,09,160,"Connecticut","Northwest Hills Planning Region",2,27,1241,649,592
050,09,160,"Connecticut","Northwest Hills Planning Region",2,28,1248,649,599
050,09,160,"Connecticut","Northwest Hills Planning Region",2,29,1214,624,590
050,09,160,"Connecticut","Northwest Hills Planning Region",2,30,1203,631,572
050,09,160,"Connecticut","Northwest Hills Planning Region",2,31,1211,614,597
050,09,160,"Connecticut","Northwest Hills Planning Region",2,32,1231,633,598
050,09,160,"Connecticut","Northwest Hills Planning Region",2,33,1273,638,635
050,09,160,"Connecticut","Northwest Hills Planning Region",2,34,1246,626,620
050,09,160,"Connecticut","Northwest Hills Planning Region",2,35,1296,672,624
050,09,160,"Connecticut","Northwest Hills Planning Region",2,36,1268,642,626
050,09,160,"Connecticut","Northwest Hills Planning Region",2,37,1279,639,640
050,09,160,"Connecticut","Northwest Hills Planning Region",2,38,1313,682,631
050,09,160,"Connecticut","Northwest Hills Planning Region",2,39,1317,674,643
050,09,160,"Connecticut","Northwest Hills Planning Region",2,40,1274,650,624
050,09,160,"Connecticut","Northwest Hills Planning Region",2,41,1246,611,635
050,09,160,"Connecticut","Northwest Hills Planning Region",2,42,1233,620,613
050,09,160,"Connecticut","Northwest Hills Planning Region",2,43,1204,608,596
050,09,160,"Connecticut","Northwest Hills Planning Region",2,44,1189,605,584
050,09,160,"Connecticut","Northwest Hills Planning Region",2,45,1195,598,597
050,09,160,"Connecticut","Northwest Hills Planning Region",2,46,1210,600,610
050,09,160,"Connecticut","Northwest Hills Planning Region",2,47,1282,632,650
050,09,160,"Connecticut","Northwest Hills Planning Region",2,48,1393,674,719
050,09,160,"Connecticut","Northwest Hills Planning Region",2,49,1584,777,807
050,09,160,"Connecticut","Northwest Hills Planning Region",2,50,1689,831,858
050,09,160,"Connecticut","Northwest Hills Planning Region",2,51,1662,815,847
050,09,160,"Connecticut","Northwest Hills Planning Region",2,52,1645,812,833
050,09,160,"Connecticut","Northwest Hills Planning Region",2,53,1696,853,843
050,09,160,"Connecticut","Northwest Hills Planning Region",2,54,1791,899,892
050,09,160,"Connecticut","Northwest Hills Planning Region",2,55,1895,931,964
050,09,160,"Connecticut","Northwest Hills Planning Region",2,56,1969,973,996
050,09,160,"Connecticut","Northwest Hills Planning Region",2,57,1936,965,971
050,09,160,"Connecticut","Northwest Hills Planning Region",2,58,1934,957,977
050,09,160,"Connecticut","Northwest Hills Planning Region",2,59,1964,964,1000
050,09,160,"Connecticut","Northwest Hills Planning Region",2,60,1941,961,980
050,09,160,"Connecticut","Northwest Hills Planning Region",2,61,1927,963,964
050,09,160,"Connecticut","Northwest Hills Planning Region",2,62,1927,966,961
050,09,160,"Connecticut","Northwest Hills Planning Region",2,63,1912,955,957
050,09,160,"Connecticut","Northwest Hills Planning Region",2,64,1794,882,912
050,09,160,"Connecticut","Northwest Hills Planning Region",2,65,1733,846,887
050,09,160,"Connecticut","Northwest Hills Planning Region",2,66,1694,845,849
050,09,160,"Connecticut","Northwest Hills Planning Region",2,67,1593,790,803
050,09,160,"Connecticut","Northwest Hills Planning Region",2,68,1531,748,783
050,09,160,"Connecticut","Northwest Hills Planning Region",2,69,1438,699,739
050,09,160,"Connecticut","Northwest Hills Planning Region",2,70,1361,673,688
050,09,160,"Connecticut","Northwest Hills Planning Region",2,71,1338,664,674
050,09,160,"Connecticut","Northwest Hills Planning Region",2,72,1311,648,663
050,09,160,"Connecticut","Northwest Hills Planning Region",2,73,1443,703,740
050,09,160,"Connecticut","Northwest Hills Planning Region",2,74,1004,472,532
050,09,160,"Connecticut","Northwest Hills Planning Region",2,75,954,441,513
050,09,160,"Connecticut","Northwest Hills Planning Region",2,76,966,446,520
050,09,160,"Connecticut","Northwest Hills Planning Region",2,77,996,468,528
050,09,160,"Connecticut","Northwest Hills Planning Region",2,78,812,376,436
050,09,160,"Connecticut","Northwest Hills Planning Region",2,79,694,319,375
050,09,160,"Connecticut","Northwest Hills Planning Region",2,80,625,280,345
050,09,160,"Connecticut","Northwest Hills Planning Region",2,81,588,260,328
050,09,160,"Connecticut","Northwest Hills Planning Region",2,82,543,228,315
050,09,160,"Connecticut","Northwest Hills Planning Region",2,83,463,198,265
050,09,160,"Connecticut","Northwest Hills Planning Region",2,84,437,193,244
050,09,160,"Connecticut","Northwest Hills Planning Region",2,85,2730,984,1746
050,09,160,"Connecticut","Northwest Hills Planning Region",3,0,877,473,404
050,09,160,"Connecticut","Northwest Hills Planning Region",3,1,955,502,453
050,09,160,"Connecticut","Northwest Hills Planning Region",3,2,941,469,472
050,09,160,"Connecticut","Northwest Hills Planning Region",3,3,1011,520,491
050,09,160,"Connecticut","Northwest Hills Planning Region",3,4,971,493,478
050,09,160,"Connecticut","Northwest Hills Planning Region",3,5,1016,511,505
050,09,160,"Connecticut","Northwest Hills Planning Region",3,6,1030,538,492
050,09,160,"Connecticut","Northwest Hills Planning Region",3,7,1039,532,507
050,09,160,"Connecticut","Northwest Hills Planning Region",3,8,1073,550,523
050,09,160,"Connecticut","Northwest Hills Planning Region",3,9,1117,570,547
050,09,160,"Connecticut","Northwest Hills Planning Region",3,10,1138,585,553
050,09,160,"Connecticut","Northwest Hills Planning Region",3,11,1163,611,552
050,09,160,"Connecticut","Northwest Hills Planning Region",3,12,1249,658,591
050,09,160,"Connecticut","Northwest Hills Planning Region",3,13,1272,648,624
050,09,160,"Connecticut","Northwest Hills Planning Region",3,14,1291,663,628
050,09,160,"Connecticut","Northwest Hills Planning Region",3,15,1361,706,655
050,09,160,"Connecticut","Northwest Hills Planning Region",3,16,1418,702,716
050,09,160,"Connecticut","Northwest Hills Planning Region",3,17,1413,726,687
050,09,160,"Connecticut","Northwest Hills Planning Region",3,18,1208,650,558
050,09,160,"Connecticut","Northwest Hills Planning Region",3,19,1011,554,457
050,09,160,"Connecticut","Northwest Hills Planning Region",3,20,1133,591,542
050,09,160,"Connecticut","Northwest Hills Planning Region",3,21,1151,595,556
050,09,160,"Connecticut","Northwest Hills Planning Region",3,22,1225,627,598
050,09,160,"Connecticut","Northwest Hills Planning Region",3,23,1248,659,589
050,09,160,"Connecticut","Northwest Hills Planning Region",3,24,1165,617,548
050,09,160,"Connecticut","Northwest Hills Planning Region",3,25,1183,631,552
050,09,160,"Connecticut","Northwest Hills Planning Region",3,26,1250,654,596
050,09,160,"Connecticut","Northwest Hills Planning Region",3,27,1287,662,625
050,09,160,"Connecticut","Northwest Hills Planning Region",3,28,1278,660,618
050,09,160,"Connecticut","Northwest Hills Planning Region",3,29,1266,655,611
050,09,160,"Connecticut","Northwest Hills Planning Region",3,30,1250,656,594
050,09,160,"Connecticut","Northwest Hills Planning Region",3,31,1256,645,611
050,09,160,"Connecticut","Northwest Hills Planning Region",3,32,1237,614,623
050,09,160,"Connecticut","Northwest Hills Planning Region",3,33,1334,675,659
050,09,160,"Connecticut","Northwest Hills Planning Region",3,34,1287,659,628
050,09,160,"Connecticut","Northwest Hills Planning Region",3,35,1338,697,641
050,09,160,"Connecticut","Northwest Hills Planning Region",3,36,1329,682,647
050,09,160,"Connecticut","Northwest Hills Planning Region",3,37,1335,675,660
050,09,160,"Connecticut","Northwest Hills Planning Region",3,38,1373,715,658
050,09,160,"Connecticut","Northwest Hills Planning Region",3,39,1349,677,672
050,09,160,"Connecticut","Northwest Hills Planning Region",3,40,1318,697,621
050,09,160,"Connecticut","Northwest Hills Planning Region",3,41,1302,655,647
050,09,160,"Connecticut","Northwest Hills Planning Region",3,42,1298,655,643
050,09,160,"Connecticut","Northwest Hills Planning Region",3,43,1261,625,636
050,09,160,"Connecticut","Northwest Hills Planning Region",3,44,1245,628,617
050,09,160,"Connecticut","Northwest Hills Planning Region",3,45,1206,610,596
050,09,160,"Connecticut","Northwest Hills Planning Region",3,46,1207,600,607
050,09,160,"Connecticut","Northwest Hills Planning Region",3,47,1254,631,623
050,09,160,"Connecticut","Northwest Hills Planning Region",3,48,1280,632,648
050,09,160,"Connecticut","Northwest Hills Planning Region",3,49,1399,679,720
050,09,160,"Connecticut","Northwest Hills Planning Region",3,50,1622,785,837
050,09,160,"Connecticut","Northwest Hills Planning Region",3,51,1674,829,845
050,09,160,"Connecticut","Northwest Hills Planning Region",3,52,1664,823,841
050,09,160,"Connecticut","Northwest Hills Planning Region",3,53,1622,803,819
050,09,160,"Connecticut","Northwest Hills Planning Region",3,54,1716,855,861
050,09,160,"Connecticut","Northwest Hills Planning Region",3,55,1768,899,869
050,09,160,"Connecticut","Northwest Hills Planning Region",3,56,1876,922,954
050,09,160,"Connecticut","Northwest Hills Planning Region",3,57,1937,959,978
050,09,160,"Connecticut","Northwest Hills Planning Region",3,58,1915,956,959
050,09,160,"Connecticut","Northwest Hills Planning Region",3,59,1934,951,983
050,09,160,"Connecticut","Northwest Hills Planning Region",3,60,1963,967,996
050,09,160,"Connecticut","Northwest Hills Planning Region",3,61,1949,965,984
050,09,160,"Connecticut","Northwest Hills Planning Region",3,62,1892,935,957
050,09,160,"Connecticut","Northwest Hills Planning Region",3,63,1921,960,961
050,09,160,"Connecticut","Northwest Hills Planning Region",3,64,1878,936,942
050,09,160,"Connecticut","Northwest Hills Planning Region",3,65,1747,853,894
050,09,160,"Connecticut","Northwest Hills Planning Region",3,66,1701,818,883
050,09,160,"Connecticut","Northwest Hills Planning Region",3,67,1668,834,834
050,09,160,"Connecticut","Northwest Hills Planning Region",3,68,1560,772,788
050,09,160,"Connecticut","Northwest Hills Planning Region",3,69,1511,738,773
050,09,160,"Connecticut","Northwest Hills Planning Region",3,70,1397,680,717
050,09,160,"Connecticut","Northwest Hills Planning Region",3,71,1314,654,660
050,09,160,"Connecticut","Northwest Hills Planning Region",3,72,1310,644,666
050,09,160,"Connecticut","Northwest Hills Planning Region",3,73,1285,630,655
050,09,160,"Connecticut","Northwest Hills Planning Region",3,74,1398,684,714
050,09,160,"Connecticut","Northwest Hills Planning Region",3,75,965,448,517
050,09,160,"Connecticut","Northwest Hills Planning Region",3,76,940,431,509
050,09,160,"Connecticut","Northwest Hills Planning Region",3,77,927,434,493
050,09,160,"Connecticut","Northwest Hills Planning Region",3,78,967,453,514
050,09,160,"Connecticut","Northwest Hills Planning Region",3,79,783,360,423
050,09,160,"Connecticut","Northwest Hills Planning Region",3,80,674,309,365
050,09,160,"Connecticut","Northwest Hills Planning Region",3,81,595,268,327
050,09,160,"Connecticut","Northwest Hills Planning Region",3,82,563,245,318
050,09,160,"Connecticut","Northwest Hills Planning Region",3,83,501,211,290
050,09,160,"Connecticut","Northwest Hills Planning Region",3,84,447,194,253
050,09,160,"Connecticut","Northwest Hills Planning Region",3,85,2771,1012,1759
050,09,160,"Connecticut","Northwest Hills Planning Region",4,0,937,498,439
050,09,160,"Connecticut","Northwest Hills Planning Region",4,1,933,499,434
050,09,160,"Connecticut","Northwest Hills Planning Region",4,2,954,500,454
050,09,160,"Connecticut","Northwest Hills Planning Region",4,3,973,504,469
050,09,160,"Connecticut","Northwest Hills Planning Region",4,4,1042,527,515
050,09,160,"Connecticut","Northwest Hills Planning Region",4,5,1016,506,510
050,09,160,"Connecticut","Northwest Hills Planning Region",4,6,1041,514,527
050,09,160,"Connecticut","Northwest Hills Planning Region",4,7,1047,545,502
050,09,160,"Connecticut","Northwest Hills Planning Region",4,8,1058,541,517
050,09,160,"Connecticut","Northwest Hills Planning Region",4,9,1117,582,535
050,09,160,"Connecticut","Northwest Hills Planning Region",4,10,1135,592,543
050,09,160,"Connecticut","Northwest Hills Planning Region",4,11,1174,599,575
050,09,160,"Connecticut","Northwest Hills Planning Region",4,12,1198,637,561
050,09,160,"Connecticut","Northwest Hills Planning Region",4,13,1265,663,602
050,09,160,"Connecticut","Northwest Hills Planning Region",4,14,1315,675,640
050,09,160,"Connecticut","Northwest Hills Planning Region",4,15,1346,690,656
050,09,160,"Connecticut","Northwest Hills Planning Region",4,16,1384,720,664
050,09,160,"Connecticut","Northwest Hills Planning Region",4,17,1406,711,695
050,09,160,"Connecticut","Northwest Hills Planning Region",4,18,1210,651,559
050,09,160,"Connecticut","Northwest Hills Planning Region",4,19,952,516,436
050,09,160,"Connecticut","Northwest Hills Planning Region",4,20,1069,577,492
050,09,160,"Connecticut","Northwest Hills Planning Region",4,21,1161,595,566
050,09,160,"Connecticut","Northwest Hills Planning Region",4,22,1176,596,580
050,09,160,"Connecticut","Northwest Hills Planning Region",4,23,1270,657,613
050,09,160,"Connecticut","Northwest Hills Planning Region",4,24,1193,630,563
050,09,160,"Connecticut","Northwest Hills Planning Region",4,25,1175,622,553
050,09,160,"Connecticut","Northwest Hills Planning Region",4,26,1192,646,546
050,09,160,"Connecticut","Northwest Hills Planning Region",4,27,1222,638,584
050,09,160,"Connecticut","Northwest Hills Planning Region",4,28,1304,660,644
050,09,160,"Connecticut","Northwest Hills Planning Region",4,29,1212,629,583
050,09,160,"Connecticut","Northwest Hills Planning Region",4,30,1245,664,581
050,09,160,"Connecticut","Northwest Hills Planning Region",4,31,1266,638,628
050,09,160,"Connecticut","Northwest Hills Planning Region",4,32,1242,635,607
050,09,160,"Connecticut","Northwest Hills Planning Region",4,33,1317,637,680
050,09,160,"Connecticut","Northwest Hills Planning Region",4,34,1353,702,651
050,09,160,"Connecticut","Northwest Hills Planning Region",4,35,1359,704,655
050,09,160,"Connecticut","Northwest Hills Planning Region",4,36,1344,682,662
050,09,160,"Connecticut","Northwest Hills Planning Region",4,37,1409,701,708
050,09,160,"Connecticut","Northwest Hills Planning Region",4,38,1405,730,675
050,09,160,"Connecticut","Northwest Hills Planning Region",4,39,1426,718,708
050,09,160,"Connecticut","Northwest Hills Planning Region",4,40,1357,708,649
050,09,160,"Connecticut","Northwest Hills Planning Region",4,41,1329,703,626
050,09,160,"Connecticut","Northwest Hills Planning Region",4,42,1336,676,660
050,09,160,"Connecticut","Northwest Hills Planning Region",4,43,1310,668,642
050,09,160,"Connecticut","Northwest Hills Planning Region",4,44,1302,646,656
050,09,160,"Connecticut","Northwest Hills Planning Region",4,45,1235,632,603
050,09,160,"Connecticut","Northwest Hills Planning Region",4,46,1225,622,603
050,09,160,"Connecticut","Northwest Hills Planning Region",4,47,1244,623,621
050,09,160,"Connecticut","Northwest Hills Planning Region",4,48,1266,632,634
050,09,160,"Connecticut","Northwest Hills Planning Region",4,49,1286,633,653
050,09,160,"Connecticut","Northwest Hills Planning Region",4,50,1434,689,745
050,09,160,"Connecticut","Northwest Hills Planning Region",4,51,1602,780,822
050,09,160,"Connecticut","Northwest Hills Planning Region",4,52,1684,837,847
050,09,160,"Connecticut","Northwest Hills Planning Region",4,53,1649,824,825
050,09,160,"Connecticut","Northwest Hills Planning Region",4,54,1598,794,804
050,09,160,"Connecticut","Northwest Hills Planning Region",4,55,1698,846,852
050,09,160,"Connecticut","Northwest Hills Planning Region",4,56,1763,897,866
050,09,160,"Connecticut","Northwest Hills Planning Region",4,57,1882,912,970
050,09,160,"Connecticut","Northwest Hills Planning Region",4,58,1891,923,968
050,09,160,"Connecticut","Northwest Hills Planning Region",4,59,1894,931,963
050,09,160,"Connecticut","Northwest Hills Planning Region",4,60,1940,962,978
050,09,160,"Connecticut","Northwest Hills Planning Region",4,61,1944,968,976
050,09,160,"Connecticut","Northwest Hills Planning Region",4,62,1929,949,980
050,09,160,"Connecticut","Northwest Hills Planning Region",4,63,1893,931,962
050,09,160,"Connecticut","Northwest Hills Planning Region",4,64,1900,957,943
050,09,160,"Connecticut","Northwest Hills Planning Region",4,65,1847,912,935
050,09,160,"Connecticut","Northwest Hills Planning Region",4,66,1706,821,885
050,09,160,"Connecticut","Northwest Hills Planning Region",4,67,1690,810,880
050,09,160,"Connecticut","Northwest Hills Planning Region",4,68,1648,829,819
050,09,160,"Connecticut","Northwest Hills Planning Region",4,69,1535,758,777
050,09,160,"Connecticut","Northwest Hills Planning Region",4,70,1478,713,765
050,09,160,"Connecticut","Northwest Hills Planning Region",4,71,1375,666,709
050,09,160,"Connecticut","Northwest Hills Planning Region",4,72,1291,641,650
050,09,160,"Connecticut","Northwest Hills Planning Region",4,73,1276,621,655
050,09,160,"Connecticut","Northwest Hills Planning Region",4,74,1250,608,642
050,09,160,"Connecticut","Northwest Hills Planning Region",4,75,1375,672,703
050,09,160,"Connecticut","Northwest Hills Planning Region",4,76,949,436,513
050,09,160,"Connecticut","Northwest Hills Planning Region",4,77,891,412,479
050,09,160,"Connecticut","Northwest Hills Planning Region",4,78,890,417,473
050,09,160,"Connecticut","Northwest Hills Planning Region",4,79,919,431,488
050,09,160,"Connecticut","Northwest Hills Planning Region",4,80,755,341,414
050,09,160,"Connecticut","Northwest Hills Planning Region",4,81,636,289,347
050,09,160,"Connecticut","Northwest Hills Planning Region",4,82,559,248,311
050,09,160,"Connecticut","Northwest Hills Planning Region",4,83,514,225,289
050,09,160,"Connecticut","Northwest Hills Planning Region",4,84,469,200,269
050,09,160,"Connecticut","Northwest Hills Planning Region",4,85,2790,1028,1762
050,09,160,"Connecticut","Northwest Hills Planning Region",5,0,922,491,431
050,09,160,"Connecticut","Northwest Hills Planning Region",5,1,990,534,456
050,09,160,"Connecticut","Northwest Hills Planning Region",5,2,958,503,455
050,09,160,"Connecticut","Northwest Hills Planning Region",5,3,957,511,446
050,09,160,"Connecticut","Northwest Hills Planning Region",5,4,969,483,486
050,09,160,"Connecticut","Northwest Hills Planning Region",5,5,1061,541,520
050,09,160,"Connecticut","Northwest Hills Planning Region",5,6,1007,519,488
050,09,160,"Connecticut","Northwest Hills Planning Region",5,7,1058,532,526
050,09,160,"Connecticut","Northwest Hills Planning Region",5,8,1072,560,512
050,09,160,"Connecticut","Northwest Hills Planning Region",5,9,1074,563,511
050,09,160,"Connecticut","Northwest Hills Planning Region",5,10,1114,578,536
050,09,160,"Connecticut","Northwest Hills Planning Region",5,11,1149,593,556
050,09,160,"Connecticut","Northwest Hills Planning Region",5,12,1195,611,584
050,09,160,"Connecticut","Northwest Hills Planning Region",5,13,1204,638,566
050,09,160,"Connecticut","Northwest Hills Planning Region",5,14,1270,660,610
050,09,160,"Connecticut","Northwest Hills Planning Region",5,15,1345,702,643
050,09,160,"Connecticut","Northwest Hills Planning Region",5,16,1398,711,687
050,09,160,"Connecticut","Northwest Hills Planning Region",5,17,1395,734,661
050,09,160,"Connecticut","Northwest Hills Planning Region",5,18,1197,634,563
050,09,160,"Connecticut","Northwest Hills Planning Region",5,19,962,518,444
050,09,160,"Connecticut","Northwest Hills Planning Region",5,20,1029,549,480
050,09,160,"Connecticut","Northwest Hills Planning Region",5,21,1132,602,530
050,09,160,"Connecticut","Northwest Hills Planning Region",5,22,1207,610,597
050,09,160,"Connecticut","Northwest Hills Planning Region",5,23,1255,663,592
050,09,160,"Connecticut","Northwest Hills Planning Region",5,24,1220,615,605
050,09,160,"Connecticut","Northwest Hills Planning Region",5,25,1206,646,560
050,09,160,"Connecticut","Northwest Hills Planning Region",5,26,1168,598,570
050,09,160,"Connecticut","Northwest Hills Planning Region",5,27,1171,612,559
050,09,160,"Connecticut","Northwest Hills Planning Region",5,28,1243,648,595
050,09,160,"Connecticut","Northwest Hills Planning Region",5,29,1286,637,649
050,09,160,"Connecticut","Northwest Hills Planning Region",5,30,1232,644,588
050,09,160,"Connecticut","Northwest Hills Planning Region",5,31,1276,654,622
050,09,160,"Connecticut","Northwest Hills Planning Region",5,32,1243,624,619
050,09,160,"Connecticut","Northwest Hills Planning Region",5,33,1297,666,631
050,09,160,"Connecticut","Northwest Hills Planning Region",5,34,1309,645,664
050,09,160,"Connecticut","Northwest Hills Planning Region",5,35,1397,736,661
050,09,160,"Connecticut","Northwest Hills Planning Region",5,36,1374,685,689
050,09,160,"Connecticut","Northwest Hills Planning Region",5,37,1382,694,688
050,09,160,"Connecticut","Northwest Hills Planning Region",5,38,1482,768,714
050,09,160,"Connecticut","Northwest Hills Planning Region",5,39,1421,717,704
050,09,160,"Connecticut","Northwest Hills Planning Region",5,40,1421,711,710
050,09,160,"Connecticut","Northwest Hills Planning Region",5,41,1372,716,656
050,09,160,"Connecticut","Northwest Hills Planning Region",5,42,1326,700,626
050,09,160,"Connecticut","Northwest Hills Planning Region",5,43,1336,688,648
050,09,160,"Connecticut","Northwest Hills Planning Region",5,44,1330,689,641
050,09,160,"Connecticut","Northwest Hills Planning Region",5,45,1309,637,672
050,09,160,"Connecticut","Northwest Hills Planning Region",5,46,1262,649,613
050,09,160,"Connecticut","Northwest Hills Planning Region",5,47,1251,634,617
050,09,160,"Connecticut","Northwest Hills Planning Region",5,48,1237,618,619
050,09,160,"Connecticut","Northwest Hills Planning Region",5,49,1273,647,626
050,09,160,"Connecticut","Northwest Hills Planning Region",5,50,1292,634,658
050,09,160,"Connecticut","Northwest Hills Planning Region",5,51,1427,686,741
050,09,160,"Connecticut","Northwest Hills Planning Region",5,52,1620,799,821
050,09,160,"Connecticut","Northwest Hills Planning Region",5,53,1676,824,852
050,09,160,"Connecticut","Northwest Hills Planning Region",5,54,1647,829,818
050,09,160,"Connecticut","Northwest Hills Planning Region",5,55,1613,800,813
050,09,160,"Connecticut","Northwest Hills Planning Region",5,56,1713,849,864
050,09,160,"Connecticut","Northwest Hills Planning Region",5,57,1754,885,869
050,09,160,"Connecticut","Northwest Hills Planning Region",5,58,1869,887,982
050,09,160,"Connecticut","Northwest Hills Planning Region",5,59,1889,908,981
050,09,160,"Connecticut","Northwest Hills Planning Region",5,60,1886,937,949
050,09,160,"Connecticut","Northwest Hills Planning Region",5,61,1924,941,983
050,09,160,"Connecticut","Northwest Hills Planning Region",5,62,1902,957,945
050,09,160,"Connecticut","Northwest Hills Planning Region",5,63,1896,918,978
050,09,160,"Connecticut","Northwest Hills Planning Region",5,64,1874,923,951
050,09,160,"Connecticut","Northwest Hills Planning Region",5,65,1871,932,939
050,09,160,"Connecticut","Northwest Hills Planning Region",5,66,1815,900,915
050,09,160,"Connecticut","Northwest Hills Planning Region",5,67,1670,797,873
050,09,160,"Connecticut","Northwest Hills Planning Region",5,68,1677,801,876
050,09,160,"Connecticut","Northwest Hills Planning Region",5,69,1642,826,816
050,09,160,"Connecticut","Northwest Hills Planning Region",5,70,1506,736,770
050,09,160,"Connecticut","Northwest Hills Planning Region",5,71,1468,714,754
050,09,160,"Connecticut","Northwest Hills Planning Region",5,72,1345,648,697
050,09,160,"Connecticut","Northwest Hills Planning Region",5,73,1265,619,646
050,09,160,"Connecticut","Northwest Hills Planning Region",5,74,1230,594,636
050,09,160,"Connecticut","Northwest Hills Planning Region",5,75,1231,595,636
050,09,160,"Connecticut","Northwest Hills Planning Region",5,76,1322,646,676
050,09,160,"Connecticut","Northwest Hills Planning Region",5,77,921,422,499
050,09,160,"Connecticut","Northwest Hills Planning Region",5,78,855,391,464
050,09,160,"Connecticut","Northwest Hills Planning Region",5,79,851,399,452
050,09,160,"Connecticut","Northwest Hills Planning Region",5,80,889,412,477
050,09,160,"Connecticut","Northwest Hills Planning Region",5,81,729,327,402
050,09,160,"Connecticut","Northwest Hills Planning Region",5,82,603,268,335
050,09,160,"Connecticut","Northwest Hills Planning Region",5,83,515,231,284
050,09,160,"Connecticut","Northwest Hills Planning Region",5,84,486,216,270
050,09,160,"Connecticut","Northwest Hills Planning Region",5,85,2846,1055,1791
050,09,170,"Connecticut","South Central Connecticut Planning Region",1,0,5489,2821,2668
050,09,170,"Connecticut","South Central Connecticut Planning Region",1,1,5580,2860,2720
050,09,170,"Connecticut","South Central Connecticut Planning Region",1,2,5715,2895,2820
050,09,170,"Connecticut","South Central Connecticut Planning Region",1,3,5844,2943,2901
050,09,170,"Connecticut","South Central Connecticut Planning Region",1,4,5900,3001,2899
050,09,170,"Connecticut","South Central Connecticut Planning Region",1,5,5910,3019,2891
050,09,170,"Connecticut","South Central Connecticut Planning Region",1,6,6005,3113,2892
050,09,170,"Connecticut","South Central Connecticut Planning Region",1,7,6028,3097,2931
050,09,170,"Connecticut","South Central Connecticut Planning Region",1,8,5999,3070,2929
050,09,170,"Connecticut","South Central Connecticut Planning Region",1,9,6198,3163,3035
050,09,170,"Connecticut","South Central Connecticut Planning Region",1,10,6344,3269,3075
050,09,170,"Connecticut","South Central Connecticut Planning Region",1,11,6617,3454,3163
050,09,170,"Connecticut","South Central Connecticut Planning Region",1,12,6965,3564,3401
050,09,170,"Connecticut","South Central Connecticut Planning Region",1,13,6991,3554,3437
050,09,170,"Connecticut","South Central Connecticut Planning Region",1,14,6927,3573,3354
050,09,170,"Connecticut","South Central Connecticut Planning Region",1,15,6970,3551,3419
050,09,170,"Connecticut","South Central Connecticut Planning Region",1,16,7125,3606,3519
050,09,170,"Connecticut","South Central Connecticut Planning Region",1,17,7215,3673,3542
050,09,170,"Connecticut","South Central Connecticut Planning Region",1,18,9226,4405,4821
050,09,170,"Connecticut","South Central Connecticut Planning Region",1,19,10148,4859,5289
050,09,170,"Connecticut","South Central Connecticut Planning Region",1,20,9779,4864,4915
050,09,170,"Connecticut","South Central Connecticut Planning Region",1,21,8856,4317,4539
050,09,170,"Connecticut","South Central Connecticut Planning Region",1,22,7683,3884,3799
050,09,170,"Connecticut","South Central Connecticut Planning Region",1,23,7110,3608,3502
050,09,170,"Connecticut","South Central Connecticut Planning Region",1,24,7197,3609,3588
050,09,170,"Connecticut","South Central Connecticut Planning Region",1,25,7352,3697,3655
050,09,170,"Connecticut","South Central Connecticut Planning Region",1,26,7567,3787,3780
050,09,170,"Connecticut","South Central Connecticut Planning Region",1,27,7630,3809,3821
050,09,170,"Connecticut","South Central Connecticut Planning Region",1,28,7513,3726,3787
050,09,170,"Connecticut","South Central Connecticut Planning Region",1,29,7414,3699,3715
050,09,170,"Connecticut","South Central Connecticut Planning Region",1,30,7441,3729,3712
050,09,170,"Connecticut","South Central Connecticut Planning Region",1,31,7441,3697,3744
050,09,170,"Connecticut","South Central Connecticut Planning Region",1,32,7552,3672,3880
050,09,170,"Connecticut","South Central Connecticut Planning Region",1,33,7448,3616,3832
050,09,170,"Connecticut","South Central Connecticut Planning Region",1,34,7469,3653,3816
050,09,170,"Connecticut","South Central Connecticut Planning Region",1,35,7342,3580,3762
050,09,170,"Connecticut","South Central Connecticut Planning Region",1,36,7164,3588,3576
050,09,170,"Connecticut","South Central Connecticut Planning Region",1,37,7163,3514,3649
050,09,170,"Connecticut","South Central Connecticut Planning Region",1,38,6994,3397,3597
050,09,170,"Connecticut","South Central Connecticut Planning Region",1,39,6802,3309,3493
050,09,170,"Connecticut","South Central Connecticut Planning Region",1,40,6800,3308,3492
050,09,170,"Connecticut","South Central Connecticut Planning Region",1,41,6699,3241,3458
050,09,170,"Connecticut","South Central Connecticut Planning Region",1,42,6600,3144,3456
050,09,170,"Connecticut","South Central Connecticut Planning Region",1,43,6497,3086,3411
050,09,170,"Connecticut","South Central Connecticut Planning Region",1,44,6320,3024,3296
050,09,170,"Connecticut","South Central Connecticut Planning Region",1,45,6354,3058,3296
050,09,170,"Connecticut","South Central Connecticut Planning Region",1,46,6292,3016,3276
050,09,170,"Connecticut","South Central Connecticut Planning Region",1,47,6559,3144,3415
050,09,170,"Connecticut","South Central Connecticut Planning Region",1,48,7088,3444,3644
050,09,170,"Connecticut","South Central Connecticut Planning Region",1,49,7719,3727,3992
050,09,170,"Connecticut","South Central Connecticut Planning Region",1,50,7616,3682,3934
050,09,170,"Connecticut","South Central Connecticut Planning Region",1,51,7678,3711,3967
050,09,170,"Connecticut","South Central Connecticut Planning Region",1,52,7458,3659,3799
050,09,170,"Connecticut","South Central Connecticut Planning Region",1,53,7725,3758,3967
050,09,170,"Connecticut","South Central Connecticut Planning Region",1,54,7926,3808,4118
050,09,170,"Connecticut","South Central Connecticut Planning Region",1,55,8176,3954,4222
050,09,170,"Connecticut","South Central Connecticut Planning Region",1,56,8325,4068,4257
050,09,170,"Connecticut","South Central Connecticut Planning Region",1,57,8215,3978,4237
050,09,170,"Connecticut","South Central Connecticut Planning Region",1,58,8327,4060,4267
050,09,170,"Connecticut","South Central Connecticut Planning Region",1,59,8350,4113,4237
050,09,170,"Connecticut","South Central Connecticut Planning Region",1,60,8187,3962,4225
050,09,170,"Connecticut","South Central Connecticut Planning Region",1,61,8094,3928,4166
050,09,170,"Connecticut","South Central Connecticut Planning Region",1,62,7985,3893,4092
050,09,170,"Connecticut","South Central Connecticut Planning Region",1,63,7525,3608,3917
050,09,170,"Connecticut","South Central Connecticut Planning Region",1,64,7337,3470,3867
050,09,170,"Connecticut","South Central Connecticut Planning Region",1,65,6975,3340,3635
050,09,170,"Connecticut","South Central Connecticut Planning Region",1,66,6630,3168,3462
050,09,170,"Connecticut","South Central Connecticut Planning Region",1,67,6393,3027,3366
050,09,170,"Connecticut","South Central Connecticut Planning Region",1,68,6126,2860,3266
050,09,170,"Connecticut","South Central Connecticut Planning Region",1,69,5641,2598,3043
050,09,170,"Connecticut","South Central Connecticut Planning Region",1,70,5558,2538,3020
050,09,170,"Connecticut","South Central Connecticut Planning Region",1,71,5497,2500,2997
050,09,170,"Connecticut","South Central Connecticut Planning Region",1,72,5593,2521,3072
050,09,170,"Connecticut","South Central Connecticut Planning Region",1,73,5581,2559,3022
050,09,170,"Connecticut","South Central Connecticut Planning Region",1,74,4016,1781,2235
050,09,170,"Connecticut","South Central Connecticut Planning Region",1,75,3912,1758,2154
050,09,170,"Connecticut","South Central Connecticut Planning Region",1,76,3949,1762,2187
050,09,170,"Connecticut","South Central Connecticut Planning Region",1,77,3933,1730,2203
050,09,170,"Connecticut","South Central Connecticut Planning Region",1,78,3248,1392,1856
050,09,170,"Connecticut","South Central Connecticut Planning Region",1,79,2806,1210,1596
050,09,170,"Connecticut","South Central Connecticut Planning Region",1,80,2609,1093,1516
050,09,170,"Connecticut","South Central Connecticut Planning Region",1,81,2464,1042,1422
050,09,170,"Connecticut","South Central Connecticut Planning Region",1,82,2305,938,1367
050,09,170,"Connecticut","South Central Connecticut Planning Region",1,83,2021,793,1228
050,09,170,"Connecticut","South Central Connecticut Planning Region",1,84,1922,774,1148
050,09,170,"Connecticut","South Central Connecticut Planning Region",1,85,13311,4462,8849
050,09,170,"Connecticut","South Central Connecticut Planning Region",2,0,5459,2814,2645
050,09,170,"Connecticut","South Central Connecticut Planning Region",2,1,5551,2845,2706
050,09,170,"Connecticut","South Central Connecticut Planning Region",2,2,5692,2893,2799
050,09,170,"Connecticut","South Central Connecticut Planning Region",2,3,5784,2919,2865
050,09,170,"Connecticut","South Central Connecticut Planning Region",2,4,5880,2980,2900
050,09,170,"Connecticut","South Central Connecticut Planning Region",2,5,5908,3012,2896
050,09,170,"Connecticut","South Central Connecticut Planning Region",2,6,5987,3094,2893
050,09,170,"Connecticut","South Central Connecticut Planning Region",2,7,6017,3096,2921
050,09,170,"Connecticut","South Central Connecticut Planning Region",2,8,5989,3066,2923
050,09,170,"Connecticut","South Central Connecticut Planning Region",2,9,6153,3141,3012
050,09,170,"Connecticut","South Central Connecticut Planning Region",2,10,6314,3248,3066
050,09,170,"Connecticut","South Central Connecticut Planning Region",2,11,6534,3402,3132
050,09,170,"Connecticut","South Central Connecticut Planning Region",2,12,6912,3557,3355
050,09,170,"Connecticut","South Central Connecticut Planning Region",2,13,6984,3557,3427
050,09,170,"Connecticut","South Central Connecticut Planning Region",2,14,6935,3562,3373
050,09,170,"Connecticut","South Central Connecticut Planning Region",2,15,6961,3557,3404
050,09,170,"Connecticut","South Central Connecticut Planning Region",2,16,7100,3604,3496
050,09,170,"Connecticut","South Central Connecticut Planning Region",2,17,7186,3655,3531
050,09,170,"Connecticut","South Central Connecticut Planning Region",2,18,8324,4057,4267
050,09,170,"Connecticut","South Central Connecticut Planning Region",2,19,8763,4262,4501
050,09,170,"Connecticut","South Central Connecticut Planning Region",2,20,8688,4360,4328
050,09,170,"Connecticut","South Central Connecticut Planning Region",2,21,8082,3990,4092
050,09,170,"Connecticut","South Central Connecticut Planning Region",2,22,7363,3722,3641
050,09,170,"Connecticut","South Central Connecticut Planning Region",2,23,7027,3558,3469
050,09,170,"Connecticut","South Central Connecticut Planning Region",2,24,7135,3592,3543
050,09,170,"Connecticut","South Central Connecticut Planning Region",2,25,7307,3673,3634
050,09,170,"Connecticut","South Central Connecticut Planning Region",2,26,7511,3757,3754
050,09,170,"Connecticut","South Central Connecticut Planning Region",2,27,7590,3789,3801
050,09,170,"Connecticut","South Central Connecticut Planning Region",2,28,7525,3738,3787
050,09,170,"Connecticut","South Central Connecticut Planning Region",2,29,7418,3689,3729
050,09,170,"Connecticut","South Central Connecticut Planning Region",2,30,7453,3716,3737
050,09,170,"Connecticut","South Central Connecticut Planning Region",2,31,7389,3676,3713
050,09,170,"Connecticut","South Central Connecticut Planning Region",2,32,7478,3653,3825
050,09,170,"Connecticut","South Central Connecticut Planning Region",2,33,7449,3617,3832
050,09,170,"Connecticut","South Central Connecticut Planning Region",2,34,7446,3629,3817
050,09,170,"Connecticut","South Central Connecticut Planning Region",2,35,7398,3620,3778
050,09,170,"Connecticut","South Central Connecticut Planning Region",2,36,7148,3559,3589
050,09,170,"Connecticut","South Central Connecticut Planning Region",2,37,7160,3523,3637
050,09,170,"Connecticut","South Central Connecticut Planning Region",2,38,7053,3427,3626
050,09,170,"Connecticut","South Central Connecticut Planning Region",2,39,6809,3307,3502
050,09,170,"Connecticut","South Central Connecticut Planning Region",2,40,6836,3332,3504
050,09,170,"Connecticut","South Central Connecticut Planning Region",2,41,6689,3238,3451
050,09,170,"Connecticut","South Central Connecticut Planning Region",2,42,6574,3144,3430
050,09,170,"Connecticut","South Central Connecticut Planning Region",2,43,6554,3114,3440
050,09,170,"Connecticut","South Central Connecticut Planning Region",2,44,6300,3006,3294
050,09,170,"Connecticut","South Central Connecticut Planning Region",2,45,6373,3062,3311
050,09,170,"Connecticut","South Central Connecticut Planning Region",2,46,6270,3003,3267
050,09,170,"Connecticut","South Central Connecticut Planning Region",2,47,6476,3104,3372
050,09,170,"Connecticut","South Central Connecticut Planning Region",2,48,6946,3367,3579
050,09,170,"Connecticut","South Central Connecticut Planning Region",2,49,7576,3671,3905
050,09,170,"Connecticut","South Central Connecticut Planning Region",2,50,7623,3678,3945
050,09,170,"Connecticut","South Central Connecticut Planning Region",2,51,7610,3680,3930
050,09,170,"Connecticut","South Central Connecticut Planning Region",2,52,7470,3649,3821
050,09,170,"Connecticut","South Central Connecticut Planning Region",2,53,7630,3714,3916
050,09,170,"Connecticut","South Central Connecticut Planning Region",2,54,7833,3774,4059
050,09,170,"Connecticut","South Central Connecticut Planning Region",2,55,8097,3909,4188
050,09,170,"Connecticut","South Central Connecticut Planning Region",2,56,8297,4049,4248
050,09,170,"Connecticut","South Central Connecticut Planning Region",2,57,8208,3983,4225
050,09,170,"Connecticut","South Central Connecticut Planning Region",2,58,8260,4021,4239
050,09,170,"Connecticut","South Central Connecticut Planning Region",2,59,8337,4093,4244
050,09,170,"Connecticut","South Central Connecticut Planning Region",2,60,8188,3971,4217
050,09,170,"Connecticut","South Central Connecticut Planning Region",2,61,8069,3911,4158
050,09,170,"Connecticut","South Central Connecticut Planning Region",2,62,7925,3858,4067
050,09,170,"Connecticut","South Central Connecticut Planning Region",2,63,7645,3676,3969
050,09,170,"Connecticut","South Central Connecticut Planning Region",2,64,7298,3459,3839
050,09,170,"Connecticut","South Central Connecticut Planning Region",2,65,6996,3339,3657
050,09,170,"Connecticut","South Central Connecticut Planning Region",2,66,6681,3188,3493
050,09,170,"Connecticut","South Central Connecticut Planning Region",2,67,6399,3034,3365
050,09,170,"Connecticut","South Central Connecticut Planning Region",2,68,6097,2847,3250
050,09,170,"Connecticut","South Central Connecticut Planning Region",2,69,5746,2646,3100
050,09,170,"Connecticut","South Central Connecticut Planning Region",2,70,5522,2523,2999
050,09,170,"Connecticut","South Central Connecticut Planning Region",2,71,5464,2487,2977
050,09,170,"Connecticut","South Central Connecticut Planning Region",2,72,5430,2447,2983
050,09,170,"Connecticut","South Central Connecticut Planning Region",2,73,5791,2642,3149
050,09,170,"Connecticut","South Central Connecticut Planning Region",2,74,4094,1827,2267
050,09,170,"Connecticut","South Central Connecticut Planning Region",2,75,3901,1746,2155
050,09,170,"Connecticut","South Central Connecticut Planning Region",2,76,3850,1712,2138
050,09,170,"Connecticut","South Central Connecticut Planning Region",2,77,3976,1751,2225
050,09,170,"Connecticut","South Central Connecticut Planning Region",2,78,3296,1420,1876
050,09,170,"Connecticut","South Central Connecticut Planning Region",2,79,2849,1226,1623
050,09,170,"Connecticut","South Central Connecticut Planning Region",2,80,2602,1093,1509
050,09,170,"Connecticut","South Central Connecticut Planning Region",2,81,2417,1016,1401
050,09,170,"Connecticut","South Central Connecticut Planning Region",2,82,2290,936,1354
050,09,170,"Connecticut","South Central Connecticut Planning Region",2,83,2009,785,1224
050,09,170,"Connecticut","South Central Connecticut Planning Region",2,84,1867,740,1127
050,09,170,"Connecticut","South Central Connecticut Planning Region",2,85,12853,4336,8517
050,09,170,"Connecticut","South Central Connecticut Planning Region",3,0,5549,2836,2713
050,09,170,"Connecticut","South Central Connecticut Planning Region",3,1,5471,2812,2659
050,09,170,"Connecticut","South Central Connecticut Planning Region",3,2,5653,2892,2761
050,09,170,"Connecticut","South Central Connecticut Planning Region",3,3,5709,2887,2822
050,09,170,"Connecticut","South Central Connecticut Planning Region",3,4,5810,2931,2879
050,09,170,"Connecticut","South Central Connecticut Planning Region",3,5,5922,3019,2903
050,09,170,"Connecticut","South Central Connecticut Planning Region",3,6,5891,2992,2899
050,09,170,"Connecticut","South Central Connecticut Planning Region",3,7,6024,3094,2930
050,09,170,"Connecticut","South Central Connecticut Planning Region",3,8,6055,3115,2940
050,09,170,"Connecticut","South Central Connecticut Planning Region",3,9,6007,3071,2936
050,09,170,"Connecticut","South Central Connecticut Planning Region",3,10,6203,3160,3043
050,09,170,"Connecticut","South Central Connecticut Planning Region",3,11,6274,3239,3035
050,09,170,"Connecticut","South Central Connecticut Planning Region",3,12,6559,3382,3177
050,09,170,"Connecticut","South Central Connecticut Planning Region",3,13,6916,3555,3361
050,09,170,"Connecticut","South Central Connecticut Planning Region",3,14,7010,3567,3443
050,09,170,"Connecticut","South Central Connecticut Planning Region",3,15,6934,3550,3384
050,09,170,"Connecticut","South Central Connecticut Planning Region",3,16,6996,3586,3410
050,09,170,"Connecticut","South Central Connecticut Planning Region",3,17,7125,3607,3518
050,09,170,"Connecticut","South Central Connecticut Planning Region",3,18,9028,4303,4725
050,09,170,"Connecticut","South Central Connecticut Planning Region",3,19,9757,4665,5092
050,09,170,"Connecticut","South Central Connecticut Planning Region",3,20,9378,4648,4730
050,09,170,"Connecticut","South Central Connecticut Planning Region",3,21,8711,4298,4413
050,09,170,"Connecticut","South Central Connecticut Planning Region",3,22,7748,3917,3831
050,09,170,"Connecticut","South Central Connecticut Planning Region",3,23,7206,3585,3621
050,09,170,"Connecticut","South Central Connecticut Planning Region",3,24,7290,3677,3613
050,09,170,"Connecticut","South Central Connecticut Planning Region",3,25,7356,3695,3661
050,09,170,"Connecticut","South Central Connecticut Planning Region",3,26,7599,3783,3816
050,09,170,"Connecticut","South Central Connecticut Planning Region",3,27,7722,3849,3873
050,09,170,"Connecticut","South Central Connecticut Planning Region",3,28,7684,3859,3825
050,09,170,"Connecticut","South Central Connecticut Planning Region",3,29,7585,3779,3806
050,09,170,"Connecticut","South Central Connecticut Planning Region",3,30,7505,3731,3774
050,09,170,"Connecticut","South Central Connecticut Planning Region",3,31,7479,3734,3745
050,09,170,"Connecticut","South Central Connecticut Planning Region",3,32,7400,3684,3716
050,09,170,"Connecticut","South Central Connecticut Planning Region",3,33,7393,3594,3799
050,09,170,"Connecticut","South Central Connecticut Planning Region",3,34,7438,3604,3834
050,09,170,"Connecticut","South Central Connecticut Planning Region",3,35,7492,3638,3854
050,09,170,"Connecticut","South Central Connecticut Planning Region",3,36,7449,3639,3810
050,09,170,"Connecticut","South Central Connecticut Planning Region",3,37,7146,3568,3578
050,09,170,"Connecticut","South Central Connecticut Planning Region",3,38,7181,3531,3650
050,09,170,"Connecticut","South Central Connecticut Planning Region",3,39,7092,3414,3678
050,09,170,"Connecticut","South Central Connecticut Planning Region",3,40,6809,3325,3484
050,09,170,"Connecticut","South Central Connecticut Planning Region",3,41,6804,3304,3500
050,09,170,"Connecticut","South Central Connecticut Planning Region",3,42,6692,3217,3475
050,09,170,"Connecticut","South Central Connecticut Planning Region",3,43,6572,3147,3425
050,09,170,"Connecticut","South Central Connecticut Planning Region",3,44,6535,3105,3430
050,09,170,"Connecticut","South Central Connecticut Planning Region",3,45,6319,3007,3312
050,09,170,"Connecticut","South Central Connecticut Planning Region",3,46,6360,3040,3320
050,09,170,"Connecticut","South Central Connecticut Planning Region",3,47,6240,2980,3260
050,09,170,"Connecticut","South Central Connecticut Planning Region",3,48,6402,3067,3335
050,09,170,"Connecticut","South Central Connecticut Planning Region",3,49,6920,3369,3551
050,09,170,"Connecticut","South Central Connecticut Planning Region",3,50,7526,3635,3891
050,09,170,"Connecticut","South Central Connecticut Planning Region",3,51,7621,3661,3960
050,09,170,"Connecticut","South Central Connecticut Planning Region",3,52,7557,3676,3881
050,09,170,"Connecticut","South Central Connecticut Planning Region",3,53,7400,3572,3828
050,09,170,"Connecticut","South Central Connecticut Planning Region",3,54,7571,3671,3900
050,09,170,"Connecticut","South Central Connecticut Planning Region",3,55,7768,3722,4046
050,09,170,"Connecticut","South Central Connecticut Planning Region",3,56,8060,3892,4168
050,09,170,"Connecticut","South Central Connecticut Planning Region",3,57,8171,3995,4176
050,09,170,"Connecticut","South Central Connecticut Planning Region",3,58,8126,3936,4190
050,09,170,"Connecticut","South Central Connecticut Planning Region",3,59,8144,3944,4200
050,09,170,"Connecticut","South Central Connecticut Planning Region",3,60,8163,3980,4183
050,09,170,"Connecticut","South Central Connecticut Planning Region",3,61,8104,3923,4181
050,09,170,"Connecticut","South Central Connecticut Planning Region",3,62,7902,3809,4093
050,09,170,"Connecticut","South Central Connecticut Planning Region",3,63,7754,3748,4006
050,09,170,"Connecticut","South Central Connecticut Planning Region",3,64,7502,3594,3908
050,09,170,"Connecticut","South Central Connecticut Planning Region",3,65,7152,3390,3762
050,09,170,"Connecticut","South Central Connecticut Planning Region",3,66,6831,3254,3577
050,09,170,"Connecticut","South Central Connecticut Planning Region",3,67,6547,3131,3416
050,09,170,"Connecticut","South Central Connecticut Planning Region",3,68,6288,2958,3330
050,09,170,"Connecticut","South Central Connecticut Planning Region",3,69,5945,2756,3189
050,09,170,"Connecticut","South Central Connecticut Planning Region",3,70,5601,2553,3048
050,09,170,"Connecticut","South Central Connecticut Planning Region",3,71,5384,2436,2948
050,09,170,"Connecticut","South Central Connecticut Planning Region",3,72,5332,2417,2915
050,09,170,"Connecticut","South Central Connecticut Planning Region",3,73,5298,2389,2909
050,09,170,"Connecticut","South Central Connecticut Planning Region",3,74,5672,2568,3104
050,09,170,"Connecticut","South Central Connecticut Planning Region",3,75,3970,1762,2208
050,09,170,"Connecticut","South Central Connecticut Planning Region",3,76,3740,1656,2084
050,09,170,"Connecticut","South Central Connecticut Planning Region",3,77,3701,1623,2078
050,09,170,"Connecticut","South Central Connecticut Planning Region",3,78,3846,1682,2164
050,09,170,"Connecticut","South Central Connecticut Planning Region",3,79,3165,1358,1807
050,09,170,"Connecticut","South Central Connecticut Planning Region",3,80,2734,1147,1587
050,09,170,"Connecticut","South Central Connecticut Planning Region",3,81,2481,1030,1451
050,09,170,"Connecticut","South Central Connecticut Planning Region",3,82,2295,953,1342
050,09,170,"Connecticut","South Central Connecticut Planning Region",3,83,2155,863,1292
050,09,170,"Connecticut","South Central Connecticut Planning Region",3,84,1880,721,1159
050,09,170,"Connecticut","South Central Connecticut Planning Region",3,85,12664,4309,8355
050,09,170,"Connecticut","South Central Connecticut Planning Region",4,0,5736,2968,2768
050,09,170,"Connecticut","South Central Connecticut Planning Region",4,1,5575,2848,2727
050,09,170,"Connecticut","South Central Connecticut Planning Region",4,2,5554,2844,2710
050,09,170,"Connecticut","South Central Connecticut Planning Region",4,3,5673,2863,2810
050,09,170,"Connecticut","South Central Connecticut Planning Region",4,4,5750,2921,2829
050,09,170,"Connecticut","South Central Connecticut Planning Region",4,5,5791,2914,2877
050,09,170,"Connecticut","South Central Connecticut Planning Region",4,6,5969,3032,2937
050,09,170,"Connecticut","South Central Connecticut Planning Region",4,7,5949,3027,2922
050,09,170,"Connecticut","South Central Connecticut Planning Region",4,8,6090,3121,2969
050,09,170,"Connecticut","South Central Connecticut Planning Region",4,9,6148,3189,2959
050,09,170,"Connecticut","South Central Connecticut Planning Region",4,10,6012,3086,2926
050,09,170,"Connecticut","South Central Connecticut Planning Region",4,11,6249,3167,3082
050,09,170,"Connecticut","South Central Connecticut Planning Region",4,12,6328,3264,3064
050,09,170,"Connecticut","South Central Connecticut Planning Region",4,13,6613,3413,3200
050,09,170,"Connecticut","South Central Connecticut Planning Region",4,14,6950,3574,3376
050,09,170,"Connecticut","South Central Connecticut Planning Region",4,15,7036,3583,3453
050,09,170,"Connecticut","South Central Connecticut Planning Region",4,16,6950,3548,3402
050,09,170,"Connecticut","South Central Connecticut Planning Region",4,17,7035,3582,3453
050,09,170,"Connecticut","South Central Connecticut Planning Region",4,18,8979,4264,4715
050,09,170,"Connecticut","South Central Connecticut Planning Region",4,19,9807,4685,5122
050,09,170,"Connecticut","South Central Connecticut Planning Region",4,20,9353,4645,4708
050,09,170,"Connecticut","South Central Connecticut Planning Region",4,21,8549,4195,4354
050,09,170,"Connecticut","South Central Connecticut Planning Region",4,22,7797,3992,3805
050,09,170,"Connecticut","South Central Connecticut Planning Region",4,23,7252,3639,3613
050,09,170,"Connecticut","South Central Connecticut Planning Region",4,24,7209,3637,3572
050,09,170,"Connecticut","South Central Connecticut Planning Region",4,25,7264,3642,3622
050,09,170,"Connecticut","South Central Connecticut Planning Region",4,26,7501,3726,3775
050,09,170,"Connecticut","South Central Connecticut Planning Region",4,27,7574,3784,3790
050,09,170,"Connecticut","South Central Connecticut Planning Region",4,28,7751,3858,3893
050,09,170,"Connecticut","South Central Connecticut Planning Region",4,29,7617,3776,3841
050,09,170,"Connecticut","South Central Connecticut Planning Region",4,30,7600,3790,3810
050,09,170,"Connecticut","South Central Connecticut Planning Region",4,31,7487,3732,3755
050,09,170,"Connecticut","South Central Connecticut Planning Region",4,32,7395,3657,3738
050,09,170,"Connecticut","South Central Connecticut Planning Region",4,33,7367,3654,3713
050,09,170,"Connecticut","South Central Connecticut Planning Region",4,34,7368,3581,3787
050,09,170,"Connecticut","South Central Connecticut Planning Region",4,35,7380,3606,3774
050,09,170,"Connecticut","South Central Connecticut Planning Region",4,36,7450,3624,3826
050,09,170,"Connecticut","South Central Connecticut Planning Region",4,37,7400,3578,3822
050,09,170,"Connecticut","South Central Connecticut Planning Region",4,38,7133,3582,3551
050,09,170,"Connecticut","South Central Connecticut Planning Region",4,39,7196,3507,3689
050,09,170,"Connecticut","South Central Connecticut Planning Region",4,40,7074,3405,3669
050,09,170,"Connecticut","South Central Connecticut Planning Region",4,41,6831,3339,3492
050,09,170,"Connecticut","South Central Connecticut Planning Region",4,42,6795,3261,3534
050,09,170,"Connecticut","South Central Connecticut Planning Region",4,43,6746,3294,3452
050,09,170,"Connecticut","South Central Connecticut Planning Region",4,44,6548,3132,3416
050,09,170,"Connecticut","South Central Connecticut Planning Region",4,45,6537,3084,3453
050,09,170,"Connecticut","South Central Connecticut Planning Region",4,46,6269,2971,3298
050,09,170,"Connecticut","South Central Connecticut Planning Region",4,47,6310,3002,3308
050,09,170,"Connecticut","South Central Connecticut Planning Region",4,48,6234,2955,3279
050,09,170,"Connecticut","South Central Connecticut Planning Region",4,49,6391,3087,3304
050,09,170,"Connecticut","South Central Connecticut Planning Region",4,50,6846,3323,3523
050,09,170,"Connecticut","South Central Connecticut Planning Region",4,51,7468,3617,3851
050,09,170,"Connecticut","South Central Connecticut Planning Region",4,52,7557,3608,3949
050,09,170,"Connecticut","South Central Connecticut Planning Region",4,53,7481,3636,3845
050,09,170,"Connecticut","South Central Connecticut Planning Region",4,54,7307,3516,3791
050,09,170,"Connecticut","South Central Connecticut Planning Region",4,55,7530,3647,3883
050,09,170,"Connecticut","South Central Connecticut Planning Region",4,56,7685,3695,3990
050,09,170,"Connecticut","South Central Connecticut Planning Region",4,57,7960,3817,4143
050,09,170,"Connecticut","South Central Connecticut Planning Region",4,58,8099,3960,4139
050,09,170,"Connecticut","South Central Connecticut Planning Region",4,59,8040,3886,4154
050,09,170,"Connecticut","South Central Connecticut Planning Region",4,60,8038,3865,4173
050,09,170,"Connecticut","South Central Connecticut Planning Region",4,61,8057,3921,4136
050,09,170,"Connecticut","South Central Connecticut Planning Region",4,62,7885,3786,4099
050,09,170,"Connecticut","South Central Connecticut Planning Region",4,63,7758,3727,4031
050,09,170,"Connecticut","South Central Connecticut Planning Region",4,64,7629,3668,3961
050,09,170,"Connecticut","South Central Connecticut Planning Region",4,65,7372,3512,3860
050,09,170,"Connecticut","South Central Connecticut Planning Region",4,66,6980,3262,3718
050,09,170,"Connecticut","South Central Connecticut Planning Region",4,67,6687,3174,3513
050,09,170,"Connecticut","South Central Connecticut Planning Region",4,68,6398,3058,3340
050,09,170,"Connecticut","South Central Connecticut Planning Region",4,69,6127,2859,3268
050,09,170,"Connecticut","South Central Connecticut Planning Region",4,70,5809,2678,3131
050,09,170,"Connecticut","South Central Connecticut Planning Region",4,71,5459,2473,2986
050,09,170,"Connecticut","South Central Connecticut Planning Region",4,72,5272,2366,2906
050,09,170,"Connecticut","South Central Connecticut Planning Region",4,73,5210,2360,2850
050,09,170,"Connecticut","South Central Connecticut Planning Region",4,74,5160,2300,2860
050,09,170,"Connecticut","South Central Connecticut Planning Region",4,75,5473,2440,3033
050,09,170,"Connecticut","South Central Connecticut Planning Region",4,76,3837,1684,2153
050,09,170,"Connecticut","South Central Connecticut Planning Region",4,77,3616,1589,2027
050,09,170,"Connecticut","South Central Connecticut Planning Region",4,78,3557,1550,2007
050,09,170,"Connecticut","South Central Connecticut Planning Region",4,79,3710,1617,2093
050,09,170,"Connecticut","South Central Connecticut Planning Region",4,80,3035,1273,1762
050,09,170,"Connecticut","South Central Connecticut Planning Region",4,81,2602,1077,1525
050,09,170,"Connecticut","South Central Connecticut Planning Region",4,82,2363,984,1379
050,09,170,"Connecticut","South Central Connecticut Planning Region",4,83,2158,881,1277
050,09,170,"Connecticut","South Central Connecticut Planning Region",4,84,2034,799,1235
050,09,170,"Connecticut","South Central Connecticut Planning Region",4,85,12631,4307,8324
050,09,170,"Connecticut","South Central Connecticut Planning Region",5,0,5661,2932,2729
050,09,170,"Connecticut","South Central Connecticut Planning Region",5,1,5762,2942,2820
050,09,170,"Connecticut","South Central Connecticut Planning Region",5,2,5534,2838,2696
050,09,170,"Connecticut","South Central Connecticut Planning Region",5,3,5578,2852,2726
050,09,170,"Connecticut","South Central Connecticut Planning Region",5,4,5701,2883,2818
050,09,170,"Connecticut","South Central Connecticut Planning Region",5,5,5766,2944,2822
050,09,170,"Connecticut","South Central Connecticut Planning Region",5,6,5824,2917,2907
050,09,170,"Connecticut","South Central Connecticut Planning Region",5,7,6007,3036,2971
050,09,170,"Connecticut","South Central Connecticut Planning Region",5,8,5995,3059,2936
050,09,170,"Connecticut","South Central Connecticut Planning Region",5,9,6075,3124,2951
050,09,170,"Connecticut","South Central Connecticut Planning Region",5,10,6155,3195,2960
050,09,170,"Connecticut","South Central Connecticut Planning Region",5,11,6014,3084,2930
050,09,170,"Connecticut","South Central Connecticut Planning Region",5,12,6240,3175,3065
050,09,170,"Connecticut","South Central Connecticut Planning Region",5,13,6303,3257,3046
050,09,170,"Connecticut","South Central Connecticut Planning Region",5,14,6572,3401,3171
050,09,170,"Connecticut","South Central Connecticut Planning Region",5,15,6941,3578,3363
050,09,170,"Connecticut","South Central Connecticut Planning Region",5,16,7066,3597,3469
050,09,170,"Connecticut","South Central Connecticut Planning Region",5,17,7028,3583,3445
050,09,170,"Connecticut","South Central Connecticut Planning Region",5,18,8884,4276,4608
050,09,170,"Connecticut","South Central Connecticut Planning Region",5,19,9786,4650,5136
050,09,170,"Connecticut","South Central Connecticut Planning Region",5,20,9429,4674,4755
050,09,170,"Connecticut","South Central Connecticut Planning Region",5,21,8499,4207,4292
050,09,170,"Connecticut","South Central Connecticut Planning Region",5,22,7585,3886,3699
050,09,170,"Connecticut","South Central Connecticut Planning Region",5,23,7287,3670,3617
050,09,170,"Connecticut","South Central Connecticut Planning Region",5,24,7312,3673,3639
050,09,170,"Connecticut","South Central Connecticut Planning Region",5,25,7302,3623,3679
050,09,170,"Connecticut","South Central Connecticut Planning Region",5,26,7358,3706,3652
050,09,170,"Connecticut","South Central Connecticut Planning Region",5,27,7521,3728,3793
050,09,170,"Connecticut","South Central Connecticut Planning Region",5,28,7566,3771,3795
050,09,170,"Connecticut","South Central Connecticut Planning Region",5,29,7629,3773,3856
050,09,170,"Connecticut","South Central Connecticut Planning Region",5,30,7628,3788,3840
050,09,170,"Connecticut","South Central Connecticut Planning Region",5,31,7622,3806,3816
050,09,170,"Connecticut","South Central Connecticut Planning Region",5,32,7418,3687,3731
050,09,170,"Connecticut","South Central Connecticut Planning Region",5,33,7360,3658,3702
050,09,170,"Connecticut","South Central Connecticut Planning Region",5,34,7373,3646,3727
050,09,170,"Connecticut","South Central Connecticut Planning Region",5,35,7380,3588,3792
050,09,170,"Connecticut","South Central Connecticut Planning Region",5,36,7375,3566,3809
050,09,170,"Connecticut","South Central Connecticut Planning Region",5,37,7451,3616,3835
050,09,170,"Connecticut","South Central Connecticut Planning Region",5,38,7399,3573,3826
050,09,170,"Connecticut","South Central Connecticut Planning Region",5,39,7069,3530,3539
050,09,170,"Connecticut","South Central Connecticut Planning Region",5,40,7120,3462,3658
050,09,170,"Connecticut","South Central Connecticut Planning Region",5,41,7061,3406,3655
050,09,170,"Connecticut","South Central Connecticut Planning Region",5,42,6785,3322,3463
050,09,170,"Connecticut","South Central Connecticut Planning Region",5,43,6807,3271,3536
050,09,170,"Connecticut","South Central Connecticut Planning Region",5,44,6667,3247,3420
050,09,170,"Connecticut","South Central Connecticut Planning Region",5,45,6544,3104,3440
050,09,170,"Connecticut","South Central Connecticut Planning Region",5,46,6498,3058,3440
050,09,170,"Connecticut","South Central Connecticut Planning Region",5,47,6204,2945,3259
050,09,170,"Connecticut","South Central Connecticut Planning Region",5,48,6265,2972,3293
050,09,170,"Connecticut","South Central Connecticut Planning Region",5,49,6191,2958,3233
050,09,170,"Connecticut","South Central Connecticut Planning Region",5,50,6321,3038,3283
050,09,170,"Connecticut","South Central Connecticut Planning Region",5,51,6780,3306,3474
050,09,170,"Connecticut","South Central Connecticut Planning Region",5,52,7396,3574,3822
050,09,170,"Connecticut","South Central Connecticut Planning Region",5,53,7512,3551,3961
050,09,170,"Connecticut","South Central Connecticut Planning Region",5,54,7391,3578,3813
050,09,170,"Connecticut","South Central Connecticut Planning Region",5,55,7238,3488,3750
050,09,170,"Connecticut","South Central Connecticut Planning Region",5,56,7491,3648,3843
050,09,170,"Connecticut","South Central Connecticut Planning Region",5,57,7572,3623,3949
050,09,170,"Connecticut","South Central Connecticut Planning Region",5,58,7880,3770,4110
050,09,170,"Connecticut","South Central Connecticut Planning Region",5,59,7993,3910,4083
050,09,170,"Connecticut","South Central Connecticut Planning Region",5,60,7918,3799,4119
050,09,170,"Connecticut","South Central Connecticut Planning Region",5,61,7938,3838,4100
050,09,170,"Connecticut","South Central Connecticut Planning Region",5,62,7881,3799,4082
050,09,170,"Connecticut","South Central Connecticut Planning Region",5,63,7727,3678,4049
050,09,170,"Connecticut","South Central Connecticut Planning Region",5,64,7655,3667,3988
050,09,170,"Connecticut","South Central Connecticut Planning Region",5,65,7486,3590,3896
050,09,170,"Connecticut","South Central Connecticut Planning Region",5,66,7269,3439,3830
050,09,170,"Connecticut","South Central Connecticut Planning Region",5,67,6843,3171,3672
050,09,170,"Connecticut","South Central Connecticut Planning Region",5,68,6584,3117,3467
050,09,170,"Connecticut","South Central Connecticut Planning Region",5,69,6260,2972,3288
050,09,170,"Connecticut","South Central Connecticut Planning Region",5,70,6034,2795,3239
050,09,170,"Connecticut","South Central Connecticut Planning Region",5,71,5694,2625,3069
050,09,170,"Connecticut","South Central Connecticut Planning Region",5,72,5366,2419,2947
050,09,170,"Connecticut","South Central Connecticut Planning Region",5,73,5183,2314,2869
050,09,170,"Connecticut","South Central Connecticut Planning Region",5,74,5121,2308,2813
050,09,170,"Connecticut","South Central Connecticut Planning Region",5,75,5002,2203,2799
050,09,170,"Connecticut","South Central Connecticut Planning Region",5,76,5312,2352,2960
050,09,170,"Connecticut","South Central Connecticut Planning Region",5,77,3755,1639,2116
050,09,170,"Connecticut","South Central Connecticut Planning Region",5,78,3483,1520,1963
050,09,170,"Connecticut","South Central Connecticut Planning Region",5,79,3439,1497,1942
050,09,170,"Connecticut","South Central Connecticut Planning Region",5,80,3580,1535,2045
050,09,170,"Connecticut","South Central Connecticut Planning Region",5,81,2922,1210,1712
050,09,170,"Connecticut","South Central Connecticut Planning Region",5,82,2482,1011,1471
050,09,170,"Connecticut","South Central Connecticut Planning Region",5,83,2240,911,1329
050,09,170,"Connecticut","South Central Connecticut Planning Region",5,84,2028,822,1206
050,09,170,"Connecticut","South Central Connecticut Planning Region",5,85,12785,4404,8381
050,09,180,"Connecticut","Southeastern Connecticut Planning Region",1,0,2601,1329,1272
050,09,180,"Connecticut","Southeastern Connecticut Planning Region",1,1,2625,1333,1292
050,09,180,"Connecticut","Southeastern Connecticut Planning Region",1,2,2821,1474,1347
050,09,180,"Connecticut","Southeastern Connecticut Planning Region",1,3,2872,1471,1401
050,09,180,"Connecticut","Southeastern Connecticut Planning Region",1,4,2888,1451,1437
050,09,180,"Connecticut","Southeastern Connecticut Planning Region",1,5,2905,1499,1406
050,09,180,"Connecticut","Southeastern Connecticut Planning Region",1,6,2863,1500,1363
050,09,180,"Connecticut","Southeastern Connecticut Planning Region",1,7,2980,1542,1438
050,09,180,"Connecticut","Southeastern Connecticut Planning Region",1,8,3139,1640,1499
050,09,180,"Connecticut","Southeastern Connecticut Planning Region",1,9,3041,1561,1480
050,09,180,"Connecticut","Southeastern Connecticut Planning Region",1,10,3124,1622,1502
050,09,180,"Connecticut","Southeastern Connecticut Planning Region",1,11,3258,1679,1579
050,09,180,"Connecticut","Southeastern Connecticut Planning Region",1,12,3426,1757,1669
050,09,180,"Connecticut","Southeastern Connecticut Planning Region",1,13,3424,1724,1700
050,09,180,"Connecticut","Southeastern Connecticut Planning Region",1,14,3364,1694,1670
050,09,180,"Connecticut","Southeastern Connecticut Planning Region",1,15,3488,1740,1748
050,09,180,"Connecticut","Southeastern Connecticut Planning Region",1,16,3526,1841,1685
050,09,180,"Connecticut","Southeastern Connecticut Planning Region",1,17,3514,1808,1706
050,09,180,"Connecticut","Southeastern Connecticut Planning Region",1,18,3894,1978,1916
050,09,180,"Connecticut","Southeastern Connecticut Planning Region",1,19,4254,2286,1968
050,09,180,"Connecticut","Southeastern Connecticut Planning Region",1,20,4265,2317,1948
050,09,180,"Connecticut","Southeastern Connecticut Planning Region",1,21,4243,2282,1961
050,09,180,"Connecticut","Southeastern Connecticut Planning Region",1,22,3967,2188,1779
050,09,180,"Connecticut","Southeastern Connecticut Planning Region",1,23,3687,2034,1653
050,09,180,"Connecticut","Southeastern Connecticut Planning Region",1,24,3705,2021,1684
050,09,180,"Connecticut","Southeastern Connecticut Planning Region",1,25,3745,2066,1679
050,09,180,"Connecticut","Southeastern Connecticut Planning Region",1,26,3787,2101,1686
050,09,180,"Connecticut","Southeastern Connecticut Planning Region",1,27,3760,2032,1728
050,09,180,"Connecticut","Southeastern Connecticut Planning Region",1,28,3604,1966,1638
050,09,180,"Connecticut","Southeastern Connecticut Planning Region",1,29,3626,1941,1685
050,09,180,"Connecticut","Southeastern Connecticut Planning Region",1,30,3593,1882,1711
050,09,180,"Connecticut","Southeastern Connecticut Planning Region",1,31,3542,1871,1671
050,09,180,"Connecticut","Southeastern Connecticut Planning Region",1,32,3648,1891,1757
050,09,180,"Connecticut","Southeastern Connecticut Planning Region",1,33,3566,1865,1701
050,09,180,"Connecticut","Southeastern Connecticut Planning Region",1,34,3661,1845,1816
050,09,180,"Connecticut","Southeastern Connecticut Planning Region",1,35,3513,1768,1745
050,09,180,"Connecticut","Southeastern Connecticut Planning Region",1,36,3392,1697,1695
050,09,180,"Connecticut","Southeastern Connecticut Planning Region",1,37,3443,1699,1744
050,09,180,"Connecticut","Southeastern Connecticut Planning Region",1,38,3353,1650,1703
050,09,180,"Connecticut","Southeastern Connecticut Planning Region",1,39,3289,1662,1627
050,09,180,"Connecticut","Southeastern Connecticut Planning Region",1,40,3248,1636,1612
050,09,180,"Connecticut","Southeastern Connecticut Planning Region",1,41,3135,1554,1581
050,09,180,"Connecticut","Southeastern Connecticut Planning Region",1,42,3123,1566,1557
050,09,180,"Connecticut","Southeastern Connecticut Planning Region",1,43,3042,1508,1534
050,09,180,"Connecticut","Southeastern Connecticut Planning Region",1,44,3023,1495,1528
050,09,180,"Connecticut","Southeastern Connecticut Planning Region",1,45,2950,1491,1459
050,09,180,"Connecticut","Southeastern Connecticut Planning Region",1,46,2970,1476,1494
050,09,180,"Connecticut","Southeastern Connecticut Planning Region",1,47,3040,1455,1585
050,09,180,"Connecticut","Southeastern Connecticut Planning Region",1,48,3378,1657,1721
050,09,180,"Connecticut","Southeastern Connecticut Planning Region",1,49,3738,1885,1853
050,09,180,"Connecticut","Southeastern Connecticut Planning Region",1,50,3713,1851,1862
050,09,180,"Connecticut","Southeastern Connecticut Planning Region",1,51,3633,1762,1871
050,09,180,"Connecticut","Southeastern Connecticut Planning Region",1,52,3652,1791,1861
050,09,180,"Connecticut","Southeastern Connecticut Planning Region",1,53,3793,1846,1947
050,09,180,"Connecticut","Southeastern Connecticut Planning Region",1,54,4051,1970,2081
050,09,180,"Connecticut","Southeastern Connecticut Planning Region",1,55,4161,2043,2118
050,09,180,"Connecticut","Southeastern Connecticut Planning Region",1,56,4278,2150,2128
050,09,180,"Connecticut","Southeastern Connecticut Planning Region",1,57,4225,2113,2112
050,09,180,"Connecticut","Southeastern Connecticut Planning Region",1,58,4207,2072,2135
050,09,180,"Connecticut","Southeastern Connecticut Planning Region",1,59,4288,2111,2177
050,09,180,"Connecticut","Southeastern Connecticut Planning Region",1,60,4290,2132,2158
050,09,180,"Connecticut","Southeastern Connecticut Planning Region",1,61,4192,2079,2113
050,09,180,"Connecticut","Southeastern Connecticut Planning Region",1,62,4175,2059,2116
050,09,180,"Connecticut","Southeastern Connecticut Planning Region",1,63,3855,1913,1942
050,09,180,"Connecticut","Southeastern Connecticut Planning Region",1,64,3653,1813,1840
050,09,180,"Connecticut","Southeastern Connecticut Planning Region",1,65,3694,1847,1847
050,09,180,"Connecticut","Southeastern Connecticut Planning Region",1,66,3543,1767,1776
050,09,180,"Connecticut","Southeastern Connecticut Planning Region",1,67,3388,1693,1695
050,09,180,"Connecticut","Southeastern Connecticut Planning Region",1,68,3120,1547,1573
050,09,180,"Connecticut","Southeastern Connecticut Planning Region",1,69,2894,1380,1514
050,09,180,"Connecticut","Southeastern Connecticut Planning Region",1,70,2883,1370,1513
050,09,180,"Connecticut","Southeastern Connecticut Planning Region",1,71,2738,1330,1408
050,09,180,"Connecticut","Southeastern Connecticut Planning Region",1,72,2787,1331,1456
050,09,180,"Connecticut","Southeastern Connecticut Planning Region",1,73,2872,1353,1519
050,09,180,"Connecticut","Southeastern Connecticut Planning Region",1,74,2026,964,1062
050,09,180,"Connecticut","Southeastern Connecticut Planning Region",1,75,2014,915,1099
050,09,180,"Connecticut","Southeastern Connecticut Planning Region",1,76,2072,962,1110
050,09,180,"Connecticut","Southeastern Connecticut Planning Region",1,77,2076,984,1092
050,09,180,"Connecticut","Southeastern Connecticut Planning Region",1,78,1716,824,892
050,09,180,"Connecticut","Southeastern Connecticut Planning Region",1,79,1479,664,815
050,09,180,"Connecticut","Southeastern Connecticut Planning Region",1,80,1270,546,724
050,09,180,"Connecticut","Southeastern Connecticut Planning Region",1,81,1243,529,714
050,09,180,"Connecticut","Southeastern Connecticut Planning Region",1,82,1154,477,677
050,09,180,"Connecticut","Southeastern Connecticut Planning Region",1,83,1041,421,620
050,09,180,"Connecticut","Southeastern Connecticut Planning Region",1,84,963,394,569
050,09,180,"Connecticut","Southeastern Connecticut Planning Region",1,85,6246,2219,4027
050,09,180,"Connecticut","Southeastern Connecticut Planning Region",2,0,2569,1309,1260
050,09,180,"Connecticut","Southeastern Connecticut Planning Region",2,1,2618,1332,1286
050,09,180,"Connecticut","Southeastern Connecticut Planning Region",2,2,2776,1438,1338
050,09,180,"Connecticut","Southeastern Connecticut Planning Region",2,3,2847,1466,1381
050,09,180,"Connecticut","Southeastern Connecticut Planning Region",2,4,2888,1454,1434
050,09,180,"Connecticut","Southeastern Connecticut Planning Region",2,5,2897,1482,1415
050,09,180,"Connecticut","Southeastern Connecticut Planning Region",2,6,2877,1503,1374
050,09,180,"Connecticut","Southeastern Connecticut Planning Region",2,7,2952,1534,1418
050,09,180,"Connecticut","Southeastern Connecticut Planning Region",2,8,3085,1606,1479
050,09,180,"Connecticut","Southeastern Connecticut Planning Region",2,9,3063,1578,1485
050,09,180,"Connecticut","Southeastern Connecticut Planning Region",2,10,3103,1604,1499
050,09,180,"Connecticut","Southeastern Connecticut Planning Region",2,11,3209,1658,1551
050,09,180,"Connecticut","Southeastern Connecticut Planning Region",2,12,3396,1744,1652
050,09,180,"Connecticut","Southeastern Connecticut Planning Region",2,13,3418,1731,1687
050,09,180,"Connecticut","Southeastern Connecticut Planning Region",2,14,3377,1704,1673
050,09,180,"Connecticut","Southeastern Connecticut Planning Region",2,15,3447,1726,1721
050,09,180,"Connecticut","Southeastern Connecticut Planning Region",2,16,3510,1812,1698
050,09,180,"Connecticut","Southeastern Connecticut Planning Region",2,17,3506,1808,1698
050,09,180,"Connecticut","Southeastern Connecticut Planning Region",2,18,3705,1909,1796
050,09,180,"Connecticut","Southeastern Connecticut Planning Region",2,19,3919,2118,1801
050,09,180,"Connecticut","Southeastern Connecticut Planning Region",2,20,4024,2203,1821
050,09,180,"Connecticut","Southeastern Connecticut Planning Region",2,21,4016,2180,1836
050,09,180,"Connecticut","Southeastern Connecticut Planning Region",2,22,3847,2120,1727
050,09,180,"Connecticut","Southeastern Connecticut Planning Region",2,23,3653,2008,1645
050,09,180,"Connecticut","Southeastern Connecticut Planning Region",2,24,3659,1991,1668
050,09,180,"Connecticut","Southeastern Connecticut Planning Region",2,25,3719,2040,1679
050,09,180,"Connecticut","Southeastern Connecticut Planning Region",2,26,3749,2067,1682
050,09,180,"Connecticut","Southeastern Connecticut Planning Region",2,27,3714,2014,1700
050,09,180,"Connecticut","Southeastern Connecticut Planning Region",2,28,3624,1970,1654
050,09,180,"Connecticut","Southeastern Connecticut Planning Region",2,29,3580,1919,1661
050,09,180,"Connecticut","Southeastern Connecticut Planning Region",2,30,3586,1882,1704
050,09,180,"Connecticut","Southeastern Connecticut Planning Region",2,31,3529,1855,1674
050,09,180,"Connecticut","Southeastern Connecticut Planning Region",2,32,3593,1860,1733
050,09,180,"Connecticut","Southeastern Connecticut Planning Region",2,33,3573,1860,1713
050,09,180,"Connecticut","Southeastern Connecticut Planning Region",2,34,3626,1843,1783
050,09,180,"Connecticut","Southeastern Connecticut Planning Region",2,35,3547,1781,1766
050,09,180,"Connecticut","Southeastern Connecticut Planning Region",2,36,3380,1694,1686
050,09,180,"Connecticut","Southeastern Connecticut Planning Region",2,37,3422,1693,1729
050,09,180,"Connecticut","Southeastern Connecticut Planning Region",2,38,3365,1656,1709
050,09,180,"Connecticut","Southeastern Connecticut Planning Region",2,39,3274,1637,1637
050,09,180,"Connecticut","Southeastern Connecticut Planning Region",2,40,3252,1635,1617
050,09,180,"Connecticut","Southeastern Connecticut Planning Region",2,41,3135,1556,1579
050,09,180,"Connecticut","Southeastern Connecticut Planning Region",2,42,3104,1555,1549
050,09,180,"Connecticut","Southeastern Connecticut Planning Region",2,43,3066,1525,1541
050,09,180,"Connecticut","Southeastern Connecticut Planning Region",2,44,2986,1483,1503
050,09,180,"Connecticut","Southeastern Connecticut Planning Region",2,45,2964,1490,1474
050,09,180,"Connecticut","Southeastern Connecticut Planning Region",2,46,2936,1464,1472
050,09,180,"Connecticut","Southeastern Connecticut Planning Region",2,47,3001,1448,1553
050,09,180,"Connecticut","Southeastern Connecticut Planning Region",2,48,3282,1598,1684
050,09,180,"Connecticut","Southeastern Connecticut Planning Region",2,49,3652,1826,1826
050,09,180,"Connecticut","Southeastern Connecticut Planning Region",2,50,3716,1859,1857
050,09,180,"Connecticut","Southeastern Connecticut Planning Region",2,51,3622,1762,1860
050,09,180,"Connecticut","Southeastern Connecticut Planning Region",2,52,3629,1780,1849
050,09,180,"Connecticut","Southeastern Connecticut Planning Region",2,53,3740,1815,1925
050,09,180,"Connecticut","Southeastern Connecticut Planning Region",2,54,3969,1930,2039
050,09,180,"Connecticut","Southeastern Connecticut Planning Region",2,55,4123,2017,2106
050,09,180,"Connecticut","Southeastern Connecticut Planning Region",2,56,4254,2123,2131
050,09,180,"Connecticut","Southeastern Connecticut Planning Region",2,57,4224,2118,2106
050,09,180,"Connecticut","Southeastern Connecticut Planning Region",2,58,4176,2065,2111
050,09,180,"Connecticut","Southeastern Connecticut Planning Region",2,59,4272,2103,2169
050,09,180,"Connecticut","Southeastern Connecticut Planning Region",2,60,4268,2117,2151
050,09,180,"Connecticut","Southeastern Connecticut Planning Region",2,61,4179,2067,2112
050,09,180,"Connecticut","Southeastern Connecticut Planning Region",2,62,4154,2051,2103
050,09,180,"Connecticut","Southeastern Connecticut Planning Region",2,63,3950,1961,1989
050,09,180,"Connecticut","Southeastern Connecticut Planning Region",2,64,3663,1816,1847
050,09,180,"Connecticut","Southeastern Connecticut Planning Region",2,65,3672,1829,1843
050,09,180,"Connecticut","Southeastern Connecticut Planning Region",2,66,3566,1772,1794
050,09,180,"Connecticut","Southeastern Connecticut Planning Region",2,67,3395,1696,1699
050,09,180,"Connecticut","Southeastern Connecticut Planning Region",2,68,3156,1565,1591
050,09,180,"Connecticut","Southeastern Connecticut Planning Region",2,69,2950,1419,1531
050,09,180,"Connecticut","Southeastern Connecticut Planning Region",2,70,2860,1365,1495
050,09,180,"Connecticut","Southeastern Connecticut Planning Region",2,71,2767,1333,1434
050,09,180,"Connecticut","Southeastern Connecticut Planning Region",2,72,2706,1291,1415
050,09,180,"Connecticut","Southeastern Connecticut Planning Region",2,73,2976,1406,1570
050,09,180,"Connecticut","Southeastern Connecticut Planning Region",2,74,2089,988,1101
050,09,180,"Connecticut","Southeastern Connecticut Planning Region",2,75,2004,922,1082
050,09,180,"Connecticut","Southeastern Connecticut Planning Region",2,76,2016,929,1087
050,09,180,"Connecticut","Southeastern Connecticut Planning Region",2,77,2102,989,1113
050,09,180,"Connecticut","Southeastern Connecticut Planning Region",2,78,1748,836,912
050,09,180,"Connecticut","Southeastern Connecticut Planning Region",2,79,1508,688,820
050,09,180,"Connecticut","Southeastern Connecticut Planning Region",2,80,1295,561,734
050,09,180,"Connecticut","Southeastern Connecticut Planning Region",2,81,1227,522,705
050,09,180,"Connecticut","Southeastern Connecticut Planning Region",2,82,1158,480,678
050,09,180,"Connecticut","Southeastern Connecticut Planning Region",2,83,1040,422,618
050,09,180,"Connecticut","Southeastern Connecticut Planning Region",2,84,968,394,574
050,09,180,"Connecticut","Southeastern Connecticut Planning Region",2,85,6180,2193,3987
050,09,180,"Connecticut","Southeastern Connecticut Planning Region",3,0,2473,1243,1230
050,09,180,"Connecticut","Southeastern Connecticut Planning Region",3,1,2579,1324,1255
050,09,180,"Connecticut","Southeastern Connecticut Planning Region",3,2,2663,1352,1311
050,09,180,"Connecticut","Southeastern Connecticut Planning Region",3,3,2814,1451,1363
050,09,180,"Connecticut","Southeastern Connecticut Planning Region",3,4,2846,1463,1383
050,09,180,"Connecticut","Southeastern Connecticut Planning Region",3,5,2888,1448,1440
050,09,180,"Connecticut","Southeastern Connecticut Planning Region",3,6,2912,1503,1409
050,09,180,"Connecticut","Southeastern Connecticut Planning Region",3,7,2863,1493,1370
050,09,180,"Connecticut","Southeastern Connecticut Planning Region",3,8,2994,1552,1442
050,09,180,"Connecticut","Southeastern Connecticut Planning Region",3,9,3099,1613,1486
050,09,180,"Connecticut","Southeastern Connecticut Planning Region",3,10,3081,1586,1495
050,09,180,"Connecticut","Southeastern Connecticut Planning Region",3,11,3083,1591,1492
050,09,180,"Connecticut","Southeastern Connecticut Planning Region",3,12,3178,1651,1527
050,09,180,"Connecticut","Southeastern Connecticut Planning Region",3,13,3392,1734,1658
050,09,180,"Connecticut","Southeastern Connecticut Planning Region",3,14,3411,1747,1664
050,09,180,"Connecticut","Southeastern Connecticut Planning Region",3,15,3396,1724,1672
050,09,180,"Connecticut","Southeastern Connecticut Planning Region",3,16,3405,1694,1711
050,09,180,"Connecticut","Southeastern Connecticut Planning Region",3,17,3490,1798,1692
050,09,180,"Connecticut","Southeastern Connecticut Planning Region",3,18,3850,1953,1897
050,09,180,"Connecticut","Southeastern Connecticut Planning Region",3,19,4073,2156,1917
050,09,180,"Connecticut","Southeastern Connecticut Planning Region",3,20,4094,2227,1867
050,09,180,"Connecticut","Southeastern Connecticut Planning Region",3,21,4115,2230,1885
050,09,180,"Connecticut","Southeastern Connecticut Planning Region",3,22,3898,2119,1779
050,09,180,"Connecticut","Southeastern Connecticut Planning Region",3,23,3627,1990,1637
050,09,180,"Connecticut","Southeastern Connecticut Planning Region",3,24,3690,2052,1638
050,09,180,"Connecticut","Southeastern Connecticut Planning Region",3,25,3722,2010,1712
050,09,180,"Connecticut","Southeastern Connecticut Planning Region",3,26,3694,1991,1703
050,09,180,"Connecticut","Southeastern Connecticut Planning Region",3,27,3722,2009,1713
050,09,180,"Connecticut","Southeastern Connecticut Planning Region",3,28,3692,1990,1702
050,09,180,"Connecticut","Southeastern Connecticut Planning Region",3,29,3707,1998,1709
050,09,180,"Connecticut","Southeastern Connecticut Planning Region",3,30,3648,1931,1717
050,09,180,"Connecticut","Southeastern Connecticut Planning Region",3,31,3631,1941,1690
050,09,180,"Connecticut","Southeastern Connecticut Planning Region",3,32,3580,1839,1741
050,09,180,"Connecticut","Southeastern Connecticut Planning Region",3,33,3607,1845,1762
050,09,180,"Connecticut","Southeastern Connecticut Planning Region",3,34,3636,1896,1740
050,09,180,"Connecticut","Southeastern Connecticut Planning Region",3,35,3633,1826,1807
050,09,180,"Connecticut","Southeastern Connecticut Planning Region",3,36,3495,1754,1741
050,09,180,"Connecticut","Southeastern Connecticut Planning Region",3,37,3390,1689,1701
050,09,180,"Connecticut","Southeastern Connecticut Planning Region",3,38,3372,1667,1705
050,09,180,"Connecticut","Southeastern Connecticut Planning Region",3,39,3375,1654,1721
050,09,180,"Connecticut","Southeastern Connecticut Planning Region",3,40,3284,1631,1653
050,09,180,"Connecticut","Southeastern Connecticut Planning Region",3,41,3216,1632,1584
050,09,180,"Connecticut","Southeastern Connecticut Planning Region",3,42,3140,1559,1581
050,09,180,"Connecticut","Southeastern Connecticut Planning Region",3,43,3086,1543,1543
050,09,180,"Connecticut","Southeastern Connecticut Planning Region",3,44,3060,1533,1527
050,09,180,"Connecticut","Southeastern Connecticut Planning Region",3,45,2967,1489,1478
050,09,180,"Connecticut","Southeastern Connecticut Planning Region",3,46,2953,1477,1476
050,09,180,"Connecticut","Southeastern Connecticut Planning Region",3,47,2926,1462,1464
050,09,180,"Connecticut","Southeastern Connecticut Planning Region",3,48,2977,1430,1547
050,09,180,"Connecticut","Southeastern Connecticut Planning Region",3,49,3267,1568,1699
050,09,180,"Connecticut","Southeastern Connecticut Planning Region",3,50,3623,1828,1795
050,09,180,"Connecticut","Southeastern Connecticut Planning Region",3,51,3654,1814,1840
050,09,180,"Connecticut","Southeastern Connecticut Planning Region",3,52,3606,1765,1841
050,09,180,"Connecticut","Southeastern Connecticut Planning Region",3,53,3570,1739,1831
050,09,180,"Connecticut","Southeastern Connecticut Planning Region",3,54,3731,1819,1912
050,09,180,"Connecticut","Southeastern Connecticut Planning Region",3,55,3902,1891,2011
050,09,180,"Connecticut","Southeastern Connecticut Planning Region",3,56,4133,2021,2112
050,09,180,"Connecticut","Southeastern Connecticut Planning Region",3,57,4207,2090,2117
050,09,180,"Connecticut","Southeastern Connecticut Planning Region",3,58,4180,2096,2084
050,09,180,"Connecticut","Southeastern Connecticut Planning Region",3,59,4158,2044,2114
050,09,180,"Connecticut","Southeastern Connecticut Planning Region",3,60,4231,2092,2139
050,09,180,"Connecticut","Southeastern Connecticut Planning Region",3,61,4196,2064,2132
050,09,180,"Connecticut","Southeastern Connecticut Planning Region",3,62,4111,2028,2083
050,09,180,"Connecticut","Southeastern Connecticut Planning Region",3,63,4084,2020,2064
050,09,180,"Connecticut","Southeastern Connecticut Planning Region",3,64,3888,1933,1955
050,09,180,"Connecticut","Southeastern Connecticut Planning Region",3,65,3640,1800,1840
050,09,180,"Connecticut","Southeastern Connecticut Planning Region",3,66,3626,1795,1831
050,09,180,"Connecticut","Southeastern Connecticut Planning Region",3,67,3508,1736,1772
050,09,180,"Connecticut","Southeastern Connecticut Planning Region",3,68,3355,1669,1686
050,09,180,"Connecticut","Southeastern Connecticut Planning Region",3,69,3097,1523,1574
050,09,180,"Connecticut","Southeastern Connecticut Planning Region",3,70,2926,1416,1510
050,09,180,"Connecticut","Southeastern Connecticut Planning Region",3,71,2812,1333,1479
050,09,180,"Connecticut","Southeastern Connecticut Planning Region",3,72,2711,1304,1407
050,09,180,"Connecticut","Southeastern Connecticut Planning Region",3,73,2650,1246,1404
050,09,180,"Connecticut","Southeastern Connecticut Planning Region",3,74,2906,1364,1542
050,09,180,"Connecticut","Southeastern Connecticut Planning Region",3,75,2025,957,1068
050,09,180,"Connecticut","Southeastern Connecticut Planning Region",3,76,1955,889,1066
050,09,180,"Connecticut","Southeastern Connecticut Planning Region",3,77,1940,880,1060
050,09,180,"Connecticut","Southeastern Connecticut Planning Region",3,78,2019,937,1082
050,09,180,"Connecticut","Southeastern Connecticut Planning Region",3,79,1673,792,881
050,09,180,"Connecticut","Southeastern Connecticut Planning Region",3,80,1428,642,786
050,09,180,"Connecticut","Southeastern Connecticut Planning Region",3,81,1246,535,711
050,09,180,"Connecticut","Southeastern Connecticut Planning Region",3,82,1142,476,666
050,09,180,"Connecticut","Southeastern Connecticut Planning Region",3,83,1060,438,622
050,09,180,"Connecticut","Southeastern Connecticut Planning Region",3,84,976,383,593
050,09,180,"Connecticut","Southeastern Connecticut Planning Region",3,85,6157,2198,3959
050,09,180,"Connecticut","Southeastern Connecticut Planning Region",4,0,2665,1357,1308
050,09,180,"Connecticut","Southeastern Connecticut Planning Region",4,1,2476,1251,1225
050,09,180,"Connecticut","Southeastern Connecticut Planning Region",4,2,2630,1365,1265
050,09,180,"Connecticut","Southeastern Connecticut Planning Region",4,3,2659,1349,1310
050,09,180,"Connecticut","Southeastern Connecticut Planning Region",4,4,2829,1453,1376
050,09,180,"Connecticut","Southeastern Connecticut Planning Region",4,5,2876,1456,1420
050,09,180,"Connecticut","Southeastern Connecticut Planning Region",4,6,2900,1441,1459
050,09,180,"Connecticut","Southeastern Connecticut Planning Region",4,7,2940,1519,1421
050,09,180,"Connecticut","Southeastern Connecticut Planning Region",4,8,2878,1510,1368
050,09,180,"Connecticut","Southeastern Connecticut Planning Region",4,9,3044,1580,1464
050,09,180,"Connecticut","Southeastern Connecticut Planning Region",4,10,3106,1614,1492
050,09,180,"Connecticut","Southeastern Connecticut Planning Region",4,11,3075,1581,1494
050,09,180,"Connecticut","Southeastern Connecticut Planning Region",4,12,3035,1558,1477
050,09,180,"Connecticut","Southeastern Connecticut Planning Region",4,13,3169,1638,1531
050,09,180,"Connecticut","Southeastern Connecticut Planning Region",4,14,3416,1773,1643
050,09,180,"Connecticut","Southeastern Connecticut Planning Region",4,15,3410,1744,1666
050,09,180,"Connecticut","Southeastern Connecticut Planning Region",4,16,3400,1724,1676
050,09,180,"Connecticut","Southeastern Connecticut Planning Region",4,17,3376,1674,1702
050,09,180,"Connecticut","Southeastern Connecticut Planning Region",4,18,3832,1938,1894
050,09,180,"Connecticut","Southeastern Connecticut Planning Region",4,19,4139,2190,1949
050,09,180,"Connecticut","Southeastern Connecticut Planning Region",4,20,4165,2238,1927
050,09,180,"Connecticut","Southeastern Connecticut Planning Region",4,21,4149,2273,1876
050,09,180,"Connecticut","Southeastern Connecticut Planning Region",4,22,3943,2149,1794
050,09,180,"Connecticut","Southeastern Connecticut Planning Region",4,23,3617,1988,1629
050,09,180,"Connecticut","Southeastern Connecticut Planning Region",4,24,3640,1997,1643
050,09,180,"Connecticut","Southeastern Connecticut Planning Region",4,25,3751,2058,1693
050,09,180,"Connecticut","Southeastern Connecticut Planning Region",4,26,3635,1938,1697
050,09,180,"Connecticut","Southeastern Connecticut Planning Region",4,27,3674,1970,1704
050,09,180,"Connecticut","Southeastern Connecticut Planning Region",4,28,3726,2008,1718
050,09,180,"Connecticut","Southeastern Connecticut Planning Region",4,29,3713,1975,1738
050,09,180,"Connecticut","Southeastern Connecticut Planning Region",4,30,3757,2000,1757
050,09,180,"Connecticut","Southeastern Connecticut Planning Region",4,31,3640,1923,1717
050,09,180,"Connecticut","Southeastern Connecticut Planning Region",4,32,3653,1895,1758
050,09,180,"Connecticut","Southeastern Connecticut Planning Region",4,33,3612,1854,1758
050,09,180,"Connecticut","Southeastern Connecticut Planning Region",4,34,3649,1882,1767
050,09,180,"Connecticut","Southeastern Connecticut Planning Region",4,35,3574,1861,1713
050,09,180,"Connecticut","Southeastern Connecticut Planning Region",4,36,3624,1817,1807
050,09,180,"Connecticut","Southeastern Connecticut Planning Region",4,37,3498,1761,1737
050,09,180,"Connecticut","Southeastern Connecticut Planning Region",4,38,3350,1660,1690
050,09,180,"Connecticut","Southeastern Connecticut Planning Region",4,39,3416,1695,1721
050,09,180,"Connecticut","Southeastern Connecticut Planning Region",4,40,3370,1646,1724
050,09,180,"Connecticut","Southeastern Connecticut Planning Region",4,41,3230,1572,1658
050,09,180,"Connecticut","Southeastern Connecticut Planning Region",4,42,3245,1664,1581
050,09,180,"Connecticut","Southeastern Connecticut Planning Region",4,43,3128,1529,1599
050,09,180,"Connecticut","Southeastern Connecticut Planning Region",4,44,3122,1578,1544
050,09,180,"Connecticut","Southeastern Connecticut Planning Region",4,45,3035,1506,1529
050,09,180,"Connecticut","Southeastern Connecticut Planning Region",4,46,2966,1484,1482
050,09,180,"Connecticut","Southeastern Connecticut Planning Region",4,47,2920,1457,1463
050,09,180,"Connecticut","Southeastern Connecticut Planning Region",4,48,2929,1467,1462
050,09,180,"Connecticut","Southeastern Connecticut Planning Region",4,49,2946,1410,1536
050,09,180,"Connecticut","Southeastern Connecticut Planning Region",4,50,3263,1595,1668
050,09,180,"Connecticut","Southeastern Connecticut Planning Region",4,51,3555,1786,1769
050,09,180,"Connecticut","Southeastern Connecticut Planning Region",4,52,3629,1810,1819
050,09,180,"Connecticut","Southeastern Connecticut Planning Region",4,53,3544,1711,1833
050,09,180,"Connecticut","Southeastern Connecticut Planning Region",4,54,3556,1729,1827
050,09,180,"Connecticut","Southeastern Connecticut Planning Region",4,55,3671,1794,1877
050,09,180,"Connecticut","Southeastern Connecticut Planning Region",4,56,3903,1879,2024
050,09,180,"Connecticut","Southeastern Connecticut Planning Region",4,57,4127,2024,2103
050,09,180,"Connecticut","Southeastern Connecticut Planning Region",4,58,4176,2056,2120
050,09,180,"Connecticut","Southeastern Connecticut Planning Region",4,59,4162,2079,2083
050,09,180,"Connecticut","Southeastern Connecticut Planning Region",4,60,4099,2021,2078
050,09,180,"Connecticut","Southeastern Connecticut Planning Region",4,61,4153,2039,2114
050,09,180,"Connecticut","Southeastern Connecticut Planning Region",4,62,4128,2038,2090
050,09,180,"Connecticut","Southeastern Connecticut Planning Region",4,63,4068,1994,2074
050,09,180,"Connecticut","Southeastern Connecticut Planning Region",4,64,4065,2003,2062
050,09,180,"Connecticut","Southeastern Connecticut Planning Region",4,65,3808,1885,1923
050,09,180,"Connecticut","Southeastern Connecticut Planning Region",4,66,3601,1792,1809
050,09,180,"Connecticut","Southeastern Connecticut Planning Region",4,67,3595,1763,1832
050,09,180,"Connecticut","Southeastern Connecticut Planning Region",4,68,3467,1713,1754
050,09,180,"Connecticut","Southeastern Connecticut Planning Region",4,69,3304,1631,1673
050,09,180,"Connecticut","Southeastern Connecticut Planning Region",4,70,3084,1523,1561
050,09,180,"Connecticut","Southeastern Connecticut Planning Region",4,71,2880,1390,1490
050,09,180,"Connecticut","Southeastern Connecticut Planning Region",4,72,2781,1311,1470
050,09,180,"Connecticut","Southeastern Connecticut Planning Region",4,73,2641,1260,1381
050,09,180,"Connecticut","Southeastern Connecticut Planning Region",4,74,2592,1205,1387
050,09,180,"Connecticut","Southeastern Connecticut Planning Region",4,75,2839,1325,1514
050,09,180,"Connecticut","Southeastern Connecticut Planning Region",4,76,1985,923,1062
050,09,180,"Connecticut","Southeastern Connecticut Planning Region",4,77,1907,852,1055
050,09,180,"Connecticut","Southeastern Connecticut Planning Region",4,78,1859,830,1029
050,09,180,"Connecticut","Southeastern Connecticut Planning Region",4,79,1947,893,1054
050,09,180,"Connecticut","Southeastern Connecticut Planning Region",4,80,1583,742,841
050,09,180,"Connecticut","Southeastern Connecticut Planning Region",4,81,1363,615,748
050,09,180,"Connecticut","Southeastern Connecticut Planning Region",4,82,1157,496,661
050,09,180,"Connecticut","Southeastern Connecticut Planning Region",4,83,1064,440,624
050,09,180,"Connecticut","Southeastern Connecticut Planning Region",4,84,984,401,583
050,09,180,"Connecticut","Southeastern Connecticut Planning Region",4,85,6185,2192,3993
050,09,180,"Connecticut","Southeastern Connecticut Planning Region",5,0,2569,1306,1263
050,09,180,"Connecticut","Southeastern Connecticut Planning Region",5,1,2712,1400,1312
050,09,180,"Connecticut","Southeastern Connecticut Planning Region",5,2,2542,1285,1257
050,09,180,"Connecticut","Southeastern Connecticut Planning Region",5,3,2637,1362,1275
050,09,180,"Connecticut","Southeastern Connecticut Planning Region",5,4,2681,1351,1330
050,09,180,"Connecticut","Southeastern Connecticut Planning Region",5,5,2818,1434,1384
050,09,180,"Connecticut","Southeastern Connecticut Planning Region",5,6,2869,1436,1433
050,09,180,"Connecticut","Southeastern Connecticut Planning Region",5,7,2909,1451,1458
050,09,180,"Connecticut","Southeastern Connecticut Planning Region",5,8,2943,1506,1437
050,09,180,"Connecticut","Southeastern Connecticut Planning Region",5,9,2891,1511,1380
050,09,180,"Connecticut","Southeastern Connecticut Planning Region",5,10,3035,1579,1456
050,09,180,"Connecticut","Southeastern Connecticut Planning Region",5,11,3109,1602,1507
050,09,180,"Connecticut","Southeastern Connecticut Planning Region",5,12,3071,1604,1467
050,09,180,"Connecticut","Southeastern Connecticut Planning Region",5,13,3013,1543,1470
050,09,180,"Connecticut","Southeastern Connecticut Planning Region",5,14,3181,1647,1534
050,09,180,"Connecticut","Southeastern Connecticut Planning Region",5,15,3416,1759,1657
050,09,180,"Connecticut","Southeastern Connecticut Planning Region",5,16,3392,1736,1656
050,09,180,"Connecticut","Southeastern Connecticut Planning Region",5,17,3364,1718,1646
050,09,180,"Connecticut","Southeastern Connecticut Planning Region",5,18,3741,1863,1878
050,09,180,"Connecticut","Southeastern Connecticut Planning Region",5,19,4108,2176,1932
050,09,180,"Connecticut","Southeastern Connecticut Planning Region",5,20,4184,2235,1949
050,09,180,"Connecticut","Southeastern Connecticut Planning Region",5,21,4144,2212,1932
050,09,180,"Connecticut","Southeastern Connecticut Planning Region",5,22,3945,2187,1758
050,09,180,"Connecticut","Southeastern Connecticut Planning Region",5,23,3740,2080,1660
050,09,180,"Connecticut","Southeastern Connecticut Planning Region",5,24,3625,1988,1637
050,09,180,"Connecticut","Southeastern Connecticut Planning Region",5,25,3658,2007,1651
050,09,180,"Connecticut","Southeastern Connecticut Planning Region",5,26,3652,1987,1665
050,09,180,"Connecticut","Southeastern Connecticut Planning Region",5,27,3681,1959,1722
050,09,180,"Connecticut","Southeastern Connecticut Planning Region",5,28,3700,1982,1718
050,09,180,"Connecticut","Southeastern Connecticut Planning Region",5,29,3691,1986,1705
050,09,180,"Connecticut","Southeastern Connecticut Planning Region",5,30,3739,1977,1762
050,09,180,"Connecticut","Southeastern Connecticut Planning Region",5,31,3737,1979,1758
050,09,180,"Connecticut","Southeastern Connecticut Planning Region",5,32,3653,1886,1767
050,09,180,"Connecticut","Southeastern Connecticut Planning Region",5,33,3707,1912,1795
050,09,180,"Connecticut","Southeastern Connecticut Planning Region",5,34,3628,1857,1771
050,09,180,"Connecticut","Southeastern Connecticut Planning Region",5,35,3681,1872,1809
050,09,180,"Connecticut","Southeastern Connecticut Planning Region",5,36,3576,1853,1723
050,09,180,"Connecticut","Southeastern Connecticut Planning Region",5,37,3687,1845,1842
050,09,180,"Connecticut","Southeastern Connecticut Planning Region",5,38,3481,1741,1740
050,09,180,"Connecticut","Southeastern Connecticut Planning Region",5,39,3388,1684,1704
050,09,180,"Connecticut","Southeastern Connecticut Planning Region",5,40,3398,1683,1715
050,09,180,"Connecticut","Southeastern Connecticut Planning Region",5,41,3323,1619,1704
050,09,180,"Connecticut","Southeastern Connecticut Planning Region",5,42,3233,1582,1651
050,09,180,"Connecticut","Southeastern Connecticut Planning Region",5,43,3226,1644,1582
050,09,180,"Connecticut","Southeastern Connecticut Planning Region",5,44,3124,1527,1597
050,09,180,"Connecticut","Southeastern Connecticut Planning Region",5,45,3112,1584,1528
050,09,180,"Connecticut","Southeastern Connecticut Planning Region",5,46,3041,1506,1535
050,09,180,"Connecticut","Southeastern Connecticut Planning Region",5,47,2961,1464,1497
050,09,180,"Connecticut","Southeastern Connecticut Planning Region",5,48,2881,1434,1447
050,09,180,"Connecticut","Southeastern Connecticut Planning Region",5,49,2894,1434,1460
050,09,180,"Connecticut","Southeastern Connecticut Planning Region",5,50,2964,1431,1533
050,09,180,"Connecticut","Southeastern Connecticut Planning Region",5,51,3209,1547,1662
050,09,180,"Connecticut","Southeastern Connecticut Planning Region",5,52,3539,1796,1743
050,09,180,"Connecticut","Southeastern Connecticut Planning Region",5,53,3628,1795,1833
050,09,180,"Connecticut","Southeastern Connecticut Planning Region",5,54,3549,1701,1848
050,09,180,"Connecticut","Southeastern Connecticut Planning Region",5,55,3503,1701,1802
050,09,180,"Connecticut","Southeastern Connecticut Planning Region",5,56,3652,1782,1870
050,09,180,"Connecticut","Southeastern Connecticut Planning Region",5,57,3891,1868,2023
050,09,180,"Connecticut","Southeastern Connecticut Planning Region",5,58,4080,1987,2093
050,09,180,"Connecticut","Southeastern Connecticut Planning Region",5,59,4176,2058,2118
050,09,180,"Connecticut","Southeastern Connecticut Planning Region",5,60,4130,2086,2044
050,09,180,"Connecticut","Southeastern Connecticut Planning Region",5,61,4029,1972,2057
050,09,180,"Connecticut","Southeastern Connecticut Planning Region",5,62,4122,2011,2111
050,09,180,"Connecticut","Southeastern Connecticut Planning Region",5,63,4076,2016,2060
050,09,180,"Connecticut","Southeastern Connecticut Planning Region",5,64,4007,1955,2052
050,09,180,"Connecticut","Southeastern Connecticut Planning Region",5,65,4034,1973,2061
050,09,180,"Connecticut","Southeastern Connecticut Planning Region",5,66,3770,1861,1909
050,09,180,"Connecticut","Southeastern Connecticut Planning Region",5,67,3570,1762,1808
050,09,180,"Connecticut","Southeastern Connecticut Planning Region",5,68,3559,1750,1809
050,09,180,"Connecticut","Southeastern Connecticut Planning Region",5,69,3388,1656,1732
050,09,180,"Connecticut","Southeastern Connecticut Planning Region",5,70,3259,1621,1638
050,09,180,"Connecticut","Southeastern Connecticut Planning Region",5,71,3033,1489,1544
050,09,180,"Connecticut","Southeastern Connecticut Planning Region",5,72,2823,1351,1472
050,09,180,"Connecticut","Southeastern Connecticut Planning Region",5,73,2725,1277,1448
050,09,180,"Connecticut","Southeastern Connecticut Planning Region",5,74,2592,1224,1368
050,09,180,"Connecticut","Southeastern Connecticut Planning Region",5,75,2528,1167,1361
050,09,180,"Connecticut","Southeastern Connecticut Planning Region",5,76,2800,1289,1511
050,09,180,"Connecticut","Southeastern Connecticut Planning Region",5,77,1934,879,1055
050,09,180,"Connecticut","Southeastern Connecticut Planning Region",5,78,1826,805,1021
050,09,180,"Connecticut","Southeastern Connecticut Planning Region",5,79,1791,792,999
050,09,180,"Connecticut","Southeastern Connecticut Planning Region",5,80,1870,852,1018
050,09,180,"Connecticut","Southeastern Connecticut Planning Region",5,81,1536,721,815
050,09,180,"Connecticut","Southeastern Connecticut Planning Region",5,82,1266,568,698
050,09,180,"Connecticut","Southeastern Connecticut Planning Region",5,83,1071,459,612
050,09,180,"Connecticut","Southeastern Connecticut Planning Region",5,84,976,395,581
050,09,180,"Connecticut","Southeastern Connecticut Planning Region",5,85,6237,2219,4018
050,09,190,"Connecticut","Western Connecticut Planning Region",1,0,6101,3108,2993
050,09,190,"Connecticut","Western Connecticut Planning Region",1,1,6349,3211,3138
050,09,190,"Connecticut","Western Connecticut Planning Region",1,2,6541,3370,3171
050,09,190,"Connecticut","Western Connecticut Planning Region",1,3,6759,3486,3273
050,09,190,"Connecticut","Western Connecticut Planning Region",1,4,6982,3560,3422
050,09,190,"Connecticut","Western Connecticut Planning Region",1,5,7095,3600,3495
050,09,190,"Connecticut","Western Connecticut Planning Region",1,6,7107,3617,3490
050,09,190,"Connecticut","Western Connecticut Planning Region",1,7,7177,3614,3563
050,09,190,"Connecticut","Western Connecticut Planning Region",1,8,7374,3720,3654
050,09,190,"Connecticut","Western Connecticut Planning Region",1,9,7620,3891,3729
050,09,190,"Connecticut","Western Connecticut Planning Region",1,10,7882,4021,3861
050,09,190,"Connecticut","Western Connecticut Planning Region",1,11,8333,4255,4078
050,09,190,"Connecticut","Western Connecticut Planning Region",1,12,8617,4413,4204
050,09,190,"Connecticut","Western Connecticut Planning Region",1,13,8766,4480,4286
050,09,190,"Connecticut","Western Connecticut Planning Region",1,14,8757,4435,4322
050,09,190,"Connecticut","Western Connecticut Planning Region",1,15,8737,4432,4305
050,09,190,"Connecticut","Western Connecticut Planning Region",1,16,8887,4547,4340
050,09,190,"Connecticut","Western Connecticut Planning Region",1,17,8785,4498,4287
050,09,190,"Connecticut","Western Connecticut Planning Region",1,18,7952,4147,3805
050,09,190,"Connecticut","Western Connecticut Planning Region",1,19,7080,3636,3444
050,09,190,"Connecticut","Western Connecticut Planning Region",1,20,7312,3727,3585
050,09,190,"Connecticut","Western Connecticut Planning Region",1,21,7588,3891,3697
050,09,190,"Connecticut","Western Connecticut Planning Region",1,22,7565,3836,3729
050,09,190,"Connecticut","Western Connecticut Planning Region",1,23,7351,3760,3591
050,09,190,"Connecticut","Western Connecticut Planning Region",1,24,7177,3722,3455
050,09,190,"Connecticut","Western Connecticut Planning Region",1,25,6971,3570,3401
050,09,190,"Connecticut","Western Connecticut Planning Region",1,26,7099,3643,3456
050,09,190,"Connecticut","Western Connecticut Planning Region",1,27,7091,3589,3502
050,09,190,"Connecticut","Western Connecticut Planning Region",1,28,6831,3475,3356
050,09,190,"Connecticut","Western Connecticut Planning Region",1,29,6704,3417,3287
050,09,190,"Connecticut","Western Connecticut Planning Region",1,30,6861,3413,3448
050,09,190,"Connecticut","Western Connecticut Planning Region",1,31,6872,3410,3462
050,09,190,"Connecticut","Western Connecticut Planning Region",1,32,7137,3531,3606
050,09,190,"Connecticut","Western Connecticut Planning Region",1,33,7392,3663,3729
050,09,190,"Connecticut","Western Connecticut Planning Region",1,34,7631,3827,3804
050,09,190,"Connecticut","Western Connecticut Planning Region",1,35,7572,3842,3730
050,09,190,"Connecticut","Western Connecticut Planning Region",1,36,7662,3867,3795
050,09,190,"Connecticut","Western Connecticut Planning Region",1,37,7811,3889,3922
050,09,190,"Connecticut","Western Connecticut Planning Region",1,38,7917,3939,3978
050,09,190,"Connecticut","Western Connecticut Planning Region",1,39,7966,3955,4011
050,09,190,"Connecticut","Western Connecticut Planning Region",1,40,7969,3884,4085
050,09,190,"Connecticut","Western Connecticut Planning Region",1,41,7863,3873,3990
050,09,190,"Connecticut","Western Connecticut Planning Region",1,42,7887,3949,3938
050,09,190,"Connecticut","Western Connecticut Planning Region",1,43,7825,3873,3952
050,09,190,"Connecticut","Western Connecticut Planning Region",1,44,7735,3825,3910
050,09,190,"Connecticut","Western Connecticut Planning Region",1,45,7769,3839,3930
050,09,190,"Connecticut","Western Connecticut Planning Region",1,46,7771,3805,3966
050,09,190,"Connecticut","Western Connecticut Planning Region",1,47,8119,3968,4151
050,09,190,"Connecticut","Western Connecticut Planning Region",1,48,8622,4224,4398
050,09,190,"Connecticut","Western Connecticut Planning Region",1,49,9291,4548,4743
050,09,190,"Connecticut","Western Connecticut Planning Region",1,50,9275,4568,4707
050,09,190,"Connecticut","Western Connecticut Planning Region",1,51,9040,4470,4570
050,09,190,"Connecticut","Western Connecticut Planning Region",1,52,9085,4435,4650
050,09,190,"Connecticut","Western Connecticut Planning Region",1,53,9385,4590,4795
050,09,190,"Connecticut","Western Connecticut Planning Region",1,54,9637,4731,4906
050,09,190,"Connecticut","Western Connecticut Planning Region",1,55,9823,4797,5026
050,09,190,"Connecticut","Western Connecticut Planning Region",1,56,9844,4779,5065
050,09,190,"Connecticut","Western Connecticut Planning Region",1,57,9600,4708,4892
050,09,190,"Connecticut","Western Connecticut Planning Region",1,58,9603,4675,4928
050,09,190,"Connecticut","Western Connecticut Planning Region",1,59,9396,4549,4847
050,09,190,"Connecticut","Western Connecticut Planning Region",1,60,9170,4489,4681
050,09,190,"Connecticut","Western Connecticut Planning Region",1,61,8889,4365,4524
050,09,190,"Connecticut","Western Connecticut Planning Region",1,62,8672,4270,4402
050,09,190,"Connecticut","Western Connecticut Planning Region",1,63,8274,4027,4247
050,09,190,"Connecticut","Western Connecticut Planning Region",1,64,7903,3879,4024
050,09,190,"Connecticut","Western Connecticut Planning Region",1,65,7538,3688,3850
050,09,190,"Connecticut","Western Connecticut Planning Region",1,66,7045,3478,3567
050,09,190,"Connecticut","Western Connecticut Planning Region",1,67,6563,3172,3391
050,09,190,"Connecticut","Western Connecticut Planning Region",1,68,6174,2939,3235
050,09,190,"Connecticut","Western Connecticut Planning Region",1,69,5687,2670,3017
050,09,190,"Connecticut","Western Connecticut Planning Region",1,70,5442,2516,2926
050,09,190,"Connecticut","Western Connecticut Planning Region",1,71,5259,2416,2843
050,09,190,"Connecticut","Western Connecticut Planning Region",1,72,5365,2472,2893
050,09,190,"Connecticut","Western Connecticut Planning Region",1,73,5551,2575,2976
050,09,190,"Connecticut","Western Connecticut Planning Region",1,74,4020,1840,2180
050,09,190,"Connecticut","Western Connecticut Planning Region",1,75,3975,1825,2150
050,09,190,"Connecticut","Western Connecticut Planning Region",1,76,3951,1791,2160
050,09,190,"Connecticut","Western Connecticut Planning Region",1,77,3974,1776,2198
050,09,190,"Connecticut","Western Connecticut Planning Region",1,78,3338,1468,1870
050,09,190,"Connecticut","Western Connecticut Planning Region",1,79,2972,1284,1688
050,09,190,"Connecticut","Western Connecticut Planning Region",1,80,2744,1171,1573
050,09,190,"Connecticut","Western Connecticut Planning Region",1,81,2574,1082,1492
050,09,190,"Connecticut","Western Connecticut Planning Region",1,82,2361,981,1380
050,09,190,"Connecticut","Western Connecticut Planning Region",1,83,2153,906,1247
050,09,190,"Connecticut","Western Connecticut Planning Region",1,84,2048,836,1212
050,09,190,"Connecticut","Western Connecticut Planning Region",1,85,13927,4869,9058
050,09,190,"Connecticut","Western Connecticut Planning Region",2,0,6144,3122,3022
050,09,190,"Connecticut","Western Connecticut Planning Region",2,1,6295,3190,3105
050,09,190,"Connecticut","Western Connecticut Planning Region",2,2,6511,3339,3172
050,09,190,"Connecticut","Western Connecticut Planning Region",2,3,6687,3451,3236
050,09,190,"Connecticut","Western Connecticut Planning Region",2,4,6941,3546,3395
050,09,190,"Connecticut","Western Connecticut Planning Region",2,5,7083,3598,3485
050,09,190,"Connecticut","Western Connecticut Planning Region",2,6,7121,3618,3503
050,09,190,"Connecticut","Western Connecticut Planning Region",2,7,7143,3604,3539
050,09,190,"Connecticut","Western Connecticut Planning Region",2,8,7285,3670,3615
050,09,190,"Connecticut","Western Connecticut Planning Region",2,9,7541,3843,3698
050,09,190,"Connecticut","Western Connecticut Planning Region",2,10,7809,3988,3821
050,09,190,"Connecticut","Western Connecticut Planning Region",2,11,8186,4180,4006
050,09,190,"Connecticut","Western Connecticut Planning Region",2,12,8578,4389,4189
050,09,190,"Connecticut","Western Connecticut Planning Region",2,13,8718,4454,4264
050,09,190,"Connecticut","Western Connecticut Planning Region",2,14,8762,4444,4318
050,09,190,"Connecticut","Western Connecticut Planning Region",2,15,8752,4439,4313
050,09,190,"Connecticut","Western Connecticut Planning Region",2,16,8868,4528,4340
050,09,190,"Connecticut","Western Connecticut Planning Region",2,17,8791,4505,4286
050,09,190,"Connecticut","Western Connecticut Planning Region",2,18,7789,4064,3725
050,09,190,"Connecticut","Western Connecticut Planning Region",2,19,6908,3567,3341
050,09,190,"Connecticut","Western Connecticut Planning Region",2,20,7271,3713,3558
050,09,190,"Connecticut","Western Connecticut Planning Region",2,21,7446,3814,3632
050,09,190,"Connecticut","Western Connecticut Planning Region",2,22,7484,3798,3686
050,09,190,"Connecticut","Western Connecticut Planning Region",2,23,7371,3771,3600
050,09,190,"Connecticut","Western Connecticut Planning Region",2,24,7154,3702,3452
050,09,190,"Connecticut","Western Connecticut Planning Region",2,25,6994,3601,3393
050,09,190,"Connecticut","Western Connecticut Planning Region",2,26,7087,3639,3448
050,09,190,"Connecticut","Western Connecticut Planning Region",2,27,7089,3600,3489
050,09,190,"Connecticut","Western Connecticut Planning Region",2,28,6912,3517,3395
050,09,190,"Connecticut","Western Connecticut Planning Region",2,29,6749,3431,3318
050,09,190,"Connecticut","Western Connecticut Planning Region",2,30,6876,3443,3433
050,09,190,"Connecticut","Western Connecticut Planning Region",2,31,6884,3422,3462
050,09,190,"Connecticut","Western Connecticut Planning Region",2,32,7082,3498,3584
050,09,190,"Connecticut","Western Connecticut Planning Region",2,33,7341,3641,3700
050,09,190,"Connecticut","Western Connecticut Planning Region",2,34,7580,3789,3791
050,09,190,"Connecticut","Western Connecticut Planning Region",2,35,7649,3875,3774
050,09,190,"Connecticut","Western Connecticut Planning Region",2,36,7606,3843,3763
050,09,190,"Connecticut","Western Connecticut Planning Region",2,37,7785,3890,3895
050,09,190,"Connecticut","Western Connecticut Planning Region",2,38,7942,3960,3982
050,09,190,"Connecticut","Western Connecticut Planning Region",2,39,7925,3936,3989
050,09,190,"Connecticut","Western Connecticut Planning Region",2,40,8044,3946,4098
050,09,190,"Connecticut","Western Connecticut Planning Region",2,41,7874,3873,4001
050,09,190,"Connecticut","Western Connecticut Planning Region",2,42,7844,3908,3936
050,09,190,"Connecticut","Western Connecticut Planning Region",2,43,7880,3909,3971
050,09,190,"Connecticut","Western Connecticut Planning Region",2,44,7700,3811,3889
050,09,190,"Connecticut","Western Connecticut Planning Region",2,45,7799,3855,3944
050,09,190,"Connecticut","Western Connecticut Planning Region",2,46,7742,3802,3940
050,09,190,"Connecticut","Western Connecticut Planning Region",2,47,8010,3915,4095
050,09,190,"Connecticut","Western Connecticut Planning Region",2,48,8496,4152,4344
050,09,190,"Connecticut","Western Connecticut Planning Region",2,49,9156,4484,4672
050,09,190,"Connecticut","Western Connecticut Planning Region",2,50,9281,4564,4717
050,09,190,"Connecticut","Western Connecticut Planning Region",2,51,9041,4466,4575
050,09,190,"Connecticut","Western Connecticut Planning Region",2,52,9032,4428,4604
050,09,190,"Connecticut","Western Connecticut Planning Region",2,53,9290,4546,4744
050,09,190,"Connecticut","Western Connecticut Planning Region",2,54,9523,4675,4848
050,09,190,"Connecticut","Western Connecticut Planning Region",2,55,9750,4764,4986
050,09,190,"Connecticut","Western Connecticut Planning Region",2,56,9826,4780,5046
050,09,190,"Connecticut","Western Connecticut Planning Region",2,57,9626,4709,4917
050,09,190,"Connecticut","Western Connecticut Planning Region",2,58,9556,4659,4897
050,09,190,"Connecticut","Western Connecticut Planning Region",2,59,9439,4574,4865
050,09,190,"Connecticut","Western Connecticut Planning Region",2,60,9166,4468,4698
050,09,190,"Connecticut","Western Connecticut Planning Region",2,61,8884,4355,4529
050,09,190,"Connecticut","Western Connecticut Planning Region",2,62,8648,4248,4400
050,09,190,"Connecticut","Western Connecticut Planning Region",2,63,8385,4094,4291
050,09,190,"Connecticut","Western Connecticut Planning Region",2,64,7903,3866,4037
050,09,190,"Connecticut","Western Connecticut Planning Region",2,65,7562,3693,3869
050,09,190,"Connecticut","Western Connecticut Planning Region",2,66,7114,3498,3616
050,09,190,"Connecticut","Western Connecticut Planning Region",2,67,6591,3195,3396
050,09,190,"Connecticut","Western Connecticut Planning Region",2,68,6176,2946,3230
050,09,190,"Connecticut","Western Connecticut Planning Region",2,69,5785,2716,3069
050,09,190,"Connecticut","Western Connecticut Planning Region",2,70,5436,2517,2919
050,09,190,"Connecticut","Western Connecticut Planning Region",2,71,5263,2417,2846
050,09,190,"Connecticut","Western Connecticut Planning Region",2,72,5216,2399,2817
050,09,190,"Connecticut","Western Connecticut Planning Region",2,73,5687,2629,3058
050,09,190,"Connecticut","Western Connecticut Planning Region",2,74,4090,1871,2219
050,09,190,"Connecticut","Western Connecticut Planning Region",2,75,3951,1810,2141
050,09,190,"Connecticut","Western Connecticut Planning Region",2,76,3877,1760,2117
050,09,190,"Connecticut","Western Connecticut Planning Region",2,77,3989,1786,2203
050,09,190,"Connecticut","Western Connecticut Planning Region",2,78,3389,1493,1896
050,09,190,"Connecticut","Western Connecticut Planning Region",2,79,2985,1295,1690
050,09,190,"Connecticut","Western Connecticut Planning Region",2,80,2751,1173,1578
050,09,190,"Connecticut","Western Connecticut Planning Region",2,81,2548,1075,1473
050,09,190,"Connecticut","Western Connecticut Planning Region",2,82,2354,979,1375
050,09,190,"Connecticut","Western Connecticut Planning Region",2,83,2144,902,1242
050,09,190,"Connecticut","Western Connecticut Planning Region",2,84,2005,821,1184
050,09,190,"Connecticut","Western Connecticut Planning Region",2,85,13421,4728,8693
050,09,190,"Connecticut","Western Connecticut Planning Region",3,0,6155,3125,3030
050,09,190,"Connecticut","Western Connecticut Planning Region",3,1,6441,3254,3187
050,09,190,"Connecticut","Western Connecticut Planning Region",3,2,6529,3281,3248
050,09,190,"Connecticut","Western Connecticut Planning Region",3,3,6727,3476,3251
050,09,190,"Connecticut","Western Connecticut Planning Region",3,4,6850,3503,3347
050,09,190,"Connecticut","Western Connecticut Planning Region",3,5,7121,3575,3546
050,09,190,"Connecticut","Western Connecticut Planning Region",3,6,7192,3637,3555
050,09,190,"Connecticut","Western Connecticut Planning Region",3,7,7200,3651,3549
050,09,190,"Connecticut","Western Connecticut Planning Region",3,8,7232,3641,3591
050,09,190,"Connecticut","Western Connecticut Planning Region",3,9,7381,3711,3670
050,09,190,"Connecticut","Western Connecticut Planning Region",3,10,7564,3852,3712
050,09,190,"Connecticut","Western Connecticut Planning Region",3,11,7940,4014,3926
050,09,190,"Connecticut","Western Connecticut Planning Region",3,12,8175,4180,3995
050,09,190,"Connecticut","Western Connecticut Planning Region",3,13,8636,4432,4204
050,09,190,"Connecticut","Western Connecticut Planning Region",3,14,8761,4486,4275
050,09,190,"Connecticut","Western Connecticut Planning Region",3,15,8739,4415,4324
050,09,190,"Connecticut","Western Connecticut Planning Region",3,16,8774,4433,4341
050,09,190,"Connecticut","Western Connecticut Planning Region",3,17,8865,4526,4339
050,09,190,"Connecticut","Western Connecticut Planning Region",3,18,7916,4114,3802
050,09,190,"Connecticut","Western Connecticut Planning Region",3,19,6810,3507,3303
050,09,190,"Connecticut","Western Connecticut Planning Region",3,20,7322,3764,3558
050,09,190,"Connecticut","Western Connecticut Planning Region",3,21,7514,3829,3685
050,09,190,"Connecticut","Western Connecticut Planning Region",3,22,7480,3807,3673
050,09,190,"Connecticut","Western Connecticut Planning Region",3,23,7348,3766,3582
050,09,190,"Connecticut","Western Connecticut Planning Region",3,24,7400,3828,3572
050,09,190,"Connecticut","Western Connecticut Planning Region",3,25,7143,3709,3434
050,09,190,"Connecticut","Western Connecticut Planning Region",3,26,7255,3726,3529
050,09,190,"Connecticut","Western Connecticut Planning Region",3,27,7272,3734,3538
050,09,190,"Connecticut","Western Connecticut Planning Region",3,28,7243,3621,3622
050,09,190,"Connecticut","Western Connecticut Planning Region",3,29,7137,3626,3511
050,09,190,"Connecticut","Western Connecticut Planning Region",3,30,7203,3614,3589
050,09,190,"Connecticut","Western Connecticut Planning Region",3,31,7299,3661,3638
050,09,190,"Connecticut","Western Connecticut Planning Region",3,32,7230,3546,3684
050,09,190,"Connecticut","Western Connecticut Planning Region",3,33,7562,3742,3820
050,09,190,"Connecticut","Western Connecticut Planning Region",3,34,7686,3780,3906
050,09,190,"Connecticut","Western Connecticut Planning Region",3,35,7874,3940,3934
050,09,190,"Connecticut","Western Connecticut Planning Region",3,36,7910,3953,3957
050,09,190,"Connecticut","Western Connecticut Planning Region",3,37,7849,3970,3879
050,09,190,"Connecticut","Western Connecticut Planning Region",3,38,8039,4037,4002
050,09,190,"Connecticut","Western Connecticut Planning Region",3,39,8195,4104,4091
050,09,190,"Connecticut","Western Connecticut Planning Region",3,40,8074,3974,4100
050,09,190,"Connecticut","Western Connecticut Planning Region",3,41,8190,4027,4163
050,09,190,"Connecticut","Western Connecticut Planning Region",3,42,7953,3878,4075
050,09,190,"Connecticut","Western Connecticut Planning Region",3,43,7961,3966,3995
050,09,190,"Connecticut","Western Connecticut Planning Region",3,44,8000,3982,4018
050,09,190,"Connecticut","Western Connecticut Planning Region",3,45,7813,3865,3948
050,09,190,"Connecticut","Western Connecticut Planning Region",3,46,7808,3865,3943
050,09,190,"Connecticut","Western Connecticut Planning Region",3,47,7725,3787,3938
050,09,190,"Connecticut","Western Connecticut Planning Region",3,48,8009,3902,4107
050,09,190,"Connecticut","Western Connecticut Planning Region",3,49,8496,4159,4337
050,09,190,"Connecticut","Western Connecticut Planning Region",3,50,9135,4455,4680
050,09,190,"Connecticut","Western Connecticut Planning Region",3,51,9251,4583,4668
050,09,190,"Connecticut","Western Connecticut Planning Region",3,52,9030,4429,4601
050,09,190,"Connecticut","Western Connecticut Planning Region",3,53,9037,4429,4608
050,09,190,"Connecticut","Western Connecticut Planning Region",3,54,9197,4501,4696
050,09,190,"Connecticut","Western Connecticut Planning Region",3,55,9364,4598,4766
050,09,190,"Connecticut","Western Connecticut Planning Region",3,56,9669,4730,4939
050,09,190,"Connecticut","Western Connecticut Planning Region",3,57,9719,4714,5005
050,09,190,"Connecticut","Western Connecticut Planning Region",3,58,9456,4617,4839
050,09,190,"Connecticut","Western Connecticut Planning Region",3,59,9452,4617,4835
050,09,190,"Connecticut","Western Connecticut Planning Region",3,60,9283,4501,4782
050,09,190,"Connecticut","Western Connecticut Planning Region",3,61,8989,4397,4592
050,09,190,"Connecticut","Western Connecticut Planning Region",3,62,8679,4244,4435
050,09,190,"Connecticut","Western Connecticut Planning Region",3,63,8474,4163,4311
050,09,190,"Connecticut","Western Connecticut Planning Region",3,64,8197,4015,4182
050,09,190,"Connecticut","Western Connecticut Planning Region",3,65,7656,3730,3926
050,09,190,"Connecticut","Western Connecticut Planning Region",3,66,7330,3563,3767
050,09,190,"Connecticut","Western Connecticut Planning Region",3,67,6922,3413,3509
050,09,190,"Connecticut","Western Connecticut Planning Region",3,68,6417,3108,3309
050,09,190,"Connecticut","Western Connecticut Planning Region",3,69,6010,2856,3154
050,09,190,"Connecticut","Western Connecticut Planning Region",3,70,5642,2639,3003
050,09,190,"Connecticut","Western Connecticut Planning Region",3,71,5325,2448,2877
050,09,190,"Connecticut","Western Connecticut Planning Region",3,72,5151,2356,2795
050,09,190,"Connecticut","Western Connecticut Planning Region",3,73,5078,2334,2744
050,09,190,"Connecticut","Western Connecticut Planning Region",3,74,5513,2530,2983
050,09,190,"Connecticut","Western Connecticut Planning Region",3,75,4003,1816,2187
050,09,190,"Connecticut","Western Connecticut Planning Region",3,76,3805,1739,2066
050,09,190,"Connecticut","Western Connecticut Planning Region",3,77,3740,1686,2054
050,09,190,"Connecticut","Western Connecticut Planning Region",3,78,3854,1716,2138
050,09,190,"Connecticut","Western Connecticut Planning Region",3,79,3254,1426,1828
050,09,190,"Connecticut","Western Connecticut Planning Region",3,80,2876,1235,1641
050,09,190,"Connecticut","Western Connecticut Planning Region",3,81,2642,1115,1527
050,09,190,"Connecticut","Western Connecticut Planning Region",3,82,2418,1000,1418
050,09,190,"Connecticut","Western Connecticut Planning Region",3,83,2215,909,1306
050,09,190,"Connecticut","Western Connecticut Planning Region",3,84,2024,830,1194
050,09,190,"Connecticut","Western Connecticut Planning Region",3,85,13453,4794,8659
050,09,190,"Connecticut","Western Connecticut Planning Region",4,0,6552,3311,3241
050,09,190,"Connecticut","Western Connecticut Planning Region",4,1,6443,3272,3171
050,09,190,"Connecticut","Western Connecticut Planning Region",4,2,6682,3385,3297
050,09,190,"Connecticut","Western Connecticut Planning Region",4,3,6707,3377,3330
050,09,190,"Connecticut","Western Connecticut Planning Region",4,4,6902,3552,3350
050,09,190,"Connecticut","Western Connecticut Planning Region",4,5,7022,3594,3428
050,09,190,"Connecticut","Western Connecticut Planning Region",4,6,7245,3629,3616
050,09,190,"Connecticut","Western Connecticut Planning Region",4,7,7296,3721,3575
050,09,190,"Connecticut","Western Connecticut Planning Region",4,8,7292,3731,3561
050,09,190,"Connecticut","Western Connecticut Planning Region",4,9,7273,3646,3627
050,09,190,"Connecticut","Western Connecticut Planning Region",4,10,7469,3743,3726
050,09,190,"Connecticut","Western Connecticut Planning Region",4,11,7630,3872,3758
050,09,190,"Connecticut","Western Connecticut Planning Region",4,12,7939,4018,3921
050,09,190,"Connecticut","Western Connecticut Planning Region",4,13,8197,4183,4014
050,09,190,"Connecticut","Western Connecticut Planning Region",4,14,8686,4450,4236
050,09,190,"Connecticut","Western Connecticut Planning Region",4,15,8784,4511,4273
050,09,190,"Connecticut","Western Connecticut Planning Region",4,16,8759,4397,4362
050,09,190,"Connecticut","Western Connecticut Planning Region",4,17,8784,4442,4342
050,09,190,"Connecticut","Western Connecticut Planning Region",4,18,7880,4083,3797
050,09,190,"Connecticut","Western Connecticut Planning Region",4,19,6662,3440,3222
050,09,190,"Connecticut","Western Connecticut Planning Region",4,20,7047,3597,3450
050,09,190,"Connecticut","Western Connecticut Planning Region",4,21,7441,3838,3603
050,09,190,"Connecticut","Western Connecticut Planning Region",4,22,7491,3808,3683
050,09,190,"Connecticut","Western Connecticut Planning Region",4,23,7136,3662,3474
050,09,190,"Connecticut","Western Connecticut Planning Region",4,24,6959,3560,3399
050,09,190,"Connecticut","Western Connecticut Planning Region",4,25,7001,3658,3343
050,09,190,"Connecticut","Western Connecticut Planning Region",4,26,6908,3573,3335
050,09,190,"Connecticut","Western Connecticut Planning Region",4,27,7005,3574,3431
050,09,190,"Connecticut","Western Connecticut Planning Region",4,28,7085,3656,3429
050,09,190,"Connecticut","Western Connecticut Planning Region",4,29,7334,3709,3625
050,09,190,"Connecticut","Western Connecticut Planning Region",4,30,7281,3660,3621
050,09,190,"Connecticut","Western Connecticut Planning Region",4,31,7255,3625,3630
050,09,190,"Connecticut","Western Connecticut Planning Region",4,32,7476,3675,3801
050,09,190,"Connecticut","Western Connecticut Planning Region",4,33,7630,3714,3916
050,09,190,"Connecticut","Western Connecticut Planning Region",4,34,7780,3881,3899
050,09,190,"Connecticut","Western Connecticut Planning Region",4,35,7883,3889,3994
050,09,190,"Connecticut","Western Connecticut Planning Region",4,36,7980,3988,3992
050,09,190,"Connecticut","Western Connecticut Planning Region",4,37,8123,4040,4083
050,09,190,"Connecticut","Western Connecticut Planning Region",4,38,8021,4067,3954
050,09,190,"Connecticut","Western Connecticut Planning Region",4,39,8095,4087,4008
050,09,190,"Connecticut","Western Connecticut Planning Region",4,40,8367,4194,4173
050,09,190,"Connecticut","Western Connecticut Planning Region",4,41,8156,4010,4146
050,09,190,"Connecticut","Western Connecticut Planning Region",4,42,8289,4102,4187
050,09,190,"Connecticut","Western Connecticut Planning Region",4,43,8029,3887,4142
050,09,190,"Connecticut","Western Connecticut Planning Region",4,44,8064,4013,4051
050,09,190,"Connecticut","Western Connecticut Planning Region",4,45,8010,3994,4016
050,09,190,"Connecticut","Western Connecticut Planning Region",4,46,7869,3909,3960
050,09,190,"Connecticut","Western Connecticut Planning Region",4,47,7830,3884,3946
050,09,190,"Connecticut","Western Connecticut Planning Region",4,48,7652,3746,3906
050,09,190,"Connecticut","Western Connecticut Planning Region",4,49,7996,3903,4093
050,09,190,"Connecticut","Western Connecticut Planning Region",4,50,8465,4140,4325
050,09,190,"Connecticut","Western Connecticut Planning Region",4,51,9055,4441,4614
050,09,190,"Connecticut","Western Connecticut Planning Region",4,52,9153,4535,4618
050,09,190,"Connecticut","Western Connecticut Planning Region",4,53,8959,4391,4568
050,09,190,"Connecticut","Western Connecticut Planning Region",4,54,8945,4376,4569
050,09,190,"Connecticut","Western Connecticut Planning Region",4,55,9045,4426,4619
050,09,190,"Connecticut","Western Connecticut Planning Region",4,56,9176,4517,4659
050,09,190,"Connecticut","Western Connecticut Planning Region",4,57,9441,4621,4820
050,09,190,"Connecticut","Western Connecticut Planning Region",4,58,9562,4612,4950
050,09,190,"Connecticut","Western Connecticut Planning Region",4,59,9270,4512,4758
050,09,190,"Connecticut","Western Connecticut Planning Region",4,60,9311,4545,4766
050,09,190,"Connecticut","Western Connecticut Planning Region",4,61,9058,4401,4657
050,09,190,"Connecticut","Western Connecticut Planning Region",4,62,8744,4265,4479
050,09,190,"Connecticut","Western Connecticut Planning Region",4,63,8456,4129,4327
050,09,190,"Connecticut","Western Connecticut Planning Region",4,64,8236,4042,4194
050,09,190,"Connecticut","Western Connecticut Planning Region",4,65,8044,3928,4116
050,09,190,"Connecticut","Western Connecticut Planning Region",4,66,7480,3617,3863
050,09,190,"Connecticut","Western Connecticut Planning Region",4,67,7076,3439,3637
050,09,190,"Connecticut","Western Connecticut Planning Region",4,68,6726,3300,3426
050,09,190,"Connecticut","Western Connecticut Planning Region",4,69,6224,2991,3233
050,09,190,"Connecticut","Western Connecticut Planning Region",4,70,5833,2769,3064
050,09,190,"Connecticut","Western Connecticut Planning Region",4,71,5519,2567,2952
050,09,190,"Connecticut","Western Connecticut Planning Region",4,72,5188,2374,2814
050,09,190,"Connecticut","Western Connecticut Planning Region",4,73,5042,2277,2765
050,09,190,"Connecticut","Western Connecticut Planning Region",4,74,4949,2271,2678
050,09,190,"Connecticut","Western Connecticut Planning Region",4,75,5349,2441,2908
050,09,190,"Connecticut","Western Connecticut Planning Region",4,76,3862,1747,2115
050,09,190,"Connecticut","Western Connecticut Planning Region",4,77,3685,1659,2026
050,09,190,"Connecticut","Western Connecticut Planning Region",4,78,3611,1611,2000
050,09,190,"Connecticut","Western Connecticut Planning Region",4,79,3679,1608,2071
050,09,190,"Connecticut","Western Connecticut Planning Region",4,80,3154,1378,1776
050,09,190,"Connecticut","Western Connecticut Planning Region",4,81,2748,1175,1573
050,09,190,"Connecticut","Western Connecticut Planning Region",4,82,2514,1058,1456
050,09,190,"Connecticut","Western Connecticut Planning Region",4,83,2265,921,1344
050,09,190,"Connecticut","Western Connecticut Planning Region",4,84,2097,837,1260
050,09,190,"Connecticut","Western Connecticut Planning Region",4,85,13539,4862,8677
050,09,190,"Connecticut","Western Connecticut Planning Region",5,0,6438,3249,3189
050,09,190,"Connecticut","Western Connecticut Planning Region",5,1,6755,3469,3286
050,09,190,"Connecticut","Western Connecticut Planning Region",5,2,6564,3295,3269
050,09,190,"Connecticut","Western Connecticut Planning Region",5,3,6731,3426,3305
050,09,190,"Connecticut","Western Connecticut Planning Region",5,4,6777,3421,3356
050,09,190,"Connecticut","Western Connecticut Planning Region",5,5,7002,3590,3412
050,09,190,"Connecticut","Western Connecticut Planning Region",5,6,7123,3627,3496
050,09,190,"Connecticut","Western Connecticut Planning Region",5,7,7304,3709,3595
050,09,190,"Connecticut","Western Connecticut Planning Region",5,8,7370,3776,3594
050,09,190,"Connecticut","Western Connecticut Planning Region",5,9,7343,3737,3606
050,09,190,"Connecticut","Western Connecticut Planning Region",5,10,7356,3661,3695
050,09,190,"Connecticut","Western Connecticut Planning Region",5,11,7536,3780,3756
050,09,190,"Connecticut","Western Connecticut Planning Region",5,12,7683,3917,3766
050,09,190,"Connecticut","Western Connecticut Planning Region",5,13,7953,3997,3956
050,09,190,"Connecticut","Western Connecticut Planning Region",5,14,8230,4193,4037
050,09,190,"Connecticut","Western Connecticut Planning Region",5,15,8668,4429,4239
050,09,190,"Connecticut","Western Connecticut Planning Region",5,16,8819,4499,4320
050,09,190,"Connecticut","Western Connecticut Planning Region",5,17,8770,4410,4360
050,09,190,"Connecticut","Western Connecticut Planning Region",5,18,7840,4038,3802
050,09,190,"Connecticut","Western Connecticut Planning Region",5,19,6786,3487,3299
050,09,190,"Connecticut","Western Connecticut Planning Region",5,20,7083,3625,3458
050,09,190,"Connecticut","Western Connecticut Planning Region",5,21,7313,3740,3573
050,09,190,"Connecticut","Western Connecticut Planning Region",5,22,7538,3875,3663
050,09,190,"Connecticut","Western Connecticut Planning Region",5,23,7247,3704,3543
050,09,190,"Connecticut","Western Connecticut Planning Region",5,24,6942,3571,3371
050,09,190,"Connecticut","Western Connecticut Planning Region",5,25,6790,3486,3304
050,09,190,"Connecticut","Western Connecticut Planning Region",5,26,6979,3646,3333
050,09,190,"Connecticut","Western Connecticut Planning Region",5,27,6838,3496,3342
050,09,190,"Connecticut","Western Connecticut Planning Region",5,28,6974,3542,3432
050,09,190,"Connecticut","Western Connecticut Planning Region",5,29,7222,3715,3507
050,09,190,"Connecticut","Western Connecticut Planning Region",5,30,7366,3717,3649
050,09,190,"Connecticut","Western Connecticut Planning Region",5,31,7365,3724,3641
050,09,190,"Connecticut","Western Connecticut Planning Region",5,32,7504,3709,3795
050,09,190,"Connecticut","Western Connecticut Planning Region",5,33,7830,3802,4028
050,09,190,"Connecticut","Western Connecticut Planning Region",5,34,7864,3858,4006
050,09,190,"Connecticut","Western Connecticut Planning Region",5,35,7873,3881,3992
050,09,190,"Connecticut","Western Connecticut Planning Region",5,36,7984,3899,4085
050,09,190,"Connecticut","Western Connecticut Planning Region",5,37,8146,4093,4053
050,09,190,"Connecticut","Western Connecticut Planning Region",5,38,8179,4098,4081
050,09,190,"Connecticut","Western Connecticut Planning Region",5,39,8117,4094,4023
050,09,190,"Connecticut","Western Connecticut Planning Region",5,40,8190,4108,4082
050,09,190,"Connecticut","Western Connecticut Planning Region",5,41,8385,4197,4188
050,09,190,"Connecticut","Western Connecticut Planning Region",5,42,8234,4022,4212
050,09,190,"Connecticut","Western Connecticut Planning Region",5,43,8223,4052,4171
050,09,190,"Connecticut","Western Connecticut Planning Region",5,44,7996,3864,4132
050,09,190,"Connecticut","Western Connecticut Planning Region",5,45,8063,4025,4038
050,09,190,"Connecticut","Western Connecticut Planning Region",5,46,7966,3982,3984
050,09,190,"Connecticut","Western Connecticut Planning Region",5,47,7829,3873,3956
050,09,190,"Connecticut","Western Connecticut Planning Region",5,48,7792,3883,3909
050,09,190,"Connecticut","Western Connecticut Planning Region",5,49,7630,3735,3895
050,09,190,"Connecticut","Western Connecticut Planning Region",5,50,7932,3865,4067
050,09,190,"Connecticut","Western Connecticut Planning Region",5,51,8409,4159,4250
050,09,190,"Connecticut","Western Connecticut Planning Region",5,52,8970,4391,4579
050,09,190,"Connecticut","Western Connecticut Planning Region",5,53,9036,4489,4547
050,09,190,"Connecticut","Western Connecticut Planning Region",5,54,8876,4372,4504
050,09,190,"Connecticut","Western Connecticut Planning Region",5,55,8862,4329,4533
050,09,190,"Connecticut","Western Connecticut Planning Region",5,56,8959,4374,4585
050,09,190,"Connecticut","Western Connecticut Planning Region",5,57,9031,4449,4582
050,09,190,"Connecticut","Western Connecticut Planning Region",5,58,9304,4542,4762
050,09,190,"Connecticut","Western Connecticut Planning Region",5,59,9455,4554,4901
050,09,190,"Connecticut","Western Connecticut Planning Region",5,60,9101,4423,4678
050,09,190,"Connecticut","Western Connecticut Planning Region",5,61,9172,4489,4683
050,09,190,"Connecticut","Western Connecticut Planning Region",5,62,8896,4328,4568
050,09,190,"Connecticut","Western Connecticut Planning Region",5,63,8633,4211,4422
050,09,190,"Connecticut","Western Connecticut Planning Region",5,64,8290,4032,4258
050,09,190,"Connecticut","Western Connecticut Planning Region",5,65,8079,3968,4111
050,09,190,"Connecticut","Western Connecticut Planning Region",5,66,7844,3824,4020
050,09,190,"Connecticut","Western Connecticut Planning Region",5,67,7251,3487,3764
050,09,190,"Connecticut","Western Connecticut Planning Region",5,68,6953,3374,3579
050,09,190,"Connecticut","Western Connecticut Planning Region",5,69,6572,3211,3361
050,09,190,"Connecticut","Western Connecticut Planning Region",5,70,6123,2922,3201
050,09,190,"Connecticut","Western Connecticut Planning Region",5,71,5734,2702,3032
050,09,190,"Connecticut","Western Connecticut Planning Region",5,72,5416,2508,2908
050,09,190,"Connecticut","Western Connecticut Planning Region",5,73,5083,2311,2772
050,09,190,"Connecticut","Western Connecticut Planning Region",5,74,4958,2243,2715
050,09,190,"Connecticut","Western Connecticut Planning Region",5,75,4833,2212,2621
050,09,190,"Connecticut","Western Connecticut Planning Region",5,76,5210,2361,2849
050,09,190,"Connecticut","Western Connecticut Planning Region",5,77,3747,1684,2063
050,09,190,"Connecticut","Western Connecticut Planning Region",5,78,3591,1595,1996
050,09,190,"Connecticut","Western Connecticut Planning Region",5,79,3499,1548,1951
050,09,190,"Connecticut","Western Connecticut Planning Region",5,80,3558,1551,2007
050,09,190,"Connecticut","Western Connecticut Planning Region",5,81,3057,1320,1737
050,09,190,"Connecticut","Western Connecticut Planning Region",5,82,2630,1138,1492
050,09,190,"Connecticut","Western Connecticut Planning Region",5,83,2375,987,1388
050,09,190,"Connecticut","Western Connecticut Planning Region",5,84,2168,861,1307
050,09,190,"Connecticut","Western Connecticut Planning Region",5,85,13790,4961,8829

